name,relative_counts,ct,ct_0,barcode,ct_1,barcode_ind
fldAp,0.28428927680798005,513,400,AGGATGAGTGAATGAAGTCA,113,1160579
fldAp,1.2460567823343849,710,316,ATGGTCAGTAAAGAGTCTTG,394,1065467
fldAp,1.075,413,199,GCCATTGGTCGGCTACCTCA,214,1065619
fldAp,0.7784810126582279,279,157,TGCTTTTAGTAGTGATCATA,122,1171230
fldAp,1.6258503401360545,384,146,CTTGGCAATCAGAGAAGTTC,238,1180354
fldAp,0.7985611510791367,248,138,GTGGGTGTCAGAGAAAAGTT,110,1159118
fldAp,1.3384615384615384,302,129,CTGAACCCGAGTGAGTCATA,173,1125319
fldAp,3.83739837398374,593,122,TGGTCAGGAGAGCAGCCCCA,471,1093292
fldAp,0.4230769230769231,146,103,AGAGCCTTGGAATCCAGCAT,43,1065026
fldAp,0.9693877551020408,191,97,TGCCTCAGCTTTTGAGAGGC,94,1147960
fldAp,0.40425531914893614,130,93,GTCCGTTGAAGACGCACGGG,37,1128268
fldAp,0.9347826086956522,176,91,TCCAGGCACGGATCGAGGCA,85,1080276
fldAp,0.7065217391304348,155,91,GACCACACTCCACTGGCCGC,64,1063858
fldAp,0.5888888888888889,141,89,CATCCAAACGCCAGAGCAAC,52,1078467
fldAp,0.29213483146067415,113,88,GAAATGAGTCTTTTGAAAGT,25,1064605
fldAp,1.6590909090909092,232,87,GTGCAGCTGAAGGCTCGTTC,145,1068559
fldAp,0.3333333333333333,114,86,TGACCGTAGATGTAGCTTTA,28,1076214
fldAp,0.05813953488372093,89,85,TGCACTACCACTCGGCCTAA,4,1085116
fldAp,0.7380952380952381,144,83,CAATGTCCGTGCTTCGACAG,61,1110463
fldAp,0.14457831325301204,93,82,CGTTTCTTCCTCCTAGGACA,11,1178300
fldAp,0.2804878048780488,103,81,GGGGCGGTAGTCACGCTTCT,22,1075448
fldAp,0.25,98,79,TTGAGGAGTTACATACCTTG,19,1169594
fldAp,1.25,178,79,TTCGGTCTTACTGACGCCTA,99,1125579
fldAp,0.4050632911392405,109,78,TTGCCTACTTCAGACTGGCA,31,1065863
fldAp,0.22784810126582278,95,78,TACAAGGTACGTCTCTCGTT,17,1141819
fldAp,0.5316455696202531,119,78,ATCCCCTTTCCGGTCCCAAA,41,1068230
fldAp,2.5384615384615383,274,77,CATGGTTAGCAACGCAAAAA,197,1133814
fldAp,0.9615384615384616,151,77,AATGACGCAGTGGTCAACTG,74,1104438
fldAp,0.33766233766233766,101,76,CTTCCTCCGCAGAGTTGGCT,25,1074848
fldAp,0.35526315789473684,101,75,GTTTAAATGTCCAAAGTTAT,26,1080267
fldAp,0.23684210526315788,92,75,GGTCCAAAGGGGACACCTGC,17,1166978
fldAp,0.5540540540540541,113,73,CAGTAAAGTCAGCTCCCTAT,40,1164249
fldAp,1.0810810810810811,152,73,AGTCGGTCGCGCACTCTTTT,79,1151872
fldAp,0.8493150684931506,133,72,TGTTAGCGATTGTCACCTTA,61,1152614
fldAp,0.7123287671232876,123,72,GGTCAAGTTCACAGGTGGAG,51,1119995
fldAp,0.7671232876712328,127,72,AGTACCAAATTCCGTTGACA,55,1110822
fldAp,2.0416666666666665,217,71,GATTAGCACCGGGTAGATAT,146,1082289
fldAp,1.7916666666666667,199,71,ACCGTTGCTCACAATACGTC,128,1106938
fldAp,2.8,264,69,GTTTAAAGCAGGTCATCTTA,195,1108498
fldAp,0.08571428571428572,74,69,GCCCAGTCCTGAAATACGCC,5,1170613
fldAp,7.3,579,69,AGACTTGCCGTATCACAGAA,510,1151173
fldAp,0.028985507246376812,69,68,AACGGCTTCAGTACCACACC,1,1118500
fldAp,0.39705882352941174,93,67,CAAGATGTCTGGGATTAGGA,26,1075616
fldAp,0.417910447761194,93,66,GTAATGCAAGATGATAGCGT,27,1072482
fldAp,3.9402985074626864,329,66,CGCTCCCTAGGATTCAAAAA,263,1169732
fldAp,0.7761194029850746,117,66,CCGCCATCCAAAAAGGGAGA,51,1111116
fldAp,2.4029850746268657,226,66,CCCTCAGTAAAGTCTAAGCG,160,1136476
fldAp,0.373134328358209,90,66,ACCAAGGTCAGTGGCCGCCA,24,1186353
fldAp,1.1363636363636365,139,65,TAGGCCGCTGGGCCACCTTA,74,1112710
fldAp,3.1515151515151514,272,65,GGCCGAAGTAGGGTTTATAT,207,1105979
fldAp,2.5454545454545454,232,65,CGGTTGGCGGGATTTCGTAT,167,1068626
fldAp,0.4090909090909091,91,65,AGGGTGGCTGGGCGCTTTCT,26,1098398
fldAp,1.1384615384615384,137,64,CTAATCCATGCGATGTTTGT,73,1127784
fldAp,1.4375,154,63,GTGCGGACGTATGGTTTAGT,91,1087098
fldAp,0.515625,95,63,GGAAAGACCGGATATGCACA,32,1129034
fldAp,0.6875,106,63,CCTGGGCGAGTTCACCGGGC,43,1074279
fldAp,2.328125,211,63,CCCGAGGCGAGCCATAAGGC,148,1133342
fldAp,4.453125,347,63,CACGGTAGAGACGACGCGAG,284,1065380
fldAp,0.15625,72,63,ACAACGCCTATCGTTGGAAT,9,1146813
fldAp,0.31746031746031744,81,62,AGCTGACCTTTAACGGGAAT,19,1132867
fldAp,1.2258064516129032,136,61,TTCCTTAATACGCGTAATTT,75,1097685
fldAp,1.532258064516129,155,61,TTAAAGTACCACGTAGGGAT,94,1134221
fldAp,0.6774193548387096,102,61,TCAATCCTTTCAAGGAATTA,41,1102961
fldAp,0.8225806451612904,111,61,GTGGCTACTCAGTGTCTCTG,50,1086682
fldAp,0.3709677419354839,83,61,GCGGGCACTTTGGTCGAAAT,22,1157197
fldAp,0.5161290322580645,92,61,GAATCTGACCGACAGCACGC,31,1101734
fldAp,0.5806451612903226,96,61,CGGCACACTCATGACCACTG,35,1069789
fldAp,0.04838709677419355,63,61,ATTCATGACAGCTGTCACGA,2,1080384
fldAp,1.1290322580645162,130,61,AGTCAATCTTTTACGAAGTG,69,1118882
fldAp,0.8524590163934426,111,60,TTCCTCCAAGTTCACGGGAT,51,1140463
fldAp,0.04918032786885246,62,60,TCGCTTAAGCACCTGGAAGA,2,1091339
fldAp,1.7704918032786885,167,60,GTTGTTTGGCGCCGATCCTA,107,1098195
fldAp,0.8524590163934426,111,60,GCTTCTCCGCACTCAAACTC,51,1087765
fldAp,1.0163934426229508,121,60,CTTATGGATGCAAGTGGGAC,61,1124418
fldAp,0.47540983606557374,88,60,CGGTAAAGGACCGACCTTGT,28,1127016
fldAp,0.6721311475409836,100,60,ATGACAAGTTGTGGCTCCTA,40,1081843
fldAp,0.5166666666666667,89,59,TTTAGAACACAAACGAAGTA,30,1149345
fldAp,1.3666666666666667,140,59,TAGGATTCGCGGTGCGGCCT,81,1152943
fldAp,0.7166666666666667,101,59,TAGCGGTCCGTCGCAGTCGT,42,1107093
fldAp,1.55,151,59,GGATAATAACTACGCTGGGT,92,1165560
fldAp,2.15,187,59,CCGATTAAGTCCCCGGGTCC,128,1080382
fldAp,0.03333333333333333,60,59,AGAGAGAATCAATGGCTTGT,1,1068036
fldAp,1.2881355932203389,133,58,TGGGTTGCTCGGCAGCTTCA,75,1120604
fldAp,0.2033898305084746,69,58,TAGTTCAAGAATGCTGGAAT,11,1176903
fldAp,0.6440677966101694,95,58,GGTACGGCTTAATACGGCAA,37,1064674
fldAp,0.3050847457627119,75,58,GCTCCTCTTTACATCACTTT,17,1184144
fldAp,0.03389830508474576,59,58,GCGATGGTGACGGGCAGCTT,1,1164041
fldAp,0.3898305084745763,80,58,CAGTAAGTTCTAGGCCTTCA,22,1073977
fldAp,0.5084745762711864,87,58,CAGGAGGATATGCGCCGTGA,29,1166495
fldAp,2.0677966101694913,179,58,ATCCTGGATTTGCCTAGCAA,121,1073174
fldAp,0.3728813559322034,79,58,ACGTACAATCAGACCGGTCG,21,1107184
fldAp,0.3275862068965517,75,57,TACAGTGGCAAGATCCCCTG,18,1063228
fldAp,1.7241379310344827,156,57,GGTTATCCTTTGCTCGGCAA,99,1142579
fldAp,1.4655172413793103,141,57,GAAGATTGCGTACCGTTCGG,84,1082186
fldAp,0.3448275862068966,76,57,CGCAATTCAAAGCCACATCT,19,1065107
fldAp,0.2413793103448276,70,57,CACACCTACAGGACGCCTGT,13,1129836
fldAp,0.13793103448275862,64,57,ATCGGAGGGTAGACCAAGAA,7,1065921
fldAp,2.293103448275862,189,57,AACTGTCGTTTTGTCGGGAC,132,1070123
fldAp,0.9649122807017544,110,56,TTGTCCTGCGGTCGAATCAT,54,1075017
fldAp,2.8421052631578947,217,56,TCTACTAGATATCGATCCGT,161,1064281
fldAp,2.2982456140350878,186,56,GGTCAGACTCGTTTGTGTGT,130,1136865
fldAp,0.3157894736842105,73,56,GAAGATGCAGTGCCGTAAGA,17,1157513
fldAp,0.2631578947368421,70,56,CTGGAAAGACGCGTCGTACA,14,1129331
fldAp,0.543859649122807,86,56,CAGTCTCGGGTAGAGCGACG,30,1101106
fldAp,1.3392857142857142,129,55,TACTGCGGGTCGGAGATAAT,74,1101653
fldAp,0.8214285714285714,100,55,GTCTTCCAGTACGGTCCCAA,45,1128615
fldAp,0.5892857142857143,87,55,GATAGCTGGAACGCCGGTGT,32,1157434
fldAp,0.3392857142857143,73,55,CGTCTGTGAGTCGCGCCCGT,18,1168037
fldAp,4.857142857142857,326,55,CGCCATAGCGCCCAGCTGGA,271,1105887
fldAp,0.8571428571428571,102,55,CCGTGGTATACCTTCACAAG,47,1161071
fldAp,0.42857142857142855,78,55,CAGCCGTTGGATAGTCCGAT,23,1113699
fldAp,0.44642857142857145,79,55,ATGTTCTTTATCTAAAGTGT,24,1177703
fldAp,0.03636363636363636,55,54,TATGGCTTCGGGAACACCAA,1,1125111
fldAp,1.7272727272727273,148,54,TAGCGCACTCCGGGGGCACA,94,1062978
fldAp,0.16363636363636364,62,54,GCAGGGAGCGCGCTGGTCTG,8,1140536
fldAp,0.7454545454545455,94,54,CTGGTGTCTAAGCAAACCGT,40,1113708
fldAp,0.509090909090909,81,54,CTACGCGGGAGACTTAGGTT,27,1151689
fldAp,1.3272727272727274,126,54,CCACAGGGCCAAGGGCCTGT,72,1103725
fldAp,0.21818181818181817,65,54,ATTTTGTGCACGCTTATCAT,11,1127483
fldAp,0.16363636363636364,62,54,ATGGGTACTAGCGCCACGAG,8,1158408
fldAp,0.37037037037037035,72,53,TGCATCAAAGACGCCCGGAT,19,1068231
fldAp,2.462962962962963,185,53,TGACATCAGTGGTTGTATGT,132,1105473
fldAp,2.0555555555555554,163,53,TAGCAGATGTCCATACACAT,110,1094993
fldAp,0.5740740740740741,83,53,GTACAGGCAAGTTCTAGTCG,30,1080278
fldAp,2.2222222222222223,172,53,GACTCCCGGGGGAGCTCAGA,119,1169686
fldAp,0.037037037037037035,54,53,CTACAACGGTGTGCTATTAT,1,1170307
fldAp,0.4444444444444444,76,53,CGGATCGCGTATTTGTTCCC,23,1070392
fldAp,0.25925925925925924,66,53,CCTGTGCTGACAAACGTTCG,13,1121834
fldAp,3.0925925925925926,219,53,CCTCTCTTTCGATTCGCCAA,166,1068562
fldAp,0.5,79,53,CCAAATGATGCGATGTAAGT,26,1160949
fldAp,0.9444444444444444,103,53,CATCCAATCCTGGTATACCT,50,1133048
fldAp,0.037037037037037035,54,53,AGGGTGGCTCAGGCGGTGGC,1,1128816
fldAp,0.037037037037037035,54,53,AGAGAAGAGGCTTGTCCGCG,1,1110676
fldAp,0.2777777777777778,67,53,AAGTGCCGCCGGCCCGTCAC,14,1087586
fldAp,0.6111111111111112,85,53,AACGATATGTACGGCTGTGA,32,1118412
fldAp,0.03773584905660377,53,52,TTAGCACCTGACGTGTGACA,1,1067167
fldAp,0.16981132075471697,60,52,TGCAGCGGGATGCCGCACAT,8,1063734
fldAp,0.03773584905660377,53,52,TCTCTGCCCGAGTTTAGCAC,1,1071648
fldAp,0.7358490566037735,90,52,GGTCCCCGGCTATTAGTCAG,38,1081209
fldAp,2.056603773584906,160,52,GGGTGCTGGGCAGGTATGGA,108,1063403
fldAp,1.320754716981132,121,52,GGCTGAGCCTGGGTTATCGC,69,1127239
fldAp,1.7358490566037736,143,52,CTGAATGCGGCTATTCTTAT,91,1133938
fldAp,0.32075471698113206,68,52,CTCTCACGCCGGTATGCTTA,16,1101879
fldAp,0.5094339622641509,78,52,CCTGGCGTAGATCAGATAAG,26,1153306
fldAp,0.5283018867924528,79,52,ATGCCAACATGATCAACTCC,27,1131745
fldAp,0.4528301886792453,75,52,AATATCGCCCGGGGTAGGGT,23,1089010
fldAp,1.0576923076923077,105,51,TGGAATGAGATCCATATAGA,54,1077080
fldAp,0.40384615384615385,71,51,TGAGTTGGGTAATCGGACAA,20,1090456
fldAp,1.2692307692307692,116,51,TGACATAGTGCCACTGTATC,65,1153982
fldAp,0.038461538461538464,52,51,TGACAAGACCAGCTCAAACG,1,1103712
fldAp,0.5576923076923077,79,51,TCGTTTGTCGTGGGCGTGTT,28,1082191
fldAp,0.6346153846153846,83,51,TAGATCAAGACTAAGATATG,32,1142209
fldAp,0.038461538461538464,52,51,GTTTAAGCACCTCGTGTGTG,1,1087363
fldAp,0.038461538461538464,52,51,GGCAGGGGGGACCAGTTAGT,1,1146067
fldAp,0.5384615384615384,78,51,GCGGCTACCAGAGCCGGGAA,27,1108416
fldAp,3.076923076923077,210,51,GAAGCGTGCAAACACTTTGA,159,1118744
fldAp,1.25,115,51,CGGACAATTTGGACCATGTT,64,1117754
fldAp,1.2692307692307692,116,51,CGAGGGTGTGGCCTCAAAGA,65,1066820
fldAp,0.4423076923076923,73,51,CCTATCCCAAGCTTACGTAT,22,1079878
fldAp,0.75,89,51,CACAATCGAACCGGTACGCT,38,1076818
fldAp,0.7884615384615384,91,51,ATATATGTCCACTCGTCATG,40,1121249
fldAp,0.75,89,51,ACAGCAAATCAGGAAACACT,38,1150637
fldAp,0.7115384615384616,87,51,AAGATCCGCGTCGGCGGTTA,36,1113537
fldAp,0.5384615384615384,78,51,AAACAAACAGTATGGCATTA,27,1078474
fldAp,0.09803921568627451,54,50,TGTTATTATGCCTGGTTAAC,4,1183113
fldAp,0.49019607843137253,74,50,TGGCCGAGCAATGTCTACAT,24,1078362
fldAp,0.47058823529411764,73,50,TGAACCTGTGCGACTCGTAC,23,1141132
fldAp,0.47058823529411764,73,50,GAGGGTCACAAGGATATCGG,23,1066097
fldAp,1.196078431372549,110,50,CTAATGGACATACGCTGAAG,60,1143512
fldAp,1.0392156862745099,102,50,CGGATTTGCGCAAAAAAAGA,52,1073172
fldAp,0.39215686274509803,69,50,CCGGTTGCACTATCCCCCGG,19,1072424
fldAp,0.9607843137254902,98,50,CCAGGTCCAGAGGTTCAAGA,48,1113070
fldAp,0.7647058823529411,88,50,CAGAGCACACCCAAGATAAT,38,1070393
fldAp,0.35294117647058826,67,50,CAGAGAAAAGACCATGAAAA,17,1119890
fldAp,0.9019607843137255,95,50,ATAGGTAACATTAGTCAAAA,45,1078858
fldAp,2.0,151,50,ACTGCAGGCTTTCCGCTGGA,101,1184216
fldAp,0.5882352941176471,79,50,ACTCAGATGCCAGTCGGCAG,29,1123949
fldAp,0.32,64,49,TTCGACAGTTATAAGATACG,15,1124847
fldAp,0.74,85,49,TTCAGTTTGAATATTTTGGA,36,1105386
fldAp,1.02,99,49,TGGGGCTGTTCATACTCGGC,50,1127584
fldAp,0.38,67,49,TCACGGTCCAAAATAGCGGT,18,1144474
fldAp,0.14,55,49,TAAAAGGAACCGTATCGACT,6,1178761
fldAp,0.62,79,49,GGCTGGGCTGTTCGTTACAG,30,1074280
fldAp,2.48,172,49,GGAGATCCCACCGGAGACAA,123,1167686
fldAp,1.78,137,49,GCACGGTGTGTATATTCATG,88,1118248
fldAp,1.0,98,49,CTGATTGACTAGATTTTAAT,49,1084273
fldAp,0.8,88,49,CTGACTAGGTCCGTCAAACC,39,1156734
fldAp,0.98,97,49,CGAGAGGTAAAGGGTAAAGT,48,1129971
fldAp,1.7,133,49,CCACGTTCCTTCTCTTATAA,84,1073187
fldAp,0.04,50,49,CCAACTGTTGCGGGAAGTGT,1,1100369
fldAp,0.12,54,49,CAGTTTAGCGCTCAAATGTG,5,1079705
fldAp,0.92,94,49,CACGTTTTTCCACAATAACA,45,1090566
fldAp,0.58,77,49,ATTTGACCCTAACTCTGTCC,28,1072886
fldAp,0.08,52,49,ATCCGTGCCTCTTGGGAACT,3,1084277
fldAp,0.04,50,49,ATCCAGCTAGGCGGAAAAAA,1,1092970
fldAp,1.2,108,49,ACAAAGCTCATTTACGCCAG,59,1074641
fldAp,0.8367346938775511,88,48,TGTTGGGCCTTCACGGAACG,40,1103425
fldAp,1.346938775510204,113,48,TAGAGGCATCCACCACGGAA,65,1074096
fldAp,2.1020408163265305,150,48,TACTATGTATCCCACTACCG,102,1071087
fldAp,1.6122448979591837,126,48,TAATGATACTACGTTGCCTT,78,1069684
fldAp,1.2244897959183674,107,48,GGGGGCTAAGGAATGCGGGA,59,1104486
fldAp,0.5510204081632653,74,48,GCCAGCTCTATAGGTGCAAT,26,1086687
fldAp,0.04081632653061224,49,48,CATTCTCTCGATTGCGCCAC,1,1103882
fldAp,0.4897959183673469,71,48,CAGTAAGGCATTAGGGCTCA,23,1073098
fldAp,0.5102040816326531,72,48,ACACTAGATCCGTTTGCTCT,24,1176928
fldAp,0.5306122448979592,73,48,AATAACACTCTCCGGCATTG,25,1096599
fldAp,0.22916666666666666,57,47,TGCAAGAATGTCAGCTGCCA,10,1088373
fldAp,3.1458333333333335,197,47,TCGTGTATCGTACGCCAATT,150,1066263
fldAp,1.4166666666666667,114,47,TCGAGACTGTGCCCAGCCTG,67,1167555
fldAp,0.4375,67,47,TATGGGCCTAGACGCTTACC,20,1096552
fldAp,1.5208333333333333,119,47,GTAATTCATCACAAATCGAA,72,1097404
fldAp,0.6041666666666666,75,47,CTGTCCGTCTTTTAAGTAGG,28,1092699
fldAp,0.3541666666666667,63,47,CAGTGGTAAAACGTAACGAT,16,1104588
fldAp,0.6666666666666666,78,47,ATTCACGTTACATGGTGAGA,31,1171031
fldAp,1.2083333333333333,104,47,AGCAGGGTCGTACCCCGGTG,57,1118050
fldAp,0.6041666666666666,75,47,ACCGTACGGCCCGATCAGGC,28,1071802
fldAp,1.4375,115,47,ACCCTTCGCTGAACCATACT,68,1063859
fldAp,0.25,58,47,AATACCCGGATTCGACTCGT,11,1106294
fldAp,0.0425531914893617,47,46,TTTTAATCGAGAGGCCTTGT,1,1139230
fldAp,1.2765957446808511,105,46,GTCAGCGTGAGCCGTGGAGA,59,1121602
fldAp,1.148936170212766,99,46,GGTATAGATCACGGTCGTCA,53,1093754
fldAp,0.44680851063829785,66,46,GCCCGAAAACCTGCTCGAGG,20,1070404
fldAp,0.7659574468085106,81,46,GACTGTGAACTTTCGAGCGT,35,1120934
fldAp,0.44680851063829785,66,46,CTTCCGTTCAGGCAGCACAT,20,1142519
fldAp,0.0425531914893617,47,46,CTCAGGGTCGTCGGCGATGG,1,1136318
fldAp,1.3829787234042554,110,46,CTATCTTGTGCAAACAAATA,64,1174141
fldAp,1.6808510638297873,124,46,CGTAGGAGAGTCGGGCAGAG,78,1087923
fldAp,1.6170212765957446,121,46,CGGCAATCTTGCTCCATTAC,75,1064129
fldAp,0.44680851063829785,66,46,ATAGTCTTCACCACAGTGCT,20,1104310
fldAp,4.212765957446808,243,46,AGGCACCCTCCGTAAAAATG,197,1075143
fldAp,0.3617021276595745,62,46,ACTGCTAGAAATGCCAAAGT,16,1120040
fldAp,0.48936170212765956,68,46,AAGGGGAAGAAATTTACATG,22,1171529
fldAp,7.468085106382978,396,46,AACCGGTCGGATCAAAGGTT,350,1064765
fldAp,1.9130434782608696,132,45,TGTTTGGTAAAAAAGCTACC,87,1107974
fldAp,2.5652173913043477,162,45,GGTAGCATGTCTCCTGGCTA,117,1152953
fldAp,2.760869565217391,171,45,GCTGCGGGAAGTGGAAATGG,126,1177385
fldAp,0.45652173913043476,65,45,GCGGTGGTGCCCGCCACGTT,20,1099919
fldAp,0.3695652173913043,61,45,GCCGACCCGACCCCCAGGCG,16,1075233
fldAp,0.782608695652174,80,45,CTACTCAAATGAATTAGAAC,35,1171446
fldAp,0.45652173913043476,65,45,CGACCCCCCGACCCTTCTTC,20,1174142
fldAp,0.8913043478260869,85,45,CCAAAATGAGGACCCACGAT,40,1072043
fldAp,1.1521739130434783,97,45,CACAATAACACTAAACCTAC,52,1099480
fldAp,1.4565217391304348,111,45,ATGTGCTGGTAACTACCGAT,66,1071372
fldAp,0.2826086956521739,57,45,ATCTTACTAGCGCCGGGATG,12,1131507
fldAp,0.5217391304347826,68,45,ATCAGGTCCTAGATTGATAA,23,1180869
fldAp,0.7608695652173914,79,45,AGTTTGAAAGGTCAGGTAGA,34,1146075
fldAp,2.5652173913043477,162,45,AGAGTCGATGTGAACCAGTT,117,1076586
fldAp,0.7608695652173914,79,45,ACATGCTCGTGCCCCCGACA,34,1150393
fldAp,0.043478260869565216,46,45,AACTGTGACCTATCCCCGCA,1,1110036
fldAp,4.739130434782608,262,45,AACAGAGATCGCGGAGGCGG,217,1142595
fldAp,4.155555555555556,230,44,TTGCGTGCAATCCTCATTCA,186,1182501
fldAp,1.1111111111111112,93,44,TGGTCGTCCGTTTTTCCTTC,49,1168995
fldAp,1.1333333333333333,94,44,TGCTATTCAACGCCGGGTCC,50,1095597
fldAp,0.35555555555555557,59,44,TAGCAGCTTCAAGTTTTGCT,15,1106508
fldAp,0.5333333333333333,67,44,GTCTGTATTTCTTAAACTCT,23,1107978
fldAp,2.022222222222222,134,44,GTCGGGTAAGGTGTACACAC,90,1105165
fldAp,1.288888888888889,101,44,CTCCATGCCATTCATACCAA,57,1069772
fldAp,0.044444444444444446,45,44,CTACAGAGGCCTAATCGAGA,1,1084828
fldAp,0.4666666666666667,64,44,CCTTTTTAGTATTTAGAACT,20,1184064
fldAp,3.2444444444444445,189,44,CAACTCCAGTGGCTGGCAGT,145,1084696
fldAp,0.7777777777777778,78,44,ATTGCAGCTAATATGGAAGT,34,1105394
fldAp,0.6222222222222222,71,44,ATTCAACGCGTTGTTGTCAA,27,1175924
fldAp,4.533333333333333,247,44,ATACGGGTGGCATATGAGGT,203,1094989
fldAp,0.044444444444444446,45,44,AATTAAAGGTGCTTGTCCGA,1,1100701
fldAp,0.4888888888888889,65,44,AAGGACGAGTATATCTGATT,21,1124508
fldAp,0.5777777777777777,69,44,AAGATCGTTTCTGGGGTAAA,25,1090030
fldAp,2.111111111111111,138,44,AACCGGCCCTTGGAAGGACA,94,1133354
fldAp,0.045454545454545456,44,43,TGCCGGAAACTATAGTTCAA,1,1122153
fldAp,0.9318181818181818,83,43,TCACAGTTGCCATGTGAGAT,40,1111217
fldAp,0.6363636363636364,70,43,TACCGTGTGCCCTACCGCAT,27,1175264
fldAp,2.1363636363636362,136,43,GTAGGAGGATGGTGTGACTT,93,1082927
fldAp,0.045454545454545456,44,43,GCCTAGATCTAGGTTCGGCA,1,1128344
fldAp,0.5227272727272727,65,43,GCATCGTTTATCAATGTCAG,22,1162312
fldAp,0.11363636363636363,47,43,CTATCCCTTGAATAATATTC,4,1103329
fldAp,0.25,53,43,CGTAGTCGTCGGCGAAAGAA,10,1069569
fldAp,0.7045454545454546,73,43,CGGTAACCCCAAAGTGTCTT,30,1100476
fldAp,1.4318181818181819,105,43,CGCAGCAGGCGGAATTACCT,62,1076600
fldAp,3.6363636363636362,202,43,CCGACCTCCGTTGCACTCTA,159,1086000
fldAp,1.5681818181818181,111,43,CCAGTCTCCGGGACAATGAC,68,1114663
fldAp,1.2272727272727273,96,43,ATTGGTGTCCCAATCAGAAT,53,1138657
fldAp,1.1590909090909092,93,43,AGTCCTTCGTCTAGCGTGTG,50,1183245
fldAp,0.9318181818181818,83,43,AGTCCGAAGTGTTCCACGGA,40,1132317
fldAp,0.7954545454545454,77,43,AGGGCTAACGTTACCGTCGC,34,1176493
fldAp,0.29545454545454547,55,43,AGCGCCCCGACTCTTTGCAT,12,1185825
fldAp,0.045454545454545456,44,43,ACTGAGATACAGGCCTGGCT,1,1162368
fldAp,2.090909090909091,134,43,ACTCTTGATGCTGGTAATCT,91,1075150
fldAp,0.45454545454545453,62,43,ACTACTAAGTGGACCCCTGG,19,1110669
fldAp,0.06818181818181818,45,43,ACGCTATGTGCGCACGACAA,2,1114672
fldAp,1.8636363636363635,124,43,ACCCAAACAGCTCCAGTCAA,81,1070519
fldAp,1.2045454545454546,95,43,AAGGGCGGACTTCAGGTTAG,52,1130834
fldAp,0.45454545454545453,62,43,AAAGCCGTGAGATACCGCTT,19,1082271
fldAp,1.813953488372093,119,42,TTTGTCCACTTGCTTTGGTA,77,1137855
fldAp,0.46511627906976744,61,42,TTTAAAGTATATAGGGACTG,19,1082272
fldAp,0.5348837209302325,64,42,TTGCGCGCTGTTGTGAAATA,22,1125461
fldAp,0.4418604651162791,60,42,TTATATTGAGCAATGGGTTA,18,1121453
fldAp,1.069767441860465,87,42,TGTAAAAGCTAGCCACCCAG,45,1159635
fldAp,0.7674418604651163,74,42,TGATTAGTGCGAGAGAGTTC,32,1121231
fldAp,1.0465116279069768,86,42,TCGACGTCTGGCGGATGTTG,44,1068427
fldAp,0.20930232558139536,50,42,TCCAATTACGTCGGACTGGC,8,1121339
fldAp,0.7674418604651163,74,42,TAGTAATCCTTGGAAGATAT,32,1078925
fldAp,0.3488372093023256,56,42,GTTTATTGTATGTGCTGTAA,14,1133614
fldAp,0.3953488372093023,58,42,GTTGCTCGGTTAGAAGGGGT,16,1108570
fldAp,1.7906976744186047,118,42,GTGCTGAGGCCAGATCCCGG,76,1124417
fldAp,0.627906976744186,68,42,GTCTTCTATACTCCGATGCT,26,1172196
fldAp,0.8604651162790697,78,42,GTACTTGACGAAATCCCGTG,36,1164522
fldAp,9.44186046511628,447,42,GTACTATCATTGTGTGAAAG,405,1088148
fldAp,0.6511627906976745,69,42,GGTTTGTGTGCGTTACTACA,27,1086468
fldAp,0.813953488372093,76,42,GGGTGCCCGTATGCAATCAT,34,1162928
fldAp,0.6511627906976745,69,42,GGAGCGACACAACCGCTGGA,27,1083961
fldAp,0.4883720930232558,62,42,GCAATCATTCATAGTGGTAA,20,1170947
fldAp,3.046511627906977,172,42,CGTACGTCAAAACATCCCTG,130,1125401
fldAp,0.9767441860465116,83,42,CGGCTTCATAGCGCCGTGGG,41,1081119
fldAp,0.7441860465116279,73,42,CGGACGGCTTATCGAGGTAA,31,1176122
fldAp,2.0930232558139537,131,42,CGCTAGGTTGCGTACACCCC,89,1067680
fldAp,0.813953488372093,76,42,CGCCGACGCGCTTTTAAGAA,34,1063151
fldAp,0.8372093023255814,77,42,CCTGGGGTTTCCACGGCTGC,35,1169087
fldAp,0.4883720930232558,62,42,CCCTTATCGTACCTGTGGCT,20,1160521
fldAp,2.953488372093023,168,42,CCCTATTCCCTAAAGAGAAC,126,1186827
fldAp,0.32558139534883723,55,42,ATGTCTACATACTGTCTTCG,13,1112772
fldAp,1.0465116279069768,86,42,ATCACGGCCGTTTTATGGAT,44,1139017
fldAp,0.4186046511627907,59,42,AGTGCGAATGTCCTCTACGA,17,1068367
fldAp,0.5813953488372093,66,42,AGTCCCGAATACTCCGAAGA,24,1159681
fldAp,1.5348837209302326,107,42,AGGTCGTGACCTATTTTTTA,65,1136475
fldAp,1.7209302325581395,115,42,AGAAGAACTCACATCGTGGA,73,1137384
fldAp,0.32558139534883723,55,42,ACTGCGCGGCACATGTCCAG,13,1066557
fldAp,0.5116279069767442,63,42,ACATCTGGACAGCCAATTCT,21,1169597
fldAp,1.4651162790697674,104,42,AATAACGCTTCAACTCCGTG,62,1114500
fldAp,0.23255813953488372,51,42,AACGGACTTAAACGTATCGG,9,1153677
fldAp,1.5348837209302326,107,42,AAATCATACTATGAGAAAAA,65,1070147
fldAp,0.6744186046511628,70,42,AAAGCCCTCTATAGTCTTGT,28,1142138
fldAp,12.833333333333334,579,41,TGCAAATGTCGGTCCCATCG,538,1103957
fldAp,2.119047619047619,129,41,TCTCGCACACTTTCTCACGA,88,1140194
fldAp,0.42857142857142855,58,41,TCGGTCTGGGTACTTACCAT,17,1129183
fldAp,0.047619047619047616,42,41,TATGTGAAGAAGGTTTTAAG,1,1181880
fldAp,1.119047619047619,87,41,TAATCCTTCGGTCACCTTAC,46,1106513
fldAp,0.5238095238095238,62,41,TAAAGTCACAGCGTAAATAT,21,1084034
fldAp,0.19047619047619047,48,41,TAAAAACATCGACTTGGGGG,7,1141646
fldAp,0.5714285714285714,64,41,GGGCAGTACTGCAATTCAAT,23,1123630
fldAp,0.047619047619047616,42,41,GGACCGACATGCGACGTCTT,1,1114658
fldAp,1.0476190476190477,84,41,GCCTCAATACGTCTAGACAG,43,1088866
fldAp,0.7857142857142857,73,41,GAGTGCATCTTCCGCCGAGC,32,1090575
fldAp,0.9761904761904762,81,41,GAATATTAACGGGACCAAAT,40,1167067
fldAp,0.47619047619047616,60,41,CTAAATGGCAATATTTGAGA,19,1132396
fldAp,1.2142857142857142,91,41,CGCGTCGCCCTTCGGCGCCT,50,1173380
fldAp,0.6428571428571429,67,41,CGCACCGAGTAATAGGCAAA,26,1092551
fldAp,0.047619047619047616,42,41,CATTAGCTCGAAGCAAATGA,1,1087478
fldAp,1.4047619047619047,99,41,CATATCCGCTAAAGTTCGAT,58,1162788
fldAp,3.0952380952380953,170,41,ATTGGACAGAGCAGAGGTAG,129,1085545
fldAp,0.6666666666666666,68,41,ATCTTTCTGAAGTAATTACC,27,1181427
fldAp,2.2857142857142856,136,41,AGTGACTATTACATAAGCGT,95,1125403
fldAp,0.8571428571428571,76,41,AGTATGGTGCTAAGCAAGCA,35,1123479
fldAp,0.5476190476190477,63,41,AGCGGGACTAGGTCCGAGTT,22,1065333
fldAp,0.047619047619047616,42,41,ACGTGATTGTCGGACATCGT,1,1166285
fldAp,0.9761904761904762,81,41,AATTTTACAATCGCTGTGTA,40,1089933
fldAp,1.0476190476190477,84,41,AATTACTCGGACCCTTAAGG,43,1125348
fldAp,0.5714285714285714,64,41,AATGACGGGGAGCTGAGTGA,23,1137030
fldAp,0.047619047619047616,42,41,AAAGCTCTAGGCGTGCGTCG,1,1088484
fldAp,1.619047619047619,108,41,AAAACGAACCGTGGCGCGTT,67,1105094
fldAp,2.1707317073170733,128,40,TTTAGGTGAGACATAAAGGT,88,1156364
fldAp,0.8048780487804879,72,40,TTCAGCAACATGGGTGAGGG,32,1179238
fldAp,1.4634146341463414,99,40,TGGTCTGGAGCAGGGGACGC,59,1168042
fldAp,0.36585365853658536,54,40,TCTAGTCGTTTTCTAACGAG,14,1073717
fldAp,0.5609756097560976,62,40,TCCTCATCCACGCAATAGTC,22,1158095
fldAp,0.24390243902439024,49,40,GTTGTGAGTCGCCGCACTCT,9,1176983
fldAp,1.1951219512195121,88,40,GTATACAGGACTGTGTTTCG,48,1099248
fldAp,1.4878048780487805,100,40,GGAGCCAGGGTGAACCCTTA,60,1117003
fldAp,1.2439024390243902,90,40,GCCAAACCCCGTATAATCAG,50,1097279
fldAp,1.3658536585365855,95,40,GAAACCACCGGAGATCCTCG,55,1087235
fldAp,1.4390243902439024,98,40,GAAAAGCCATCGATAATGGG,58,1122778
fldAp,0.8048780487804879,72,40,CCGGCCAAGACCTAACAGAA,32,1092091
fldAp,0.43902439024390244,57,40,CATTCGAAAACTTCTGTCCT,17,1157714
fldAp,0.8292682926829268,73,40,CATGGATGTTGGCTAGACGT,33,1098578
fldAp,0.34146341463414637,53,40,CAGCAGGGGAGGCGGTTAAC,13,1169599
fldAp,1.0,80,40,ATTAATTGCAGCAATTAGCA,40,1068843
fldAp,0.5365853658536586,61,40,ATAGGTGAGGCACTTACATT,21,1134820
fldAp,1.1219512195121952,85,40,ACGAGCATCTTGGACGAGGA,45,1082036
fldAp,0.04878048780487805,41,40,AAATACCTTCAGCAATTTGA,1,1143436
fldAp,0.675,65,39,TTTAATAACCCTCAACTAAT,26,1129043
fldAp,2.1,122,39,TTGCTTACGTGAGTTGAGTT,83,1168135
fldAp,0.05,40,39,TTATAATTGAACTCTAACGT,1,1112681
fldAp,2.0,118,39,TGTGGCAAGGTGACGGGATA,79,1067471
fldAp,1.375,93,39,TGGCTAAGGTTGGGCTGCAT,54,1177369
fldAp,1.75,108,39,TCCGGTGCCACGAGTAGATG,69,1162825
fldAp,0.05,40,39,TAGAGCCGCCGCAGGATCGA,1,1137190
fldAp,0.05,40,39,GCCAATCCTAAGGGTTGCTC,1,1065329
fldAp,0.25,48,39,GATACGCGCGCCTGGACCTG,9,1086142
fldAp,1.5,98,39,GAGTTAAACTGTCCTGCCAC,59,1074931
fldAp,1.35,92,39,GACCTAATAGTAACCCTCAT,53,1080260
fldAp,1.625,103,39,CTTTGGGTGATCCTTAATGC,64,1116273
fldAp,2.9,154,39,CTTACTCATTACCCTGCGCA,115,1141053
fldAp,0.4,54,39,CTCCAGCATGTTTCGATGCT,15,1125475
fldAp,0.575,61,39,CTAGCCTGCCGTACTTTCGA,22,1076991
fldAp,4.425,215,39,CGCGCTGATTTATCATGTTT,176,1094304
fldAp,1.075,81,39,CGCAACTGTGGCTGGTTTGG,42,1133677
fldAp,0.15,44,39,CATAAAGCTGAGACCAGTTT,5,1111472
fldAp,0.625,63,39,CACTACTGAGGCGATGATGA,24,1071649
fldAp,0.525,59,39,CACGAATGATGTTACCTTCT,20,1115101
fldAp,0.9,74,39,CAATCGCCGTGTCCCAGGGC,35,1143200
fldAp,1.0,78,39,ATGAAGCAGTACGGGAACAT,39,1080850
fldAp,0.525,59,39,ATATATCGTATGCAGACCCA,20,1159783
fldAp,1.25,88,39,AGGGCCGAGAAGTTTCACCG,49,1166918
fldAp,0.45,56,39,AGCGACTCCACAGGAGCTTG,17,1175235
fldAp,0.85,72,39,AGATCTCACGGCATGGTGCT,33,1103509
fldAp,0.975,77,39,ACGGGCGATCTGGTTGTGTG,38,1095043
fldAp,1.6,102,39,ACCCTTCAATTGTGAATTTT,63,1118051
fldAp,2.1,122,39,ACAATTAAAATCTTGCTTGA,83,1110374
fldAp,1.025,79,39,ACAAACAAGACGGATAAGTA,40,1073248
fldAp,0.55,60,39,AATAATGTTAGGGTCTCCCA,21,1103162
fldAp,0.8974358974358975,72,38,TTTTATCTTTCTCAGCGGAC,34,1079455
fldAp,3.128205128205128,159,38,TTCCTAGAAGCTACGAGCCA,121,1167693
fldAp,0.7948717948717948,68,38,TTACTTCTTGCGAGCGGAGG,30,1164862
fldAp,0.07692307692307693,40,38,TGGGCGCGCAATTGCAGGAA,2,1123870
fldAp,1.8717948717948718,110,38,TGGCGAATCACCTAGAATAA,72,1118886
fldAp,1.0769230769230769,79,38,TGCGTGCCAAACCATACTAA,41,1168674
fldAp,0.9743589743589743,75,38,TGATAGGAGTCGTCTTAGAC,37,1103921
fldAp,0.5897435897435898,60,38,TGACCTAGGGATGACACTCT,22,1111845
fldAp,0.717948717948718,65,38,TCTACGTAGCTGCCAAAGTT,27,1133543
fldAp,3.3076923076923075,166,38,TCGGGATCCGGCAGAAAGGG,128,1102399
fldAp,1.9743589743589745,114,38,TCCTGATCTCATGACTTCCG,76,1086138
fldAp,2.076923076923077,118,38,TATCGCACTCGGCCAACCAC,80,1116621
fldAp,0.05128205128205128,39,38,TAGGGTCGGTCACGCGGAAA,1,1079378
fldAp,5.205128205128205,240,38,TACATCATCAGCTTGGTGCA,202,1073336
fldAp,0.38461538461538464,52,38,GTGAAGCTGTCCCTCCATGG,14,1127563
fldAp,0.8461538461538461,70,38,GTCCAGCTGCATTCCGCAAG,32,1121951
fldAp,0.05128205128205128,39,38,GGTTTGTGGAGATTTTAGCT,1,1173852
fldAp,3.3846153846153846,169,38,GGCCACAGACTTCTTCGCCC,131,1129730
fldAp,0.2564102564102564,47,38,GCGCGCTGGTTAAACGATCA,9,1143511
fldAp,0.7692307692307693,67,38,GCCAGCCCGTGGAATGGCTA,29,1113774
fldAp,0.7435897435897436,66,38,GAGGACGCTTACCCCCGAGT,28,1114515
fldAp,0.4358974358974359,54,38,GAGAGCAGGGGACATTGGGT,16,1104183
fldAp,1.0,76,38,GAATTCAGATGAGCCGCACG,38,1080625
fldAp,0.5641025641025641,59,38,GAACGTATACAGGGGCTTCA,21,1136094
fldAp,0.8717948717948718,71,38,CTCTATAATGACGGGAGCCA,33,1143858
fldAp,0.717948717948718,65,38,CTCGCTTTAATGGGCGGGAT,27,1165853
fldAp,3.2051282051282053,162,38,CTCCCGACACAATCTGGCAT,124,1149827
fldAp,1.3846153846153846,91,38,CTCACGTGCGCCCGAATGGT,53,1107788
fldAp,0.3076923076923077,49,38,CCGAATATTGCTAGTCGTCA,11,1179224
fldAp,0.05128205128205128,39,38,CATGACAGAGCTAGCGAAAG,1,1111740
fldAp,6.435897435897436,288,38,CATCTAATAGATAGTGTGTA,250,1133942
fldAp,1.205128205128205,84,38,CACGTCCAGGACAGATGAAT,46,1168825
fldAp,1.0512820512820513,78,38,ATGTGTGTGTACCATGGCGC,40,1075977
fldAp,2.641025641025641,140,38,ATAGAGCGGAGCGTCTCTAT,102,1132394
fldAp,0.05128205128205128,39,38,ATACCTTGTTGGCAGTCATT,1,1091426
fldAp,0.717948717948718,65,38,AGTCTTTCATTCTGAACCCA,27,1095227
fldAp,8.846153846153847,382,38,AGTCGTGATTAGGCTGTTTC,344,1094772
fldAp,0.23076923076923078,46,38,AGCGGCTCTCTTGGACATAT,8,1146728
fldAp,4.256410256410256,203,38,AGCAGGGGCTCCTCAAGTCT,165,1110144
fldAp,0.5384615384615384,58,38,ACTCGTTGCTATCATGGACC,20,1160777
fldAp,0.6923076923076923,64,38,ACCCCACTGTTTAGCTCTTA,26,1116688
fldAp,2.6153846153846154,139,38,ACATAGTTATTATCACGGTT,101,1178428
fldAp,0.7948717948717948,68,38,AACCGGGGTCTTTGTAAACC,30,1128863
fldAp,0.5641025641025641,59,38,AAATTATTCGTAACTGATAT,21,1065868
fldAp,0.5384615384615384,58,38,AAAGGCAATTCGCCCAATTG,20,1069818
fldAp,0.7894736842105263,66,37,TTGACCCTGTTACGTATAAG,29,1169972
fldAp,0.05263157894736842,38,37,TGTGGTAATGATGGATCCGG,1,1094167
fldAp,1.8157894736842106,105,37,TGGTTTATGTACAGAGGCAT,68,1176506
fldAp,1.0263157894736843,75,37,TGGGTTTGCCTTCACAGATG,38,1133340
fldAp,2.5789473684210527,134,37,TGGCTCACCACTCCTCCCGA,97,1167041
fldAp,1.3157894736842106,86,37,TGCGGTTAAGGGCTCCAGTT,49,1138833
fldAp,1.6578947368421053,99,37,TGAACTCTCTTTAGTCGTAG,62,1069989
fldAp,1.368421052631579,88,37,TCAAGGTTCTCGAAAAGGCA,51,1107947
fldAp,0.42105263157894735,52,37,TCAAGCAAGCGAGGCAGCTT,15,1149872
fldAp,3.5526315789473686,171,37,TATAATACATACTTTTGTTA,134,1140670
fldAp,1.0263157894736843,75,37,TACTTTCAATCAATAGTTGG,38,1078207
fldAp,1.736842105263158,102,37,GTAGACTGTTAACCGCCGTA,65,1075178
fldAp,0.3684210526315789,50,37,GGACCTTCCCGATGTCGGCA,13,1074763
fldAp,3.526315789473684,170,37,GAGGTAACAAGGTATAGAGG,133,1177353
fldAp,0.5789473684210527,58,37,GACCCAGGGTTACATCATTT,21,1114377
fldAp,0.10526315789473684,40,37,GAAGTGGTCGGGCGTCTCCA,3,1165659
fldAp,0.39473684210526316,51,37,CTTGAACAGCGGGCTAGATA,14,1128719
fldAp,0.05263157894736842,38,37,CTGTCGCAATTCAACGTCAT,1,1136855
fldAp,1.2105263157894737,82,37,CGCACTAGGATCTGATCGGG,45,1157318
fldAp,0.05263157894736842,38,37,CGAGGATTTTTTCACGGTCC,1,1064591
fldAp,1.0,74,37,CCTGTAGCATTTCCTTTGGC,37,1072894
fldAp,0.8157894736842105,67,37,CCTATGCTAAGCTACCAGGG,30,1129846
fldAp,1.0789473684210527,77,37,CCGCTGGAACGCATGGCCTA,40,1072822
fldAp,1.4736842105263157,92,37,CCGAGTGTGGCTCCGTCGGT,55,1117008
fldAp,0.6842105263157895,62,37,CCCGTGGATCGGCCCCGAGA,25,1161681
fldAp,2.9210526315789473,147,37,CCACATGCTTGTCAGTTCAC,110,1134946
fldAp,1.0263157894736843,75,37,CAGATGATGTTTCAACTGAT,38,1088876
fldAp,0.5526315789473685,57,37,CAATCGGGTTATCTGTATCA,20,1165462
fldAp,0.21052631578947367,44,37,CAAGACAGTTGTTCCACACT,7,1121529
fldAp,0.631578947368421,60,37,ATCTCGACCTGTCCGCTGAT,23,1107004
fldAp,0.42105263157894735,52,37,ATCCGGCCCTTAGGGGCAGC,15,1079697
fldAp,0.5526315789473685,57,37,ATACCGGGACTTAACAGCTA,20,1169408
fldAp,0.10526315789473684,40,37,ATAAGAGGCTGGCTAAACCT,3,1099558
fldAp,2.6052631578947367,135,37,AGTGAAATCGTACGTATCAG,98,1080153
fldAp,0.05263157894736842,38,37,AGTCACGAGGTCTGTACTGT,1,1079698
fldAp,0.3157894736842105,48,37,AATGACTCTTACAGTGTGTA,11,1136273
fldAp,2.3684210526315788,126,37,AAAACGACGGCCTAACTAAA,89,1174395
fldAp,1.7297297297297298,99,36,TGTGGTATCACTTGAGATAA,63,1178089
fldAp,1.6486486486486487,96,36,TGGTCATGATGGGTGCTAGG,60,1066094
fldAp,0.8108108108108109,65,36,TGGGATGTGCTGGCACTGCA,29,1106287
fldAp,5.891891891891892,253,36,TAAATGATAATTGGTTGTCT,217,1152947
fldAp,1.162162162162162,78,36,GGCGGATCATTAACAAGGTA,42,1152944
fldAp,1.5135135135135136,91,36,GGCACTGGTAAGAAGCATCG,55,1184992
fldAp,0.3783783783783784,49,36,GCTTCAGTACTCGGCCCGGA,13,1089560
fldAp,1.3243243243243243,84,36,GCAAATTAAGTTCGTCACAC,48,1172730
fldAp,0.08108108108108109,38,36,GAGATAACAGCGGGAGACAA,2,1078253
fldAp,0.4864864864864865,53,36,CTTTACAGACATATCGGAAT,17,1149633
fldAp,0.43243243243243246,51,36,CTGCCCTGGATATCGAATTT,15,1064472
fldAp,0.7567567567567568,63,36,CTGACGATGCTGACACCAAT,27,1141078
fldAp,0.5135135135135135,54,36,CTACGTGCAACTTGGTGACA,18,1112475
fldAp,1.7837837837837838,101,36,CGGTATACTAATCGTGAATT,65,1069411
fldAp,1.4594594594594594,89,36,CGCGTCTATCAGCTAATTGA,53,1065068
fldAp,3.2432432432432434,155,36,CCTTCCGAAGGAAACATTGT,119,1108527
fldAp,3.7027027027027026,172,36,CCTTATGCGAGCATATAAAA,136,1157931
fldAp,0.8918918918918919,68,36,CATGGGCGACTCTACAACGT,32,1146910
fldAp,0.05405405405405406,37,36,CATACTTCCGGATCGGAATA,1,1123006
fldAp,0.8378378378378378,66,36,CAGGGGGCGCGGTATCAGGC,30,1126615
fldAp,1.3243243243243243,84,36,CAGGCCTCATGGGAAATCTA,48,1134578
fldAp,0.972972972972973,71,36,CACCAATCCATCAACCATCA,35,1143304
fldAp,0.05405405405405406,37,36,AGCTCCGGACTTAAGTTGGG,1,1085589
fldAp,2.4324324324324325,125,36,ACGCAAAATCCTAGTAAGCT,89,1083887
fldAp,1.135135135135135,77,36,AAGTTCCCTTGCTAGATCCC,41,1175242
fldAp,0.8378378378378378,66,36,AAAGGCGGGCTGTACTTGTT,30,1117742
fldAp,0.7222222222222222,60,35,TTTGGACGGCCCACTCATGT,25,1167857
fldAp,0.6388888888888888,57,35,TTGCTACCCGTGAGATCGCA,22,1110682
fldAp,1.6388888888888888,93,35,TTATCACCAGAGTCAACGGG,58,1069361
fldAp,0.16666666666666666,40,35,TTACTATGGATAAATGGTAT,5,1132625
fldAp,1.3888888888888888,84,35,TCCGTAATGTAGCGCGGTAT,49,1070942
fldAp,0.3333333333333333,46,35,TCCCCGGCCGCGGCAGGTCC,11,1129451
fldAp,0.75,61,35,TCAGACAAGGTGAGCACCTG,26,1180929
fldAp,0.6388888888888888,57,35,TAAGGTAAGGGAAGCGACCC,22,1107540
fldAp,1.1111111111111112,74,35,TAACGCCTCAGTTTGCAAAA,39,1104783
fldAp,1.1944444444444444,77,35,GTTAGGTGCAATCAGCACGA,42,1161675
fldAp,0.8333333333333334,64,35,GGTGATCGATGATGGCCAAG,29,1104056
fldAp,1.3611111111111112,83,35,GGCTTCGGACGGCCGGGGTA,48,1151103
fldAp,0.05555555555555555,36,35,GGCGCGTGAATATCGTAGGT,1,1157123
fldAp,0.5833333333333334,55,35,GAGGACCACTGATCCTTCCA,20,1091549
fldAp,0.5,52,35,CTCTACAGAGCCTTTAACCG,17,1091112
fldAp,0.05555555555555555,36,35,CTATCAAGGGGCTTGGGTAA,1,1156363
fldAp,0.3333333333333333,46,35,CGAGGGGGAAACGCGGTCTT,11,1132870
fldAp,1.25,79,35,CGAACTTGACCTCAGGTTAG,44,1180052
fldAp,0.8055555555555556,63,35,CCGCCCTTGAGTATTGGGGG,28,1118499
fldAp,0.75,61,35,CCCGCTTGAGCCCGTTCAAT,26,1118227
fldAp,0.6388888888888888,57,35,CACTTTCTAACGGGTGCAAT,22,1133054
fldAp,1.0277777777777777,71,35,CACGTGCACTATAAGACGTA,36,1178742
fldAp,1.0555555555555556,72,35,CACATGGATCGGTAGGTATA,37,1079534
fldAp,0.5277777777777778,53,35,CACAAGGTGGAAGTTGGGTT,18,1168166
fldAp,5.666666666666667,238,35,ATTGTGCGATTATAATGGGG,203,1117961
fldAp,0.9166666666666666,67,35,ATTGAGTATGCATTGGCGAG,32,1121954
fldAp,1.0833333333333333,73,35,ATGTACGACGGTCGGTCCAG,38,1082219
fldAp,0.5,52,35,AGGTGCGGCACTACCTCTAG,17,1087241
fldAp,16.583333333333332,631,35,ACGGAGTGTGCTCAGGGGCG,596,1114242
fldAp,3.388888888888889,156,35,AATCGGCAAGTGACGGCCAG,121,1072567
fldAp,2.888888888888889,138,35,AAGCGTATTGTCAAGATAGT,103,1157783
fldAp,2.9722222222222223,141,35,AACACTTCATCTCTGTACCC,106,1110585
fldAp,0.6111111111111112,56,35,AAAAGCATGATCCCCACGCA,21,1075731
fldAp,2.8285714285714287,132,34,TTTTCCGTCGAGACTAGACT,98,1164446
fldAp,1.6285714285714286,90,34,TTACACACGGTGCACTTTGT,56,1181673
fldAp,1.3714285714285714,81,34,TGCCCAATAGACGGTAATCC,47,1104475
fldAp,1.2571428571428571,77,34,TGCAACTTGCACGCCTTCTT,43,1103344
fldAp,0.34285714285714286,45,34,TGAACGGCGGTAGTTCATTG,11,1087159
fldAp,0.8571428571428571,63,34,TCTGCGAAGTACCTAGCTTG,29,1133485
fldAp,2.257142857142857,112,34,TCTGAATGATTACGCAACAA,78,1142123
fldAp,0.9428571428571428,66,34,TCCAAAGGGCCGATCCGGCA,32,1069683
fldAp,0.8,61,34,TATAGGGCGGAGCTCTAATA,27,1086108
fldAp,0.6285714285714286,55,34,TACGCAACATGTCGGAGGAG,21,1091169
fldAp,3.4285714285714284,153,34,TAAATGTACGAACAGCTCCT,119,1122722
fldAp,0.7142857142857143,58,34,GTGTTGTGCACTCTCCATGT,24,1096392
fldAp,0.6571428571428571,56,34,GGTCATTGCGTAGCTTTAAT,22,1069022
fldAp,1.2857142857142858,78,34,GGGTGGATACACCTTGGGCA,44,1096194
fldAp,2.0285714285714285,104,34,GGGTGATTCGATACAGGGCG,70,1077106
fldAp,1.9714285714285715,102,34,GGAGCGGGGCTGCGATTCTA,68,1108739
fldAp,0.8857142857142857,64,34,GCTTCGGTCTGTTAGACCAT,30,1174165
fldAp,1.0571428571428572,70,34,GCTCCGGAACGCCGTCTGAA,36,1101843
fldAp,0.4,47,34,GCTAGTCGGGAGACCGAGTG,13,1141242
fldAp,0.45714285714285713,49,34,GAGCACTGCGGTGGGCACAA,15,1099561
fldAp,2.9714285714285715,137,34,GACCTCAATTTAATTGGTAG,103,1113170
fldAp,0.7428571428571429,59,34,CTGCCAAGTACAGGTACTAG,25,1088485
fldAp,0.2857142857142857,43,34,CTGAGCTTAGAATCCAATCA,9,1069787
fldAp,1.0857142857142856,71,34,CTACATCACCTCGTCGTGGC,37,1119857
fldAp,0.6285714285714286,55,34,CGTTGGGGTCCGAGACGACA,21,1075435
fldAp,0.05714285714285714,35,34,CGCTCCAATAGCCTCTTAAG,1,1116096
fldAp,0.05714285714285714,35,34,CGATGCGGCGACTGGACATG,1,1157105
fldAp,0.7428571428571429,59,34,CCGGGGATGGTAAGGGAGAT,25,1064684
fldAp,6.457142857142857,259,34,CCCGCTTTGCGGGCATAACT,225,1178637
fldAp,1.4285714285714286,83,34,CCACATACGACTCAGCTCCA,49,1156129
fldAp,0.8285714285714286,62,34,CATAATCAAGCATTAAGCCC,28,1152753
fldAp,0.4857142857142857,50,34,CATAAGATTTGACGTTCAGA,16,1116968
fldAp,0.4,47,34,CACTGAACCCGGGGGTCAAT,13,1081553
fldAp,1.1428571428571428,73,34,CACGCACCGAGATGGCCAAA,39,1159925
fldAp,3.5714285714285716,158,34,ATTGCTGGCTGAGTTTCCAC,124,1121718
fldAp,0.8285714285714286,62,34,AGGGGTGTCAGCTCCTGCAG,28,1071729
fldAp,0.8,61,34,ACGCGCTGGATCGTCTAGAC,27,1067965
fldAp,0.4,47,34,AATGGCTGTTAAGAAGTGCA,13,1164529
fldAp,2.914285714285714,135,34,AATGCTCTAGAAGAAGAGCT,101,1126618
fldAp,1.9714285714285715,102,34,AATCGCCGCGTTGTACATCA,68,1097893
fldAp,0.7428571428571429,59,34,AATCCTAGTATTGGGACTAA,25,1141225
fldAp,0.8285714285714286,62,34,AAGCAAGAAGCCTGCTTCCC,28,1128598
fldAp,1.6,89,34,AACCTAGATTTTCCTGGACA,55,1081548
fldAp,0.8571428571428571,63,34,AAATCAAAGGTAGCGCTCCA,29,1096319
fldAp,0.05714285714285714,35,34,AAAGCTCAGCATGCCGGACA,1,1125558
fldAp,0.7142857142857143,58,34,AAACCCGCCCACCGTTCCGG,24,1171331
fldAp,2.7941176470588234,127,33,TTTACAAATGGTCAGATATA,94,1119390
fldAp,0.7941176470588235,59,33,TTGACGCATACGTTGGGTTT,26,1128610
fldAp,1.0294117647058822,67,33,TTCCGCTTTAGACAGTCTTT,34,1098296
fldAp,4.117647058823529,172,33,TTAGGATCTCAAATAACGGT,139,1075231
fldAp,0.6470588235294118,54,33,TGCATCTCTCTACGAGCAAC,21,1111471
fldAp,0.3235294117647059,43,33,TGCAATGGACAATAGAGATT,10,1065231
fldAp,0.7941176470588235,59,33,TCTACCCTGGTAATCATATG,26,1174799
fldAp,0.058823529411764705,34,33,TCCGCGCGGGGCGTTGGAAC,1,1110487
fldAp,3.3529411764705883,146,33,TCCGAGCAGACCGTGAGACA,113,1134503
fldAp,0.08823529411764706,35,33,TCATTCTCAAATAACACAGA,2,1078398
fldAp,3.1470588235294117,139,33,TAAATCGGCTTAGCTAGTAA,106,1142001
fldAp,1.0294117647058822,67,33,GTTGCTATCAATGATGACAT,34,1081661
fldAp,0.058823529411764705,34,33,GGAAGGCGTCGATTCCTTAC,1,1164980
fldAp,1.0588235294117647,68,33,GCTGTAGATTTAATCACTGG,35,1085410
fldAp,0.8235294117647058,60,33,GCCAATAGCTTCGGGTAGTC,27,1142537
fldAp,0.5882352941176471,52,33,GCAGCTGGGCTAGAAGGAGG,19,1109660
fldAp,0.058823529411764705,34,33,GCAAGCAAGTTAGTGCCGTA,1,1144489
fldAp,1.2058823529411764,73,33,CTTCGCTGACCTGACCGGAG,40,1139146
fldAp,1.0,66,33,CTTAGGAGGGCGCGCCAGGA,33,1138046
fldAp,0.7352941176470589,57,33,CTGTTCCCTGCAATCCTTTG,24,1165865
fldAp,1.6470588235294117,88,33,CGGCCTGTTGGCAACGGATA,55,1063241
fldAp,3.0294117647058822,135,33,CGAAGCCCGGCGAGGGCATT,102,1082702
fldAp,1.0,66,33,CCGCTTATGTAGAGCTTTAT,33,1080157
fldAp,0.9705882352941176,65,33,CCATCAAGTTATTAACTCAA,32,1172687
fldAp,0.9411764705882353,64,33,CATATAACCGACCTGCGCTT,31,1067709
fldAp,1.911764705882353,97,33,CATACCTGCAGAATACGCAG,64,1182992
fldAp,0.058823529411764705,34,33,CACTTTATAAGCTAGCCCCT,1,1135925
fldAp,0.5882352941176471,52,33,CACGCTTGGGGTTTCTCCCG,19,1172550
fldAp,1.1764705882352942,72,33,CACCTAGCCAATGATGAAAT,39,1106370
fldAp,3.8529411764705883,163,33,CACCCAAGTTGGTGCTTTCA,130,1116628
fldAp,0.4411764705882353,47,33,CAACCCTGTTTTCTTTCGCA,14,1175393
fldAp,0.058823529411764705,34,33,ATTAGTTGTGTGTGGGACGG,1,1107186
fldAp,1.088235294117647,69,33,AGTTAAATCGTACGGGGCAT,36,1182465
fldAp,1.088235294117647,69,33,AGCGATGGCTAAGCACCAAC,36,1071233
fldAp,1.5294117647058822,84,33,AGATGGTGGCGTTGAGGTCT,51,1067704
fldAp,0.6470588235294118,54,33,ACTCGTCTCGTGAACATTTC,21,1168142
fldAp,1.2647058823529411,75,33,ACGGGGGTCACTCCGATAAT,42,1163770
fldAp,3.735294117647059,159,33,AAGGGGTAGTCTGACGATCT,126,1155366
fldAp,0.8529411764705882,61,33,AACAACATATACCGGGCAGT,28,1101531
fldAp,1.1818181818181819,70,32,TTTGGACGCACATGAGGGGT,38,1098503
fldAp,1.2121212121212122,71,32,TTTAGGTATGGAAGAACGTG,39,1168225
fldAp,0.9393939393939394,62,32,TGTTACCCAAGGAGGTACGG,30,1142508
fldAp,3.5454545454545454,148,32,TGGTTCCTGACATCGTTGTT,116,1072552
fldAp,2.1515151515151514,102,32,TCGTGGCCGTTACACGTCCA,70,1168934
fldAp,0.5454545454545454,49,32,TCCAACCATCCTGGTGCTGT,17,1108418
fldAp,0.7575757575757576,56,32,TATTAAACGCACAAAGCCTG,24,1075870
fldAp,6.090909090909091,232,32,TAGCCGTTCGATGATTCAAC,200,1077534
fldAp,1.6363636363636365,85,32,GTGTTGCCAGCTCTGACATC,53,1065994
fldAp,0.06060606060606061,33,32,GTCTCCCTGTGCCGAAAACT,1,1144539
fldAp,2.272727272727273,106,32,GTCTAGTGTCACTGAAATAT,74,1117004
fldAp,0.7878787878787878,57,32,GTCGTCTTGCACACCGCGGC,25,1114302
fldAp,0.42424242424242425,45,32,GTCGAGCCCGGCCCGCATCA,13,1173760
fldAp,0.06060606060606061,33,32,GTCCTGACGTAGCGGATATC,1,1089200
fldAp,0.9393939393939394,62,32,GTAGGTCAAGAAGTCGTCGT,30,1141523
fldAp,0.45454545454545453,46,32,GGTATAGTGTCTGTGTGGCT,14,1097233
fldAp,0.30303030303030304,41,32,GGTACATCTTTATCGGTGTA,9,1148695
fldAp,0.42424242424242425,45,32,GGGTATCCGACACCCATATC,13,1132663
fldAp,0.6363636363636364,52,32,GGATGCCCATGTTTGTTTGC,20,1106192
fldAp,15.0,526,32,GCCGAGCGGGCCTGTATCAC,494,1064762
fldAp,0.06060606060606061,33,32,GATCTGATGCCCCGTATAAG,1,1079630
fldAp,1.2121212121212122,71,32,GATCTGATATGTCATAGACG,39,1112365
fldAp,0.5454545454545454,49,32,GAGCGAACCAACAGGGAGTA,17,1146643
fldAp,0.09090909090909091,34,32,GAACGGCGCCGCCGGCTCAA,2,1077868
fldAp,0.06060606060606061,33,32,CTGATGGGGGGTATGTTTCG,1,1176608
fldAp,0.45454545454545453,46,32,CTCGACAACGGGCGTCATGG,14,1143910
fldAp,2.3636363636363638,109,32,CTAGTCTTACAGTGCCGTTC,77,1133410
fldAp,0.06060606060606061,33,32,CTAAAAACAATGAAACTTGG,1,1091417
fldAp,1.696969696969697,87,32,CGTAAGCCTAATTGGGGCGG,55,1099714
fldAp,0.36363636363636365,43,32,CGGAGAGGCATAGTCCATCA,11,1162562
fldAp,1.0,64,32,CGGACGTCCTCCGGTGCAAA,32,1126775
fldAp,0.6666666666666666,53,32,CGCTGTCGGCCGTCACAATA,21,1110820
fldAp,0.06060606060606061,33,32,CCTCGATCTTCGTGATGGCT,1,1185259
fldAp,2.090909090909091,100,32,CCTATGTTTTCACAAGGTTT,68,1066920
fldAp,2.5757575757575757,116,32,CCGGGATCCGTTCTTAGGAA,84,1146612
fldAp,0.36363636363636365,43,32,CCCTATGTTCACTGCGTAGA,11,1075332
fldAp,2.0,97,32,CCCGCATCTTGCACTTTGAC,65,1072806
fldAp,1.4545454545454546,79,32,CCCCTCACGCTATGAATTCT,47,1142876
fldAp,0.06060606060606061,33,32,CAGGCGTGACGTTGATTCTA,1,1137290
fldAp,1.0,64,32,CAGCTCGTCCGGACCTACAA,32,1066365
fldAp,1.7272727272727273,88,32,CAGACATGCGTATCCCGCCA,56,1097069
fldAp,0.5151515151515151,48,32,CACTGTAGGTTTAAGCTAGG,16,1174734
fldAp,0.48484848484848486,47,32,ATTTCGAGTAGAGGGTCCAA,15,1101555
fldAp,1.6363636363636365,85,32,ATTGCCGACAAACCTAAACA,53,1152375
fldAp,1.1818181818181819,70,32,ATGTTGTTAATTAGGATCCT,38,1142252
fldAp,1.3333333333333333,75,32,ATCCGCCGGAACTTTCGAAT,43,1075766
fldAp,2.515151515151515,114,32,ATAGCCAGGTCGCATCGGGT,82,1115017
fldAp,0.06060606060606061,33,32,ATAGAAGCCTGGGCTTTAGG,1,1179599
fldAp,2.727272727272727,121,32,ATACGCTTATGGTTCGGCCA,89,1098067
fldAp,1.4545454545454546,79,32,ATACAGAGGCATTAGATTAT,47,1166619
fldAp,2.484848484848485,113,32,AGCAATTTGTAAATCGTGGA,81,1070218
fldAp,1.2424242424242424,72,32,AGAGCACGTGATCGTGCATT,40,1100321
fldAp,0.6363636363636364,52,32,ACGGGGGTCTCTAGTCAGCA,20,1102962
fldAp,1.4242424242424243,78,32,ACATCACTTCTCTGCCGCTA,46,1161918
fldAp,1.1515151515151516,69,32,ACAGTGGGTGGTTTTGAGTC,37,1160959
fldAp,0.30303030303030304,41,32,ACAGGCCCACGGCCAGATCT,9,1105647
fldAp,0.8484848484848485,59,32,AAGGCGGGTATATAATCGTA,27,1153900
fldAp,5.242424242424242,204,32,AACTAGGCGTCCAATGCCAA,172,1179701
fldAp,0.84375,57,31,TTGTTTTATCTTTAGGTGAT,26,1096899
fldAp,0.0625,32,31,TTCACGACAGCCTTGACGCA,1,1152229
fldAp,2.53125,111,31,TGGTTAAGCGAACCAGCTAC,80,1124599
fldAp,0.59375,49,31,TGGACCCAACTTATAACCAT,18,1102396
fldAp,0.75,54,31,TGCTCATGCATGAAGTACAA,23,1185821
fldAp,1.28125,71,31,TATTGCCTCTGAGAAAGCAG,40,1139338
fldAp,1.875,90,31,TATGAGTGCTTAATCCACGA,59,1113197
fldAp,0.59375,49,31,TATCACGATTCATATTTAGT,18,1133180
fldAp,2.65625,115,31,TATATGCCTGTGAGGTGGAT,84,1124655
fldAp,0.8125,56,31,TAGGATTACAGGACCTGCGC,25,1086747
fldAp,2.9375,124,31,TAGATTCATCCGATGGTTAC,93,1154499
fldAp,1.90625,91,31,TACCGTCTACCAGCAGAAAG,60,1174061
fldAp,0.0625,32,31,TACCGAGAGATTCAGCAACG,1,1153505
fldAp,0.6875,52,31,TAAAGTCTTTGGCTGCACAT,21,1074095
fldAp,0.0625,32,31,GTTTTCAGGCTACTATGACT,1,1133435
fldAp,0.0625,32,31,GTCTCGGTAACACCACGTAT,1,1082284
fldAp,1.40625,75,31,GTCTAGGTGAATTTTAACTA,44,1177345
fldAp,0.9375,60,31,GGGCTGCCGGGAACAGGGCA,29,1165333
fldAp,3.125,130,31,GGGCTCGTGGGATGTGCTAT,99,1077168
fldAp,0.1875,36,31,GGATAGCTTGGTGGCCACGC,5,1165757
fldAp,1.21875,69,31,GGAAAGAACCGTAAGATTCA,38,1117560
fldAp,1.90625,91,31,GCTGGGGATGAACAGCCATA,60,1160797
fldAp,0.0625,32,31,GATTGCTGATTTACTAGTAT,1,1120613
fldAp,1.03125,63,31,GACTGTGCACACGTACTGAA,32,1091823
fldAp,0.0625,32,31,CTTCGGTTGCCCCGACCTGA,1,1178571
fldAp,1.5625,80,31,CTCCATTTAGAAACCAACGA,49,1176249
fldAp,1.9375,92,31,CGTCACCGCTGTGCTGGCCC,61,1145194
fldAp,0.0625,32,31,CGGGCGATACCTGGCTCGTA,1,1098706
fldAp,0.0625,32,31,CCCTCGAGGCTGTTGAAATG,1,1160557
fldAp,1.375,74,31,CCATTGGAAGGGAGGATCAC,43,1164646
fldAp,1.40625,75,31,CATGCGCCAGCTCATCGGGA,44,1168174
fldAp,3.5,142,31,CATCTCTTCGGCTACATGTA,111,1145089
fldAp,0.71875,53,31,CACTAGCACAGCGTCGGGAG,22,1185015
fldAp,0.875,58,31,CAACGACCGGAGTTTCAGAA,27,1161890
fldAp,0.0625,32,31,ATGGTACCGGTTGAACTTCA,1,1075740
fldAp,0.5625,48,31,ATGGGGGGGTTGGAGCGCTT,17,1145628
fldAp,0.0625,32,31,ATCTCCGCTACGGACCTGGT,1,1127073
fldAp,0.34375,41,31,ATAGAGCTTAGCAATCATGT,10,1114379
fldAp,1.5,78,31,AGTCTACTCCGACGTCGAAC,47,1084829
fldAp,6.125,226,31,AGGTCTCGAAAGCCAGCGCG,195,1145639
fldAp,0.0625,32,31,AGGCATTACAGCGCCACGCA,1,1129182
fldAp,9.71875,341,31,AGACTCCGAGACCCATCCTT,310,1103953
fldAp,0.3125,40,31,ACTGGTAATTTGGGGAGCTC,9,1065324
fldAp,1.9375,92,31,ACTCTGCGGTCGGCCGAATG,61,1100700
fldAp,0.125,34,31,ACGTGGCCAAACAGGCTTTT,3,1087084
fldAp,1.8125,88,31,ACGTAGTTCTGCAAAGCCTA,57,1179522
fldAp,1.625,82,31,ACCAGTCTGTCTAAATTTTA,51,1139946
fldAp,0.0625,32,31,ACACGACCGGGTATACGGTG,1,1174436
fldAp,0.3125,40,31,ACACACATGGATCAAAGCGG,9,1101611
fldAp,1.78125,87,31,ACAAATAGTCACGCAGCAAA,56,1124048
fldAp,3.09375,129,31,AACTCACTCCTACGAGTTGC,98,1162789
fldAp,2.21875,101,31,AACCAGTTGTTGCCACACGG,70,1103424
fldAp,0.8709677419354839,56,30,TTTTTCAAGATTGCGAGTAC,26,1097304
fldAp,1.8387096774193548,86,30,TTTCGGTAGAGGGGCCTCCC,56,1112861
fldAp,3.3870967741935485,134,30,TTGTATCGTGATACGTGTCG,104,1121052
fldAp,0.7096774193548387,51,30,TTCTACTGCGTAAGAGTGGA,21,1081471
fldAp,1.1935483870967742,66,30,TTATGGCTTCTGGTGGTCTA,36,1141136
fldAp,0.7096774193548387,51,30,TGTGTTATGAGTGCAAGAAC,21,1161339
fldAp,1.7419354838709677,83,30,TGCACAGGAGTTGACAAGAT,53,1105061
fldAp,1.903225806451613,88,30,TCGCTGAACGTATCCTACCA,58,1097151
fldAp,0.1935483870967742,35,30,TCAGTCGTGGAATTATAAAT,5,1082033
fldAp,0.6774193548387096,50,30,TAGAGGGCCATAGAAAAATA,20,1117108
fldAp,0.6129032258064516,48,30,GTTTGATCTAGGCCGTTTAA,18,1176561
fldAp,1.1935483870967742,66,30,GTGGTAGTCGGATCAGGCAA,36,1185183
fldAp,1.3870967741935485,72,30,GTCTGGACCGATATAACAAA,42,1160867
fldAp,1.2903225806451613,69,30,GGTGGGTAGGGTTAGTCAAA,39,1102759
fldAp,1.0,60,30,GGCGCGCCAGTCACGTCACT,30,1150336
fldAp,1.6451612903225807,80,30,GGATAAACCAACAATGTGGC,50,1162629
fldAp,0.6451612903225806,49,30,GCGTTTCACACGGGCTCCCC,19,1083143
fldAp,1.2258064516129032,67,30,GCGCGCCTTCGTTCGACCAG,37,1164421
fldAp,1.2580645161290323,68,30,GCCCCATGTTAAGCTTACAC,38,1104212
fldAp,1.4516129032258065,74,30,GATATATCGAGTTGCTATTT,44,1105320
fldAp,1.2903225806451613,69,30,GACGCGGTCGTTCTGTCTAA,39,1169595
fldAp,2.3225806451612905,101,30,GAAAGGACTTGTCACAGATG,71,1179059
fldAp,0.8064516129032258,54,30,CTCTTTAGTCGTCCTGCCTG,24,1168919
fldAp,3.225806451612903,129,30,CTATACAATTCCCCTACGAT,99,1111535
fldAp,4.32258064516129,163,30,CCTTGGCGACCCATAGTGAA,133,1095298
fldAp,0.8387096774193549,55,30,CCTAGTTACAATCGTTTACT,25,1114300
fldAp,0.7741935483870968,53,30,CCGTTAAAGCTCATATGGTG,23,1135922
fldAp,1.2580645161290323,68,30,CCGTAAAGATGAACTCTCAA,38,1100031
fldAp,1.6451612903225807,80,30,CCCTCATTACCAACTGCGCC,50,1102211
fldAp,1.6451612903225807,80,30,CCCCTTCGCCTATCACTCTC,50,1172274
fldAp,2.064516129032258,93,30,CCATGTCAAGATTCGGAGGT,63,1074320
fldAp,1.4516129032258065,74,30,CCACTAATGGACCTCTCCTA,44,1073431
fldAp,0.7741935483870968,53,30,CATGAAGCCGTTGAGCATGC,23,1068655
fldAp,1.6129032258064515,79,30,CATCCGTATCTCCCTGACCT,49,1152133
fldAp,1.3225806451612903,70,30,CAGTCCTTTTAAACAATTGA,40,1138418
fldAp,1.903225806451613,88,30,CACGACATACAACAGAACTA,58,1148164
fldAp,0.8064516129032258,54,30,CACCTTTATTCCTAGCAATT,24,1136321
fldAp,0.7096774193548387,51,30,CACAGCGATTCTATATCGCT,21,1184066
fldAp,0.6774193548387096,50,30,CACACGGCCCATATGGTTCT,20,1081295
fldAp,1.3548387096774193,71,30,CAATTCTAGTCAACAGCCGA,41,1120979
fldAp,8.35483870967742,288,30,CAACAGTTAGCTCCGCAACA,258,1159214
fldAp,0.0967741935483871,32,30,ATTGCCAAGTAGTGGTTGAT,2,1123473
fldAp,1.7096774193548387,82,30,ATGCATATACCTGGCACATA,52,1128818
fldAp,3.4516129032258065,136,30,ATGCACACACGTCTCGCGCC,106,1138408
fldAp,0.8387096774193549,55,30,ATGAAGGTCTAATGTTTTAC,25,1096250
fldAp,2.6451612903225805,111,30,ATCTCAAAAAATGTATCGTT,81,1103239
fldAp,0.7741935483870968,53,30,ATCAGCTGTCGCCTCATAGC,23,1143180
fldAp,0.06451612903225806,31,30,ATCAAACGCAACAACACCAA,1,1174443
fldAp,1.1290322580645162,64,30,ATATGATCTAATAAGCGTCT,34,1100628
fldAp,1.4193548387096775,73,30,AGGTTTTGGTCCCACCGGGT,43,1127785
fldAp,1.8064516129032258,85,30,AGCGGTTTGTACCTTCGCGG,55,1103090
fldAp,0.2903225806451613,38,30,AGCCGCCCCGGCACGGCTAT,8,1099251
fldAp,1.2903225806451613,69,30,AGATAAGTTACGTTCTATGT,39,1183823
fldAp,1.4193548387096775,73,30,ACTGTCTTGTAACAGAGCCA,43,1098501
fldAp,0.6774193548387096,50,30,ACTAGGTGGGAACGATTTAC,20,1164845
fldAp,1.2258064516129032,67,30,ACGGTGGATTGTCGTACGTT,37,1130845
fldAp,0.8387096774193549,55,30,ACCTAATTGAAGACACAAGG,25,1115453
fldAp,0.967741935483871,59,30,ACCATACGAGCTGTCCTACA,29,1082694
fldAp,0.7741935483870968,53,30,AAGTAAGGCCAGTTTACACA,23,1085993
fldAp,0.9032258064516129,57,30,AAGGCAGACCTTGTCTCGAA,27,1124352
fldAp,0.6774193548387096,50,30,AAAAGATCTCGGCCCGATCG,20,1111178
fldAp,0.06451612903225806,31,30,AAAAAGCAACAGTTAGTGGT,1,1105076
fldAp,2.1666666666666665,93,29,TTTCAGATCATAGGGCCTTT,64,1167349
fldAp,0.3,37,29,TTGACTTCCGGTAAAGAGCA,8,1144129
fldAp,3.4,130,29,TTCCAATGGGCGGCGTCACA,101,1116468
fldAp,2.933333333333333,116,29,TGGTGTGTTAATGGCACGGT,87,1114574
fldAp,2.6333333333333333,107,29,TGGCTTTACTCCCTCTTGGT,78,1115346
fldAp,0.8,52,29,TGCTCACTACACTCGGACCA,23,1108631
fldAp,0.9666666666666667,57,29,TGCCGACCCCTTAGTAGCGT,28,1110683
fldAp,1.5666666666666667,75,29,TCGTTCCCCCCGACGTTCAT,46,1133824
fldAp,0.8666666666666667,54,29,TCCCCAGTTGTAAATACCAG,25,1121605
fldAp,28.733333333333334,890,29,TATGGTATGTCGCCGACAAT,861,1064768
fldAp,1.3333333333333333,68,29,TATGAAGAAAGTTCTCTTAG,39,1162766
fldAp,0.9333333333333333,56,29,TATCTTTATGTTGGTCCAGG,27,1167162
fldAp,0.1,31,29,TAGGAGGAGGACTTTAAGAG,2,1065238
fldAp,0.36666666666666664,39,29,TAGGACGCTAACAAGTACAG,10,1104616
fldAp,0.4666666666666667,42,29,TACCTGAGATCGGGCCATAT,13,1158942
fldAp,1.1333333333333333,62,29,TAAGAGGCAGCGACGATTCA,33,1147131
fldAp,1.7666666666666666,81,29,GTCCTTTCCGTTCGACGGCT,52,1186940
fldAp,0.8333333333333334,53,29,GTCCTGCAACATGGGGTAGT,24,1107545
fldAp,1.6,76,29,GTACGGTTCGTTACTCAAAT,47,1172275
fldAp,1.3,67,29,GGTAGCATCGGCGACTATCC,38,1185031
fldAp,1.0333333333333334,59,29,GGTAAAACCGTCGCTAAGGC,30,1113713
fldAp,0.7666666666666667,51,29,GGGCACTGGGGGTGACGAAG,22,1090854
fldAp,0.4666666666666667,42,29,GGCAAGTTCGATCGTGTGAC,13,1176445
fldAp,0.9,55,29,GGAGATAATGGGTATCAGTA,26,1073988
fldAp,1.0333333333333334,59,29,GGACTGATCCATGCCCATAT,30,1105480
fldAp,0.06666666666666667,30,29,GCTCATCCAGGTGAACCCGA,1,1115177
fldAp,0.06666666666666667,30,29,GCGTCTGGACCGCGGTTACT,1,1102334
fldAp,2.3666666666666667,99,29,GCGGGAAATGCGACCCGTCA,70,1127714
fldAp,4.033333333333333,149,29,GATTACGGGATCCTATGACT,120,1139411
fldAp,1.7,79,29,GATCACGGAGCCTTCCGTAA,50,1090031
fldAp,0.8,52,29,GAGGGACTGACATCTGACTG,23,1108706
fldAp,0.5333333333333333,44,29,GACCGTTGTATCCGCCCGAA,15,1076939
fldAp,1.2666666666666666,66,29,GACAGCTTACTTGACGTATC,37,1091904
fldAp,0.6333333333333333,47,29,CTTTGGTAACTAGACCATAC,18,1179551
fldAp,1.8666666666666667,84,29,CTGTCTGTAACTATCTACTG,55,1069972
fldAp,0.4666666666666667,42,29,CTCGGCGTAGCACAAGGGGA,13,1169212
fldAp,0.06666666666666667,30,29,CTATTCGCTCTCCTACAGTT,1,1107939
fldAp,0.7666666666666667,51,29,CGGGCATCTAGAGGGGTTGT,22,1076530
fldAp,5.4,190,29,CGGAGACTGAATTTACATCA,161,1121053
fldAp,1.2666666666666666,66,29,CGATTACTATAATTTTGCGC,37,1127565
fldAp,0.26666666666666666,36,29,CGATAAGATGAGCGCGAGGC,7,1143530
fldAp,0.5,43,29,CGACCTGTTGTGCTTATGTA,14,1101301
fldAp,0.9,55,29,CCTCAGCGAGGTCTTCCTAT,26,1109515
fldAp,0.7333333333333333,50,29,CCTAGTAAGGCAACTATTGG,21,1069470
fldAp,1.7,79,29,CCGTCGCGTCCTCCCTAGAA,50,1084370
fldAp,0.7666666666666667,51,29,CCCCCACGACACAGCGGTCA,22,1129444
fldAp,0.7333333333333333,50,29,CCCCATTAGGACAGCCCCGA,21,1175928
fldAp,0.23333333333333334,35,29,CCCACTCCTAGCTCCGTGTT,6,1119675
fldAp,3.1333333333333333,122,29,CCATCTAAACCTGTGGACAG,93,1105881
fldAp,0.06666666666666667,30,29,CATGGATAGCGCAACACAGA,1,1145552
fldAp,0.6666666666666666,48,29,CAATTAATTCACAGCTCGGC,19,1160136
fldAp,0.9,55,29,CAACATATTTTGCGACTCAA,26,1120047
fldAp,0.06666666666666667,30,29,CAAAACGTTGGGCATAACGG,1,1139262
fldAp,5.6,196,29,ATTGGGGTTTCGACACATCA,167,1157929
fldAp,24.966666666666665,777,29,ATTAACCATGTAGACCGTTG,748,1135658
fldAp,1.5333333333333334,74,29,ATGGTTATGCGTACTTCATT,45,1137711
fldAp,2.533333333333333,104,29,ATGCGTTCGGCGACAAGGTA,75,1169982
fldAp,0.06666666666666667,30,29,ATGACACGTCCGCGCATTAT,1,1097587
fldAp,0.06666666666666667,30,29,ATCGTGCTCTCCCGCAGTGT,1,1120598
fldAp,1.0666666666666667,60,29,ATAGCTGAATGTCTTCCTGC,31,1094364
fldAp,0.3,37,29,AGTAATGAGAAAAACGGGTA,8,1183205
fldAp,1.0,58,29,AGCTATCGTAGTGGCCATGC,29,1087168
fldAp,1.1666666666666667,63,29,AGCAAATGTATATTAGTAAG,34,1105981
fldAp,2.066666666666667,90,29,AGAACAATGGCTCTTGCGCT,61,1137287
fldAp,1.1,61,29,ACTTTAGTCCCTGTAGACGA,32,1082797
fldAp,0.3,37,29,ACTTCAAATGTGGTGGTCGG,8,1078460
fldAp,2.3,97,29,ACGTGTTTGTAATCCCTCCG,68,1089504
fldAp,0.8333333333333334,53,29,ACGATGAATAGCCTGAAAAA,24,1084149
fldAp,0.06666666666666667,30,29,ACGACACAGAATTGCCCCCA,1,1137953
fldAp,0.6666666666666666,48,29,ACCTGGAACCATCGCAGGCT,19,1147324
fldAp,0.6666666666666666,48,29,ACATCACATAGGTCCTCGTC,19,1110821
fldAp,1.6666666666666667,78,29,AAGGTTTTTCAAGAAGGTGA,49,1094698
fldAp,0.8,52,29,AAGATGGTGGGACGGTGCGA,23,1122891
fldAp,1.1333333333333333,62,29,AAATCACTCGCTACTGTTTA,33,1165860
fldAp,0.06896551724137931,29,28,TTTGTTTACGCTTTCCTCGG,1,1118474
fldAp,1.6551724137931034,75,28,TTTAGACCATAGGAACAAAC,47,1085880
fldAp,0.06896551724137931,29,28,TTGGTCCCGAGGAGGCCCCG,1,1156110
fldAp,2.1724137931034484,90,28,TTAACTCTTGCTAGCGCAAG,62,1149347
fldAp,2.2758620689655173,93,28,TGTTAGTGCGGGGTCGAACC,65,1068428
fldAp,1.3793103448275863,67,28,TGTAGTGTTGGCCCAGTTGC,39,1167762
fldAp,1.6551724137931034,75,28,TGGACAAGCAGCCGCGTGAT,47,1101980
fldAp,2.2758620689655173,93,28,TGCAAGGGATCCCATCAGCG,65,1169302
fldAp,3.0344827586206895,115,28,TCGTCACCACCGTTGGTCAG,87,1135842
fldAp,0.4827586206896552,41,28,TCCGTCACTCAACCTTTAAC,13,1063778
fldAp,0.20689655172413793,33,28,TCCCACGTTCCCTCCCGGCA,5,1162415
fldAp,0.06896551724137931,29,28,TCACGTGCATGATCAGATTA,1,1164940
fldAp,2.6551724137931036,104,28,TATCAAGCGCAGCGGCAGAT,76,1094931
fldAp,0.8275862068965517,51,28,TATACGGCTGTTTTAGTTCT,23,1080700
fldAp,0.6896551724137931,47,28,TAATAGGTAGAAGTAAAGAA,19,1070223
fldAp,0.9655172413793104,55,28,GTACACAAATAACTCCTATG,27,1095930
fldAp,0.7586206896551724,49,28,GGTAGTATAAATTACTGTAC,21,1069095
fldAp,0.7241379310344828,48,28,GGCTTTCGTATACTGAGTGT,20,1077757
fldAp,2.0,85,28,GGCGTCGGCAATAGGGCACT,57,1073099
fldAp,1.5517241379310345,72,28,GGCGGTGTCTGAGCACTCTT,44,1114105
fldAp,4.172413793103448,148,28,GGACAAGACGATCCCTAGCA,120,1137636
fldAp,1.0689655172413792,58,28,GGAATTCAATCAGATCACAG,30,1121756
fldAp,0.06896551724137931,29,28,GCTAGCGTGGCGTGGAGACT,1,1137957
fldAp,3.8620689655172415,139,28,GCCTCTAGGACAGCCCGTGC,111,1094010
fldAp,1.0689655172413792,58,28,GCCGCGAAGTTCGTATGAGG,30,1156376
fldAp,0.10344827586206896,30,28,GCAGATCGGGTCATAGAGCG,2,1096985
fldAp,3.1724137931034484,119,28,GATTCCTCCGTGTAAGTATA,91,1070309
fldAp,1.5517241379310345,72,28,GATGTGGTCTCTAAGTAATA,44,1175088
fldAp,3.9310344827586206,141,28,GATCGGTGGCTAGCCATGAG,113,1079194
fldAp,0.3793103448275862,38,28,GAGTGTTCCCCTCCCACTCG,10,1133400
fldAp,1.8275862068965518,80,28,GACCTTGTTAAAAGCGACCT,52,1097985
fldAp,1.103448275862069,59,28,GACAATGAAGCAGCCGTTTG,31,1183986
fldAp,1.1724137931034482,61,28,GAATAGGTCGGGGCATAGGT,33,1130902
fldAp,1.9310344827586208,83,28,CTTGCGTGTATCGGTTACCA,55,1083566
fldAp,0.6551724137931034,46,28,CTTGCCACGCTCTTTGTGGT,18,1131221
fldAp,0.10344827586206896,30,28,CTCTCTTGAGATGGCTGGTT,2,1112909
fldAp,3.0689655172413794,116,28,CTACTGTCGGTCGGTATTGA,88,1142637
fldAp,1.9655172413793103,84,28,CGTGTAGTCTTCCAGTAGGT,56,1105884
fldAp,1.0,56,28,CGGGTGCATCGCCTAGATGA,28,1079626
fldAp,0.06896551724137931,29,28,CGCAGCCGATTGGTCTCATA,1,1109433
fldAp,0.5517241379310345,43,28,CGAGATTTCGCAACAACTTA,15,1153135
fldAp,1.0689655172413792,58,28,CCTTGACCCAAGGGGTTCAA,30,1068136
fldAp,0.7931034482758621,50,28,CCGTCAGACGATCCTAGATG,22,1113628
fldAp,0.06896551724137931,29,28,CCGCGTAGTGCGGCTACGGT,1,1158539
fldAp,0.2413793103448276,34,28,CCGCGCTGTAGCCCCGTGAA,6,1110917
fldAp,2.206896551724138,91,28,CCGCGCCGATAGATTGTCCT,63,1071153
fldAp,1.7586206896551724,78,28,CCCTACGCTAGTGTCCGAGA,50,1150768
fldAp,0.7931034482758621,50,28,CCCATAGGACGCGGCGGGTA,22,1130305
fldAp,1.3103448275862069,65,28,CCCAAAAGGCAAGCCATGAG,37,1070630
fldAp,2.0689655172413794,87,28,CCATAAATCCACGGAGCCCG,59,1129910
fldAp,1.0344827586206897,57,28,CATCGGCGTTCTCACGCTTT,29,1153439
fldAp,1.5862068965517242,73,28,CATCCTCAGTCCGGAATATG,45,1128814
fldAp,1.3103448275862069,65,28,CAGATCATGCACGATGCCTT,37,1067679
fldAp,0.4827586206896552,41,28,CACAGAAATCTGAGCGCACA,13,1176262
fldAp,0.5517241379310345,43,28,CAATTCAGGTCCCGTCCTTG,15,1089004
fldAp,1.6206896551724137,74,28,CAAGCTTGTGATAGTGCTAC,46,1141726
fldAp,2.7241379310344827,106,28,CAAACGCGTTCTTGGATACT,78,1071584
fldAp,0.6551724137931034,46,28,CAAAAGCAGTCCCTGCATCA,18,1094293
fldAp,1.1724137931034482,61,28,ATTAGCCAGCGCCTTAATCG,33,1077023
fldAp,2.103448275862069,88,28,ATTACATTGCTTCACATATA,60,1072077
fldAp,2.2758620689655173,93,28,ATGCTATACGACGCTACGGC,65,1110145
fldAp,0.06896551724137931,29,28,ATATTGACATAGCGGCGGAG,1,1073250
fldAp,0.06896551724137931,29,28,ATATAGTCTTGATGTATTCA,1,1092744
fldAp,0.10344827586206896,30,28,ATAGCCGATTAACTTCCGTA,2,1099252
fldAp,0.06896551724137931,29,28,AGTTAGTCTATATATGTGGT,1,1144495
fldAp,3.310344827586207,123,28,AGTCTATCTTGGCGCCCGTT,95,1094686
fldAp,0.20689655172413793,33,28,AGGTCTTACCTTTAATGGCG,5,1081662
fldAp,1.4137931034482758,68,28,AGGTCAGGGGTGTCTCGAGT,40,1089739
fldAp,0.9655172413793104,55,28,AGCCTAAGTAAGTACGGGCA,27,1182774
fldAp,9.137931034482758,292,28,AGCAAGTTTGTCTGTAAAGA,264,1103959
fldAp,1.6551724137931034,75,28,AGATTGGGACAGCGGCCGAA,47,1135307
fldAp,0.5862068965517241,44,28,AGATCTGTGAAGCAAGGACC,16,1086737
fldAp,1.206896551724138,62,28,AGATAGCATGGTCCTAATAC,34,1072404
fldAp,2.8620689655172415,110,28,ACGGATTTTGGGTACGGGAA,82,1179055
fldAp,1.0344827586206897,57,28,ACGCGATCAATACGCACGGA,29,1117386
fldAp,0.10344827586206896,30,28,ACAGGGGAGGTTGGCTTTAG,2,1154609
fldAp,0.6896551724137931,47,28,ACAGGACACACGAACCCACA,19,1123828
fldAp,0.27586206896551724,35,28,AAGTTGAACCCCACTCGCTT,7,1078081
fldAp,5.793103448275862,195,28,AAGGGGGGAATAATCCCGAC,167,1086467
fldAp,1.3448275862068966,66,28,AACGTAACAATGCGGATTTC,38,1130588
fldAp,2.4482758620689653,98,28,AACACTCATGCCACGGCTCC,70,1091911
fldAp,1.4482758620689655,69,28,AAATTATTACGAGATAGAAA,41,1177794
fldAp,0.06896551724137931,29,28,AAATGTACCTCTTTGTATAA,1,1113396
fldAp,2.103448275862069,88,28,AAACGCTCTTTATGCCGCGA,60,1115906
fldAp,0.9642857142857143,53,27,TTTTTATCCAGGAGATGGCC,26,1076504
fldAp,0.6071428571428571,43,27,TTGGCCATCGCTCTACAGCA,16,1140558
fldAp,0.5357142857142857,41,27,TGTGATACCTACGGGCTCAA,14,1087595
fldAp,0.14285714285714285,30,27,TGTATAGGACCCTATGTGCT,3,1097516
fldAp,1.5,68,27,TGTAGGTACAGCACGTCCAT,41,1173295
fldAp,1.1428571428571428,58,27,TGTACATGACGCGGCAGTAA,31,1110586
fldAp,0.8928571428571429,51,27,TGGTATGGGCCGAGCAACAA,24,1148558
fldAp,1.25,61,27,TGGGGGCTAAATCGGGCGGG,34,1111266
fldAp,0.8214285714285714,49,27,TGCCGTTGAACGGGTATGAG,22,1077617
fldAp,1.5,68,27,TGACAGCAAACTCCCCTGCC,41,1124071
fldAp,0.07142857142857142,28,27,TCTCTAATCCTATGAACTAT,1,1144101
fldAp,0.32142857142857145,35,27,TCGTCCACGAATATCGAACT,8,1068745
fldAp,1.8928571428571428,79,27,TCGGCGAGAAGGAAAAGATC,52,1104963
fldAp,1.0714285714285714,56,27,TCCCGTTTTGCCTAGAAACT,29,1148543
fldAp,0.6785714285714286,45,27,TCCCAGTCACAGATGTTACA,18,1127821
fldAp,0.42857142857142855,38,27,TCCCACGATACTCATTCCGA,11,1136569
fldAp,1.1785714285714286,59,27,TCATTCGTAACTATTTACAG,32,1157977
fldAp,1.7857142857142858,76,27,TCATATAGGAGACACGGCCA,49,1066640
fldAp,0.8928571428571429,51,27,TCAGTTCGACGCCAGCTTCT,24,1109709
fldAp,4.535714285714286,153,27,TATTGTGCTTCCCCCTGAAA,126,1114571
fldAp,5.392857142857143,177,27,TATTCGTTCCCCCAGGTTTC,150,1112384
fldAp,0.6428571428571429,44,27,TATCGTCGTCATCGTTTGGG,17,1132509
fldAp,2.357142857142857,92,27,TATCATAAATGCGAGCGAGT,65,1119301
fldAp,1.0357142857142858,55,27,TAGTGCTAGGGTCTGGGCAT,28,1158888
fldAp,0.5714285714285714,42,27,TACCGTGAGGACCGTCGCGA,15,1147112
fldAp,1.2142857142857142,60,27,TAATTCGACTAACAGATGAA,33,1105176
fldAp,1.3214285714285714,63,27,TAACTGAGTTCATCGCAGCA,36,1166079
fldAp,2.8214285714285716,105,27,TAACCGGGTCAGGTAGTAAA,78,1064925
fldAp,1.2142857142857142,60,27,GTTGCCAAGCGCAGACCATG,33,1068040
fldAp,0.8214285714285714,49,27,GTTGACAGACCAACTTACGC,22,1079879
fldAp,1.6071428571428572,71,27,GTGATCGTGAACATGCGCCA,44,1116237
fldAp,2.0357142857142856,83,27,GTGAATACGCAGAGCACGAT,56,1092014
fldAp,0.07142857142857142,28,27,GTCCAAAGCTGTTTCAGAGC,1,1174866
fldAp,2.5357142857142856,97,27,GTCAAGGTCGGCTCGCCAAT,70,1134411
fldAp,0.07142857142857142,28,27,GTCAAACTGTGCCTCAGCAA,1,1068266
fldAp,1.1071428571428572,57,27,GTATGGCGGCAGGCTCCTAG,30,1092351
fldAp,0.9642857142857143,53,27,GTATATATCCTTGGGAAATT,26,1135492
fldAp,1.0357142857142858,55,27,GTACAGGTTGCGACTCCTCC,28,1142853
fldAp,5.642857142857143,184,27,GTAACGTGCTCGGTCTAAGG,157,1185232
fldAp,1.4642857142857142,67,27,GGTCGCAGAGGATCACCCAT,40,1117107
fldAp,1.0357142857142858,55,27,GGTCCCTTATGCCTCCGATG,28,1067837
fldAp,1.1071428571428572,57,27,GGGTTAAGTAAGCTTTTCAC,30,1074926
fldAp,0.6428571428571429,44,27,GGGATTTATCGTGTTGGCTC,17,1136576
fldAp,0.35714285714285715,36,27,GGGAGTGAGACACGCTAGCC,9,1112186
fldAp,3.5,124,27,GGGAGAACTGGATTCGCGAT,97,1145110
fldAp,1.4642857142857142,67,27,GGCTGCGCCCTCCGTCTAGA,40,1106937
fldAp,1.3928571428571428,65,27,GGATGACCGGTGCTTGAATT,38,1095980
fldAp,1.3214285714285714,63,27,GGAATCAGGTGTATCGCACG,36,1064586
fldAp,0.5714285714285714,42,27,GGAAGATAGCCTGTCATTGG,15,1142528
fldAp,0.6785714285714286,45,27,GCTTTAATCATTGTCTACGA,18,1141424
fldAp,1.5,68,27,GCTTACAGCTATGATTTAGG,41,1144699
fldAp,5.964285714285714,193,27,GCTGGCAGGGTCACGCAATA,166,1090568
fldAp,6.392857142857143,205,27,GCGCAATAAGTTCTGTCGGT,178,1145079
fldAp,0.7142857142857143,46,27,GCCGCCTTGCTACACGAGCT,19,1173845
fldAp,1.6428571428571428,72,27,GCCACCCTTTTTGATAGAAT,45,1064288
fldAp,1.0714285714285714,56,27,GCAAGTTGTAAAGCGTCCTG,29,1093827
fldAp,1.2857142857142858,62,27,GAGGGTACCTCATGAGCTTA,35,1179067
fldAp,2.2857142857142856,90,27,GACTGGTTTTCGTTCGTCTA,63,1142565
fldAp,0.6428571428571429,44,27,GACCTCATTTAGATAGTACA,17,1144182
fldAp,0.4642857142857143,39,27,CTTGTACCACAGTGTCGGTT,12,1116208
fldAp,0.07142857142857142,28,27,CTTATCGGTTTTCGTCAGTA,1,1120230
fldAp,0.7142857142857143,46,27,CTGCGCGAGTTGTATTTAGA,19,1168079
fldAp,0.07142857142857142,28,27,CTGATGCATCACCAAGACGA,1,1110461
fldAp,1.4642857142857142,67,27,CTCGACTGGGGCTAATAACT,40,1150744
fldAp,0.75,47,27,CTACGGTACCCCCGCTCATT,20,1129100
fldAp,0.14285714285714285,30,27,CTAAACCTCTTCTGGCGTTA,3,1074535
fldAp,1.1785714285714286,59,27,CGTTCTAAACCAACCACCTA,32,1152963
fldAp,2.4285714285714284,94,27,CGTCGTGGATCTGGCAGACA,67,1134984
fldAp,0.10714285714285714,29,27,CGGGACCGTCACTGAACCAC,2,1065927
fldAp,1.0714285714285714,56,27,CGGCGGACTCTCCCACACCG,29,1170358
fldAp,3.6785714285714284,129,27,CGAGTGGCCTGGAATCGCTT,102,1140887
fldAp,1.9642857142857142,81,27,CGAGAGTATTATAGACTCAC,54,1145187
fldAp,2.7142857142857144,102,27,CGAGAGACGTTTCAGCCACT,75,1118117
fldAp,1.2857142857142858,62,27,CCTTCAGCTAATTTTAGGTA,35,1094813
fldAp,0.07142857142857142,28,27,CCTCCTACGACCAGCGGGGT,1,1120068
fldAp,2.2142857142857144,88,27,CCTACCTGGCTTCTCGGATG,61,1074868
fldAp,2.392857142857143,93,27,CCATCTTTTCGTGGGGAGTA,66,1111950
fldAp,0.14285714285714285,30,27,CCAGGTGTTGGGTTTTAAAT,3,1117257
fldAp,3.2857142857142856,118,27,CCACCCTTCGGTAAGAGACA,91,1095288
fldAp,1.5714285714285714,70,27,CAGGCTCGGACGTAGTGAGA,43,1101305
fldAp,0.7142857142857143,46,27,CAGAGATAGTGCAGGGACAA,19,1119200
fldAp,0.6071428571428571,43,27,CACTGCGCAGCTCATGGTCT,16,1181065
fldAp,1.3928571428571428,65,27,CACCGTTCGAGGCATGGGCA,38,1175412
fldAp,2.1785714285714284,87,27,CACCCGCGGGGCATCACGTA,60,1147699
fldAp,0.07142857142857142,28,27,ATTCATGCAAGAATAGCTAC,1,1111467
fldAp,2.75,103,27,ATGTGACCGTCAAGCCGTTA,76,1169786
fldAp,1.0,54,27,ATGGTCGGGATAGCGTGCTG,27,1082235
fldAp,1.0714285714285714,56,27,ATGAGACGCGCCGGGGCCGT,29,1156939
fldAp,1.5714285714285714,70,27,ATGACTTGTATCACGTGCTT,43,1181760
fldAp,3.5714285714285716,126,27,ATCTATTACAGAGCTCCCAG,99,1103427
fldAp,1.0714285714285714,56,27,ATCTAGGGGCTACCTCTTAG,29,1119852
fldAp,0.14285714285714285,30,27,ATAATGATGTCGTAGTTATC,3,1165888
fldAp,0.9285714285714286,52,27,AGGCATCCTCTCATGGATGA,25,1104479
fldAp,0.6071428571428571,43,27,AGAGGGCGAGTTACTGGCTC,16,1140115
fldAp,1.8214285714285714,77,27,ACTTGCGCAGACCATAGGCA,50,1165908
fldAp,2.142857142857143,86,27,ACTGCTTAATAGGTTAACCC,59,1175239
fldAp,1.5,68,27,ACTACGTATGCCTGATCTCA,41,1155340
fldAp,4.285714285714286,146,27,ACCTATATACTACGAGACCT,119,1110139
fldAp,3.9642857142857144,137,27,ACAGTCAGGGTAAGAATCCA,110,1110372
fldAp,1.5714285714285714,70,27,ACACGGTCGATAGTGGTCGG,43,1175151
fldAp,0.07142857142857142,28,27,ACAATGTTCTTCTATTGCTA,1,1149155
fldAp,1.6428571428571428,72,27,ACAAGACTAAGTAAGGAGCA,45,1106785
fldAp,1.1071428571428572,57,27,AATTGGGTGAGTGCCAATCT,30,1138326
fldAp,1.1428571428571428,58,27,AAGAGTACAGTTATGGGATA,31,1095776
fldAp,2.607142857142857,99,27,AACACAGCGCTGCAGACAGT,72,1080664
fldAp,1.0357142857142858,55,27,AAATGCTCAAACTAACGGTA,28,1148117
fldAp,1.5357142857142858,69,27,AAATCGCCTACTTGGCGAGG,42,1082188
fldAp,3.107142857142857,113,27,AAATAAACAGTGGGGTCATG,86,1131012
fldAp,2.3333333333333335,88,26,TTTGGTTCCGGTACTGTTAC,62,1149073
fldAp,2.0,79,26,TTTCTCTCTAGGGAAACGGA,53,1107351
fldAp,2.2222222222222223,85,26,TTGAGGCATACAAGTCTTTG,59,1102885
fldAp,1.5925925925925926,68,26,TTCCCGTTATCCTCGCAATC,42,1174381
fldAp,1.1481481481481481,56,26,TTAGTTTTCAGATCAGCGTA,30,1070127
fldAp,1.2962962962962963,60,26,TTAGTGGTACCAGGACATAC,34,1169091
fldAp,1.4814814814814814,65,26,TTACAGTTGTTACGTACCCG,39,1103245
fldAp,0.07407407407407407,27,26,TGTTTGTGATCGCTGGTATA,1,1112478
fldAp,1.5185185185185186,66,26,TGTGTTAGACAATATGTCCT,40,1112180
fldAp,1.0,52,26,TGTCAGAGCGGGTGGGACGT,26,1096602
fldAp,0.25925925925925924,32,26,TGGGACAAGACGTGAGTGTA,6,1161307
fldAp,0.07407407407407407,27,26,TGCTTAGCTGTATTGTCATG,1,1158264
fldAp,2.4444444444444446,91,26,TGATTGCTCAATGGATCGGG,65,1113494
fldAp,2.3703703703703702,89,26,TGACAGCAGAACGTCCGGGG,63,1129039
fldAp,1.1481481481481481,56,26,TCTAGCTCCTGTTTAGCCCA,30,1085706
fldAp,4.777777777777778,154,26,TCCCATCCCCGCATCAATGA,128,1093285
fldAp,1.1481481481481481,56,26,TCATAGAACCTGTCTAGCCA,30,1133738
fldAp,3.2962962962962963,114,26,TCAGGGAGAATTCTGGTGGC,88,1105268
fldAp,0.48148148148148145,38,26,TCAGGCGCGCCGGCAGCGTC,12,1169705
fldAp,0.48148148148148145,38,26,TATGTCAGTTTGTACCAAGG,12,1125673
fldAp,1.2222222222222223,58,26,TATGCATTCAGCTATGTTCT,32,1139225
fldAp,0.5925925925925926,41,26,TATCTCCCGGAGCGTACCAG,15,1077266
fldAp,0.9259259259259259,50,26,TAGCTGTAATTGTGCGTTAG,24,1095355
fldAp,0.37037037037037035,35,26,TAGATTTTCGGCCACTTCTT,9,1133513
fldAp,2.1481481481481484,83,26,TACGGCGGTAGGAGGCTTTT,57,1128113
fldAp,2.4444444444444446,91,26,TAACTTGAGATTCCACCCCT,65,1182600
fldAp,0.48148148148148145,38,26,TAACAGGTAAAGTGGTTGAG,12,1129104
fldAp,0.07407407407407407,27,26,TAAATTACTTACGGAGACAG,1,1100551
fldAp,1.3703703703703705,62,26,GTTGATTAAGTGGATCGAGG,36,1180172
fldAp,0.14814814814814814,29,26,GTGTAACGTCTCAGTGAGCT,3,1122992
fldAp,1.6296296296296295,69,26,GTGGCGTTACCGCTGTAGTT,43,1142515
fldAp,1.0740740740740742,54,26,GTCTGGACCCGTGCCATGAC,28,1098784
fldAp,0.07407407407407407,27,26,GTCTATAACTGGGATGGTTC,1,1161822
fldAp,0.8518518518518519,48,26,GTCGTGTGCATCCAGAAGGA,22,1104877
fldAp,0.5925925925925926,41,26,GTCGTAGGAGATTGGGGACC,15,1140214
fldAp,0.8148148148148148,47,26,GTATGTGATACTCGGCCTCC,21,1075604
fldAp,1.7037037037037037,71,26,GTATCCGGGCCAATCGCAAT,45,1100389
fldAp,4.851851851851852,156,26,GGTCTCGACACATATCGTCT,130,1157600
fldAp,0.5555555555555556,40,26,GGGTTCTAATGCACTGCGGT,14,1074815
fldAp,1.6666666666666667,70,26,GGCGCCGGTGAAGGCTCCTC,44,1111533
fldAp,1.037037037037037,53,26,GGACCATTATTGGTAGGTTA,27,1142721
fldAp,0.8888888888888888,49,26,GCTGCATAAATGCTAGCGGT,23,1157601
fldAp,1.037037037037037,53,26,GCTAGGCATTCTTAGCTGTG,27,1114673
fldAp,2.185185185185185,84,26,GCGTGTTGCCAAACCTGTGT,58,1110365
fldAp,0.07407407407407407,27,26,GCCTTGCAGGATCAACCGAT,1,1109706
fldAp,0.8148148148148148,47,26,GCCTAGCCTATAGTTGTTGT,21,1105638
fldAp,1.6296296296296295,69,26,GCCGCAGCACACAGGGGGGT,43,1110378
fldAp,1.4074074074074074,63,26,GCCCCTGTCGCCTTGACAAC,37,1107171
fldAp,1.3333333333333333,61,26,GCATATACCATTTACTTGGA,35,1105385
fldAp,3.2962962962962963,114,26,GAGGCATTACCTGGGTTAAG,88,1164422
fldAp,2.037037037037037,80,26,GACCGTATGCAGGATTAGGT,54,1099417
fldAp,4.814814814814815,155,26,GACCGACACGGCTTAGCGCA,129,1135310
fldAp,1.3703703703703705,62,26,CTTTAGTGTTGCTATTAGAC,36,1181315
fldAp,1.037037037037037,53,26,CTTCTTATATTTGTTCACAG,27,1063743
fldAp,3.2222222222222223,112,26,CTCGGCAATGATAAGGAAGG,86,1070493
fldAp,1.3703703703703705,62,26,CTATATTCCAATTCCGGTTC,36,1146812
fldAp,0.25925925925925924,32,26,CGTGCCGTTAGCGAAGTCGC,6,1094941
fldAp,0.4074074074074074,36,26,CGTGCCCGGCTCCGTATCGA,10,1124604
fldAp,6.148148148148148,191,26,CGGGGCTAAGCACAGAACGA,165,1174575
fldAp,1.4074074074074074,63,26,CGGAGGCATGAAGGCCTGTG,37,1181877
fldAp,0.4074074074074074,36,26,CGCTAACTCCTGGTGAAAAT,10,1097720
fldAp,0.07407407407407407,27,26,CGCCACGTGCCACCGGGTGA,1,1094613
fldAp,0.1111111111111111,28,26,CGCACGGCATGGGTGCGTAA,2,1131209
fldAp,2.2222222222222223,85,26,CGAGCAACAGATATGCCAGA,59,1086488
fldAp,1.7037037037037037,71,26,CGAATTTCTCGTGTATCGGT,45,1065482
fldAp,0.9259259259259259,50,26,CGAATAGGTGGCGGCCACTT,24,1095737
fldAp,1.1111111111111112,55,26,CGAACCATGACTACACGTGT,29,1174736
fldAp,1.7407407407407407,72,26,CGAACAGTATGCAGTTTAAA,46,1068057
fldAp,1.1111111111111112,55,26,CCTTCTGTGCTCACTCAGAA,29,1185840
fldAp,0.3333333333333333,34,26,CCGTCGCCGGTAATACTCGA,8,1165056
fldAp,0.8148148148148148,47,26,CCGGGCTGTTCAAACCTGGC,21,1182009
fldAp,0.07407407407407407,27,26,CCCAAGCCGGCTTGACCAAT,1,1110523
fldAp,1.0,52,26,CCAGGTTAGTCTAGCAACAA,26,1172285
fldAp,2.5185185185185186,93,26,CATTCCTCTGGTAGATCGTA,67,1121710
fldAp,1.1851851851851851,57,26,CATGGTTCACTGGTTATCCG,31,1150042
fldAp,1.037037037037037,53,26,CATAAATCCGGGCTCCGTAG,27,1085990
fldAp,0.37037037037037035,35,26,ATCGCAATTTGTTCCAGACC,9,1085520
fldAp,0.18518518518518517,30,26,ATCAGCCGCCAGATGAACAT,4,1147828
fldAp,1.1111111111111112,55,26,ATAGTACGCGAAGATTAGAG,29,1107518
fldAp,0.2962962962962963,33,26,AGTGGTATGTAGGCGGGTGA,7,1089561
fldAp,0.4444444444444444,37,26,AGTGGCCGACAATGCGCGCT,11,1130510
fldAp,2.2962962962962963,87,26,AGTCAAAACAGCCTGATTAA,61,1095433
fldAp,2.4074074074074074,90,26,AGGTCTATATGGAATTACGT,64,1132228
fldAp,1.0740740740740742,54,26,AGGGTGGCTCGCGCTAGGAA,28,1183384
fldAp,0.5185185185185185,39,26,AGGAGTGCGAACTTAAAGCC,13,1118932
fldAp,0.5185185185185185,39,26,AGGACCTCACAATCAACAGA,13,1128416
fldAp,0.07407407407407407,27,26,AGCCCCGGCTCAAACGTCGC,1,1075055
fldAp,1.5555555555555556,67,26,AGACCCGAGGGACTAGATAC,41,1158421
fldAp,0.8888888888888888,49,26,AGACAATGTAACGTAGGACG,23,1090693
fldAp,1.1481481481481481,56,26,AGAAAGACACCTATGCGTTG,30,1155734
fldAp,2.0,79,26,ACTTGGTGAGACAGTCTTAA,53,1087093
fldAp,1.0740740740740742,54,26,ACTTAGGTGGTGAAGCAGGA,28,1087488
fldAp,2.5185185185185186,93,26,ACTAAACGCAACCGGGTTGT,67,1077114
fldAp,1.6666666666666667,70,26,ACGGCAGACTGCGTAGTACT,44,1084282
fldAp,0.07407407407407407,27,26,ACCGAGACGGGTGGATGTTG,1,1106561
fldAp,2.259259259259259,86,26,ACAGTTGAAGGTCCCGACTT,60,1146654
fldAp,1.4444444444444444,64,26,ACAGTTCCGCATTCCAGAAT,38,1065470
fldAp,2.814814814814815,101,26,ACAGCCCTGGTACGAGACAC,75,1157944
fldAp,1.1481481481481481,56,26,AAGGACCCGACGGTCGTTTA,30,1132155
fldAp,0.9629629629629629,51,26,AAGCACAGTTAAATCGGATG,25,1186909
fldAp,3.4814814814814814,119,26,AAATTCAGATGCAGCCATCC,93,1088197
fldAp,0.9629629629629629,51,26,AAAGATGGTATCAGAATCGT,25,1106742
fldAp,1.5925925925925926,68,26,AAACTGCATGATCAGGCAAA,42,1115140
fldAp,0.07692307692307693,26,25,TTTATGTGTCACACGATATT,1,1128611
fldAp,8.307692307692308,240,25,TTTACACCAATCTTAATCAC,215,1113209
fldAp,0.6923076923076923,42,25,TTGTTGGCCCGAAAGCGAGA,17,1159478
fldAp,1.0,50,25,TTGCGCTGAGACCTGGTCGC,25,1130071
fldAp,2.6538461538461537,93,25,TTGACTCACTCCAACAGTGT,68,1102650
fldAp,1.1538461538461537,54,25,TTCGCAGTGGCCCTTTGAGA,29,1165769
fldAp,1.6153846153846154,66,25,TTCGAACTCAATCGCACGTG,41,1096983
fldAp,1.2692307692307692,57,25,TTCCGATTTTCATATGATTA,32,1157444
fldAp,0.7307692307692307,43,25,TTAATTGCCGCGAGGCCCTA,18,1169001
fldAp,2.5384615384615383,90,25,TGTCGAAACAAGCGCTGCCG,65,1125882
fldAp,1.2307692307692308,56,25,TGGTTACGGCGTTCGTCGGA,31,1171832
fldAp,2.230769230769231,82,25,TGGTACACAGGAATTAACCC,57,1105574
fldAp,0.7307692307692307,43,25,TGGGTCTAAAGAGCACGAAC,18,1153413
fldAp,0.34615384615384615,33,25,TGCCTGCGGCAGATGTCCCA,8,1082128
fldAp,1.0769230769230769,52,25,TCTGCCCTAGAATCTATAAG,27,1110166
fldAp,2.1153846153846154,79,25,TCTATGGGGCGATAAATCTT,54,1145888
fldAp,1.3076923076923077,58,25,TCTAGACGGGAGGTGGACAT,33,1119807
fldAp,0.38461538461538464,34,25,TCGGGGTTTAAGACGTCGAG,9,1134410
fldAp,7.8076923076923075,227,25,TCCATAGTGGGGCATCGCCT,202,1078614
fldAp,1.6923076923076923,68,25,TCATGAACAGCACCTGGCAA,43,1077182
fldAp,0.07692307692307693,26,25,TCATAAACCGGACCTAGCAT,1,1081123
fldAp,0.5,37,25,TATTCGGTCGCCATGTCTCT,12,1128616
fldAp,0.07692307692307693,26,25,TATTACGCGTCCGTATCGAC,1,1156291
fldAp,2.6923076923076925,94,25,TATCCGACCTGGTGTCTGCC,69,1139144
fldAp,1.0384615384615385,51,25,TATCCCTCTCGCAAATTATT,26,1101176
fldAp,1.0,50,25,TAGAACACGACGGAAGGAAA,25,1145649
fldAp,1.9615384615384615,75,25,TACGGAGGGTCATCGTTATG,50,1170231
fldAp,0.9615384615384616,49,25,TAATGTGACAGGTTTGTTCT,24,1078671
fldAp,1.5,63,25,TAAGCGCATATCCACCGCGC,38,1090912
fldAp,0.6923076923076923,42,25,TAACTGGTTTAAAGTCTCAA,17,1063309
fldAp,9.807692307692308,279,25,TAAAGGCACTCGCACGCGTG,254,1063632
fldAp,0.5384615384615384,38,25,GTTTCCGCGCACCTCGCTAC,13,1107855
fldAp,0.9230769230769231,48,25,GTTATGCGCAAGCATTGAAT,23,1128665
fldAp,1.8461538461538463,72,25,GTGGTGATTTGCCTGACTGT,47,1122908
fldAp,0.9230769230769231,48,25,GTGGGTTGCTGCGTGTACAG,23,1149364
fldAp,0.19230769230769232,29,25,GTCGCTACCGGATGGTCGGA,4,1174297
fldAp,1.6538461538461537,67,25,GTATAGTGTCCAGTAAGATG,42,1064379
fldAp,4.230769230769231,134,25,GTAGAGTCGGTTTAGCAGAG,109,1128653
fldAp,0.4230769230769231,35,25,GTAGAATAGTGTGGGCGGAA,10,1088375
fldAp,1.2692307692307692,57,25,GTAGAAAATTCAAGCTCGCA,32,1106267
fldAp,0.9615384615384616,49,25,GGTTGTTAATACAATAACTT,24,1070917
fldAp,2.3461538461538463,85,25,GGTAACTGGCTGACCCTTGT,60,1113289
fldAp,0.9615384615384616,49,25,GGGTTTCTGCTGTTATTCCT,24,1123156
fldAp,0.07692307692307693,26,25,GGGCTTTAACGTTTCGCAAA,1,1084049
fldAp,1.1923076923076923,55,25,GGGAAGGGTGTTCCTTAACA,30,1063905
fldAp,0.9615384615384616,49,25,GGCGGGCATGCACAAATAAT,24,1131317
fldAp,0.19230769230769232,29,25,GGCGAGGTAGTAAAGATCCA,4,1185742
fldAp,2.6153846153846154,92,25,GGACGTCTAGAATCTGGCGT,67,1153817
fldAp,0.07692307692307693,26,25,GCTTTACCTACACCAGTTTA,1,1128896
fldAp,4.115384615384615,131,25,GCGTTTTCCGCCGCTACACA,106,1113947
fldAp,1.4615384615384615,62,25,GCGGAAGTCCGGGCTCATAT,37,1092343
fldAp,1.6538461538461537,67,25,GCGCTCTTGCTAGGTTTGGG,42,1125960
fldAp,0.9230769230769231,48,25,GCGACATATAGTAGCGATCT,23,1142587
fldAp,1.8076923076923077,71,25,GCCGGAAGCCTAATTGTAGG,46,1123321
fldAp,0.6538461538461539,41,25,GCATACACAGGCAAATACTC,16,1118177
fldAp,4.153846153846154,132,25,GAGTAATCCACTGACAGCCA,107,1145224
fldAp,1.1153846153846154,53,25,GAGCCGAGTTTGTTTTCATG,28,1137348
fldAp,5.461538461538462,166,25,GACCAGCCGTACACGATTTT,141,1132518
fldAp,1.4230769230769231,61,25,GAAAGGACACGGAGTAACTG,36,1167435
fldAp,2.8846153846153846,99,25,CTGGTTGGGTAACCAGCAGG,74,1179534
fldAp,0.8846153846153846,47,25,CTGGTAGCAGTAATAGTCGG,22,1071901
fldAp,10.961538461538462,309,25,CTCACCCCGGGAGGGAGATT,284,1066624
fldAp,3.3461538461538463,111,25,CTAGTCGGGACGGGTGGGAG,86,1064282
fldAp,0.8846153846153846,47,25,CTAAGCATCGGGAACGACAC,22,1169442
fldAp,0.7692307692307693,44,25,CGTTGAGGTTAAGCGGCGAT,19,1107555
fldAp,0.07692307692307693,26,25,CGTTCACTTTTCCCCAGTGA,1,1137128
fldAp,1.2692307692307692,57,25,CGGTGGGCAATCGGGCCAAC,32,1104085
fldAp,1.4615384615384615,62,25,CGGGTTAATACCACCGGCAT,37,1156962
fldAp,0.4230769230769231,35,25,CGGGAGGGGGTTTTAAAAGG,10,1085443
fldAp,0.7307692307692307,43,25,CGGCTTTTCGCATCGATGAT,18,1114964
fldAp,0.07692307692307693,26,25,CGGCAGTGACACTGCGAAGA,1,1160142
fldAp,3.0,102,25,CGCTTATTGAAAGTCACCTC,77,1106065
fldAp,0.07692307692307693,26,25,CGCTGTCACTGCTTATTTAG,1,1162946
fldAp,2.923076923076923,100,25,CGCTGGATCGGCGGCGGGCT,75,1079711
fldAp,1.3076923076923077,58,25,CGCTCACCTTCCCTAAGGTA,33,1092318
fldAp,1.1153846153846154,53,25,CGAGTTACTACCTCAACAGT,28,1079803
fldAp,0.8846153846153846,47,25,CGACAATCATATCTCGGGAA,22,1078148
fldAp,0.07692307692307693,26,25,CGAAGTTTTGTACAGAGTTG,1,1092220
fldAp,1.1538461538461537,54,25,CCCTTATACCCTCTTACACT,29,1099474
fldAp,3.076923076923077,104,25,CCCTTAGCCGAGTTACAGAA,79,1095521
fldAp,0.6923076923076923,42,25,CCCGACGCCGGATTCTGAAC,17,1120062
fldAp,1.0769230769230769,52,25,CCCCGTCATTTACGGGGGTT,27,1159975
fldAp,4.1923076923076925,133,25,CCCCAACGGTAACACATCGC,108,1082285
fldAp,0.9615384615384616,49,25,CCCACCTTATGTCCTTTGCT,24,1152296
fldAp,1.1538461538461537,54,25,CCCAAGTTGGACCAGGCAAT,29,1118537
fldAp,2.8846153846153846,99,25,CCCAAAGCATGTACGCGCCT,74,1178603
fldAp,3.730769230769231,121,25,CCATCGAGTTCAAGATAGTA,96,1141729
fldAp,0.07692307692307693,26,25,CCATATCAGATATATCGAAG,1,1091896
fldAp,2.1923076923076925,81,25,CCATAAGAGTAGGCCTGTGG,56,1080156
fldAp,13.615384615384615,378,25,CCACGTGTGCCACGGAGATA,353,1073368
fldAp,1.6153846153846154,66,25,CCAATTCAGCCTGAATAAAT,41,1159199
fldAp,1.2307692307692308,56,25,CATTCGGTGTTTAAATTCAT,31,1076828
fldAp,0.5384615384615384,38,25,CATGAGGGGCGCCCTGCATT,13,1166618
fldAp,4.961538461538462,153,25,CAGCTAGCTTTGAATTTCCT,128,1102356
fldAp,0.07692307692307693,26,25,CAGCGTCTGTTACCGGCCTA,1,1083438
fldAp,2.5,89,25,CACTCCTTGGGCAGGGAGAA,64,1151743
fldAp,0.07692307692307693,26,25,CACATGTTCTCATATCGTAG,1,1110519
fldAp,2.6153846153846154,92,25,CACAAGTGACATGCCTGGGG,67,1115478
fldAp,1.7692307692307692,70,25,CAAGCGAAGTACGTATCCGT,45,1139032
fldAp,1.3076923076923077,58,25,ATTCATGCCTCGACTGTTGA,33,1159403
fldAp,1.0769230769230769,52,25,ATGATCTCAGTTGGGTCATA,27,1171448
fldAp,1.0384615384615385,51,25,ATCGACTAATTTTTTATTCC,26,1115304
fldAp,0.07692307692307693,26,25,ATATGCTGCAAAAGGTATAG,1,1126830
fldAp,0.6538461538461539,41,25,AGTTGAGTCGAACCAGTGTA,16,1176061
fldAp,0.23076923076923078,30,25,AGTTCTCCCTCATGCGTCCG,5,1140965
fldAp,1.5384615384615385,64,25,AGTATGCAACGGCCGGGTGG,39,1151546
fldAp,3.5,115,25,AGGGGCATTTACAACCGTGA,90,1090699
fldAp,1.2692307692307692,57,25,AGGAACTTTGCAATGGAATC,32,1137284
fldAp,1.3461538461538463,59,25,AGACGGGATGGTACGCGGAT,34,1128345
fldAp,2.1538461538461537,80,25,ACCATTCTGGGCATGAAAGT,55,1136662
fldAp,1.6923076923076923,68,25,ACCATAAGAATGAGCCGGTG,43,1152010
fldAp,1.8076923076923077,71,25,ACCAAGGGGCGCCAGAGTTT,46,1103333
fldAp,1.5769230769230769,65,25,ACATATGCCTGCTACTCGTA,40,1117302
fldAp,1.7692307692307692,70,25,ACAGAAGCGCCCGAGGTGGT,45,1131950
fldAp,0.8076923076923077,45,25,ACACCACTGCTAAGTTCTCA,20,1105562
fldAp,0.6923076923076923,42,25,AATGTCGCGCCCGTTAATAC,17,1103877
fldAp,3.1538461538461537,106,25,AATACCCGTGACTAGCTTAG,81,1170782
fldAp,0.6153846153846154,40,25,AAGTTCCGCGGTAATTACAA,15,1130597
fldAp,2.1538461538461537,80,25,AAGTCTTTGTCTGTTAGGTC,55,1076653
fldAp,2.3461538461538463,85,25,AAGTCGTTCACAAATCCGAG,60,1085510
fldAp,0.07692307692307693,26,25,AACGCATATCTTTTATATGG,1,1134781
fldAp,4.6923076923076925,146,25,AACACCAAAATACGCTCAAC,121,1086837
fldAp,0.56,37,24,TTTCCTGTCGAGTTTCGGAT,13,1156644
fldAp,1.0,48,24,TTGTTTCAGTGAGTTCAAGA,24,1168083
fldAp,1.88,70,24,TTGTGGCACAAACCGCATAT,46,1110032
fldAp,0.12,26,24,TTGTAAGCTCCACACCGGTG,2,1104599
fldAp,0.76,42,24,TTGCAGTGGTTACGGACCAT,18,1093218
fldAp,3.84,119,24,TTCGCCCGCCTAATTTATGG,95,1118885
fldAp,0.08,25,24,TGTGAAGAGCAACGGACCCC,1,1136826
fldAp,1.36,57,24,TGGTGATAAACCCAGGGACA,33,1129913
fldAp,1.04,49,24,TGGTAGCTATCGATTAAAAT,25,1125958
fldAp,1.52,61,24,TGGCCATCAGCATGCGGCGT,37,1123419
fldAp,1.28,55,24,TGAACAGAGGCGCAATGATC,31,1104693
fldAp,1.16,52,24,TGAACAAGGCAGCAGGACCT,28,1182605
fldAp,1.0,48,24,TCTCCCATCAATGTTGCAGG,24,1174156
fldAp,5.04,149,24,TCTACTAAAGTACATACGCA,125,1098726
fldAp,2.52,86,24,TCGAACGCGTGTTAGCTGCC,62,1103710
fldAp,0.12,26,24,TCCGTTTGGCCGTCTAGTGC,2,1149151
fldAp,0.4,33,24,TACAAGCCGCTATGCGGCAG,9,1091347
fldAp,3.0,98,24,TAATGCGTCACCCCGCTACG,74,1064676
fldAp,12.16,327,24,TAAGATGCCGTTCGAAACTT,303,1119146
fldAp,1.4,58,24,GTTAGTAACCCGGATTTGTA,34,1084637
fldAp,2.6,88,24,GTCAGTACGTAGTCGTTCTC,64,1088231
fldAp,1.84,69,24,GTATGCTAACTAGCTCACGG,45,1088069
fldAp,1.44,59,24,GTATACTTTCATCCCTTTTA,35,1076155
fldAp,0.08,25,24,GTAGTCATGACATACGGCCA,1,1094586
fldAp,0.12,26,24,GTAGTCAGGGCTAGCGATCT,2,1090445
fldAp,1.52,61,24,GTACGTAGTGCGAGCAAGGT,37,1105934
fldAp,0.56,37,24,GGTTACCGCCCTGGAGGGAG,13,1177122
fldAp,1.28,55,24,GGTCGAAACGTTTCCGCGAT,31,1117018
fldAp,0.52,36,24,GGTAAGGTGAGGTATCGCCT,12,1139947
fldAp,3.92,121,24,GGGTGTTCGGGGCGGAAATA,97,1168950
fldAp,0.96,47,24,GGGGTTTTAGTGGGCACGGA,23,1092465
fldAp,0.64,39,24,GGACCGGCTTTAGGAACACA,15,1104328
fldAp,1.04,49,24,GCTTAGTAATTTTATAGGTT,25,1068335
fldAp,0.8,43,24,GCTCCCCCATGGGTATTAAC,19,1136700
fldAp,1.4,58,24,GCGGCAAAAGTCTCGGTTGC,34,1122160
fldAp,2.24,79,24,GCGCCTAGGAACATTCAGCC,55,1138839
fldAp,0.12,26,24,GCGAAAGCCGTATTAAGTAC,2,1100213
fldAp,0.08,25,24,GCCTGATAAGAACTTGCAGG,1,1116405
fldAp,1.92,71,24,GCATGAACACGCTCACCGAG,47,1080701
fldAp,5.32,156,24,GCACGATCGGGTCCCACGTC,132,1174296
fldAp,1.24,54,24,GCACACTTGCCGCGAATTTC,30,1128363
fldAp,3.52,111,24,GCAATTAATTGGTCTGTGAT,87,1063471
fldAp,1.72,66,24,GATTTTGGCTTCTCTCGTTC,42,1131668
fldAp,2.16,77,24,GATTAGCAAACGAGATTCGA,53,1130671
fldAp,2.08,75,24,GATAAGATAGGGTGAGGAAG,51,1067616
fldAp,1.56,62,24,GAGCCACCTGCGCGGCTCTC,38,1108098
fldAp,0.08,25,24,GACCACTCTTGGATCCTGTA,1,1140325
fldAp,1.48,60,24,GACAAAAACCTCGTGGCCTT,36,1113951
fldAp,1.6,63,24,GAAGATCAGTGGATCAACGG,39,1129966
fldAp,0.96,47,24,CTTGCAGGTGTTTGGGGCCT,23,1114491
fldAp,0.88,45,24,CTTCGTAACGTGCGCGTTTA,21,1074522
fldAp,1.84,69,24,CTGTGAAGTGTACAATATTA,45,1154699
fldAp,0.76,42,24,CTGGTTACCATGATTTATCG,18,1114659
fldAp,4.36,132,24,CTGGCCCGCTGCACAGCGAT,108,1168947
fldAp,0.08,25,24,CTCGCTGGTGGTGGCACCAG,1,1133815
fldAp,0.2,28,24,CTCATGGCTATCTTCAGAAG,4,1163206
fldAp,0.08,25,24,CTCACACGACGATCTTAGAC,1,1149661
fldAp,0.28,30,24,CTAGGGGCGATAGTAAAGAC,6,1168707
fldAp,1.96,72,24,CTACTCAGGGTATATCTTGG,48,1114528
fldAp,6.92,196,24,CTACCAAAGACGCCGCCCAA,172,1109061
fldAp,0.64,39,24,CTACAAAACACGAGTAAGCC,15,1122924
fldAp,0.12,26,24,CTAACTTACGGCTTCAGAGG,2,1111137
fldAp,5.64,164,24,CTAACAATAGGGCAAGTGTA,140,1073834
fldAp,0.72,41,24,CGTTCTGAGGTTTGAAATGA,17,1136335
fldAp,0.6,38,24,CGTGAATTTGGCGGGGGTCA,14,1085102
fldAp,0.48,35,24,CGGTAGGTGAGGTCCTTTAG,11,1157610
fldAp,1.08,50,24,CGGATCGAGTATGATAAATA,26,1088733
fldAp,0.08,25,24,CGCGCTTTTGGTTCTTGTGA,1,1084697
fldAp,0.84,44,24,CGCGATATGGATGAATCCCT,20,1111854
fldAp,0.08,25,24,CGCAATCGTAACGGTTCGGG,1,1082426
fldAp,1.0,48,24,CGACCATCGGTTGGACTTAT,24,1143046
fldAp,0.08,25,24,CCTATACTCCTATATACCCC,1,1118907
fldAp,1.44,59,24,CCGTTAACGCTGTACTTCTC,35,1176121
fldAp,0.44,34,24,CCGTGCCGTGAGTTTAAGCG,10,1169159
fldAp,1.2,53,24,CCGGAGCCGCTAACCTACGA,29,1144235
fldAp,1.48,60,24,CCCGGAGTCACTGACGAGTG,36,1134898
fldAp,0.92,46,24,CCCGAGGTGCGGTTACACGC,22,1099351
fldAp,1.76,67,24,CCACACCAATGCGTAAATGT,43,1166673
fldAp,1.88,70,24,CATGGGTCATATTTAGCCGA,46,1069497
fldAp,1.12,51,24,CATCGAGGAGTGAAGCGGTC,27,1111342
fldAp,0.08,25,24,CAGTGTTCGGCGCTTTGGGG,1,1087698
fldAp,0.12,26,24,CAGATCGAGGACGTGGCACC,2,1143648
fldAp,0.56,37,24,CAATGATACAGCGTGGAATC,13,1094810
fldAp,1.08,50,24,CAAGTCATATAACCCCATCC,26,1154531
fldAp,1.56,62,24,ATGGCTGATTATACTGGGAC,38,1064471
fldAp,2.24,79,24,ATGGACACCCTGGCTAACAC,55,1103721
fldAp,2.68,90,24,ATGAGTACATGGGGCACGAC,66,1069884
fldAp,1.04,49,24,ATGACAGCGATCTGGTTTGG,25,1139038
fldAp,1.04,49,24,ATCGTCTATTGACTGCCCGA,25,1114481
fldAp,1.64,64,24,ATATACGGCGTATTAAGTGC,40,1109520
fldAp,0.08,25,24,AGGGGACCGGTCCTATTTGT,1,1077759
fldAp,1.76,67,24,AGGCCGAATATAGCCCGGCC,43,1113793
fldAp,0.36,32,24,AGGAACGACTCGGTACGATC,8,1107768
fldAp,0.96,47,24,AGCTTACTGTCCGCGGGGTG,23,1074946
fldAp,0.68,40,24,AGCGGACTGATGTTAAGTGA,16,1071681
fldAp,1.88,70,24,AGCCCAGTCCAGGGCTAACT,46,1146483
fldAp,0.56,37,24,AGAGGCTACCAGGAGCGCTA,13,1093209
fldAp,8.28,230,24,AGAATCTATTACCGAAGGCA,206,1116471
fldAp,4.4,133,24,AGAAGATTGGCTCCCAGCCA,109,1077580
fldAp,0.4,33,24,ACTTTCGGGAGCGTGGATTT,9,1157284
fldAp,0.56,37,24,ACGTGTGTTTTGGCCTCAGC,13,1103834
fldAp,4.12,126,24,ACGGCTGCGTCTGGCGCTTC,102,1109304
fldAp,2.04,74,24,ACGCTATCGTTTTTCTAGGG,50,1126098
fldAp,1.32,56,24,ACGAGATCTGAACCGGAATA,32,1093429
fldAp,2.6,88,24,ACGACAGAAAAATTAGAAAT,64,1105309
fldAp,1.16,52,24,ACCGATGTTTCCGGGGCCAA,28,1110272
fldAp,0.44,34,24,ACATACCGTCCTATGCTCCT,10,1136609
fldAp,0.12,26,24,AATTGTAAGGAATGGGACGA,2,1154605
fldAp,1.08,50,24,AATATTAACGGGCTATTTTC,26,1072294
fldAp,1.92,71,24,AAGTAGGACTTAAACTCCTT,47,1146582
fldAp,1.24,54,24,AAGGTTCCGTTTCTCAAGGG,30,1077316
fldAp,0.64,39,24,AAGCGCACGGCACTGGCTCT,15,1150681
fldAp,3.92,121,24,AACTAAATTCCAACGATATC,97,1095506
fldAp,5.8,168,24,AACGCGGCAAACTTGATCGC,144,1066609
fldAp,1.16,52,24,AACCATACTCAGCGTGGCTT,28,1176494
fldAp,0.08,25,24,AACAATTATGTCATGAATGA,1,1114759
fldAp,0.84,44,24,AACAACTGTCATGAACGCAA,20,1165848
fldAp,2.0,73,24,AAAGCTCCTAAACCTGCTTA,49,1151258
fldAp,1.72,66,24,AAACTGTTTAAGACTAAGGT,42,1089394
fldAp,0.08333333333333333,24,23,TTGGAGTAGCCATTAAGCTT,1,1140672
fldAp,1.625,61,23,TTCTGCGTGCCTTTGACTAG,38,1167643
fldAp,1.125,49,23,TTCGTGCGCGTATCTATATC,26,1069506
fldAp,2.875,91,23,TTCGGTCGTGAGCCACCGAT,68,1136317
fldAp,0.2916666666666667,29,23,TTCGGGCTATACAATTGCTA,6,1152074
fldAp,1.1666666666666667,50,23,TTATCACCATCCTGTTGACT,27,1114743
fldAp,0.16666666666666666,26,23,TGTTCCTAGGCTCGGGGCTG,3,1105743
fldAp,2.4166666666666665,80,23,TGTAGACGACACCAAGTTGT,57,1076993
fldAp,1.375,55,23,TGGTCCCTGGTCAACTAAGA,32,1073978
fldAp,0.08333333333333333,24,23,TGGGCTATAGTACATGGCAT,1,1112181
fldAp,1.2916666666666667,53,23,TGGACGACAGTCTCTGCCTT,30,1094230
fldAp,1.625,61,23,TGCTGTGCAAATTATCACAC,38,1176629
fldAp,1.7083333333333333,63,23,TGCTAGCTTCGGTTACATGA,40,1149538
fldAp,0.7916666666666666,41,23,TGCATCGCCAGGGTTGTGGC,18,1179272
fldAp,1.375,55,23,TCGTAGTAACCACGTGGAAA,32,1094808
fldAp,2.0416666666666665,71,23,TCCACGTTAGTCTGTGATGT,48,1100773
fldAp,1.125,49,23,TCAAGAAGTTTGAGAGGCCT,26,1162921
fldAp,2.1666666666666665,74,23,TATTTTCGCTAGACAAGATC,51,1103186
fldAp,0.4583333333333333,33,23,TATTTTATCAAGTAGACTGA,10,1143313
fldAp,2.0,70,23,TAGGGTTATACGATTAGCGT,47,1112391
fldAp,0.08333333333333333,24,23,TACTCAGCATTTTTCTCCCC,1,1129738
fldAp,6.208333333333333,171,23,TACAGGCTGCTCCCACCAAA,148,1084450
fldAp,1.8333333333333333,66,23,TACACTTGTGGGTCACCAAA,43,1156357
fldAp,0.3333333333333333,30,23,TAAGGACAGCACGCCGACAC,7,1066103
fldAp,0.4166666666666667,32,23,TAACAAAGTACGAAGACCTT,9,1138184
fldAp,0.08333333333333333,24,23,GTTTTGGCCCACCCGGATCA,1,1149641
fldAp,1.2083333333333333,51,23,GTTTAGCCTACTCACTCTGT,28,1178774
fldAp,1.4166666666666667,56,23,GTTAGCTTCGATGATGGAGA,33,1166198
fldAp,0.20833333333333334,27,23,GTCTTCCTGCATGGAACGAG,4,1154496
fldAp,0.6666666666666666,38,23,GTCAGAGAGTCTGTGGATGC,15,1136657
fldAp,1.875,67,23,GTATCGCGGGATGGCAATTC,44,1142652
fldAp,1.875,67,23,GTATACTACTCGGCCTGATG,44,1183465
fldAp,1.5416666666666667,59,23,GTAGACTGTCTGTAGTGGTA,36,1074356
fldAp,1.75,64,23,GGGGGTGTACGTTACTGGTA,41,1132309
fldAp,2.2916666666666665,77,23,GGGCTGCCAAAAGCCCGTTT,54,1109702
fldAp,1.5833333333333333,60,23,GGATTGATGGGTTTACTAGC,37,1073532
fldAp,0.8333333333333334,42,23,GGAGATGCGCCCTTATCACG,19,1115820
fldAp,1.4166666666666667,56,23,GCTTGATTTGCGCAGATAGG,33,1157011
fldAp,1.0,46,23,GCTGTTGGACCTGGTCGCGA,23,1094995
fldAp,5.375,151,23,GCTGTATCGCACTTGTCCAT,128,1072401
fldAp,1.5833333333333333,60,23,GCTCTCCTTCTACGCACACC,37,1179983
fldAp,3.25,100,23,GCTCCTCTGGGCCGGGTCTC,77,1082844
fldAp,1.8333333333333333,66,23,GCTCCGTCATTAGATGCGAT,43,1063473
fldAp,0.08333333333333333,24,23,GCGGTCTGAAAGCCATGGTT,1,1143037
fldAp,3.2916666666666665,101,23,GCATTATAAGATCTGAAACA,78,1180160
fldAp,0.7083333333333334,39,23,GCATCTTATAGTTCGATATG,16,1122902
fldAp,1.1666666666666667,50,23,GCAGGGGCCTTCTGTATCAG,27,1087785
fldAp,0.9583333333333334,45,23,GCAGCAGATCCCCAATTTAT,22,1137951
fldAp,1.0,46,23,GATGCCGATCAGCTGAGATA,23,1132233
fldAp,1.2916666666666667,53,23,GAGATTTGAATCCCCGTTTA,30,1128726
fldAp,4.833333333333333,138,23,GAGAAAATGAGCTTGGCACG,115,1166692
fldAp,0.08333333333333333,24,23,GACTCATGGCCTTTCTTTAA,1,1125879
fldAp,5.041666666666667,143,23,GACGCCATTAGTCCCGATGT,120,1175857
fldAp,2.25,76,23,GACCCCCCAGCACCTTGAGT,53,1093375
fldAp,3.5833333333333335,108,23,GAAGCGGTCGCTGGTACAAC,85,1141432
fldAp,2.4166666666666665,80,23,CTTGACCTACCCGAGAAATC,57,1167168
fldAp,1.1666666666666667,50,23,CTTCTCGGCAACTTTAACAC,27,1063197
fldAp,0.9583333333333334,45,23,CTGGTGGTGGCAGTACTCAT,22,1096998
fldAp,1.0833333333333333,48,23,CTCGCGCCACGCACTACACT,25,1110260
fldAp,1.6666666666666667,62,23,CTATTCTCACCGGTGGATCT,39,1185537
fldAp,0.125,25,23,CTAACCAAAGTAGTCACCCC,2,1151705
fldAp,1.25,52,23,CTAAATTAGACCCCTGTCAT,29,1126738
fldAp,0.7083333333333334,39,23,CGTTCGCTGAAGACTTTAAA,16,1085584
fldAp,2.5416666666666665,83,23,CGTCTGTTAACTCCAGATGG,60,1088232
fldAp,1.0833333333333333,48,23,CGTACTTCTGGGAGTAACAA,25,1105851
fldAp,1.75,64,23,CGGTTCCAGCTAACCAGGGG,41,1141745
fldAp,1.125,49,23,CGGGGCTAATGCTACTTCAA,26,1078926
fldAp,1.5,58,23,CGGCGTCGCTAAGTGAGATA,35,1085158
fldAp,2.0,70,23,CGCTAGGTTCCGGATTACCC,47,1153795
fldAp,1.9583333333333333,69,23,CCTTTAGTGAAGCTCGGTTA,46,1071666
fldAp,2.3333333333333335,78,23,CCGTGTCTAATCTCTGTGGT,55,1115038
fldAp,0.125,25,23,CCGAACCCTTGTTAATCCGT,2,1174510
fldAp,12.791666666666666,329,23,CCCACGTAAAGCGCATCGGA,306,1176933
fldAp,0.75,40,23,CAGTTGGAGGAACCCCACAC,17,1091650
fldAp,0.5,34,23,CAGTATTAAAGGGTGTGCGT,11,1099381
fldAp,4.375,127,23,CACCTGCATTGCAGAGTTGG,104,1094203
fldAp,0.4166666666666667,32,23,CACCGGTCCGCTGTTCGCAT,9,1173061
fldAp,0.5,34,23,CAAGTGCGAGGCATTCTAAG,11,1154535
fldAp,2.6666666666666665,86,23,CAACGTGGATCGTCTGGCTA,63,1113546
fldAp,0.7083333333333334,39,23,CAAATTCCTAGGGTTCTACA,16,1112491
fldAp,0.25,28,23,ATTCGCAGCTTGACTGTTTA,5,1069029
fldAp,2.8333333333333335,90,23,ATTCCGCGCTCTGCGTGTGA,67,1076595
fldAp,0.7083333333333334,39,23,ATGGGGTTTTCACCCTCTGG,16,1157115
fldAp,0.625,37,23,ATGGCCTAGTCTGGGTTGTA,14,1159559
fldAp,0.125,25,23,ATGACAAGTTCTAGATATTA,2,1068064
fldAp,1.75,64,23,ATCCTGGGCTACGTTTAGAA,41,1098207
fldAp,3.6666666666666665,110,23,ATACATCTTACACGACAAGG,87,1163428
fldAp,1.2083333333333333,51,23,ATACAATAGTTAAGGGCGGT,28,1161653
fldAp,1.1666666666666667,50,23,AGTCATGGAAGTCAATCTAG,27,1134314
fldAp,0.9583333333333334,45,23,AGCTTATTTGCTGTTTTATA,22,1095615
fldAp,0.16666666666666666,26,23,AGCCCCGGCTCAAACGTCGA,3,1075083
fldAp,2.0416666666666665,71,23,ACTTTGTTATTTTGACTCGA,48,1088993
fldAp,1.0833333333333333,48,23,ACTTGGTTTACGTAGTACGT,25,1079027
fldAp,1.0,46,23,ACTTATATCAGCGCCTGGTA,23,1086693
fldAp,0.20833333333333334,27,23,ACTGGGGCTCAAGTGTCGAA,4,1093444
fldAp,3.5416666666666665,107,23,ACTCATCTTGAAAAGCTGTC,84,1108178
fldAp,1.5,58,23,ACGTCCCACGGGCAATGGTC,35,1133718
fldAp,0.5833333333333334,36,23,ACGTACAAACTACATGAGGA,13,1181076
fldAp,0.9166666666666666,44,23,ACGCAATCCCAGGGCGTGTT,21,1185513
fldAp,0.25,28,23,ACGACTAACACTATGCCTTC,5,1105640
fldAp,0.9583333333333334,45,23,ACCATTGGCATCCGCGCACC,22,1101035
fldAp,0.25,28,23,ACCAGTAGAGTTACCCCATC,5,1097679
fldAp,1.9166666666666667,68,23,ACAGTCCTTCATTCCAGCGG,45,1066742
fldAp,3.5833333333333335,108,23,ACACCTATATATACCTTAGT,85,1121708
fldAp,6.625,181,23,ACAATGAAGACAATTCCTCA,158,1136565
fldAp,6.166666666666667,170,23,ACAAAAGCAGGGGAGTAGGT,147,1127717
fldAp,1.75,64,23,AAGGTCATCCTCCTTGATAC,41,1091555
fldAp,2.3333333333333335,78,23,AACATTTAGTCTCGTTCAGC,55,1145355
fldAp,0.625,37,23,AACATCTAGACGGCAAAGTC,14,1113391
fldAp,0.6666666666666666,38,23,AAAACCCAATGTCTCACCTC,15,1075743
fldAp,3.0,90,22,TTTACGAGGGGTCGTTTCAA,68,1077538
fldAp,3.5217391304347827,102,22,TTGCAGAGTAAATCACCATA,80,1174574
fldAp,0.6521739130434783,36,22,TTCTGCTAGGTACCGCCCGT,14,1092310
fldAp,2.0,67,22,TTCGATGTTATCTGCCCTCT,45,1184686
fldAp,4.391304347826087,122,22,TTATCCGGCAAGGGTACCAC,100,1076414
fldAp,0.08695652173913043,23,22,TTATCCCGGGATATCATTTC,1,1160131
fldAp,0.08695652173913043,23,22,TTATAAGCGGTCTGAAATAG,1,1071049
fldAp,1.565217391304348,57,22,TTACAAAAGACTGTATGAAA,35,1149070
fldAp,1.6956521739130435,60,22,TTAAGCCCGGGTCAAAGCTA,38,1064763
fldAp,1.434782608695652,54,22,TGTTACGTCATGTCGTGTCG,32,1157285
fldAp,2.4782608695652173,78,22,TGTGGGACAGTTTCGCGGTG,56,1141526
fldAp,3.217391304347826,95,22,TGAGTGACACGATTCGGCCC,73,1159902
fldAp,1.0,44,22,TGAACTTCAAAGTTTGTCCG,22,1128540
fldAp,1.3043478260869565,51,22,TCTTAGCCACAGCTCTTACT,29,1088714
fldAp,0.4782608695652174,32,22,TCTCAAGCCCGTTCCATTCC,10,1166461
fldAp,0.08695652173913043,23,22,TCGGTCACTACAGTTAAGCC,1,1149260
fldAp,0.08695652173913043,23,22,TCGCCTCGGGTTCCCTGTTT,1,1167887
fldAp,1.0869565217391304,46,22,TCCTCGAAGGCCAATGACAC,24,1067967
fldAp,2.4782608695652173,78,22,TCCGTGTGTTCCTGAATCTA,56,1070733
fldAp,2.0,67,22,TCCATTGCCCGAGACATACT,45,1114482
fldAp,1.6956521739130435,60,22,TCCAATGGATGAAATCCGTT,38,1152215
fldAp,0.9565217391304348,43,22,TCATGGGTGAGTCAGATTAT,21,1122103
fldAp,0.08695652173913043,23,22,TCAGGTCGATTAATGTTGCT,1,1123732
fldAp,0.9565217391304348,43,22,TCACGTTATGCGCGTGGAGA,21,1097572
fldAp,2.391304347826087,76,22,TCACGGCACAGAGTGGTCTG,54,1108334
fldAp,1.3043478260869565,51,22,TATTAAAATCTGGACACCCA,29,1156958
fldAp,1.1304347826086956,47,22,TAGGGGGGAAGACATTAGTC,25,1076587
fldAp,0.6956521739130435,37,22,TACAGTTAAAGATCTTCGGT,15,1083227
fldAp,10.652173913043478,266,22,TACAGGATAGCCACACGCAA,244,1109320
fldAp,1.9130434782608696,65,22,TACAAACTTGAAGCAGACAG,43,1179447
fldAp,1.3478260869565217,52,22,TAATGTGGAGTGAAACCGCG,30,1168218
fldAp,1.0434782608695652,45,22,TAATAGAACTACATTTGAAT,23,1119663
fldAp,0.391304347826087,30,22,TAATACAGACGTATATAGCA,8,1136313
fldAp,0.13043478260869565,24,22,TAAAGATCAGTGGAGAACGG,2,1109200
fldAp,1.4782608695652173,55,22,GTTTCGAGTTCGAAACCGAA,33,1144633
fldAp,2.4347826086956523,77,22,GTTTAAAGCGACCTTTAGGA,55,1124170
fldAp,1.7826086956521738,62,22,GTTGAATTTTTCGAACTTCA,40,1094485
fldAp,1.391304347826087,53,22,GTTGAAGTGGTAAAGGCCAA,31,1075750
fldAp,0.13043478260869565,24,22,GTGCTGGGAATCTTCTTCTG,2,1086918
fldAp,2.0869565217391304,69,22,GTGCAGACAGTTCGAAGGAT,47,1181944
fldAp,4.739130434782608,130,22,GTCTTGAAATTTGTTAGCTT,108,1137380
fldAp,1.7391304347826086,61,22,GTCAGTTTATAATGAGTAGA,39,1105559
fldAp,2.217391304347826,72,22,GTACAGAACTCCGGTCTACA,50,1161720
fldAp,3.347826086956522,98,22,GTAATATTACATTACACCGT,76,1139142
fldAp,1.2173913043478262,49,22,GGGTTCACAATTCGCCTGCG,27,1169850
fldAp,3.0869565217391304,92,22,GGGCACAAAGACCGTCGGCA,70,1154301
fldAp,0.6521739130434783,36,22,GGGACCGAGTCAGCTAATAA,14,1085977
fldAp,2.8260869565217392,86,22,GGAACATCCCTCGCGATATA,64,1105147
fldAp,1.826086956521739,63,22,GCTTGTATACGTCCACAACC,41,1082636
fldAp,1.434782608695652,54,22,GCTCACCTGAGCCCTACCCA,32,1113443
fldAp,0.9565217391304348,43,22,GCTATTTCCAACCGAAGGGA,21,1146480
fldAp,2.608695652173913,81,22,GCTAATACGAGAAGTCGGTT,59,1158670
fldAp,0.08695652173913043,23,22,GCGGAGGCAATGCCCCATCA,1,1089572
fldAp,2.217391304347826,72,22,GCGCCGTATGCTTATCGAAT,50,1074582
fldAp,1.4782608695652173,55,22,GCATGCGAACTGTACATCAA,33,1070206
fldAp,3.217391304347826,95,22,GCATGCACAGGGTAACGCAG,73,1089812
fldAp,0.13043478260869565,24,22,GCAATGGCACATCGATGTAT,2,1069195
fldAp,1.2173913043478262,49,22,GCAAACGTTCCGAGAGGCGA,27,1071739
fldAp,0.391304347826087,30,22,GATTTAGGGCGGTAAGACCT,8,1131219
fldAp,1.4782608695652173,55,22,GATGTTTTCGTGCTGGCTTT,33,1168816
fldAp,2.9130434782608696,88,22,GATGATTGCTCAAAACCCCT,66,1079237
fldAp,1.6956521739130435,60,22,GATAATGGTACGCCACGTAG,38,1164245
fldAp,1.608695652173913,58,22,GAGTAGTTTTTGGTCACAGT,36,1082288
fldAp,7.521739130434782,194,22,GACTACGAAACTTAGATAGG,172,1084535
fldAp,0.30434782608695654,28,22,GACCTTTATGATAACGCGTT,6,1064691
fldAp,0.21739130434782608,26,22,GACCGTTCATTGCGCGAGCC,4,1149272
fldAp,0.08695652173913043,23,22,GACCCCACCGGTCTCAGACC,1,1067470
fldAp,1.6956521739130435,60,22,GACACTGTAACGTAGTAAAC,38,1151266
fldAp,1.9130434782608696,65,22,GAAGTGGGTATACCTTCGGA,43,1066755
fldAp,3.3043478260869565,97,22,GAAAAGCTTCGTCCATATTA,75,1152299
fldAp,4.478260869565218,124,22,CTTGCACTTAGCCCTGGACT,102,1184749
fldAp,0.9130434782608695,42,22,CTTATTGTCTGCGTTGATTG,20,1081290
fldAp,1.391304347826087,53,22,CTGGGTCATAGGGCCACTTG,31,1086684
fldAp,0.08695652173913043,23,22,CTCGTGTCTAAAGACAAGGA,1,1145622
fldAp,4.043478260869565,114,22,CTCGCTGAGGGAAAGGATGA,92,1131216
fldAp,2.0,67,22,CTCCCGATTAAAGCCCGGAC,45,1063145
fldAp,0.782608695652174,39,22,CGTTAGCGGTTAGTCTTTAG,17,1167399
fldAp,0.6086956521739131,35,22,CGTGAGTACCATAAAGACCA,13,1157450
fldAp,2.9130434782608696,88,22,CGGTACGCCGCTTAAAGCTG,66,1164267
fldAp,0.5652173913043478,34,22,CGGGCGCAAAGTCAAGATCT,12,1121466
fldAp,1.3043478260869565,51,22,CGGAGCGATTAAACCGACCA,29,1091552
fldAp,0.30434782608695654,28,22,CGAGGAGATGGACTTTCCTT,6,1095825
fldAp,0.13043478260869565,24,22,CGACAATTTCTAGCATGCTT,2,1075761
fldAp,1.608695652173913,58,22,CCTTATGGGCGTATGCGTAG,36,1137395
fldAp,0.34782608695652173,29,22,CCTGTTTAGCCCTATCCAAA,7,1137571
fldAp,1.4782608695652173,55,22,CCTATCGATAAGACTTCACA,33,1136767
fldAp,1.0869565217391304,46,22,CCTAGTGCTCTGCTCGGGGG,24,1072063
fldAp,3.4347826086956523,100,22,CCGGCCAGGCGACAACGGAA,78,1122255
fldAp,4.782608695652174,131,22,CCGCCCTGGTTGGGTCTCGT,109,1065385
fldAp,0.782608695652174,39,22,CCGAGCTCGCGCCGCAACTT,17,1160304
fldAp,2.0,67,22,CCGACATGCCCTGCCGAGAC,45,1102969
fldAp,0.6086956521739131,35,22,CCCTTCGGGCCATGAAATGT,13,1096941
fldAp,0.391304347826087,30,22,CCCACAGCTGCTACTTAGAT,8,1080615
fldAp,1.9565217391304348,66,22,CATTTCACTCGACGGAGTAA,44,1110367
fldAp,2.869565217391304,87,22,CATCTTCTCGCAGTTAGCAT,65,1090328
fldAp,0.17391304347826086,25,22,CAGGTCTGTCTTAGACAGCA,3,1157765
fldAp,4.695652173913044,129,22,CAGGAGATGCCGAGCCACGG,107,1179990
fldAp,0.08695652173913043,23,22,CAGCTAAATACTCCTCACGC,1,1115812
fldAp,0.7391304347826086,38,22,CAGCCGGGGATTAAGGTGGT,16,1067937
fldAp,1.8695652173913044,64,22,CACCTCCTTATGGTTAACTT,42,1068393
fldAp,0.6956521739130435,37,22,CACACGGAGACTGACATACA,15,1095065
fldAp,0.08695652173913043,23,22,CAAGCAAATGGTTCGTCGTA,1,1123415
fldAp,0.9130434782608695,42,22,CAACTTGACTGACCTTCTGG,20,1140546
fldAp,3.5652173913043477,103,22,CAACTGCAGGACCTGTTGTC,81,1064453
fldAp,1.6521739130434783,59,22,ATTAGTGTGCTTCCTTGCCC,37,1162288
fldAp,1.0869565217391304,46,22,ATGGGGCAGCGCAGTCCTTC,24,1101181
fldAp,1.0434782608695652,45,22,ATGATATCATAACTACGCCA,23,1160375
fldAp,2.9130434782608696,88,22,ATGAGTTCTATGCTTACCAA,66,1110518
fldAp,1.0,44,22,ATGAGCATGTGGATATCCTC,22,1081696
fldAp,2.260869565217391,73,22,ATCGCTGGCCTTGCTGTATT,51,1118765
fldAp,1.173913043478261,48,22,ATCGATGCCTTGTATGCATG,26,1132994
fldAp,1.2608695652173914,50,22,ATCCTAACTGCTCTGCTAAG,28,1064210
fldAp,1.7826086956521738,62,22,ATCAGTTGAGAGGATCGCGT,40,1126860
fldAp,0.13043478260869565,24,22,ATCACTGAAGAATGCAGTCA,2,1072529
fldAp,1.608695652173913,58,22,ATAATGTGGCGTACGAAAAT,36,1109742
fldAp,0.8260869565217391,40,22,AGTTGGTAAGTACAAGACAT,18,1084035
fldAp,0.34782608695652173,29,22,AGTTCTGGTCCCCCGGGCTA,7,1081297
fldAp,6.391304347826087,168,22,AGTTAATCTCAGACTGATCT,146,1118071
fldAp,1.434782608695652,54,22,AGGGTTCACGGACGCTACGG,32,1087354
fldAp,2.6956521739130435,83,22,AGGCTTCTGCTGGCGTGGAA,61,1115832
fldAp,0.43478260869565216,31,22,AGCTTTACGCAGCGATGTGA,9,1134430
fldAp,1.434782608695652,54,22,AGCTGATAAACCTTGTTGAT,32,1133266
fldAp,2.0,67,22,AGCCGCGCTCGGAGAGTGGG,45,1145185
fldAp,0.08695652173913043,23,22,AGCACCCGTGTTAGAGAACT,1,1114416
fldAp,1.0,44,22,AGATAAGCCAAGAAGGGCAT,22,1172101
fldAp,1.5217391304347827,56,22,ACTTTAAAAGGCCATGGGAA,34,1087236
fldAp,1.0,44,22,ACTGGATCAGGTGCGCGCAT,22,1135739
fldAp,0.8260869565217391,40,22,ACGTTCTCAATCTGCGCTTG,18,1132910
fldAp,0.08695652173913043,23,22,ACGAAGTTGCGCACATGGAT,1,1164943
fldAp,2.217391304347826,72,22,ACCGGGGCATGTTAAGTGCC,50,1090327
fldAp,2.1739130434782608,71,22,ACAGATGGGGAGGGTTTGCT,49,1073502
fldAp,1.6956521739130435,60,22,AATTCGTCTAATCTTTTCCC,38,1165559
fldAp,1.2608695652173914,50,22,AATCTCCGCCACGTCGGTCG,28,1149079
fldAp,0.17391304347826086,25,22,AACGTTATCACGGCCACAGT,3,1123071
fldAp,1.565217391304348,57,22,AAATACTGGTGACGGTTTTA,35,1080087
fldAp,0.7272727272727273,36,21,TTTTCCTCTGTTCCGATTTA,15,1150876
fldAp,0.5909090909090909,33,21,TTTGCACAGTTCAAGTTCAG,12,1102472
fldAp,1.3636363636363635,50,21,TTTCCCCGTGAAATCGTGTG,29,1075237
fldAp,1.0,42,21,TTTCAGGACTCTCGTACTAC,21,1124329
fldAp,2.5,75,21,TTTATCCTGATCCCCCTTTG,54,1174735
fldAp,6.0,152,21,TTGTTAAAGTGGACGCATGA,131,1165278
fldAp,1.0,42,21,TTGTATCTAAGATAGCGTAA,21,1123721
fldAp,1.4090909090909092,51,21,TTGCTGCCTAACTGGCAGGG,30,1102874
fldAp,2.3181818181818183,71,21,TTGACATTTTTTCAATCTAG,50,1129784
fldAp,0.8636363636363636,39,21,TTCCTTTAGACCAGGGTTTT,18,1168347
fldAp,2.5454545454545454,76,21,TTAGCATGCCTGTCAGTTAC,55,1106120
fldAp,2.8181818181818183,82,21,TTAGACGTTACGGTTGGACA,61,1076746
fldAp,1.0,42,21,TTAACGGCCGTTGATTGAGG,21,1077688
fldAp,3.4545454545454546,96,21,TGTTGGGGAGGTCCTGTACA,75,1089508
fldAp,2.3636363636363638,72,21,TGTTCGGACAGGAGTGACGT,51,1101846
fldAp,0.6363636363636364,34,21,TGGCCCGAATTCCCGAGTCA,13,1103373
fldAp,1.1363636363636365,45,21,TGCGGCCCCCTGATCTGCCC,24,1158899
fldAp,1.0909090909090908,44,21,TGCACGTGCACTGCATATGG,23,1171807
fldAp,0.7727272727272727,37,21,TGACTTTCTAGGTGGGAAGT,16,1173539
fldAp,5.045454545454546,131,21,TGACCTTGTTCGCACACTAT,110,1080104
fldAp,1.2727272727272727,48,21,TGAAATCGCTTTGAGTCTGG,27,1154864
fldAp,3.409090909090909,95,21,TCTTCGACAAGAGCGAGCGC,74,1171038
fldAp,3.227272727272727,91,21,TCTGTTTTGCAGGAGATGTA,70,1167213
fldAp,0.5909090909090909,33,21,TCTGTGTCGGTCCGCACGAA,12,1077628
fldAp,3.409090909090909,95,21,TCGTCTAGGATAAGGACATT,74,1136669
fldAp,0.09090909090909091,22,21,TCGGGTGGCGCCGAAATAAG,1,1174015
fldAp,0.8181818181818182,38,21,TCGGGGTCCAAAACAGAACC,17,1097303
fldAp,0.09090909090909091,22,21,TCGGGGCGATGTGAGCGGGG,1,1098566
fldAp,2.5,75,21,TCGACTCGTAGGGGTAACGG,54,1184998
fldAp,1.4545454545454546,52,21,TCCTTTCCGGTCTAACGCGT,31,1081531
fldAp,3.5,97,21,TCCTCCCGACACAAGAATTC,76,1083816
fldAp,1.2272727272727273,47,21,TCCGGGGACAATCAAGGAAC,26,1150217
fldAp,1.2727272727272727,48,21,TCCCGTTGCTTAGCTGCCTG,27,1180906
fldAp,3.8636363636363638,105,21,TCCCGTCCCGCAGAAGGTCT,84,1172154
fldAp,2.0454545454545454,65,21,TCCAACGCTCTACTAGCGAT,44,1178086
fldAp,1.4545454545454546,52,21,TCAAGTCGAGCGTAGCCGTT,31,1076751
fldAp,1.6818181818181819,57,21,TCAACCGCGGGGTGGTCTGT,36,1104139
fldAp,0.13636363636363635,23,21,TATTGTTCGCAGGTGAGGAA,2,1098073
fldAp,0.09090909090909091,22,21,TATTGTACTGTAGGTTAGAT,1,1147250
fldAp,0.09090909090909091,22,21,TATTGCAGGTTTACATCGTA,1,1074642
fldAp,2.5,75,21,TATGGGGTCCTTTACCGCAT,54,1148559
fldAp,0.9090909090909091,40,21,TATATGTGCGGGCCTTGACA,19,1173853
fldAp,0.13636363636363635,23,21,TAGGCATCTCGTCTTCGGCG,2,1084150
fldAp,7.409090909090909,183,21,TACTTGCTCGTTTTGCAATG,162,1109309
fldAp,0.09090909090909091,22,21,TACGCCATTAGGATCCGGTA,1,1072402
fldAp,1.4090909090909092,51,21,TACCATTAGTCACCACACGG,30,1161971
fldAp,0.6818181818181818,35,21,TAAGCACGACTCTTACGATC,14,1097248
fldAp,2.090909090909091,66,21,TAAGATTAAACCGGAACGTA,45,1166544
fldAp,1.1363636363636365,45,21,TAACGGGGTCAACGGTTAAG,24,1090513
fldAp,1.3181818181818181,49,21,TAAAAACCGTGCTTGTAGTT,28,1156298
fldAp,3.772727272727273,103,21,GTGTTTTGATCCGATTTACT,82,1083021
fldAp,1.0454545454545454,43,21,GTGTTTCTTTTAATGCGATT,22,1141410
fldAp,0.13636363636363635,23,21,GTGTTACCAACAAGGCAGGA,2,1151765
fldAp,0.5,31,21,GTGGACCTCGCCGAAGGATT,10,1174305
fldAp,0.9545454545454546,41,21,GTGCTCACCCGGGCGTAAAT,20,1141875
fldAp,2.0454545454545454,65,21,GTCCTATCAGTCTAGTCTCA,44,1110833
fldAp,1.5454545454545454,54,21,GTATTATCTACTAGGACATT,33,1133355
fldAp,1.2727272727272727,48,21,GTACAGGCAGATTTAACATG,27,1151271
fldAp,1.0454545454545454,43,21,GGTGCTTCGCTGTTAATTAC,22,1136090
fldAp,0.45454545454545453,30,21,GGGAATGGTGTCCCTCCGAC,9,1116551
fldAp,0.36363636363636365,28,21,GGCAACCTGAATGGCAAGCC,7,1133537
fldAp,6.545454545454546,164,21,GGATGGCTATTTCTCGCTTC,143,1066746
fldAp,0.5909090909090909,33,21,GGAGCCGCTGCGTTTATCTT,12,1086007
fldAp,2.1818181818181817,68,21,GCTGTTGTACACTAGATCTA,47,1150261
fldAp,1.5454545454545454,54,21,GCTACGGCCGACTACGTTTC,33,1161206
fldAp,3.0454545454545454,87,21,GCTACATCTCGCAGTAAGCT,66,1181649
fldAp,1.0454545454545454,43,21,GCGTACTAAATTAACCCCAT,22,1114665
fldAp,1.4090909090909092,51,21,GCGCTCATTCCCTGGCCGCC,30,1073177
fldAp,0.9090909090909091,40,21,GCCTCAAGAGCCCAGGGCAG,19,1116563
fldAp,1.8181818181818181,60,21,GCCACTTATAAGACGTGGAG,39,1097987
fldAp,4.454545454545454,118,21,GCATATTCAAGATATGAAAT,97,1101983
fldAp,1.9090909090909092,62,21,GATTTGTGCCATTTGGTACA,41,1063139
fldAp,1.8181818181818181,60,21,GATCCCACCTTGGAGCCATT,39,1126719
fldAp,1.3181818181818181,49,21,GAGTCTTGGCCGGAAGTAAC,28,1182990
fldAp,0.36363636363636365,28,21,GACTCGACCGTCTAGGGTAA,7,1134782
fldAp,3.0454545454545454,87,21,GACGGCGAACACACGAATGT,66,1155209
fldAp,1.2727272727272727,48,21,GAATGTTTCCTGTGCACGGG,27,1127017
fldAp,4.318181818181818,115,21,GAACTGATCATGGGAATTCA,94,1163260
fldAp,2.6818181818181817,79,21,CTGTCCTGAGCGTGCGCAAT,58,1079717
fldAp,2.227272727272727,69,21,CTCGGAGATTAGTTCTGAGT,48,1094288
fldAp,0.8636363636363636,39,21,CTCGCAATCAGTGGTTTATT,18,1120694
fldAp,1.9545454545454546,63,21,CTCGATAATAATCAATAGGA,42,1127789
fldAp,0.45454545454545453,30,21,CTCCATGTTGAAATCGCTTC,9,1132968
fldAp,1.5909090909090908,55,21,CTCCAGGATAAGCACAGAGA,34,1135203
fldAp,0.5,31,21,CTAAGAGGCAGATCGAGTAG,10,1087926
fldAp,0.8636363636363636,39,21,CGTTCAGTCTTCCCCAAACT,18,1068548
fldAp,1.3636363636363635,50,21,CGTACGTAATGTTGAGTAGG,29,1150669
fldAp,7.0,174,21,CGGTAAATACGAGTCGTTAA,153,1082589
fldAp,4.090909090909091,110,21,CGGGGATGCATTCCAGGTTG,89,1101283
fldAp,0.4090909090909091,29,21,CGGCTCTGGAAATCTGACCG,8,1183225
fldAp,3.9545454545454546,107,21,CGGCTCCCGGGTACGCAGCA,86,1089386
fldAp,0.13636363636363635,23,21,CGCTATTATTACATTTTGTG,2,1096440
fldAp,2.090909090909091,66,21,CGATTAAGAGGTTCGCGTCT,45,1070591
fldAp,0.09090909090909091,22,21,CGAGTGACGGCAAATGCTTA,1,1137029
fldAp,1.2727272727272727,48,21,CGACTTATGCTTGGTTGGAC,27,1078251
fldAp,0.09090909090909091,22,21,CGACTCTACGAACCGGGCTA,1,1150391
fldAp,5.7727272727272725,147,21,CGACGCTTTTCCCTTGTTCT,126,1174084
fldAp,0.09090909090909091,22,21,CGAAGAGCGGGCCTAAGTAT,1,1068749
fldAp,1.8181818181818181,60,21,CGAACTGGTCTCGGGGTGAG,39,1130516
fldAp,0.13636363636363635,23,21,CCTCTGAAGCGGGGGCTGCT,2,1182490
fldAp,0.13636363636363635,23,21,CCTAAACCGCTGTAATGGTT,2,1067278
fldAp,3.772727272727273,103,21,CCTAAAAAGAACGGTACAAA,82,1179352
fldAp,0.18181818181818182,24,21,CCGGGAAGGGGTTGGGATGT,3,1109362
fldAp,1.5454545454545454,54,21,CCGGCTTTACGTCCGGCCCT,33,1078927
fldAp,0.09090909090909091,22,21,CCGGATTGCCTGGCGGGCTT,1,1068059
fldAp,0.8181818181818182,38,21,CCCGGGTATTTGCCACCAGG,17,1179650
fldAp,2.227272727272727,69,21,CCCCCGTGTGACCACCAGTG,48,1075856
fldAp,2.8181818181818183,82,21,CCCATGAGCAAAAGCTACTG,61,1070806
fldAp,4.363636363636363,116,21,CCCATGAATTAATGGCTTGT,95,1148404
fldAp,1.6818181818181819,57,21,CCCAAGAATCCCTCACCTAT,36,1081113
fldAp,1.1818181818181819,46,21,CCACGTTATGAGCAAGACAG,25,1144481
fldAp,2.090909090909091,66,21,CATTTTGTCCGCCCACAAGT,45,1141734
fldAp,1.1363636363636365,45,21,CATTAACCAGGCCAGGTTAT,24,1085403
fldAp,0.36363636363636365,28,21,CATGAGCAAGGTATAACTCT,7,1119799
fldAp,0.7727272727272727,37,21,CACACGGATTGTCCTAATGC,16,1082618
fldAp,1.7727272727272727,59,21,CACACCAGAACTCTCGCTGA,38,1107985
fldAp,0.8636363636363636,39,21,CACACACACGGAAGATGCCA,18,1143482
fldAp,1.0909090909090908,44,21,CAAGCTTTGGCCCGAGTTGT,23,1167776
fldAp,2.4545454545454546,74,21,CAACTGATTGAGCGGAGAGC,53,1134819
fldAp,3.1363636363636362,89,21,CAACAGGAATGGGCCGCTAT,68,1133049
fldAp,1.2727272727272727,48,21,ATTTGCTGGCAGAGTTACCT,27,1099147
fldAp,1.0,42,21,ATTGCCACAACCGTTTAAAG,21,1157932
fldAp,1.1363636363636365,45,21,ATTGACTGAGTTCACCGTGA,24,1103658
fldAp,1.0909090909090908,44,21,ATGTAATGCGGTTGCACAGG,23,1169783
fldAp,1.4090909090909092,51,21,ATGATAGGGGGACATGGGCG,30,1172793
fldAp,1.0909090909090908,44,21,ATCTATTCGGCCAGAATAAG,23,1081109
fldAp,2.1818181818181817,68,21,ATCCTCTAAATAAGAGGTGG,47,1141446
fldAp,2.272727272727273,70,21,ATCCCTGTGCGACGGGGCTG,49,1101129
fldAp,4.7727272727272725,125,21,AGTTTGCTGAGACCCGCTTG,104,1167055
fldAp,0.9090909090909091,40,21,AGCGATCCACCATTCGCAAA,19,1154682
fldAp,1.0,42,21,AGAGGAGCTGCGGTTAGACA,21,1183637
fldAp,3.909090909090909,106,21,AGAGGAAAGAAGTAGAATTG,85,1151681
fldAp,1.3181818181818181,49,21,ACTTTGGACTTAGTGAGGCG,28,1123857
fldAp,1.7727272727272727,59,21,ACTTGTACCTTGGGCTCACA,38,1179906
fldAp,0.09090909090909091,22,21,ACTGATAGTCATGCCGTAGT,1,1131558
fldAp,4.7272727272727275,124,21,ACTCTGGTTGGATCCATTGG,103,1150646
fldAp,2.3181818181818183,71,21,ACGTTTAACAGACGCCAGAT,50,1093880
fldAp,0.4090909090909091,29,21,ACGCACTCATATACGCAGAA,8,1092858
fldAp,1.5,53,21,ACGATGACGCACAAGTTTAT,32,1087832
fldAp,1.2272727272727273,47,21,ACGAATTTACCGCTAGTTTC,26,1094309
fldAp,0.6363636363636364,34,21,ACCTCGTGAATCCCTTATCC,13,1089123
fldAp,1.1363636363636365,45,21,ACCGCGGGAATGTGATCCGT,24,1140274
fldAp,3.0,86,21,ACAGTGTCTTATAAGGTTAT,65,1172119
fldAp,0.8181818181818182,38,21,ACAGGGGACCTCCAACATCG,17,1151644
fldAp,4.090909090909091,110,21,ACACTCCCTGCTCTTCGATG,89,1083926
fldAp,1.1363636363636365,45,21,ACACCTATCATATCCTGCTG,24,1169344
fldAp,3.8181818181818183,104,21,ACAAGATTATTCCCTCTTCA,83,1081847
fldAp,1.7727272727272727,59,21,AATTGTCACAGGCTATTAAT,38,1164351
fldAp,2.6818181818181817,79,21,AATCTACGATAGTCGGTCCC,58,1183449
fldAp,1.6818181818181819,57,21,AATAGTGAGATCGGGTTTAG,36,1173658
fldAp,1.8181818181818181,60,21,AATAGGGTTCTATAGTTTGT,39,1160862
fldAp,0.3181818181818182,27,21,AAGTGGTTGGAACTGCGTAG,6,1152301
fldAp,1.3636363636363635,50,21,AAGTCGTTTCCCGTATGCAG,29,1080261
fldAp,0.6818181818181818,35,21,AAGGAATTGTCACTGCTTGA,14,1181428
fldAp,16.90909090909091,392,21,AAGACACTCCCACTGTATTC,371,1107663
fldAp,0.09090909090909091,22,21,AAAGGTACCAGTCGTAGTAA,1,1151441
fldAp,1.3333333333333333,47,20,TTTGACTACCAGATTCACCA,27,1082031
fldAp,1.4761904761904763,50,20,TTTCACTCCAGGGAAACTGA,30,1142512
fldAp,0.5238095238095238,30,20,TTGCTAGTAAAATTGTTGTC,10,1133850
fldAp,1.4761904761904763,50,20,TTGATGGGTGAGATACATGA,30,1158777
fldAp,1.7142857142857142,55,20,TTCTAGATGCGATCTGTATT,35,1136710
fldAp,0.7142857142857143,34,20,TTCTACGATTAAGACAAGGA,14,1102783
fldAp,5.523809523809524,135,20,TTCCTAACCTATGTACAATT,115,1064090
fldAp,0.47619047619047616,29,20,TTCCCTCCGACAGGGCGGCT,9,1160391
fldAp,2.3333333333333335,68,20,TTATGTATAAGGAACAGTCG,48,1126096
fldAp,0.7142857142857143,34,20,TTATCGCCTCGCCTCTCGAG,14,1142319
fldAp,6.619047619047619,158,20,TTATAAAGTGCTCAGGGCTT,138,1151174
fldAp,0.09523809523809523,21,20,TGTTGCCTCCCGGTGGCTAA,1,1131014
fldAp,1.7619047619047619,56,20,TGTTATATACTAGACGGATC,36,1122706
fldAp,1.380952380952381,48,20,TGTCGCCCTCATACATTCCA,28,1128597
fldAp,1.2380952380952381,45,20,TGTCGAGGACCAATTCCTGA,25,1160846
fldAp,4.809523809523809,120,20,TGTATCTATATTCGTGTTAT,100,1145075
fldAp,1.8095238095238095,57,20,TGGTGTACTGGCGTACGCTT,37,1101187
fldAp,2.380952380952381,69,20,TGGCAATTTTACGGACGGAG,49,1109777
fldAp,2.1904761904761907,65,20,TGGACTTGTTAACCATGCTT,45,1175259
fldAp,0.14285714285714285,22,20,TGCCCCTCAAGTATCTGTAA,2,1131692
fldAp,1.7142857142857142,55,20,TGCCAATTATTGGCTTAGAT,35,1146478
fldAp,1.0476190476190477,41,20,TGACGTCTGCGCGTCTTCCA,21,1076131
fldAp,1.1428571428571428,43,20,TGACACGCGGCATGCTGAAG,23,1083851
fldAp,1.0476190476190477,41,20,TCTTCGAGCGCAAACCTATT,21,1065029
fldAp,1.5238095238095237,51,20,TCTGTCAGCTTGAAAGGAAA,31,1111944
fldAp,1.380952380952381,48,20,TCGTTACTCTCGTATACAGG,28,1140398
fldAp,1.7619047619047619,56,20,TCGGCCCGAGCTTTCCCAGT,36,1139319
fldAp,1.0476190476190477,41,20,TCGGCACCAATGTTAGGTCC,21,1084166
fldAp,0.09523809523809523,21,20,TCGCCGGCGTACGAACCCCC,1,1179545
fldAp,3.9047619047619047,101,20,TCCTTGATGTTACGTCCCTA,81,1182043
fldAp,1.0476190476190477,41,20,TCAGTCTTTATCCTGATTCA,21,1095124
fldAp,1.1904761904761905,44,20,TATGCCGTGCTATGTTTGGG,24,1113637
fldAp,0.7619047619047619,35,20,TATCCTCATCTAAGAGACGT,15,1153565
fldAp,3.3333333333333335,89,20,TATACGGAAAAGGTTATGTA,69,1112554
fldAp,1.8095238095238095,57,20,TAATGTCCCCACTGTTTCAG,37,1098721
fldAp,0.09523809523809523,21,20,TAAAACGAATCGTGTAGTGA,1,1124933
fldAp,7.238095238095238,171,20,GTTTGAGTGTGCGTTACGAC,151,1127121
fldAp,1.8571428571428572,58,20,GTTGTCAGCTTTCGAATTCA,38,1128890
fldAp,0.6666666666666666,33,20,GTTCTGTACTCGTGGTTGAC,13,1103343
fldAp,2.0476190476190474,62,20,GTTAATCTTCTCCGGATAGA,42,1181184
fldAp,1.0952380952380953,42,20,GTGGTGAAGTTCAATTGATT,22,1114148
fldAp,4.0476190476190474,104,20,GTGCAGCGCAAAAGTCCCAG,84,1138648
fldAp,0.8571428571428571,37,20,GTGACGCGGATGGCCCCAAC,17,1155812
fldAp,3.238095238095238,87,20,GTCTGCTTGGACAGGTACGA,67,1080084
fldAp,0.09523809523809523,21,20,GTCGCTCGACGGCTCTTTAT,1,1084989
fldAp,1.380952380952381,48,20,GTATGCATAGTAATACAGTT,28,1108788
fldAp,1.1904761904761905,44,20,GTACCGATGTAGGTCCGTTT,24,1081960
fldAp,1.3333333333333333,47,20,GTAAAGTAGCGCTAAGGGTC,27,1128343
fldAp,0.9523809523809523,39,20,GTAAAAGATCGGGCCTCATC,19,1150038
fldAp,0.42857142857142855,28,20,GGTAAGGAGTTTTGACGAAC,8,1132988
fldAp,0.09523809523809523,21,20,GGGTTACTTTGAACTCTCTA,1,1149892
fldAp,1.6666666666666667,54,20,GGGGGATGTCCCAGAAAACA,34,1080149
fldAp,1.1428571428571428,43,20,GGGAGACCGGAACAAAGAAT,23,1130835
fldAp,1.2380952380952381,45,20,GGGAACGCTTGGATTGAATT,25,1101991
fldAp,2.238095238095238,66,20,GGCTTTATACGCTAGGGGGG,46,1146594
fldAp,1.0952380952380953,42,20,GGCGTGGGGAATTTAGTGCT,22,1170951
fldAp,1.380952380952381,48,20,GGATAGTGGTAAGGGCGGTG,28,1122279
fldAp,15.523809523809524,345,20,GGAAGATTATACAGTTAACG,325,1107668
fldAp,2.619047619047619,74,20,GCTCGGGTTCGGCAAATATG,54,1067550
fldAp,0.23809523809523808,24,20,GCTAAACATAAGTGCACGAC,4,1141228
fldAp,0.09523809523809523,21,20,GCGTGCCACAGGGCCAAAAC,1,1138921
fldAp,1.0476190476190477,41,20,GCGACCGGAATTTTAACGCC,21,1084372
fldAp,0.09523809523809523,21,20,GCGACAAGACATCCGGAAGA,1,1078476
fldAp,0.47619047619047616,29,20,GCGAACATTTTCAAAAACAC,9,1164183
fldAp,2.9047619047619047,80,20,GCCTGTGGCGAGGCATTTAT,60,1164425
fldAp,1.0476190476190477,41,20,GCCGGGATGCCTCGTCACCT,21,1086637
fldAp,9.666666666666666,222,20,GCATTTGTTGGCCAGTTAGT,202,1066273
fldAp,4.523809523809524,114,20,GCATTAATAAGATTTCGATG,94,1145427
fldAp,0.09523809523809523,21,20,GCATCTGCCATTGATATACA,1,1064688
fldAp,1.2380952380952381,45,20,GCAGCGTTTCACGCCTTTAA,25,1123565
fldAp,1.1904761904761905,44,20,GCACTCATGTACTGACAAGG,24,1181003
fldAp,1.5714285714285714,52,20,GATTTGTATGTTCACATTCT,32,1162074
fldAp,1.8095238095238095,57,20,GATTTCGACGGACCGAAAAT,37,1078263
fldAp,0.3333333333333333,26,20,GATCGATAAGGCCACCGGGG,6,1140065
fldAp,0.9047619047619048,38,20,GATATTGCGATCCGTGTTCT,18,1140503
fldAp,1.380952380952381,48,20,GATAGCGGGGCGCATCTCTA,28,1090533
fldAp,1.2857142857142858,46,20,GAGTAGGGGGCAGACACACT,26,1164345
fldAp,0.2857142857142857,25,20,GACCGTATTCTACTCGCCGT,5,1177128
fldAp,0.19047619047619047,23,20,GACATACGAAATCCCGGTAT,3,1076192
fldAp,0.9523809523809523,39,20,GAATTATGCTAGACCAGCAT,19,1085511
fldAp,1.8571428571428572,58,20,GAATCGTACCATTTTTATAG,38,1080676
fldAp,0.09523809523809523,21,20,GAAGCTGGTGCAACGGGATC,1,1143870
fldAp,1.2857142857142858,46,20,GAAACGTTCACCGAGCGTTC,26,1183817
fldAp,1.1428571428571428,43,20,CTGCGGCTGTTGGTTTACCA,23,1171783
fldAp,4.190476190476191,107,20,CTGATCTCGAAGGCCGGAGT,87,1077542
fldAp,0.14285714285714285,22,20,CTCTGAGGTAGCCCCCGGTC,2,1117870
fldAp,0.09523809523809523,21,20,CTAGTTCCCCTGGTCGGTCA,1,1104680
fldAp,0.5714285714285714,31,20,CTAATGATACTGAAACGTGG,11,1144336
fldAp,1.4285714285714286,49,20,CTAACGTGAGCTACAGTGAA,29,1103247
fldAp,3.7142857142857144,97,20,CGTTTTGCGAGATTCAGTCC,77,1106273
fldAp,15.619047619047619,347,20,CGTCGAAATTATTGGCGTGG,327,1109057
fldAp,4.0,103,20,CGGCCCTATAACAATAAGCT,83,1163025
fldAp,1.2857142857142858,46,20,CGGAGCATGGGAATCCCCCG,26,1090695
fldAp,2.1904761904761907,65,20,CGGACTAGAGGGACTCTTAC,45,1122250
fldAp,0.14285714285714285,22,20,CGCGCGAGGTATCCGGCGAG,2,1088096
fldAp,1.0,40,20,CGCCATGGGATAACCAACCT,20,1066745
fldAp,0.09523809523809523,21,20,CGAGTTTCTAATTCCGCGCA,1,1070948
fldAp,3.5238095238095237,93,20,CGAGCTTGATGCACGGGTAC,73,1103958
fldAp,0.2857142857142857,25,20,CGAGCGAAGGTAAGTATTTC,5,1135937
fldAp,5.9523809523809526,144,20,CGAGCCGGGAAGATCTGGCA,124,1111194
fldAp,0.09523809523809523,21,20,CGAAGTAGCTATCACTGCAT,1,1117748
fldAp,1.2380952380952381,45,20,CGAAGAGCAGCGTACGTGTA,25,1136084
fldAp,2.2857142857142856,67,20,CCTGGTTGTGATACCGCCAT,47,1172984
fldAp,0.9047619047619048,38,20,CCTCTGGCAAAGGAAAATCA,18,1083127
fldAp,0.09523809523809523,21,20,CCTCATAAACCACCCGCTAA,1,1116712
fldAp,1.4761904761904763,50,20,CCGGCGTTACTGCTAAAGGG,30,1122470
fldAp,2.7142857142857144,76,20,CCGCCCACGTTGTCGAGCTC,56,1179271
fldAp,0.47619047619047616,29,20,CCGAACCGGTGACTGAGAGG,9,1174821
fldAp,0.09523809523809523,21,20,CCCCACACGGTTAACAATGT,1,1161603
fldAp,3.142857142857143,85,20,CCATTATTAGCGCACAGTCT,65,1172114
fldAp,3.3333333333333335,89,20,CCAGAGCCACGGATGGCGCC,69,1121698
fldAp,1.5238095238095237,51,20,CCACATCATGCGTCTTCCGT,31,1068653
fldAp,0.14285714285714285,22,20,CATCGCTGCATAGACTGTGA,2,1117694
fldAp,1.4761904761904763,50,20,CAGTTCCTTAAAGCTAGGGT,30,1103718
fldAp,1.4761904761904763,50,20,CACTTGAGGACTGCTGGTTC,30,1088006
fldAp,0.9523809523809523,39,20,CACTCTAGGCCCCTCCTGGA,19,1128018
fldAp,3.238095238095238,87,20,CACCTGTTTTTGTCAGGTAA,67,1159317
fldAp,0.5714285714285714,31,20,CACAATTTCTGTACAAGGTT,11,1183600
fldAp,7.142857142857143,169,20,CAATCGGAAAACATATCCAC,149,1172116
fldAp,5.428571428571429,133,20,CAACTGCCAGATCGGATCTC,113,1169128
fldAp,1.7619047619047619,56,20,ATTGGTGTAGCATTGATATT,36,1114409
fldAp,3.9047619047619047,101,20,ATTGCCGACTCTGTGTCCCT,81,1067923
fldAp,0.09523809523809523,21,20,ATTGATACAGTTATGCCCAA,1,1135028
fldAp,4.0,103,20,ATTATTCCATAGGACCCGTC,83,1162367
fldAp,1.619047619047619,53,20,ATTAGCTCGAAGCTCGATAA,33,1092973
fldAp,1.1904761904761905,44,20,ATGGTAAGTCGCACATGGAC,24,1163443
fldAp,0.09523809523809523,21,20,ATGGCCTGGACCGAGCATAG,1,1185926
fldAp,2.619047619047619,74,20,ATGCAGGGCGATCGGAATTG,54,1138043
fldAp,1.619047619047619,53,20,ATGACCGCCCGGCAACACCT,33,1064519
fldAp,2.5238095238095237,72,20,ATCCACGATAATGGTGTATG,52,1171279
fldAp,0.09523809523809523,21,20,AGTGACAATCTCAACTGGAG,1,1161520
fldAp,0.09523809523809523,21,20,AGTCATGTGAATACCCTGAC,1,1162118
fldAp,1.8571428571428572,58,20,AGGGCGAGCCAAGTGTAGCA,38,1149358
fldAp,1.0952380952380953,42,20,AGGATATACCACGGCCGGAG,22,1180192
fldAp,2.4285714285714284,70,20,AGGATACCTCCCCAACTGTT,50,1153591
fldAp,0.9523809523809523,39,20,AGGACCGTCACAGCAGTTGA,19,1083629
fldAp,0.42857142857142855,28,20,AGCGTCGGGGAGACTCTCTG,8,1108618
fldAp,4.523809523809524,114,20,AGCCTGCATCAGTTTAGGGA,94,1144025
fldAp,0.5238095238095238,30,20,AGAGGTTCTAGGCGAACATT,10,1066281
fldAp,0.09523809523809523,21,20,AGAGGGGGAGGCTGGAGGCT,1,1104135
fldAp,3.5714285714285716,94,20,AGAACAGGCCTGGCGGGGGG,74,1148396
fldAp,1.1428571428571428,43,20,AGAAATACCCTCGGAGCTAC,23,1150867
fldAp,2.619047619047619,74,20,ACTCTAGTCTCGGGGGCAAA,54,1067630
fldAp,3.8095238095238093,99,20,ACTAATCACGTCCTTGGCTC,79,1107433
fldAp,2.2857142857142856,67,20,ACCTGCCGGGACGAGGTGCA,47,1084449
fldAp,0.3333333333333333,26,20,ACCGCCAACCATTCCGGGTT,6,1127472
fldAp,1.3333333333333333,47,20,ACCACTTACTCGAGCCCGGT,27,1087551
fldAp,1.1904761904761905,44,20,ACAGGGTTAGTCCACACAGG,24,1099717
fldAp,2.6666666666666665,75,20,ACACTGCGCCCCATTTCTAC,55,1085787
fldAp,3.380952380952381,90,20,ACAATTAGATAAGTGAGATT,70,1114972
fldAp,0.19047619047619047,23,20,ACAATCTGAGCTCGAGATTA,3,1156562
fldAp,1.5238095238095237,51,20,ACAAGTTGTAGTCTAGCTCC,31,1085514
fldAp,2.5714285714285716,73,20,AAGTGGTCCACCACTTACCA,53,1146775
fldAp,2.2857142857142856,67,20,AAGTCTCGCGCCCGCACCTT,47,1139227
fldAp,2.0952380952380953,63,20,AAGGGATGGGGGGTTGTGCC,43,1077959
fldAp,1.7619047619047619,56,20,AACGAGCTCATCTATTACGA,36,1096434
fldAp,0.8571428571428571,37,20,AACGAGATCTGTGTCCACTC,17,1157307
fldAp,0.6666666666666666,33,20,AACCGCAGTACCGCATAAAC,13,1128300
fldAp,0.47619047619047616,29,20,AAATATTCCTGCTGAGTCTC,9,1186524
fldAp,1.619047619047619,53,20,AAACACAATCGACCGGTAAG,33,1076908
fldAp,2.1,60,19,TTTTTATGAAAATGGCTCGC,41,1145879
fldAp,8.4,186,19,TTTGGACTGGATCGGTCTCA,167,1073345
fldAp,0.1,20,19,TTTAAACTGCGAGGCCACAA,1,1101727
fldAp,2.2,62,19,TTGATTTTTCTTGGATCCGT,43,1135562
fldAp,3.45,87,19,TTCGGTAAGCAAAATGTCGC,68,1139136
fldAp,1.2,42,19,TTCGCAAGGCTTTATAATGT,23,1124519
fldAp,0.1,20,19,TTCCTCACCTAGCACAGCGT,1,1170451
fldAp,3.4,86,19,TTAGTGCGATCAGGCGGGGT,67,1120763
fldAp,4.3,104,19,TTACGCTTCGGTCGTCATAG,85,1137658
fldAp,0.15,21,19,TTACCCAAACGTTCACACAA,2,1156493
fldAp,1.3,44,19,TGTGACTCAATAGGGAACTT,25,1094994
fldAp,3.15,81,19,TGTCTCTCAGGCCATTTCGC,62,1069786
fldAp,6.15,141,19,TGTAGACTCGGAACGCTGTC,122,1084563
fldAp,1.2,42,19,TGTAAGAAAGTCCTAAGCTA,23,1075586
fldAp,1.0,38,19,TGTAACTAGCGCTCAGCACA,19,1103552
fldAp,1.75,53,19,TGGGCAACTCTGTAGTCTGA,34,1085122
fldAp,1.85,55,19,TGGGAGTCTCGATCTCCAAT,36,1074205
fldAp,3.3,84,19,TGGGACTGCAATGGGGGAAG,65,1137660
fldAp,0.1,20,19,TGGATAATCTCGATGCGTTA,1,1150045
fldAp,0.1,20,19,TGCGGGTAAGGCCATTTCTT,1,1161968
fldAp,1.6,50,19,TGCAAGCCTGAATAGCTCTG,31,1139143
fldAp,2.2,62,19,TCTCCATCCGCGCAGGGGGA,43,1098580
fldAp,0.15,21,19,TCTACGCCTTGTGTGTTGTA,2,1077112
fldAp,0.1,20,19,TCGCTTCAGAACCTCTACAA,1,1084042
fldAp,0.1,20,19,TCGCCCATCGGAGGGTGGAG,1,1146522
fldAp,2.05,59,19,TCGAGGCGACCCAAGCAAGA,40,1110277
fldAp,1.55,49,19,TCCGTACTTTGGGAAAACGT,30,1155808
fldAp,2.7,72,19,TCCAGACGGCACTTTTCTAT,53,1127284
fldAp,2.6,70,19,TCATTTTCCATACGGCCGTA,51,1129902
fldAp,3.15,81,19,TCATGCTGGAGCCCTCGTTA,62,1149156
fldAp,1.05,39,19,TCACGTGCCAAAAAGCTTTC,20,1105569
fldAp,0.55,29,19,TCAAAGGTCGTCCGCGGGTG,10,1139903
fldAp,2.6,70,19,TATGTTGGATCACCGAACAC,51,1153079
fldAp,1.3,44,19,TATGGGGACATACACAGTCT,25,1167284
fldAp,0.2,22,19,TATAGAGTAAACATTGAAAA,3,1070396
fldAp,10.4,226,19,TACTTCCAAAATCTCAACGC,207,1073330
fldAp,3.0,78,19,TACACACCTGTGGATTACCC,59,1083794
fldAp,2.55,69,19,TAATGCCTGGCCACTAAATT,50,1082876
fldAp,0.1,20,19,TAACCGTAGCGCGCACTCAC,1,1096758
fldAp,0.3,24,19,TAAAAATCGTTGGCATCATG,5,1140102
fldAp,3.3,84,19,GTTCATGGCCACTAGACTGT,65,1082198
fldAp,5.25,123,19,GTTCATCGGTGATAAGAACG,104,1072410
fldAp,1.25,43,19,GTTACGTTATACAGACTAAT,24,1136014
fldAp,3.1,80,19,GTTACGGGCCGCAGTACCGG,61,1180427
fldAp,3.35,85,19,GTTACCCTAGCAGACTCTCG,66,1108142
fldAp,0.1,20,19,GTTAATCGTTCAGGAGGGAC,1,1104072
fldAp,0.1,20,19,GTGGCACAAGGTCAGCTAGG,1,1096810
fldAp,0.9,36,19,GTGCCCGTAACTCCCATAGT,17,1147436
fldAp,1.55,49,19,GTGCCACGCTCCGGACAAGC,30,1123627
fldAp,1.6,50,19,GTCTCGTCAAGGCACTGGGT,31,1186435
fldAp,0.9,36,19,GTAGACTGTCGTCCTTGCGG,17,1090547
fldAp,2.55,69,19,GTAGACCGGAAAAGCCTTAT,50,1185233
fldAp,2.25,63,19,GTAAAAGCCGCCAGTCCACT,44,1180933
fldAp,1.5,48,19,GGTTTTCCTAGGCTGATGAG,29,1106355
fldAp,2.35,65,19,GGTTTTAACCGCTAGTTGCA,46,1148641
fldAp,0.1,20,19,GGTTGTAGGGGGCCTTAATT,1,1077165
fldAp,1.7,52,19,GGTTCTCTGTTGACCGCCCT,33,1156300
fldAp,3.95,97,19,GGTGCACATTCAAAGAGGTG,78,1141133
fldAp,1.55,49,19,GGTCTCTGGTGCCTCCAGGA,30,1115215
fldAp,1.0,38,19,GGGTGTGCGTATCACCCACC,19,1151646
fldAp,1.8,54,19,GGCCTGGTTACGCTCCATGG,35,1124476
fldAp,3.5,88,19,GGAGCCCGCAACCGGATATA,69,1089458
fldAp,3.1,80,19,GCTTGACACGATTTTGTCTG,61,1084379
fldAp,1.8,54,19,GCTCGACGTCTACACATGTA,35,1144931
fldAp,0.1,20,19,GCTAGCGGCTTCCTCCCGCA,1,1107126
fldAp,2.95,77,19,GCTACGTCAGCACTACATTT,58,1113702
fldAp,1.75,53,19,GCGGTCCGTGTAGTCAGCTT,34,1076503
fldAp,3.35,85,19,GCGGCAGAGCATCCTGGTAT,66,1083810
fldAp,1.6,50,19,GCGGAGAGGTAGCGCTTGAG,31,1108144
fldAp,0.85,35,19,GCCACAAGTATCTATGTCAT,16,1142283
fldAp,1.65,51,19,GCATCTTGTCGTTAGCATGT,32,1133058
fldAp,1.3,44,19,GCAGGGCGTAAAAGAAGCGA,25,1081305
fldAp,1.55,49,19,GCACGACCAAATTCCCGCGA,30,1090813
fldAp,1.0,38,19,GCACCCATCTTGTGGTAGGA,19,1123955
fldAp,3.6,90,19,GATTAGAAAGAGCGATACAC,71,1082686
fldAp,1.85,55,19,GAGTTTGCGGGCGTGCGCAT,36,1079740
fldAp,1.5,48,19,GAGCCTTGCTGAGTAACCGC,29,1101851
fldAp,3.4,86,19,GAGATTCAAATGTGCGGGGC,67,1158003
fldAp,2.95,77,19,GAGAGGGCTTATAGGGTAAC,58,1113067
fldAp,6.7,152,19,GACGTGGCTCTCTAACTCCT,133,1121059
fldAp,5.8,134,19,GACCCTTGAAAAGGATAGAG,115,1117060
fldAp,1.2,42,19,GACCAGGGAAACCGCTATTA,23,1088236
fldAp,1.1,40,19,GAATAGCGAGACACAATTCA,21,1093954
fldAp,3.15,81,19,GAAGTGTACTGGGGATTGGT,62,1064786
fldAp,0.25,23,19,GAAGATTGCCGTTCCTCTCA,4,1124044
fldAp,3.75,93,19,GAAATAAGTCCTACGGCCCT,74,1114494
fldAp,3.25,83,19,CTTTCGTGTTTCAACAGGAA,64,1179724
fldAp,2.05,59,19,CTTGATTTGGCGAGCACACT,40,1128523
fldAp,3.15,81,19,CTGTTCGTGTCATCGTCACA,62,1065864
fldAp,6.2,142,19,CTGTAAGTCACGTCAGGGGT,123,1065389
fldAp,1.75,53,19,CTGCCTGCTCCTCACTCGGT,34,1101140
fldAp,0.9,36,19,CTGAGATCATGGGGGATATA,17,1094126
fldAp,2.75,73,19,CTCTCTTGTATCAGGAGCAT,54,1133816
fldAp,1.8,54,19,CTCCCGCACCCGTATATTTG,35,1117749
fldAp,1.7,52,19,CTAGCAAGGCAGCGTTGAGT,33,1115677
fldAp,0.95,37,19,CTAGACAGCTGGAAGAATGG,18,1090183
fldAp,1.65,51,19,CTACTAGGTCTACCCGATGT,32,1140481
fldAp,3.05,79,19,CTAATGCGGGTAACTTCCAT,60,1108167
fldAp,0.65,31,19,CGTGGGCCTAATGCAAGTAG,12,1142798
fldAp,1.45,47,19,CGTGCTGTAAATACCTACTA,28,1161941
fldAp,5.55,129,19,CGTCCTTAGTCCTATATTAG,110,1151995
fldAp,0.1,20,19,CGCGTTGGAACCGAATGGTA,1,1067879
fldAp,1.9,56,19,CGATACGAAAACAAGAAGTC,37,1086065
fldAp,0.1,20,19,CGATAAGTCATGCTATCGAT,1,1084871
fldAp,1.95,57,19,CGAAAGAGGGCGAGAAAAAG,38,1094301
fldAp,0.75,33,19,CCTTTAAATCCTTTTATTGC,14,1081219
fldAp,1.6,50,19,CCACTAAGAGGAGTAAGGGA,31,1122497
fldAp,0.9,36,19,CCAAGCCATTCTCAGTTGGT,17,1080390
fldAp,2.6,70,19,CATTAGCATCTTCAGGAGAA,51,1124248
fldAp,1.6,50,19,CATAGATTCCTTGGATGGTA,31,1137192
fldAp,5.95,137,19,CAGTTTCAGTTCTAAGACCC,118,1153810
fldAp,4.4,106,19,CAGTGTTTCGGACGAATTCG,87,1161831
fldAp,1.85,55,19,CAGTCAACTAACAGAACTAG,36,1077955
fldAp,2.35,65,19,CAGAATCGATTACAAAAAAC,46,1136901
fldAp,0.8,34,19,CAGAAAATACCTACGTATGA,15,1136306
fldAp,0.8,34,19,CAAGCTGAGCGGGGTTTTTC,15,1071373
fldAp,0.6,30,19,CAAGCAGATCCGCTACTGGA,11,1160157
fldAp,1.4,46,19,CAACGAAAGCGAGTTCTGAA,27,1122241
fldAp,1.4,46,19,ATTTGCAGCATGGAACACGT,27,1125684
fldAp,6.8,154,19,ATTGCGCTGTTTATATGGGG,135,1070219
fldAp,4.95,117,19,ATTGCGCCATGCGTAAACAA,98,1136681
fldAp,0.3,24,19,ATTGAATATTTTAACAGGCG,5,1100971
fldAp,0.8,34,19,ATGTTCGCCAAGAAGCCCGA,15,1131573
fldAp,0.15,21,19,ATGGCATGACAGTTAGGTGT,2,1123935
fldAp,2.8,74,19,ATGCCACATGAGCACAATAG,55,1104478
fldAp,0.15,21,19,ATCCCCAGGTGCACAAAGCG,2,1087480
fldAp,3.45,87,19,ATATGCTGCAGCACAACGGT,68,1092018
fldAp,1.2,42,19,ATACGGGGATCCTCCGTCGC,23,1142563
fldAp,0.1,20,19,AGTGTGTCTGTTTCAATGGT,1,1104962
fldAp,5.55,129,19,AGTGAAATCACCAGAACGAT,110,1111356
fldAp,0.15,21,19,AGTAGCTGCTATGGGACTCT,2,1164956
fldAp,2.3,64,19,AGGGTCAGGCACCACTAGAT,45,1169175
fldAp,2.8,74,19,AGGGAAGGCAGAGTCTTAGT,55,1108193
fldAp,0.1,20,19,AGGCTACCGCGAGTCCGGCC,1,1128049
fldAp,1.25,43,19,AGGCCGGACGGCGATTTCCC,24,1160482
fldAp,1.15,41,19,AGGAGGTGTTTTTTGTGCTC,22,1092794
fldAp,2.65,71,19,AGATGCATTGGGGTAACTCA,52,1139546
fldAp,4.5,108,19,AGACTCTTGAGGGGAGCGTC,89,1120418
fldAp,2.25,63,19,ACTTGCACGCGGGCTGATGT,44,1130796
fldAp,1.3,44,19,ACTGTGCTACAAGAATGGTC,25,1080618
fldAp,1.1,40,19,ACTCGTTAGTTCTAAATTAC,21,1130759
fldAp,5.0,118,19,ACTCCGGCTATTACCATATT,99,1159310
fldAp,0.9,36,19,ACGTTATCTGCATACGGCAG,17,1151912
fldAp,1.05,39,19,ACGTCTATGGTACGCAGTCG,20,1159230
fldAp,9.5,208,19,ACGCGTGCCCGAGGACGCAG,189,1146181
fldAp,2.0,58,19,ACGATGCTACCCGGTACTGG,39,1166509
fldAp,4.85,115,19,ACGACTCTACTTCCGGTAGA,96,1149083
fldAp,0.65,31,19,ACCTAAGATGCGGGCGTGTG,12,1147399
fldAp,1.7,52,19,ACCGGACACCTCAGGCGCAA,33,1152019
fldAp,1.3,44,19,ACCCGTAGAACGGGGACCTC,25,1106114
fldAp,0.15,21,19,ACCATGAGCCGCTTTAATGT,2,1138165
fldAp,0.6,30,19,ACATTTGGCTGTTATTCACT,11,1154345
fldAp,0.9,36,19,AATCCCATACCGCTCAAGCC,17,1103706
fldAp,0.8,34,19,AATATTCGAAGGACCACGTT,15,1135219
fldAp,1.25,43,19,AATATTAGCACAATGATAGG,24,1096474
fldAp,4.2,102,19,AATAAGACGTGCGGCTTAAG,83,1077712
fldAp,1.65,51,19,AAGTGATGTCCATACTTCAC,32,1067984
fldAp,0.8,34,19,AAGCGCGCAGTGTAGGATCA,15,1183674
fldAp,1.65,51,19,AAGAGCGATGGGAGGGTATC,32,1122695
fldAp,1.75,53,19,AACTGGTAGGCCGGGAACGT,34,1101987
fldAp,16.65,351,19,AACTGCCTAATAACCTTGTC,332,1145111
fldAp,4.75,113,19,AACGTAACGACCTAGTTCTA,94,1114943
fldAp,0.5,28,19,AAATTGCAGTGTCATATACG,9,1163195
fldAp,1.7,52,19,AAAGTTCGTTCTAGCGTCAT,33,1139273
fldAp,3.0,78,19,AAAAGACACCGGGAGTGTGC,59,1139137
fldAp,1.9473684210526316,54,18,TTTGTAAGCTAGCTCGGGTC,36,1159252
fldAp,4.0,93,18,TTTATTCATCGGATCGTTTA,75,1185180
fldAp,2.1052631578947367,57,18,TTTAGCCATTAGGGCTACTT,39,1077110
fldAp,2.473684210526316,64,18,TTTAACTCGTAAGGGAGGCC,46,1143075
fldAp,9.842105263157896,204,18,TTGGTGCATGACAAGTTTAT,186,1076736
fldAp,3.473684210526316,83,18,TTGGATTTACAGAGACTAGC,65,1144243
fldAp,0.10526315789473684,19,18,TTCTTCCCTAGTACACGGAT,1,1072876
fldAp,0.10526315789473684,19,18,TTCTTAATACGCCTCATGGT,1,1185579
fldAp,1.894736842105263,53,18,TTCGGACGAAACTAAGATTA,35,1084455
fldAp,1.4210526315789473,44,18,TTCACCCTCCGGACCCGATC,26,1129235
fldAp,1.2105263157894737,40,18,TTCACACGGATGGAGCTCTG,22,1116242
fldAp,1.7894736842105263,51,18,TTAGTATTCATTGGACGGCA,33,1136752
fldAp,1.105263157894737,38,18,TTACCAATGCGCTCATTTTG,20,1174069
fldAp,1.3157894736842106,42,18,TGTGCGTATAGAAATGAATA,24,1111264
fldAp,1.894736842105263,53,18,TGTCGCATATCTTCCCAACG,35,1106412
fldAp,1.263157894736842,41,18,TGGGTGTGTCGAAGGGGCGT,23,1063135
fldAp,0.5789473684210527,28,18,TGCTTACTGATCGCCTTCGC,10,1142317
fldAp,0.47368421052631576,26,18,TGCGTGGGTTTATAGACGTT,8,1111549
fldAp,20.0,397,18,TGCGGGGAAGTAACACGCGA,379,1114227
fldAp,5.894736842105263,129,18,TGCAATATTCGAGCACGGAC,111,1127315
fldAp,2.8421052631578947,71,18,TGCAAATAGCGATTGGAACA,53,1156078
fldAp,1.105263157894737,38,18,TGCAAAAAGGTATAGTCTGA,20,1117208
fldAp,1.5263157894736843,46,18,TGAGCGAAAGGCCGGCCGTT,28,1077853
fldAp,2.0,55,18,TGACAATGCTAACAGACATA,37,1139886
fldAp,1.8421052631578947,52,18,TGAATTCTGCCATCGACAAT,34,1074699
fldAp,1.368421052631579,43,18,TCTGTTGGATAAGTATATGT,25,1070394
fldAp,1.2105263157894737,40,18,TCTGACAGATCAGGACTGCA,22,1138878
fldAp,3.1052631578947367,76,18,TCTCGCGGGCCTTGCCGCTG,58,1071658
fldAp,0.10526315789473684,19,18,TCGTCAGCTGCGACTACGTT,1,1085283
fldAp,1.4210526315789473,44,18,TCGTCAAAGTGTGCTCGGTT,26,1084782
fldAp,1.0,36,18,TCCGGACCCGGAGTTCAGGG,18,1074691
fldAp,1.0,36,18,TCCGATGGCTCAAATCGGCA,18,1106936
fldAp,3.0,74,18,TCCCGATCTCCGTTTACGGC,56,1064309
fldAp,4.2631578947368425,98,18,TCATAGAAATCAGGGCAAGA,80,1066040
fldAp,2.1052631578947367,57,18,TCAGGGCGACCAACAGTATA,39,1153922
fldAp,1.8421052631578947,52,18,TATGCAACTAACTGGATAAT,34,1063894
fldAp,1.894736842105263,53,18,TATCAAGGCCCCACCCCCCA,35,1106416
fldAp,0.10526315789473684,19,18,TAGGTCGTCCGGTATCTTCA,1,1149657
fldAp,0.8947368421052632,34,18,TAGCTTTGCACTGGTGCTAT,16,1102774
fldAp,1.736842105263158,50,18,TAGAATTTGTTTAGAAAAGG,32,1178816
fldAp,1.894736842105263,53,18,TAGAACCACTGGTGAACTGC,35,1071385
fldAp,1.736842105263158,50,18,TACCGCCTCTGGACCCGGCA,32,1096253
fldAp,3.3157894736842106,80,18,TACCAGCCATTCCCTTAAAG,62,1108164
fldAp,1.894736842105263,53,18,TAATGAAGACCTGCCCGGAT,35,1158525
fldAp,7.526315789473684,160,18,TAAGTTCAGGGATGCGTTCT,142,1157967
fldAp,1.7894736842105263,51,18,TAAGGGTTTGAGGGAACCCT,33,1135336
fldAp,0.7894736842105263,32,18,TAAGACAATACGACAGTAAA,14,1174174
fldAp,1.368421052631579,43,18,TAAGAAGCGTGGCTGCAATT,25,1144036
fldAp,4.631578947368421,105,18,TAACGCCTACGAATTGGGGC,87,1132495
fldAp,5.473684210526316,121,18,TAAATAGTCGATCAGCTGCT,103,1116973
fldAp,1.4210526315789473,44,18,GTTTTATGCTCCCGCCTCTT,26,1130514
fldAp,1.2105263157894737,40,18,GTTGAGTAGGTCTAGCTTGG,22,1136582
fldAp,0.9473684210526315,35,18,GTTACGTGTTAAGGTCTTAT,17,1137286
fldAp,3.3157894736842106,80,18,GTGTCGGTTTAAAGGTGACA,62,1111532
fldAp,0.8421052631578947,33,18,GTGATGACCATAGGATGTCG,15,1087090
fldAp,1.105263157894737,38,18,GTGAGCCGAAACGGGTATAT,20,1164691
fldAp,1.105263157894737,38,18,GTCTGGGGTGGCCCTCCGAA,20,1113166
fldAp,0.5789473684210527,28,18,GTCGGTAAACTGTGCTATGT,10,1123239
fldAp,1.7894736842105263,51,18,GTCGCTTAGCCGTTTCTCCC,33,1167384
fldAp,1.4210526315789473,44,18,GTCCGGCCGACCGGACAAAT,26,1079628
fldAp,2.8947368421052633,72,18,GTATTTCTGCGGTATATGTG,54,1179004
fldAp,2.473684210526316,64,18,GTATGCTACCAGTACACTCA,46,1144068
fldAp,10.947368421052632,225,18,GTATGACTCGCATTCGCCAA,207,1105886
fldAp,2.4210526315789473,63,18,GTACCTATACCCTGGCCGTC,45,1131138
fldAp,1.7894736842105263,51,18,GGTTGTATCCTTCCAGTCCT,33,1149211
fldAp,1.8421052631578947,52,18,GGTGCTGCACACCCATGGTT,34,1182525
fldAp,1.0,36,18,GGTCTACCTTAGCGCTCTTA,18,1159901
fldAp,0.10526315789473684,19,18,GGTACTCAAGAGAGTCAGAA,1,1153142
fldAp,0.10526315789473684,19,18,GGTAATCGTGAACCTGATCA,1,1123880
fldAp,0.47368421052631576,26,18,GGGGGAATAGCGTTTCCCTT,8,1139547
fldAp,0.631578947368421,29,18,GGGCGCTGATTTTAATGATA,11,1161888
fldAp,2.3684210526315788,62,18,GGCTTGTCAAGCACAGTAAG,44,1161262
fldAp,0.5789473684210527,28,18,GGCGTAATACGTAGTGACCG,10,1072032
fldAp,0.5263157894736842,27,18,GGCCTTGGTTGTGACTAGGT,9,1149013
fldAp,1.6842105263157894,49,18,GGCCCGATGCCAAACGGGAA,31,1101848
fldAp,0.10526315789473684,19,18,GGATAAGTCTCGCTAAGTAG,1,1144892
fldAp,1.4210526315789473,44,18,GGAGGGTCCATAAGTTACAC,26,1088523
fldAp,1.8421052631578947,52,18,GGAGCATTCAAACAGGTGAG,34,1144415
fldAp,0.10526315789473684,19,18,GGAGATGGGCGGGGTTTATA,1,1081211
fldAp,0.10526315789473684,19,18,GGAATCGTAGCCGGTACTCT,1,1186527
fldAp,2.3157894736842106,61,18,GCTTAGGCGCCTAGGGTCAG,43,1146077
fldAp,2.5789473684210527,66,18,GCTCGTAAGGTTGTAACATC,48,1138422
fldAp,0.42105263157894735,25,18,GCTCACACGGACACTCACCG,7,1110040
fldAp,0.5263157894736842,27,18,GCTATACTGCAGTTCGTGTG,9,1065422
fldAp,2.210526315789474,59,18,GCGTTTTCAAGGCAGTCCTT,41,1145447
fldAp,2.473684210526316,64,18,GCGTTTGAACATGCCTATAT,46,1101992
fldAp,7.631578947368421,162,18,GCGTGTAGACAAAACCGCAT,144,1118338
fldAp,1.368421052631579,43,18,GCGAGTAAATTGAGTGTGAA,25,1120936
fldAp,0.10526315789473684,19,18,GCGAACTTCCCATGCGGTCA,1,1178303
fldAp,7.7894736842105265,165,18,GCCTAGACTGGTCAGTTGGC,147,1087482
fldAp,0.5263157894736842,27,18,GATGGTGCATCCGCTCTTAC,9,1065712
fldAp,1.0,36,18,GATAAGGCCATATTAAATGT,18,1126099
fldAp,0.10526315789473684,19,18,GACGAGGATCGCGTTCTGGA,1,1174655
fldAp,1.7894736842105263,51,18,GACCGAGCTAGATTTAGTGA,33,1082232
fldAp,2.0526315789473686,56,18,GAAGCCCTTGTACACAGTCA,38,1137300
fldAp,3.736842105263158,88,18,CTTGGGCACTTCGTCGGCTA,70,1081031
fldAp,0.2631578947368421,22,18,CTTATTGGGGTAGCAGATAT,4,1168150
fldAp,1.263157894736842,41,18,CTGTTCTTTAGGGCAAGGTA,23,1175252
fldAp,1.894736842105263,53,18,CTGGTATCCGGGCCGATCGC,35,1081115
fldAp,1.8421052631578947,52,18,CTGCAAATATAATAACTGGG,34,1082347
fldAp,1.368421052631579,43,18,CTGACTCTAGAGAATGGCTG,25,1083799
fldAp,1.5789473684210527,47,18,CTCTGGACTGTGAAATGCAG,29,1107333
fldAp,1.6842105263157894,49,18,CTCAACGGCCTATGCCGGTC,31,1163876
fldAp,6.2105263157894735,135,18,CTCAAACAACTGCATCAAGT,117,1146401
fldAp,3.0,74,18,CTACTTGGAAGACAAAAAAG,56,1122107
fldAp,1.2105263157894737,40,18,CTAATCGTTCGTGGGGCTCC,22,1186492
fldAp,0.10526315789473684,19,18,CGTCCTTTTGTCATATGGCA,1,1100208
fldAp,2.8421052631578947,71,18,CGTCAATCGGACACGCCCCC,53,1090120
fldAp,6.2631578947368425,136,18,CGTATACTGGTGTCCTGCGT,118,1105474
fldAp,1.5263157894736843,46,18,CGGTGATATTATCAATCCAA,28,1101773
fldAp,3.789473684210526,89,18,CGGTCTTGTCGATACGAGGC,71,1148544
fldAp,0.10526315789473684,19,18,CGGTCCATGTTAGCTTTATT,1,1144981
fldAp,0.15789473684210525,20,18,CGGTACGACCAGGCTGAACT,2,1153607
fldAp,0.6842105263157895,30,18,CGGGCCTATGCTTTGTGATC,12,1072276
fldAp,3.736842105263158,88,18,CGGGCCATGCGCAGTCTTTA,70,1127120
fldAp,0.7368421052631579,31,18,CGGCTCCCCATCGCGAACAG,13,1162217
fldAp,0.47368421052631576,26,18,CGGCTCAAAACCTGGAACTC,8,1103360
fldAp,1.5789473684210527,47,18,CGGACCTCTTTCGGATGTTG,29,1124253
fldAp,1.0,36,18,CGCGTTCGGGTCTTCTGAAT,18,1132629
fldAp,21.94736842105263,434,18,CGATAAGGCCGGAAGTGAGA,416,1126528
fldAp,0.3157894736842105,23,18,CGACCGACCGCATGTTCACA,5,1116098
fldAp,2.789473684210526,70,18,CCTTGTTTGAAAGCATTACT,52,1127322
fldAp,2.8947368421052633,72,18,CCTTGTTTCATGGAGCGCCC,54,1158173
fldAp,2.9473684210526314,73,18,CCTTCCCGGACAATACCGTA,55,1094215
fldAp,1.7894736842105263,51,18,CCTTATGATTCCGTCCGGCA,33,1132117
fldAp,0.10526315789473684,19,18,CCTATTCCCAGGTGCGTCGC,1,1150221
fldAp,1.3157894736842106,42,18,CCTATAGGGTTGCGACCTTG,24,1146300
fldAp,0.10526315789473684,19,18,CCGTTCGTTCTGGATAGGGG,1,1115349
fldAp,2.0526315789473686,56,18,CCGTATCGGATAATGTTTCA,38,1084052
fldAp,2.473684210526316,64,18,CCGGCGCTAAAGTTCATGGT,46,1076826
fldAp,0.5789473684210527,28,18,CCGCGAACGAATGCCGAGAT,10,1151704
fldAp,1.368421052631579,43,18,CCCTTGGACCCCGGTTTCCT,25,1080595
fldAp,3.789473684210526,89,18,CCCTACCAGGAGTTTAACGC,71,1117210
fldAp,1.7894736842105263,51,18,CCCCGGCGTCTATGACGTGT,33,1064280
fldAp,0.6842105263157895,30,18,CCATGAGACGCGCAAATACT,12,1086848
fldAp,2.263157894736842,60,18,CCAAAGATGCCCTCCGAGTT,42,1080082
fldAp,0.3157894736842105,23,18,CATGTCACGATCACCATGAC,5,1080794
fldAp,1.5789473684210527,47,18,CATCGGTCCAATGATTTATG,29,1135010
fldAp,1.105263157894737,38,18,CAGTGGGCTTCTCATTATAA,20,1101747
fldAp,8.736842105263158,183,18,CAGGTCCATTGCATAGTTAT,165,1145069
fldAp,0.10526315789473684,19,18,CAGGACCGCGACAATAATCC,1,1134229
fldAp,2.0,55,18,CAGCGACTGGGCACAAAATG,37,1114570
fldAp,1.3157894736842106,42,18,CACGCTCATATTTAACGGGT,24,1081040
fldAp,2.1578947368421053,58,18,CACGACCTCCGAGAGTGTAA,40,1171917
fldAp,1.368421052631579,43,18,CACCCGAGGTTTCGAAAAAG,25,1131564
fldAp,1.736842105263158,50,18,CACAGATTCACTATAGAGGT,32,1069775
fldAp,3.736842105263158,88,18,CACAAGTAAGATTACAAAGT,70,1066739
fldAp,0.42105263157894735,25,18,CAATGACTTGAGAGTACTCA,7,1068139
fldAp,4.2631578947368425,98,18,CAAGCGTATGAATAGGGTCA,80,1127722
fldAp,2.1052631578947367,57,18,CAAGCAGAAGAACTCACGTG,39,1172094
fldAp,1.736842105263158,50,18,CAAGACTGTGTTTGGAGTAT,32,1114950
fldAp,3.1578947368421053,77,18,ATGTTGATTCCCTTTGTTCT,59,1128784
fldAp,2.789473684210526,70,18,ATGTGTAAAATTATCCAGTT,52,1125205
fldAp,1.4736842105263157,45,18,ATGTAGTTTTCTTGCGATTT,27,1114493
fldAp,2.5789473684210527,66,18,ATGTAGGTTATCAACTGAAT,48,1070307
fldAp,0.8947368421052632,34,18,ATGACTTTTCTGGAACTCGA,16,1139034
fldAp,0.15789473684210525,20,18,ATGACTCGTTCTAAGGCCAG,2,1079246
fldAp,3.3157894736842106,80,18,ATCCCTGTCGGAACGGATAT,62,1136825
fldAp,2.3157894736842106,61,18,ATATGGGTCATGCGTCACGG,43,1166194
fldAp,0.8947368421052632,34,18,ATATCCTATACACCTTCCAT,16,1141929
fldAp,0.42105263157894735,25,18,AGTTTTCACGCAGACCATAT,7,1167076
fldAp,1.105263157894737,38,18,AGTTCCGCTAAAGCATGGCT,20,1086688
fldAp,1.736842105263158,50,18,AGGTCGCGGCAGTATCCTTG,32,1151708
fldAp,4.2631578947368425,98,18,AGGGTCGCATATCAGGGACT,80,1153963
fldAp,0.10526315789473684,19,18,AGCGGGCCTCTTAGCAATCT,1,1184846
fldAp,19.210526315789473,382,18,AGCCTCTCAGTGACGCGACC,364,1066025
fldAp,0.15789473684210525,20,18,AGCCACCGGATCGTGAACGC,2,1100327
fldAp,3.526315789473684,84,18,AGATCTTGTAAGTTCGGGCA,66,1106743
fldAp,12.68421052631579,258,18,ACTGTGGGTGAGTTGGTCTA,240,1107679
fldAp,5.2631578947368425,117,18,ACGGCGGCGGTCAGCGCTAT,99,1081380
fldAp,3.8421052631578947,90,18,ACCCAGTGGTAGCTTACTTG,72,1148560
fldAp,1.6842105263157894,49,18,ACCACCGGGTAGGTGAGGTA,31,1084992
fldAp,2.4210526315789473,63,18,ACACACAACTGATTTAGCGA,45,1097695
fldAp,0.5263157894736842,27,18,ACAACGCGCCGACAAGCTAA,9,1114662
fldAp,0.42105263157894735,25,18,AATTCCGCGTAACTCTTTCA,7,1094817
fldAp,0.10526315789473684,19,18,AATCCTTGCCGTGTAGGGAG,1,1070209
fldAp,2.0526315789473686,56,18,AAGAAATTTCGAGGTCGAAT,38,1144714
fldAp,1.4210526315789473,44,18,AACGTGGGACTGTCGTCGCT,26,1164692
fldAp,0.3157894736842105,23,18,AACCGCGATCTGAGGAATAG,5,1111884
fldAp,1.368421052631579,43,18,AACCCACTGCGTAAGCGCTC,25,1073781
fldAp,4.0,93,18,AACAGGCGCTCGTCAGGGTT,75,1174552
fldAp,0.6842105263157895,30,18,AAATTGTAAACGCTACGGCC,12,1088861
fldAp,1.263157894736842,41,18,AAATTAGCTCGGAGCAAGAT,23,1144971
fldAp,4.5,97,17,TTTGGACGGTGTAACTGATA,80,1124332
fldAp,4.0,88,17,TTTACTGTCTATCGGCAAGA,71,1183486
fldAp,3.7222222222222223,83,17,TTGTTTATCCCTTGAATTTG,66,1119228
fldAp,2.111111111111111,54,17,TTGATTCCGATGCGTCCACC,37,1173460
fldAp,0.16666666666666666,19,17,TTGACCCTGTTCAGCCAAGT,2,1075009
fldAp,0.1111111111111111,18,17,TTCGCAGCGAATACAAGGTA,1,1102528
fldAp,1.3333333333333333,40,17,TTCACTTAAACGTGAGGGTC,23,1175092
fldAp,1.3333333333333333,40,17,TTACCGGAGATGGGGCGTAC,23,1131867
fldAp,2.7777777777777777,66,17,TTACCACTAATCCCTTTCGT,49,1095429
fldAp,0.16666666666666666,19,17,TTACAGTGCCAGCAAAGGGA,2,1084053
fldAp,1.2222222222222223,38,17,TGTGATGTCATTGCAAGCGG,21,1133626
fldAp,1.6666666666666667,46,17,TGTATACGCACGGGAGATAC,29,1169007
fldAp,1.1666666666666667,37,17,TGGTGCTGAGATTACCGTCC,20,1144548
fldAp,1.3333333333333333,40,17,TGGGTTACTTTCGGGCCTCA,23,1181969
fldAp,3.2222222222222223,74,17,TGCGTTTTTGTACCGGATTA,57,1139294
fldAp,3.5,79,17,TGCGTACGGTGCCTGCGAAA,62,1090759
fldAp,1.6666666666666667,46,17,TGCATGGACACCCTCTCCCA,29,1160389
fldAp,1.6666666666666667,46,17,TGCATCCAAGGAAGATCTTT,29,1164429
fldAp,1.5,43,17,TGACCGAGTTGGATCCCATG,26,1071798
fldAp,1.6111111111111112,45,17,TGACCGAATGGCAGTAAATC,28,1125971
fldAp,1.1111111111111112,36,17,TCTTTAGCTCTGCTGACCTC,19,1174080
fldAp,0.16666666666666666,19,17,TCTTTAAAGCCGAGGTGATT,2,1169712
fldAp,0.9444444444444444,33,17,TCTAAAGGGGATAAGGCCGG,16,1186501
fldAp,0.7777777777777778,30,17,TCGTCTGCTCCAATGATATT,13,1158920
fldAp,0.1111111111111111,18,17,TCGTACCGGGTTTCGGCCAA,1,1100727
fldAp,1.2222222222222223,38,17,TCGCGCCTTGATCCCAAAGT,21,1081154
fldAp,1.6666666666666667,46,17,TCGCCGAACCATAGCACGGT,29,1142382
fldAp,3.4444444444444446,78,17,TCGAGCTAGACAATGGAAAC,61,1089742
fldAp,1.3888888888888888,41,17,TCCTCCTGAGAGAGTATTAA,24,1141838
fldAp,0.1111111111111111,18,17,TCCCCAAAGGCTTAGGTTAG,1,1131275
fldAp,2.7777777777777777,66,17,TCACTACACATATGGAAAGA,49,1087161
fldAp,1.3333333333333333,40,17,TCACGTCTAACGCCTTAGAG,23,1176135
fldAp,4.0,88,17,TCACCATTGTTTACTAATCT,71,1091530
fldAp,2.5555555555555554,62,17,TCACCAAGATTTCCATTCCT,45,1104681
fldAp,0.5,25,17,TCACAGCCCGGTCATCCAGG,8,1092650
fldAp,0.16666666666666666,19,17,TCAATCGTCGTACCATATAG,2,1109142
fldAp,1.4444444444444444,42,17,TATTCGTGATCGGGAGGCTT,25,1152763
fldAp,2.0555555555555554,53,17,TATTAATAAAGCGATGTTAG,36,1182499
fldAp,2.3333333333333335,58,17,TATCGTGCTAGTTAGAACTA,41,1080158
fldAp,2.0,52,17,TATCGCATGGCGAACACAGC,35,1079296
fldAp,0.1111111111111111,18,17,TAGGACAGGGCAGTCTGGTT,1,1113541
fldAp,4.833333333333333,103,17,TAGCTTAGTCTTCAAGCCCA,86,1156435
fldAp,0.2777777777777778,21,17,TACTGGTTCAGGTAATGGGA,4,1133172
fldAp,8.555555555555555,170,17,TACGTGGGATCGCCACGGAA,153,1066080
fldAp,1.2777777777777777,39,17,TACGGATTGAAAGGCTCAAT,22,1161352
fldAp,0.3888888888888889,23,17,TACAAATGCATAACTGGGAT,6,1137073
fldAp,1.3888888888888888,41,17,TAATCGCATGTGTTCGGTAT,24,1110650
fldAp,0.7222222222222222,29,17,GTTCTGCATGAACAGTCCGT,12,1136261
fldAp,1.8333333333333333,49,17,GTTCCTGAAAGCGCGCACTG,32,1163417
fldAp,0.1111111111111111,18,17,GTGTATGGTCTAAGGTAAAT,1,1067090
fldAp,1.5555555555555556,44,17,GTGGTGGTTGTGATTTTATT,27,1186150
fldAp,1.2777777777777777,39,17,GTGGGCAGGTCGGTACTATT,22,1131208
fldAp,1.2222222222222223,38,17,GTCGGAGCTCGGGAAGTGTA,21,1170653
fldAp,0.16666666666666666,19,17,GTCGATGCATATCCTATTTA,2,1108138
fldAp,1.1111111111111112,36,17,GTCCTCCATGGGATTAGAAC,19,1118505
fldAp,1.4444444444444444,42,17,GTCAGCGTGTGTCGCGACTA,25,1163189
fldAp,3.2777777777777777,75,17,GTCAGCAGAGGATCGTTTTA,58,1120769
fldAp,1.2222222222222223,38,17,GTCAATGTCGCAGTAATGGT,21,1184704
fldAp,2.9444444444444446,69,17,GTATAGACGGCTGAGAACAG,52,1157949
fldAp,0.8888888888888888,32,17,GTAGCCAGAGCACCGGTCAA,15,1122119
fldAp,1.2222222222222223,38,17,GTACAGCGCTGATTTATCTT,21,1077964
fldAp,0.16666666666666666,19,17,GTAACTTACCGGATAGTTCT,2,1119384
fldAp,2.0555555555555554,53,17,GGTTTAAGGGTTCAATGCCG,36,1183103
fldAp,0.7777777777777778,30,17,GGTCTACCATAGATGTATTA,13,1136263
fldAp,0.1111111111111111,18,17,GGTAATCGGTACGACAGGTA,1,1093626
fldAp,1.1111111111111112,36,17,GGGTTTCGTCACTCCAAGAC,19,1064191
fldAp,1.7777777777777777,48,17,GGGGGAGCACCCCGGCCTGC,31,1066945
fldAp,0.1111111111111111,18,17,GGGCGGCAACCTTCTCTCGT,1,1098923
fldAp,1.1111111111111112,36,17,GGCCTCAGACTAGATGATTG,19,1150003
fldAp,1.1111111111111112,36,17,GGATGAAACCAAGGAACGTA,19,1078257
fldAp,14.5,277,17,GGATCTCTAGTACTATACCG,260,1114232
fldAp,5.722222222222222,119,17,GGAGTGGCAGGGAGGACCCG,102,1118344
fldAp,1.1666666666666667,37,17,GGAGGCCTGCCGTATGAACG,20,1131323
fldAp,1.7777777777777777,48,17,GGAGACGAAACTAATAGCTC,31,1126974
fldAp,2.5555555555555554,62,17,GCTTGATTCGAGCGGCTTGC,45,1134838
fldAp,1.6111111111111112,45,17,GCTTCCGACATCGGGGGAAG,28,1095366
fldAp,0.1111111111111111,18,17,GCTGTTTGGTCTAGTAAAGT,1,1182308
fldAp,1.8888888888888888,50,17,GCTCTAGGGACCTATATGAT,33,1152665
fldAp,1.0555555555555556,35,17,GCGCGGTGAGGTATTTGGTG,18,1166072
fldAp,1.5,43,17,GCGAGTAGAGGCGTCCACAG,26,1095123
fldAp,3.0,70,17,GCCTAGCAATTCGCTCAGCA,53,1141237
fldAp,2.388888888888889,59,17,GCCGCTTCACCATTGGCGGT,42,1186091
fldAp,3.0,70,17,GCATTCGGACTTCATCTATA,53,1121385
fldAp,1.2777777777777777,39,17,GCAGTTGTTTGATAGCCCGG,22,1144967
fldAp,0.1111111111111111,18,17,GCACCGGGTTAGGGACCCAC,1,1177652
fldAp,1.7222222222222223,47,17,GCAATAAGATAAATATGAGG,30,1104500
fldAp,2.5,61,17,GCAACCGTCTTCTGGTTAGA,44,1154921
fldAp,0.16666666666666666,19,17,GATTCACCTTGATTATAGAT,2,1140555
fldAp,0.7777777777777778,30,17,GATATCGCCGGGTCAACTTT,13,1091840
fldAp,2.0555555555555554,53,17,GAGCCGTACCACTTGAGGTA,36,1124851
fldAp,1.3888888888888888,41,17,GACGTGGAATAGAATTGCAA,24,1070038
fldAp,0.1111111111111111,18,17,GACGCCTTAGAAGGTGTCGC,1,1113710
fldAp,0.1111111111111111,18,17,GACGCAAACCAATACGTTGA,1,1138905
fldAp,0.7222222222222222,29,17,GACCGCGCGCATAACATACT,12,1108993
fldAp,1.1111111111111112,36,17,GACAAACCTTCTGGAGTTAC,19,1148627
fldAp,2.5555555555555554,62,17,GAAGTTTGGATGTGAAAGTA,45,1088307
fldAp,3.611111111111111,81,17,GAACCGGTGGACAGGACGCA,64,1143905
fldAp,0.16666666666666666,19,17,CTTTATAACCTGGCTGGCGG,2,1139239
fldAp,0.1111111111111111,18,17,CTTTACCTAAATAGTATGAT,1,1178311
fldAp,0.1111111111111111,18,17,CTTGGTTCGTTATTCTGGCT,1,1090587
fldAp,0.1111111111111111,18,17,CTTCTGCTCGTGCTTTTCAA,1,1117785
fldAp,1.2222222222222223,38,17,CTTCCAGAACCGTGACTGGT,21,1178906
fldAp,0.2777777777777778,21,17,CTTATTCCGTCATGGTGTGG,4,1107183
fldAp,0.7222222222222222,29,17,CTGTAATTCTATGACTCTAA,12,1142641
fldAp,3.3333333333333335,76,17,CTGAAGTGATTCGTCACGGT,59,1138917
fldAp,0.3888888888888889,23,17,CTCTCTGCCGGGACAGCCTG,6,1099830
fldAp,1.2222222222222223,38,17,CTCCTCGTGACAGTTGCTTC,21,1076505
fldAp,2.0555555555555554,53,17,CTCAACGCGTTCGGCACTCT,36,1153799
fldAp,5.833333333333333,121,17,CTAGGAAAGGCCTTCTTGGT,104,1073391
fldAp,0.1111111111111111,18,17,CTAATTATAGTTCACGTGCA,1,1122594
fldAp,3.0555555555555554,71,17,CGTGCAAGGGTTTAAAGCAT,54,1162638
fldAp,3.111111111111111,72,17,CGTCGGATGGTTCACAGGAC,55,1102405
fldAp,0.7222222222222222,29,17,CGGTAGGTTCTGCCACTGCA,12,1094227
fldAp,3.3333333333333335,76,17,CGGGATGCAGGTTTGAGCGC,59,1112993
fldAp,3.5,79,17,CGCCTCGGTCAAGTCCACAC,62,1084536
fldAp,0.16666666666666666,19,17,CGCCCGTGGCAACCACTCAT,2,1117965
fldAp,0.16666666666666666,19,17,CGAGGTCTAGCCACTTCAAA,2,1095991
fldAp,1.9444444444444444,51,17,CGAAAAAGGAACGCTTTCAC,34,1141138
fldAp,0.7777777777777778,30,17,CCTGCGCTATCTTGAGGTTG,13,1147560
fldAp,3.4444444444444446,78,17,CCTCGGGCGCATTTCTGGTT,61,1174217
fldAp,5.555555555555555,116,17,CCTCGGCGAAACTGCAATGG,99,1109055
fldAp,0.1111111111111111,18,17,CCTAATATAGCTGAGCAAAG,1,1117436
fldAp,2.3333333333333335,58,17,CCGTCGCACCCCTCTCTAGT,41,1157287
fldAp,3.0,70,17,CCGGTTCTGCTTCGATTTAA,53,1149582
fldAp,3.8333333333333335,85,17,CCGATAAAAGAGATGTCATT,68,1121050
fldAp,0.1111111111111111,18,17,CCCTGTTCTCTTCGCGAACT,1,1116432
fldAp,0.6666666666666666,28,17,CCCTAATCCGATTAGTTAGC,11,1119083
fldAp,1.6666666666666667,46,17,CCCGGTTCGCAATACGTTGC,29,1092546
fldAp,1.3888888888888888,41,17,CCCGACGGAATGGTCTCTAG,24,1134230
fldAp,1.7777777777777777,48,17,CCCCTTACGCCGGTGGCTAT,31,1112179
fldAp,1.0,34,17,CCCCGCACCGATATAACGGA,17,1168221
fldAp,1.1111111111111112,36,17,CCCAAAACCCCGTTTTTTGT,19,1079987
fldAp,0.8333333333333334,31,17,CCATCCTTCTGTCGTTTGAC,14,1125295
fldAp,2.5,61,17,CCATACCACCTCCCGCGTGC,44,1141989
fldAp,1.2777777777777777,39,17,CCAGTGTTGTTATGAAACGA,22,1172738
fldAp,0.1111111111111111,18,17,CCAGCGCTAGGACGTTTAAT,1,1098932
fldAp,3.8333333333333335,85,17,CCAGCGAGTGATCACACAAG,68,1166334
fldAp,3.2777777777777777,75,17,CCAGACATAAAGGGCGTCCA,58,1082944
fldAp,1.3333333333333333,40,17,CCAAATCCACGATGGTAATA,23,1112979
fldAp,2.7777777777777777,66,17,CATACAATAAAGTCTCCGAC,49,1153212
fldAp,0.8888888888888888,32,17,CAGCACACCTTAATTGTGGC,15,1076742
fldAp,1.1111111111111112,36,17,CACGCTTGTCACCAAGCCGC,19,1159313
fldAp,2.0,52,17,CACGAGATCATGGAACGCGA,35,1134373
fldAp,1.2777777777777777,39,17,CACAGGATCGTTAGGAGAGA,22,1080804
fldAp,1.7777777777777777,48,17,CACAGCAAGTGCTTAGGCTA,31,1154621
fldAp,1.3333333333333333,40,17,CACACGTCTTACGTACAGGT,23,1137802
fldAp,0.8888888888888888,32,17,CACAACAGATTGTGTCTACA,15,1162577
fldAp,4.722222222222222,101,17,CAAGTCACTTCCGATATTCA,84,1167037
fldAp,1.8333333333333333,49,17,CAAGACCACACATTAAGAGC,32,1085598
fldAp,12.944444444444445,249,17,CAACGAAGGGACGGCGGCAA,232,1114251
fldAp,0.1111111111111111,18,17,CAAATCGTTCTAGCAGACAC,1,1106619
fldAp,0.1111111111111111,18,17,ATTCGGCTCGCATCATGGCA,1,1068305
fldAp,1.7777777777777777,48,17,ATGTATGAATAACTAGGGTG,31,1109705
fldAp,0.1111111111111111,18,17,ATGGGCTGACCTTAGGTTAG,1,1066548
fldAp,0.1111111111111111,18,17,ATGGCAGTTTTAACTTTGAG,1,1119934
fldAp,0.1111111111111111,18,17,ATGGCACGGCCCTGCCCGCT,1,1163968
fldAp,0.7777777777777778,30,17,ATGAATAAAGCTCAGTATGA,13,1142644
fldAp,0.7222222222222222,29,17,ATCAGGCCTGATTTCCAGAC,12,1100697
fldAp,0.8888888888888888,32,17,ATATACAGGTGATGAACAGA,15,1183319
fldAp,0.2222222222222222,20,17,ATACGCTCGATAAAAAGCTC,3,1135014
fldAp,2.388888888888889,59,17,ATAACGGTGTTATTTGCGCT,42,1172824
fldAp,3.4444444444444446,78,17,ATAACCACGTCAAAGTTTAA,61,1185577
fldAp,3.1666666666666665,73,17,AGTTGAGGCATTGGGTGACG,56,1125347
fldAp,2.0,52,17,AGTCTTTGGTATGGTTGACC,35,1084276
fldAp,2.0555555555555554,53,17,AGTAGATTCTCTATTGCGAA,36,1127471
fldAp,23.88888888888889,446,17,AGGTGTGGAGATCGCGAGGT,429,1118342
fldAp,1.3333333333333333,40,17,AGGGTAGAGGAATACGTTGT,23,1164694
fldAp,2.1666666666666665,55,17,AGGGACACGGTGGAAGGGGT,38,1144497
fldAp,4.277777777777778,93,17,AGCGGCTCCGCGGCGAAGAC,76,1110154
fldAp,6.555555555555555,134,17,AGCGGCAAGGATTGATGAGC,117,1082585
fldAp,1.5,43,17,AGCGAGTGCGACTTCCGAGT,26,1093455
fldAp,28.444444444444443,528,17,AGCGAAGTAGTGCTCTTATG,511,1107664
fldAp,2.111111111111111,54,17,AGAGGACCTCGATTTCTAGA,37,1068186
fldAp,3.7777777777777777,84,17,AGAGACGACTTACGCACAAT,67,1075773
fldAp,0.7777777777777778,30,17,AGACTGACGGCGCAAAGTAG,13,1163382
fldAp,0.1111111111111111,18,17,ACTGGCTAACCTAAGCGAGA,1,1109412
fldAp,0.1111111111111111,18,17,ACTCGAGACTGGCTAAGGTT,1,1172236
fldAp,0.1111111111111111,18,17,ACTACCCGCTAGATCTCCGT,1,1109924
fldAp,4.222222222222222,92,17,ACGTTAAATGGGTAGGCCAA,75,1064306
fldAp,5.777777777777778,120,17,ACGTCTCACCTCCATAGTAT,103,1074444
fldAp,2.6666666666666665,64,17,ACGTACTCCATGGAAGGTAC,47,1089782
fldAp,0.16666666666666666,19,17,ACGATATGGATTCGCGTTTT,2,1141131
fldAp,1.2222222222222223,38,17,ACGAGTAGACTATGCTTGAA,21,1136823
fldAp,1.6111111111111112,45,17,ACCGGTTTTTATGAACCGAT,28,1147576
fldAp,3.1666666666666665,73,17,ACCCCGTTGTCCGTGCCCCA,56,1105824
fldAp,0.5,25,17,ACCACAGTGGGTCCTGTGAA,8,1177217
fldAp,2.0555555555555554,53,17,ACATGAGTTATGGTTGATCC,36,1149464
fldAp,1.8333333333333333,49,17,ACAGACGCGGATATATTGAT,32,1159215
fldAp,2.111111111111111,54,17,ACACCCACGGTCACATCATG,37,1150980
fldAp,1.3333333333333333,40,17,ACAACAAAGAGCTGGACTAT,23,1101134
fldAp,1.3333333333333333,40,17,AATTCGGGTGGCCTGAATGT,23,1133510
fldAp,3.611111111111111,81,17,AATGTAGCTACAAGGTCCGT,64,1124038
fldAp,2.2222222222222223,56,17,AATGAAATATCCGCGCAACT,39,1083398
fldAp,1.6666666666666667,46,17,AATCGCGTCCGTGCTGCCGA,29,1079885
fldAp,2.0,52,17,AATATCGGTATCTCCATCGT,35,1073185
fldAp,1.3888888888888888,41,17,AATAGTGCCTCGACGAAACC,24,1109385
fldAp,3.9444444444444446,87,17,AAGTGAGCGATGAATGTCAC,70,1068547
fldAp,4.944444444444445,105,17,AAGACTTGGCGTAACTGGCG,88,1106134
fldAp,1.6111111111111112,45,17,AAGAAGCGGCTACTATGCGA,28,1115988
fldAp,0.8333333333333334,31,17,AACGCAAGATCTACGTTTGA,14,1148345
fldAp,1.1111111111111112,36,17,AAAGTCGGCTGGTTAAAATC,19,1140680
fldAp,1.7777777777777777,48,17,AAAAGTACATGCGTGTTTTG,31,1067773
fldAp,0.9444444444444444,33,17,AAAACGGAATCGGATGAGAC,16,1168725
fldAp,1.1176470588235294,34,16,TTTTTGCTAACCGGTCCTCG,18,1170462
fldAp,0.4117647058823529,22,16,TTTTCGAGTAGAAGATGCTT,6,1143514
fldAp,3.235294117647059,70,16,TTTGCCAAATCACGAGGACG,54,1185514
fldAp,0.11764705882352941,17,16,TTTCGATTCTGACCCGGTGA,1,1072170
fldAp,2.176470588235294,52,16,TTTAGTTGCCGGACCGGGAT,36,1184223
fldAp,4.352941176470588,89,16,TTTAGATGATGGGATCCTCA,73,1067536
fldAp,0.17647058823529413,18,16,TTGTGACCTTACAAGCGGCC,2,1074390
fldAp,3.5294117647058822,75,16,TTGGTGACGAATAAAGTGAT,59,1099607
fldAp,2.8823529411764706,64,16,TTGGGGTCAAGTTACGGTAC,48,1141407
fldAp,4.0588235294117645,84,16,TTGCAGTTGGTTTAATCGCC,68,1108066
fldAp,1.9411764705882353,48,16,TTCTGATGGCTTAACTCAAG,32,1185009
fldAp,2.0588235294117645,50,16,TTCGCCATCAGGGGTAATGC,34,1165858
fldAp,3.411764705882353,73,16,TTATTCTCTAGATCTAACAC,57,1186792
fldAp,2.0,49,16,TTATTACTACACTCTTCGGC,33,1120060
fldAp,0.8235294117647058,29,16,TTATGACTAGAAACGGCGGG,13,1168823
fldAp,0.11764705882352941,17,16,TTATCGAAAGCCCTAATCGT,1,1177592
fldAp,1.7058823529411764,44,16,TTATCCCTCTCATTTCCTGG,28,1082862
fldAp,1.3529411764705883,38,16,TTACCAGAGGTAGAGCGCCT,22,1105506
fldAp,0.11764705882352941,17,16,TTACCACAGCCTCGTAGCTT,1,1066197
fldAp,2.411764705882353,56,16,TGTTTTGTAATAGTCACTTC,40,1080694
fldAp,0.8823529411764706,30,16,TGTTAATAAGATGTGTGCGC,14,1130284
fldAp,0.29411764705882354,20,16,TGTGACCTTCCAATGGACAG,4,1184049
fldAp,0.11764705882352941,17,16,TGTCGTTTCTGACTTTAGGT,1,1167251
fldAp,1.588235294117647,42,16,TGTCCGAACCGCGCCAGCAT,26,1090989
fldAp,2.1176470588235294,51,16,TGTAGTTGACTCCGATTATA,35,1101190
fldAp,1.4705882352941178,40,16,TGGTGTTATACGTATATGAT,24,1151561
fldAp,1.411764705882353,39,16,TGGTCGATCAGCATCGGGTG,23,1139957
fldAp,1.6470588235294117,43,16,TGGGGTAACAAGAAATGACC,27,1065627
fldAp,10.411764705882353,192,16,TGCGTGCGGGGTCCAGATTT,176,1156113
fldAp,0.7647058823529411,28,16,TGCGCTGTGGACAGTATAGC,12,1105485
fldAp,0.11764705882352941,17,16,TGCCTCCTCGAGACGTCCAA,1,1085123
fldAp,0.17647058823529413,18,16,TGCAGGGTTACCAGGCCGGA,2,1128349
fldAp,2.3529411764705883,55,16,TGATGGGTCGGGAATTCCTG,39,1091782
fldAp,1.1764705882352942,35,16,TGAGCTAACGTTGAAATAGA,19,1174018
fldAp,2.0,49,16,TGACCTCACTGATTACGAGG,33,1077003
fldAp,2.3529411764705883,55,16,TGAACGTGCAACTGCGCTTC,39,1099182
fldAp,2.4705882352941178,57,16,TGAACGCCTACCGTGGCCGT,41,1112996
fldAp,4.705882352941177,95,16,TCTTGGATAAGATATAAGAT,79,1181541
fldAp,1.2352941176470589,36,16,TCTGTACTGACAAAGTGTGA,20,1173715
fldAp,3.764705882352941,79,16,TCTGCGGCCCGTTTGCCGGT,63,1113213
fldAp,2.2941176470588234,54,16,TCTGAAGTTGATAAGTACCT,38,1126872
fldAp,13.0,236,16,TCTCCTAAACAGCTCTCTCG,220,1063648
fldAp,1.6470588235294117,43,16,TCTCCCCGGGACACGGCTTC,27,1086683
fldAp,1.3529411764705883,38,16,TCTCCAAGCCGTCCAGGGTT,22,1144645
fldAp,3.588235294117647,76,16,TCGCTTTTGTAAGGCCTCAT,60,1147318
fldAp,1.0,32,16,TCGCCGACACAGGAGAATGT,16,1162220
fldAp,5.647058823529412,111,16,TCGCAGTTAAAGGGCGGGTA,95,1179523
fldAp,1.1764705882352942,35,16,TCGATTAGTATCGCTAAATA,19,1180617
fldAp,1.4705882352941178,40,16,TCGACCAAAATAGAAGCTCC,24,1151551
fldAp,2.0,49,16,TCCTGTACAGTAGACGTTGA,33,1111745
fldAp,0.11764705882352941,17,16,TCCTCATCCGCCATCAGGGG,1,1070919
fldAp,1.2352941176470589,36,16,TCCCTGCATGATGGAAGTAT,20,1089207
fldAp,1.8235294117647058,46,16,TCCCAATCGCCACACCTTTG,30,1106756
fldAp,1.1764705882352942,35,16,TCCATGCCAAATAAAAACCC,19,1083638
fldAp,1.3529411764705883,38,16,TCATGAAGCCGCCCGGTCCT,22,1171468
fldAp,0.11764705882352941,17,16,TCATATAAAGGGCGAAGTCT,1,1173848
fldAp,3.176470588235294,69,16,TATTGGGAACGAACGGTGCA,53,1142629
fldAp,1.5294117647058822,41,16,TATTCTCCAGCCGTCGCAGC,25,1167079
fldAp,0.4117647058823529,22,16,TAGGGGTATCGGGACGCTGG,6,1119590
fldAp,1.7647058823529411,45,16,TAGCCGGCCCCAGTCCAGCC,29,1136916
fldAp,5.529411764705882,109,16,TAGACATGCCATTTAATCAC,93,1147707
fldAp,0.17647058823529413,18,16,TACTGATTCAGGGAAATGTC,2,1111839
fldAp,1.2352941176470589,36,16,TACGCTTTGCCGTTCTAGAA,20,1157400
fldAp,4.352941176470588,89,16,TACGCTTATTGCCAACCCGT,73,1097350
fldAp,2.1176470588235294,51,16,TACAGTTAGTCCTTCATAGT,35,1172563
fldAp,2.176470588235294,52,16,TAATTTCTACTACCATAAGA,36,1110386
fldAp,0.8235294117647058,29,16,TAAACCATTTAGTTGCTTCG,13,1154408
fldAp,3.411764705882353,73,16,GTTTTGTTCCTTCTGCTACA,57,1159301
fldAp,1.7058823529411764,44,16,GTTAGCCCACGCTTCTCCTA,28,1178136
fldAp,7.352941176470588,140,16,GTGTCGATCTCCGTGTCCAA,124,1101281
fldAp,1.9411764705882353,48,16,GTGATATTATTAATAGCGTT,32,1125688
fldAp,1.3529411764705883,38,16,GTGATAGGATGAAAAACCGA,22,1072890
fldAp,0.5882352941176471,25,16,GTCTTGGCTTCTTAAAGCAC,9,1180726
fldAp,0.35294117647058826,21,16,GTCGTCGCTTTTCGAGCGCA,5,1088601
fldAp,0.4117647058823529,22,16,GTCATTGGCAGTCAATCAGA,6,1067170
fldAp,3.2941176470588234,71,16,GTCACGGCACCAGTCCTTCA,55,1070579
fldAp,3.764705882352941,79,16,GGTGCTTGTTTAGAATTTCT,63,1127961
fldAp,1.588235294117647,42,16,GGTATGGCAACGCCTTAAAG,26,1099592
fldAp,2.823529411764706,63,16,GGTAACGGGGCTAATGGTGT,47,1070582
fldAp,1.0,32,16,GGGGGGTTCCTGTGAAGACA,16,1156433
fldAp,0.8823529411764706,30,16,GGGGCCTTTGTCAGTAACCA,14,1108827
fldAp,5.470588235294118,108,16,GGGGATGATCATTCAGGATG,92,1102871
fldAp,2.7058823529411766,61,16,GGGCGGTGAGCAGGGACACT,45,1065409
fldAp,2.0588235294117645,50,16,GGGCCTTACACCGGATGATC,34,1143152
fldAp,1.7058823529411764,44,16,GGCCTGGTTTCTCTAGACCT,28,1085579
fldAp,1.588235294117647,42,16,GGCATAGCCGCAGCGGTGAA,26,1142063
fldAp,1.0,32,16,GGCAGGTTCCTGTCAACGTC,16,1070230
fldAp,1.4705882352941178,40,16,GGATTTGCATATGATCATAG,24,1112728
fldAp,0.17647058823529413,18,16,GGATACGACAATTCACATAC,2,1176243
fldAp,1.2941176470588236,37,16,GGAGTGTAAATGTAGGCGTA,21,1125176
fldAp,0.17647058823529413,18,16,GGACATGGGCATAGTAACTT,2,1069362
fldAp,0.11764705882352941,17,16,GGAAAAAGTAACTCCGTAGT,1,1093227
fldAp,4.117647058823529,85,16,GCTAGGCATTGCAAACTCCA,69,1111121
fldAp,0.11764705882352941,17,16,GCGTGCAGTTTTCAACTCTC,1,1068597
fldAp,1.1764705882352942,35,16,GCGTATGGGCGATCGCTTAA,19,1116777
fldAp,1.4705882352941178,40,16,GCGGCGTGACACATAACACG,24,1147931
fldAp,0.11764705882352941,17,16,GCCGGGCCTGAAGGATTACA,1,1066112
fldAp,1.9411764705882353,48,16,GCCGGCTAGGGGTGAAGAGA,32,1110324
fldAp,0.17647058823529413,18,16,GCCCCGCATAGAGCCTAACA,2,1163176
fldAp,2.411764705882353,56,16,GCCAGCACCCCTACACTGCA,40,1111363
fldAp,0.7647058823529411,28,16,GCCACGTTCGCTTTAGGATT,12,1099635
fldAp,2.6470588235294117,60,16,GCCACGTAGCGGCCTGTATG,44,1124030
fldAp,2.2941176470588234,54,16,GCCAAACCCTTTGGCGTTGA,38,1181400
fldAp,1.8235294117647058,46,16,GCATGAGACGGGAGAACTAG,30,1161836
fldAp,1.2941176470588236,37,16,GCATCCACGGCAATATTGCC,21,1137292
fldAp,1.6470588235294117,43,16,GCAGTGAATCTTAGCTGACA,27,1100957
fldAp,0.4117647058823529,22,16,GCAGACATGTTCCCAGGAGT,6,1165990
fldAp,0.9411764705882353,31,16,GCACACAGATTGGGAAGTGA,15,1095508
fldAp,1.6470588235294117,43,16,GCAAGGTCACACATTTAAGG,27,1123963
fldAp,1.1176470588235294,34,16,GATTTGAAAACGGAACGTCT,18,1172273
fldAp,1.7647058823529411,45,16,GATTGCGAAATACCATGGAA,29,1092706
fldAp,0.9411764705882353,31,16,GATGCACGTCAACGTATAAT,15,1072486
fldAp,3.7058823529411766,78,16,GATACAACCCTCCTCGGACT,62,1142117
fldAp,0.9411764705882353,31,16,GAGTGTCGCTAGGATCGCTG,15,1087993
fldAp,0.17647058823529413,18,16,GAGTCCGGACCCACTCCTGC,2,1077892
fldAp,0.47058823529411764,23,16,GAGCGTCGTTACCGAGATAC,7,1119198
fldAp,1.8823529411764706,47,16,GACTTGAGCTGCTCACATGG,31,1088252
fldAp,2.0588235294117645,50,16,GACGACTTTTATGGTTACAT,34,1150951
fldAp,0.11764705882352941,17,16,GACCATACTCCGGAGCATAA,1,1127788
fldAp,3.7058823529411766,78,16,GAATGAATCTCAATTTTACA,62,1084571
fldAp,1.8235294117647058,46,16,GAACTTGGCTGGCTCCTGCT,30,1163271
fldAp,1.588235294117647,42,16,GAACTGCGTTGCCGGTCCTT,26,1090038
fldAp,2.411764705882353,56,16,GAAACCTTTAGTCCAGGGCG,40,1156128
fldAp,7.470588235294118,142,16,CTTTGAGGCAGTGCGAACAT,126,1063634
fldAp,0.35294117647058826,21,16,CTTTGAGACCTTCGATATGC,5,1161119
fldAp,1.7058823529411764,44,16,CTTTACATTGTAGTAGACCA,28,1150394
fldAp,4.352941176470588,89,16,CTTTAAGAGACTGCATCAAG,73,1104285
fldAp,0.11764705882352941,17,16,CTTGATGTGTCTTCTTTGAC,1,1123158
fldAp,4.9411764705882355,99,16,CTTCTGCAAAGGGCACGGAG,83,1127797
fldAp,0.11764705882352941,17,16,CTCTCGTCAACCCAGCACCC,1,1179734
fldAp,4.176470588235294,86,16,CTCCGTGACCTACAGTTAGT,70,1076435
fldAp,1.7058823529411764,44,16,CTATAATCTTAATGTAGACT,28,1072871
fldAp,0.11764705882352941,17,16,CTATAAGTTCGATGGTGTTC,1,1144112
fldAp,2.235294117647059,53,16,CTAGTACCGTTAAACGGTTG,37,1127573
fldAp,0.11764705882352941,17,16,CGTACCGAGGCGCAGCAAGA,1,1149885
fldAp,2.3529411764705883,55,16,CGTACAAGTGAAGTTTCCCA,39,1088584
fldAp,1.0,32,16,CGGTATGTGTCCATTGCCGT,16,1153235
fldAp,3.0588235294117645,67,16,CGGGTACATTACGACAAAGT,51,1127738
fldAp,2.0,49,16,CGGATCCTCATACGCCGGAC,33,1122713
fldAp,2.3529411764705883,55,16,CGGAGTCGATAGCTGGTATA,39,1112224
fldAp,2.764705882352941,62,16,CGGACCTAGGGTAACTTACC,46,1133612
fldAp,1.588235294117647,42,16,CGCCATCTCTCTCGTTTAGA,26,1183342
fldAp,3.3529411764705883,72,16,CGCATCTGCTCCGATTACGT,56,1168215
fldAp,2.7058823529411766,61,16,CGCAACAACTGGAATAGGTA,45,1073806
fldAp,3.5294117647058822,75,16,CGACAAATGTAGTTCTCTAT,59,1093928
fldAp,0.23529411764705882,19,16,CCTCGCTACCACTGTCATTG,3,1095045
fldAp,4.470588235294118,91,16,CCTCCCCTCTCCACCACTAC,75,1182594
fldAp,0.11764705882352941,17,16,CCGTCCAACGAAGTGTAGCG,1,1109129
fldAp,1.3529411764705883,38,16,CCGGCGGAGCATTCATTGGT,22,1073102
fldAp,1.4705882352941178,40,16,CCGGCAAAAGGTGAAACTAA,24,1162317
fldAp,0.6470588235294118,26,16,CCGCGGTTTAGGAGAATTTC,10,1153245
fldAp,1.3529411764705883,38,16,CCGAGGAACAAGGTCACCTC,22,1100174
fldAp,13.235294117647058,240,16,CCCTTTCTCGGTGTGTTGAT,224,1114234
fldAp,1.6470588235294117,43,16,CCCGCCGATATGTGTCCCGA,27,1079548
fldAp,2.5294117647058822,58,16,CCCGAGGCTGGTCCCGCGAG,42,1067776
fldAp,0.11764705882352941,17,16,CCCAGGCACCATGTTGGGAA,1,1155214
fldAp,1.4705882352941178,40,16,CCACGGGGAAGGTCCGCGAA,24,1154127
fldAp,1.4705882352941178,40,16,CCAATGCCATTCGTTACACA,24,1152389
fldAp,0.11764705882352941,17,16,CCAACATGCCCCTGTGTGTA,1,1176630
fldAp,2.235294117647059,53,16,CATTGTCTGGTATATGCTTG,37,1090529
fldAp,0.7058823529411765,27,16,CATGTTAATCAACCTTAATG,11,1069587
fldAp,0.11764705882352941,17,16,CATGATTACTAGATTGTGGT,1,1131793
fldAp,1.588235294117647,42,16,CATGAAACGTGCTCGGGTGA,26,1172722
fldAp,1.2941176470588236,37,16,CATCACTCTGCCTTTGTTGC,21,1090334
fldAp,2.8823529411764706,64,16,CAGCCGGCTGGGGAGTAAGA,48,1148454
fldAp,2.3529411764705883,55,16,CAGCAGCGGAGCTATCCAGG,39,1075733
fldAp,0.9411764705882353,31,16,CACTCTTAGGGCTACGCTGC,15,1177287
fldAp,1.6470588235294117,43,16,CACCTTTCTTTTGAGTGCAG,27,1118162
fldAp,1.0,32,16,CACACGAGTAAAACCTCTCG,16,1105504
fldAp,3.0588235294117645,67,16,CAATAATACGTAATTTATCT,51,1164782
fldAp,1.7647058823529411,45,16,CAACTTCTCACCTCCACTTA,29,1185021
fldAp,1.1176470588235294,34,16,ATTTTAAGAGTCGTGGATGG,18,1117017
fldAp,7.823529411764706,148,16,ATTTGATCGTGTACCCGTAG,132,1121055
fldAp,0.8823529411764706,30,16,ATTTGACTGCCGGAGTGCAG,14,1145672
fldAp,0.11764705882352941,17,16,ATTCAGACCGGACATATCCA,1,1134502
fldAp,0.11764705882352941,17,16,ATGGTCTGCTCATTCCGCTT,1,1095216
fldAp,1.0,32,16,ATCTTCATTTCTTTTGTCTT,16,1127625
fldAp,1.6470588235294117,43,16,ATCCCGATCGGCTCGACCAT,27,1154614
fldAp,1.5294117647058822,41,16,ATATCAGAGTCTCATCGACT,25,1172983
fldAp,2.823529411764706,63,16,ATAAATACCGGGGGAGCAAC,47,1171054
fldAp,2.1176470588235294,51,16,AGTTTGAGGGCGCTCGATTC,35,1071594
fldAp,1.8235294117647058,46,16,AGTTTAGTGTTTTTTAGGAA,30,1122897
fldAp,1.1176470588235294,34,16,AGTTAGGTGGCTCCGCCTCG,18,1080778
fldAp,2.764705882352941,62,16,AGTTAATTCCATAATCTTCG,46,1094345
fldAp,0.11764705882352941,17,16,AGTCTGGAACATGCGGAGCA,1,1116872
fldAp,1.1764705882352942,35,16,AGTCCTGTTAGGGACCGTTG,19,1123731
fldAp,2.0,49,16,AGGTGTGGGCTGGGCCACGT,33,1117750
fldAp,0.11764705882352941,17,16,AGGCCACCATCGGTAGGTTA,1,1159993
fldAp,1.7058823529411764,44,16,AGGAGGCACTTATGCCCCGG,28,1112122
fldAp,3.3529411764705883,72,16,AGGAACAGGAGAAACGAGCA,56,1087419
fldAp,2.6470588235294117,60,16,AGGAAATAATGATCGCTAAG,44,1180774
fldAp,0.8235294117647058,29,16,AGCGCGCTTGCTCTAAAGCA,13,1067974
fldAp,1.7058823529411764,44,16,AGCCTGCCGACAACTTAATG,28,1119788
fldAp,0.11764705882352941,17,16,AGACTACAGTCCCAAGTATC,1,1132815
fldAp,0.17647058823529413,18,16,AGACACATTGACCGGGCCAG,2,1077655
fldAp,1.6470588235294117,43,16,ACTTTGATAGATTGTGGTCC,27,1152399
fldAp,2.764705882352941,62,16,ACTGGGCCTGTATAGGGTGA,46,1066943
fldAp,2.411764705882353,56,16,ACTACTAAGTGCCTATGGAA,40,1186560
fldAp,0.7058823529411765,27,16,ACTAAATTCTAGTCACCTGA,11,1148801
fldAp,1.6470588235294117,43,16,ACGGGCTAGTTTAATTCAGT,27,1078802
fldAp,1.7647058823529411,45,16,ACCTGTCTTCGGCCAGTCTC,29,1130762
fldAp,0.11764705882352941,17,16,ACCTACCCAAACCCTTGGCT,1,1138598
fldAp,0.8235294117647058,29,16,ACCCCATAGCCTCAGTTCGT,13,1121872
fldAp,2.9411764705882355,65,16,ACCCACAACGTTTCACAGCA,49,1076669
fldAp,5.0,100,16,ACAAAGTATTATCTTTTGAG,84,1126112
fldAp,2.764705882352941,62,16,AATGGCACTTGGAAGCGGTT,46,1109365
fldAp,0.11764705882352941,17,16,AAGTGTCGTTCGTGGTCTCC,1,1068848
fldAp,0.5294117647058824,24,16,AAGTCCCGACCCTGAGCACT,8,1140329
fldAp,3.0588235294117645,67,16,AAGTACGAAGGGATACTCAG,51,1170547
fldAp,2.8823529411764706,64,16,AAGGTCGGGAGTAACTCTTC,48,1185206
fldAp,1.1764705882352942,35,16,AAGGGACTGTATAACAAGTA,19,1115016
fldAp,1.7058823529411764,44,16,AAGGCGCCTACAAAACTGTT,28,1127570
fldAp,2.764705882352941,62,16,AAGAGAACCGGAATGGCTCA,46,1093310
fldAp,6.117647058823529,119,16,AACTAATATTAAAGAGACAT,103,1157943
fldAp,2.0,49,16,AACCTTCCCATATTTACCCC,33,1108503
fldAp,0.11764705882352941,17,16,AACCCGCCGAAATGGGTGAT,1,1109510
fldAp,5.529411764705882,109,16,AACATTTTATCAGTGCGGCA,93,1169112
fldAp,0.17647058823529413,18,16,AAATGTCCCACTCCCAGTGA,2,1085408
fldAp,3.4705882352941178,74,16,AAATAGCGTATTAATCATAA,58,1145082
fldAp,2.7058823529411766,61,16,AAACGGGGGTTCCCGTACGT,45,1086473
fldAp,1.875,44,15,TTTTGCTCTTTATACAGGTG,29,1152217
fldAp,2.0,46,15,TTTATACTGAATGCAGACAC,31,1151631
fldAp,3.4375,69,15,TTTAGACATACAATGAGATA,54,1178570
fldAp,1.625,40,15,TTGTTAGCTTTTCGTCAACC,25,1094682
fldAp,15.4375,261,15,TTCTTTCTAGCCTCTATAAC,246,1077540
fldAp,1.1875,33,15,TTCTGCCCCCGGTTGATAAA,18,1098884
fldAp,3.3125,67,15,TTCAACGGATGGTGGTTAGA,52,1147684
fldAp,0.125,16,15,TTAAATCCGCGGACGTGAGT,1,1186096
fldAp,1.625,40,15,TGTGGCTCTTACTTTAGTAG,25,1141721
fldAp,1.125,32,15,TGTGCTTGGGTGGTGCGAGT,17,1152071
fldAp,1.625,40,15,TGTGATGCCAGACGCCTGTT,25,1161912
fldAp,0.25,18,15,TGTCGTTCGAAGTCGTCCGC,3,1145734
fldAp,1.75,42,15,TGTCCCCCTACTCGAACCGA,27,1125893
fldAp,1.0,30,15,TGTCACAGCGATCCAGAGCA,15,1130006
fldAp,1.0625,31,15,TGGTTGAAATTAGGCGATCA,16,1140650
fldAp,2.625,56,15,TGGTTCTATGATGAATTGAG,41,1097318
fldAp,0.375,20,15,TGGGCTCCCACAATTTAACT,5,1123078
fldAp,5.0625,95,15,TGGCTGGCAGCTGTACTCGA,80,1066267
fldAp,0.1875,17,15,TGGAGTCTGTAATTCGTGGT,2,1105072
fldAp,1.4375,37,15,TGGAATGTGCCACTCTGCGC,22,1065500
fldAp,2.125,48,15,TGCGAACGGTCTTGGGAACC,33,1100270
fldAp,0.125,16,15,TGCCCCACGAACTCGATGAC,1,1142751
fldAp,3.9375,77,15,TGCAGCGATTATTATTTGCC,62,1133338
fldAp,2.75,58,15,TGAGGAAACGCTGAATTGTG,43,1162405
fldAp,1.3125,35,15,TGAGCAAAGTTTGAGCGTGT,20,1087771
fldAp,3.375,68,15,TGACGACAATGCATCCGATT,53,1153457
fldAp,0.125,16,15,TCTTTTAAGTGCCAGATGAA,1,1089216
fldAp,2.25,50,15,TCTGGAGGGTAACTATATGA,35,1066645
fldAp,2.125,48,15,TCTAGACGCTTTACAGCAGT,33,1088072
fldAp,2.0625,47,15,TCGTTTCGTATAATCTTCAT,32,1098678
fldAp,0.125,16,15,TCGGTACATATAGTATGTTG,1,1155794
fldAp,1.0,30,15,TCGGTAACAATTGGCTCTCA,15,1118003
fldAp,1.5625,39,15,TCGGCTACCGTGCTGAGAAT,24,1149292
fldAp,0.125,16,15,TCGGAGTGTGGCCCGTGTGA,1,1158132
fldAp,2.125,48,15,TCCTGCAAGCGCATTTGTCA,33,1112976
fldAp,4.0,78,15,TCCTGAAGCGACGGCATTAA,63,1165468
fldAp,0.6875,25,15,TCCTCCAAGCGAACATCCAA,10,1094854
fldAp,2.5625,55,15,TCCGGCGATCCACTATAGGG,40,1114311
fldAp,7.875,140,15,TCCGAGGGACTAATCAGTCA,125,1063143
fldAp,2.625,56,15,TCCCATCGGTTCCTTGAGTG,41,1176918
fldAp,0.3125,19,15,TCAAAAATCCCGCGAATTGA,4,1158187
fldAp,3.9375,77,15,TATGCCCCCGCACTACTTAG,62,1172930
fldAp,1.8125,43,15,TATCGCGCGGGATCCATCTT,28,1097187
fldAp,2.5625,55,15,TAGCGGGACAACCGCTAACG,40,1079522
fldAp,1.5625,39,15,TACGATCAACTCGGTCACTA,24,1163886
fldAp,3.1875,65,15,TACCGCCCGCACGGGCGAAA,50,1184865
fldAp,1.75,42,15,TACCCGGAGCCCGAATAATG,27,1108135
fldAp,3.3125,67,15,TAATCCGTTTCCAACCATCG,52,1175870
fldAp,3.0625,63,15,TAAGTCGAGTCCAGAGCGGG,48,1171264
fldAp,3.5,70,15,TAAATCAGTGCTCGTTCAAC,55,1082283
fldAp,1.6875,41,15,TAAATACTTCCGCAAGTCAC,26,1147126
fldAp,1.9375,45,15,TAAAGAAATGGTCTATTGTC,30,1100372
fldAp,1.625,40,15,TAAACTTAAAATATCGGGTT,25,1116848
fldAp,1.625,40,15,GTTCAATTCTCGGGTATAAT,25,1122244
fldAp,1.875,44,15,GTTAGGTAGGAGCTTCAGCT,29,1133720
fldAp,0.1875,17,15,GTTACCCGGGGGTGACAGCT,2,1134183
fldAp,0.125,16,15,GTTAAGTCGAGGGTCTGGGT,1,1095854
fldAp,1.8125,43,15,GTGTTAAAAATGGTACAAAT,28,1080205
fldAp,3.3125,67,15,GTGGATTACCAAGGGGCAAG,52,1152528
fldAp,0.125,16,15,GTGGAAGGGCTTCGCAAGGG,1,1181556
fldAp,4.0625,79,15,GTCCACACTCGAACACTCAC,64,1108930
fldAp,0.125,16,15,GTCATAGCGTGATGTACGTA,1,1158273
fldAp,0.125,16,15,GTCAAGCCTCCTGGGCGAAT,1,1174009
fldAp,1.625,40,15,GTCAACGGAGTTACAACCCT,25,1125791
fldAp,2.75,58,15,GTCAAAGTGCTCTTGAGCAG,43,1083886
fldAp,1.125,32,15,GTACGTCCATGCTTCGCGTT,17,1144758
fldAp,0.125,16,15,GTACATACCTCCGATTCCGC,1,1173312
fldAp,1.4375,37,15,GTAAGCTACGGCTGTTTTGC,22,1154992
fldAp,2.0625,47,15,GGTTTGCCACGGGTGGGCAG,32,1167156
fldAp,1.9375,45,15,GGGTCAGTTCCTCGCACCAA,30,1185371
fldAp,2.4375,53,15,GGGTATGCCTGGCGCAGCGT,38,1083094
fldAp,0.1875,17,15,GGGGGTAGGTGTAAAAGGTG,2,1170846
fldAp,1.8125,43,15,GGGCTCCATGGGCAGACAAG,28,1073719
fldAp,1.8125,43,15,GGGATATGGCACGGGGCATA,28,1173437
fldAp,2.75,58,15,GGAGTCTACCGTTATACCTC,43,1098963
fldAp,1.75,42,15,GGACGGTGGGATCGAATCGC,27,1065708
fldAp,2.875,60,15,GGACCTTAACAGACATAGTG,45,1142665
fldAp,1.9375,45,15,GGAACTGCTGGGTAGGGTCA,30,1106317
fldAp,1.125,32,15,GCTTGAGAAGAGTTAATAGG,17,1133353
fldAp,6.4375,117,15,GCTGTGTAATAATCCGAGAT,102,1125039
fldAp,1.625,40,15,GCTGTGATAAAGTTACACAC,25,1183271
fldAp,1.9375,45,15,GCTGGCCGAGTGCGATTGGT,30,1132712
fldAp,4.875,92,15,GCTAGTACTTCGGTAGTAGT,77,1113612
fldAp,2.375,52,15,GCGTGTTAGAACCAACGGCA,37,1128109
fldAp,1.5625,39,15,GCGGTCTCTGTGGGGCGTAT,24,1089209
fldAp,0.125,16,15,GCGGACGAGGCCACCTAACT,1,1090696
fldAp,0.8125,27,15,GCGCCCCAACCATTGATGAC,12,1095131
fldAp,1.9375,45,15,GCGCCAAGAAACTATATTTG,30,1179860
fldAp,1.1875,33,15,GCGCACGCACTGTGACACGG,18,1094579
fldAp,1.9375,45,15,GCCTATTATAGCCAAGATGT,30,1086216
fldAp,1.875,44,15,GCCTATCTTCCTAGTCTGGA,29,1144324
fldAp,1.4375,37,15,GCCGTCGGGTCTACATATTA,22,1121755
fldAp,0.375,20,15,GCCGAATCATAATTACAATC,5,1090564
fldAp,2.75,58,15,GCCCTACTGACTTCGCAGTT,43,1074097
fldAp,0.125,16,15,GCAGTTAGTGGATCCGGGGC,1,1132410
fldAp,2.6875,57,15,GCAGGGTTCACTTTTCGGCG,42,1137373
fldAp,1.75,42,15,GCAGCCAGAGTCCTCCCAAT,27,1130187
fldAp,1.875,44,15,GCAGCAAAATCCGTCACCGT,29,1097923
fldAp,1.5,38,15,GCACTCGAGAGAGGGTGCTT,23,1147103
fldAp,1.5,38,15,GCAACTGAGCGTAACGTTGG,23,1096022
fldAp,1.25,34,15,GATATATCTCCATTGGGTGA,19,1136685
fldAp,2.6875,57,15,GATACTTTGTAGGGTTTACG,42,1077946
fldAp,2.25,50,15,GATACACTATGTCCCCACGT,35,1102336
fldAp,1.8125,43,15,GAGTTACGTTCTATATTTAT,28,1085415
fldAp,0.125,16,15,GAGTCGTCTATGCAGTACTA,1,1169515
fldAp,2.6875,57,15,GAGCCAGCACTTCGACGGTT,42,1143110
fldAp,2.4375,53,15,GAGATGTATCCAGGGGTTTT,38,1080489
fldAp,0.125,16,15,GACCATCGGGGAGATGCTGG,1,1107893
fldAp,1.75,42,15,GACATGCGATGACCTCGCGA,27,1167647
fldAp,5.875,108,15,GACAATCTCGTTACCGCCGA,93,1085988
fldAp,1.9375,45,15,GAATGCTACCGTGTTCCCTT,30,1170841
fldAp,2.1875,49,15,GAATCCACCATAGACGTTTA,34,1169330
fldAp,0.25,18,15,GAAGCTAAGCCTAGAGTCTC,3,1178312
fldAp,0.125,16,15,GAACACGAGTCAACGAACCA,1,1164020
fldAp,1.4375,37,15,GAAAGCAATCCATCACCATA,22,1141980
fldAp,0.25,18,15,GAAAAGTAGGGATGTCACAC,3,1100032
fldAp,1.4375,37,15,CTTATCTGCATTCAGCAATC,22,1118413
fldAp,3.0625,63,15,CTTATAGCAGGTCAACTACG,48,1075760
fldAp,0.125,16,15,CTTACTCGAGTTTGCCTCTG,1,1148576
fldAp,0.125,16,15,CTTAATCATCCTACACGAAC,1,1123094
fldAp,2.5,54,15,CTGTTCAACGGGGTGCCGTT,39,1076415
fldAp,4.0,78,15,CTGGTAAGCATACTCTTTAT,63,1165484
fldAp,2.5625,55,15,CTGGGACGTCAGTCTTACCT,40,1132990
fldAp,3.0625,63,15,CTGATATAGTAGCCTTTGAA,48,1066020
fldAp,2.3125,51,15,CTGAGCCACCAGTGCAGAAA,36,1077252
fldAp,0.125,16,15,CTCGATTGGGTACACTACGT,1,1124051
fldAp,5.5625,103,15,CTCCGCCCGGGTTCCGGAAG,88,1156194
fldAp,1.0,30,15,CTCCATCTACCGAACTGAGA,15,1175133
fldAp,0.5625,23,15,CTACTTTCCATGTTACCATG,8,1179987
fldAp,2.4375,53,15,CGTTAGAGGGTAGGCGTCTA,38,1139483
fldAp,8.75,154,15,CGTGGTATTTTTGCTCTTAC,139,1111357
fldAp,1.75,42,15,CGTATCAGGGAGGGGAATCA,27,1096781
fldAp,1.1875,33,15,CGTATACAGAGGTGCGCTTA,18,1110600
fldAp,1.9375,45,15,CGTAAACCTCTATACACTTA,30,1084278
fldAp,7.4375,133,15,CGGCTTTCTAATACTCAAGT,118,1109619
fldAp,5.375,100,15,CGGCTAATGGCTAGACTTCT,85,1114505
fldAp,3.9375,77,15,CGGCAGGTGATACCCGCCGT,62,1063155
fldAp,2.375,52,15,CGGAGGTAATTCGCCGGAAA,37,1117046
fldAp,1.0,30,15,CGCCGGAATTATCCAAATGC,15,1156191
fldAp,1.5625,39,15,CGCACCAGGGCATTGACGCC,24,1084997
fldAp,2.25,50,15,CGAGGTATGAGACTTCTTAT,35,1114863
fldAp,2.1875,49,15,CGAGAGTGCAACCACGCTCG,34,1153397
fldAp,1.5,38,15,CGACGGTATAGGCGGAGATC,23,1093990
fldAp,2.5,54,15,CGACAACAATGACTAAGGGG,39,1157966
fldAp,0.125,16,15,CCTTGATACGAATCAGTATT,1,1168938
fldAp,6.8125,123,15,CCTTCCCGTAGTGATCTGAT,108,1121054
fldAp,0.9375,29,15,CCTTAGAGTAAAGATACGAG,14,1162787
fldAp,1.375,36,15,CCTTAATCAGCCCGCTATTG,21,1074682
fldAp,0.125,16,15,CCTGCAAGCAATACAAGTTG,1,1096287
fldAp,0.125,16,15,CCTCTTTGCGTTCTACGAGT,1,1075588
fldAp,5.75,106,15,CCTACACAAAGCCACGGGAA,91,1109780
fldAp,3.4375,69,15,CCGTTTAGGGGCTACCGGAG,54,1119666
fldAp,1.1875,33,15,CCGGAGAACGCACTAGCTTA,18,1091553
fldAp,0.1875,17,15,CCGCCTTTTCCCCCCCACGC,2,1117964
fldAp,3.75,74,15,CCCTGGAACGCGGACGTTCG,59,1181497
fldAp,1.0625,31,15,CCCGGCGCCTGAAGTGCAAA,16,1133623
fldAp,1.4375,37,15,CCCGATACTCGCCGGAGTAG,22,1136111
fldAp,0.125,16,15,CCCAGGTTAGTTTCGATAAT,1,1076526
fldAp,2.6875,57,15,CCCAAATATGCATATGCGGT,42,1184913
fldAp,0.1875,17,15,CCATTTTTAGTATAGAGATA,2,1123230
fldAp,1.0625,31,15,CCATTCGGTGCGTTCACCAT,16,1145202
fldAp,13.125,224,15,CCACATACTATACGACAATG,209,1064778
fldAp,0.125,16,15,CCAAGCCCACAGCGGCACAG,1,1074047
fldAp,1.4375,37,15,CATTTATTTCTGTACCTGAT,22,1086686
fldAp,10.5625,183,15,CATTCGACAGGACGTACCCG,168,1164122
fldAp,1.875,44,15,CATCGCCCCGCGATGTTGAT,29,1114318
fldAp,0.125,16,15,CAGTGCGGCGAGCAATTTGA,1,1171034
fldAp,2.375,52,15,CAGGTCTTCCCCCCCGGGGG,37,1172157
fldAp,0.875,28,15,CAGCTTTACTCTTTCCTATT,13,1152521
fldAp,1.8125,43,15,CACTCCGGCCTCGAATCGGT,28,1131168
fldAp,2.5625,55,15,CACTCCCAAAGTAAGTTATT,40,1169615
fldAp,0.625,24,15,CACCCTTTACATAGAGCAGC,9,1102690
fldAp,1.5625,39,15,CACCCCCTTAGGGTACGTTT,24,1131824
fldAp,0.875,28,15,CACAAGCTGGAATCGTCTTG,13,1102966
fldAp,2.8125,59,15,CACAAATTACCCAGTCCATT,44,1151869
fldAp,1.625,40,15,CAATATCAAATAGGACAACG,25,1127652
fldAp,0.125,16,15,CAACCGTGATAGCCAGGTAT,1,1171811
fldAp,0.1875,17,15,CAACCGAGGCATGCTACATG,2,1085975
fldAp,0.125,16,15,CAAACGCGCGGTCGTTCCGT,1,1171717
fldAp,0.9375,29,15,ATTTATATGGTTTGATTACA,14,1106250
fldAp,1.75,42,15,ATTTAAGATGAAACTGATAA,27,1133888
fldAp,5.5,102,15,ATTATCGTACCCGTTGTAGA,87,1094295
fldAp,3.25,66,15,ATGTGCTTCAGTTGTCGCAG,51,1090022
fldAp,4.125,80,15,ATGGTGTCACTCTGCCCTTT,65,1147700
fldAp,0.1875,17,15,ATGGGGTTTCGGCATCTGGA,2,1068457
fldAp,2.3125,51,15,ATGACACGGACGCAAGGGCT,36,1077837
fldAp,1.5,38,15,ATCTTTTTAAAACGAGTGAC,23,1177728
fldAp,0.125,16,15,ATCGGAACCGGATAAGTCCG,1,1093226
fldAp,1.375,36,15,ATCGCAAAACGTGCAACGTT,21,1091608
fldAp,12.75,218,15,ATCGAGGTAATATCAACTGA,203,1077555
fldAp,3.0625,63,15,ATCGACCCCAGACGTTGCAA,48,1138834
fldAp,3.625,72,15,ATCCGTCTGCGGTGAGATGT,57,1066148
fldAp,0.125,16,15,ATCCCGAGCTATCCTATTTA,1,1112195
fldAp,2.5,54,15,ATCACGTACCTCATCAAGTG,39,1077541
fldAp,1.375,36,15,ATATTAGACAGTCCGCCCGA,21,1113560
fldAp,1.1875,33,15,ATATGCCGACGGCAGCGTTA,18,1091446
fldAp,1.6875,41,15,ATATCCTAGCGGTAGGTGTT,26,1105837
fldAp,0.125,16,15,ATAGTCAATTTTAGTCCACG,1,1172919
fldAp,7.25,130,15,ATAGGTGCGATATTTGACCA,115,1063701
fldAp,1.25,34,15,ATAAACCCCCGACGCCTCCA,19,1146931
fldAp,1.625,40,15,AGTTTGGTCCTGGGAGAACC,25,1072061
fldAp,0.125,16,15,AGTTTGGCCTCTAAGAGCTA,1,1160116
fldAp,8.9375,157,15,AGTCGGTGCGCCCGATCCTA,142,1140907
fldAp,0.75,26,15,AGTCCTCGGTCGGGGGTGAA,11,1149878
fldAp,1.25,34,15,AGGTTGAATGGCCGTATATA,19,1112059
fldAp,4.0625,79,15,AGGTTAGGTTCACCACCTAC,64,1159200
fldAp,2.5625,55,15,AGGTAGGCGCTTTGAGCAAG,40,1107442
fldAp,0.25,18,15,AGGCGTTAATCAGCGCCTCC,3,1074119
fldAp,2.25,50,15,AGGCCTTATGTAACGATAAC,35,1072025
fldAp,0.125,16,15,AGCGTTGCAGGTACTCTGAA,1,1125675
fldAp,1.8125,43,15,AGCGTGCCATAAAGTAATTG,28,1074122
fldAp,1.4375,37,15,AGCGCTGTAGTGGGTTCGAT,22,1077950
fldAp,1.125,32,15,AGCGCCCGATGTGCTGAGAG,17,1163572
fldAp,0.125,16,15,AGAGCCCCGTGATGAGACAA,1,1107007
fldAp,0.875,28,15,AGACGGTTATATTAAGAATC,13,1134200
fldAp,9.3125,163,15,ACTCCTTCCATATGGTTCGT,148,1118331
fldAp,4.5625,87,15,ACTAGGCGGCATATTATGTG,72,1111947
fldAp,2.0,46,15,ACTAACGGCTAGCCCCAAGC,31,1070057
fldAp,2.125,48,15,ACGCGGGGGGGAATTAGGCA,33,1146541
fldAp,1.0,30,15,ACGCCGTCCTAACGATCAAT,15,1159908
fldAp,0.875,28,15,ACGCCAGATATCTTACCGAC,13,1146622
fldAp,1.5,38,15,ACGCAGATAGGATAACGACG,23,1097904
fldAp,1.25,34,15,ACGATAGCTGTTGGGTCACT,19,1076418
fldAp,1.25,34,15,ACGATAAAGGCCCACCGATC,19,1120601
fldAp,1.0,30,15,ACCTTTCATCTTACCAAAGT,15,1164254
fldAp,3.75,74,15,ACCTTGATCATTCATCAGCT,59,1091053
fldAp,1.3125,35,15,ACCGAATGTATAATGGCTGA,20,1097161
fldAp,2.8125,59,15,ACCGAAGTCAGGGTCGCCTG,44,1082113
fldAp,1.1875,33,15,ACCCTAGCACGGGCAAAATG,18,1143185
fldAp,6.4375,117,15,ACCCATATCACTGTTACCTA,102,1103443
fldAp,1.125,32,15,ACCCAGCACCATTTAGTCTC,17,1082481
fldAp,0.625,24,15,ACATTCTGGGTTTGGTCACA,9,1168967
fldAp,0.125,16,15,ACATCTCCGGGAAGATTTGT,1,1178375
fldAp,3.5,70,15,ACATCGGGGATGGGCGTGTC,55,1141747
fldAp,0.125,16,15,ACAGTGATACTTGGAATCTC,1,1174154
fldAp,0.75,26,15,ACAGGAGTTCATGATAGCAG,11,1069014
fldAp,1.1875,33,15,AATTAGAACAACAACCGAAG,18,1120033
fldAp,0.125,16,15,AATGGTGGTATACCGGGCTC,1,1098934
fldAp,1.3125,35,15,AATCCGAAGGATCAAGTTAA,20,1123634
fldAp,0.8125,27,15,AATAAGATATGCTCAGTGCG,12,1130511
fldAp,2.125,48,15,AAGCGGCTCTGTGCGTCGTA,33,1162982
fldAp,5.625,104,15,AAGCCGTACTCAACTTACAT,89,1167182
fldAp,2.875,60,15,AACTCAGTGGCACACACTCG,45,1075036
fldAp,5.1875,97,15,AACGGGAGGTGAGGCCCGGT,82,1155349
fldAp,7.125,128,15,AACGGCCGCTCCGAAAGAGG,113,1071003
fldAp,3.25,66,15,AACCGCGGTAATAGTATACT,51,1097368
fldAp,1.375,36,15,AACATCGTGTTGCTGACTAT,21,1114114
fldAp,1.4375,37,15,AACAGTCTCTTCTTTTGCTT,22,1184713
fldAp,2.3125,51,15,AACACATGTACTCCCGTAAG,36,1070581
fldAp,3.3125,67,15,AAAGGATTACGCACTACGGA,52,1084528
fldAp,3.25,66,15,AAACTTCGAGGGTCAACTTG,51,1112060
fldAp,7.3125,131,15,AAAAACTCGGGTTAGAACAA,116,1157458
fldAp,0.13333333333333333,15,14,TTTTATAGTTTCGTCCCTAA,1,1111734
fldAp,1.7333333333333334,39,14,TTTGTGCTCAAATGAAGTGC,25,1095286
fldAp,1.6666666666666667,38,14,TTTGGGTCTGTAAACATCCC,24,1078383
fldAp,0.2,16,14,TTTGCAATTTTTTCCTTCCA,2,1098948
fldAp,1.6,37,14,TTTCTGAGTGCGTCCAGCAT,23,1090914
fldAp,2.533333333333333,51,14,TTTAACCTCTCGTCTGTGAG,37,1149665
fldAp,2.2666666666666666,47,14,TTGTTACAACTTTGTCGGTG,33,1103234
fldAp,1.1333333333333333,30,14,TTGTATTTGTCCGCTTCTTA,16,1098204
fldAp,3.1333333333333333,60,14,TTGGTAGAGCGTGTGATTGT,46,1082593
fldAp,4.733333333333333,84,14,TTCTTCCTTTGGGCGCATGG,70,1078238
fldAp,1.3333333333333333,33,14,TTATTGTAACAGGAAGGAGG,19,1166016
fldAp,1.8666666666666667,41,14,TTATTGCGAAAGCACAGGCT,27,1135176
fldAp,8.266666666666667,137,14,TTACTTTAACATTTGGTAAC,123,1066015
fldAp,2.8666666666666667,56,14,TTAAGATGAGGCGTTTGCTC,42,1138419
fldAp,0.13333333333333333,15,14,TGTGTAATGAATGACGTGCC,1,1088390
fldAp,2.533333333333333,51,14,TGTATTGGCTGTTTTTGGAA,37,1126861
fldAp,0.2,16,14,TGGTGGAGGAAGTACTAAAA,2,1095522
fldAp,2.1333333333333333,45,14,TGGCGTATTGGTAGTCGGTT,31,1105483
fldAp,5.6,97,14,TGGCCTTCATTTTGTCTACA,83,1077126
fldAp,0.8666666666666667,26,14,TGGCCGGGTCAGAATCGTAT,12,1072998
fldAp,1.0666666666666667,29,14,TGGACTTTGCTGCGTCATAG,15,1165883
fldAp,1.9333333333333333,42,14,TGCTTAGGGCTCCCCCGGTT,28,1090443
fldAp,16.933333333333334,267,14,TGCTAAAATAACGTTCTCGG,253,1114284
fldAp,1.4666666666666666,35,14,TGCCTCATGACGCGGGATTA,21,1186829
fldAp,2.1333333333333333,45,14,TGCAAGGTTGACCGGACTGT,31,1129850
fldAp,3.466666666666667,65,14,TGAGGTGCGATCCGGCTTCA,51,1155626
fldAp,4.133333333333334,75,14,TGAAGCGCACCGGGTGGCTT,61,1168611
fldAp,1.3333333333333333,33,14,TGAACCTTTATCTCGGTTGG,19,1150551
fldAp,0.13333333333333333,15,14,TCTGTTAGAACATTGTGCTA,1,1150266
fldAp,2.6,52,14,TCTGTGTCCACCGACTGTGG,38,1117110
fldAp,3.1333333333333333,60,14,TCTGATGGTGCCCGGTTGTG,46,1073608
fldAp,2.0,43,14,TCTCCTAGGTGAAAGTTGTG,29,1148299
fldAp,0.13333333333333333,15,14,TCGGGGGTGGAAATTGGGGC,1,1177746
fldAp,4.2,76,14,TCGCCGGTTGAGATTCTATG,62,1079560
fldAp,0.4,19,14,TCGCAGGTTCGTCTTGGGTT,5,1125772
fldAp,1.4,34,14,TCGATATACTATCGTGTTGA,20,1132983
fldAp,2.4,49,14,TCCTATACCTGGGCCATTTA,35,1179223
fldAp,10.733333333333333,174,14,TCCTACCACTCTCGGCTCCG,160,1104001
fldAp,1.6,37,14,TCATTGGGTTGAGTGCGAGG,23,1133952
fldAp,1.8666666666666667,41,14,TCATTCCCAAGAACTCTATT,27,1108737
fldAp,1.7333333333333334,39,14,TCACGATTTTCATCATGTGG,25,1107940
fldAp,2.8666666666666667,56,14,TCAATAGTAGGGTTGTCACT,42,1137544
fldAp,2.066666666666667,44,14,TATTTCCTCAGATCACCTAC,30,1077749
fldAp,4.666666666666667,83,14,TATTTCAACCGGGTGCAAGT,69,1126859
fldAp,1.8666666666666667,41,14,TATGATTTCCCGATTACCTA,27,1149712
fldAp,2.2666666666666666,47,14,TATGATCACCATGTGGATTG,33,1132595
fldAp,4.0,73,14,TATCGACTCCACAGCGGCCT,59,1067925
fldAp,2.6666666666666665,53,14,TATCCATATTACATTAACGC,39,1165180
fldAp,5.333333333333333,93,14,TAGGGTACAGCGGCACGCTT,79,1065926
fldAp,5.466666666666667,95,14,TAGGCGCCGGTTATATCAGA,81,1154606
fldAp,0.5333333333333333,21,14,TAGGCACCCCCCCAGATAAG,7,1185594
fldAp,1.4,34,14,TAGCAAAGTGTAGCTAGTCA,20,1073120
fldAp,1.6666666666666667,38,14,TACGTCCTCGCGAAATGAAA,24,1091529
fldAp,3.0,58,14,TACGTATTCTACGCCGGTTT,44,1113223
fldAp,8.266666666666667,137,14,TACGGATCCCGCTATTTATC,123,1085433
fldAp,3.066666666666667,59,14,TACGATACTTAACGCAGTAT,45,1072079
fldAp,0.13333333333333333,15,14,TACCGTCAAGCTCGGTTAGG,1,1093757
fldAp,1.3333333333333333,33,14,TACCACGGGTAGTCCTCTAG,19,1112988
fldAp,1.8666666666666667,41,14,TACAACGCGCTAAATTCAAT,27,1071799
fldAp,0.8666666666666667,26,14,TAATCCAGCTTCGATTGCGA,12,1159400
fldAp,3.4,64,14,GTTTTGTAGAACTCGCCGGA,50,1105845
fldAp,1.8666666666666667,41,14,GTTTTCACGAGTATGCGGTC,27,1064137
fldAp,0.26666666666666666,17,14,GTTTGGGATTAATTATTTAG,3,1109679
fldAp,0.4666666666666667,20,14,GTTTGATCTCGTATGTGGCT,6,1064709
fldAp,1.1333333333333333,30,14,GTTCCATATGGATTTAATAA,16,1080317
fldAp,2.533333333333333,51,14,GTTATTTTCTACCTGAGGCT,37,1124967
fldAp,1.3333333333333333,33,14,GTTATAAAGGAAGTGCTCAT,19,1178804
fldAp,0.4666666666666667,20,14,GTTAGGTGCCGGGCGAGCAT,6,1065753
fldAp,0.13333333333333333,15,14,GTTAGGACTGCATTCAACGG,1,1066952
fldAp,0.7333333333333333,24,14,GTTAGCATTGCGTGCGTTAC,10,1159805
fldAp,1.2,31,14,GTTAGAGCCTGCTATGAATC,17,1103590
fldAp,2.2,46,14,GTTACACCAATGAGGCCTTA,32,1134023
fldAp,0.2,16,14,GTGTTGATGGGATCTTTAAA,2,1116238
fldAp,2.7333333333333334,54,14,GTGTCTACAACAGCAGTACA,40,1086383
fldAp,2.466666666666667,50,14,GTGCGCGCGGCAGGCGTAAA,36,1114378
fldAp,0.13333333333333333,15,14,GTCGTCCCTTTTATTTGCGT,1,1137864
fldAp,0.2,16,14,GTCGAAAGAAGTCTTATGAA,2,1122154
fldAp,0.13333333333333333,15,14,GTCCCGCTGGACTAGCCAAA,1,1073129
fldAp,0.2,16,14,GTCAGCAGCGTATTATCTTT,2,1170812
fldAp,0.13333333333333333,15,14,GTCAGAGCTGCTCCAACTTG,1,1069202
fldAp,3.3333333333333335,63,14,GTATCCTGCTTCCCGTAAAA,49,1105477
fldAp,5.4,94,14,GTAGCTTTAGTGGGCGATCT,80,1106952
fldAp,1.8666666666666667,41,14,GTACTCTCTACCGGACGAGA,27,1134651
fldAp,0.3333333333333333,18,14,GTACACCCCATAGGTCTTGT,4,1146457
fldAp,3.933333333333333,72,14,GTAAGTTGTTACGGAACATA,58,1133359
fldAp,2.533333333333333,51,14,GTAAGAATGAGTATAATTGG,37,1160319
fldAp,2.6,52,14,GTAACCACACTTACAGCATC,38,1078143
fldAp,2.4,49,14,GGTGCACTAGAGCGGCTGAA,35,1152154
fldAp,4.866666666666666,86,14,GGTGAATGATGGCGGAAATG,72,1084537
fldAp,7.6,127,14,GGTATCTTATTTCCGTCGTT,113,1066017
fldAp,2.3333333333333335,48,14,GGTAATATAGCGCCCTCTTT,34,1156284
fldAp,0.13333333333333333,15,14,GGGGGACTAAGGGCGTCTCC,1,1112724
fldAp,1.9333333333333333,42,14,GGGCAACGCGGTATGAGCAG,28,1137752
fldAp,5.466666666666667,95,14,GGGAGATCTCCTGAAACCAA,81,1111339
fldAp,0.13333333333333333,15,14,GGGACCAATGTACCAATCGC,1,1081927
fldAp,11.933333333333334,192,14,GGCTACATCCACTTCCATAC,178,1129900
fldAp,0.4666666666666667,20,14,GGCTAAGGCCCCGACTAACA,6,1168774
fldAp,1.8666666666666667,41,14,GGCGGTTAGATACATCGTTT,27,1103542
fldAp,7.4,124,14,GGCCGGAGTCAGGAGAACAT,110,1116491
fldAp,2.2666666666666666,47,14,GGAGTGGCCTCCTACCAGGT,33,1086475
fldAp,1.6,37,14,GGAGTATTGATCCATAACCT,23,1074466
fldAp,3.0,58,14,GGAGGTTGAAGTGAGGACCT,44,1121157
fldAp,4.066666666666666,74,14,GGAGATAACAAGCAACTCCC,60,1158884
fldAp,1.6,37,14,GGACAGCGGTAGTACAGCCC,23,1140896
fldAp,2.1333333333333333,45,14,GCTTCGACCCGAGATAAAGA,31,1079184
fldAp,0.2,16,14,GCTCATCAGATATGCCAATG,2,1131268
fldAp,2.3333333333333335,48,14,GCTATCCATCCGAAATCTAC,34,1084227
fldAp,6.933333333333334,117,14,GCTAAGACTCGATATCGCGT,103,1078599
fldAp,2.2666666666666666,47,14,GCGCGATAGAAGTTCGGAGC,33,1105741
fldAp,1.4666666666666666,35,14,GCCGTGGAGGTGTATCTTGG,21,1181908
fldAp,1.2,31,14,GCCATGTTGGGTACAGCAAG,17,1138550
fldAp,2.6666666666666665,53,14,GCCAGATACCCGCTTTGCAG,39,1136661
fldAp,4.2,76,14,GCAGCTCTGGCGACCTTAAT,62,1111398
fldAp,0.9333333333333333,27,14,GCACTCTCAGTGTTGGCCTG,13,1146853
fldAp,1.7333333333333334,39,14,GCACCCATGTACACGATAGT,25,1159213
fldAp,0.4,19,14,GCAAGTTTGGCCCTCCGATT,5,1068442
fldAp,0.26666666666666666,17,14,GATTTCCCGAGCAATTCATT,3,1133420
fldAp,0.2,16,14,GATTGATGGTCCGCTCCCAA,2,1079680
fldAp,2.8,55,14,GATCGCCTCGAGAAGGTCAT,41,1161650
fldAp,2.8666666666666667,56,14,GATAGGGTTTATCTTTCAGG,42,1071632
fldAp,7.933333333333334,132,14,GAGTACTGGATCCACCCGTT,118,1066728
fldAp,1.1333333333333333,30,14,GAGCTAGGATGACACTGGGT,16,1132284
fldAp,2.466666666666667,50,14,GACTATTGCTTTTTCCGCAA,36,1108865
fldAp,1.0666666666666667,29,14,GACCAGTTACGCTGCCTTGG,15,1077543
fldAp,0.13333333333333333,15,14,GACCAACTTAAATATTGCGC,1,1121162
fldAp,1.9333333333333333,42,14,GACAGCACTGGCCGCGACAG,28,1150462
fldAp,2.2,46,14,GAAGAAGCAGCAACAAGTGT,32,1125780
fldAp,2.0,43,14,GAAATAGGTAAAACTTAACC,29,1110047
fldAp,2.7333333333333334,54,14,GAAATAATCCTGATAGCGAT,40,1163139
fldAp,1.6,37,14,GAAAAATGCCCACTAGAAAT,23,1160848
fldAp,1.4666666666666666,35,14,GAAAAACAATAGTAAAGTTG,21,1181613
fldAp,1.5333333333333334,36,14,CTTTGCCTATAACGTCGGGT,22,1070133
fldAp,0.13333333333333333,15,14,CTTTAGCTAGCTAGCACATA,1,1065486
fldAp,1.4,34,14,CTTCCCATCACGCTAACCAT,20,1113724
fldAp,1.9333333333333333,42,14,CTTCATAAGGGCGTACCTGT,28,1171890
fldAp,0.5333333333333333,21,14,CTGCTCGTAAGGCCACGGCG,7,1085535
fldAp,5.066666666666666,89,14,CTCTGGGAATTTCCGTCAAT,75,1161656
fldAp,3.6666666666666665,68,14,CTCTGATGAAGTACAGCGAG,54,1137285
fldAp,5.533333333333333,96,14,CTCCTCCATTATAACGGGGA,82,1174618
fldAp,0.13333333333333333,15,14,CTCAGGAAGAGAGACAGAGT,1,1138137
fldAp,2.933333333333333,57,14,CTCAGCTATCCCCCTTTTTT,43,1170050
fldAp,2.6,52,14,CTCAAGTCGTTCTGACGAGG,38,1109947
fldAp,5.2,91,14,CTAACTCCCGAGGACATGGG,77,1137815
fldAp,0.13333333333333333,15,14,CGTTTCACAGTCCTTGTCAT,1,1098941
fldAp,0.8666666666666667,26,14,CGTTGCCTCGGGGGTTAATC,12,1097586
fldAp,1.1333333333333333,30,14,CGTTATTCCAACAATGGGAC,16,1125021
fldAp,1.7333333333333334,39,14,CGTATATAATGTTGAGGTTA,25,1108877
fldAp,2.2666666666666666,47,14,CGTAGCCTCTACATACCCTT,33,1069579
fldAp,23.2,361,14,CGTACAGACTCGAGTCCGAC,347,1064773
fldAp,2.2,46,14,CGGTTGAACAGGGTGGCGCA,32,1094034
fldAp,0.9333333333333333,27,14,CGGTTAAGCGCGCAAGGAAG,13,1153366
fldAp,3.1333333333333333,60,14,CGGTCGGCGAGAAGTCAACC,46,1073501
fldAp,2.2,46,14,CGGTCAACGGCCACACCCCC,32,1158217
fldAp,2.0,43,14,CGGTATTCAGATATGTTCAT,29,1087422
fldAp,2.933333333333333,57,14,CGGGGCCTAGAGTGGCGTTA,43,1114856
fldAp,1.2666666666666666,32,14,CGGCTCCAGGTCCACCGATA,18,1173223
fldAp,0.13333333333333333,15,14,CGGCACAACAGGGAGGTGTA,1,1161034
fldAp,1.4,34,14,CGGAGCGGGAAATGTTTCAG,20,1132777
fldAp,2.0,43,14,CGCGTGGGGCACTTAATCTG,29,1160326
fldAp,2.466666666666667,50,14,CGCGTCTGCTATCTTCAACA,36,1099499
fldAp,20.666666666666668,323,14,CGCGCTCGACAACGTGGCTT,309,1114226
fldAp,0.5333333333333333,21,14,CGCCGCGAGTCGTTAGGTGT,7,1136006
fldAp,6.933333333333334,117,14,CGCCACTCGTGAATCAACAG,103,1179263
fldAp,1.2666666666666666,32,14,CGCAGAAGCCCGTTTGGCGG,18,1182753
fldAp,1.0666666666666667,29,14,CGCACTCTAATTGAGAAGTA,15,1155148
fldAp,2.1333333333333333,45,14,CGCAATGTAACTTGGACAAA,31,1181048
fldAp,0.26666666666666666,17,14,CGCAAATTACATGCCGAGTT,3,1130830
fldAp,0.26666666666666666,17,14,CGATTCTGCGATGTGATCTA,3,1138200
fldAp,1.4666666666666666,35,14,CGAGTCCAGTAGCATCCTTC,21,1069305
fldAp,1.8666666666666667,41,14,CGAGGAAGGTAAGTGGATAG,27,1073418
fldAp,0.2,16,14,CGACTTACCGTGGTAGCTGT,2,1067992
fldAp,1.1333333333333333,30,14,CGACCATTAAAAGCCGTCGC,16,1174062
fldAp,2.2,46,14,CGAATGATTTGATACTTAAC,32,1177873
fldAp,3.533333333333333,66,14,CGAATAGACTAAGCCCCATA,52,1138462
fldAp,2.066666666666667,44,14,CGAACGGACTTTCGTCTATC,30,1083460
fldAp,2.0,43,14,CCTTCTCTCAGGAACTGATT,29,1155356
fldAp,0.13333333333333333,15,14,CCTTAATAACACTAAAGATG,1,1148977
fldAp,1.7333333333333334,39,14,CCTCCGATTGGCGTGCACAC,25,1084632
fldAp,3.933333333333333,72,14,CCTATTGGGGTCGTTGGTGA,58,1070556
fldAp,0.13333333333333333,15,14,CCTAGCGCGGACTTAAATTG,1,1184459
fldAp,0.8666666666666667,26,14,CCGTCGCGACCAGCTAAAGG,12,1071529
fldAp,2.0,43,14,CCGGTGACTATCCATCGGGT,29,1143770
fldAp,5.333333333333333,93,14,CCGGGGCGAGAGCGAGGATC,79,1141752
fldAp,4.533333333333333,81,14,CCGGCTGGGATATATTTTTC,67,1109580
fldAp,5.133333333333334,90,14,CCCTTCATACGAGCGTTCCA,76,1099713
fldAp,1.6666666666666667,38,14,CCCGGATTACTCGAGCTACA,24,1138324
fldAp,2.1333333333333333,45,14,CCCGCTTCTGACAAGGTAAG,31,1128361
fldAp,0.3333333333333333,18,14,CCCATCACGTCGATAGGTCA,4,1176726
fldAp,1.3333333333333333,33,14,CCAGTTGCACCCAACGCAGC,19,1089935
fldAp,1.2666666666666666,32,14,CCAGTCTTCCGTCTACTATC,18,1137817
fldAp,3.6,67,14,CCAGGTGAGTCGAATGGGGG,53,1109681
fldAp,1.6666666666666667,38,14,CCAGCATCGTGAAATTCGTA,24,1100646
fldAp,3.8666666666666667,71,14,CATTGGGCTGGTATCATTCT,57,1146408
fldAp,2.6666666666666665,53,14,CATGTGACCGAAGGGCGCGT,39,1074568
fldAp,2.933333333333333,57,14,CATGCTGGTGCCAGTTTGCT,43,1129761
fldAp,1.6,37,14,CATGAGAGCAGTATTTAGAG,23,1143922
fldAp,3.1333333333333333,60,14,CATCCGTTGGATTTGCAACG,46,1144011
fldAp,2.066666666666667,44,14,CATCCGGCTTTGGGTTCCAG,30,1160544
fldAp,1.4,34,14,CATAACTTTGCGGAGGTGCG,20,1076058
fldAp,10.8,175,14,CATAACCTGTTATGACCAGA,161,1127716
fldAp,1.6666666666666667,38,14,CAGGATAGTCTGCTCATGAA,24,1160450
fldAp,1.9333333333333333,42,14,CACTTAGCCTATGGGACTGT,28,1079207
fldAp,1.0666666666666667,29,14,CACTAATCGAACCGAAGCCG,15,1159744
fldAp,2.8,55,14,CAATTAGGCCTCAGTCGATA,41,1091429
fldAp,3.2666666666666666,62,14,CAAGAGGACGCAAGTCATGT,48,1155688
fldAp,1.4666666666666666,35,14,CAACTCCCGGCCAGGAGCTT,21,1169854
fldAp,12.4,199,14,CAACGGACGTTATCCCGCCG,185,1146170
fldAp,2.0,43,14,CAACCGGTAGCCTGACTAGA,29,1128981
fldAp,0.6,22,14,CAACAAATTGATGTGTGTTT,8,1124344
fldAp,2.8666666666666667,56,14,CAAAAGTGCCAGAACCAACA,42,1114951
fldAp,1.6666666666666667,38,14,CAAAACACTTCCACCCGTGT,24,1076518
fldAp,8.666666666666666,143,14,ATTTGAGGCCGGAGACAAGC,129,1151207
fldAp,5.866666666666666,101,14,ATTTAGCACTACATCTAGTG,87,1178681
fldAp,0.13333333333333333,15,14,ATTCTATCATGGTGAAGCAG,1,1178318
fldAp,0.13333333333333333,15,14,ATTCAGCCGTAGTCATCGAT,1,1081457
fldAp,2.066666666666667,44,14,ATGTGTGCGCCATGGCCAAT,30,1096033
fldAp,1.6,37,14,ATGCTAAACGAGCACTTGTG,23,1135004
fldAp,0.13333333333333333,15,14,ATGAGACGCGATCTCTATAC,1,1145361
fldAp,0.6,22,14,ATCTGAGAAAACGTTTAAGT,8,1167379
fldAp,2.466666666666667,50,14,ATCTACTTCCAATATGAGCT,36,1083820
fldAp,3.466666666666667,65,14,ATCATGCTCAGTGAACTCCG,51,1066286
fldAp,1.4666666666666666,35,14,ATCACGTGGCCACAGAACAT,21,1113393
fldAp,0.2,16,14,ATCACCATATTCGGGTCAAC,2,1156050
fldAp,1.8,40,14,ATATGCCTTATGCTGTGCAA,26,1153400
fldAp,1.1333333333333333,30,14,ATAAAAGGCCCGTTGACCCT,16,1178927
fldAp,1.9333333333333333,42,14,AGTTTACCAATTTTTCCGGA,28,1078956
fldAp,3.2,61,14,AGTTCAATCACCACTGACTC,47,1072051
fldAp,0.13333333333333333,15,14,AGTCCGAGGCACTGTCTCAA,1,1128817
fldAp,0.13333333333333333,15,14,AGGGTGTGTGTCAAGGCTAA,1,1068445
fldAp,0.13333333333333333,15,14,AGGGGGATAACCACGGCTCC,1,1134899
fldAp,1.3333333333333333,33,14,AGGGCGGTAAATCACCTAAG,19,1083940
fldAp,1.4,34,14,AGGCTGCCATTTGTGAGCTT,20,1072198
fldAp,1.5333333333333334,36,14,AGGCGTCACTAAGTGACGAA,22,1175848
fldAp,1.2666666666666666,32,14,AGGAAATCCGGGGAGACTGG,18,1148622
fldAp,0.13333333333333333,15,14,AGCTCATGGTTAGTTAAGTA,1,1181811
fldAp,2.6666666666666665,53,14,AGCGGGAGTAGTTAGAAAAA,39,1081785
fldAp,1.6,37,14,AGCCTTGATGCCCCTACGTC,23,1101013
fldAp,0.13333333333333333,15,14,AGCAAGCACGTCGTGCGAAT,1,1068244
fldAp,1.4666666666666666,35,14,AGATCGGTACCAGCGCAGTT,21,1142115
fldAp,1.5333333333333334,36,14,AGAGTTGGGTCAGTTAACAA,22,1168131
fldAp,1.6,37,14,AGAGTACGCGTCCACGGGTT,23,1083801
fldAp,13.2,211,14,AGAGGCATTTAGCCCGCTCT,197,1135356
fldAp,2.7333333333333334,54,14,AGAGCAAGCTCGCCTGTTTG,40,1084845
fldAp,2.066666666666667,44,14,AGAGACGATGCGCGCCAAAG,30,1104306
fldAp,4.066666666666666,74,14,AGACGTTTGTACTTGCAGCT,60,1147611
fldAp,3.3333333333333335,63,14,ACTGACTGTGTTCATTGTAA,49,1137638
fldAp,1.8,40,14,ACTGAATATACGGACGGACA,26,1150642
fldAp,0.13333333333333333,15,14,ACTATTAGTATCGTCTTTAA,1,1149902
fldAp,2.3333333333333335,48,14,ACTATCGTTTTTTTCGGTCT,34,1090859
fldAp,1.0666666666666667,29,14,ACTATAGATCTAACGGTCCA,15,1125419
fldAp,2.7333333333333334,54,14,ACGTTTGACAATATACATTT,40,1127534
fldAp,2.933333333333333,57,14,ACGTTAAATATTGCAATTGA,43,1118825
fldAp,1.8,40,14,ACGCTAGGGACTTCACAAGT,26,1082143
fldAp,0.6,22,14,ACCTGAGCGTCCCCGAAGGT,8,1099493
fldAp,1.2666666666666666,32,14,ACCTCAGTGTGAGCGTGGCC,18,1109115
fldAp,3.7333333333333334,69,14,ACCCAGCTGGACTACGCTTG,55,1087239
fldAp,1.6,37,14,ACACTCTGCGGGGGACGGAA,23,1173754
fldAp,4.6,82,14,ACAAGGATTCTACGCGTTCA,68,1129749
fldAp,1.1333333333333333,30,14,ACAAGATGGGACGCAAGTAC,16,1142653
fldAp,1.8666666666666667,41,14,AATGCGTAACTCCGACGTAT,27,1162866
fldAp,1.6,37,14,AATCGCGCCGCTTACTGTGT,23,1074470
fldAp,14.733333333333333,234,14,AATAGATTACATGTCAAAGC,220,1127712
fldAp,0.13333333333333333,15,14,AAGTTTCAAATTCAAGGGAT,1,1140158
fldAp,3.7333333333333334,69,14,AAGTCCCCAGTAGTCCGAGA,55,1167264
fldAp,1.4666666666666666,35,14,AAGCCTCAAGACTATTCCAC,21,1149386
fldAp,3.6,67,14,AAGAGTTCAGGTTTCCAGTG,53,1108353
fldAp,1.0,28,14,AAGAATTCCAGTGTATCGTT,14,1097302
fldAp,0.13333333333333333,15,14,AACTTTGAGGACCATAGCTA,1,1182998
fldAp,0.2,16,14,AACTTAGCGGATGTGACGTT,2,1163857
fldAp,2.0,43,14,AACTCCGGCATTTTCTTTGC,29,1151928
fldAp,2.466666666666667,50,14,AACTAACCTGGGCAAGCGCT,36,1079206
fldAp,2.0,43,14,AACGTTCGCTGCACATATGT,29,1104753
fldAp,2.0,43,14,AACACGTGAGTACGCTATCA,29,1150633
fldAp,1.1333333333333333,30,14,AAATTCAAATATCTCAGGGA,16,1152523
fldAp,2.066666666666667,44,14,AAAGTTGGGTTAAAATGTTT,30,1154646
fldAp,6.466666666666667,110,14,AAACTCCAAGGAGTGGCGTT,96,1135844
fldAp,4.666666666666667,83,14,AAACCCTCGAATACGGACGG,69,1090435
fldAp,7.0,110,13,TTTTCACGGGCCGCCTGTTA,97,1094683
fldAp,0.14285714285714285,14,13,TTTGGAACTTGCGGTAACTA,1,1129923
fldAp,1.6428571428571428,35,13,TTTGCATTACTGATCCCAGA,22,1086609
fldAp,14.285714285714286,212,13,TTTCACTGCCTACACAGGAT,199,1112332
fldAp,1.2857142857142858,30,13,TTTAACCTAGAATCCGGCGT,17,1150969
fldAp,1.4285714285714286,32,13,TTGTTGAATTATGAGGGTAT,19,1082972
fldAp,2.5,47,13,TTGTACCGGTAACGGTAAGG,34,1089115
fldAp,2.7142857142857144,50,13,TTGAGTACCTGGGCAACGAG,37,1107343
fldAp,5.285714285714286,86,13,TTCTTTCCTCGCGTGCCCAT,73,1107709
fldAp,1.0,26,13,TTCTTCTTCCCCTTACACCC,13,1074212
fldAp,1.4285714285714286,32,13,TTCTCGGATGCCAACGAGTG,19,1182021
fldAp,3.5,61,13,TTCCCAAGTGGCATAGCTTT,48,1169538
fldAp,0.5,19,13,TTCATACACAAGTTCCCGAC,6,1133941
fldAp,1.9285714285714286,39,13,TTCAGCGCTCGGGGTTCCCA,26,1135927
fldAp,0.8571428571428571,24,13,TTATTGCAGACAGACTTCGA,11,1095371
fldAp,2.2857142857142856,44,13,TTATCTGGTAGGAACAGTTG,31,1114063
fldAp,1.3571428571428572,31,13,TTATAGAACTCAGAGGCTCC,18,1166147
fldAp,6.071428571428571,97,13,TTAGTTTCTTCGCGCCTACT,84,1081372
fldAp,3.7142857142857144,64,13,TTAGCTGGGTAATGCTTGGT,51,1124846
fldAp,3.5714285714285716,62,13,TTACTGCTAGGTTTATAAGG,49,1084448
fldAp,1.7142857142857142,36,13,TTACCCATTCAAACGTTACT,23,1066852
fldAp,3.142857142857143,56,13,TGTTGGTTCTGGGGAGCGAA,43,1136676
fldAp,1.6428571428571428,35,13,TGTGTCCTCCAGGTCAAATA,22,1173301
fldAp,0.7142857142857143,22,13,TGTACACGGTTCGCTCGTTA,9,1069039
fldAp,0.9285714285714286,25,13,TGGTTTCACCAGAAATTTAC,12,1075753
fldAp,2.7857142857142856,51,13,TGGTCCCTACGAGGAGGTGG,38,1150470
fldAp,3.0714285714285716,55,13,TGGTATTTTGGTGCTTCGCC,42,1168285
fldAp,5.571428571428571,90,13,TGGTAAGGAACATGAGATCC,77,1179652
fldAp,1.7142857142857142,36,13,TGGGCTTATGTCGCAGAAAG,23,1096023
fldAp,0.7142857142857143,22,13,TGGCCCTTGTTTCCGCCTCT,9,1173716
fldAp,1.0,26,13,TGGATTGGATCTCACGAAAG,13,1174114
fldAp,5.571428571428571,90,13,TGCTTTGAACGCAGATCTAA,77,1156446
fldAp,1.5714285714285714,34,13,TGCTGGCCTTGATCCCGGAT,21,1178866
fldAp,6.071428571428571,97,13,TGCTACTAGGAGCGCATCCC,84,1069783
fldAp,3.0714285714285716,55,13,TGCAGGTAAAGGGTAAAGGA,42,1078596
fldAp,3.9285714285714284,67,13,TGAGGTTTTCCAATGGTCTT,54,1147549
fldAp,0.7142857142857143,22,13,TGAGGCGCTCATTTTGACAT,9,1162069
fldAp,3.7857142857142856,65,13,TGAATAAGATAAAAACGAGG,52,1105905
fldAp,1.8571428571428572,38,13,TCTTGTGTCTGGCAGTTGTT,25,1150936
fldAp,5.214285714285714,85,13,TCTGCAGGCTAATGACCGAT,72,1147101
fldAp,1.8571428571428572,38,13,TCTCCCGGGCCTGATTACCC,25,1149776
fldAp,3.2142857142857144,57,13,TCTCCATGCGTCGCGGTCCT,44,1131664
fldAp,1.2857142857142858,30,13,TCTCCATCTGCGGCTCAGTC,17,1127599
fldAp,1.2142857142857142,29,13,TCTATTCCTCCATATAATTA,16,1067764
fldAp,3.7142857142857144,64,13,TCTATGAGCGAGGATATAAA,51,1151175
fldAp,1.8571428571428572,38,13,TCTACAGTAATTAAAGGCTA,25,1093533
fldAp,1.4285714285714286,32,13,TCGGCGCTCAAAGGCTAGCT,19,1125293
fldAp,2.2857142857142856,44,13,TCGGCCTCTTTTATTACGAG,31,1067367
fldAp,0.42857142857142855,18,13,TCGGAAGGAATACAAACGGT,5,1149262
fldAp,2.5714285714285716,48,13,TCGCACGGAGTTCCCGGCTT,35,1098834
fldAp,3.142857142857143,56,13,TCGAGCCTCGCGCACAATAT,43,1177355
fldAp,1.4285714285714286,32,13,TCGAGAGGGCGAATACAGTC,19,1140263
fldAp,2.642857142857143,49,13,TCGACCTCAAGTAACCCATA,36,1117114
fldAp,0.5,19,13,TCGAAGGAACGATTGCGAAT,6,1105896
fldAp,1.8571428571428572,38,13,TCCTTGGCAAGGACACAAAA,25,1105850
fldAp,0.35714285714285715,17,13,TCCTCACTGTGCCCAAACCT,4,1178987
fldAp,0.21428571428571427,15,13,TCCTACCTTGGGCTATACCG,2,1169681
fldAp,4.428571428571429,74,13,TCCGACTAGACCATCGTAAC,61,1079196
fldAp,8.642857142857142,133,13,TCCCCCAGGGAAACGTGCCT,120,1085524
fldAp,0.14285714285714285,14,13,TCCCATCAGTAAGGAAGTAA,1,1072403
fldAp,3.5714285714285716,62,13,TCCAATCGCCGGGTAAAAAA,49,1176548
fldAp,3.357142857142857,59,13,TCACTGTGCGACATATTATC,46,1144639
fldAp,0.14285714285714285,14,13,TCAAGCCGAGACGCGTTCGA,1,1115180
fldAp,2.357142857142857,45,13,TCAAAGGGACAGTCAAGAAG,32,1140563
fldAp,4.0,68,13,TATTAACTCATCTTCGCTGC,55,1065223
fldAp,1.3571428571428572,31,13,TAGCCTAAGAGCATTGGGCA,18,1143442
fldAp,1.1428571428571428,28,13,TAGCCAGTCGAGTGGTGAAT,15,1079762
fldAp,0.7857142857142857,23,13,TACTGTTGTTTCAAGGGTAA,10,1072218
fldAp,0.9285714285714286,25,13,TACCTGTCAAACAGCGTTGA,12,1075789
fldAp,2.0,40,13,TACAGTCTGTTATCATGTCT,27,1080492
fldAp,0.14285714285714285,14,13,TACAGGCACCGCCCCAGACA,1,1101125
fldAp,2.2142857142857144,43,13,TAATAAGGGCTCCAGGGGCT,30,1161678
fldAp,0.42857142857142855,18,13,TAAGGGACCGGCGGATTACC,5,1134093
fldAp,1.7142857142857142,36,13,TAACCCGAGCTTAATCATAA,23,1153826
fldAp,3.142857142857143,56,13,GTTTCTAAAAGTGCGAAGCA,43,1125034
fldAp,0.5714285714285714,20,13,GTTTACCCCATCCATGGCAA,7,1123936
fldAp,0.14285714285714285,14,13,GTTGGTAGTGTCTGAAGATT,1,1123119
fldAp,1.5,33,13,GTTCTACCGCAAGTAGATGC,20,1106670
fldAp,0.14285714285714285,14,13,GTGTGTTGACGCGCAACTGA,1,1176828
fldAp,2.4285714285714284,46,13,GTGTGCCATTACATTAGAGG,33,1178659
fldAp,0.5714285714285714,20,13,GTGTACAACCCGAGTGCCAT,7,1132827
fldAp,0.14285714285714285,14,13,GTGGGATCACTTCTATAGAC,1,1137850
fldAp,0.8571428571428571,24,13,GTGGCATCTGTTGATGTGTC,11,1132802
fldAp,0.14285714285714285,14,13,GTGGAATCTATCGTTGTTAC,1,1075759
fldAp,3.0714285714285716,55,13,GTCTGGTTTTTATCCGTCAG,42,1172713
fldAp,4.642857142857143,77,13,GTCTAGTGGAAACTAGCCCA,64,1093415
fldAp,1.7142857142857142,36,13,GTCGGGGGCTTTGGGATGCA,23,1103819
fldAp,1.2142857142857142,29,13,GTCGCCGGGTAACACATAAC,16,1068546
fldAp,11.428571428571429,172,13,GTCGATAATCCAGCTATCAT,159,1178674
fldAp,1.7857142857142858,37,13,GTCCGGTAGTCGGGCGAGTA,24,1090365
fldAp,0.14285714285714285,14,13,GTCCGCCGGGTGATTCGCGC,1,1186252
fldAp,1.8571428571428572,38,13,GTCCCTCCGACATTACACTG,25,1186093
fldAp,2.2857142857142856,44,13,GTATGTTCAGCGTGGTAATT,31,1068124
fldAp,2.7857142857142856,51,13,GTATGTTACGAGCTCAAAGC,38,1185361
fldAp,3.0,54,13,GTATGAACTGCATGTCGTGT,41,1104995
fldAp,6.857142857142857,108,13,GTACTTTTATTTAGACCTCA,95,1126402
fldAp,1.0,26,13,GTACTTGAAGAAGTACCAGG,13,1066367
fldAp,10.0,152,13,GTACTTACTCAACCAAAACA,139,1140890
fldAp,2.4285714285714284,46,13,GGTGTGGCACGTCAATCAAC,33,1109514
fldAp,2.142857142857143,42,13,GGTCCGGCCTCTATAGACGT,29,1093060
fldAp,2.7857142857142856,51,13,GGTCAGCACCGGTGCAGAAA,38,1131853
fldAp,10.0,152,13,GGGTGGTACTAGATTCCTTG,139,1077548
fldAp,0.14285714285714285,14,13,GGGGATGAGTCTAGATCCCG,1,1067557
fldAp,3.2857142857142856,58,13,GGGGACAGTGGTAGACGGTA,45,1163958
fldAp,1.6428571428571428,35,13,GGGCGTAGGGTGTTCGCTGT,22,1127615
fldAp,2.2142857142857144,43,13,GGGCGCTTTTAGGGCGCATC,30,1087279
fldAp,9.571428571428571,146,13,GGGCCGCGGAGTATGCTCGA,133,1114256
fldAp,6.571428571428571,104,13,GGGACCATAAGCTATACAAG,91,1108055
fldAp,3.0714285714285716,55,13,GGCTGTGGATAGTGCGGTGA,42,1095709
fldAp,2.142857142857143,42,13,GGCTGAGCACAGCAACCGTT,29,1111756
fldAp,0.14285714285714285,14,13,GGCTCCTGGTGCCCGTGGAG,1,1132504
fldAp,1.7857142857142858,37,13,GGCGTGCTGAAAACACGCGC,24,1182916
fldAp,0.14285714285714285,14,13,GGCGAATAGTCTGAGGTTCA,1,1161181
fldAp,2.7142857142857144,50,13,GGCATTACATACGGTTGGGT,37,1084987
fldAp,3.142857142857143,56,13,GGCACCTCAGAATCGAATAC,43,1162569
fldAp,18.928571428571427,277,13,GGATGTGATAATCCTGGGCT,264,1176940
fldAp,1.8571428571428572,38,13,GGAGTGCCGGTGCAGCAATT,25,1073658
fldAp,0.14285714285714285,14,13,GGAGGTTGCACCAATCCATA,1,1116986
fldAp,3.2142857142857144,57,13,GGAGGGGTGTTACGTAAATT,44,1154167
fldAp,2.7142857142857144,50,13,GCTCTAGCACATGCAAACGT,37,1112442
fldAp,0.21428571428571427,15,13,GCTACGGGGCTTTCCATATC,2,1161266
fldAp,1.0714285714285714,27,13,GCGTCTACCATACAGTATTC,14,1070918
fldAp,2.9285714285714284,53,13,GCGGTAGGCAGTACTTGTGA,40,1146243
fldAp,5.785714285714286,93,13,GCGCTCTCGTCTGCAGGTCC,80,1113331
fldAp,0.42857142857142855,18,13,GCGCGATGGGGTAGTTAGTT,5,1125260
fldAp,0.9285714285714286,25,13,GCCTCCCAAGATAAGAGCGG,12,1099278
fldAp,1.0714285714285714,27,13,GCCGGATAAGTGGGCAAGGC,14,1129273
fldAp,1.3571428571428572,31,13,GCCCGGCTTCCGCAATTTAT,18,1128211
fldAp,0.5714285714285714,20,13,GCCAAGGTATGTTGCGGAAT,7,1151560
fldAp,6.071428571428571,97,13,GCAGTAAAGTTAGTAGAACA,84,1165595
fldAp,1.5,33,13,GCAGGTGGGAGCATCCGGTA,20,1104886
fldAp,1.6428571428571428,35,13,GCAGGCATCTGGCACATCGA,22,1135751
fldAp,1.0,26,13,GCACATCCTTCATAGAGCCC,13,1145973
fldAp,0.6428571428571429,21,13,GCAATGAATAAGGCCACTCT,8,1165647
fldAp,3.142857142857143,56,13,GATTGATTTATATAGAGCGG,43,1066195
fldAp,2.857142857142857,52,13,GATGTACGGGAAATCAGGCG,39,1148098
fldAp,3.0,54,13,GATCTTTCGTCTCGCGTGTG,41,1110590
fldAp,1.7142857142857142,36,13,GATATTCTTGTTGGTAACGA,23,1073026
fldAp,3.0,54,13,GATAGTCAGCCATGGTCCGG,41,1124345
fldAp,0.21428571428571427,15,13,GAGGGGAATTAATCGTTCTC,2,1081477
fldAp,2.2857142857142856,44,13,GAGGATATGTCTCTGTACGT,31,1184176
fldAp,2.357142857142857,45,13,GAGCAGGCCAGTTAACGTTC,32,1077952
fldAp,1.3571428571428572,31,13,GACGCAGCATGGCCCCATGA,18,1095808
fldAp,2.5,47,13,GACCTATCAACTCCACAGGA,34,1170953
fldAp,1.4285714285714286,32,13,GACCGGGCCAAGGTTGGTTA,19,1134844
fldAp,2.0,40,13,GACCCGGCGTCTGTAGGGCC,27,1086720
fldAp,6.785714285714286,107,13,GACATCACGTAGCCTGCATA,94,1137293
fldAp,0.21428571428571427,15,13,GAAGTAGCGGCTTATGTATT,2,1090207
fldAp,1.5,33,13,GAAGGATCCTGGAGAAGCCC,20,1145347
fldAp,2.5714285714285716,48,13,GAAGCGAGCGTTTCTGTTGA,35,1142847
fldAp,4.928571428571429,81,13,GAAACGCCCCGCCCCACTGA,68,1176747
fldAp,3.9285714285714284,67,13,CTTTGAACGAACAAGATCTG,54,1179126
fldAp,1.5,33,13,CTTTAGGTTTTGGCCCACGT,20,1181668
fldAp,4.857142857142857,80,13,CTTTAAGATAATACGTCAAA,67,1094687
fldAp,2.0,40,13,CTTGTCAGAGGACTAGACAC,27,1090131
fldAp,0.14285714285714285,14,13,CTTGGGCAACAGCTGGGAGC,1,1089481
fldAp,1.9285714285714286,39,13,CTTGGCTCCTCGCTTAAAGT,26,1112557
fldAp,0.9285714285714286,25,13,CTTGCCACCAATGTGCAGGG,12,1066325
fldAp,3.5,61,13,CTTAAGGGGACACGGCGGTA,48,1083800
fldAp,1.9285714285714286,39,13,CTGTAAGGGTTATTTTTTCA,26,1075041
fldAp,1.0,26,13,CTGCTAACGTATCCGTGTTT,13,1160775
fldAp,4.5,75,13,CTGAGGATCTACCATATTGA,62,1140305
fldAp,1.7857142857142858,37,13,CTCCAAGGAACGGCACCGAA,24,1097571
fldAp,1.0714285714285714,27,13,CTCATCTAATGCCTCGAAAT,14,1143737
fldAp,0.14285714285714285,14,13,CTAGTCAAGCCTACCGCGAG,1,1096014
fldAp,0.14285714285714285,14,13,CTAGGGAGCTTCGAAGTGAG,1,1076904
fldAp,0.7142857142857143,22,13,CTAGCTAGCTAGCGCTGGGA,9,1128969
fldAp,2.5,47,13,CTAGCGATCGTATTCTGGTT,34,1167405
fldAp,0.14285714285714285,14,13,CTACGCTTACTCGGCGCTTA,1,1083266
fldAp,3.5,61,13,CGTGGGTCATCCGAACACAC,48,1146479
fldAp,8.285714285714286,128,13,CGTGGATTCTGCTTTAGGCA,115,1066748
fldAp,1.7857142857142858,37,13,CGTCAACAACCATTTTAGAA,24,1129336
fldAp,3.142857142857143,56,13,CGTAGTGGGAAATCTCACGG,43,1068549
fldAp,0.14285714285714285,14,13,CGGTCACACAGCGCCGATTA,1,1152066
fldAp,1.9285714285714286,39,13,CGGACAGTGCGTCAGAATCT,26,1162674
fldAp,1.0714285714285714,27,13,CGCTTGCGCGTATCAGCACT,14,1065251
fldAp,1.5,33,13,CGCCGGCAGAGTGCCCTTCA,20,1162266
fldAp,1.8571428571428572,38,13,CGCAGACTAAAAGAGCCGTA,25,1137330
fldAp,0.14285714285714285,14,13,CGATTTGTCGTTAGTAGTAT,1,1157113
fldAp,2.142857142857143,42,13,CGATTAATGAGCTAATGGAT,29,1092485
fldAp,1.5,33,13,CGACGTAGGGTGTTCATGGA,20,1123224
fldAp,2.7857142857142856,51,13,CGACGGGCTAGCTCTCCGTA,38,1085527
fldAp,0.5714285714285714,20,13,CGAACCAGCTCGATTCCTCA,7,1176352
fldAp,0.6428571428571429,21,13,CCTCGCTACTGCTTCGAGAG,8,1117821
fldAp,12.642857142857142,189,13,CCTCACAGAGTAGCAGTGAT,176,1066010
fldAp,1.5,33,13,CCTAGTAGCCTTTTCGTGAT,20,1154108
fldAp,0.14285714285714285,14,13,CCGTTCACTCATCGTGCCGA,1,1151758
fldAp,2.642857142857143,49,13,CCGTGTGGCGAGGTCATTAT,36,1098723
fldAp,0.14285714285714285,14,13,CCGTCGTTACAACTTTCGGA,1,1145737
fldAp,1.2142857142857142,29,13,CCGGGTCATGAAATGACCGA,16,1164126
fldAp,1.5,33,13,CCGGCGTTTTCGTTCTGCCA,20,1083898
fldAp,0.14285714285714285,14,13,CCGGATCGGCGGGTTAAGAA,1,1109429
fldAp,0.14285714285714285,14,13,CCGCTCCAATCCGCCTTCAA,1,1154237
fldAp,0.14285714285714285,14,13,CCGCCATTGGGAAATGTGCT,1,1132956
fldAp,0.14285714285714285,14,13,CCGATCGCACCAAAATGTCA,1,1107239
fldAp,6.0,96,13,CCCTGACGAGTTGCTTCTCA,83,1101568
fldAp,0.6428571428571429,21,13,CCCTCCCGTTTTTGATCACT,8,1071734
fldAp,0.14285714285714285,14,13,CCCGGTAACTATTGATGGAT,1,1133637
fldAp,0.6428571428571429,21,13,CCCGACGGTTCGGTTAAGGA,8,1183173
fldAp,2.0714285714285716,41,13,CCCCGTCCGCGACCCAAGAG,28,1133680
fldAp,1.1428571428571428,28,13,CCCACTAGGTAACATGAAGT,15,1154970
fldAp,2.0714285714285716,41,13,CCATCTCTAGTCTCATTTAA,28,1113228
fldAp,2.857142857142857,52,13,CCACGTGCGTCATCTGCAAT,39,1161177
fldAp,1.4285714285714286,32,13,CCACCAGTTGCATGACCCCC,19,1088588
fldAp,1.8571428571428572,38,13,CCAATACTATGATATGGGGA,25,1098816
fldAp,0.14285714285714285,14,13,CCAAGATGCCCGATGGGATA,1,1064042
fldAp,1.4285714285714286,32,13,CCAACCGGGCTTTTTCATCA,19,1181047
fldAp,1.9285714285714286,39,13,CATGTAGCACCCCTTACGCA,26,1125179
fldAp,0.21428571428571427,15,13,CATGCGTACCAGGCACCCCT,2,1183102
fldAp,3.642857142857143,63,13,CATCGGTAAGATGATGTACT,50,1160644
fldAp,1.6428571428571428,35,13,CATCGAATCGACTTTCTTTA,22,1151113
fldAp,0.14285714285714285,14,13,CATCCCTAGGACTCTCTCCG,1,1172627
fldAp,0.14285714285714285,14,13,CATCAACCTGGGGAGGGAAG,1,1149312
fldAp,1.2142857142857142,29,13,CATATGCGGTTCCATGGGGT,16,1156286
fldAp,0.14285714285714285,14,13,CATATCTATCCACCTGCTCG,1,1139963
fldAp,1.8571428571428572,38,13,CAGTACCCGCCTGACAAATT,25,1113944
fldAp,1.1428571428571428,28,13,CAGTAACGGCGTCATGGTTA,15,1076998
fldAp,1.6428571428571428,35,13,CAGGGTTCTACGACCACCCT,22,1175230
fldAp,2.0,40,13,CACTGCCCGACCGCTTAGAC,27,1169679
fldAp,0.2857142857142857,16,13,CACTATCTTTCACACGAAAG,3,1185276
fldAp,5.071428571428571,83,13,CACGTAAGCAAGTTGCCCAC,70,1165632
fldAp,1.2857142857142858,30,13,CACCGGGCACCGTTTTATTT,17,1115399
fldAp,1.3571428571428572,31,13,CACATTTCTGTGCCATGGGG,18,1090371
fldAp,1.5714285714285714,34,13,CAATTCTATGGCGTGGCAAA,21,1125418
fldAp,0.5714285714285714,20,13,CAATGGATAAAGACTGTGAG,7,1096176
fldAp,1.0,26,13,CAATGCGCGCGGACAATCCA,13,1101302
fldAp,5.5,89,13,CAAGATAGATACATGGATAT,76,1112725
fldAp,4.642857142857143,77,13,ATTCGCGTAGTATAAAGTCA,64,1146187
fldAp,1.5714285714285714,34,13,ATTCGAACGAGTGTCGCCAG,21,1078075
fldAp,2.2857142857142856,44,13,ATTCCTCTAAGCCTGCAGAT,31,1171818
fldAp,3.2857142857142856,58,13,ATTCCACTATAAAACTGACT,45,1156150
fldAp,0.14285714285714285,14,13,ATTCACAACTGCCCCGCTTG,1,1103367
fldAp,5.857142857142857,94,13,ATGTATTCAGTGAGTGCTAA,81,1105842
fldAp,0.6428571428571429,21,13,ATGTATACGCAACATGTAAG,8,1079791
fldAp,0.9285714285714286,25,13,ATGGGCCGGAACCACCGTCC,12,1151197
fldAp,2.2857142857142856,44,13,ATGCTAAGCTGAAATGGGGA,31,1084990
fldAp,2.7857142857142856,51,13,ATGCAACGCAATACCAGTCT,38,1130429
fldAp,1.7857142857142858,37,13,ATGAAGTATCGATTCTGTGC,24,1110148
fldAp,1.3571428571428572,31,13,ATCGTGCAAAGTTGCGTCAT,18,1081041
fldAp,3.7142857142857144,64,13,ATCGCTATCGCGGAATCCGT,51,1171909
fldAp,3.0,54,13,ATCGAACCTTGCATTCGGGA,41,1168922
fldAp,6.357142857142857,101,13,ATCCTAGTACAGTCAGTGGT,88,1177705
fldAp,0.14285714285714285,14,13,ATCCGGACCGCATGGTCGCA,1,1073722
fldAp,2.642857142857143,49,13,ATCCAATTAAGTACCCCTGA,36,1080961
fldAp,1.2142857142857142,29,13,ATCATTAGTGTTGCAAACTT,16,1103655
fldAp,1.9285714285714286,39,13,ATATCGCAGCGTGCGACACA,26,1129710
fldAp,0.14285714285714285,14,13,ATATCAGGCATAATTTGTCC,1,1129192
fldAp,2.0714285714285716,41,13,ATATAGAATAGCATGGCCAC,28,1064985
fldAp,0.35714285714285715,17,13,ATAGTAAGTCTTACTGCTCC,4,1117861
fldAp,1.2857142857142858,30,13,ATAGCTGAGTGCACATAACA,17,1176667
fldAp,4.642857142857143,77,13,ATAGCCAAAGGTGTGCTGAT,64,1182995
fldAp,2.5,47,13,ATAGATCCCCCATAAACGCT,34,1139964
fldAp,0.14285714285714285,14,13,ATACGATTCGCCTCTTTTTT,1,1172153
fldAp,1.4285714285714286,32,13,ATAAGCTGGGAGTAATTGTC,19,1150941
fldAp,3.142857142857143,56,13,ATAAATCAGGCGGCAAGTTT,43,1141806
fldAp,5.285714285714286,86,13,AGTTATTTAATCGCCTGGGA,73,1175233
fldAp,2.142857142857143,42,13,AGTGCGCATGTACGAACCAG,29,1079741
fldAp,0.21428571428571427,15,13,AGTCATTTTGATATAAACCA,2,1080383
fldAp,8.0,124,13,AGTATAAAAACTTAGTCCCT,111,1108056
fldAp,4.5,75,13,AGTACGGTTTGTAAGGATGG,62,1121065
fldAp,3.2857142857142856,58,13,AGGTTTCGGTAGATATATAG,45,1121161
fldAp,1.2857142857142858,30,13,AGGTAGGAAGGCCTTCAATG,17,1176648
fldAp,1.6428571428571428,35,13,AGGGGCGTTTTGGCGTTGAA,22,1125313
fldAp,3.142857142857143,56,13,AGGGGCATGTTTCAAGCACT,43,1099249
fldAp,2.4285714285714284,46,13,AGGGGACTCTAGCTTCGTGA,33,1072597
fldAp,1.9285714285714286,39,13,AGGGAGGTGAGGTTCCCGGC,26,1122837
fldAp,4.357142857142857,73,13,AGGAGCTTTGAGGTGCCCAA,60,1132700
fldAp,6.714285714285714,106,13,AGCCGCTAAGAGCCCCTCAT,93,1079554
fldAp,0.14285714285714285,14,13,AGCCGCGAGGAGGACAGAAT,1,1139151
fldAp,2.642857142857143,49,13,AGCCCGTTACGCGAGACCAC,36,1078009
fldAp,4.142857142857143,70,13,AGCAGATAAACTAATTTCAA,57,1153802
fldAp,1.7857142857142858,37,13,AGCAATTCTGACTCTACGGT,24,1114230
fldAp,1.7857142857142858,37,13,AGCAAGCATCGACAGGTTGA,24,1124427
fldAp,3.142857142857143,56,13,AGATTGGTCGATCTTATAAT,43,1068592
fldAp,2.2857142857142856,44,13,AGACGGTACTGAAATAACAG,31,1065253
fldAp,2.7857142857142856,51,13,AGAAAGCCACCAAATGCGCT,38,1087418
fldAp,1.7142857142857142,36,13,ACTTTGTAAGGCGTATATAA,23,1068779
fldAp,5.428571428571429,88,13,ACTGTACTTGTCATAATAGC,75,1162817
fldAp,0.14285714285714285,14,13,ACGTTGCGTTCACGCCGGGG,1,1079790
fldAp,1.5714285714285714,34,13,ACGGAATATAAGGCGAGTGG,21,1088152
fldAp,3.0,54,13,ACGCGCTAGAGCGCGTCATT,41,1114330
fldAp,2.9285714285714284,53,13,ACGATTGAATTGGCAGGCTA,40,1158426
fldAp,1.7142857142857142,36,13,ACCGCACATCAATGTGTTAC,23,1085885
fldAp,2.857142857142857,52,13,ACAGCCATATAACGCATCAT,39,1110927
fldAp,5.285714285714286,86,13,ACAGATTTCGTAAGGTGGCA,73,1185197
fldAp,4.642857142857143,77,13,ACACGCGGTGGCCAGGACAG,64,1144744
fldAp,3.7142857142857144,64,13,ACACGACTTGCTCAAGCCCA,51,1070620
fldAp,1.2142857142857142,29,13,ACAAGGGGGATCGCAGTACC,16,1185923
fldAp,1.3571428571428572,31,13,ACAAGCAGGAGCTGGGGGCA,18,1128748
fldAp,5.5,89,13,ACAACTACGGACGCCCTCCA,76,1181812
fldAp,4.5,75,13,ACAACCAAGGCGCACGTTAA,62,1106122
fldAp,1.3571428571428572,31,13,AATTTAGGATATTATCCCCG,18,1129519
fldAp,2.0,40,13,AATTTAAGCATGAACAAGAA,27,1098525
fldAp,4.071428571428571,69,13,AATGGGGGGAATCGACGACG,56,1093397
fldAp,3.2857142857142856,58,13,AATCTCGGGCACGAAACGAA,45,1094307
fldAp,4.714285714285714,78,13,AATATTTGCGGTCTAGCTTG,65,1147223
fldAp,2.0714285714285716,41,13,AAGTTCATCACATAGCAATT,28,1117027
fldAp,0.14285714285714285,14,13,AAGTGACTGTCGCTCGTGAT,1,1078242
fldAp,11.714285714285714,176,13,AAGGTGCAAGGAGCGTAATA,163,1073334
fldAp,1.9285714285714286,39,13,AAGCGGGCTGAAACGGATGG,26,1160150
fldAp,4.142857142857143,70,13,AACTTGAGGAAAATAAGTTC,57,1067610
fldAp,1.4285714285714286,32,13,AACTGATCGGAAGTGGTCCT,19,1114851
fldAp,5.428571428571429,88,13,AACTACCCATCAATCCAGCA,75,1070359
fldAp,1.6428571428571428,35,13,AACCTGGCTGGTCCCCATTT,22,1114426
fldAp,2.857142857142857,52,13,AACCTATTTAGGTAAGCCGT,39,1075434
fldAp,2.2857142857142856,44,13,AACACTGTTTACCGGAAGGG,31,1138433
fldAp,2.357142857142857,45,13,AAATCAACGATGCTAATGTA,32,1076610
fldAp,0.15384615384615385,13,12,TTTTTGTCGATTAGACTTTA,1,1101858
fldAp,4.769230769230769,73,12,TTTTCATGCTAATCGCTAGA,61,1124328
fldAp,0.15384615384615385,13,12,TTTCGTTTAACAAGGGTCCT,1,1155341
fldAp,3.3076923076923075,54,12,TTTCAGATAGGCCCTCTGGT,42,1067845
fldAp,4.461538461538462,69,12,TTTACTTAAGTCGGATGCAA,57,1089515
fldAp,2.6923076923076925,46,12,TTGGGGCGTTTACCTTTGTG,34,1127933
fldAp,3.6153846153846154,58,12,TTGGATATCGGCTGTACCTC,46,1135316
fldAp,2.6153846153846154,45,12,TTGCTGTATTGGTCCTCCAT,33,1094498
fldAp,1.5384615384615385,31,12,TTGCCATCCTCCCCGATATT,19,1089059
fldAp,5.6923076923076925,85,12,TTGATCAGATGAGTTGTCCT,73,1119668
fldAp,2.3846153846153846,42,12,TTCTTGTCGCCGTGCGGCGA,30,1110376
fldAp,1.6923076923076923,33,12,TTCGGGTTAGCGGCGTTCAT,21,1154453
fldAp,1.9230769230769231,36,12,TTCGGGCGATACGCCCTTGA,24,1179083
fldAp,3.769230769230769,60,12,TTCGCCTGCGGTGTGGCGGG,48,1146272
fldAp,2.230769230769231,40,12,TTATGGGTTCGAGAAACGTT,28,1151114
fldAp,2.3076923076923075,41,12,TTATAGCCGGCCCCTGGGCA,29,1126868
fldAp,3.1538461538461537,52,12,TTAGATAACCTGTTACATAT,40,1105732
fldAp,2.5384615384615383,44,12,TTAATCAATGTGCAAATAGT,32,1181654
fldAp,2.230769230769231,40,12,TTAAGTGCATTAAATACTGG,28,1140953
fldAp,0.3076923076923077,15,12,TTAAGAAAGAGGCATGGGTG,3,1172338
fldAp,0.15384615384615385,13,12,TTAAAGCGGAATGCGTGGCA,1,1129417
fldAp,1.8461538461538463,35,12,TGTTTCTTGCACGATTAAAT,23,1098767
fldAp,0.38461538461538464,16,12,TGTTCTGTATGCCGCATAGA,4,1083416
fldAp,3.923076923076923,62,12,TGTGATGTCGGGTGTTCTAT,50,1070134
fldAp,2.4615384615384617,43,12,TGTCTCGGGGGGCCATTGTG,31,1101521
fldAp,2.923076923076923,49,12,TGTCTACCCAAGGGACGTAG,37,1093318
fldAp,2.0,37,12,TGTAGGTCTGGGGGCGCGGG,25,1108525
fldAp,2.3076923076923075,41,12,TGGTGAAAGAGAGGCCAAAA,29,1074719
fldAp,3.0,50,12,TGGTAGTAGAGTTGGATGTG,38,1171363
fldAp,4.153846153846154,65,12,TGGCCTCCTCTGAACCTTGT,53,1117865
fldAp,3.230769230769231,53,12,TGGCCTCATCCCCGAGGTTG,41,1138340
fldAp,1.7692307692307692,34,12,TGGATCATCTGCGGACGCAT,22,1172158
fldAp,2.230769230769231,40,12,TGGAAGGCTTCGATTAGACT,28,1156985
fldAp,0.46153846153846156,17,12,TGCGTGGACAGAGCGCCTCC,5,1079904
fldAp,0.15384615384615385,13,12,TGCCGAGGGCAGAAGTAACA,1,1125035
fldAp,1.7692307692307692,34,12,TGCAGCAGATTGACCTTAAA,22,1179989
fldAp,2.076923076923077,38,12,TGATTGGCGATATCCCGATA,26,1127029
fldAp,1.6153846153846154,32,12,TGACTAGAGGTGGCGTTTTT,20,1097689
fldAp,2.1538461538461537,39,12,TGAAGCCATCCGCAAAATGA,27,1169980
fldAp,5.0,76,12,TGAAAAGTGGGGATATCATG,64,1162807
fldAp,0.15384615384615385,13,12,TCTTCGAGCATTCCGCTGAG,1,1145513
fldAp,0.15384615384615385,13,12,TCTGTTTTCTCAAGTGCTCC,1,1125080
fldAp,0.15384615384615385,13,12,TCTGGCGGAGTTTCCCCCGG,1,1171632
fldAp,3.8461538461538463,61,12,TCTCACTCCTAGATCGGAAC,49,1084512
fldAp,0.15384615384615385,13,12,TCTAGGGATGTCCACAAGGC,1,1073984
fldAp,11.846153846153847,165,12,TCGTAGGTTGAACCCCCAGA,153,1135666
fldAp,0.23076923076923078,14,12,TCGGTGGACTCAAACTTTTC,2,1082763
fldAp,0.6153846153846154,19,12,TCGGTATATCGCGTTCATCT,7,1130838
fldAp,1.0769230769230769,25,12,TCGGGACTGCAATGTCCCCA,13,1148285
fldAp,1.0,24,12,TCGGACCGGCAACCGCTTAT,12,1109391
fldAp,9.307692307692308,132,12,TCGCCTCTCCAGCATCAGAC,120,1110143
fldAp,1.5384615384615385,31,12,TCCTCTTCTTATCCTTGATT,19,1085125
fldAp,1.9230769230769231,36,12,TCCGATTGTCCTACAGGATA,24,1149972
fldAp,1.6153846153846154,32,12,TCCCTCTGGTAACTCTACTA,20,1145652
fldAp,7.0,102,12,TCCCCACAAAAGAGGTAAGT,90,1078770
fldAp,4.461538461538462,69,12,TCCAAACAGCACACGTGACA,57,1117015
fldAp,3.076923076923077,51,12,TCATGATAACAGTTGGATCA,39,1108559
fldAp,5.3076923076923075,80,12,TCATCTCCTTGGACGGTCGG,68,1154498
fldAp,0.6153846153846154,19,12,TCAGCAGAGTCCCCCGCTTA,7,1145007
fldAp,2.1538461538461537,39,12,TCACCCGGGCGAGGAGTGTG,27,1075142
fldAp,6.0,89,12,TATTTTGCGGAACTCGAACA,77,1158804
fldAp,2.6153846153846154,45,12,TATTGCGAGTCTGGCGTATT,33,1140479
fldAp,0.15384615384615385,13,12,TATTATATTGAAGTTCCCTA,1,1129841
fldAp,0.15384615384615385,13,12,TATCTGTTCCTAATGTGCCT,1,1173541
fldAp,0.38461538461538464,16,12,TATCTCAGGTAGCAGTATTG,4,1161490
fldAp,6.6923076923076925,98,12,TATCGAAGCTCACGAGCATT,86,1109736
fldAp,10.461538461538462,147,12,TAGGGCTTTGAATCTGCAGT,135,1128179
fldAp,2.0,37,12,TAGCCTGCGTCTGCGACCTT,25,1102968
fldAp,0.9230769230769231,23,12,TAGCCGCGACTTTGGGTGAT,11,1127215
fldAp,3.6923076923076925,59,12,TAGAGTTAAGGACGCAAGCT,47,1084758
fldAp,0.15384615384615385,13,12,TAGAGGGCGTCCGGGTCGGT,1,1142383
fldAp,1.7692307692307692,34,12,TAGACACGTATGGTCTCACC,22,1131141
fldAp,1.7692307692307692,34,12,TACTCGGGCGCGCAGCCTCT,22,1132314
fldAp,3.6153846153846154,58,12,TACGCAAATGGCCCGTTGAG,46,1097329
fldAp,8.76923076923077,125,12,TACCCGGCCAGTAAAGCATA,113,1093342
fldAp,1.8461538461538463,35,12,TACATTCATTACCCACAATG,23,1071923
fldAp,0.3076923076923077,15,12,TACAAAATAGGTGTCGCAAC,3,1097045
fldAp,0.8461538461538461,22,12,TAAGGGTTTCTTATTGGGAT,10,1086295
fldAp,2.3846153846153846,42,12,TAACATAAATATAGGTCGCT,30,1071776
fldAp,2.230769230769231,40,12,TAACAAAAATAGAGCAGCGA,28,1110323
fldAp,1.6923076923076923,33,12,GTTTCTTGACCTTAATATAC,21,1090429
fldAp,2.6153846153846154,45,12,GTTGATAGGTATCCGTTACA,33,1064135
fldAp,3.6153846153846154,58,12,GTTCTGCTTTAATTGGCCAT,46,1107021
fldAp,0.5384615384615384,18,12,GTTCGACAGTTGAGCACCAG,6,1163098
fldAp,0.5384615384615384,18,12,GTTAGGGCGAGTAAATGAGA,6,1150455
fldAp,2.230769230769231,40,12,GTTAGAGTCACCGTGGGCGT,28,1157290
fldAp,1.6153846153846154,32,12,GTGTGTATCTCTAAGAACGA,20,1063074
fldAp,0.9230769230769231,23,12,GTGTCACTATAAGTACGGCA,11,1105649
fldAp,1.3076923076923077,28,12,GTGTAACGGGGTATTACCGG,16,1069712
fldAp,4.769230769230769,73,12,GTGGTTGCCTATAAGTGTTC,61,1067739
fldAp,1.3076923076923077,28,12,GTGCTCTGGGTCTCCTCACA,16,1081215
fldAp,2.0,37,12,GTGAGCGCCTCCAAATATGG,25,1081048
fldAp,1.6923076923076923,33,12,GTGAGACCCCACTGCGGCGA,21,1173455
fldAp,2.3846153846153846,42,12,GTGACCATATGTAGTGCGCA,30,1160397
fldAp,2.3076923076923075,41,12,GTCCTTTCTAGGGTAGAGCT,29,1102064
fldAp,0.7692307692307693,21,12,GTCAAATGACGTATCCTAAC,9,1114826
fldAp,1.5384615384615385,31,12,GTACATATACGCAGGCAACA,19,1068447
fldAp,5.461538461538462,82,12,GTAATCTTTCTGTCAGTATG,70,1089511
fldAp,0.6923076923076923,20,12,GTAATAGTATTCGTGGGCGT,8,1158966
fldAp,2.076923076923077,38,12,GTAAATGAAAACCTATGTTC,26,1133822
fldAp,1.6153846153846154,32,12,GGTGTGGAACCGTTGCAGGG,20,1123394
fldAp,0.23076923076923078,14,12,GGTGGGGGGTGCTGAAGGCC,2,1157200
fldAp,1.0,24,12,GGTCAAGTGGCCTCGTTAGC,12,1109135
fldAp,6.615384615384615,97,12,GGGTTTCCTTACCACCACAA,85,1127935
fldAp,4.0,63,12,GGGTTAGGGGGAGGGGTGGG,51,1134253
fldAp,0.15384615384615385,13,12,GGGTGTACTTCACGCCGTTA,1,1165667
fldAp,3.1538461538461537,52,12,GGGTGCGCTCGTTTCCATTA,40,1156776
fldAp,8.76923076923077,125,12,GGGTACAACGGGGAATTGAA,113,1146182
fldAp,1.1538461538461537,26,12,GGGGGGAGCTGGGCTAAGAC,14,1096701
fldAp,1.6153846153846154,32,12,GGGGGACCGTTAGTAAGACG,20,1100038
fldAp,0.15384615384615385,13,12,GGGGCTTAGGGTTCCTCGTA,1,1069778
fldAp,5.769230769230769,86,12,GGGGACCCTGAACCGTGGAT,74,1098894
fldAp,0.15384615384615385,13,12,GGGCAGATAAAGCACCGCTC,1,1182686
fldAp,1.0,24,12,GGGATACTCCTTAATCGCCG,12,1154742
fldAp,1.7692307692307692,34,12,GGGACATAACCACATGATAT,22,1158044
fldAp,2.076923076923077,38,12,GGGAAAGAAGTTAGGAGAGC,26,1163575
fldAp,1.6153846153846154,32,12,GGCGTTGTATTTGGTCTGTT,20,1068924
fldAp,12.692307692307692,176,12,GGCGCATCCGTACCACACGA,164,1105572
fldAp,2.1538461538461537,39,12,GGCGAGTTCCCCCAATTATT,27,1063866
fldAp,1.7692307692307692,34,12,GGCCCATCCGGATTAGTGTC,22,1099051
fldAp,6.076923076923077,90,12,GGCCACCACGGTCTTGGCGA,78,1139307
fldAp,3.8461538461538463,61,12,GGCAGCCGCCTACACGGTCA,49,1114771
fldAp,1.6153846153846154,32,12,GGCACCGCGCGCTGGTTAAT,20,1126094
fldAp,5.6923076923076925,85,12,GGATTACACCGCTGTGCCCT,73,1084037
fldAp,2.923076923076923,49,12,GGAGCTCACATTAGGAGTCG,37,1152167
fldAp,0.15384615384615385,13,12,GGAGAGGGGTCTCCTAAACC,1,1104098
fldAp,4.615384615384615,71,12,GGACCGTTGAAGATGTAATC,59,1156424
fldAp,0.15384615384615385,13,12,GCTGCAGTGCGGCCTGTGAG,1,1113099
fldAp,1.8461538461538463,35,12,GCTGAATCCTGGTCTTTGGT,23,1123439
fldAp,2.6153846153846154,45,12,GCTCGCGGCGTTCGGCCATA,33,1088746
fldAp,1.0769230769230769,25,12,GCTCAGGTTTAAAGCGGCTT,13,1151301
fldAp,1.7692307692307692,34,12,GCTAAAGTAATCGCCCGAGA,22,1087000
fldAp,0.46153846153846156,17,12,GCGTCAGTACAGATCATCCT,5,1128730
fldAp,2.230769230769231,40,12,GCGGATTCCATAGGGTCGTG,28,1116863
fldAp,1.6923076923076923,33,12,GCGCGCCCCACACTCGGGTC,21,1161274
fldAp,1.6923076923076923,33,12,GCGCATAAAATAGATCGGGC,21,1134906
fldAp,1.3846153846153846,29,12,GCGATTTACTATAGTGAACA,17,1074567
fldAp,2.0,37,12,GCGAATGGGTCGCAATTGTG,25,1098419
fldAp,3.6923076923076925,59,12,GCGAACAGGATTGTGACGCG,47,1162088
fldAp,2.769230769230769,47,12,GCGAACAACTAGATCGAGAT,35,1164840
fldAp,0.3076923076923077,15,12,GCCCACGGTTGGCAATGGTA,3,1148899
fldAp,1.3076923076923077,28,12,GCCATCTTACGCGCTACCGT,16,1106078
fldAp,2.230769230769231,40,12,GCCAGCAAGGGACATTGACA,28,1112784
fldAp,3.6923076923076925,59,12,GCATTGTTCTAACGGCACCA,47,1163368
fldAp,7.923076923076923,114,12,GCAGCAGCCCGCACCATTCG,102,1118343
fldAp,0.8461538461538461,22,12,GCACCCTGAGGAAGACTGGT,10,1100652
fldAp,3.0,50,12,GCACAAGCAATACGGGCGCC,38,1132491
fldAp,0.6153846153846154,19,12,GCAAGGCAACGGGGATAGGA,7,1185052
fldAp,6.3076923076923075,93,12,GATTTTAGGATCAGAGAATC,81,1078601
fldAp,1.6923076923076923,33,12,GATGGTTGGTTGGAGCAAGA,21,1142316
fldAp,4.6923076923076925,72,12,GATGATTGCTCTCTGAAAGT,60,1086798
fldAp,7.615384615384615,110,12,GATAGGCTGCTCCTGTGACT,98,1169925
fldAp,4.0,63,12,GAGTGCGCGGCGAAATAGCG,51,1095827
fldAp,1.2307692307692308,27,12,GAGGTAAGTACGCCAATCTT,15,1063022
fldAp,3.3076923076923075,54,12,GAGGGTGTAACATCTACGTT,42,1131669
fldAp,0.15384615384615385,13,12,GAGAAAGATGTCTTGATGAG,1,1106680
fldAp,0.15384615384615385,13,12,GACCGTTACGCTGGGTAGGA,1,1117144
fldAp,1.6153846153846154,32,12,GACCGATAGAGGGAATAGTA,20,1070808
fldAp,2.4615384615384617,43,12,GACATACTTTGGGGGGGCAG,31,1138213
fldAp,2.076923076923077,38,12,GAACTGGTGCGACGGTCGTT,26,1076352
fldAp,1.0,24,12,GAACCTCGACACCGAAATTA,12,1073155
fldAp,1.7692307692307692,34,12,GAAACCATCTGCGCAAGTAC,22,1178087
fldAp,0.6153846153846154,19,12,GAAAAGAGAACGGCCGGGGC,7,1077174
fldAp,1.7692307692307692,34,12,CTTTTTGGGAGCAGCATAAA,22,1161891
fldAp,2.3846153846153846,42,12,CTTTACATAGCGTCCGGGCT,30,1106497
fldAp,1.8461538461538463,35,12,CTTTACACTATAAAGTGAAT,23,1179258
fldAp,3.3076923076923075,54,12,CTTGGGACTTCACGTGAAAG,42,1073311
fldAp,0.15384615384615385,13,12,CTTCTGGTCGATCCGCTAGC,1,1103337
fldAp,20.76923076923077,281,12,CTTCCGTGCAGAGCAATCTC,269,1176938
fldAp,9.0,128,12,CTTACCAGCATTAACGGAAT,116,1063674
fldAp,2.6153846153846154,45,12,CTTAACGATTCAGCTTACAA,33,1145443
fldAp,5.538461538461538,83,12,CTGTTACGTTGCTACTATTA,71,1104132
fldAp,1.3076923076923077,28,12,CTGGTAAGAACTGGACAAGA,16,1074437
fldAp,6.769230769230769,99,12,CTGGCACAGCCAGACCAGGT,87,1157926
fldAp,3.6923076923076925,59,12,CTGCCACGGTATCCTGCCTC,47,1127715
fldAp,0.15384615384615385,13,12,CTCTCCGTCGGTGAGGAGAC,1,1098572
fldAp,2.4615384615384617,43,12,CTCCGTACACGCCGACCTCC,31,1149462
fldAp,1.5384615384615385,31,12,CTCCGCTCCCCGTTGAAGCA,19,1182685
fldAp,1.7692307692307692,34,12,CTCCCGACGTAGAGCGTACA,22,1123107
fldAp,3.230769230769231,53,12,CTCAGGTCAAACGTGGGCTA,41,1076480
fldAp,1.5384615384615385,31,12,CTCAACGCTTGAGGCAGTTT,19,1101428
fldAp,4.0,63,12,CTAGCAACGCACTGTATGGA,51,1070588
fldAp,0.8461538461538461,22,12,CTAGAGACAGCTGGCTCAAT,10,1181044
fldAp,7.0,102,12,CTACGGATCTCCCAGATTTA,90,1177347
fldAp,1.9230769230769231,36,12,CTAATTGGCGAAAACTACAG,24,1098510
fldAp,11.461538461538462,160,12,CTAAGTTGTTTGGAAGAAAC,148,1128099
fldAp,0.15384615384615385,13,12,CTAAAAGGAGCCTCTGGGTC,1,1127469
fldAp,1.1538461538461537,26,12,CGTTTCGATCCCGCGGCCGG,14,1119671
fldAp,1.1538461538461537,26,12,CGTTGAGCACCGCGAGAGAG,14,1161110
fldAp,0.23076923076923078,14,12,CGTTCAAGATAAAAGGCATA,2,1168242
fldAp,2.0,37,12,CGTGTGGCCATAGGGTTGTA,25,1163984
fldAp,0.15384615384615385,13,12,CGTGGAGATTGACCCGGTTT,1,1070211
fldAp,2.3846153846153846,42,12,CGTCGCGGGGTTCATGTTAA,30,1073982
fldAp,1.5384615384615385,31,12,CGTATGCTGTAGGCAATGCC,19,1086855
fldAp,8.23076923076923,118,12,CGGTGAGATGAATCGGTCGT,106,1084560
fldAp,0.15384615384615385,13,12,CGGCCTCGGTTCACAACGCT,1,1171101
fldAp,1.9230769230769231,36,12,CGGAGGAGTACACGAACCCC,24,1131763
fldAp,0.8461538461538461,22,12,CGGAAAGGCTCAAGCGTCGT,10,1121223
fldAp,0.38461538461538464,16,12,CGCTTACAGCTATAGCGAGG,4,1074282
fldAp,0.6923076923076923,20,12,CGCGTCAGCGTTCAAGCATG,8,1159656
fldAp,2.5384615384615383,44,12,CGCGCGGTCCGGTTGTCCCA,32,1097300
fldAp,3.0,50,12,CGCGCAACGTCATCCTCCCA,38,1151682
fldAp,2.769230769230769,47,12,CGCCGTCGATTGAACGTATT,35,1126411
fldAp,2.8461538461538463,48,12,CGCATGGCCATATGATTACT,36,1086059
fldAp,0.7692307692307693,21,12,CGATCGGTGGTCCATCTTCA,9,1123560
fldAp,1.3846153846153846,29,12,CGAAGGACTTTCTAAGACAG,17,1074761
fldAp,1.3846153846153846,29,12,CCTCCAAGGCGCGCTCGAAT,17,1109376
fldAp,0.8461538461538461,22,12,CCTAGCCTAATCAACGTCGT,10,1118881
fldAp,0.15384615384615385,13,12,CCGTGTAGCGCGGATTCTGT,1,1083096
fldAp,10.23076923076923,144,12,CCGTCACGCCTTGTATGACA,132,1125676
fldAp,2.3076923076923075,41,12,CCGGTACCCTGTCTGGGCGA,29,1095571
fldAp,2.0,37,12,CCGGGCTAAAAGACCAGCCA,25,1114015
fldAp,2.230769230769231,40,12,CCGGCCGGCCTGTCATAACA,28,1115716
fldAp,1.0769230769230769,25,12,CCGGAACAACGGGTAACATC,13,1155469
fldAp,2.1538461538461537,39,12,CCGCAAGAGTTGTTGATGTA,27,1080603
fldAp,0.15384615384615385,13,12,CCGAAACGTAGGAGGCCTTA,1,1122301
fldAp,7.230769230769231,105,12,CCCTGTGTAGATGGCCGGAA,93,1105913
fldAp,2.3076923076923075,41,12,CCCTCTTGGTCGCTTTCGAA,29,1083636
fldAp,1.3076923076923077,28,12,CCCTACCGGGGCAGGCTCCG,16,1167799
fldAp,7.076923076923077,103,12,CCCGGATATTCAGCATGTGA,91,1139549
fldAp,0.15384615384615385,13,12,CCCGGAGCACTAACATGAAC,1,1103815
fldAp,2.6923076923076925,46,12,CCCCGGAAGGCGCTAGTCCT,34,1143067
fldAp,1.8461538461538463,35,12,CCCCAGCGTGCCGTAGCAAA,23,1119673
fldAp,0.46153846153846156,17,12,CCATAGTTCGCAAGACGTAC,5,1164096
fldAp,7.384615384615385,107,12,CCACCGTGTGTGAGCGCCAT,95,1086507
fldAp,0.15384615384615385,13,12,CCACAAGATGAAACACTGGG,1,1149744
fldAp,1.7692307692307692,34,12,CATTGACGTTAGTGGTGAAT,22,1079344
fldAp,4.3076923076923075,67,12,CATGTCGCAATGATTATTCG,55,1095290
fldAp,5.846153846153846,87,12,CATGGCCCCGATCATGGTTA,75,1144328
fldAp,6.384615384615385,94,12,CATGGAGTCCGGCCGCTGAT,82,1127478
fldAp,3.0,50,12,CATGATACGATAGGGGTCAC,38,1066613
fldAp,4.0,63,12,CATCCGGGAGATATCCTGCA,51,1174894
fldAp,0.15384615384615385,13,12,CATACGGATCTTCTAGCAAG,1,1146380
fldAp,6.615384615384615,97,12,CATAAAATTTCACGGCAGTA,85,1069051
fldAp,7.461538461538462,108,12,CAGGGCTGCCGCTCAAGAGC,96,1109315
fldAp,2.076923076923077,38,12,CAGGCACTTCTCAAATCGAT,26,1109758
fldAp,2.5384615384615383,44,12,CAGCTACCGTGTCACGTGTT,32,1109782
fldAp,2.0,37,12,CAGAGGAGACCTATCCCATG,25,1185994
fldAp,2.8461538461538463,48,12,CAGAATAATCTGGCCGCGAA,36,1101038
fldAp,6.153846153846154,91,12,CACGTGGACTCTACTTATGG,79,1066743
fldAp,2.4615384615384617,43,12,CACATAATGTTTTGCGTGTT,31,1163284
fldAp,1.0769230769230769,25,12,CACAAGCCCGTTCCTGCAGA,13,1075324
fldAp,2.230769230769231,40,12,CACAAAGTCTTGTATCTGCT,28,1139923
fldAp,1.7692307692307692,34,12,CAATCCTTTCGGTGGAAATT,22,1158667
fldAp,1.6923076923076923,33,12,CAATCAAAACTAGAACGCGC,21,1110149
fldAp,2.1538461538461537,39,12,CAAGACAGACACCGGTGTAT,27,1098005
fldAp,4.538461538461538,70,12,CAACTCAAGGTAGGCGACGA,58,1151109
fldAp,1.3076923076923077,28,12,CAAAGTTGGCTGAACGTCCC,16,1136663
fldAp,0.15384615384615385,13,12,CAAAACCAGTTCCTTTAATG,1,1182218
fldAp,2.3846153846153846,42,12,ATTTTTGAATACTCGTACTT,30,1136827
fldAp,2.3076923076923075,41,12,ATTTTTCTTGGCGCCTCAAC,29,1115558
fldAp,2.230769230769231,40,12,ATTTGTCCTGCTGGCCATGT,28,1179934
fldAp,5.923076923076923,88,12,ATTGACGTAGTAGCGAGGAC,76,1171077
fldAp,1.0,24,12,ATTCCTACTCAGGTTGCCCA,12,1084698
fldAp,2.076923076923077,38,12,ATGGCTCTAAAATGGCCAAA,26,1113544
fldAp,2.4615384615384617,43,12,ATGGCCCTGCTACTATTGCT,31,1135644
fldAp,3.4615384615384617,56,12,ATGCAACATAGAGAACGAGC,44,1121121
fldAp,1.5384615384615385,31,12,ATGATTTTAGGTTTGATCAC,19,1121472
fldAp,9.461538461538462,134,12,ATGAGTATGAGGAGAGCGCA,122,1178657
fldAp,3.3076923076923075,54,12,ATGAACAACCGCTTGGCAGC,42,1165463
fldAp,7.0,102,12,ATCTGGTCACATACATTAAC,90,1112874
fldAp,1.9230769230769231,36,12,ATCTGAGAATGGATTGCTTG,24,1132197
fldAp,15.846153846153847,217,12,ATCTCATCAGAGTTATATGT,205,1118328
fldAp,1.0769230769230769,25,12,ATCTCACCATGATTCTTAGG,13,1073721
fldAp,4.615384615384615,71,12,ATCGCACTTACAAGATGGTC,59,1164440
fldAp,1.5384615384615385,31,12,ATCGACTTAGGTCGCGGACC,19,1166794
fldAp,1.4615384615384615,30,12,ATCCCCTTTTAGTACACAGC,18,1139312
fldAp,1.3076923076923077,28,12,ATATTAACCGAGAGCAGCGC,16,1102320
fldAp,5.461538461538462,82,12,ATATAGCATTCGCAAGTGGA,70,1101282
fldAp,2.769230769230769,47,12,ATACTTGATGACATCGGTCT,35,1152006
fldAp,1.5384615384615385,31,12,ATACGGTTCAAGTTAATATC,19,1125152
fldAp,2.6153846153846154,45,12,ATACGAAGCTAGCATATTAC,33,1148584
fldAp,3.3076923076923075,54,12,AGTTTGACCAACCGGTATCT,42,1183410
fldAp,8.384615384615385,120,12,AGTATCGAGGTTCAGGGATG,108,1077409
fldAp,3.0,50,12,AGTAGTTGATTTAAGCCAAG,38,1111268
fldAp,1.5384615384615385,31,12,AGTAGTGGGCTTAAGGGTCT,19,1164969
fldAp,2.6153846153846154,45,12,AGTAGTAACGAGATGCATAA,33,1065770
fldAp,2.3846153846153846,42,12,AGGTGGAATAGACTTCAGCC,30,1157996
fldAp,3.4615384615384617,56,12,AGGTGACACCGTATTGGGAG,44,1085022
fldAp,1.3076923076923077,28,12,AGGTAATTATATAGGCGAAA,16,1083888
fldAp,0.46153846153846156,17,12,AGGCTCCCGCCCAGCGGAGG,5,1117527
fldAp,7.769230769230769,112,12,AGGCATGCGGCAACAGGCTA,100,1095517
fldAp,2.8461538461538463,48,12,AGGCAGGGTGCTAACATAGC,36,1070840
fldAp,3.4615384615384617,56,12,AGGATGAGCACGATACAAAA,44,1158788
fldAp,2.6923076923076925,46,12,AGGACTTCGTTTTCGCATAA,34,1136585
fldAp,2.3076923076923075,41,12,AGGAAGGGTGTGCCGACTCA,29,1099755
fldAp,0.6153846153846154,19,12,AGCTACGCAGCACAAGTTTC,7,1083309
fldAp,2.769230769230769,47,12,AGCGGCTGGAATGTACACAC,35,1122111
fldAp,0.23076923076923078,14,12,AGCCCTCGGAATAATTTTTG,2,1161073
fldAp,3.8461538461538463,61,12,AGCATTGCGTAACCCGGGAA,49,1176522
fldAp,3.0,50,12,AGCACTCGCGCTTGCTGGAC,38,1083042
fldAp,1.3076923076923077,28,12,AGATTAACACGATACTATTC,16,1109667
fldAp,1.7692307692307692,34,12,AGAGGGGATCGTCGAATCTT,22,1102442
fldAp,1.4615384615384615,30,12,AGAGCTGATTCATACGATCC,18,1120963
fldAp,2.923076923076923,49,12,AGACTGCCCTGTAGGTTACC,37,1087003
fldAp,1.0,24,12,AGACCTACGGTGTCTTATTG,12,1150357
fldAp,2.1538461538461537,39,12,AGACACCAAGGCGATGAGCT,27,1091895
fldAp,1.6153846153846154,32,12,AGAATCGTCAGGTCTTCTTG,20,1172565
fldAp,0.8461538461538461,22,12,ACTTCCGGCGGTAATATAAT,10,1137478
fldAp,1.0769230769230769,25,12,ACTTACGGATTAACTTAGGG,13,1180120
fldAp,1.6923076923076923,33,12,ACTGGTCTCGATAAATCAGT,21,1165985
fldAp,5.3076923076923075,80,12,ACTGGGAGGTAGATAACCAC,68,1074439
fldAp,2.0,37,12,ACTGGCTAAGCCATATTATA,25,1166273
fldAp,1.6923076923076923,33,12,ACTCCAGCATGAGTAACCGA,21,1077572
fldAp,3.6923076923076925,59,12,ACTCCACGATGGCAGAAAAG,47,1127028
fldAp,1.0,24,12,ACTATATCTTTAATTAGTGC,12,1139432
fldAp,1.5384615384615385,31,12,ACTAATATCTCATAATCGTG,19,1129664
fldAp,1.6923076923076923,33,12,ACGTTTGCCGTCATGCAGGC,21,1158780
fldAp,11.384615384615385,159,12,ACGTCGAACACAGACCCGCT,147,1107695
fldAp,0.6153846153846154,19,12,ACGTACCCTCCGTGGACTCC,7,1124768
fldAp,0.23076923076923078,14,12,ACGGGTAATATAGGTTACGG,2,1165266
fldAp,0.23076923076923078,14,12,ACGCGTAGTGGAATCGGCTA,2,1128909
fldAp,5.769230769230769,86,12,ACGCGACGTACGTAACTCTG,74,1158821
fldAp,1.1538461538461537,26,12,ACGCCGACCGACTTCCTGAT,14,1091004
fldAp,0.38461538461538464,16,12,ACGAGTGGTGACGCCTTAGT,4,1154288
fldAp,10.76923076923077,151,12,ACGAGCAAGAGTTATTCAAG,139,1082591
fldAp,2.4615384615384617,43,12,ACGACCCGTCGAGCATCCTC,31,1171716
fldAp,3.923076923076923,62,12,ACCTCTGCCTGTCGCGCCTT,50,1113698
fldAp,0.15384615384615385,13,12,ACCTATCAGCGCGCTACTAT,1,1124006
fldAp,3.1538461538461537,52,12,ACCGAATCCAACGATGGTTG,40,1134959
fldAp,3.6923076923076925,59,12,ACCCCTATATTGCGTTTAGA,47,1098727
fldAp,0.15384615384615385,13,12,ACATTTCGGGAGGTCACATG,1,1122025
fldAp,0.23076923076923078,14,12,ACATCTACTGTCTCCGGACA,2,1065768
fldAp,2.1538461538461537,39,12,ACATCATCAGAGGGCACTAA,27,1167733
fldAp,1.5384615384615385,31,12,ACATATGTTTGAAGCGGGAC,19,1171827
fldAp,0.15384615384615385,13,12,ACAGATCGGGTGCAACTCTT,1,1097307
fldAp,3.923076923076923,62,12,ACACAGCTCGCCAACAGTTG,50,1166354
fldAp,1.2307692307692308,27,12,ACAAGCCCGGATAGTTCAGA,15,1126955
fldAp,2.076923076923077,38,12,ACAACTGACATTTCTTTGAC,26,1125710
fldAp,1.7692307692307692,34,12,AATTCATCTGACCACAGATC,22,1117207
fldAp,2.3846153846153846,42,12,AATCTGAGGGTTCCACTAAG,30,1158533
fldAp,1.5384615384615385,31,12,AATCGGTCGAAAATGCCAGA,19,1174010
fldAp,2.1538461538461537,39,12,AATCCGTCATCAGTATCGAT,27,1126384
fldAp,1.6923076923076923,33,12,AATCCGGGTGAAGAGGTTGC,21,1089385
fldAp,5.3076923076923075,80,12,AAGTTGGCCAGATCGTGGCA,68,1136833
fldAp,0.15384615384615385,13,12,AAGCTCCCGCTCATCCGTTT,1,1136310
fldAp,0.38461538461538464,16,12,AAGCCCAAGTGCCAAGTGAT,4,1107879
fldAp,2.5384615384615383,44,12,AAGACTCGTTCAGGTTAGTA,32,1152688
fldAp,0.7692307692307693,21,12,AACTTTTATATTTTTGCGTC,9,1087101
fldAp,3.3846153846153846,55,12,AACCTGGACATGAATCTGCG,43,1178359
fldAp,5.384615384615385,81,12,AACCACGTGATTGACTAGCG,69,1133675
fldAp,0.15384615384615385,13,12,AAAGGGAAGGTTACAACCAC,1,1075887
fldAp,0.15384615384615385,13,12,AAACTGTAAGGGTCGAAGTC,1,1063397
fldAp,2.3846153846153846,42,12,AAACTCGGTCGGAATCGAAC,30,1120462
fldAp,2.076923076923077,38,12,AAAATCCTCCGGAAGACATG,26,1078176
fldAp,6.923076923076923,101,12,AAAAGTTCTTGCGTTGGAAT,89,1179659
fldAp,1.9230769230769231,36,12,AAAACCTGCTCCCATAGGAG,24,1100731
fldAp,1.9166666666666667,33,11,TTTTGGCGACGGGTAATGCA,22,1130901
fldAp,0.4166666666666667,15,11,TTTTGAATAAACAAACTTAA,4,1157933
fldAp,1.5833333333333333,29,11,TTTATGCCGTCGCCCTCTTA,18,1160129
fldAp,6.916666666666667,93,11,TTTAATATGTCAATTCATAT,82,1175413
fldAp,8.416666666666666,111,11,TTGTTGAGACCTCAGGCGGT,100,1108083
fldAp,1.4166666666666667,27,11,TTGGCGAAAGTAGGCAGGAC,16,1083808
fldAp,6.416666666666667,87,11,TTCTCCTAGCTTTGTACATA,76,1169923
fldAp,2.0,34,11,TTCTATGCGAGTTAGGGCCC,23,1120997
fldAp,1.25,25,11,TTCCTCGCCCCATCCTGGGT,14,1110673
fldAp,3.1666666666666665,48,11,TTCATGGCGGCTCCATATAA,37,1122781
fldAp,0.25,13,11,TTCACTTAACTCTCACAACG,2,1142906
fldAp,2.0833333333333335,35,11,TTATTTATAGTGGGGGGCTA,24,1167839
fldAp,8.583333333333334,113,11,TTAAGTTGCTCTACGGGCTA,102,1082580
fldAp,3.25,49,11,TTAAGGCCTTCGCATAGCTG,38,1121064
fldAp,1.75,31,11,TGTCTGGGCTTCTCGTAGTG,20,1143079
fldAp,1.1666666666666667,24,11,TGGTGTCTATTTTTGGGCTT,13,1097951
fldAp,2.25,37,11,TGGTAGTGGTTTAACCCGAG,26,1141444
fldAp,3.0833333333333335,47,11,TGGGCCGTAGATATGGACTA,36,1139311
fldAp,8.0,106,11,TGGGAAAGAATTAACTGCCG,95,1078597
fldAp,2.0,34,11,TGGCTGGCATCGAAATCGGA,23,1113738
fldAp,5.916666666666667,81,11,TGGATACGTTTGCGATCGCT,70,1166676
fldAp,1.1666666666666667,24,11,TGCTCTGTCACTATACAGTT,13,1146808
fldAp,2.3333333333333335,38,11,TGCTCCATGCGTTAGGGGAC,27,1160486
fldAp,4.0,58,11,TGCTCAGGGAAAGCTCATCC,47,1066000
fldAp,0.16666666666666666,12,11,TGCGTCTCCTCACCCACGCA,1,1147934
fldAp,4.75,67,11,TGCGCGCCAGCAGGTAATGC,56,1135846
fldAp,2.6666666666666665,42,11,TGCATTGCCTGACTAGGACA,31,1154739
fldAp,9.25,121,11,TGCATTCTTATTTGAGGCCT,110,1072154
fldAp,0.16666666666666666,12,11,TGCAAAGGCTTCTTTCGCTG,1,1096456
fldAp,3.75,55,11,TGATCAATGGCGTCGATGTA,44,1161605
fldAp,0.16666666666666666,12,11,TGACACCGTGATGGGCGACT,1,1166218
fldAp,1.75,31,11,TGAATTAGGTTTAAGGCTCC,20,1079187
fldAp,4.166666666666667,60,11,TGAATACAGGAGGTATAGAA,49,1123566
fldAp,2.25,37,11,TGAAAGCGTTTGCGAATGTA,26,1104322
fldAp,1.8333333333333333,32,11,TCTTTTGATCAATGCATAAC,21,1124034
fldAp,2.0833333333333335,35,11,TCTTGGGAATCAGAGGGCTG,24,1101016
fldAp,2.0,34,11,TCTTACCGGAACAGGCAGAC,23,1066458
fldAp,2.6666666666666665,42,11,TCTGGCCCGATCCTTTGCAA,31,1145199
fldAp,2.0,34,11,TCTGCACGGGCCTCTCAGAG,23,1116558
fldAp,0.16666666666666666,12,11,TCTGATAGGCTTAGTATCAG,1,1125464
fldAp,0.16666666666666666,12,11,TCTCTGGACCCTACGCCCCC,1,1088239
fldAp,1.8333333333333333,32,11,TCTACAAACCCGGCTCGGAA,21,1152332
fldAp,2.6666666666666665,42,11,TCGTTTCGTCGGTAACAGCG,31,1120765
fldAp,2.6666666666666665,42,11,TCGGGTCACGGGGAGGACAC,31,1084711
fldAp,2.25,37,11,TCGCCCTGAGAGAAGTCAGA,26,1095446
fldAp,1.75,31,11,TCGACTCTTGAGCCGTACAC,20,1086157
fldAp,1.75,31,11,TCGAACGGTTCACTTAGTGA,20,1169114
fldAp,2.0,34,11,TCCTGGCTGTTACGTACTAA,23,1071591
fldAp,8.916666666666666,117,11,TCCTCTGTAAGCGGCGCTTG,106,1074657
fldAp,2.0833333333333335,35,11,TCCTAGTCCTTGTCAAGGGG,24,1139413
fldAp,1.9166666666666667,33,11,TCCGACGAAGCATTCACTGT,22,1144698
fldAp,1.3333333333333333,26,11,TCCAGTTTAGACGTACTTCA,15,1140025
fldAp,2.3333333333333335,38,11,TCCAGCTCGACTAATACATA,27,1066923
fldAp,2.4166666666666665,39,11,TCCAGATGCTTAATCTACTA,28,1162867
fldAp,0.16666666666666666,12,11,TCCAAGTAGAGTACGTGCAT,1,1168831
fldAp,5.0,70,11,TCATGTGACCGTTAATCTAG,59,1169454
fldAp,2.3333333333333335,38,11,TCATGCCTCGTTTTCTAAGC,27,1087929
fldAp,2.4166666666666665,39,11,TCAGGAGTAAGATGTGAGCT,28,1137726
fldAp,2.5833333333333335,41,11,TCAGCACGCTGAGAAAGTCT,30,1126740
fldAp,4.166666666666667,60,11,TCACTATTGGTCCGGGGTGT,49,1093280
fldAp,2.8333333333333335,44,11,TCACAGGAAGAGGAGGGGGG,33,1086478
fldAp,0.16666666666666666,12,11,TCAATTACCTCGAGTGCGGA,1,1166566
fldAp,1.5833333333333333,29,11,TCAAGATCACCTTCAACATA,18,1113798
fldAp,0.16666666666666666,12,11,TCAAACATGCGTGGGTGGCA,1,1148075
fldAp,2.3333333333333335,38,11,TCAAAATCAATATTGGCTCC,27,1137743
fldAp,7.0,94,11,TATGTGGTTAAACCGGGCTT,83,1108859
fldAp,2.1666666666666665,36,11,TATGCCACCAGGACAAACTA,25,1114829
fldAp,2.5,40,11,TATGACTACCTGGTCAGAAC,29,1103522
fldAp,3.1666666666666665,48,11,TATCTGTATCCTCCGTGATC,37,1168247
fldAp,1.9166666666666667,33,11,TATACCGCTGTGGGGATTTA,22,1124164
fldAp,6.25,85,11,TAGCTGGTTTTTTCAATGAA,74,1085985
fldAp,0.6666666666666666,18,11,TAGCGCGAGTTTCGGACAAT,7,1108151
fldAp,1.1666666666666667,24,11,TAGCGAAAAATGATGTGTTA,13,1100359
fldAp,8.083333333333334,107,11,TAGCCTAAGGGCATCCATAT,96,1166429
fldAp,2.75,43,11,TAGCCACGACAAGCCTGACT,32,1133385
fldAp,2.6666666666666665,42,11,TAGATACTTCGGGAGCGAGT,31,1106943
fldAp,13.666666666666666,174,11,TAGAATACCGCGCATCTACT,163,1088190
fldAp,0.16666666666666666,12,11,TAGAAGGTAGTTCTCTTAGG,1,1102782
fldAp,2.0,34,11,TAGAAGAAGCTACTATGTAC,23,1080396
fldAp,2.25,37,11,TACTTTGGGTAGTAATCGTA,26,1082123
fldAp,3.8333333333333335,56,11,TACGGAGTCGTCCAAAAGGC,45,1168813
fldAp,0.16666666666666666,12,11,TACCTTCAGCACCAGGATCA,1,1165070
fldAp,1.0833333333333333,23,11,TACCCTTTATGGTGAGATAG,12,1087253
fldAp,2.75,43,11,TACCCGAGACGCATTAATTT,32,1067362
fldAp,3.5,52,11,TAATTGCTGCAAGAGCTTCT,41,1178905
fldAp,3.25,49,11,TAATGGCATTCTATGACCAC,38,1135847
fldAp,1.5833333333333333,29,11,TAAGAATCATATACCTTGAT,18,1137439
fldAp,0.16666666666666666,12,11,TAACACTGTCAGATGTCTTT,1,1101215
fldAp,4.916666666666667,69,11,TAAATTTAGGGAAGCCCTCT,58,1177806
fldAp,0.9166666666666666,21,11,GTTGTGTACTGTCTTGCCAT,10,1130316
fldAp,0.16666666666666666,12,11,GTTGTGCTGCGAGCAGAGCA,1,1163002
fldAp,0.16666666666666666,12,11,GTTGACAAGGACTTAGTACG,1,1127038
fldAp,7.666666666666667,102,11,GTTCATCACCGCTCGCTTCA,91,1114229
fldAp,2.3333333333333335,38,11,GTTCACTGCGGTGGAGATTA,27,1063231
fldAp,1.25,25,11,GTTATACCTATTTATCGTTA,14,1114403
fldAp,3.75,55,11,GTTACTTATGTGCCTAGGGG,44,1066710
fldAp,5.083333333333333,71,11,GTTAAATAACGTAGCTTGTG,60,1178586
fldAp,2.6666666666666665,42,11,GTGTCTTTCTCTTGTCACTA,31,1095225
fldAp,19.25,241,11,GTGTCACCCGGGCGTGGAGT,230,1066006
fldAp,3.75,55,11,GTGTAGTTATTTTGACCTTT,44,1106280
fldAp,0.16666666666666666,12,11,GTGGGTAGCATGTAGCTGTG,1,1073220
fldAp,3.75,55,11,GTGCGACGACCGTCCACCAT,44,1155476
fldAp,1.6666666666666667,30,11,GTGAACGGGCAAAAGAAGGG,19,1184149
fldAp,1.6666666666666667,30,11,GTCTCTATAGCGACTTTCGA,19,1170229
fldAp,0.25,13,11,GTCGTTCACATGCCTGCGTA,2,1111673
fldAp,2.8333333333333335,44,11,GTCGTGTATTAGTTGAGGGT,33,1144461
fldAp,1.75,31,11,GTCGGTCAAGGCAAGAGTGC,20,1177372
fldAp,3.5,52,11,GTCCGTTAAATAAAAGATTT,41,1148794
fldAp,3.3333333333333335,50,11,GTATAAACGCAGTTTTCCTA,39,1100757
fldAp,0.75,19,11,GTAGTGTTCTCTCAGCACGG,8,1073733
fldAp,0.16666666666666666,12,11,GTAGGTGGGGAGTTGGCAAC,1,1082217
fldAp,2.75,43,11,GTACTCGTATTATCGCCTGC,32,1114827
fldAp,3.5833333333333335,53,11,GTACGTTATATACACAGGGG,42,1076514
fldAp,1.6666666666666667,30,11,GTACATCACACCTTTTAAAA,19,1071730
fldAp,0.16666666666666666,12,11,GTACAGAACGACTCATCGCT,1,1089135
fldAp,10.083333333333334,131,11,GGTTTGACATCGAGGTCTGA,120,1108171
fldAp,7.083333333333333,95,11,GGTTTCGGCTGGTGGGGGAC,84,1137307
fldAp,2.9166666666666665,45,11,GGTTGTTCATGGAGATGGTT,34,1133843
fldAp,0.16666666666666666,12,11,GGTTGTGAGAAGTTCCCCTT,1,1150054
fldAp,3.1666666666666665,48,11,GGTGTTTAGTATGGCACGGC,37,1159883
fldAp,8.166666666666666,108,11,GGTCGAACGCAGAGGGACCA,97,1119149
fldAp,2.0833333333333335,35,11,GGGGATCGATACTAATGGAG,24,1094581
fldAp,1.5,28,11,GGGCGTTGGGGCAGAAGTTA,17,1084985
fldAp,3.1666666666666665,48,11,GGGCCATACCCTAGCGACCG,37,1070126
fldAp,2.75,43,11,GGGCATTCTTACGCATCATG,32,1172178
fldAp,3.4166666666666665,51,11,GGGATTGGAGAAACCAACAA,40,1087868
fldAp,0.16666666666666666,12,11,GGCGAGGAGGTAGGGTCCAG,1,1141582
fldAp,0.6666666666666666,18,11,GGCAGGTCTCATGTTAGTCA,7,1108173
fldAp,2.0833333333333335,35,11,GGCAGCGGGGTAGAGTAAAT,24,1154297
fldAp,2.4166666666666665,39,11,GGATGGTGGGCGAAGCACAT,28,1068741
fldAp,1.25,25,11,GGATGATACGCCAATTTGCA,14,1070037
fldAp,1.25,25,11,GGAGGGAACTTGCAGTAAAT,14,1158660
fldAp,2.25,37,11,GGAGATTTCCGCGGAAAGTG,26,1139039
fldAp,0.16666666666666666,12,11,GGAATACAACTCCTGCATTG,1,1123295
fldAp,2.6666666666666665,42,11,GCTTGTCTACGGTCGTGAAA,31,1099739
fldAp,4.5,64,11,GCTGCTAGGAAACATTAGGG,53,1173114
fldAp,1.5,28,11,GCTCATTTTCTCGTGAATCT,17,1172232
fldAp,2.0833333333333335,35,11,GCTACGGACTATCGGTGCAA,24,1144187
fldAp,2.6666666666666665,42,11,GCGTTCGTCGTAGCCGACAT,31,1076511
fldAp,5.583333333333333,77,11,GCGTACGAGTGCTGCCGCCC,66,1119888
fldAp,1.0833333333333333,23,11,GCGGTCTGGTCAGGCAACGT,12,1124903
fldAp,0.16666666666666666,12,11,GCGCTTCCCAGACACCATCC,1,1135008
fldAp,3.5,52,11,GCGCTCCACCGCATTATTGT,41,1125555
fldAp,0.16666666666666666,12,11,GCGCGCGCATGGTCTTTCGT,1,1067623
fldAp,3.4166666666666665,51,11,GCGACATCAAGAGTCGCACG,40,1184710
fldAp,1.5,28,11,GCCTTACTATATAGGTATAC,17,1117187
fldAp,0.16666666666666666,12,11,GCCTGGGTTTCCGTTTCCTC,1,1076855
fldAp,3.1666666666666665,48,11,GCCTACTTTCGGCATATTCA,37,1137419
fldAp,1.3333333333333333,26,11,GCCGTAACGTTCTGGCAGCG,15,1164426
fldAp,3.5833333333333335,53,11,GCCGGAGGCGGGATCGAATT,42,1128117
fldAp,1.75,31,11,GCCCGAGCCATGACAATCAA,20,1169729
fldAp,3.0833333333333335,47,11,GCATTCCACCCTACCAGCAG,36,1142810
fldAp,0.16666666666666666,12,11,GCATCTGCGGGCTGACACTC,1,1169393
fldAp,1.0,22,11,GCATCATTTGAACCCTTCGG,11,1096563
fldAp,2.9166666666666665,45,11,GCAGTATGGGAATGCACATG,34,1104974
fldAp,0.16666666666666666,12,11,GCAGGTGTGGGCGACAAATG,1,1135229
fldAp,4.5,64,11,GCACTGGCCGATCGTGCCAG,53,1088721
fldAp,6.25,85,11,GCACGGTTACGGGGCTTGCA,74,1064039
fldAp,7.5,100,11,GCAAGTTTAAAATGTTAAAT,89,1101284
fldAp,2.0833333333333335,35,11,GCAAAGGCTTCGCTCTCGAT,24,1160434
fldAp,0.25,13,11,GATTCCGGGAATGCGTTCAT,2,1142996
fldAp,2.3333333333333335,38,11,GATTAGGAGGCGGCGGTACC,27,1076100
fldAp,2.0833333333333335,35,11,GATGCCCGATCACCGGCAGA,24,1156556
fldAp,0.25,13,11,GATCGCACGTAATGGGCTGT,2,1139574
fldAp,1.5833333333333333,29,11,GATACGTGTGAGAAGTGCCT,18,1063284
fldAp,6.833333333333333,92,11,GATACGGCAACATTACTATT,81,1159660
fldAp,2.25,37,11,GAGGGTCAAGTGGACTTGAG,26,1115365
fldAp,2.8333333333333335,44,11,GAGGCACTTACAGAGTGTAA,33,1151559
fldAp,4.916666666666667,69,11,GAGGAATCGAGCAACTAGCT,58,1118927
fldAp,2.1666666666666665,36,11,GAGAGTGGTATCATCAACCT,25,1154608
fldAp,2.5833333333333335,41,11,GAGACCTGTTGGCGCCATCT,30,1149957
fldAp,2.5,40,11,GACTTGTACGTGCGGTGGTA,29,1144105
fldAp,6.333333333333333,86,11,GACTTAGTAGGGTGCGACAA,75,1065381
fldAp,4.083333333333333,59,11,GACGTGCAAGCCGTTAGTGT,48,1103974
fldAp,0.16666666666666666,12,11,GACCTGAAAAAGTTCGCAGG,1,1079149
fldAp,1.25,25,11,GACACAGTTCCGCGCTATGC,14,1185862
fldAp,1.75,31,11,GAATGCTAGACTTTGAGAAG,20,1116962
fldAp,0.16666666666666666,12,11,GAATCTGACCGGATGTGAGT,1,1140182
fldAp,0.8333333333333334,20,11,GAAGATGATTTGAAGCCGCA,9,1177393
fldAp,0.75,19,11,GAACACGCCGTTGAATTAGC,8,1129237
fldAp,2.0833333333333335,35,11,CTTTCTATCAAGGCAATCCG,24,1107975
fldAp,1.75,31,11,CTTGGCTTCGTATTTCTTAG,20,1147808
fldAp,1.1666666666666667,24,11,CTTGATTTACGATAGTTGGT,13,1135340
fldAp,0.16666666666666666,12,11,CTTAGTGTTTAGTACTGGAT,1,1133849
fldAp,1.5,28,11,CTTAAGCCGGACCGACGACA,17,1121257
fldAp,3.4166666666666665,51,11,CTGTTCGAGCAGCTCGCCGT,40,1182586
fldAp,0.16666666666666666,12,11,CTGTGAGTGTGTCAAGTTAC,1,1167177
fldAp,4.666666666666667,66,11,CTGTATCCACGTAGTGCGCC,55,1183251
fldAp,9.916666666666666,129,11,CTGGTTACGACTGTAAGGGC,118,1094486
fldAp,1.75,31,11,CTGGCTCCAAGGGTTCGGAT,20,1080154
fldAp,2.1666666666666665,36,11,CTGAACTGCCTAAGCGATCG,25,1125445
fldAp,1.9166666666666667,33,11,CTCTTCGGCGACCTGAGGCC,22,1164341
fldAp,2.3333333333333335,38,11,CTCTGCGTACCCAGTCAGGT,27,1167854
fldAp,2.6666666666666665,42,11,CTCGGTCCCCAGAGGGTGCA,31,1087329
fldAp,2.1666666666666665,36,11,CTCGATGAGCAACGGTTTTC,25,1090762
fldAp,3.0,46,11,CTATTCGGGTATAGTCGCAG,35,1158012
fldAp,2.5833333333333335,41,11,CTAGATTGAGTAGGAGTCAG,30,1085699
fldAp,2.5833333333333335,41,11,CTACTAATTAGGTGGAACTT,30,1154686
fldAp,5.166666666666667,72,11,CTACGGAAGAACAGCACCCC,61,1159549
fldAp,0.5,16,11,CTACAGACCTCAACTCCAAT,5,1167944
fldAp,4.166666666666667,60,11,CTAAAATCCCGTTCTGTTAA,49,1086136
fldAp,2.1666666666666665,36,11,CGTTTGCAACCTTATCTTTT,25,1119791
fldAp,1.3333333333333333,26,11,CGTTAATATGCGACCGGGAC,15,1159479
fldAp,1.3333333333333333,26,11,CGTGTTCGGATTTGGCACTT,15,1177312
fldAp,5.0,70,11,CGTCGGTTTCGCTAGTGTCT,59,1136471
fldAp,2.0833333333333335,35,11,CGTCCCCGCTTAGCCCTGTT,24,1068161
fldAp,2.75,43,11,CGTACCAGGTGAAGGGACTT,32,1067363
fldAp,1.1666666666666667,24,11,CGGTACGTCCTGATCCGGCA,13,1117280
fldAp,5.916666666666667,81,11,CGGGTGTACCTCCAGGGTGA,70,1167165
fldAp,7.833333333333333,104,11,CGGGGGCTTATTACTTTACT,93,1073349
fldAp,1.5,28,11,CGGGCTGCGTAGTGTTCCCC,17,1076190
fldAp,0.16666666666666666,12,11,CGGGCAGTTTGGTTTCTCCC,1,1137774
fldAp,1.1666666666666667,24,11,CGGAACGGTTCGGAGGGTAC,13,1120599
fldAp,0.25,13,11,CGCTTCTAAACATAGGCGTA,2,1109342
fldAp,1.25,25,11,CGCTCTGGAATTTTAGTCCC,14,1065947
fldAp,3.5,52,11,CGCTACAGAAAATTGCCTAC,41,1141146
fldAp,2.5833333333333335,41,11,CGCATTGAGCCCAATTAAAC,30,1100925
fldAp,4.0,58,11,CGCAAATTTACCATCCGTTC,47,1178682
fldAp,1.4166666666666667,27,11,CGATTGTAATCGCCTGGAGG,16,1123843
fldAp,2.25,37,11,CGATCTGAGCCGAAAGGATC,26,1143069
fldAp,0.25,13,11,CGATCCAGGGTTCATATGGT,2,1158178
fldAp,0.16666666666666666,12,11,CGAGGTGAAACAGCGAGTTT,1,1168668
fldAp,5.0,70,11,CGAGCAGCCGAATCGCGTGA,59,1071875
fldAp,0.16666666666666666,12,11,CGACGGTGCAGCATCGTTTC,1,1110373
fldAp,8.75,115,11,CGAAGAGCCGTGAGGGGGGG,104,1111337
fldAp,2.3333333333333335,38,11,CGAAAATTCTCGCGCCACTC,27,1072325
fldAp,4.166666666666667,60,11,CCTTGGTAGGCATGACAGAT,49,1146226
fldAp,1.0,22,11,CCTGATTGCAAGACCTCCAG,11,1078878
fldAp,20.25,253,11,CCTCCGCGGGGTCACTATTG,242,1114253
fldAp,10.583333333333334,137,11,CCGTTCTAGGTGAGTCCTGT,126,1094767
fldAp,2.75,43,11,CCGTGTCCGCCTTGAACAAA,32,1173339
fldAp,5.916666666666667,81,11,CCGTCTCTGCTTGTGCTCGT,70,1097740
fldAp,5.5,76,11,CCGTCACGTAGTCTGAGTTA,65,1180300
fldAp,1.6666666666666667,30,11,CCGGTCACATGTGGGGAAAT,19,1105566
fldAp,0.75,19,11,CCGGACGAGCTGAATTGTAC,8,1173371
fldAp,4.0,58,11,CCGCTTTCTCTCTGTATTCA,47,1164527
fldAp,2.5,40,11,CCGCTCACGTTATCTAGCTA,29,1135124
fldAp,0.16666666666666666,12,11,CCGCGGGGGGAAACCAAATA,1,1175679
fldAp,2.75,43,11,CCGACAAAACCCAAGGTATT,32,1089298
fldAp,1.5,28,11,CCCTCCGCTCAGGACGTTTT,17,1171035
fldAp,0.16666666666666666,12,11,CCCGCGTAAATTACCGGAGT,1,1100582
fldAp,1.3333333333333333,26,11,CCCCGCTTTTCTCCTCGGAC,15,1095285
fldAp,2.0833333333333335,35,11,CCCATGCAGCGAAGCGACGG,24,1157640
fldAp,0.16666666666666666,12,11,CCCAGCGTTCCAGTGATAAC,1,1116354
fldAp,0.4166666666666667,15,11,CCATTTTTAGGCAGCCGGCG,4,1139314
fldAp,2.3333333333333335,38,11,CCAACTGGGAGGAAAAGGAA,27,1114355
fldAp,6.25,85,11,CATTGGTATATGAAGGCAAT,74,1125463
fldAp,1.6666666666666667,30,11,CATTGCGATTAGCCTATCTA,19,1143643
fldAp,3.3333333333333335,50,11,CATTGAAGCCCTCTCGGCTG,39,1099649
fldAp,0.16666666666666666,12,11,CATGAACGACTGCAAATATG,1,1182504
fldAp,3.1666666666666665,48,11,CATCGTATTTCGTGAATATT,37,1111333
fldAp,7.0,94,11,CATCATTGTGGGAGACGACG,83,1137637
fldAp,2.0833333333333335,35,11,CATCAGGTTACTATTGTTAG,24,1092208
fldAp,1.1666666666666667,24,11,CATATGGAAGCCGTATGGTG,13,1136255
fldAp,3.75,55,11,CAGTTTTTAGCGGTTTAGCA,44,1112790
fldAp,0.16666666666666666,12,11,CAGTACACGGACTCGGAAAT,1,1093514
fldAp,2.8333333333333335,44,11,CAGGAGGGCAGATCGTGAGG,33,1183391
fldAp,5.333333333333333,74,11,CAGAGAAGGGATTTGAGTGC,63,1150636
fldAp,4.833333333333333,68,11,CACTACCATATGTCGCCATG,57,1085767
fldAp,1.25,25,11,CACGTATTGGGGTTAGAAGT,14,1152792
fldAp,2.3333333333333335,38,11,CACGGTACCTCCCCTAGAGT,27,1134609
fldAp,1.75,31,11,CACGCGTATGGTAGTCTTTA,20,1140190
fldAp,1.5833333333333333,29,11,CACGAATGTGCTTGATGGGT,18,1102910
fldAp,1.75,31,11,CACCATTCGCCCACGGCGGT,20,1111979
fldAp,7.416666666666667,99,11,CAATCGTTGGTGGGGTTTGT,88,1133336
fldAp,1.8333333333333333,32,11,CAATCAGCTCAAGATCGCAT,21,1142520
fldAp,1.5833333333333333,29,11,CAAGGAGCACTTAATATAAA,18,1099941
fldAp,3.0,46,11,CAAGGACCCCGAGCGTCGCA,35,1186629
fldAp,3.75,55,11,CAAGCACACGTTCGCGCGCG,44,1186687
fldAp,5.916666666666667,81,11,CAAGATGTATTGCGGGGCTG,70,1174582
fldAp,3.3333333333333335,50,11,CAAGAGATAGGGCAAGGGGA,39,1174803
fldAp,0.16666666666666666,12,11,ATTTGCTAGAACTGAGCTGA,1,1119469
fldAp,1.5833333333333333,29,11,ATTTCTGCTCTTTGTCACAA,18,1134839
fldAp,4.083333333333333,59,11,ATTGGGAAGTTTTCGGTTTC,48,1151181
fldAp,2.0,34,11,ATTGCTTCGATGTGCAAAGA,23,1099388
fldAp,2.1666666666666665,36,11,ATTCTAGATGCCTTTAGCGT,25,1138537
fldAp,2.0,34,11,ATTCCACCGCTGCGAACACT,23,1150340
fldAp,2.5,40,11,ATTATCTAGATCAACATCGG,29,1106413
fldAp,2.3333333333333335,38,11,ATTAGGGTTTCGTTGACGCC,27,1081368
fldAp,1.25,25,11,ATTAGGGTACGAGTCCGTAT,14,1075163
fldAp,1.25,25,11,ATGTCTCCTTCTATACAGAT,14,1156909
fldAp,1.5833333333333333,29,11,ATGTAGGGTCCCCACCGGAT,18,1086633
fldAp,1.8333333333333333,32,11,ATGGCGTAAGGTTAGCAGCT,21,1131850
fldAp,2.4166666666666665,39,11,ATGCTATACGAGGCATTCTC,28,1184265
fldAp,1.5833333333333333,29,11,ATGCGCCGGGAAAAGGCGTT,18,1147617
fldAp,8.416666666666666,111,11,ATGCGCCCAGTGTAATTCTT,100,1116956
fldAp,1.5833333333333333,29,11,ATCGTCCTTGGGCGAGGCCG,18,1178495
fldAp,2.4166666666666665,39,11,ATCCGTTTAAGTGATTGATA,28,1138511
fldAp,1.0833333333333333,23,11,ATCCGGTGTAACTCCCTGCT,12,1138658
fldAp,2.5,40,11,ATCATGGTATTCCGGCGGCA,29,1145096
fldAp,1.4166666666666667,27,11,ATCAGTGATGAATGACCCAT,16,1154193
fldAp,4.25,61,11,ATCAACCAGTAATCATCATG,50,1072303
fldAp,1.4166666666666667,27,11,ATAGTATAGAAGCAGCCCCA,16,1134086
fldAp,7.75,103,11,ATAGGTACCCACTTTGCACT,92,1064940
fldAp,0.16666666666666666,12,11,ATAGCTACGTGTTCGTGGCT,1,1119868
fldAp,1.5,28,11,ATACCGGACCCGATGTATTT,17,1086235
fldAp,1.75,31,11,ATACAGCTGCACTCACTTGT,20,1108133
fldAp,1.75,31,11,ATAATTCGTTTGATCTCGTA,20,1171486
fldAp,2.5833333333333335,41,11,ATAATAGAAGTTTCGGTCGC,30,1116254
fldAp,5.583333333333333,77,11,ATAAGCCCCCTACGCCCCGC,66,1130881
fldAp,0.16666666666666666,12,11,AGTTTCCGGGGATCCGCACT,1,1172001
fldAp,2.4166666666666665,39,11,AGTTGGAATTACAAGAGATC,28,1101175
fldAp,2.4166666666666665,39,11,AGTTGACCCTTGGCGTTGAC,28,1123957
fldAp,3.0833333333333335,47,11,AGTGAATAGAACTGTGGAAC,36,1158420
fldAp,4.0,58,11,AGTATGGGACGATTCTCAGT,47,1168349
fldAp,0.16666666666666666,12,11,AGTAGAAAAACCAAGAAATA,1,1142735
fldAp,5.583333333333333,77,11,AGTAACAATTTCTAGACAGA,66,1064048
fldAp,4.75,67,11,AGGTCCAATACGAACAGAGG,56,1140221
fldAp,2.5,40,11,AGGTAAGAACTCATCGGGGA,29,1162693
fldAp,1.25,25,11,AGGGGAACCGAGTGCTCTTG,14,1121369
fldAp,3.1666666666666665,48,11,AGGGCCAGACTCATTAAAAG,37,1063666
fldAp,6.416666666666667,87,11,AGGGATTATGCGCCAATCGT,76,1137065
fldAp,2.75,43,11,AGGCGCTCTTATCACCACAA,32,1171528
fldAp,2.9166666666666665,45,11,AGGCCAGGGACGATGGAGAA,34,1118830
fldAp,1.8333333333333333,32,11,AGGCACTGATAAACAATACG,21,1099483
fldAp,4.166666666666667,60,11,AGGCACTCTTGAGGAAGATT,49,1124250
fldAp,2.75,43,11,AGGACGCGTCGTGATGGCTA,32,1070220
fldAp,2.0833333333333335,35,11,AGCTTTTTTAAGCTCATGGG,24,1121239
fldAp,0.16666666666666666,12,11,AGCACCTTATATGGTACGGT,1,1137106
fldAp,2.6666666666666665,42,11,AGATTCTCAGGTGCCGGTCT,31,1177821
fldAp,0.5833333333333334,17,11,AGATTATATGTAAAAGAACT,6,1086846
fldAp,0.25,13,11,AGAGCGGCTGAGGTAGCAGC,2,1142118
fldAp,1.1666666666666667,24,11,AGAGAGGACGCGACCTAGAC,13,1186106
fldAp,0.75,19,11,AGACTTTCCAAAGCCATGTC,8,1089391
fldAp,3.25,49,11,AGAAGCGGTACTGGTAAGCA,38,1137039
fldAp,2.9166666666666665,45,11,ACTTGCTTCGCGCTCTTGCA,34,1102618
fldAp,2.1666666666666665,36,11,ACTGAACTTTCCCCTGCTGG,25,1081876
fldAp,0.16666666666666666,12,11,ACTCGCTGTCACGCGTATCT,1,1154760
fldAp,0.16666666666666666,12,11,ACGTTTCCCGGGGATATGAA,1,1103092
fldAp,0.16666666666666666,12,11,ACGTTCATCTTGCTGCCCTC,1,1089406
fldAp,1.5833333333333333,29,11,ACGTCACTACAATCATGACT,18,1096200
fldAp,0.9166666666666666,21,11,ACGTCACATGGGGATGTCCA,10,1138335
fldAp,1.5833333333333333,29,11,ACGGTGGTTCAAAAGGGTGC,18,1103449
fldAp,9.666666666666666,126,11,ACGGAGTGCGGTACGTTCAA,115,1097335
fldAp,0.16666666666666666,12,11,ACGCTACCTCTCGCGTTTGT,1,1180462
fldAp,1.9166666666666667,33,11,ACGCAAACGTTGGTCCCTGG,22,1170347
fldAp,2.8333333333333335,44,11,ACGATGAGATCGTGGCGAGA,33,1147110
fldAp,2.75,43,11,ACGATCTACGCACTTGCTAA,32,1168892
fldAp,0.3333333333333333,14,11,ACGATCGTTCCACGCCTAGG,3,1077057
fldAp,1.1666666666666667,24,11,ACGAGTGAGCGCTCGACACA,13,1177456
fldAp,3.5833333333333335,53,11,ACCAGGGAAGTCTGGCATGA,42,1066007
fldAp,1.6666666666666667,30,11,ACCAGATCACACCGCGGAAG,19,1094618
fldAp,2.6666666666666665,42,11,ACCACCCTAAAAGCTGCGTC,31,1099718
fldAp,0.9166666666666666,21,11,ACATTTTCGAGATTACTATC,10,1110848
fldAp,0.4166666666666667,15,11,ACATGTTAAAACACAAAGCA,4,1134323
fldAp,2.0,34,11,ACAGTTGGTTACTTGGGCCA,23,1166010
fldAp,1.0833333333333333,23,11,ACAGGTTTATACGTTGCAGA,12,1091060
fldAp,0.16666666666666666,12,11,ACAGCAGCCTCTCAATTTAA,1,1140765
fldAp,4.833333333333333,68,11,ACAGAGGATGATAGCCCTAC,57,1142609
fldAp,1.1666666666666667,24,11,ACACTGGGTCGAGGCCGTAT,13,1078792
fldAp,0.16666666666666666,12,11,ACACCAACTCATCACACTGT,1,1125779
fldAp,0.16666666666666666,12,11,ACACACGGTGAATCTCCTGA,1,1167863
fldAp,1.5833333333333333,29,11,ACAACGAGATAAGCTGTCAT,18,1094685
fldAp,2.25,37,11,AATTGTGCGGAGCTGTTTTT,26,1121400
fldAp,2.8333333333333335,44,11,AATTGGTAAGCTGAGACGGT,33,1122844
fldAp,2.0,34,11,AATTACTTGCAGCCAAGTTT,23,1151636
fldAp,2.9166666666666665,45,11,AATTAATATGCCCGTTCGAT,34,1114326
fldAp,1.1666666666666667,24,11,AATGCGTGAACCTTGTCAAC,13,1076078
fldAp,1.4166666666666667,27,11,AAGTTGCCACGTGGCGAGGG,16,1108494
fldAp,3.4166666666666665,51,11,AAGTGACCACCCTGGCGGAA,40,1176294
fldAp,0.16666666666666666,12,11,AACTTAATGGTTTTCGCTAA,1,1072429
fldAp,0.9166666666666666,21,11,AACTGGGAATTTAAAGACAT,10,1083524
fldAp,0.16666666666666666,12,11,AACTGGCCTTTCGCATAGAA,1,1123662
fldAp,0.16666666666666666,12,11,AACTGCCCCAGTCCGGTTCA,1,1083128
fldAp,0.16666666666666666,12,11,AACTCCTGCCAGCGGGCTAC,1,1115577
fldAp,2.0833333333333335,35,11,AACTAATTTTCGGTGATACC,24,1063229
fldAp,5.0,70,11,AACGTAGATACACTTTGGTA,59,1141732
fldAp,2.9166666666666665,45,11,AACGGCGTTATAAGCCCTAC,34,1176934
fldAp,2.5833333333333335,41,11,AACCTGTGCAACTAAGTACA,30,1180003
fldAp,1.8333333333333333,32,11,AACCACCATTCGGTCCGTCA,21,1135496
fldAp,1.5,28,11,AACATTCAGCAAAATGGATT,17,1069527
fldAp,0.16666666666666666,12,11,AACATTACGTCTCTTCCATC,1,1123830
fldAp,2.9166666666666665,45,11,AACATACACTGCCGCGCTAT,34,1076304
fldAp,7.75,103,11,AAATCAGTCAGGAGAGGGGT,92,1094036
fldAp,2.0833333333333335,35,11,AAAGATTAGTGCGCCAATTT,24,1136329
fldAp,1.3333333333333333,26,11,AAAACAAGGTGATCATTCCT,15,1161825
fldAp,5.818181818181818,73,10,TTTTCGAGTTGAGTTACCTC,63,1181821
fldAp,2.272727272727273,34,10,TTTATGGAAATGGAGAGATA,24,1101185
fldAp,0.18181818181818182,11,10,TTTATAATACCGTTCCTCAA,1,1134012
fldAp,2.4545454545454546,36,10,TTGTCATACTCACAGGCACA,26,1166884
fldAp,0.18181818181818182,11,10,TTGTATCGTAGCCGTTAAAG,1,1078163
fldAp,2.1818181818181817,33,10,TTGGTCCCCCCAACGTTACT,23,1158567
fldAp,0.9090909090909091,19,10,TTGGGGGAATGGGAACATTT,9,1084880
fldAp,0.18181818181818182,11,10,TTGAGCTGTAAGACCTGTGG,1,1155926
fldAp,0.18181818181818182,11,10,TTGAGACCCCGGTCAGGGGG,1,1154971
fldAp,2.090909090909091,32,10,TTGACGCTGAAAACGAGTAG,22,1156441
fldAp,0.18181818181818182,11,10,TTGAATCGTCCGGTTATGAT,1,1116617
fldAp,1.7272727272727273,28,10,TTGAAGCACCTTTCCCGGTT,18,1158837
fldAp,3.6363636363636362,49,10,TTGAAGAGGTACGCAGGCAT,39,1143024
fldAp,0.18181818181818182,11,10,TTCTAAGAGAAGTATCTTCC,1,1095228
fldAp,6.545454545454546,81,10,TTCGGAGGTAGCGCCAGGCT,71,1133347
fldAp,5.090909090909091,65,10,TTCGAGTCATAAAGGGGGTT,55,1131707
fldAp,3.8181818181818183,51,10,TTCCGACACTCCGCATTTCT,41,1064285
fldAp,0.7272727272727273,17,10,TTCCCGACGCTTGCATAACA,7,1126284
fldAp,0.18181818181818182,11,10,TTCCAGTTTCGATAATCGGT,1,1141398
fldAp,3.0,42,10,TTCACTAAAGTGCATCAGAC,32,1090855
fldAp,6.181818181818182,77,10,TTACTTTGTCTTAACACGTT,67,1089354
fldAp,2.090909090909091,32,10,TTACGCAAGTTGCTTCTCGG,22,1149258
fldAp,0.8181818181818182,18,10,TTACCACTATACCCTGGACT,8,1113202
fldAp,4.7272727272727275,61,10,TTACAGAAGAAGGTGAATGG,51,1147685
fldAp,4.181818181818182,55,10,TTAAGTTGCTCTACGGGCGA,45,1082620
fldAp,3.0,42,10,TGTTTGGCTATCAAAGGCCA,32,1104345
fldAp,11.636363636363637,137,10,TGTTTGGCGGGATTTATTAC,127,1063636
fldAp,1.2727272727272727,23,10,TGTTAGATTGTACCATTAGT,13,1075053
fldAp,4.2727272727272725,56,10,TGTTAGAGTGATATGGTGTT,46,1073127
fldAp,1.8181818181818181,29,10,TGTGTTAAGTTATGCCCTCT,19,1108882
fldAp,2.272727272727273,34,10,TGTGCCCAGGAATGTAAGTT,24,1141983
fldAp,0.18181818181818182,11,10,TGTCGATCCACCACCGTATA,1,1152454
fldAp,0.18181818181818182,11,10,TGTCCTGACCGATTTCATCA,1,1177641
fldAp,3.5454545454545454,48,10,TGTCAAGAAAAAAGATTGGC,38,1110158
fldAp,4.090909090909091,54,10,TGTATGTATTGAGCTAAAAG,44,1147680
fldAp,1.0,20,10,TGGTTTCTTAATCTTAAGAT,10,1168240
fldAp,4.0,53,10,TGGGTTCCTCGTCCTACCAC,43,1070337
fldAp,3.3636363636363638,46,10,TGGGTTCAGAGACCGGCTGT,36,1083518
fldAp,0.18181818181818182,11,10,TGGCCGCTCAGCGCCACATG,1,1127950
fldAp,1.0909090909090908,21,10,TGGATCGAAAACTTCAAGAG,11,1082034
fldAp,2.727272727272727,39,10,TGGACTGGTAAATGACGGTG,29,1113203
fldAp,2.727272727272727,39,10,TGGAACGAATGTGTAGCCTT,29,1180094
fldAp,4.454545454545454,58,10,TGCTTTCGTATGTGCGCGCC,48,1113079
fldAp,1.9090909090909092,30,10,TGCTGTCAATAGATCGGTGG,20,1070526
fldAp,9.363636363636363,112,10,TGCAAATCCGGGAGGGTGTG,102,1082597
fldAp,2.6363636363636362,38,10,TGATTCGGATGCGAAGGGAG,28,1169693
fldAp,2.8181818181818183,40,10,TGATCAAAGGGGCAGTAAGT,30,1108026
fldAp,0.2727272727272727,12,10,TGATAGTACTGGATAGGCTA,2,1134141
fldAp,3.272727272727273,45,10,TGAGTTACCTGGGTAGAGTT,35,1124054
fldAp,3.909090909090909,52,10,TGAGGGCGTTGCGGTAGTAC,42,1101236
fldAp,10.727272727272727,127,10,TGAGCGTTCGCGAGCCTATG,117,1087431
fldAp,5.090909090909091,65,10,TGAGAAGCATTGTACTACCC,55,1141817
fldAp,2.5454545454545454,37,10,TGACCCATCTATCGAGGCCA,27,1091148
fldAp,4.636363636363637,60,10,TGACCAAGCCGGGGGGCGTA,50,1070128
fldAp,3.3636363636363638,46,10,TGACAAGGAATGTCGAGTAG,36,1113976
fldAp,2.727272727272727,39,10,TGAAGCGGGACGGGGACAAT,29,1155565
fldAp,1.5454545454545454,26,10,TGAACGCGGCTGTAATACTT,16,1117897
fldAp,1.5454545454545454,26,10,TCTGTCGCGTTGGCCTTCCT,16,1157389
fldAp,0.18181818181818182,11,10,TCTGAGTCCCGCCACTCGCA,1,1157629
fldAp,2.4545454545454546,36,10,TCTCGGGGTTCCATGGTGCA,26,1063006
fldAp,3.090909090909091,43,10,TCTATTTCTCCCCCCGTCAA,33,1066964
fldAp,0.18181818181818182,11,10,TCTAGTGCGGGAGTCTATGC,1,1069702
fldAp,0.7272727272727273,17,10,TCTAGAAAGGGTGGTTACGT,7,1149162
fldAp,5.2727272727272725,67,10,TCGTTGGATACATAGGCCAG,57,1167178
fldAp,4.909090909090909,63,10,TCGTTCGATTTCATTGCTTA,53,1135836
fldAp,0.18181818181818182,11,10,TCGGTCCGTTTTTTAAAGTC,1,1173479
fldAp,1.9090909090909092,30,10,TCGGCTAGTAAACCCACGCT,20,1157310
fldAp,5.454545454545454,69,10,TCGGCAAGTCACGTTCGAGT,59,1149619
fldAp,2.272727272727273,34,10,TCGGAGATCTAGCTTATCCA,24,1125032
fldAp,0.9090909090909091,19,10,TCGCCAAAGTGCCATATATG,9,1076580
fldAp,0.9090909090909091,19,10,TCCTCGAGGTACTGGGATGA,9,1141911
fldAp,2.0,31,10,TCCTACGCTCGGCTTTGGGT,21,1079186
fldAp,3.4545454545454546,47,10,TCCGTCCACCCCTAATAAAG,37,1173221
fldAp,0.18181818181818182,11,10,TCCGATTGCCGCCGGATACC,1,1185403
fldAp,1.7272727272727273,28,10,TCCGAGTTGCTAAGATACCT,18,1078068
fldAp,3.909090909090909,52,10,TCCCGTTCGAGCGCGCCCCT,42,1133370
fldAp,1.0909090909090908,21,10,TCCAGGATAACAAGCTATGT,11,1095323
fldAp,2.272727272727273,34,10,TCATTACGGGCCGACCTTTG,24,1107477
fldAp,4.363636363636363,57,10,TCATAAGGGCCATCATGTTA,47,1130410
fldAp,2.090909090909091,32,10,TCAGTAAGCATTAACCATGC,22,1067143
fldAp,3.1818181818181817,44,10,TCACGTCACGGAATTTTTTT,34,1165017
fldAp,4.090909090909091,54,10,TCACGTACGCACTGGCTCAA,44,1116253
fldAp,3.0,42,10,TCACAGGATAGCAATCAAAG,32,1114725
fldAp,3.4545454545454546,47,10,TCAAGACAGCATTCGGTCCG,37,1160803
fldAp,2.1818181818181817,33,10,TCAACGCTCAATGGGGGTCT,23,1089793
fldAp,0.18181818181818182,11,10,TCAACACTCTATATAGGCTT,1,1170224
fldAp,4.363636363636363,57,10,TATTGCACATTAAGAGAACG,47,1121051
fldAp,0.2727272727272727,12,10,TATTGCACAAGGTGGCGTTG,2,1152119
fldAp,9.818181818181818,117,10,TATGGGCGAATCATCCCCGG,107,1096706
fldAp,1.0909090909090908,21,10,TATCGTACGCCCCCCAATGA,11,1106050
fldAp,2.5454545454545454,37,10,TATCACCATACGCTAGGAAT,27,1110167
fldAp,2.6363636363636362,38,10,TATATCCGGGGCTGCTCATT,28,1129875
fldAp,1.0,20,10,TATAGTCCATGGGAACGCTG,10,1129741
fldAp,2.909090909090909,41,10,TAGGAGGACAACACAAGGTG,31,1159415
fldAp,2.4545454545454546,36,10,TAGGAATACGACCAGGGGTA,26,1145653
fldAp,0.18181818181818182,11,10,TAGCCCTTGGGAGGCTCGGT,1,1120179
fldAp,2.090909090909091,32,10,TAGATCTGATTGTGCAGTAT,22,1101666
fldAp,1.8181818181818181,29,10,TAGATCCAAGTCGTTACGCT,19,1126716
fldAp,1.4545454545454546,25,10,TAGAAAGGACTGGGGATTGA,15,1151918
fldAp,4.454545454545454,58,10,TACTGGACTAATGGTGCTGG,48,1101977
fldAp,3.1818181818181817,44,10,TACCTTAAGCTGAGATTACT,34,1129421
fldAp,2.3636363636363638,35,10,TACAATCAGTGCCGTCTTAG,25,1148424
fldAp,0.18181818181818182,11,10,TAATCATTCATTAAGTTTTT,1,1159615
fldAp,3.1818181818181817,44,10,TAACTAGCCCTCTGGTGGTT,34,1144986
fldAp,0.18181818181818182,11,10,TAACGGGCGTTGCATACGAC,1,1150938
fldAp,3.909090909090909,52,10,TAAATCTTATCCGGGAAATA,42,1093061
fldAp,0.18181818181818182,11,10,TAAACTCCCTGACGCATTAC,1,1177857
fldAp,8.363636363636363,101,10,TAAAAGGTTTTCTTTAGCGT,91,1116246
fldAp,2.6363636363636362,38,10,GTTTCAAAATACGCGTCCAC,28,1142688
fldAp,4.0,53,10,GTTGGCTTTGAAACTCGTAG,43,1104079
fldAp,1.4545454545454546,25,10,GTTCGGTGATAACTCTGTTA,15,1081140
fldAp,0.18181818181818182,11,10,GTTATCTTGGCGGTGTAGCA,1,1094609
fldAp,2.0,31,10,GTGTCTGGAGGTAAAAGCGG,21,1085877
fldAp,1.7272727272727273,28,10,GTGTCGTTTCAAGACGCTCC,18,1063742
fldAp,2.3636363636363638,35,10,GTGGATGTCGGATGCGCCCT,25,1180593
fldAp,2.1818181818181817,33,10,GTGCACATGCTGTGGTGAAC,23,1100397
fldAp,5.545454545454546,70,10,GTGCACAACTCTTGGGGGCA,60,1064037
fldAp,1.6363636363636365,27,10,GTCGTAATATCCACATCCAG,17,1099395
fldAp,0.45454545454545453,14,10,GTCGCAGTAGAAACTTTCAG,4,1178900
fldAp,0.18181818181818182,11,10,GTCGATACATCAAATCAATG,1,1186024
fldAp,14.545454545454545,169,10,GTCCCCCTTTCGATCTCAAG,159,1140921
fldAp,1.9090909090909092,30,10,GTCCAGCCGAATCGCCAAGC,20,1110168
fldAp,2.1818181818181817,33,10,GTCATGCAAGGCGCCTAAGA,23,1179075
fldAp,2.3636363636363638,35,10,GTCACCGTTAGCCTTTTAGT,25,1068649
fldAp,2.0,31,10,GTATGGCGAGTCTACTAGCG,21,1167174
fldAp,6.2727272727272725,78,10,GTATGAGGGGTGATGTGCCT,68,1094696
fldAp,1.0909090909090908,21,10,GTAGGCCTGGCGCAAGTTAC,11,1082276
fldAp,2.6363636363636362,38,10,GTACGTCGGCAAGATCTATA,28,1067467
fldAp,3.727272727272727,50,10,GTACACACTGGTTAGATAGT,40,1157792
fldAp,2.0,31,10,GTAACGCGGGTGTATCATCT,21,1139299
fldAp,0.2727272727272727,12,10,GGTTTGACCGTTTTTGATGT,2,1063150
fldAp,2.272727272727273,34,10,GGTTCAGTCCATGTGACCTA,24,1070610
fldAp,2.272727272727273,34,10,GGTGTGCAATGACACCTGCA,24,1104309
fldAp,6.0,75,10,GGTCAACGTCGTAACAGCCA,65,1064932
fldAp,2.909090909090909,41,10,GGTACGTTTTCCTTCCATTG,31,1168045
fldAp,5.545454545454546,70,10,GGTAACATTGAAATAATGCT,60,1126095
fldAp,6.363636363636363,79,10,GGGTGTGATGGTAAGTTTGG,69,1153190
fldAp,0.18181818181818182,11,10,GGGGTGCCTTTGTTTCCAGT,1,1137298
fldAp,1.3636363636363635,24,10,GGGGTCACTCCCGCATGTGT,14,1164394
fldAp,0.18181818181818182,11,10,GGGGTATTCTGTTTTAAATC,1,1125824
fldAp,4.7272727272727275,61,10,GGGCGGAGCCCCATTAGCGG,51,1158002
fldAp,5.818181818181818,73,10,GGGATCAATAACCTCGTACT,63,1095297
fldAp,2.090909090909091,32,10,GGCTGCCCCCTATCAGCACA,22,1094933
fldAp,2.4545454545454546,36,10,GGCGGGGAGAGTTAGAACTC,26,1119351
fldAp,7.090909090909091,87,10,GGCGGGCGCGTTCAGTCAAA,77,1151206
fldAp,5.454545454545454,69,10,GGCGGCACGTTCAATGTTGC,59,1081679
fldAp,4.909090909090909,63,10,GGCCTAGACGAGCTAATCGT,53,1065155
fldAp,3.0,42,10,GGCCGCAGGGTCGAATCGAA,32,1161178
fldAp,1.2727272727272727,23,10,GGCCCGTTCTGCGCGAGTCG,13,1173574
fldAp,4.0,53,10,GGCAAGAGGTAGCGAACACT,43,1102393
fldAp,0.45454545454545453,14,10,GGATCCCGAAAGCCGATAGT,4,1110186
fldAp,1.8181818181818181,29,10,GGAGTCCATATAAGGACATG,19,1115818
fldAp,1.7272727272727273,28,10,GGAAGTGGTAGCACCATATT,18,1152706
fldAp,0.18181818181818182,11,10,GGAAGCCGAACGGACCTCTC,1,1181062
fldAp,2.090909090909091,32,10,GGAACGTGGCTATTATGGAA,22,1095206
fldAp,4.090909090909091,54,10,GCTTTCGGGATAAGTGTCTA,44,1084051
fldAp,0.18181818181818182,11,10,GCTTGAGGTTGAAGGACCGT,1,1176611
fldAp,0.36363636363636365,13,10,GCTTACCACCGAAGACAGAC,3,1113984
fldAp,4.090909090909091,54,10,GCTGTCATAGTCACCGTCTG,44,1173935
fldAp,6.181818181818182,77,10,GCTCGGATATCGTGGTCTCT,67,1167158
fldAp,3.8181818181818183,51,10,GCTACGGTCTAATTACTGAT,41,1079188
fldAp,1.0,20,10,GCGTACGAACGTAATAAAAC,10,1148808
fldAp,3.5454545454545454,48,10,GCGGTCTTTACAGGTAACGT,38,1068925
fldAp,1.2727272727272727,23,10,GCGGCGCAGATCTGGCCGGA,13,1115714
fldAp,1.0,20,10,GCGCTTAACCTAATATATAT,10,1079077
fldAp,2.8181818181818183,40,10,GCGCGAGCTGTCTCCGAACT,30,1159893
fldAp,0.18181818181818182,11,10,GCGATACACCACGCCATATT,1,1108501
fldAp,2.090909090909091,32,10,GCGACAGCAGATCTAGATGC,22,1177124
fldAp,2.0,31,10,GCCGTTGCACGTTAACTGTA,21,1063860
fldAp,7.454545454545454,91,10,GCCGGTCTGGGAGCGACTTC,81,1105816
fldAp,1.0909090909090908,21,10,GCCGAGCTGTGAGCACAAAG,11,1107920
fldAp,1.6363636363636365,27,10,GCCCTGGGAACCCCAGATGG,17,1096260
fldAp,2.272727272727273,34,10,GCCCCTTTCTCGCCTCGCGG,24,1147613
fldAp,2.6363636363636362,38,10,GCATGTGCCCTTAGACACAC,28,1127530
fldAp,3.727272727272727,50,10,GCATCATAATATTTCTGGAC,40,1163103
fldAp,2.3636363636363638,35,10,GCAGTTGAGTGCAAATGATC,25,1085089
fldAp,2.090909090909091,32,10,GCAGCCATGTTTCACACGCC,22,1148631
fldAp,4.090909090909091,54,10,GCACTTTACTCAGAGTGAAA,44,1129739
fldAp,1.0,20,10,GCAATCTAGGTATCGAACAA,10,1125615
fldAp,2.0,31,10,GCAAGCGGGTCCTCAGCGAA,21,1123824
fldAp,0.18181818181818182,11,10,GCAAAACCTGGAAGCAGCAG,1,1103825
fldAp,2.1818181818181817,33,10,GATTTGTCTTGCGGCGCACA,23,1079645
fldAp,1.8181818181818181,29,10,GATTCCATTGAGTCTAGCGT,19,1150822
fldAp,2.727272727272727,39,10,GATGGATATCCATACTAATT,29,1105282
fldAp,0.18181818181818182,11,10,GATGCACGTGCACGATGATT,1,1152870
fldAp,3.8181818181818183,51,10,GATCCCAATAGGACGGAGCA,41,1093139
fldAp,1.8181818181818181,29,10,GATACCGGTCATTCATTGCT,19,1132027
fldAp,3.0,42,10,GAGTGTGCATTAACTGCTGT,32,1086129
fldAp,14.545454545454545,169,10,GAGCAATACACAGGCACTTG,159,1073366
fldAp,1.4545454545454546,25,10,GAGATCTCTGAATCTCTCTA,15,1097817
fldAp,1.3636363636363635,24,10,GACCCAAAGGCAGACGCCAA,14,1121852
fldAp,0.7272727272727273,17,10,GACAGCAGCTTAACACTATC,7,1064457
fldAp,1.9090909090909092,30,10,GAATGGGGCGTGGCAAGGCA,20,1124300
fldAp,4.363636363636363,57,10,GAAGAGTAACGGGGGGATCC,47,1081856
fldAp,1.6363636363636365,27,10,GAAATACGACAAAGCGTTCT,17,1079992
fldAp,2.4545454545454546,36,10,GAAAATCTTCCCAAACTCAG,26,1150399
fldAp,2.8181818181818183,40,10,CTTTGGGCGCATTCTTCTGT,30,1063737
fldAp,1.8181818181818181,29,10,CTTTGATGCGCAAGCCGTTG,19,1154078
fldAp,4.545454545454546,59,10,CTTGTCCTCCTACATGCCGG,49,1092129
fldAp,3.272727272727273,45,10,CTTCTAATTTTATTCGAATT,35,1116100
fldAp,0.18181818181818182,11,10,CTTCGCAGAAAGATCTTCGA,1,1119099
fldAp,4.181818181818182,55,10,CTGGGCGGAACCCACCCGCG,45,1178644
fldAp,4.181818181818182,55,10,CTGAGATTAATCAGGCGCTG,45,1080147
fldAp,2.909090909090909,41,10,CTGAATAAACTTATTAAAGC,31,1165566
fldAp,4.090909090909091,54,10,CTCTTCGCATAATGCAAATG,44,1168819
fldAp,2.6363636363636362,38,10,CTCATTGATGTTGTACGACA,28,1164352
fldAp,3.4545454545454546,47,10,CTCACTGGTAAAGACCGCCA,37,1164778
fldAp,2.1818181818181817,33,10,CTATGGCAAATCAAACAATG,23,1082588
fldAp,0.18181818181818182,11,10,CTATGCCCTTGGTCATCGTT,1,1098310
fldAp,4.0,53,10,CTAGGTCACTTGGCAGGTGT,43,1105283
fldAp,5.0,64,10,CTACTTGTTGAAAAGTACCG,54,1086055
fldAp,2.5454545454545454,37,10,CTACATGTTGGATAAGCTTT,27,1106597
fldAp,1.4545454545454546,25,10,CTAACCACAAAGTACGGGAC,15,1156029
fldAp,4.090909090909091,54,10,CGTTGAAATCTGATCATTGG,44,1175121
fldAp,6.7272727272727275,83,10,CGTTACAAGGGATTACAGGG,73,1117746
fldAp,3.909090909090909,52,10,CGTGCGACCGCACTGTAATC,42,1095419
fldAp,1.9090909090909092,30,10,CGTGAGGCTATTTTGACTAC,20,1120194
fldAp,3.727272727272727,50,10,CGTCGTCGTAGGCCCGGTTA,40,1176509
fldAp,5.636363636363637,71,10,CGTCCGAGTTGTATGGTTTT,61,1099169
fldAp,2.090909090909091,32,10,CGTATTTGCCTGCGCGCGGG,22,1084610
fldAp,11.272727272727273,133,10,CGTATCGCTTTAAGTCTTAC,123,1139176
fldAp,1.7272727272727273,28,10,CGTACCGGTAAGCCGCTCGT,18,1065122
fldAp,3.090909090909091,43,10,CGGTAAGACTAAAGGTAACG,33,1098512
fldAp,2.6363636363636362,38,10,CGGGGGATTTGAGGGGCCTC,28,1117094
fldAp,2.4545454545454546,36,10,CGGGGGAGGACAGAGTCAGG,26,1113300
fldAp,4.090909090909091,54,10,CGGGATGATAAGTAACCCAT,44,1149216
fldAp,0.18181818181818182,11,10,CGGCGTTGCGCCTGCTTCGG,1,1127804
fldAp,2.5454545454545454,37,10,CGGCCCCTTGGTTGGCCATC,27,1101180
fldAp,1.4545454545454546,25,10,CGGCCCCCTGGCTCGTCGGG,15,1067377
fldAp,3.727272727272727,50,10,CGGACCAATGGGCTGGAGAA,40,1134577
fldAp,0.18181818181818182,11,10,CGGAATTTTTCGAGAATTTT,1,1085552
fldAp,2.5454545454545454,37,10,CGCTAGTTGTATGACATCAT,27,1148401
fldAp,2.727272727272727,39,10,CGCTACTTATACGGAGCTCA,29,1141335
fldAp,3.6363636363636362,49,10,CGCGCTGCTCGGCTGTTTGC,39,1079734
fldAp,3.5454545454545454,48,10,CGCGCTGCAATGTTTTCATA,38,1114944
fldAp,0.6363636363636364,16,10,CGCCAGCCTCCCCTGTAGGT,6,1112016
fldAp,6.181818181818182,77,10,CGCCACGAGCTTGTTATTAA,67,1151287
fldAp,5.818181818181818,73,10,CGCAGGTAGTTAAGACTAAT,63,1101023
fldAp,2.727272727272727,39,10,CGATTCCTCCTAAGGTTTCC,29,1180479
fldAp,1.5454545454545454,26,10,CGATTACGTGAGATGTCCAG,16,1075879
fldAp,2.727272727272727,39,10,CGACTTCGAACGGATCGGAT,29,1080091
fldAp,1.0909090909090908,21,10,CGACTCGGGTAGCTATGAGA,11,1150709
fldAp,2.090909090909091,32,10,CGACGTACAATACCAGCCCG,22,1067682
fldAp,2.3636363636363638,35,10,CGACCTTGAAGATCTGGGCA,25,1124919
fldAp,4.909090909090909,63,10,CCTGTCGTTAGGTTTAAATT,53,1150628
fldAp,2.0,31,10,CCTGGCATCGAAGCGTCTCC,21,1115665
fldAp,0.18181818181818182,11,10,CCTGCTGGGGACGGTCAGAT,1,1064356
fldAp,0.18181818181818182,11,10,CCTCTGCCCATTAGGGCACT,1,1112406
fldAp,3.1818181818181817,44,10,CCTCTGAGGACTCGTCTTTA,34,1180155
fldAp,3.6363636363636362,49,10,CCTCGTAACAGTGGTTCCTG,39,1076741
fldAp,5.545454545454546,70,10,CCTCCCAAGAAGGTCCGCGT,60,1173565
fldAp,2.8181818181818183,40,10,CCTCAAGAATTAGAAGCCCT,30,1139520
fldAp,0.18181818181818182,11,10,CCTACCGTTTGCCGTCCGCC,1,1088635
fldAp,2.272727272727273,34,10,CCTAAGGCCAGGCACAACTA,24,1096710
fldAp,1.7272727272727273,28,10,CCGGGTAAGTCCCCTGTCAG,18,1178559
fldAp,5.545454545454546,70,10,CCGGGAAATACTTTAAAATC,60,1166227
fldAp,9.727272727272727,116,10,CCGGATCTCACCTCGCGCAA,106,1147690
fldAp,1.6363636363636365,27,10,CCGCGGACAAACTGGTTGTA,17,1125686
fldAp,2.272727272727273,34,10,CCGCAGGAATATCATTCCGT,24,1118917
fldAp,10.363636363636363,123,10,CCGATTATTATTTGGGGATT,113,1088091
fldAp,2.909090909090909,41,10,CCCTGTAAGGTCTATGGGTC,31,1131964
fldAp,0.18181818181818182,11,10,CCCGCCGGCTACTTGCCCGA,1,1110924
fldAp,10.727272727272727,127,10,CCCCATAGAGTGAACCGTGT,117,1103960
fldAp,2.4545454545454546,36,10,CCATGGCACCCTCAATGTAA,26,1073105
fldAp,4.181818181818182,55,10,CCATAATTACACAAACTCGG,45,1135128
fldAp,2.6363636363636362,38,10,CCAGAGGGGGGCACACCATG,28,1092555
fldAp,3.272727272727273,45,10,CCACGCGATATGGTGTCGAG,35,1141739
fldAp,16.727272727272727,193,10,CATTTCCCACCGCCCAGGTA,183,1107653
fldAp,0.36363636363636365,13,10,CATTTACTCTGGGATGCCCA,3,1086516
fldAp,6.454545454545454,80,10,CATGTCGTCGAAACAGTCTG,70,1151376
fldAp,1.6363636363636365,27,10,CATGTAGATCATCGACCAGG,17,1118783
fldAp,6.2727272727272725,78,10,CATGCTGATGTCGTAAAATT,68,1065430
fldAp,5.090909090909091,65,10,CATGCACGGCAGATTATTAG,55,1133834
fldAp,5.636363636363637,71,10,CATAGCCACTGCCTTTGATG,61,1080499
fldAp,1.7272727272727273,28,10,CATACACCAGCGGAGACTAG,18,1151261
fldAp,2.0,31,10,CAGGCAATGCGATTCGCATC,21,1097525
fldAp,2.1818181818181817,33,10,CAGGAGTAGGAACCCGGAAT,23,1165696
fldAp,1.8181818181818181,29,10,CAGCGTCTGTCAGCGTCGCT,19,1126151
fldAp,2.5454545454545454,37,10,CAGCCCCTCTCCTTAGTCAG,27,1111122
fldAp,1.2727272727272727,23,10,CACGTAGATTTTCCGTGCTG,13,1094575
fldAp,2.5454545454545454,37,10,CACCTCACCGCCCAGGGCTA,27,1114486
fldAp,1.5454545454545454,26,10,CACCACGGGAAACTCTTACT,16,1110470
fldAp,2.727272727272727,39,10,CACATATAGGTCCCAAGGTT,29,1124118
fldAp,2.3636363636363638,35,10,CACAGTCCCTCCTTGAGACA,25,1159217
fldAp,0.18181818181818182,11,10,CACAAAGAACTTAAGTCCAC,1,1149586
fldAp,6.0,75,10,CAATTCCTCATTGTTATCGG,65,1100877
fldAp,2.8181818181818183,40,10,CAATCTTCGAACAACACCTA,30,1155446
fldAp,1.4545454545454546,25,10,CAATCAAGGTAGGGCGTTAA,15,1167985
fldAp,2.090909090909091,32,10,CAAGTTCGCTTTACGGTCTG,22,1091453
fldAp,4.363636363636363,57,10,CAAGGCCCTTCATCCTCACA,47,1162315
fldAp,2.0,31,10,CAAGCGTAAGAACCATGGAG,21,1154179
fldAp,2.5454545454545454,37,10,CAACACACAGCCAGAAATTC,27,1161443
fldAp,1.3636363636363635,24,10,ATTTTGTAGAGTTGCTACAG,14,1094872
fldAp,3.0,42,10,ATTTGTGAACAGAACTGAGC,32,1117867
fldAp,2.727272727272727,39,10,ATTTCGAAAATAGTTGGAGG,29,1148039
fldAp,0.18181818181818182,11,10,ATTGCGGTGATACGAAGATA,1,1082199
fldAp,1.8181818181818181,29,10,ATTGAGGGCCAACGAATTCA,19,1179194
fldAp,4.454545454545454,58,10,ATTGACGATGCTGGTAAGGT,48,1145989
fldAp,2.8181818181818183,40,10,ATTGAAAGATTTCCGGCACC,30,1107346
fldAp,0.18181818181818182,11,10,ATTCTACCATGTAGCCAGAT,1,1147393
fldAp,0.18181818181818182,11,10,ATTCGACAAAGTCACAGCCT,1,1152385
fldAp,1.0,20,10,ATTATACGGAGGTTAGACAG,10,1159324
fldAp,3.3636363636363638,46,10,ATTACGTGATTATGATAACT,36,1114976
fldAp,0.18181818181818182,11,10,ATGTCGCACGCCATTAACGA,1,1093653
fldAp,9.0,108,10,ATGTACGGGAACGAGTTGGT,98,1089389
fldAp,2.4545454545454546,36,10,ATGTACATGATTAAACGTGT,26,1145543
fldAp,6.909090909090909,85,10,ATGGCCGGCATGAGTCCTCC,75,1109665
fldAp,2.272727272727273,34,10,ATGGCACTCCTAAAGGACTT,24,1139019
fldAp,3.090909090909091,43,10,ATGCTTCTAGTTGTGGCATT,33,1105932
fldAp,1.4545454545454546,25,10,ATGATTCCCAGTGTATGCTG,15,1087484
fldAp,0.2727272727272727,12,10,ATGAATTTGGATGCAACCAG,2,1113741
fldAp,2.0,31,10,ATCTTAATCAGGTGGCTGGA,21,1076513
fldAp,3.1818181818181817,44,10,ATCTTAAGATTCAACAGAAC,34,1174379
fldAp,2.6363636363636362,38,10,ATCTCCGAAATGGGAGTCAG,28,1166777
fldAp,1.5454545454545454,26,10,ATCTATTGAGGACTTTGCAC,16,1126376
fldAp,1.4545454545454546,25,10,ATCCATTTAGCGCTGATCTG,15,1125552
fldAp,0.18181818181818182,11,10,ATCCAGGACTCAGAACGAGC,1,1146588
fldAp,6.636363636363637,82,10,ATCAGAGTACCCCTGTTCTA,72,1111367
fldAp,0.18181818181818182,11,10,ATATGTTGGAACAGCGGATG,1,1080001
fldAp,2.909090909090909,41,10,ATATCTAGATCGAGCGGGGT,31,1143323
fldAp,3.909090909090909,52,10,ATACGTTGTAAACCAGAGTT,42,1093879
fldAp,19.363636363636363,222,10,ATACCGCGAGCGCCTTCAGC,212,1118329
fldAp,14.636363636363637,170,10,ATACCGCATGAACTCACCAC,160,1114237
fldAp,2.1818181818181817,33,10,ATACAATCATGAAATTAAGT,23,1175484
fldAp,5.181818181818182,66,10,ATAACGCAAACAGCCCTACA,56,1084497
fldAp,4.2727272727272725,56,10,ATAACGACTTGAACCAGTTA,46,1071585
fldAp,0.6363636363636364,16,10,AGTTGTTGAGCCATCTCCTC,6,1065891
fldAp,10.727272727272727,127,10,AGTGGATGGTTGTGGCCCCG,117,1126531
fldAp,5.7272727272727275,72,10,AGTGCAGGGGCACGTACCTG,62,1106362
fldAp,2.727272727272727,39,10,AGTCGGTTCTTCCCGACCAG,29,1095829
fldAp,3.272727272727273,45,10,AGTCAATTGGAGTTGGGCCA,35,1134911
fldAp,4.2727272727272725,56,10,AGTCAACAGGAGGCCTTAGA,46,1121716
fldAp,1.6363636363636365,27,10,AGTACGACGTCCTCTAAAGG,17,1156812
fldAp,2.1818181818181817,33,10,AGGATCCTTACTGCTTCATG,23,1072104
fldAp,1.3636363636363635,24,10,AGGAACTCTTCGACGTCGTA,14,1138827
fldAp,1.5454545454545454,26,10,AGGAACGAGTGCAACGAGTC,16,1123964
fldAp,7.2727272727272725,89,10,AGCTGGCATGTGTCAAAGTG,79,1106166
fldAp,2.272727272727273,34,10,AGCTCTTAACTACTAGAAGT,24,1143081
fldAp,2.6363636363636362,38,10,AGCTCGTACGAGACTTCCAT,28,1069493
fldAp,2.0,31,10,AGCGAGAAATCAGCAGGATA,21,1178399
fldAp,2.3636363636363638,35,10,AGCCTTGGGGAGCAACGCGG,25,1086405
fldAp,1.6363636363636365,27,10,AGCCCTGCCGACCGAATTCA,17,1130898
fldAp,5.7272727272727275,72,10,AGCCCACCTTCGTATGACTA,62,1169970
fldAp,1.0909090909090908,21,10,AGCCAGACTTAACGTACACA,11,1097306
fldAp,2.3636363636363638,35,10,AGCAGGCACGGTGGATATTG,25,1096211
fldAp,1.3636363636363635,24,10,AGCAGCCGCGATATCGGAAA,14,1154289
fldAp,10.181818181818182,121,10,AGCAAATCTTAGAACTGTAG,111,1111265
fldAp,16.09090909090909,186,10,AGCAAAGAGTGCGCCGTGAT,176,1118330
fldAp,4.090909090909091,54,10,AGATGGAGGTCCACCTGACA,44,1105953
fldAp,2.272727272727273,34,10,AGATGAACTGATAGACTTAG,24,1105989
fldAp,1.0909090909090908,21,10,AGAGGGGGCGCGCCCAGGCT,11,1069472
fldAp,3.090909090909091,43,10,AGAGCGCCTTTTGCTGGTCT,33,1064291
fldAp,1.0909090909090908,21,10,AGACTCAGTAGCGGTCGGTG,11,1087834
fldAp,2.090909090909091,32,10,ACTTGTGCTTTCTACGCCTT,22,1181792
fldAp,2.909090909090909,41,10,ACTTGGGAATCGGTATTGAG,31,1111538
fldAp,3.727272727272727,50,10,ACTGCTGTGTGGGGATAATA,40,1183647
fldAp,0.9090909090909091,19,10,ACTCAAGAGCAGTACCCTGG,9,1114110
fldAp,2.272727272727273,34,10,ACTACGGTAACGTCGGAGAA,24,1094564
fldAp,1.4545454545454546,25,10,ACGTGGCTTATATCCCCCAA,15,1156114
fldAp,0.18181818181818182,11,10,ACGGGCAGTGCTGCCGCCAT,1,1068429
fldAp,0.18181818181818182,11,10,ACGGGACCACTTTCTCCCGG,1,1110275
fldAp,3.727272727272727,50,10,ACGGATCACCATGTGGGTTA,40,1098737
fldAp,2.727272727272727,39,10,ACGGACCAATCACCGGATTT,29,1153828
fldAp,4.181818181818182,55,10,ACGCCCGCCTAATGGTTTTT,45,1154281
fldAp,2.6363636363636362,38,10,ACGATCAAGAGGCTGCGGGG,28,1111741
fldAp,0.45454545454545453,14,10,ACCTGGTCTCGCAAGAGCTT,4,1101116
fldAp,2.5454545454545454,37,10,ACCTGAACATGGTACGGCAG,27,1154290
fldAp,4.909090909090909,63,10,ACCGTGCAGGATGTCACCTA,53,1082400
fldAp,3.6363636363636362,49,10,ACCGCTACTACAGGGCATCT,39,1132882
fldAp,11.545454545454545,136,10,ACCCCCGCGCTGAGTCAATG,126,1102758
fldAp,5.2727272727272725,67,10,ACCCAAACGTTCGGCACTAT,57,1164100
fldAp,1.0909090909090908,21,10,ACCAGGACGACTATAATTAA,11,1151291
fldAp,0.9090909090909091,19,10,ACCAGATTGTGCGGCAAGCC,9,1171838
fldAp,0.18181818181818182,11,10,ACAGGAGTCCCTGGGGTATA,1,1164783
fldAp,8.454545454545455,102,10,ACAGCTTGGAGCTAGACGGA,92,1108326
fldAp,2.727272727272727,39,10,ACACTAGAAATATATCTGTT,29,1167955
fldAp,0.18181818181818182,11,10,AATTTGAGTCTATGCCAAAA,1,1137080
fldAp,9.636363636363637,115,10,AATTACCGGGCGAGGCCAGA,105,1110160
fldAp,25.636363636363637,291,10,AATCTGTGGGTAAAATTGGT,281,1081609
fldAp,0.7272727272727273,17,10,AATACAAGACTCTTCCCCCG,7,1184877
fldAp,1.8181818181818181,29,10,AAGTTGTACGGATTCTGCGT,19,1121105
fldAp,2.5454545454545454,37,10,AAGTAACGTGTGATAAGGGT,27,1126157
fldAp,5.0,64,10,AAGGTCTACGCAACTCCGAG,54,1087440
fldAp,6.363636363636363,79,10,AAGCTATTGAATTGAAATTT,69,1128426
fldAp,2.3636363636363638,35,10,AAGATGCATTCTAACTACTG,25,1093894
fldAp,0.18181818181818182,11,10,AAGAGGAGGGGACCTGTGCC,1,1164620
fldAp,2.0,31,10,AAGACTGCCGGAGGCGCAAT,21,1136211
fldAp,0.8181818181818182,18,10,AAGACTGCAAATGACTCGCA,8,1124226
fldAp,0.18181818181818182,11,10,AAGACAGCTCGGTTGGGCCT,1,1084079
fldAp,0.18181818181818182,11,10,AACGTTTAGCTAGGTGTTAT,1,1116151
fldAp,2.272727272727273,34,10,AACGTTCTCGACAATCATCA,24,1078777
fldAp,2.5454545454545454,37,10,AACATTATTTACGACTCTAT,27,1153305
fldAp,0.18181818181818182,11,10,AACAGAATAGCCACAAGTTT,1,1100705
fldAp,3.5454545454545454,48,10,AACAAGCCAGCTATATGATT,38,1072959
fldAp,5.909090909090909,74,10,AACAAACTTTGCAGCATGCA,64,1115721
fldAp,5.181818181818182,66,10,AAATAAACTTGCACAAAGAT,56,1077054
fldAp,1.8181818181818181,29,10,AAAGTGAGGATCTACCCAGC,19,1118286
fldAp,3.272727272727273,45,10,AAAGCAGGCCGCTATAAGCA,35,1128811
fldAp,1.8181818181818181,29,10,AAACCCCTGGAACGGTGCAT,19,1130466
fldAp,2.1818181818181817,33,10,AAAATCCTTACTAGAACCTA,23,1169285
fldAp,0.18181818181818182,11,10,AAAACGCACAATCGTAGGTA,1,1105169
fldAp,2.5454545454545454,37,10,AAAAATCGAATGTAGACTAC,27,1067975
fldAp,5.5,63,9,TTTTTGAATAGCATCTTATA,54,1063204
fldAp,6.8,76,9,TTTGTTGTCTGAGGACCCTG,67,1118937
fldAp,1.7,25,9,TTTGGACCAAGCATGGAGTG,16,1104968
fldAp,1.6,24,9,TTTGAGGCGGGGTCGTATTA,15,1097692
fldAp,27.5,283,9,TTTCAAATCCTTCTATCTCA,274,1107657
fldAp,4.8,56,9,TTTAGTACGGCGTGCTCAAA,47,1094992
fldAp,3.2,40,9,TTTACGTAACTTAAGTAGCT,31,1178813
fldAp,0.2,10,9,TTTACGGCGATCACAGGTGT,1,1126987
fldAp,4.1,49,9,TTGGATGTCCGATAGGATCT,40,1108358
fldAp,19.9,207,9,TTGCTTTGGCAACTCATGAT,198,1064782
fldAp,1.0,18,9,TTGCGATATGAAACTATGCG,9,1112398
fldAp,0.2,10,9,TTGCCGAACATCCCATTCGT,1,1066749
fldAp,0.2,10,9,TTGATCGAAATTGTTGCCTC,1,1164537
fldAp,4.1,49,9,TTGACAGGGGTCGTTCCTCG,40,1081671
fldAp,1.3,21,9,TTCGCTTATGGCCATAAAAA,12,1159876
fldAp,11.4,122,9,TTCCACCAAGGCACGGGCGA,113,1111349
fldAp,2.9,37,9,TTCATCATTGCAATCGCTGC,28,1168824
fldAp,2.0,28,9,TTCAGTCCAGCTCTTTCGTT,19,1068949
fldAp,2.3,31,9,TTCACAAAGTGTGCCATCAA,22,1081891
fldAp,2.1,29,9,TTATGATTTCGCGGCACCAC,20,1086392
fldAp,3.7,45,9,TTATCACCTGGCATATAGGC,36,1124668
fldAp,2.6,34,9,TTAGGCATCGTAGCTCGCTC,25,1079619
fldAp,0.2,10,9,TTAGAAGCTCACAGGTGGCG,1,1089035
fldAp,5.5,63,9,TTACTCTTTGACCTCATGAG,54,1122027
fldAp,10.2,110,9,TTACTAAATACTAAAAATGC,101,1115028
fldAp,1.4,22,9,TTAAGTTAGCGACATCGGGG,13,1101132
fldAp,0.2,10,9,TTAAGATACTCCCGTTTCAG,1,1086245
fldAp,8.2,90,9,TTAACTTTAAGACCGGCCAC,81,1137809
fldAp,3.3,41,9,TTAACCGTTAGTGCTAGAAA,32,1067909
fldAp,2.3,31,9,TGTGTTAGGTAACGACATAG,22,1108136
fldAp,1.8,26,9,TGTCCTAAAGGGTTCCGGAC,17,1119855
fldAp,1.2,20,9,TGGCCATAAGCAAGCTGTCT,11,1143015
fldAp,0.2,10,9,TGGATGCCCCACGCACGGCG,1,1145631
fldAp,2.2,30,9,TGGAACAATGGCGTTTTGCG,21,1135027
fldAp,3.6,44,9,TGCTTGATCCAGTGGTCACC,35,1096106
fldAp,0.3,11,9,TGCTCCAACCCCGTGGCTAG,2,1082274
fldAp,0.8,16,9,TGCGTCACTCGCGACGTAGT,7,1173464
fldAp,0.2,10,9,TGCGCTTTCGAGCTCGCTGA,1,1078546
fldAp,2.8,36,9,TGCGAGACGTAAATGGACGT,27,1172210
fldAp,1.4,22,9,TGCAGCTACATCCGGCGAGT,13,1121311
fldAp,2.9,37,9,TGATTGGCTGCCCTCACGCC,28,1135018
fldAp,5.4,62,9,TGATGTCCAATCCAGGAGCG,53,1100850
fldAp,3.4,42,9,TGATGATGAATACGTGTTTA,33,1104661
fldAp,0.6,14,9,TGAGGGGAGCTACCTGATGT,5,1064572
fldAp,3.8,46,9,TGAGGAGGAAGATCATTGTT,37,1163126
fldAp,2.2,30,9,TGACTTCTGAGGGCTGCAAC,21,1168374
fldAp,9.4,102,9,TGACATATATTAGCAGGCTT,93,1159637
fldAp,3.0,38,9,TGAATGCCCCACCATCCCCT,29,1156423
fldAp,1.7,25,9,TCTTGCTCGTAGACACTTAC,16,1109440
fldAp,4.3,51,9,TCTTCGTCCTGTATGTCTCA,42,1160520
fldAp,3.6,44,9,TCTGATAGCGGCATAGGTAT,35,1117576
fldAp,2.0,28,9,TCTACGGTCTTCCTGTGGTC,19,1174400
fldAp,0.5,13,9,TCGTCCCATCGTTCTCTAAA,4,1172438
fldAp,2.3,31,9,TCGGTTCTCCTATGGTGACA,22,1083905
fldAp,0.4,12,9,TCGGTGGCGCTCGCCGTGCT,3,1151703
fldAp,7.2,80,9,TCGGTCCCCCGTGTCGTTTG,71,1119480
fldAp,3.7,45,9,TCGGGTCCATGCTAATAGCA,36,1178093
fldAp,3.3,41,9,TCGGAAGGCCCCTGGCTTTG,32,1140551
fldAp,2.0,28,9,TCGCCAGTATTTACAACGCT,19,1154979
fldAp,1.9,27,9,TCGAGCGGACTAGAGTCCTG,18,1176431
fldAp,0.2,10,9,TCCTCCAGGTAGAAAAGTAT,1,1076188
fldAp,3.6,44,9,TCCTAGCCTAGCGAAAGAGT,35,1165272
fldAp,1.1,19,9,TCCGTTTGAGTTGGGGCAAG,10,1063465
fldAp,0.2,10,9,TCCGTCATGCTAGGCTGTTA,1,1110836
fldAp,0.7,15,9,TCCGTATCGTCAAAATTCAG,6,1128744
fldAp,4.4,52,9,TCCCGTGATGCAGAATGCTT,43,1129591
fldAp,3.4,42,9,TCCCAATATACGGATAAGAA,33,1138670
fldAp,1.9,27,9,TCCATTATTACTTACTCGGT,18,1169991
fldAp,4.9,57,9,TCCACGGGGCACAAGCCGAT,48,1169089
fldAp,0.2,10,9,TCATCCCGCAATCCTACGGT,1,1106661
fldAp,0.3,11,9,TCATAGTTCGCGGCGTCCTT,2,1063061
fldAp,1.8,26,9,TCAGTAATCCATCTTCCGAC,17,1172033
fldAp,0.8,16,9,TCAGGATAACCGTTAAGGTA,7,1108906
fldAp,3.8,46,9,TCAGCTGGGCGATGTACAAA,37,1115771
fldAp,0.2,10,9,TCAGCACTGAAACACTAGTC,1,1086427
fldAp,1.9,27,9,TCACTGCCTTCGCGGAGGGT,18,1156524
fldAp,0.3,11,9,TCACGGCCGAATGAATATAG,2,1106544
fldAp,11.2,120,9,TCACAGGTTGAGCAGAGGCA,111,1088158
fldAp,4.3,51,9,TCAACTGTAAACTCGCTCCC,42,1099595
fldAp,4.6,54,9,TCAACTGCTCGATCAAGATA,45,1170946
fldAp,3.3,41,9,TCAACGATTTTATTTAAAGT,32,1076108
fldAp,0.5,13,9,TATTCATAAGGACATACGCG,4,1105174
fldAp,1.9,27,9,TATGTAAGCGACAACTTTCA,18,1100567
fldAp,3.3,41,9,TATGGACTTGGTTAGAAGGC,32,1084230
fldAp,1.5,23,9,TATCCCGAAATTGTATGGTT,14,1080272
fldAp,3.7,45,9,TATCATGTTCAAACTCGGAG,36,1113102
fldAp,1.8,26,9,TATATTACCGGTACCCTGTG,17,1115387
fldAp,1.8,26,9,TATAACTGGGACTCAAGGGT,17,1110678
fldAp,1.4,22,9,TAGGGGATTCGTACCCCCAG,13,1151927
fldAp,3.9,47,9,TAGGACAAGTTTCTTTTTCC,38,1066299
fldAp,3.3,41,9,TAGCTCCATCTAGTGTAGCG,32,1150902
fldAp,31.8,326,9,TAGCAAGCCGTTGTACGGTA,317,1107680
fldAp,0.2,10,9,TAGAGCCCCTCAATACGAAG,1,1133192
fldAp,3.0,38,9,TAGAACTAGGCTTAAAGGAC,29,1183026
fldAp,0.5,13,9,TACGATGTGCCATTCATATA,4,1098568
fldAp,1.7,25,9,TACGATCTCTAGAACGCATG,16,1105584
fldAp,3.3,41,9,TACCTCGAATCGTTATCGGT,32,1140323
fldAp,2.9,37,9,TACAGCTCGTATCACTGAGT,28,1101412
fldAp,2.7,35,9,TAATAGCCTCAGGCAGTACT,26,1107277
fldAp,4.0,48,9,TAAGTCATTCTGAGATAGAA,39,1067373
fldAp,5.8,66,9,TAACAAGAATGCAGGAATTT,57,1076763
fldAp,2.8,36,9,TAAAGGATGTAAATATTAGT,27,1076685
fldAp,0.2,10,9,GTTTTGGTAACAGTGCTAAT,1,1066292
fldAp,5.4,62,9,GTTTTGCCAAAGTCCACTGT,53,1108767
fldAp,3.5,43,9,GTTTCCTTTACAGATTCGCT,34,1067018
fldAp,3.6,44,9,GTTGTTCACTAAGGCGGTAC,35,1126408
fldAp,6.8,76,9,GTTGGAAAGAGACCCACGCT,67,1087830
fldAp,0.2,10,9,GTTCGGGTCGATCCTAACTC,1,1070055
fldAp,0.4,12,9,GTTATCTGCACGGTAGAGAG,3,1137327
fldAp,0.6,14,9,GTTAGCCGCCACACTCCCCC,5,1066785
fldAp,0.2,10,9,GTTAAGACGCATCAGGTTAC,1,1068777
fldAp,5.6,64,9,GTGTTAGTCGTTTGCGTGCC,55,1149573
fldAp,6.7,75,9,GTGTCGCCATGATGCCTCAT,66,1114953
fldAp,1.5,23,9,GTGCTTATCACCCGTGTCCG,14,1173644
fldAp,0.8,16,9,GTGATATTATATCGTTTGGT,7,1176411
fldAp,0.2,10,9,GTGACACGAACGGGTATAGA,1,1139671
fldAp,2.4,32,9,GTCCTGTTGTTTTTCTGGGT,23,1093667
fldAp,2.5,33,9,GTCAGCTTACATCGCCTAAC,24,1075148
fldAp,2.7,35,9,GTCAGACGCCCAGCTTCGGC,26,1130742
fldAp,1.5,23,9,GTATTGGTCTCTTAGTTATC,14,1117140
fldAp,4.3,51,9,GTATTACAGCGCGTACGTTA,42,1131939
fldAp,3.4,42,9,GTATAGTCTCGGGCCAAAAT,33,1131115
fldAp,3.3,41,9,GTAGCCAGGCGTGGCCTGAG,32,1165469
fldAp,0.4,12,9,GTACAGTTGCGTCAGTAATG,3,1124105
fldAp,2.6,34,9,GTAAGGGCTCCTTCCGACGA,25,1098854
fldAp,1.9,27,9,GGTTAAAGCCGGAAGGTAGC,18,1186204
fldAp,2.5,33,9,GGTGGTAGTACGTTGATTAA,24,1169095
fldAp,1.9,27,9,GGTCTCTTAGTGATTAGGTC,18,1179664
fldAp,3.1,39,9,GGTATGCAGTAAGGTCACTC,30,1099477
fldAp,0.3,11,9,GGGTCGCCTCGACTTGACTT,2,1120468
fldAp,7.6,84,9,GGGGTTCCAATCAACCCAAC,75,1135674
fldAp,0.2,10,9,GGGGTGGCTCAAACTAACGA,1,1140994
fldAp,0.3,11,9,GGGGACCTACTCTCCTTAAC,2,1084206
fldAp,2.9,37,9,GGGCTGGCCTCTATTTAGGG,28,1133610
fldAp,1.6,24,9,GGGAGGGAATAGCCGCCCCC,15,1116690
fldAp,5.4,62,9,GGCTGCCTGTGAATGACAGG,53,1099921
fldAp,0.4,12,9,GGCGTAATCGCTAAGAAGCT,3,1072027
fldAp,0.2,10,9,GGCACTTGAGGTCAGTCTTC,1,1164839
fldAp,3.3,41,9,GGATTTCTTCTCTTTAGGTA,32,1093913
fldAp,3.2,40,9,GGATTTCGGTGGACATCATG,31,1088930
fldAp,0.8,16,9,GGAGTTGGTACGGCATTAAA,7,1152086
fldAp,2.4,32,9,GGAAGTTAACAGGGCAAGGG,23,1072891
fldAp,0.2,10,9,GCTGGTTAAAGCACGTCTGT,1,1185281
fldAp,0.2,10,9,GCTCGTATTGTTCAAATTGC,1,1150101
fldAp,1.9,27,9,GCTACATTCACTCGCATCGT,18,1109530
fldAp,2.5,33,9,GCTAAAAGCAGTCTGCATGC,24,1112871
fldAp,2.9,37,9,GCGTGCTGCAAGCCAGCCCC,28,1149910
fldAp,2.5,33,9,GCGTGCAGTCAGGGGTTTTG,24,1086492
fldAp,3.1,39,9,GCGGGCTGCGCATGGAACGT,30,1080386
fldAp,5.2,60,9,GCGGGACTGCATACGGCTTC,51,1067612
fldAp,3.0,38,9,GCGATCTCGGTAACTGAGCC,29,1150892
fldAp,2.1,29,9,GCGAATTCGTGAGGATTTCC,20,1156355
fldAp,5.6,64,9,GCCGTGATGCCCACTAGCGG,55,1067678
fldAp,0.2,10,9,GCCCCTGAAGTTATCGCTTG,1,1068879
fldAp,8.2,90,9,GCCAGTCACTGACTTCTATG,81,1078057
fldAp,3.1,39,9,GCCAGCCTTTAATTTAGAAG,30,1176454
fldAp,5.1,59,9,GCCACGCTTACGGTAACTTT,50,1136011
fldAp,2.6,34,9,GCCACCTCTGTAAGGTCTTC,25,1082040
fldAp,1.7,25,9,GCCAACGTTTGAACACTCAC,16,1094843
fldAp,4.4,52,9,GCATGGGACTGTATTCTGGC,43,1138199
fldAp,3.7,45,9,GCATAGTGGTACATTACAAT,36,1128093
fldAp,2.4,32,9,GCATAGCGTACGTTTTTCGA,23,1167687
fldAp,6.8,76,9,GCACTGTTCATCTTGTAGTA,67,1093220
fldAp,2.2,30,9,GCACAATGGCAATCTAGAGA,21,1097691
fldAp,1.0,18,9,GCAATGAGCGGGCAAAAATG,9,1151902
fldAp,0.9,17,9,GATTGTTATCTCCGCGCAAG,8,1087495
fldAp,2.8,36,9,GATTACGGAGGCGCTCGTAC,27,1131153
fldAp,3.9,47,9,GATTAAAAAGACCGGTAGAC,38,1122028
fldAp,0.3,11,9,GATCTGCCGGTGTCTAAACA,2,1109623
fldAp,1.4,22,9,GATCTCAATTGGCGCCTCGT,13,1085881
fldAp,3.4,42,9,GATCCAGTCTTCCTGACTTT,33,1133179
fldAp,4.9,57,9,GATCCAGAACCTTTGCGGAG,48,1174057
fldAp,26.2,270,9,GATACACTACTACAACCGCA,261,1126532
fldAp,2.4,32,9,GATAACCCCATATGAAAGAA,23,1099781
fldAp,3.3,41,9,GAGTCGAGTAATTGCCGATG,32,1168699
fldAp,2.1,29,9,GAGTCGAGCGCGTTAGTGAT,20,1154343
fldAp,4.5,53,9,GAGATACCCGGATAGAACGA,44,1175265
fldAp,0.8,16,9,GAGACCCGCTTTGCACGCTG,7,1108373
fldAp,0.7,15,9,GACTGGTTTTGATTCGCTAT,6,1142517
fldAp,2.4,32,9,GACTGGGCTCGTTATCGTGC,23,1087787
fldAp,4.4,52,9,GACTGAGACCGATACCCTGT,43,1166434
fldAp,5.6,64,9,GACGGTATCCGAGCGTAACG,55,1150497
fldAp,3.8,46,9,GACGGGTGCGGATATCGTCC,37,1127325
fldAp,3.4,42,9,GACCTGTCGAAGTAATGCAA,33,1121709
fldAp,0.2,10,9,GACCCGCGCATAGGGCTAGA,1,1083525
fldAp,1.7,25,9,GAAGGGTGCACGAGATAAAG,16,1071590
fldAp,3.8,46,9,GAAGATAGGATATTTGTAAC,37,1103287
fldAp,6.1,69,9,GAACAACAATTGCCAGTCTC,60,1082196
fldAp,4.0,48,9,GAAAGGTCAGGCGAACGAGA,39,1146702
fldAp,8.4,92,9,GAAAGCAGTGCTAGAGAGAT,83,1145071
fldAp,1.8,26,9,CTTTCGTCACTGAATTCTAG,17,1139050
fldAp,5.8,66,9,CTTTCCAAGCCAGGGGGTTG,57,1064038
fldAp,0.2,10,9,CTTTAACTCTTACAATCTCC,1,1078568
fldAp,3.3,41,9,CTTGTTTAAGGGGTAAGTTA,32,1083915
fldAp,0.4,12,9,CTTGCTATACCGCCAATGCG,3,1102876
fldAp,2.6,34,9,CTTAGCAACCTCCTTTTAAG,25,1089292
fldAp,3.9,47,9,CTGTTTACTAGCAACGAGCC,38,1184126
fldAp,0.2,10,9,CTGGTAGTTCTCTTTTAGGT,1,1150823
fldAp,0.6,14,9,CTGCTTGTTGAGAATAGAAC,5,1156057
fldAp,1.8,26,9,CTGATTTGGGCCTCGACATA,17,1095411
fldAp,1.1,19,9,CTCTCGTCGGAGCTAACAGT,10,1124866
fldAp,39.2,400,9,CTCTCACGGTTCTTTCCACT,391,1063631
fldAp,2.7,35,9,CTCGGGGCACACCCACAAAA,26,1106193
fldAp,5.9,67,9,CTCGCGATCGTGCTGCGCGC,58,1106113
fldAp,2.4,32,9,CTCACCCCATTCAACAGAGA,23,1063779
fldAp,0.2,10,9,CTATTCTGGAGCCCAAGTTT,1,1170326
fldAp,1.2,20,9,CTATCACGTTAAGCCTGGCG,11,1113547
fldAp,2.0,28,9,CTAGAGAAATCCCGTCACTC,19,1103994
fldAp,0.4,12,9,CTACCGAAAAAGCGAACTTA,3,1163745
fldAp,21.4,222,9,CGTTTCGCGGTGGAAATTAC,213,1166714
fldAp,0.9,17,9,CGTGGACAAAGACTAGATCA,8,1167870
fldAp,1.6,24,9,CGTCTGCCGCTAGCTCCATA,15,1136709
fldAp,4.0,48,9,CGTCAGTAGCAGTTGACGTG,39,1086471
fldAp,2.3,31,9,CGTCACCACCACATGGCCGA,22,1075326
fldAp,1.4,22,9,CGTCAAGGCGCTATTTCGGG,13,1094499
fldAp,2.3,31,9,CGTAGGCAATTCTACCATGA,22,1157196
fldAp,2.9,37,9,CGTAGCCGCTGGAAAGACCC,28,1064918
fldAp,4.2,50,9,CGTACAAGGGTCCGGTGATA,41,1069799
fldAp,1.1,19,9,CGTAACCAGGGTGGAACTTC,10,1152031
fldAp,3.4,42,9,CGGTTCCGAACTTCGGGCAA,33,1173035
fldAp,0.2,10,9,CGGTGTCCCAGTATTGTGGA,1,1112057
fldAp,2.6,34,9,CGGTGGGACAGGCGGAAGCG,25,1150662
fldAp,1.1,19,9,CGGTAGGAGGCCCAGTACCC,10,1074939
fldAp,0.2,10,9,CGGATACACAGTGGGCCAAT,1,1141191
fldAp,0.6,14,9,CGCTTGTGCCTCATCTCCGA,5,1102379
fldAp,3.9,47,9,CGCTATGCTAGTAAGTAGGA,38,1153551
fldAp,2.3,31,9,CGCGTACAAAGTGTAATCAA,22,1078042
fldAp,1.7,25,9,CGCCTCTCCACTCGTTCCAC,16,1113957
fldAp,2.4,32,9,CGATGTAAGGCCTAGCAGTG,23,1096360
fldAp,3.6,44,9,CGAGGTGTCTGTAGGAGGAT,35,1126150
fldAp,2.1,29,9,CGACTGTGTATCGTATTTAC,20,1067791
fldAp,3.5,43,9,CGAAACGTCCGGAACAAAGT,34,1140789
fldAp,3.3,41,9,CCTTTATCGCCCGGAGTGAC,32,1065388
fldAp,0.9,17,9,CCTGTATGGCGTGGTCCTCC,8,1129243
fldAp,2.3,31,9,CCTGAGGGGCTTATATTCTT,22,1110869
fldAp,2.9,37,9,CCTAGTACTATCAAGGTAAT,28,1162816
fldAp,2.1,29,9,CCTAGCGTTTACGAGCAGTG,20,1113413
fldAp,1.7,25,9,CCTACAAGGATGTCCAGTTA,16,1149770
fldAp,0.5,13,9,CCTAATGGACACACAGGCCT,4,1063875
fldAp,2.3,31,9,CCTAAGCACAAGAGGTTGAT,22,1070207
fldAp,5.1,59,9,CCGTGCTAGCCTAGGTCGAA,50,1083890
fldAp,2.4,32,9,CCGTCACGCGGTATCAGTTT,23,1079259
fldAp,4.0,48,9,CCGTAAAGAGCCCTAACATG,39,1079195
fldAp,2.2,30,9,CCGCAAATCGGTACTTGTGC,21,1064067
fldAp,0.2,10,9,CCGAGTAGAACTACGAGAGA,1,1136004
fldAp,0.2,10,9,CCCTGCGACTTTGTGCAATT,1,1084294
fldAp,2.3,31,9,CCCTACTGGGATATGATTCC,22,1159336
fldAp,2.6,34,9,CCCCGAACAGTATCAATTCG,25,1154351
fldAp,1.2,20,9,CCATACCTAGACCGGTCCAC,11,1120134
fldAp,2.7,35,9,CCAGTAGGGTAACGCATTCT,26,1101177
fldAp,2.0,28,9,CCACTCCTGTGTATTTATTC,19,1094202
fldAp,1.6,24,9,CCACCGAATTTTTACAGTAA,15,1080188
fldAp,0.6,14,9,CCAAAGGTTTCAGTGCCCAA,5,1075862
fldAp,2.2,30,9,CATTGAAGTTTTCTGTCAAG,21,1171925
fldAp,2.6,34,9,CATGTTCATGTTGTATGGTG,25,1172008
fldAp,0.3,11,9,CATGGAAGCGTAATGCAACA,2,1067775
fldAp,0.2,10,9,CATGACATCGGTAATGGAAG,1,1098062
fldAp,4.4,52,9,CATCTAAAGTCGCCGCGCTA,43,1111835
fldAp,2.6,34,9,CATCATTGATGTCTTGTCCT,25,1151464
fldAp,1.7,25,9,CATAGTTTTCTACGAGAGCT,16,1127321
fldAp,3.2,40,9,CATAGGTCCTACTCGCGCCA,31,1101182
fldAp,6.6,74,9,CATAGCCCTCATACTGACGC,65,1087843
fldAp,2.0,28,9,CATAACGTTAGCATCAGACA,19,1087088
fldAp,0.5,13,9,CATAAATTTCTGTTTCTGCA,4,1100845
fldAp,0.2,10,9,CAGGTCTACCGGTGGCTTTG,1,1131955
fldAp,2.5,33,9,CAGGTCACAGCCCATCGGTT,24,1159904
fldAp,7.0,78,9,CAGGTACATCGATGGCTCCA,69,1146109
fldAp,1.3,21,9,CAGCTGCCTCCTCGCCCACA,12,1172966
fldAp,0.2,10,9,CAGCTCGTTGAGATTAATTC,1,1137811
fldAp,2.4,32,9,CAGCGCGAGTCCCCTCGGAG,23,1104485
fldAp,0.2,10,9,CAGAGACTAAGGGCTCCAGA,1,1079783
fldAp,2.3,31,9,CAGACTGACAGTCATCTCTA,22,1160930
fldAp,0.2,10,9,CACTCCACTCTCAATTTGAC,1,1177325
fldAp,1.4,22,9,CACTAGGACTCCTAGTTTCA,13,1086287
fldAp,1.7,25,9,CACGATTCTTCCAGAATCGG,16,1120658
fldAp,2.9,37,9,CACCACATAGGGATTAACAT,28,1107352
fldAp,2.2,30,9,CACACTCGCTTTTGACCTGG,21,1095001
fldAp,4.0,48,9,CAATTCCCTCTCATGTATGA,39,1140685
fldAp,3.4,42,9,CAATCGCACGTAAGCTGACT,33,1115162
fldAp,3.7,45,9,CAAGTGGCGGTCGATTTCAT,36,1119412
fldAp,5.5,63,9,CAAGGTCAAACCAGCAACTG,54,1068311
fldAp,2.7,35,9,CAAGGATGGAGTACCCTTAA,26,1126911
fldAp,2.5,33,9,CAAGCTGATTAGACATCGGT,24,1177419
fldAp,2.7,35,9,CAACTTTTGTCGTTTCGTCA,26,1142998
fldAp,3.1,39,9,ATTTGGTCGCCGGGGGAAAG,30,1183464
fldAp,5.1,59,9,ATTTCGGGCTGGTTGAACTT,50,1159748
fldAp,1.1,19,9,ATTTATGTAGGGAATATCAT,10,1179809
fldAp,2.3,31,9,ATTTAGCAAGTGATAAACTG,22,1066004
fldAp,3.9,47,9,ATTGGGCGAACTCTTCCGAC,38,1137461
fldAp,0.2,10,9,ATTCTTCACCAAAATCGCGT,1,1117458
fldAp,16.7,175,9,ATTATGGCTGTAATCATCAG,166,1126525
fldAp,2.5,33,9,ATTATATCACAATATGTGAG,24,1119249
fldAp,2.9,37,9,ATTAGAGTTTGGTTCCAAGG,28,1124448
fldAp,0.5,13,9,ATGGCATGACTGTGAGGAAA,4,1099827
fldAp,2.9,37,9,ATGCACAGCTTGTTGGTGAA,28,1128629
fldAp,2.6,34,9,ATGATACGTGCCTGGGATCA,25,1164045
fldAp,14.2,150,9,ATGAGAATCAGTTGGTCGGT,141,1066001
fldAp,2.2,30,9,ATGACTAAGCGAGAGCCCAA,21,1146391
fldAp,0.2,10,9,ATCTTACTCCTTATTTCTAT,1,1087996
fldAp,2.5,33,9,ATCTGTGGTGCCAGAATTCG,24,1072093
fldAp,5.3,61,9,ATCTCCGGGGCTCGACAAAC,52,1065131
fldAp,2.6,34,9,ATCGCGCACTACACGGAGCT,25,1138612
fldAp,2.2,30,9,ATCCCGCCCAATGCTACCCA,21,1122118
fldAp,2.3,31,9,ATCATTATGGGCAGGGCAAC,22,1127867
fldAp,4.2,50,9,ATCAGTGCATGGATAGGCTC,41,1078775
fldAp,1.0,18,9,ATATCCACTTGGGCTTTACA,9,1154030
fldAp,2.7,35,9,ATAGTATGCAATTTGCACAA,26,1139053
fldAp,12.2,130,9,ATAGGAAGTGAGTCTTTTAA,121,1082578
fldAp,6.8,76,9,ATACTGTGACTGGATGTGGG,67,1181503
fldAp,2.2,30,9,ATACGGCCTATTGGTGATCT,21,1180175
fldAp,3.3,41,9,ATAAGAAACGCAGGTCACTA,32,1108344
fldAp,4.3,51,9,AGTGTACGATCGGAGTGAGT,42,1111556
fldAp,0.2,10,9,AGTGGAGATGAAAGTCGCGT,1,1184180
fldAp,5.6,64,9,AGTGATACCCGCATGTGAGA,55,1133380
fldAp,1.9,27,9,AGTGAACCCGCGTGATTATA,18,1125323
fldAp,0.2,10,9,AGTCTAACGGATAGTCGAAA,1,1102004
fldAp,0.2,10,9,AGTCATATTGCACCAGCCTC,1,1104417
fldAp,2.6,34,9,AGTACAAGGGGAGAGATGGA,25,1120651
fldAp,0.8,16,9,AGGTAGGGATGATATTCGGA,7,1069597
fldAp,1.6,24,9,AGGATGTTTTGTGGTAAGGT,15,1073749
fldAp,2.4,32,9,AGGAGTCTTAGGACGGGGAA,23,1138705
fldAp,1.6,24,9,AGGACCTGACCCCAACAGGG,15,1115673
fldAp,0.2,10,9,AGGACAAGCTTGTCTGGTCG,1,1167460
fldAp,4.3,51,9,AGCTCCCACCGGGGTCAATA,42,1072412
fldAp,2.8,36,9,AGCGGGCCAAAGACGTGGCT,27,1186626
fldAp,1.6,24,9,AGCCTGGTGTAGTTCGTGTG,15,1093258
fldAp,0.2,10,9,AGCCGCAGAATTTCCGGCCA,1,1123242
fldAp,2.7,35,9,AGCCCGAGTCCGCCCTGGTC,26,1151617
fldAp,4.9,57,9,AGCATGGTTCAGTAAAGCAT,48,1179658
fldAp,0.2,10,9,AGCAAATACGAAAATCGGAG,1,1130236
fldAp,1.7,25,9,AGATTGTACCTCGGGAGCGA,16,1110314
fldAp,7.0,78,9,AGAGCTGCGCCAAAATTTGA,69,1118327
fldAp,2.3,31,9,AGAGCTCAAACGCAGAGATC,22,1113226
fldAp,2.9,37,9,AGAGACGGGCCACGATGCGG,28,1160487
fldAp,5.4,62,9,AGACCTGCAACTGGATCGGC,53,1113026
fldAp,4.8,56,9,ACTTAACAATCTGCGTCCGT,47,1127254
fldAp,6.5,73,9,ACTGATCACCGATGCGAATT,64,1158746
fldAp,5.4,62,9,ACTCGTCGTCCGAGATTTGC,53,1088869
fldAp,2.3,31,9,ACTCGCTCACGGCTTGTCCA,22,1105216
fldAp,2.6,34,9,ACTCACACGGCTATTTGATC,25,1093762
fldAp,0.2,10,9,ACTCAAATAAGCGTGTCATG,1,1114210
fldAp,5.6,64,9,ACGTTGGATAGCAACCAATA,55,1095377
fldAp,0.2,10,9,ACGTGGGCGGCTAACAGTCG,1,1101527
fldAp,2.2,30,9,ACGTGCGCCCCTCTAATGTG,21,1159327
fldAp,3.2,40,9,ACGTGCACGGCTGACCAGAT,31,1100827
fldAp,2.5,33,9,ACGTGAACAAGCGTACGAAA,24,1177785
fldAp,6.6,74,9,ACGGTTATGATGGGAGCCAT,65,1177351
fldAp,3.3,41,9,ACGGGGACGCACGACCATAT,32,1156712
fldAp,2.0,28,9,ACGGACAACTCTATTAAGCT,19,1079982
fldAp,1.9,27,9,ACGCGTGAAGGGGACTATGG,18,1146653
fldAp,0.3,11,9,ACGATGCCTCCTCACCGGAG,2,1130756
fldAp,0.2,10,9,ACGACCGCGCGCCTGGGTGG,1,1102514
fldAp,2.3,31,9,ACCTTTGGATATGTGGACAA,22,1143603
fldAp,5.5,63,9,ACCTAGTCGTTACCATCAGA,54,1106683
fldAp,1.6,24,9,ACCTAAGGGTTCAAGATTTT,15,1081428
fldAp,2.3,31,9,ACCGGATTCGATCTTCTATA,22,1154400
fldAp,0.4,12,9,ACCCAGACGATGCGGGCACC,3,1118386
fldAp,1.8,26,9,ACCAGAACGCCTTTCGCCAT,17,1183189
fldAp,0.3,11,9,ACATGTCTTACTCCGACAGC,2,1066130
fldAp,4.7,55,9,ACAATGATTCTCAAAAACAT,46,1097326
fldAp,2.0,28,9,AATTTAGTCCCTACGTATTC,19,1142581
fldAp,2.5,33,9,AATGGTAGCATCCGGCAGAT,24,1140918
fldAp,0.2,10,9,AATGGATATTTAAAATTGGG,1,1170584
fldAp,2.8,36,9,AATGCGCCCCCTATAGATAT,27,1185270
fldAp,3.6,44,9,AATCCACCGTCTAGTTGATT,35,1125891
fldAp,2.1,29,9,AATATTCTTCACTGGTCAGG,20,1150154
fldAp,2.0,28,9,AATATATTCCTCGGGGGTTG,19,1113789
fldAp,1.2,20,9,AAGTTTCGGGCTTTGGTATT,11,1172347
fldAp,2.9,37,9,AAGTCATACATATAACTTAT,28,1155350
fldAp,6.9,77,9,AAGGCTCTTTACTGGTCAAG,68,1124042
fldAp,5.3,61,9,AAGGCTCTCCACATAAGATG,52,1113815
fldAp,3.3,41,9,AAGGCATGGTCATAGCACAT,32,1108791
fldAp,0.2,10,9,AAGCCATCTTACGTTCAAAT,1,1135342
fldAp,9.1,99,9,AAGATTTGTGACAGGACAGA,90,1133681
fldAp,3.0,38,9,AAGAGGGCCTGGAACGCACG,29,1186197
fldAp,0.2,10,9,AACTTGCGCATCTAGCTAGC,1,1168147
fldAp,0.2,10,9,AACTACCCATCAATTGAGAC,1,1129668
fldAp,25.3,261,9,AACGCATATTCATACACAGT,252,1066072
fldAp,0.2,10,9,AACGAGGCTGTCGGGGCCAT,1,1155816
fldAp,3.1,39,9,AACCTTTTCGATGGTTTGCC,30,1087490
fldAp,2.9,37,9,AACCAGCCGGCACGCTTGCA,28,1174746
fldAp,2.1,29,9,AACATTCTTAGACATCGAGT,20,1145206
fldAp,3.6,44,9,AACATCGCTGAGAAAATATT,35,1177403
fldAp,2.5,33,9,AACACTGCTATCGGCTCTAT,24,1086976
fldAp,2.8,36,9,AAATCTGGCCCCCCGGCGCA,27,1110471
fldAp,2.3,31,9,AAATCGACCCCCACTACACG,22,1164775
fldAp,4.1,49,9,AAAGTGGTGGAACTTGGGCG,40,1132176
fldAp,4.8,56,9,AAAGTACGCTCACTACCATG,47,1155160
fldAp,3.2,40,9,AAAGTAATGACGGGCATTAT,31,1101984
fldAp,3.5,43,9,AAAGGATTCTCTTAATTCTA,34,1117375
fldAp,1.8,26,9,AAACTTATGATATCAAACGT,17,1155379
fldAp,8.3,91,9,AAACTATTACACCGTTGGCA,82,1067799
fldAp,2.3,31,9,AAAAGAATTCTTTGTATCAC,22,1134821
fldAp,0.2,10,9,AAAACGCGTGTCGTGTCAGT,1,1164836
fldAp,0.2,10,9,AAAACCGATAGTATCAGAGG,1,1098579
fldAp,0.2222222222222222,9,8,TTTTTAATGAGCTGCCCCGA,1,1097712
fldAp,2.888888888888889,33,8,TTTTGTGGCAGCTTCCCGGC,25,1078940
fldAp,3.0,34,8,TTTTGTAACGGGACGGAGAA,26,1150564
fldAp,5.111111111111111,53,8,TTTTATCTACCCTCAATTTA,45,1145192
fldAp,3.4444444444444446,38,8,TTTATTACTTGACATTCGAA,30,1174067
fldAp,8.333333333333334,82,8,TTGCTCGATCATATGTTTAC,74,1135870
fldAp,0.8888888888888888,15,8,TTGCGGAGAATTCCGTAGCA,7,1146661
fldAp,4.333333333333333,46,8,TTGCAGCTTGCTTAGTGCTT,38,1081032
fldAp,1.2222222222222223,18,8,TTCTTGTCCTAACGGCAACA,10,1141615
fldAp,8.88888888888889,87,8,TTCTAAGGGCGAGGAAGTAA,79,1165510
fldAp,0.2222222222222222,9,8,TTCGTCCGACCCCCACGGGA,1,1186541
fldAp,3.7777777777777777,41,8,TTCGCCGATTGGGGCGTGTT,33,1184129
fldAp,2.6666666666666665,31,8,TTCCCTTGGAGACACGTGTC,23,1063521
fldAp,2.111111111111111,26,8,TTCCCAAGTATAAGACTGCG,18,1141738
fldAp,0.2222222222222222,9,8,TTAGTGACAAACAAGTCCGA,1,1090594
fldAp,3.0,34,8,TTAGGAACTAAGTCTTCATG,26,1071652
fldAp,1.8888888888888888,24,8,TTACGGGTTATCATCGGGGA,16,1083884
fldAp,3.6666666666666665,40,8,TTACAACCGAGTCATCAATA,32,1168957
fldAp,2.5555555555555554,30,8,TTAATTCCCTTGTCGGGTCA,22,1096704
fldAp,8.88888888888889,87,8,TTAAGGCAGCCGTGATTTAG,79,1081383
fldAp,9.11111111111111,89,8,TGTTAGTTGAAAGCAAGTAT,81,1135485
fldAp,2.7777777777777777,32,8,TGTTAGGCAAATCAGTACTT,24,1092565
fldAp,0.2222222222222222,9,8,TGTGGCGTCTACCACACCAT,1,1097810
fldAp,0.8888888888888888,15,8,TGTCTTCTTTACGTCGCAAT,7,1086469
fldAp,1.8888888888888888,24,8,TGTCCGTACTGCGTCTGGTA,16,1108359
fldAp,0.2222222222222222,9,8,TGTAAGATACCGCGTTGTAC,1,1137553
fldAp,0.2222222222222222,9,8,TGGTCCCACATTACAGTTGT,1,1075436
fldAp,3.3333333333333335,37,8,TGGGACTGACTATTAACAGT,29,1165590
fldAp,0.3333333333333333,10,8,TGGCGCTTTAAGTGATATCC,2,1132875
fldAp,2.2222222222222223,27,8,TGGAGGCCACCTCCTGCAGT,19,1063134
fldAp,5.222222222222222,54,8,TGGACGGTAATATCGTCTCG,46,1143650
fldAp,5.0,52,8,TGGACATAAGTTATTGGGAT,44,1124167
fldAp,0.2222222222222222,9,8,TGGACACGACTGCACCGCCA,1,1089704
fldAp,4.444444444444445,47,8,TGCTTGATGCTGACCGGAAT,39,1082596
fldAp,4.555555555555555,48,8,TGCCTGGGGGCGGACACGAG,40,1116689
fldAp,0.3333333333333333,10,8,TGCCGATAGGATAGTTTGAT,2,1174946
fldAp,3.2222222222222223,36,8,TGAGGTGGGTACATCCACCC,28,1108360
fldAp,8.222222222222221,81,8,TGAGGCCAAAAATGTGGGGT,73,1084619
fldAp,0.2222222222222222,9,8,TGAGGATCGTGAGTTTACAA,1,1170524
fldAp,3.7777777777777777,41,8,TGAGCCTTAACGGAGGTGGG,33,1134830
fldAp,1.8888888888888888,24,8,TGACCCTATGAAATAACTGT,16,1066270
fldAp,1.6666666666666667,22,8,TGACCAGTGGTATGGAATTC,14,1139462
fldAp,1.7777777777777777,23,8,TGACATGGAGGGCCGTCGGG,15,1144154
fldAp,4.222222222222222,45,8,TGAAGCATGTGTCCACTTCT,37,1183455
fldAp,1.0,16,8,TCTTGACCATGTATTTGTAT,8,1128613
fldAp,2.5555555555555554,30,8,TCTTATGGATGCCGTTCATT,22,1139765
fldAp,4.555555555555555,48,8,TCTGGCCTTAAAAGGGGTTA,40,1167710
fldAp,2.5555555555555554,30,8,TCGTCGTATGGGGGAGTAAA,22,1126154
fldAp,1.5555555555555556,21,8,TCGGGATATCATGTTCCTCG,13,1180831
fldAp,7.0,70,8,TCGCTTGCCCCAGCTACGCT,62,1112107
fldAp,2.2222222222222223,27,8,TCGCAAAAGTCAGTACCCGG,19,1094438
fldAp,2.2222222222222223,27,8,TCCTCTAATGGGCCTGGCCA,19,1137593
fldAp,0.2222222222222222,9,8,TCCGCCGGCACAGTAAGCAT,1,1107829
fldAp,1.5555555555555556,21,8,TCCGCCGCATCGACCGTATA,13,1168446
fldAp,3.3333333333333335,37,8,TCCGCCAATTTGCCTTTTAT,29,1128525
fldAp,3.6666666666666665,40,8,TCCCTATTGTCACTAGCACC,32,1114946
fldAp,2.0,25,8,TCCCCGTTCGGTAATTTCGG,17,1119592
fldAp,4.555555555555555,48,8,TCCCCGCTCGGAAATTGCAA,40,1101996
fldAp,2.6666666666666665,31,8,TCCCAGGTTAGGGATGGGGA,23,1180162
fldAp,2.7777777777777777,32,8,TCATTGGTTTCCCAGGCGCC,24,1146883
fldAp,2.5555555555555554,30,8,TCATGCTGTGGAAAGACACG,22,1160646
fldAp,0.2222222222222222,9,8,TCATCATCTCTACTGCGCAA,1,1073575
fldAp,2.7777777777777777,32,8,TCATAATGCGCTTCCAGACG,24,1100694
fldAp,3.6666666666666665,40,8,TCAGTCTCCTGGTCAGTGAG,32,1080076
fldAp,1.2222222222222223,18,8,TCAGTAGAAGTAATAGCATC,10,1108423
fldAp,0.2222222222222222,9,8,TCAGCTTGTCCCGACTCATT,1,1138078
fldAp,2.888888888888889,33,8,TCACCTGGTAGTGACGGTAG,25,1149527
fldAp,1.4444444444444444,20,8,TCACAAGAAGCTCTTGGTAA,12,1107434
fldAp,2.7777777777777777,32,8,TCAAGATGGAGAACAGCCAT,24,1087935
fldAp,0.8888888888888888,15,8,TCAAAGCACCTCGTTCTAGA,7,1181866
fldAp,0.2222222222222222,9,8,TATTCTACGCCTAGGGCCTT,1,1078536
fldAp,2.111111111111111,26,8,TATTACCAAGCTTTGTACGT,18,1077614
fldAp,0.2222222222222222,9,8,TATGTCATACACTTCAGCGT,1,1121299
fldAp,3.0,34,8,TATGCCCGTGGGAAACGCTG,26,1173243
fldAp,2.111111111111111,26,8,TATATTTTCACGTTGTTTGT,18,1158778
fldAp,5.888888888888889,60,8,TATATATTAGTTTAGGCCTA,52,1132225
fldAp,0.2222222222222222,9,8,TAGGGTGTGCAACTTGTGCA,1,1089841
fldAp,1.8888888888888888,24,8,TAGGACAAAAAAAGAGTTCT,16,1145751
fldAp,0.6666666666666666,13,8,TAGCTCAAAATGCAGATGTA,5,1076992
fldAp,5.444444444444445,56,8,TAGCGGACTTGCGAGGAACA,48,1135490
fldAp,4.444444444444445,47,8,TAGCATGATACGTTGCTTTA,39,1165586
fldAp,2.888888888888889,33,8,TACTTAATAATCTCGAAGCA,25,1097323
fldAp,0.7777777777777778,14,8,TACTGCTGCATAACACGGTG,6,1084300
fldAp,2.7777777777777777,32,8,TACCGGCTGGTGCGCATTCC,24,1146684
fldAp,2.3333333333333335,28,8,TACATGAGTGAACGAAACTT,20,1117156
fldAp,3.5555555555555554,39,8,TACAGCTAGTTTTCTCCCTG,31,1153740
fldAp,6.888888888888889,69,8,TAATCAGGAGTCAAGAAGTT,61,1076740
fldAp,4.222222222222222,45,8,TAATACGGAATGCGTACTCC,37,1116263
fldAp,4.777777777777778,50,8,TAAGGTCTATCTCTCTTTGG,42,1178713
fldAp,7.444444444444445,74,8,TAAAGGGAGGGTGTAGGGGT,66,1116552
fldAp,3.3333333333333335,37,8,GTTTTTAAGTTCACGCCGGA,29,1136414
fldAp,1.2222222222222223,18,8,GTTTGCTCCCGTCACGGGTC,10,1076543
fldAp,2.7777777777777777,32,8,GTTTCGTCGTATGCTATGTT,24,1109927
fldAp,9.444444444444445,92,8,GTTGTCTGTTTTGCAGCTAG,84,1074105
fldAp,6.111111111111111,62,8,GTTGTACGGGTACCGGGATT,54,1130908
fldAp,25.666666666666668,238,8,GTTATGCCAGCGTCACGAAT,230,1151172
fldAp,1.4444444444444444,20,8,GTTACACTGCGAAAGTGAAG,12,1104918
fldAp,5.111111111111111,53,8,GTGTTACGCGAATATACCAA,45,1074499
fldAp,0.2222222222222222,9,8,GTGTCATATTTCGGTTAACA,1,1157974
fldAp,7.222222222222222,72,8,GTGCAGTAGGGACAGGTGTG,64,1160489
fldAp,1.3333333333333333,19,8,GTGAGGGCGCTAATTATTTT,11,1128059
fldAp,6.222222222222222,63,8,GTCTTTAAAGACGTTTGCTT,55,1149107
fldAp,3.7777777777777777,41,8,GTCTTGCCGGCGGCAATTAT,33,1181669
fldAp,3.0,34,8,GTCTCACTGGACGATCGTGA,26,1161554
fldAp,2.0,25,8,GTCTATCCACGAAGAAATTG,17,1075367
fldAp,2.7777777777777777,32,8,GTCTAAACGGCCTTCTTACG,24,1181507
fldAp,4.111111111111111,44,8,GTCGTTCCCAACGAACCGAA,36,1124384
fldAp,9.88888888888889,96,8,GTCGTTATTGTGCCATGCAA,88,1095019
fldAp,3.3333333333333335,37,8,GTCGCTTCGATACAGCCTTA,29,1102324
fldAp,5.777777777777778,59,8,GTCGAAGGCCATAATGCTAT,51,1157648
fldAp,11.0,106,8,GTCCGAAGCATAACTAGAGG,98,1158771
fldAp,2.4444444444444446,29,8,GTCAGGCCGTGTCGCCGCTG,21,1111574
fldAp,8.555555555555555,84,8,GTATGGCGCGGAGCCAGAAT,76,1129636
fldAp,0.4444444444444444,11,8,GTATGGCCTGCGGGTAAGCA,3,1179131
fldAp,7.555555555555555,75,8,GTATGCAATAGCCAAGAAGC,67,1135849
fldAp,2.4444444444444446,29,8,GTATCTATCGTGGCGTGATC,21,1093885
fldAp,2.6666666666666665,31,8,GTAGTGAACGTGAGCGTCCG,23,1138325
fldAp,1.6666666666666667,22,8,GTAGTCTTCCCGCTCACTTA,14,1181587
fldAp,3.4444444444444446,38,8,GTACGTGCGAAGCCCTACAG,30,1132580
fldAp,0.2222222222222222,9,8,GTACATTTTCGTGAGCGTAA,1,1064367
fldAp,6.111111111111111,62,8,GTAAGGACGCCGCATAATTA,54,1109392
fldAp,1.5555555555555556,21,8,GGTTCTCTTTAATTGACATT,13,1153924
fldAp,0.8888888888888888,15,8,GGTTATCCGTCCACAGGATA,7,1135669
fldAp,1.4444444444444444,20,8,GGTGGGTGAACTAATGTCTG,12,1140909
fldAp,3.7777777777777777,41,8,GGTGAACAACTAGCGCGGGG,33,1064200
fldAp,0.7777777777777778,14,8,GGTCCTTGGCAGTGTGGTTA,6,1144095
fldAp,6.555555555555555,66,8,GGTCATGACAGGTCTGTTTC,58,1156434
fldAp,3.5555555555555554,39,8,GGTAGCAGCAACTTGATCGC,31,1074884
fldAp,0.2222222222222222,9,8,GGTACAATGCAACTAGTATT,1,1176638
fldAp,0.2222222222222222,9,8,GGGTTACGGGCAAGACGCAA,1,1094599
fldAp,2.3333333333333335,28,8,GGGGGTACGAATATGCCGCT,20,1159433
fldAp,0.7777777777777778,14,8,GGGGCTCTGCGGGGCTTTCA,6,1127795
fldAp,0.2222222222222222,9,8,GGGCTATGGTACACGTTCTG,1,1087667
fldAp,2.4444444444444446,29,8,GGGCCTTGCGTTACTTGGGG,21,1093230
fldAp,12.0,115,8,GGGAAAGACACTTGCACTGT,107,1185826
fldAp,2.4444444444444446,29,8,GGGAAAAGAAGGTCATGGCC,21,1119388
fldAp,3.111111111111111,35,8,GGCTTGGGACTATATAGAAT,27,1179655
fldAp,1.5555555555555556,21,8,GGCTGCGAATCAATGAGGCA,13,1135012
fldAp,0.2222222222222222,9,8,GGCTCTCCAAATCTTCTGGA,1,1110916
fldAp,9.0,88,8,GGCTCGGCCGAATGTCTTCC,80,1074610
fldAp,1.4444444444444444,20,8,GGCGTCTCATTTCCGCTCCT,12,1140395
fldAp,0.2222222222222222,9,8,GGCGGGGGCGGGAAGATAAG,1,1134252
fldAp,2.2222222222222223,27,8,GGCGCGTGACGCGCCGAGCT,19,1111402
fldAp,5.0,52,8,GGCGACCTCGGTGTGGCGGG,44,1083798
fldAp,3.6666666666666665,40,8,GGCGACAGCACCGAAGGGGC,32,1084596
fldAp,4.888888888888889,51,8,GGCCGGAACGGCCCAATACT,43,1111555
fldAp,3.5555555555555554,39,8,GGCAGTCGGCGGTCCCATAT,31,1127480
fldAp,31.22222222222222,288,8,GGATTTTATCTAGATGGTCA,280,1064807
fldAp,7.444444444444445,74,8,GGATGTAGGAATTGTTGTGG,66,1091695
fldAp,3.2222222222222223,36,8,GGATCATTTTCTCCCCTTAA,28,1115826
fldAp,4.0,43,8,GGATACTGATGGAAGTGAGG,35,1112362
fldAp,4.0,43,8,GGAATGTAAGAATTGCATCC,35,1152633
fldAp,3.111111111111111,35,8,GCTTTCGTGTGTTAAGGACG,27,1155858
fldAp,0.3333333333333333,10,8,GCTTGTTGAAAGAAATTTTA,2,1166151
fldAp,2.4444444444444446,29,8,GCTTAAGCTCCCTCTGGTGT,21,1082885
fldAp,2.3333333333333335,28,8,GCTTAAACCGCTTTCGATAT,20,1105553
fldAp,0.4444444444444444,11,8,GCTGGCGTAATGCTTTCCTA,3,1144492
fldAp,1.1111111111111112,17,8,GCTGCCACTGACAGCAAAAC,9,1099140
fldAp,13.444444444444445,128,8,GCTCTTATCCGCTACGTAAG,120,1146586
fldAp,2.6666666666666665,31,8,GCTCATTTATTGTGCCTCGT,23,1119909
fldAp,1.3333333333333333,19,8,GCTATGCACTCCAAGGAACC,11,1160673
fldAp,1.8888888888888888,24,8,GCGTGTCGAGTGCAAAAGAG,16,1121456
fldAp,3.0,34,8,GCGTGGCCTAGCAGAGACAA,26,1081293
fldAp,2.2222222222222223,27,8,GCGTATCCGTAGGCTTTGAA,19,1066796
fldAp,0.2222222222222222,9,8,GCGGAAGTTTTTACTTAGGA,1,1105067
fldAp,2.888888888888889,33,8,GCGCTGGTAAATTAGGTATC,25,1103165
fldAp,2.0,25,8,GCGCTATCCAACAGCGCCCT,17,1123298
fldAp,5.555555555555555,57,8,GCGCGGCTCAGAACACCACA,49,1166669
fldAp,1.4444444444444444,20,8,GCGCGCTACCGTGATCCAGT,12,1067543
fldAp,2.5555555555555554,30,8,GCGCGACATTCGGAATCTTA,22,1146231
fldAp,1.3333333333333333,19,8,GCGCACACGCCATGAAGCAT,11,1122147
fldAp,0.2222222222222222,9,8,GCGACAAGTAAGGGCAGGAG,1,1082954
fldAp,1.1111111111111112,17,8,GCCTCGGTAAGATCCCGTTT,9,1090548
fldAp,8.11111111111111,80,8,GCCGGGTAGGTGACTCTAAA,72,1085768
fldAp,5.888888888888889,60,8,GCCCGCGATGTCTACCCCTT,52,1132498
fldAp,1.8888888888888888,24,8,GCCCAGGTCAGTTCGTCACC,16,1137035
fldAp,4.666666666666667,49,8,GCCCAACCCGACGGGGCAGA,41,1131917
fldAp,0.2222222222222222,9,8,GCCATTGCCGCTTCTTAAGG,1,1090844
fldAp,3.5555555555555554,39,8,GCATCAGAGTGAGAGTGGAT,31,1149598
fldAp,7.0,70,8,GCATAAGCTACGAAATGCTC,62,1095295
fldAp,0.2222222222222222,9,8,GCACTTCGGTTGTTCTGGGG,1,1114631
fldAp,1.8888888888888888,24,8,GCAAGTGGTGGGCCGCGGCT,16,1138420
fldAp,0.5555555555555556,12,8,GCAAGGCGTCAGGAGGGGGC,4,1150689
fldAp,3.2222222222222223,36,8,GATTTGGGTTAGGGATGCTA,28,1181200
fldAp,1.8888888888888888,24,8,GATTTGCCGTGTGGAGCCAC,16,1141820
fldAp,2.111111111111111,26,8,GATGCGGACCGTTACGTTCT,18,1110428
fldAp,4.777777777777778,50,8,GATCTGTTTCTAGCCGAATT,42,1167335
fldAp,5.333333333333333,55,8,GATCCCAACGCACGGAGCCT,47,1077888
fldAp,2.6666666666666665,31,8,GATAATGATGCTCTTCACTC,23,1125801
fldAp,0.6666666666666666,13,8,GAGTTAAGAGACGGCGAGGC,5,1120645
fldAp,3.4444444444444446,38,8,GAGTGACCGTTGGGTTCCCC,30,1156362
fldAp,9.333333333333334,91,8,GAGTCCCTCGGGGATATTAC,83,1105924
fldAp,2.3333333333333335,28,8,GAGGTTCTCAGGGTTGGCTA,20,1128032
fldAp,2.2222222222222223,27,8,GAGCACCGTTTGGAGCAGTG,19,1087883
fldAp,3.5555555555555554,39,8,GACTTCCGAGCTATTATTGG,31,1168229
fldAp,2.111111111111111,26,8,GACTGAGTTCTTGGGTCAGC,18,1160483
fldAp,2.7777777777777777,32,8,GACGGAATGTGTCTTGTAAT,24,1169730
fldAp,6.0,61,8,GACGGAAGCAAGAAACGGAG,53,1112193
fldAp,3.5555555555555554,39,8,GACGATACTCTGTAATGACT,31,1124047
fldAp,2.5555555555555554,30,8,GACGAGGCGATCCTGTGCTT,22,1072812
fldAp,2.0,25,8,GACCGCTACAATTGGTCTTG,17,1079564
fldAp,1.3333333333333333,19,8,GACAGCGCGCAGATCGGCTA,11,1171626
fldAp,2.3333333333333335,28,8,GACAATAGCTCGCAATAGGT,20,1085685
fldAp,3.0,34,8,GAATGTGCGAGCCCATAGCA,26,1069332
fldAp,13.11111111111111,125,8,GAATCGAAGAGCACTACGAA,117,1186625
fldAp,2.7777777777777777,32,8,GAAGGGGCAAACTGACAAAG,24,1086144
fldAp,4.222222222222222,45,8,GAAAGACGGTCGTTGACCCT,37,1138058
fldAp,3.5555555555555554,39,8,CTTTTTTTATAGCCTACGCA,31,1085252
fldAp,1.5555555555555556,21,8,CTTTCTTGTTTAATGGTGTC,13,1178179
fldAp,1.5555555555555556,21,8,CTTGTTCAGGGGATTGAAAA,13,1146504
fldAp,1.5555555555555556,21,8,CTTGTCCATAAAGTGAACCG,13,1145287
fldAp,1.8888888888888888,24,8,CTTGCCAGACAAGGGTGATA,16,1116799
fldAp,0.2222222222222222,9,8,CTTCTCGTCAATCGGGTCCT,1,1182949
fldAp,5.444444444444445,56,8,CTTCCAGATGCTATGTCTGT,48,1114228
fldAp,4.777777777777778,50,8,CTTCCAACTACGAAAAACTA,42,1163797
fldAp,8.11111111111111,80,8,CTTCAACCGCACCAACGTTT,72,1063695
fldAp,1.0,16,8,CTTAAGACATCCGCACAAAC,8,1181576
fldAp,4.0,43,8,CTGTGTAGATAGGTAGTATG,35,1084755
fldAp,7.333333333333333,73,8,CTGTGGGGTATCTGTAGGAT,65,1100839
fldAp,2.111111111111111,26,8,CTGTAAGGATTCATCCCGTA,18,1167392
fldAp,1.8888888888888888,24,8,CTGGTCCCTGCCCCTCTGCC,16,1140308
fldAp,1.8888888888888888,24,8,CTGGGATGCCCCCCGATGTA,16,1171184
fldAp,2.5555555555555554,30,8,CTGCATCGCCCCTCGCCGAG,22,1165499
fldAp,3.4444444444444446,38,8,CTGCAAGCAAGAGGGGACTT,30,1158941
fldAp,0.2222222222222222,9,8,CTCTAGTTCGTAGTCAGAAA,1,1121154
fldAp,3.0,34,8,CTCGGGGGGCTCACTCTGAT,26,1174145
fldAp,2.4444444444444446,29,8,CTCGCAACTTCATGTTTCTC,21,1154548
fldAp,6.333333333333333,64,8,CTCGATAACTCTACCTCGTG,56,1135667
fldAp,13.777777777777779,131,8,CTCCGTCTTCCGATGGGCAG,123,1135660
fldAp,4.888888888888889,51,8,CTCACCACAAACGCCCCCGT,43,1106659
fldAp,4.222222222222222,45,8,CTCAATTCAGTCTTTGTGTT,37,1161209
fldAp,2.6666666666666665,31,8,CTATTCGGGATTACCAACTA,23,1157845
fldAp,3.3333333333333335,37,8,CTATAGAGGGAGTCCTGCAG,29,1095885
fldAp,5.444444444444445,56,8,CTAGACAAAGCCCATACTTG,48,1105271
fldAp,0.3333333333333333,10,8,CTACCTTTTTCACTGATAAC,2,1083999
fldAp,5.0,52,8,CTAATGTGCCTTACGTAACA,44,1180016
fldAp,14.0,133,8,CTAATATTTATTGCCACCCT,125,1148836
fldAp,14.11111111111111,134,8,CTAAGTTGCGAGTTGTGCTC,126,1103954
fldAp,3.111111111111111,35,8,CTAAAGTCTATCATGCTCTG,27,1162920
fldAp,1.7777777777777777,23,8,CTAAAACCGCCCGATCGGTG,15,1094513
fldAp,0.5555555555555556,12,8,CGTTGGCTGATTCTTACCCT,4,1152622
fldAp,3.4444444444444446,38,8,CGTTAAAGTCCATCTCAAAT,30,1153895
fldAp,25.22222222222222,234,8,CGTGTAAAATTCAACGCCTG,226,1093284
fldAp,4.666666666666667,49,8,CGTGGGAGGTGTGAAGTATC,41,1105895
fldAp,0.3333333333333333,10,8,CGTGACGTCAGGCGGACTGG,2,1111847
fldAp,0.2222222222222222,9,8,CGTGACGGAGCGGCTACCTC,1,1065703
fldAp,3.888888888888889,42,8,CGTAGCTGCGCTACCCGTAC,34,1117938
fldAp,3.111111111111111,35,8,CGTACTCTTCCACCGCTGGA,27,1066644
fldAp,0.2222222222222222,9,8,CGTAATAGTTCGAAGGGTTG,1,1129515
fldAp,4.333333333333333,46,8,CGGTCAGGCTTTCATGTTGT,38,1102757
fldAp,4.0,43,8,CGGGTGTCATCGGGCATTAA,35,1186387
fldAp,4.333333333333333,46,8,CGGGCGACTGGCATCTGGCT,38,1162671
fldAp,4.111111111111111,44,8,CGGCTTGCGAATCATTTAAA,36,1140400
fldAp,1.1111111111111112,17,8,CGGCCAATATCCGGGTTAAG,9,1096123
fldAp,4.666666666666667,49,8,CGGATATATGGTTTAGAATT,41,1186718
fldAp,3.3333333333333335,37,8,CGGAAGAAATATCCGGGCGG,29,1064571
fldAp,4.111111111111111,44,8,CGCGTCATAATATGTGTGCA,36,1132507
fldAp,2.888888888888889,33,8,CGCCTTTACACTGATTTGGT,25,1107345
fldAp,1.2222222222222223,18,8,CGCCGTACAGGCGAGCGGAC,10,1117029
fldAp,0.2222222222222222,9,8,CGCCATCATCGATGTTTCAT,1,1063130
fldAp,12.333333333333334,118,8,CGCAGGATGTACCCGCGTCG,110,1174603
fldAp,3.111111111111111,35,8,CGATAATCCCTCTCAGCCTA,27,1120597
fldAp,0.2222222222222222,9,8,CGAGGGGCAGAGAGTGGATC,1,1130272
fldAp,6.555555555555555,66,8,CGAGCCTAGCAACTTTTATA,58,1085998
fldAp,1.6666666666666667,22,8,CGACTCACAGTCTTCAAGTT,14,1064132
fldAp,7.777777777777778,77,8,CCTTTTCAGCGACGGTCTGA,69,1143681
fldAp,0.2222222222222222,9,8,CCTTTATTACAGGGGCGATG,1,1170788
fldAp,5.666666666666667,58,8,CCTTGTAGTGGTTAAATTAA,50,1180313
fldAp,7.555555555555555,75,8,CCTTCTCAGCTTTTCAATGG,67,1113949
fldAp,2.888888888888889,33,8,CCTGGCAGGGGATTCAGCGA,25,1097582
fldAp,1.5555555555555556,21,8,CCTGCCGGCATAACATAGCT,13,1137587
fldAp,3.4444444444444446,38,8,CCTGATCAAGAGGTACGACA,30,1087420
fldAp,2.5555555555555554,30,8,CCTACGCGTTCCGTAGTACT,22,1137773
fldAp,7.888888888888889,78,8,CCTACCTTAGAGTGGATCGC,70,1138241
fldAp,0.2222222222222222,9,8,CCGTTAAGTTAGGTGGCTGC,1,1150550
fldAp,0.8888888888888888,15,8,CCGGTGGGCAGACGAGGAGG,7,1130963
fldAp,0.3333333333333333,10,8,CCGGCCCCGCGATAGTACGT,2,1157202
fldAp,4.0,43,8,CCGCAGTGCGTGGACGAGCC,35,1161582
fldAp,4.666666666666667,49,8,CCGATAGCGAATCCTCCAAA,41,1093298
fldAp,1.5555555555555556,21,8,CCGACTCTGGTGACTCCGAT,13,1090178
fldAp,1.8888888888888888,24,8,CCGACTCGCCCGCAGACTGA,16,1133958
fldAp,2.3333333333333335,28,8,CCCTGGGGAAGCACTCTTCG,20,1118057
fldAp,4.444444444444445,47,8,CCCGTTTATGACAAAAGTGG,39,1107566
fldAp,2.4444444444444446,29,8,CCCGGTTAGAGTCCGAGGTG,21,1094457
fldAp,6.0,61,8,CCCCGATCACACTACAAGAG,53,1133649
fldAp,0.6666666666666666,13,8,CCCCAAGTATCGGCCCGATA,5,1133820
fldAp,0.2222222222222222,9,8,CCCATTTTGAATAATTCCGA,1,1146397
fldAp,0.7777777777777778,14,8,CCCAACACGGGACTTCAAAA,6,1133567
fldAp,2.5555555555555554,30,8,CCATCCCCCAATGAATATTC,22,1148256
fldAp,7.0,70,8,CCACCGGCTAAGCCAGATAA,62,1110597
fldAp,0.5555555555555556,12,8,CCACATGCAATGCAGCTAGT,4,1185632
fldAp,6.666666666666667,67,8,CCAATAGCCTATGGGGTCTT,59,1151725
fldAp,0.2222222222222222,9,8,CATTCACCAATGAGCATGGC,1,1072562
fldAp,1.2222222222222223,18,8,CATGTTGTACTTAACTTGCT,10,1104167
fldAp,4.111111111111111,44,8,CATGTTGAGTCACGAGAGCG,36,1163858
fldAp,3.5555555555555554,39,8,CATGTGCGCCAAATACCTAG,31,1161858
fldAp,1.0,16,8,CATGTCATACATCGGCGCGG,8,1134417
fldAp,5.444444444444445,56,8,CATGCTTCTTTACCACTGTA,48,1136686
fldAp,6.222222222222222,63,8,CATGAACTATGAGGAAAGGG,55,1110395
fldAp,1.2222222222222223,18,8,CATCCGATCCGACGGGTAAT,10,1064075
fldAp,0.2222222222222222,9,8,CATAAGCCTTATCTCGGCGC,1,1095007
fldAp,10.444444444444445,101,8,CAGTTCGGCTTGCAACCGAG,93,1085681
fldAp,7.888888888888889,78,8,CAGTGAGAGGTTGTAGAATA,70,1166333
fldAp,8.222222222222221,81,8,CAGTCCCGTGTTCATCCCGT,73,1174388
fldAp,2.6666666666666665,31,8,CAGGTAAAGACGGGGGTAAG,23,1096195
fldAp,3.2222222222222223,36,8,CAGGGCACTGCTAAGCAGTA,28,1184484
fldAp,3.4444444444444446,38,8,CAGGAAGCGCTATCTCCGGT,30,1134209
fldAp,0.2222222222222222,9,8,CAGCCAGGGGACATCTTGTA,1,1091275
fldAp,2.4444444444444446,29,8,CAGATCGCTCCACGTCTGCG,21,1074293
fldAp,2.4444444444444446,29,8,CACTTCCCGGATAGCAGCGC,21,1082601
fldAp,1.5555555555555556,21,8,CACTTACGTAACGACATTTC,13,1118832
fldAp,2.5555555555555554,30,8,CACTGATACCGCTTACGCAT,22,1097274
fldAp,2.2222222222222223,27,8,CACTAATCCCTGTCGAGGAT,19,1114833
fldAp,0.2222222222222222,9,8,CACGCGCGAGCAACTGCCTC,1,1087617
fldAp,2.111111111111111,26,8,CACGATCATGGGGTAAAGTG,18,1144407
fldAp,0.2222222222222222,9,8,CAATTCAAGCTTCCTGCCGC,1,1173886
fldAp,6.666666666666667,67,8,CAAGGGATAGCTGGCGCCGA,59,1082039
fldAp,3.2222222222222223,36,8,CAAGCGTGCCGCCATAGAGG,28,1148653
fldAp,2.0,25,8,CAAGCCTTGAACACGCTAGT,17,1109321
fldAp,5.555555555555555,57,8,CAAGAGCCCGAAAGTTGCAA,49,1085700
fldAp,4.666666666666667,49,8,CAACTCGGACTTTACAGCTG,41,1124657
fldAp,2.7777777777777777,32,8,ATTTTTCGGGAAATCAGAGT,24,1186572
fldAp,2.2222222222222223,27,8,ATTTAGAGTCCTGCGTGCAA,19,1180423
fldAp,3.4444444444444446,38,8,ATTGACGGCGACGACCCTGA,30,1121147
fldAp,1.8888888888888888,24,8,ATTCGACCTTAGCCATCGCA,16,1160134
fldAp,2.3333333333333335,28,8,ATTATCGTTAGAAGGAGGAG,20,1179540
fldAp,12.222222222222221,117,8,ATTACGTAATTAATCATACA,109,1162318
fldAp,2.4444444444444446,29,8,ATGTGTCCATTATTGTCGTC,21,1117265
fldAp,4.777777777777778,50,8,ATGGCAAGTTTTACCAACAT,42,1101110
fldAp,3.3333333333333335,37,8,ATGCGTGATGAGGCCAAGCA,29,1151892
fldAp,5.111111111111111,53,8,ATCGCGTCAAACTGACGGCC,45,1107339
fldAp,3.2222222222222223,36,8,ATCCCAAAAATCCTCATATA,28,1148493
fldAp,8.444444444444445,83,8,ATCCACAGACATACTGGCAG,75,1112338
fldAp,2.111111111111111,26,8,ATATTATAGAGTTGTAGATT,18,1087425
fldAp,4.333333333333333,46,8,ATAGTTCAGCTTTTGTAAGT,38,1149239
fldAp,2.0,25,8,ATACTTGGGACTCCGGCGAA,17,1092493
fldAp,3.888888888888889,42,8,ATACGTAGACGGACTGGCTG,34,1087846
fldAp,8.666666666666666,85,8,ATACCAGAGACTGAAGTTTA,77,1140689
fldAp,2.3333333333333335,28,8,AGTTTTCTACCATACTCTTA,20,1175266
fldAp,19.666666666666668,184,8,AGTTGATGTGAAATGAAAAA,176,1118345
fldAp,9.0,88,8,AGTTCTCCTCAATCACAAAG,80,1111154
fldAp,4.222222222222222,45,8,AGTTATCAAGAAGTACACTT,37,1157075
fldAp,2.4444444444444446,29,8,AGTGTTGCTAAAGGCCTGAC,21,1151760
fldAp,3.6666666666666665,40,8,AGTATTTACTTACGGGTGAG,32,1116000
fldAp,2.5555555555555554,30,8,AGTAACACGAATTGGGGCTA,22,1145579
fldAp,2.0,25,8,AGGCACGGGTTAGGTAGCCC,17,1180447
fldAp,4.0,43,8,AGGATAACCCGCCCAACCCT,35,1105099
fldAp,1.7777777777777777,23,8,AGGAGGACTTTTATCATTGC,15,1098648
fldAp,13.666666666666666,130,8,AGCGGGTGGTGGCGCATTGT,122,1082653
fldAp,2.7777777777777777,32,8,AGCGGGAGAAGGTTTCCAGC,24,1090852
fldAp,0.6666666666666666,13,8,AGCGAAGCTATTTTGGTTAT,5,1124703
fldAp,1.7777777777777777,23,8,AGCCATATAGGACCAATGTA,15,1075601
fldAp,2.4444444444444446,29,8,AGAGGGCCAGTCTGGGGATT,21,1139466
fldAp,5.666666666666667,58,8,AGAGATCTGTGAACGGTAAA,50,1076590
fldAp,1.6666666666666667,22,8,AGAGATCACTCGTGCTCAAA,14,1139692
fldAp,4.222222222222222,45,8,AGAGACGCATCGGCAGACCA,37,1167324
fldAp,1.1111111111111112,17,8,AGACTCGTTACTTATTAGAT,9,1126226
fldAp,9.555555555555555,93,8,AGAATTCCGTAAGGGTAGGA,85,1076799
fldAp,0.2222222222222222,9,8,AGAATGGGGACCATATAGAT,1,1104983
fldAp,0.2222222222222222,9,8,AGAATCTTCGGCTGGGATGA,1,1078010
fldAp,1.7777777777777777,23,8,AGAAAAATTCGGCCAACGCA,15,1081955
fldAp,1.8888888888888888,24,8,ACTTTGGATCTTAGACTGTA,16,1128441
fldAp,2.111111111111111,26,8,ACTTGGACTGACGTAAACGC,18,1103540
fldAp,2.7777777777777777,32,8,ACTTCTCACAACGGCTAAGT,24,1117284
fldAp,0.2222222222222222,9,8,ACTTCCGGGAAGGTCTCACT,1,1169103
fldAp,2.4444444444444446,29,8,ACTTAACTCTCATAGAACCT,21,1179649
fldAp,2.6666666666666665,31,8,ACTGGGCTCGATTGCTAGTT,23,1155426
fldAp,9.444444444444445,92,8,ACTGGACGGATAAGCACTAC,84,1062997
fldAp,0.2222222222222222,9,8,ACTGCGATAGGCGGGAGTGC,1,1113444
fldAp,0.7777777777777778,14,8,ACTCGGTTCCCTTGCATACG,6,1159056
fldAp,0.2222222222222222,9,8,ACTCAATGTACGTTCTAGAT,1,1110332
fldAp,5.0,52,8,ACTATAGTCTGTACTGACTT,44,1156491
fldAp,0.2222222222222222,9,8,ACGTCTTGTGGGCTCTCAAA,1,1168638
fldAp,2.7777777777777777,32,8,ACGGTAGTGATTATGAGAGG,24,1094125
fldAp,2.6666666666666665,31,8,ACGGGTAATGGAAGCTGGGG,23,1183745
fldAp,2.6666666666666665,31,8,ACGGAAAGTTGGTGGTGAGC,23,1162492
fldAp,2.888888888888889,33,8,ACGCCTACGGGAGTCACCCG,25,1070330
fldAp,8.666666666666666,85,8,ACGCACGTTGCAGGGAGTCT,77,1126125
fldAp,0.2222222222222222,9,8,ACGACACACTAGACCAGCGC,1,1102616
fldAp,2.0,25,8,ACGAAGTCATACTCGTTCTG,17,1163018
fldAp,2.6666666666666665,31,8,ACCTCTAAAACCAACTCAGT,23,1072621
fldAp,10.555555555555555,102,8,ACCGTGTTTGGTGTTTCGGT,94,1097311
fldAp,0.2222222222222222,9,8,ACCGTCTTAGTAGCATTCAT,1,1112286
fldAp,1.3333333333333333,19,8,ACCCGGGGAAGATGCTAAAG,11,1125959
fldAp,1.1111111111111112,17,8,ACCAAGTCTCCGGAGGCCTC,9,1155748
fldAp,1.8888888888888888,24,8,ACAGAGGACTTGGTATGGTA,16,1082189
fldAp,2.6666666666666665,31,8,ACACCTTCGAGTTTGTCACG,23,1182238
fldAp,2.6666666666666665,31,8,ACACATAGAAGTCAATACTG,23,1185213
fldAp,2.3333333333333335,28,8,ACACAATGGGAGCGCCGGTG,20,1081763
fldAp,1.3333333333333333,19,8,AATTTAGTGCTGGCTTTAGC,11,1171126
fldAp,3.888888888888889,42,8,AATTCACGGGGTCGAGCTAT,34,1132412
fldAp,9.444444444444445,92,8,AATGTATACTTAGGTCACTG,84,1139607
fldAp,8.88888888888889,87,8,AATGGGTAGTTTGGTCATAG,79,1137397
fldAp,4.222222222222222,45,8,AATGAAGGTTCGGCATTCGT,37,1139683
fldAp,3.2222222222222223,36,8,AAGGCAGTGAGGATGTCAAT,28,1073903
fldAp,1.2222222222222223,18,8,AAGCTGACCCCGCCAACAGT,10,1111985
fldAp,5.111111111111111,53,8,AAGATATCCAACGGTGCTTT,45,1082677
fldAp,1.5555555555555556,21,8,AAGAGATGATGATCGTCTTG,13,1107336
fldAp,2.3333333333333335,28,8,AAGACAGTAGATCGACCATA,20,1124938
fldAp,7.111111111111111,71,8,AACTGAAGTAGTAATGCCCA,63,1080426
fldAp,3.111111111111111,35,8,AACGCCGGAGCAACGTGATC,27,1155463
fldAp,0.2222222222222222,9,8,AACGAGGTAATGGCTGTACG,1,1114419
fldAp,3.2222222222222223,36,8,AACGAAACTATGTGGGAAGT,28,1137408
fldAp,12.88888888888889,123,8,AACCTGTGAACATGGATTTA,115,1116800
fldAp,4.777777777777778,50,8,AACAGGGACACCTGTGCTAA,42,1079099
fldAp,8.444444444444445,83,8,AAATTTTTAAAGGTTCCTTT,75,1107686
fldAp,1.4444444444444444,20,8,AAATACGTGCCGTGATGAAG,12,1086753
fldAp,2.5555555555555554,30,8,AAAGTTCTCTATAAGTCTAT,22,1108952
fldAp,17.77777777777778,167,8,AAAGGCTCCGATGACCGGTA,159,1174594
fldAp,3.2222222222222223,36,8,AAACGCCTCCTTTCGTTGGC,28,1165988
fldAp,4.777777777777778,50,8,AAACCTACTTAAGATATCAT,42,1077352
fldAp,1.6666666666666667,22,8,AAAACTGGCGTGGGTGGGCA,14,1125078
fldAp,0.375,9,7,TTTTTTTTGCCTCGAGCTTT,2,1125290
fldAp,5.0,46,7,TTTTCACAATGATCTGACAT,39,1067324
fldAp,0.75,12,7,TTTTAATGAGCCCATTTTGG,5,1166278
fldAp,9.625,83,7,TTTGGTCACTAACGGTTGGG,76,1062986
fldAp,0.25,8,7,TTTGCCGAGAATATCTGGGA,1,1095378
fldAp,4.875,45,7,TTTCCCCGGTATACAACTCT,38,1102602
fldAp,2.75,28,7,TTGTGGTTCCTAGTACTTCT,21,1119298
fldAp,1.5,18,7,TTGTGCGGCCCGCATTTTGT,11,1118229
fldAp,0.25,8,7,TTGGTCACGAACAAAAGCGT,1,1183485
fldAp,3.875,37,7,TTGGATTTTCAAAGCTTACC,30,1177956
fldAp,15.0,126,7,TTGCTGCCAGTCGGAACGTA,119,1129908
fldAp,4.625,43,7,TTGACGGTCTTGGTGAAACC,36,1107335
fldAp,0.25,8,7,TTGAACCATCTCGTGACACC,1,1102162
fldAp,1.375,17,7,TTCGTAAGCCGGCAGTTGTA,10,1166204
fldAp,3.5,34,7,TTCGGACGGGAGTTTATGCT,27,1169206
fldAp,3.875,37,7,TTCCTGAGGGAATCAATGTG,30,1179227
fldAp,1.5,18,7,TTCCCGTCTTCGCTCGATAC,11,1163660
fldAp,8.875,77,7,TTCCCATGCTGATATACCCA,70,1140919
fldAp,2.875,29,7,TTCCAGCAAGCGGGACTAAG,22,1128183
fldAp,5.25,48,7,TTCAGTCTAACCGGTTATTC,41,1102873
fldAp,1.0,14,7,TTCAATCTCGGGGCTCTGGG,7,1111125
fldAp,5.125,47,7,TTATGTTGCGTCCTGGCCAT,40,1102500
fldAp,0.25,8,7,TTATGTGGCTCCGAAAGGTA,1,1107997
fldAp,7.625,67,7,TTATGGAGATCATACGAGCT,60,1134525
fldAp,2.75,28,7,TTATCATTGTCACGAATTCG,21,1120085
fldAp,4.125,39,7,TTAGTAATCGGCGACTCGCT,32,1140906
fldAp,8.0,70,7,TTAGACTGCCGGGTTCTGGC,63,1066331
fldAp,4.0,38,7,TTACCGGTCATGTAGGAATG,31,1169853
fldAp,1.25,16,7,TTACATACCGTCTAATGGCA,9,1180334
fldAp,0.25,8,7,TGTTTATCCTCAACCTTCTT,1,1083406
fldAp,0.25,8,7,TGTTCACGTAAGGAGACCGC,1,1158833
fldAp,0.875,13,7,TGTGTGTCGGTGTCATGGCG,6,1181577
fldAp,2.875,29,7,TGTGTGGAGGGGGTACGAGG,22,1083213
fldAp,1.875,21,7,TGTGGCTACCTCCACTGTAA,14,1114141
fldAp,1.25,16,7,TGTGGAGGTTACTGCCTATT,9,1167463
fldAp,1.75,20,7,TGTCTCGAAGTACCTACCGG,13,1157951
fldAp,0.25,8,7,TGTCGTAGGGGCGCGCGTAA,1,1087992
fldAp,3.75,36,7,TGTACTCTATTTTCGGTCTG,29,1164690
fldAp,3.0,30,7,TGGTTGGTGCAAAGATATGT,23,1101220
fldAp,0.25,8,7,TGGTGGAAGTTTGGGGAGAT,1,1071972
fldAp,0.75,12,7,TGGTCGAACTATGTACTCAT,5,1167194
fldAp,0.25,8,7,TGGTCAGCTAGGTCAAGATC,1,1103250
fldAp,4.25,40,7,TGGGTAATCCGGAAACTGAC,33,1099564
fldAp,3.125,31,7,TGGCACGTAATTCCAGGCCA,24,1181698
fldAp,3.875,37,7,TGCGGTGAGGATCACGGATA,30,1113744
fldAp,10.875,93,7,TGCGGATTGTTCGTTGCTTC,86,1077536
fldAp,20.125,167,7,TGCCGATTATTGGACTTTCT,160,1129734
fldAp,0.375,9,7,TGCAGTATTGCATGACCAAT,2,1160410
fldAp,0.25,8,7,TGCACCTCTTGCGGGTAATG,1,1075070
fldAp,2.125,23,7,TGACTAAAGCCCGACAGGCA,16,1123456
fldAp,5.75,52,7,TGACGTATCGGTGGCTACGA,45,1097509
fldAp,2.375,25,7,TCTTTCATCCCCCCACTTCA,18,1069430
fldAp,1.875,21,7,TCTGTTCGTAATCGTCATAC,14,1116549
fldAp,5.75,52,7,TCTGCCATAGGACTCCTGCG,45,1163151
fldAp,3.0,30,7,TCTCTGTGGTCTACAGAGAG,23,1171344
fldAp,3.0,30,7,TCTCTCTAACGGATCTAAAT,23,1078246
fldAp,5.875,53,7,TCTATGCGTTAACCCGTTGG,46,1066790
fldAp,0.625,11,7,TCTAAAATGACAGAAGGACG,4,1111849
fldAp,4.375,41,7,TCGTTGCCTGCACGGGTGGT,34,1110316
fldAp,2.25,24,7,TCGGCAGGGGGAGAACAGAC,17,1102900
fldAp,13.125,111,7,TCGGAAAGATGCTGCCCCGC,104,1178639
fldAp,2.0,22,7,TCGATGGGAGATAGAAACAA,15,1072092
fldAp,12.125,103,7,TCGAATTGTGGCAGGAATAG,96,1186659
fldAp,4.75,44,7,TCCTTACGATCGCGCGTTAC,37,1144351
fldAp,2.625,27,7,TCCGACAGGGTGAATATCAA,20,1068576
fldAp,4.375,41,7,TCCCCGACCGGTAACATCAC,34,1072554
fldAp,2.375,25,7,TCCAGGGTTTGCGAAGCACA,18,1063604
fldAp,4.125,39,7,TCCAACGATGGTAGGTATTA,32,1136850
fldAp,2.625,27,7,TCATTTCGACGCGTATTTTA,20,1138443
fldAp,23.25,192,7,TCATTAGTCAGTTTGCATTA,185,1135663
fldAp,2.875,29,7,TCATGGCCACGTCCAATTAA,22,1085806
fldAp,5.0,46,7,TCATCCAGATCCTTTAATGA,39,1109755
fldAp,2.625,27,7,TCATAGGGCATTAGGCTGGT,20,1154680
fldAp,7.0,62,7,TCACGTGAGAGTCTGCCCTA,55,1155727
fldAp,1.875,21,7,TCACGCATGCGCTGCATGGG,14,1103956
fldAp,17.875,149,7,TCACCGAGATGGTGCATCGC,142,1063670
fldAp,5.125,47,7,TCACCATTCCGTAACATGTT,40,1177942
fldAp,0.25,8,7,TCAATGCCTGACGGGAGCGA,1,1082667
fldAp,0.25,8,7,TCAACGAAACTAGCGAAGCA,1,1088078
fldAp,5.125,47,7,TATTATTGAAGACTCGGCAA,40,1131270
fldAp,3.625,35,7,TATAGTTCTTTCATACGTTA,28,1069843
fldAp,4.25,40,7,TATAGTAGCTTAGCCCGCAG,33,1180535
fldAp,1.5,18,7,TATAATATATATCGCTTTAC,11,1140676
fldAp,7.25,64,7,TAGGGTCTGCTTTCCACTGT,57,1087841
fldAp,7.25,64,7,TAGGAAGCATAAAACACGAA,57,1156950
fldAp,0.25,8,7,TAGCTCCTTCTAGTCAGTGT,1,1171226
fldAp,6.875,61,7,TAGCCCCGCAGTTTCGCCGG,54,1152136
fldAp,3.0,30,7,TAGAAGGCGTGGACCTCTAG,23,1095705
fldAp,3.625,35,7,TACTTCTCTAACGTCTCCCA,28,1131859
fldAp,0.875,13,7,TACTCGTGAAACCCTGGGAA,6,1077111
fldAp,1.75,20,7,TACTCAAAAAAATGATTTCT,13,1109585
fldAp,5.625,51,7,TACGGTTGGGGGCTAGTCTA,44,1147134
fldAp,2.875,29,7,TACCGGGGGTCTAAACGTCA,22,1079844
fldAp,2.875,29,7,TACCCATAAAATGCAAGATA,22,1077784
fldAp,7.625,67,7,TACATCCGCGACCTCGGAGA,60,1140206
fldAp,5.25,48,7,TAATGCGATGGATACACACG,41,1145242
fldAp,5.5,50,7,TAATATTGTGGGCATGTTGG,43,1131080
fldAp,3.25,32,7,TAAGTAGAGGAGCGTCGCGT,25,1078146
fldAp,0.25,8,7,TAACGGATCCGAAGGCGCCT,1,1159547
fldAp,21.0,174,7,TAACGACGAGCTTAACGAAC,167,1084477
fldAp,7.125,63,7,GTTTTCTGAGGCAATCCGCG,56,1091839
fldAp,7.375,65,7,GTTTGTCCCCTTATACACAA,58,1110157
fldAp,1.375,17,7,GTTGGATAGAAGCTACTGAC,10,1073003
fldAp,1.75,20,7,GTTCTTGGAAGGTCTCATGC,13,1083365
fldAp,3.5,34,7,GTTCCGCGGCCGGAGGTAGA,27,1166882
fldAp,0.5,10,7,GTTATGAGAAATCGAAGGCT,3,1064539
fldAp,0.25,8,7,GTTAAGCCGCTCTAGGCACG,1,1171850
fldAp,6.125,55,7,GTTAACTATAGTGTCCTAGA,48,1165391
fldAp,0.375,9,7,GTGTGTGCGGGTATTAATGC,2,1152847
fldAp,3.875,37,7,GTGTGCAGGATACCTCAGGC,30,1144991
fldAp,5.125,47,7,GTGGTAGGGAACCGTAAAAC,40,1147704
fldAp,5.25,48,7,GTGGCCCTGTTTGCCTGCAG,41,1122738
fldAp,3.0,30,7,GTCTTATACGGCAATGAGTC,23,1102409
fldAp,2.25,24,7,GTCTTAGATACTTGGTCATC,17,1102084
fldAp,1.0,14,7,GTCTCTCCATCGTCGCCGTA,7,1086616
fldAp,1.0,14,7,GTCTAAACAGGAGTCATCAC,7,1066827
fldAp,3.5,34,7,GTCGAGGCGCCGGTAGTGGT,27,1077475
fldAp,2.5,26,7,GTCCCGGGGTTTCTATACGG,19,1093000
fldAp,3.75,36,7,GTCCCAAGGTAGTAAGCACT,29,1152450
fldAp,0.375,9,7,GTCAGGATTGTAGGACCGCA,2,1160216
fldAp,3.125,31,7,GTCACTTCCTCTCGGCCTAG,24,1104252
fldAp,3.0,30,7,GTCACGCGCAAAGCTGTATA,23,1076743
fldAp,3.25,32,7,GTCACGACAGTGGGTGGGGT,25,1132622
fldAp,6.5,58,7,GTCACACAACTCGGGTGTTA,51,1110469
fldAp,2.0,22,7,GTATGCGACGAATGCACACT,15,1117376
fldAp,3.125,31,7,GTATATGGGTTCCTACAGCA,24,1175682
fldAp,5.125,47,7,GTATAAGACCATGACGTGAA,40,1135854
fldAp,3.0,30,7,GTAGTTATTTAGGGATGTCT,23,1173098
fldAp,2.875,29,7,GTAGGGTGTTAGAATCACCA,22,1079540
fldAp,0.25,8,7,GTACGGTAACTACAGGATTA,1,1145816
fldAp,2.25,24,7,GTACACCTAGCCGGATCGAA,17,1115003
fldAp,3.125,31,7,GGTCGTCATTTACGTTGAGG,24,1154611
fldAp,0.625,11,7,GGTCGGCGTGCTGCGCAACC,4,1179801
fldAp,2.0,22,7,GGTCAGGTCCTCGGGATAAA,15,1152363
fldAp,4.875,45,7,GGTCAGAATCTCCCATAAAG,38,1153972
fldAp,4.625,43,7,GGTAGTAGAACTAAAAACAT,36,1123775
fldAp,0.375,9,7,GGTACCCAATGTGTTGGAGC,2,1094517
fldAp,1.625,19,7,GGGTGAGAGCTACTTAATCA,12,1083433
fldAp,9.0,78,7,GGGTCTACGGGCGGGTATCC,71,1092770
fldAp,0.25,8,7,GGGGGGCAACTAATCCTGCA,1,1125327
fldAp,7.375,65,7,GGGGACAGGATCCTTATCGG,58,1135162
fldAp,5.75,52,7,GGGCTCGTTTGACAGTTAGT,45,1107038
fldAp,9.25,80,7,GGGCCTAGACTTTTTATGCA,73,1166662
fldAp,1.375,17,7,GGGCAGTGTACCACTGCTTT,10,1149791
fldAp,0.875,13,7,GGCTTGAGATGTCAATAAAT,6,1157716
fldAp,0.25,8,7,GGCGGCGATCCAGAGCCGAG,1,1097709
fldAp,1.625,19,7,GGCGGACCTGCAAAACCTGG,12,1131515
fldAp,0.25,8,7,GGCGATAGTGCAGGTCATTT,1,1160113
fldAp,0.25,8,7,GGCCCGAAGACCTGGAAACG,1,1159799
fldAp,0.25,8,7,GGATTAGTCCGAATGGTCCT,1,1081565
fldAp,2.5,26,7,GGATCCTTATCCAAATGCAA,19,1157071
fldAp,9.125,79,7,GGATCACCGTTCCGGCGCTT,72,1159208
fldAp,2.625,27,7,GGAGCGTATCCTGATAACGG,20,1172401
fldAp,7.25,64,7,GGAGCCACATCCGTGGCCCT,57,1064300
fldAp,0.25,8,7,GGAGAGATGTCTCCTACGCG,1,1088595
fldAp,2.5,26,7,GGACGAGTTCTTGCGACTGT,19,1118066
fldAp,2.125,23,7,GGAAGGTTTACCTGTATGGG,16,1139190
fldAp,4.25,40,7,GGAAAAACCGTCATTCGCTA,33,1067956
fldAp,13.625,115,7,GCTGGCAGCGAGCTTTTGTT,108,1082574
fldAp,0.25,8,7,GCTGAGATAAGGGCGGATCT,1,1125088
fldAp,5.0,46,7,GCTCAGGCAAGTACTCCTCG,39,1126120
fldAp,5.375,49,7,GCTAGACTTTTATAGATGAA,42,1106217
fldAp,2.75,28,7,GCGTTTCCGTAAGAGTGCAT,21,1139513
fldAp,0.75,12,7,GCGTCAAAGATTGTACAAAT,5,1084774
fldAp,5.0,46,7,GCGGGTGGTCGTCTGAATGT,39,1099072
fldAp,1.5,18,7,GCGGGTCGGGCATCCTCCAT,11,1114044
fldAp,0.25,8,7,GCGGCTCTTCGTCCGATCCC,1,1090341
fldAp,5.25,48,7,GCGGCCATTCCCTCGACTAC,41,1087994
fldAp,3.625,35,7,GCGCGTGTAACCGAGTGATA,28,1170689
fldAp,0.375,9,7,GCGCGTAACCGTTGAGCGGA,2,1091916
fldAp,4.75,44,7,GCGCGGGTGCGCCCGGGACT,37,1161576
fldAp,24.375,201,7,GCGAGGAGCCAGTGAGATTC,194,1135834
fldAp,1.75,20,7,GCGAGAGCCAGCATTCTGAT,13,1097062
fldAp,1.625,19,7,GCGACCGGATGTCATCGTAC,12,1175853
fldAp,0.25,8,7,GCCGTTATCGCGGGTAACGG,1,1173270
fldAp,5.25,48,7,GCCGAAGTATCAGTAATGGT,41,1147200
fldAp,3.125,31,7,GCCCCAATCTAGCCGACAGT,24,1146297
fldAp,0.25,8,7,GCCAGATGACTTTATACTTG,1,1069102
fldAp,1.125,15,7,GCATTGACGTTCCATCAGCA,8,1094240
fldAp,3.25,32,7,GCATTCGCTCAACCTCTAAG,25,1076909
fldAp,3.375,33,7,GCATGTGGAGTTTCTTGGTC,26,1135354
fldAp,4.625,43,7,GCATACGCCGGAGAGGACGT,36,1107567
fldAp,5.625,51,7,GCAGCTACTATTGTGTTACG,44,1121705
fldAp,7.0,62,7,GCAGACTTATGTAAATTCCT,55,1154501
fldAp,0.875,13,7,GCAAACAGTTGCCTGACCAT,6,1175487
fldAp,0.25,8,7,GATTCCTCCGTAACTACAAA,1,1121728
fldAp,3.25,32,7,GATGTAACGGCGAGCGGAAT,25,1111831
fldAp,8.875,77,7,GATGCGGTCCAAAGCAGTAG,70,1105478
fldAp,3.625,35,7,GATGACTTGATACGGGGCTC,28,1099666
fldAp,10.0,86,7,GATCGAGCGTATGTCAATTC,79,1184711
fldAp,2.375,25,7,GATCAGGTCTGGTATAAATA,18,1139793
fldAp,4.625,43,7,GATCAGGCAGGGCGATCGGA,36,1097308
fldAp,0.25,8,7,GATCAGACAGATCGCGCCAG,1,1107262
fldAp,2.375,25,7,GATACTGGTAACATTATCCT,18,1110753
fldAp,5.375,49,7,GATAACAAGCGCCAGACAAG,42,1111840
fldAp,7.625,67,7,GAGTTACCGCCAGTGCGTAG,60,1146298
fldAp,1.25,16,7,GAGGTCGTGCACACATCCTT,9,1102319
fldAp,4.5,42,7,GAGGGCACATACTCATGCCC,35,1080673
fldAp,5.375,49,7,GAGGCTGTGATTAGTCTCCT,42,1069097
fldAp,0.25,8,7,GAGGCTCTCCTAAAGGATCT,1,1166988
fldAp,0.25,8,7,GAGGCAAATCGTCCGCTGGG,1,1175609
fldAp,3.5,34,7,GAGCTTTCTCATCAGACGGC,27,1131956
fldAp,0.5,10,7,GAGCTACTCTTAGGCCCAGG,3,1120039
fldAp,5.25,48,7,GAGCGGAGTGTTAGATCATC,41,1089788
fldAp,2.125,23,7,GAGCAGTGCGATGGGATGCC,16,1073616
fldAp,1.125,15,7,GAGATCCTACCGGATCTATC,8,1082693
fldAp,0.25,8,7,GACTAGCATACAGCCCCTCA,1,1144152
fldAp,19.375,161,7,GACGTCGCGACTAGAGTTCT,154,1107655
fldAp,8.875,77,7,GACCTTGCCGTCAGACCACG,70,1068923
fldAp,0.25,8,7,GACCTTAGTAGGACGGGAAC,1,1086484
fldAp,5.0,46,7,GACCTCTGGCCCGCAGTATC,39,1075064
fldAp,4.375,41,7,GACCGCGCTAGCCCGAGTGA,34,1157293
fldAp,6.0,54,7,GACCGACAGTTCTCAGGCTG,47,1135319
fldAp,2.125,23,7,GACAGTAGGCACCTAATACT,16,1073997
fldAp,2.625,27,7,GACAACGTATCCGATATGGA,20,1137409
fldAp,2.125,23,7,GAATATGGAGCTGATTATGA,16,1150482
fldAp,2.625,27,7,GAAGGAGTAATTTGTATGAA,20,1133082
fldAp,1.75,20,7,GAACCGAATCTACACATCGT,13,1077178
fldAp,0.25,8,7,GAAAGGAGGTGAGATGGTAC,1,1146348
fldAp,5.0,46,7,CTTTTTGGCTCTGTAGTTTA,39,1179662
fldAp,3.375,33,7,CTTTTCGTTAATGACGATGG,26,1158258
fldAp,11.375,97,7,CTTTATGTAGGAGGTACAGA,90,1114255
fldAp,2.0,22,7,CTTGATAGAGGAATACCTGA,15,1077887
fldAp,2.75,28,7,CTTCACGTAATATGTAAGGA,21,1083803
fldAp,9.0,78,7,CTTCACGCTTCGGGAATTGA,71,1165534
fldAp,3.625,35,7,CTTAGTAGATAACCATCGTG,28,1184051
fldAp,3.375,33,7,CTTAGAGAGCCTACTCCGAC,26,1126108
fldAp,0.25,8,7,CTTACTGTAGAGCGGTCCGT,1,1081144
fldAp,3.625,35,7,CTTACACAGGGACTCGATAC,28,1156492
fldAp,5.125,47,7,CTTAATAGCAAGAGACATAA,40,1185186
fldAp,1.125,15,7,CTGCTCCGAGATTTGGCCAG,8,1139024
fldAp,15.375,129,7,CTGCGCACAGGGAACGGGGT,122,1111332
fldAp,2.75,28,7,CTCTCGAGGCTGCCCATTAA,21,1084559
fldAp,6.25,56,7,CTCGTAGGATATAGTGCACC,49,1073331
fldAp,3.875,37,7,CTCGGCCTTGACAGCAATAA,30,1119070
fldAp,2.5,26,7,CTCGAGGCACAGAGAGCTGC,19,1174150
fldAp,7.875,69,7,CTCCGATTAATGGTGGCGAA,62,1127320
fldAp,8.125,71,7,CTCCCCACTCTGTCTTTCTT,64,1066012
fldAp,0.875,13,7,CTCAGGCTGGCGACCCGACA,6,1077209
fldAp,0.25,8,7,CTCAATCGCATGATGGGACG,1,1098198
fldAp,2.125,23,7,CTATGGGTTCCTGGGAGATG,16,1098732
fldAp,0.375,9,7,CTAGTATTTCCTCTGTTGGT,2,1150579
fldAp,1.5,18,7,CTAGGCATCATTTGTTCCGA,11,1152093
fldAp,1.375,17,7,CTACGCCGTTCGTGGCACTA,10,1131246
fldAp,0.25,8,7,CTACGCACGTGGAACGTTTG,1,1145981
fldAp,0.25,8,7,CTACCTCGGGATGGTTTGAG,1,1076655
fldAp,0.5,10,7,CTAATAGACTCAATGGCTAA,3,1131673
fldAp,5.25,48,7,CTAATACTTACATCTTATCC,41,1075427
fldAp,5.375,49,7,CTAAGGCATTAGCCCTAAAC,42,1094990
fldAp,1.25,16,7,CTAACTTCTATCAGTTTCAT,9,1173425
fldAp,4.25,40,7,CTAAAGTCCCTGAGGCTTCG,33,1158035
fldAp,1.5,18,7,CTAAAACGTATGACCCTCAC,11,1073664
fldAp,0.875,13,7,CGTTCTAACCTGTGGAGCTG,6,1156965
fldAp,4.25,40,7,CGTTACACAGTCCAGTGGGT,33,1139700
fldAp,5.625,51,7,CGTCCGCGTTGTTACAAGGG,44,1176937
fldAp,8.5,74,7,CGGTTTGTCTGCGAGAGGCA,67,1091281
fldAp,1.125,15,7,CGGGTCTTCACCCGGCATAA,8,1126021
fldAp,3.0,30,7,CGGGGGCGGGCAGACTAGAT,23,1125402
fldAp,1.5,18,7,CGGAGGTAGGAGGGTTAACA,11,1173946
fldAp,0.375,9,7,CGCTAGTGATAAAGGGCTTG,2,1100159
fldAp,4.125,39,7,CGCCACGTCGGCCTGGGCCC,32,1102036
fldAp,3.75,36,7,CGCAGAGCTGTCAGCGCCCA,29,1154504
fldAp,0.25,8,7,CGATGTGTAACTAATCAAGC,1,1102566
fldAp,0.625,11,7,CGATACGTGGCTATGGGCAG,4,1115607
fldAp,1.625,19,7,CGATACACCCGCGAACTATA,12,1088801
fldAp,4.375,41,7,CGAGGTGGTGGGCTTTTACA,34,1171942
fldAp,1.25,16,7,CGAGGAACGCACCAGACAGG,9,1082286
fldAp,3.875,37,7,CGAAGTCTGTTGGCGATAGG,30,1144013
fldAp,4.0,38,7,CGAAAGACGCAATTTGGCTG,31,1142397
fldAp,0.25,8,7,CGAAACTACGGCCACCAGTG,1,1186863
fldAp,0.25,8,7,CGAAACGGGTCGGCTCAGGG,1,1105098
fldAp,13.25,112,7,CCTTCTAAGATGGAAGTATA,105,1096254
fldAp,0.25,8,7,CCTGTCCTATAAGTGGTGGA,1,1094446
fldAp,0.25,8,7,CCTGCTCCATCTGGCTACCC,1,1100826
fldAp,0.25,8,7,CCTGAGCAGATCTATAGAGA,1,1068134
fldAp,2.5,26,7,CCTCTGACATGGCGGCGACC,19,1074938
fldAp,1.5,18,7,CCTAGTGCATACCAAGAGGC,11,1064380
fldAp,0.875,13,7,CCGGGTTTGACTTATAGAAG,6,1102643
fldAp,5.625,51,7,CCGGGTGTACTTGAAAAACT,44,1135119
fldAp,9.375,81,7,CCGGCCTTAGAAATATGCCC,74,1168600
fldAp,2.875,29,7,CCGGAGTATTGCAGCAAAGC,22,1178558
fldAp,3.625,35,7,CCGCCCGTTTTTATCTCTGC,28,1067700
fldAp,3.25,32,7,CCGCAGCTTAGTTTGCAGCA,25,1168954
fldAp,3.125,31,7,CCGCAATTTAGGCCCGATGT,24,1098237
fldAp,2.625,27,7,CCGATCTACAAATGTCACTG,20,1161463
fldAp,4.5,42,7,CCGAGTCATCAAAGGGACTC,35,1168997
fldAp,3.0,30,7,CCGACTTTCCTTTCCACAAT,23,1146481
fldAp,2.625,27,7,CCCGGTACAGAATGCCTTAG,20,1147977
fldAp,7.0,62,7,CCCGCACACAGAACGGAGTT,55,1165851
fldAp,8.25,72,7,CCCGACCGGATTGGCGGCAT,65,1093289
fldAp,0.375,9,7,CCCGAACCGCTGCTGTGAAT,2,1123842
fldAp,1.875,21,7,CCCCTAATAAGACCTGGTAT,14,1151380
fldAp,2.5,26,7,CCCATAATCCTGGATAGCGT,19,1162132
fldAp,27.75,228,7,CCATTTGGTCCTCTTATTAA,221,1067633
fldAp,2.5,26,7,CCATCGCGACCAGGTCCTAT,19,1068019
fldAp,0.375,9,7,CCAGGTACACACACTCCCGG,2,1083954
fldAp,8.5,74,7,CCAGGAGTAGGGGCGTCTGC,67,1074124
fldAp,4.75,44,7,CCACTCTGTCCATACCGACG,37,1067420
fldAp,4.5,42,7,CCACGGACGTGGGAGATGTT,35,1133694
fldAp,0.25,8,7,CCACACTCTCTAACCCTGAA,1,1078624
fldAp,2.375,25,7,CCAATTCGTCCCCTAGAGTC,18,1168222
fldAp,2.875,29,7,CCAATTCAAGGCCGGCTCGT,22,1088333
fldAp,3.5,34,7,CCAATCAGAGCTTCCGCTAG,27,1167336
fldAp,1.875,21,7,CCAAGCTGCTAGGCACATAG,14,1124354
fldAp,2.25,24,7,CCAAATTATGGCTTTAATCC,17,1153078
fldAp,0.25,8,7,CCAAATGTCCCCGGTGGTCC,1,1142862
fldAp,2.25,24,7,CATTGTTGATCGAAAGATTA,17,1073347
fldAp,1.875,21,7,CATTGCGCGGCTCTCCAGAA,14,1084566
fldAp,4.5,42,7,CATTCTTCCGGACCCTCATT,35,1107094
fldAp,4.625,43,7,CATTATTCTACAAATTGTCG,36,1114487
fldAp,2.875,29,7,CATGGTACATTAGGACTCTA,22,1149584
fldAp,3.625,35,7,CATGCACAGTGCCCCCTCAG,28,1093052
fldAp,13.0,110,7,CATCTTGACTCATACACTTA,103,1109050
fldAp,2.375,25,7,CATAGGCTATTCGCTTGCCT,18,1175473
fldAp,2.25,24,7,CATAGACTATAGATAAGTGA,17,1092521
fldAp,7.5,66,7,CATAACCATGCCAGAAGCTT,59,1129731
fldAp,0.25,8,7,CAGTATCTCATCCCCTAAGC,1,1159651
fldAp,5.25,48,7,CAGTAATCTCGGGCTGGGAA,41,1084148
fldAp,1.625,19,7,CAGGTAATATGGGCTAACGT,12,1164467
fldAp,3.75,36,7,CAGGCACAAGAAATGGACCC,29,1134163
fldAp,11.875,101,7,CAGGATCGGTTGCCTCAAAT,94,1073354
fldAp,9.25,80,7,CAGCTGCGATGGGGATTAAA,73,1177406
fldAp,3.375,33,7,CAGATTATGAGTATCGCTCC,26,1090700
fldAp,3.0,30,7,CAGACCAAGGAACCTCCCTA,23,1097104
fldAp,4.5,42,7,CACTGCTTACTGGCAAGGAT,35,1113658
fldAp,0.5,10,7,CACTCTTCTCTCAAAGCTAA,3,1177544
fldAp,2.625,27,7,CACTCGTAAATCCTCGTGAC,20,1154528
fldAp,0.25,8,7,CACTAGCACGCGCCAATCCC,1,1085312
fldAp,6.25,56,7,CACGTCAGTCTTGGTAAAGG,49,1098747
fldAp,9.625,83,7,CACGTACGCCGGTCAATTCT,76,1147203
fldAp,7.875,69,7,CACGGGTCCGTGCTATGAGA,62,1107280
fldAp,1.875,21,7,CACGCCCCTGAAAATCGGTT,14,1120840
fldAp,0.25,8,7,CACGCATGCGACGGTATCCA,1,1067000
fldAp,0.875,13,7,CACGACAGTTCTGAGGGCTT,6,1177978
fldAp,2.0,22,7,CACATTCCCACCGCGTGGCG,15,1138336
fldAp,11.0,94,7,CACAGAATAGGAACTGGTTC,87,1094690
fldAp,5.375,49,7,CAATCCACTCGCCGGGGGGA,42,1137036
fldAp,8.375,73,7,CAATCAAACGGTCGCATGGT,66,1064294
fldAp,3.25,32,7,CAATAGCTAACCCTCGGCAG,25,1126243
fldAp,3.0,30,7,CAATACTAACGTTCGGTTCC,23,1154842
fldAp,0.625,11,7,CAAGAAATAGTGCCCACTCT,4,1139949
fldAp,2.75,28,7,CAACTACTTAGGGCTGAATA,21,1175847
fldAp,4.0,38,7,CAACAGGCAGGTGGCATTAA,31,1085841
fldAp,3.125,31,7,CAAATCAAGTGCGTTTGGCC,24,1072406
fldAp,3.75,36,7,CAAAGTTACCCATTAAGCGA,29,1152371
fldAp,2.125,23,7,CAAAGAAGCCAGACACGGCA,16,1143440
fldAp,3.75,36,7,ATTTGTCAACCTAAACCTCA,29,1180168
fldAp,6.25,56,7,ATTTGGATAGCCTCTACTCA,49,1113207
fldAp,6.0,54,7,ATTGTCCAGTTGCTCTACAT,47,1164434
fldAp,5.0,46,7,ATTGGATAAGAGTCCTCTTA,39,1161205
fldAp,3.5,34,7,ATTGCGATCTTAATAAGGTA,27,1143004
fldAp,0.25,8,7,ATTGATACGGTCGGACCTGC,1,1107482
fldAp,3.125,31,7,ATTGACTATAGCCTCCAAGG,24,1099146
fldAp,4.25,40,7,ATTGAACCTAACCAGACTCC,33,1088825
fldAp,4.125,39,7,ATTCTAACCGTTATGGGGTT,32,1170098
fldAp,1.25,16,7,ATTATTCATGCTGTAGGCTC,9,1086953
fldAp,2.125,23,7,ATGTTTTTGGCTAAGGCAAT,16,1139191
fldAp,2.0,22,7,ATGTGCATCAAGCAGGCTGG,15,1116257
fldAp,4.875,45,7,ATGTGAGAGGATTAAGACCG,38,1086491
fldAp,6.0,54,7,ATGGTGAGCGCTTTTCAGCA,47,1096713
fldAp,3.25,32,7,ATGGGTTGCGGTCATCCTGA,25,1142170
fldAp,2.125,23,7,ATGGGGGCAACAATACAGCT,16,1135855
fldAp,22.75,188,7,ATGCTGCTTACCACTAAACA,181,1064770
fldAp,2.25,24,7,ATGCAGGCGAGCCCCTGGTG,17,1131563
fldAp,0.25,8,7,ATGCACGGATTATTCCGGAT,1,1154195
fldAp,3.375,33,7,ATGATTGCATTGGGTAGACG,26,1152591
fldAp,0.25,8,7,ATGATTATGATGGAGGCGGT,1,1116705
fldAp,4.25,40,7,ATGACTCTGCCCTCCTCGCA,33,1117177
fldAp,3.375,33,7,ATCGTGATCACACTTTATCC,26,1121832
fldAp,1.375,17,7,ATCGGTTCTTCAGCTGCCTC,10,1166014
fldAp,3.25,32,7,ATCGGGACGTTCGCCGTGAT,25,1072483
fldAp,3.125,31,7,ATCGGCCGCATTGGACATAG,24,1167646
fldAp,4.25,40,7,ATCGACGCACCATGAGCCTA,33,1120147
fldAp,3.625,35,7,ATCCGTGGTCCACCAGCCCT,28,1133116
fldAp,2.25,24,7,ATCACGTACACAAATGGCCA,17,1124033
fldAp,4.25,40,7,ATCACGGGTCCTCTGTTGCC,33,1132489
fldAp,5.875,53,7,ATATTAGTAAAAGTGTTTCA,46,1181646
fldAp,0.625,11,7,ATATGGTCAAAACAAAGCGT,4,1174100
fldAp,2.125,23,7,ATAGTTTTGTCTTGCTTCGT,16,1132521
fldAp,2.625,27,7,ATAGGCGAATGCATCCACTA,20,1108150
fldAp,0.75,12,7,ATACTCTTATCCTGCGCTTC,5,1168433
fldAp,27.125,223,7,AGTTTAGATCTGACGTTCTG,216,1107675
fldAp,2.375,25,7,AGTTGGCAAATATCAATGGC,18,1078595
fldAp,4.0,38,7,AGTGTGATCCTGCTTCTTTG,31,1086091
fldAp,7.875,69,7,AGTCTATCCGAGGCCGTCAA,62,1116976
fldAp,4.875,45,7,AGTATTGGCCTACTCTAGCT,38,1122109
fldAp,3.125,31,7,AGTATCGATTGCAGAAAACT,24,1178640
fldAp,0.25,8,7,AGTAGCGCACGGGAGTGATT,1,1157939
fldAp,4.0,38,7,AGTAATTTTGTCCAGTTCAA,31,1083984
fldAp,4.25,40,7,AGTAATAGGACCTGCCTCAA,33,1182831
fldAp,1.625,19,7,AGGTTTCCATTCAGCATTTA,12,1126383
fldAp,0.375,9,7,AGGTAATTTAAGGAAGGTTT,2,1140911
fldAp,3.125,31,7,AGGTAATCCTAAGCAAAGTA,24,1065033
fldAp,4.75,44,7,AGGTAAAAAGTGCTCAACCT,37,1111124
fldAp,3.375,33,7,AGGGCTGGCTCGTTTTACGC,26,1113797
fldAp,3.125,31,7,AGGCGCTCTGGACGCGGTGT,24,1152582
fldAp,7.0,62,7,AGGAATCACAAGCAGACCGT,55,1180048
fldAp,3.875,37,7,AGGAAATGCTAGCCTCTGTA,30,1117112
fldAp,0.25,8,7,AGCTCGTTCCAGTAGGTTTG,1,1102096
fldAp,2.875,29,7,AGCGTTAGCAAGAATGTTGT,22,1067101
fldAp,4.625,43,7,AGCGTACTTCTTAGAGTGGA,36,1095733
fldAp,5.375,49,7,AGCGGTGAAATAAATATGAT,42,1070908
fldAp,6.625,59,7,AGCGCAGGGTTCGAACGTCC,52,1165584
fldAp,14.5,122,7,AGCGACATTACGTGGCCTAC,115,1065997
fldAp,2.75,28,7,AGCGAAGGTCTAGCGAAGGT,21,1164535
fldAp,2.875,29,7,AGCACGTTTGTCAGCCACTC,22,1103413
fldAp,0.25,8,7,AGATTTAGTAAGCGACTTCA,1,1148577
fldAp,8.375,73,7,AGATTGGATTGGACGTGACC,66,1125435
fldAp,2.75,28,7,AGATTGAACGGGCGTCGTGA,21,1157048
fldAp,0.25,8,7,AGATGCGGCACAGCTCTGCT,1,1159801
fldAp,3.125,31,7,AGATGCATTAAGAAGTAGGT,24,1135583
fldAp,1.75,20,7,AGATCGGTCCGGCTATCGAT,13,1066614
fldAp,0.75,12,7,AGAGCATTATGGTCGGACAC,5,1092640
fldAp,5.625,51,7,AGAGCAAACATATTCGGGCA,44,1157526
fldAp,0.375,9,7,AGAGATACGCGCAAACCGAT,2,1118551
fldAp,4.75,44,7,AGACCGCGAACACTCCCTAA,37,1153611
fldAp,2.25,24,7,AGACCCATACGGGCCGGTAA,17,1093408
fldAp,0.25,8,7,AGAACGTTTTCATTTCTGAA,1,1117714
fldAp,5.375,49,7,ACTTGTTACAGTCATCGTAA,42,1135589
fldAp,1.5,18,7,ACTGGATCTATGTCATATCT,11,1083972
fldAp,2.875,29,7,ACTCCGAGTCGCGGCTTCGG,22,1074024
fldAp,14.625,123,7,ACTCCAAGCCAGCAGCTTTG,116,1140903
fldAp,4.125,39,7,ACTAGCGCTACCTGTTCTCA,32,1134658
fldAp,3.0,30,7,ACTACGTTATTTGCCGGGTA,23,1104350
fldAp,0.25,8,7,ACTACGGTCAGCTGTCCTAG,1,1147424
fldAp,3.5,34,7,ACGTGTAACTCCTCTAATAT,27,1077005
fldAp,0.25,8,7,ACGTACGAGCGAGAGGTCTT,1,1119492
fldAp,2.5,26,7,ACGTAAAAGGAATAAGCATA,19,1174540
fldAp,7.75,68,7,ACGGGCAACCTGTACATCAT,61,1171057
fldAp,2.625,27,7,ACGATTTTGGTGAGCACTAG,20,1113131
fldAp,1.125,15,7,ACGAACTACCTAGCTGTCAG,8,1171659
fldAp,2.875,29,7,ACCGTTACGTCAAGATTCTA,22,1175996
fldAp,6.0,54,7,ACCCCTTACGGACATCGTCA,47,1162153
fldAp,5.5,50,7,ACCCACTACGTTGTTGTCAC,43,1096321
fldAp,1.5,18,7,ACCATCTAGTCTCGGTGAAT,11,1140623
fldAp,3.625,35,7,ACCAGGAAAGCACTTAACAC,28,1148635
fldAp,2.5,26,7,ACACTCAGCGGCTTGCTGTT,19,1175118
fldAp,2.375,25,7,ACACGGTATGTCTCGGCAGA,18,1153084
fldAp,30.75,252,7,ACACGATGGTCATCCCCCAT,245,1109045
fldAp,7.25,64,7,AATGTTCGAAGGCTGCGGTG,57,1186630
fldAp,0.375,9,7,AATGCATATGTACGCGTTTT,2,1148696
fldAp,2.875,29,7,AATGAATTGCATAAATAATC,22,1066019
fldAp,5.125,47,7,AATCTCGGTCTCTGCTCAAA,40,1119845
fldAp,3.25,32,7,AATCGATTGAGTTAATGACT,25,1068571
fldAp,0.5,10,7,AATATACGAAAGGAACCTGA,3,1068518
fldAp,4.25,40,7,AATATAAGGGGGTTACTTGA,33,1164022
fldAp,4.375,41,7,AAGTCTAGCGCACTCAGAAA,34,1149787
fldAp,3.125,31,7,AAGGGGAGAGTTTCCAACGA,24,1170005
fldAp,8.375,73,7,AAGGGCTAATGGATACCGCG,66,1116469
fldAp,4.5,42,7,AAGGGAGCTTACTGGAGGTC,35,1158262
fldAp,1.875,21,7,AAGGAAGGGGATTCCCAGGC,14,1090550
fldAp,8.75,76,7,AAGCTGCGGTAATTGTGAGG,69,1118408
fldAp,4.0,38,7,AAGCGTTGAGGTCTGCTGTA,31,1065360
fldAp,1.5,18,7,AAGCGTCCTGTGAGTCATTT,11,1165986
fldAp,2.625,27,7,AAGCGGCCCCCAACGCGAGG,20,1097459
fldAp,11.0,94,7,AAGCCATATTCCGGGATTTG,87,1103963
fldAp,2.875,29,7,AAGCATCACAACTTGGCCCG,22,1129762
fldAp,17.5,146,7,AAGCAGAAGACCAGTTTCGT,139,1107743
fldAp,4.5,42,7,AAGCACGCTCCGCGTTGAGT,35,1164635
fldAp,5.0,46,7,AAGAATTAGCGTTATTTTTA,39,1148638
fldAp,0.5,10,7,AACTTCAGGAAACTAGCTTG,3,1184734
fldAp,2.5,26,7,AACTACACGTTGGGAGTTAC,19,1066753
fldAp,2.75,28,7,AACCATGAGTTCCTGTGGAT,21,1147356
fldAp,11.0,94,7,AACAACGTCTTTACGTGCTC,87,1134826
fldAp,2.5,26,7,AAAGTGGGGTACGGGCTCAA,19,1107272
fldAp,0.5,10,7,AAAGGTTTTTCCTTGTAGCA,3,1079089
fldAp,3.75,36,7,AAAGGGTGTTCTTGATTGTT,29,1108264
fldAp,14.0,118,7,AAAGGGGTCGCTTACCTAAC,111,1073342
fldAp,1.5,18,7,AAACCCGCGCGACTAACCCA,11,1081073
fldAp,2.375,25,7,AAAATTCACGTATGTATACT,18,1111274
fldAp,3.125,31,7,AAAAGGATTATCATACCGGT,24,1139029
fldAp,2.125,23,7,AAAAACTTCCCCTCTTCAAT,16,1120357
fldAp,11.285714285714286,84,6,TTTTGGTAAGGGGCGTAACC,78,1093287
fldAp,3.142857142857143,27,6,TTTGGATTACGTGAGCACGC,21,1094760
fldAp,5.571428571428571,44,6,TTTGCTTCTCCCCGGATATA,38,1100218
fldAp,6.428571428571429,50,6,TTTCCATAGTTCATGTACCC,44,1098642
fldAp,2.2857142857142856,21,6,TTTAGAGTGCACAATTTAAC,15,1087924
fldAp,4.142857142857143,34,6,TTTAACTAACGGAGCAAGTA,28,1068663
fldAp,10.857142857142858,81,6,TTGTTATTAGTGAATAGTCT,75,1159909
fldAp,0.42857142857142855,8,6,TTGTCCTTTCCGAACGTAAC,2,1141139
fldAp,5.571428571428571,44,6,TTGTCAATGCATCGAGTGTA,38,1154929
fldAp,0.2857142857142857,7,6,TTGGCAGAAACCTATCTTGC,1,1115572
fldAp,1.0,12,6,TTGCGGGTCACGTGACTACT,6,1182063
fldAp,0.2857142857142857,7,6,TTGCGCTACTAACAGCCCGT,1,1094178
fldAp,10.0,75,6,TTGCGAAAGTTTAACCGAGC,69,1077562
fldAp,19.428571428571427,141,6,TTGCCAATTGCAACCACGGT,135,1066029
fldAp,0.2857142857142857,7,6,TTGCAGACCTGTATGAGGAC,1,1120274
fldAp,2.2857142857142856,21,6,TTGAAACAGCTGAACTTCCC,15,1077105
fldAp,13.285714285714286,98,6,TTCTTTTACGGATAGGGACT,92,1066274
fldAp,11.714285714285714,87,6,TTCTAATGCAATAAGTGAGG,81,1079189
fldAp,5.285714285714286,42,6,TTCGGCGGGATCTTTTAGTG,36,1082144
fldAp,3.142857142857143,27,6,TTCGCTTAGTGCCTATGCCA,21,1179002
fldAp,0.42857142857142855,8,6,TTCCTTTACGTGCCACTGGG,2,1121214
fldAp,1.0,12,6,TTCCTGCGCCCGGACGATCG,6,1175160
fldAp,0.42857142857142855,8,6,TTCCGTCTTGATGCGAACCT,2,1088302
fldAp,4.0,33,6,TTCATAGTGCGGAGCTGATA,27,1175598
fldAp,0.8571428571428571,11,6,TTCACCGATAGGGATCTCTG,5,1169517
fldAp,8.428571428571429,64,6,TTATAGGAGCTGTCGTGCTG,58,1152525
fldAp,4.714285714285714,38,6,TTAGTAACGGCTTATATTTC,32,1167702
fldAp,1.7142857142857142,17,6,TTACCCGACTACCTATTATT,11,1135037
fldAp,7.142857142857143,55,6,TTACCCCATACGCGGTAGTT,49,1115118
fldAp,4.285714285714286,35,6,TTACAAGGTGCGGCTAGATG,29,1176734
fldAp,4.857142857142857,39,6,TGTTTAACAGACACATCTCC,33,1065116
fldAp,2.7142857142857144,24,6,TGTGACAGGATTCCCCACAT,18,1094066
fldAp,0.42857142857142855,8,6,TGTCTCGCGTCATATTAACA,2,1178407
fldAp,3.0,26,6,TGTCCGGCCACAGGACACAC,20,1174036
fldAp,4.571428571428571,37,6,TGTCCATCACTCGGGGCAGG,31,1179270
fldAp,3.4285714285714284,29,6,TGTATCAGATTGAACATGGA,23,1112492
fldAp,0.2857142857142857,7,6,TGTAGACCTTCGCAGGCAAT,1,1094812
fldAp,2.857142857142857,25,6,TGGGGAATCAGCACCATGAT,19,1166396
fldAp,4.571428571428571,37,6,TGGGCGCACCCAGGAATGAC,31,1154889
fldAp,9.0,68,6,TGGCTAGATACAACGCTCGC,62,1157972
fldAp,3.2857142857142856,28,6,TGGCGCCTTTCGGTCGATGA,22,1116486
fldAp,6.857142857142857,53,6,TGGCCCTGTTCGTAATTTCA,47,1134662
fldAp,2.2857142857142856,21,6,TGGCATGGTCTGGGCTTAGA,15,1101241
fldAp,12.428571428571429,92,6,TGGAGAGACTGCTCGAGAAC,86,1133343
fldAp,1.0,12,6,TGGACTTTGCTCAACCAGCT,6,1105395
fldAp,1.7142857142857142,17,6,TGGACGCGGGTTTTGGGCTT,11,1144504
fldAp,6.0,47,6,TGCTTAAGACATCGCGAACT,41,1064044
fldAp,3.4285714285714284,29,6,TGCTGTGGCTAACAGTAAAT,23,1093755
fldAp,5.428571428571429,43,6,TGCTGTCCGAAACTGGCTTC,37,1124790
fldAp,4.714285714285714,38,6,TGCTGGTTATGGCGCAACTC,32,1116023
fldAp,7.571428571428571,58,6,TGCTCCCCATAGGTTAACTT,52,1169508
fldAp,4.857142857142857,39,6,TGCAGCATCTAAGATACCAC,33,1089836
fldAp,5.0,40,6,TGATCGTACGTTGTGCGATG,34,1112960
fldAp,1.2857142857142858,14,6,TGATCGAAACACAGTGTACA,8,1113792
fldAp,3.2857142857142856,28,6,TGATCCGGAGATCCACGGCG,22,1066932
fldAp,9.142857142857142,69,6,TGATACGGGGATTACGATGC,63,1119664
fldAp,2.857142857142857,25,6,TGACCATCATCAGTAGCATT,19,1096327
fldAp,11.428571428571429,85,6,TGAAGCGCCTTTCATGTGGA,79,1082946
fldAp,4.714285714285714,38,6,TGAACACTGACCGTTTTTGA,32,1111787
fldAp,0.2857142857142857,7,6,TGAAAAGGTTGTAGCCTCTG,1,1183955
fldAp,1.2857142857142858,14,6,TCTTTTATTAGGCACGTATG,8,1091367
fldAp,4.428571428571429,36,6,TCTTTCCAAACAATAACTGC,30,1132352
fldAp,2.857142857142857,25,6,TCTTCCTATGAATCGCAGCC,19,1167402
fldAp,0.2857142857142857,7,6,TCTTAGTCTTGGGCCTATAA,1,1086689
fldAp,4.857142857142857,39,6,TCGTGTCTCTCCGTCGTGGC,33,1085134
fldAp,7.142857142857143,55,6,TCGTGCCCCTCTCTCGTAAA,49,1169787
fldAp,5.714285714285714,45,6,TCGTAGGAACAAGAATACGA,39,1178853
fldAp,2.857142857142857,25,6,TCGGGAGGTGGCTCTCGCAA,19,1131885
fldAp,5.857142857142857,46,6,TCGCGCACGCGGTCTGATAT,40,1073367
fldAp,1.0,12,6,TCGCATCACAAGGGACTTGG,6,1084541
fldAp,5.857142857142857,46,6,TCGATCACCAGCCTGAAATA,40,1166008
fldAp,0.2857142857142857,7,6,TCGAAGCCATCAGTATTCAG,1,1128864
fldAp,4.714285714285714,38,6,TCGAAAGGAAGAGGTTAGAA,32,1124333
fldAp,18.0,131,6,TCCTTAACCGAATCCTCTGG,125,1108355
fldAp,5.428571428571429,43,6,TCCTCCACTTATTTGTCGCT,37,1115836
fldAp,4.285714285714286,35,6,TCCCAACAAAGGAAACGATC,29,1177135
fldAp,6.428571428571429,50,6,TCCAGTTTGCGTCCTTGAGA,44,1105069
fldAp,0.5714285714285714,9,6,TCCAAGCAACGGTTTTAGTT,3,1082891
fldAp,3.2857142857142856,28,6,TCATGCACGAAGTGTATTCG,22,1156970
fldAp,12.0,89,6,TCAGAGGCACCGTCACACCA,83,1107701
fldAp,3.857142857142857,32,6,TCACTTGTGTGTTGTGACAT,26,1172457
fldAp,4.428571428571429,36,6,TCACGGAATTCGCACTAGGG,30,1082346
fldAp,0.42857142857142855,8,6,TCAAAAAGGTAAGACGAAGC,2,1091938
fldAp,2.142857142857143,20,6,TATCTTTAGAGCGGCGACCG,14,1134435
fldAp,2.4285714285714284,22,6,TATCATGTAATCACGTGGGG,16,1164178
fldAp,3.857142857142857,32,6,TATAGCGAATCACACTTCCG,26,1159136
fldAp,3.142857142857143,27,6,TAGGATATAGGGGAGGTATT,21,1174399
fldAp,0.2857142857142857,7,6,TAGCGATAGGGTCACAATCT,1,1109741
fldAp,0.2857142857142857,7,6,TAGCAACCGCAATCCGAATG,1,1067092
fldAp,4.857142857142857,39,6,TACTGCCTCCGGTCCAGTGC,33,1145468
fldAp,4.0,33,6,TACTCTAAATAGTAGATATC,27,1136416
fldAp,1.2857142857142858,14,6,TACGGTCGTTACATCCATGA,8,1101751
fldAp,4.714285714285714,38,6,TACCTAGATGGCTTCTACAG,32,1090136
fldAp,5.142857142857143,41,6,TACCTACGTGCAATACATTC,35,1176351
fldAp,10.571428571428571,79,6,TACACCGTTAACAACAGAAG,73,1093875
fldAp,0.2857142857142857,7,6,TACAAGCCGTTGGCATCATT,1,1106531
fldAp,3.4285714285714284,29,6,TAAGTGTAACAGACGCGGCA,23,1144257
fldAp,7.285714285714286,56,6,TAAGGGGGGTGACCATCCGT,50,1172444
fldAp,3.0,26,6,TAAGGCAATCTCGGTGGAAT,20,1184444
fldAp,2.7142857142857144,24,6,TAAGCATTCGTGGGTAGCCC,18,1063131
fldAp,1.7142857142857142,17,6,TAACATGGCCAAATATGTGT,11,1155010
fldAp,0.42857142857142855,8,6,TAAAGGTCGTATTGTTGACT,2,1161366
fldAp,3.857142857142857,32,6,TAAAAGGATTGCTCACGGCT,26,1093314
fldAp,5.857142857142857,46,6,TAAAACACCGTTGTGTCGTT,40,1082846
fldAp,8.714285714285714,66,6,GTTTATGTTTAGCATTTACT,60,1135495
fldAp,3.4285714285714284,29,6,GTTTAGAAATCATTCTTGCC,23,1063762
fldAp,5.571428571428571,44,6,GTTGTTCGCTCACTCCGGGC,38,1063665
fldAp,0.2857142857142857,7,6,GTTGTTACAGTCGAGGGTGA,1,1127245
fldAp,2.5714285714285716,23,6,GTTCGGTTTCTGTTGTAAGT,17,1091860
fldAp,0.5714285714285714,9,6,GTTCCATAGAGCGGTCGGGG,3,1115397
fldAp,0.2857142857142857,7,6,GTTACCCGCCAACTACGGAT,1,1118524
fldAp,1.4285714285714286,15,6,GTGTAATCCAAGTATGCACT,9,1065027
fldAp,5.714285714285714,45,6,GTGTAAGCAGACGGAACATA,39,1088161
fldAp,5.857142857142857,46,6,GTGGTTCGCAAGCAATGCCA,40,1144009
fldAp,8.571428571428571,65,6,GTGCGTGGCTCATTATGTAA,59,1109770
fldAp,4.714285714285714,38,6,GTGCGGTGATTTCCCTTGAA,32,1114534
fldAp,9.0,68,6,GTGCAGTCCTTGGCCGGAGG,62,1148625
fldAp,6.142857142857143,48,6,GTGCACCTGTGCGGCTGAGC,42,1182505
fldAp,3.142857142857143,27,6,GTGATCATGTGTCTCAATTC,21,1106859
fldAp,23.571428571428573,170,6,GTGAGCACGCAACCTCCGGC,164,1103955
fldAp,0.2857142857142857,7,6,GTGAACGACCGGTTGCTCAA,1,1139832
fldAp,10.714285714285714,80,6,GTCGTTATGGTAAGCCGGCT,74,1125720
fldAp,0.2857142857142857,7,6,GTCGGTCGCTCAGACAGAAA,1,1175689
fldAp,2.2857142857142856,21,6,GTCCCTTCTGGGTCCTCTGC,15,1086056
fldAp,2.7142857142857144,24,6,GTCCCCGATACATATCAACC,18,1074441
fldAp,3.4285714285714284,29,6,GTCCATAGTGGGAGACAGAC,23,1150866
fldAp,3.0,26,6,GTCAATTGTGTATACCTATT,20,1139110
fldAp,3.857142857142857,32,6,GTATCTAACTCTGAGCACGG,26,1082203
fldAp,0.2857142857142857,7,6,GTATATCGATCCGTAGAAGT,1,1079375
fldAp,6.428571428571429,50,6,GTAGTAGACGAATAGGTAGG,44,1178456
fldAp,7.428571428571429,57,6,GTACTAGGTTTTTTGTTGTG,51,1139471
fldAp,3.2857142857142856,28,6,GTACGGGCGTTGTGCTTGCC,22,1151440
fldAp,4.428571428571429,36,6,GTACCGCAGAGAAGGCTTCA,30,1114849
fldAp,2.857142857142857,25,6,GTAACAACGGTACTCTCGAT,19,1101738
fldAp,3.0,26,6,GGTTTAGAACCTTAAGGTAG,20,1104887
fldAp,3.5714285714285716,30,6,GGTGATGTTAGTGGTCCGAT,24,1124232
fldAp,18.428571428571427,134,6,GGTCGCCCCCGCAGCCAATA,128,1118354
fldAp,6.285714285714286,49,6,GGTCCTGTGTGTATGGAAAA,43,1112739
fldAp,0.2857142857142857,7,6,GGTCCTGCCTAACGAAGGGT,1,1185458
fldAp,3.857142857142857,32,6,GGTCCATCATGTTGGGCAGT,26,1171341
fldAp,0.42857142857142855,8,6,GGTCACGTGCAGTCATGCAA,2,1178365
fldAp,6.428571428571429,50,6,GGTATTGGAAGCCAACACTG,44,1105620
fldAp,3.5714285714285716,30,6,GGTAGGCTGTGCATATTTTT,24,1109651
fldAp,0.2857142857142857,7,6,GGTACGCCGCTTAACGGGCT,1,1068900
fldAp,0.5714285714285714,9,6,GGGTTCTCTCCGGTCGCCCC,3,1096726
fldAp,3.7142857142857144,31,6,GGGTTCCTTATGTCGCGACT,25,1145658
fldAp,4.428571428571429,36,6,GGGTCCGTACTTCGCTACCT,30,1107676
fldAp,3.0,26,6,GGGTCCAGGCCTGTACACCT,20,1101859
fldAp,7.142857142857143,55,6,GGGGTGGACACTGGTACTTC,49,1129860
fldAp,2.4285714285714284,22,6,GGGGTGATGCCCGTTAAGGT,16,1108520
fldAp,13.142857142857142,97,6,GGGGCACAGGAGTGGACCTA,91,1083914
fldAp,4.142857142857143,34,6,GGGCTCAACATTAGGTTTCC,28,1089169
fldAp,2.857142857142857,25,6,GGGCACGTGTTTTGAGTTAG,19,1095240
fldAp,3.857142857142857,32,6,GGGAATCAAAAACGGTAAAG,26,1184029
fldAp,22.142857142857142,160,6,GGCTGTGTCCCGGTCTCTTC,154,1064286
fldAp,3.142857142857143,27,6,GGCTGTGAATTGTTCCGACC,21,1142028
fldAp,0.2857142857142857,7,6,GGCTCTTAGGCCCGCTCCTT,1,1175328
fldAp,1.0,12,6,GGCTCCATGTGGTTGACTTG,6,1085367
fldAp,1.2857142857142858,14,6,GGCCTCCAGGGCGTAAGGGG,8,1186773
fldAp,0.2857142857142857,7,6,GGCCCCACACTATTCTTAAC,1,1152656
fldAp,0.2857142857142857,7,6,GGCAACTTCCTTGCTGGAGT,1,1115363
fldAp,0.42857142857142855,8,6,GGATACGTAAGTCTCACGCA,2,1158036
fldAp,11.285714285714286,84,6,GGAGTGCGAATATGACACGT,78,1170777
fldAp,5.142857142857143,41,6,GGAGCACCAACGCGCAATAT,35,1070044
fldAp,0.2857142857142857,7,6,GGAGAATTCGGTTAGCCCCT,1,1124689
fldAp,0.2857142857142857,7,6,GGACGGTACAGTATGGATTC,1,1172441
fldAp,4.571428571428571,37,6,GGAATGTCTGGGTTCTCTCA,31,1081546
fldAp,4.428571428571429,36,6,GCTGTTGGTTTCCTGTTCTG,30,1159227
fldAp,0.2857142857142857,7,6,GCTCCAAGCGATGATTTCGA,1,1144042
fldAp,4.571428571428571,37,6,GCTATCGGTGCATATTCAGG,31,1086169
fldAp,1.7142857142857142,17,6,GCTATCGCAAGGATTTCAAA,11,1081795
fldAp,9.0,68,6,GCGTTAATCCGGGTGTCCGA,62,1118250
fldAp,1.8571428571428572,18,6,GCGTCCGCCGAATTAGGCTG,12,1112599
fldAp,6.0,47,6,GCGGTGAGCTTGAAAGTAAT,41,1165991
fldAp,0.2857142857142857,7,6,GCGCCGCGGTAGTTGTAAAT,1,1175903
fldAp,4.0,33,6,GCGCAGCGGTGACATATCCA,27,1147109
fldAp,5.857142857142857,46,6,GCGCAAGGCGTTATAAGTTA,40,1183020
fldAp,10.571428571428571,79,6,GCGAGGCGCAACAGAAAGGA,73,1157728
fldAp,12.285714285714286,91,6,GCGACGAGGCGAGTGGCTTA,85,1137776
fldAp,0.2857142857142857,7,6,GCGACATTCGAAGTGCGTTT,1,1153371
fldAp,8.285714285714286,63,6,GCGAACAAGCAACGACCTGA,57,1097686
fldAp,5.714285714285714,45,6,GCCTTTGCTGCAATATCTGC,39,1134571
fldAp,4.142857142857143,34,6,GCCTTGAGGTCCATTAATCG,28,1099640
fldAp,4.857142857142857,39,6,GCCTGAAGAAATAGCTCGTC,33,1098509
fldAp,1.8571428571428572,18,6,GCCGGTACCGTTGTCCATCC,12,1086152
fldAp,2.142857142857143,20,6,GCCCGGCGGAAACAGTTACT,14,1070333
fldAp,3.2857142857142856,28,6,GCCCGAGTCCCGAAGGCCAT,22,1097702
fldAp,0.2857142857142857,7,6,GCCATTGATGGCGAGCTGAA,1,1161126
fldAp,0.2857142857142857,7,6,GCCATGACTGGGGCGTGTAC,1,1067792
fldAp,9.142857142857142,69,6,GCCACTTTCTAATGCACACC,63,1146568
fldAp,2.2857142857142856,21,6,GCATCCGAAAAACTTGGAGC,15,1139563
fldAp,4.857142857142857,39,6,GCAGTGTAAGTTTGGTGTGC,33,1151298
fldAp,2.7142857142857144,24,6,GCAAGTTCCCGGTGAGGATT,18,1109158
fldAp,3.7142857142857144,31,6,GATTTTACTCGTGCGCCAGC,25,1127317
fldAp,3.4285714285714284,29,6,GATTAATACACTTGCGGATT,23,1126543
fldAp,4.0,33,6,GATTAACCGGTACCGCCAGA,27,1158827
fldAp,7.714285714285714,59,6,GATGCTGACTTCAGCCTTGC,53,1132572
fldAp,5.0,40,6,GATGCCAATTAGAACTTTGT,34,1173089
fldAp,8.285714285714286,63,6,GATGCACTTAATCGTAAGAT,57,1076451
fldAp,6.285714285714286,49,6,GATGCAACCCCCAATCCATT,43,1077947
fldAp,4.571428571428571,37,6,GATCCTCTTGAATTAGCTTC,31,1094052
fldAp,6.142857142857143,48,6,GATAGCCAATGGTACGCCGT,42,1071655
fldAp,2.142857142857143,20,6,GATAGCAGTAATCGTTGTTA,14,1161283
fldAp,7.857142857142857,60,6,GATACGGAGGACCCAGACTC,54,1139011
fldAp,5.857142857142857,46,6,GATACGCAGGTACTTCGCGT,40,1110059
fldAp,0.2857142857142857,7,6,GAGTTTGTATGCACGTGACT,1,1179928
fldAp,0.2857142857142857,7,6,GAGGTTGACAAAAAACCAGA,1,1161069
fldAp,0.42857142857142855,8,6,GAGGGTCACGTACCCGCGAC,2,1103592
fldAp,1.2857142857142858,14,6,GAGGGCGCACATAGTATCAT,8,1086387
fldAp,8.142857142857142,62,6,GAGGAGGGGTAAAATTCTTC,56,1149172
fldAp,2.2857142857142856,21,6,GAGCTCGAGTGTGTGTATCT,15,1170836
fldAp,0.2857142857142857,7,6,GAGCCTAGCTATTCCTGAGG,1,1170517
fldAp,26.571428571428573,191,6,GAGCCGTTTTATCCGGGCTC,185,1065995
fldAp,6.0,47,6,GAGAGTAGGCCCACATACTT,41,1097376
fldAp,0.7142857142857143,10,6,GACTGCGGTAATGCTTGGGG,4,1066616
fldAp,3.5714285714285716,30,6,GACTGATCGTGAGATCACAG,24,1154738
fldAp,0.42857142857142855,8,6,GACTACCGGCCAGTCAGTAC,2,1069187
fldAp,6.714285714285714,52,6,GACGTGCGATTTATCCCCGA,46,1080270
fldAp,2.0,19,6,GACGGCTTCGAAGCCCCCGG,13,1144934
fldAp,1.8571428571428572,18,6,GACCCTCAATCAGTAATGAA,12,1066778
fldAp,1.7142857142857142,17,6,GACCCCGAAGAGGGCATCAA,11,1070856
fldAp,4.571428571428571,37,6,GACAATGGCGTTGATGGTCT,31,1082212
fldAp,1.5714285714285714,16,6,GACAAAACAGTACTTGTGAC,10,1175090
fldAp,0.8571428571428571,11,6,GAATCTGGCCGATTAGCTAT,5,1086009
fldAp,0.2857142857142857,7,6,GAATCCCTAGAAGGTTCGAC,1,1185088
fldAp,2.142857142857143,20,6,GAAGTGACCTCGGCACCAAG,14,1181450
fldAp,10.428571428571429,78,6,GAACGGTTCGGATTCAGATC,72,1097577
fldAp,4.428571428571429,36,6,GAACAGGCATAGCCGGAGGC,30,1095134
fldAp,3.142857142857143,27,6,GAAATTTCCGTGGTCGGGGA,21,1091235
fldAp,1.7142857142857142,17,6,CTTGGTTGTTAGGTCTAGAT,11,1108414
fldAp,6.857142857142857,53,6,CTTGCGGTTATATTTATAAT,47,1090257
fldAp,0.7142857142857143,10,6,CTTGCACACTAGAGGTAATC,4,1152083
fldAp,3.857142857142857,32,6,CTTCTTCATTTGGTACCAGC,26,1076077
fldAp,10.142857142857142,76,6,CTTATGACGGCTTAGCGGGA,70,1156294
fldAp,0.2857142857142857,7,6,CTTATCCTTCCGAGCATAGG,1,1118052
fldAp,0.2857142857142857,7,6,CTTAAAATATGTTGGTTTAA,1,1089890
fldAp,10.428571428571429,78,6,CTGTTTTGTCGCTCCAGTGA,72,1138650
fldAp,0.7142857142857143,10,6,CTGTGTGCGGTAAGTGCTTG,4,1127064
fldAp,0.2857142857142857,7,6,CTGTGGATCAGATGTGAGCA,1,1119756
fldAp,7.428571428571429,57,6,CTGTCGATCTCAGGGGCCTC,51,1185301
fldAp,3.5714285714285716,30,6,CTGTCCGAAAGTAAATCAAG,24,1128181
fldAp,0.2857142857142857,7,6,CTGTCAGAATCCTTAGTTTA,1,1075858
fldAp,4.571428571428571,37,6,CTGTAGCTTTACGTAAAGTC,31,1159345
fldAp,0.2857142857142857,7,6,CTGTACGTGGACCTTCCTGC,1,1076949
fldAp,3.142857142857143,27,6,CTGGTGTGGCCTGTGAAGAT,21,1081933
fldAp,2.7142857142857144,24,6,CTGGTACGGATGAGATATGG,18,1152654
fldAp,0.42857142857142855,8,6,CTGGCTGGGGAGAGATTACT,2,1112333
fldAp,2.7142857142857144,24,6,CTGGACGCGGTTGCGCGCAG,18,1066611
fldAp,7.571428571428571,58,6,CTGCCCGGAGTCGTAAGAGC,52,1114508
fldAp,7.0,54,6,CTGCCCGACCCACAGTGGTT,48,1133739
fldAp,29.571428571428573,212,6,CTGCCATGTGAAAAGACCTA,206,1178649
fldAp,5.857142857142857,46,6,CTGATGCTATAAGCATTGTA,40,1065996
fldAp,3.142857142857143,27,6,CTCTCGGGCGCAGCCTCAGG,21,1141872
fldAp,6.0,47,6,CTCTAGTAACCTTGTAACTT,41,1103964
fldAp,4.0,33,6,CTCGGGTAGCCGTCCATCGG,27,1181958
fldAp,0.2857142857142857,7,6,CTCGGGAGACTCCGCAAAAT,1,1181179
fldAp,9.571428571428571,72,6,CTCCGCCTGGATGGTAGTCA,66,1066271
fldAp,4.285714285714286,35,6,CTCCGATGTCAAAAAAGGCC,29,1119072
fldAp,7.285714285714286,56,6,CTCCCCCAGTCCCTTCTAGG,50,1068755
fldAp,6.571428571428571,51,6,CTCCAGGTAGCATCAGCTGA,45,1084008
fldAp,5.285714285714286,42,6,CTCAGCCTGCATTAAAAGGT,36,1157681
fldAp,5.142857142857143,41,6,CTCACTCCTGAAGTAAGCGT,35,1110606
fldAp,3.5714285714285716,30,6,CTATTCACAAGAAATCCGTG,24,1145193
fldAp,7.0,54,6,CTATGCTGTTTCGCGATTCA,48,1113145
fldAp,0.2857142857142857,7,6,CTATCTACGCCTTGCATGTC,1,1133406
fldAp,0.2857142857142857,7,6,CTATCCTTACCTGAAACCCT,1,1147382
fldAp,4.428571428571429,36,6,CTATAAGCTTTGTGAAGGCT,30,1169911
fldAp,0.7142857142857143,10,6,CTAGTTACCAAATCAGGGCA,4,1142015
fldAp,0.2857142857142857,7,6,CTAGTGGTTCCCTGCGCGAC,1,1157532
fldAp,4.714285714285714,38,6,CTAGATAATAGTCCTACTAA,32,1070144
fldAp,1.2857142857142858,14,6,CGTTTCGGGTTGTACCAGGG,8,1120695
fldAp,2.142857142857143,20,6,CGTTACTTCTATGTTCGGTC,14,1114304
fldAp,4.857142857142857,39,6,CGTGGGGGACTGTTGAGGTC,33,1149943
fldAp,3.0,26,6,CGTGGCTCTATAGTACCTCG,20,1139463
fldAp,2.7142857142857144,24,6,CGTGCCCGGAGTCTTCATTG,18,1115029
fldAp,2.857142857142857,25,6,CGTGAATTTTCCATAGATCG,19,1099458
fldAp,4.285714285714286,35,6,CGTGAATCCCATGTATCACA,29,1163826
fldAp,6.571428571428571,51,6,CGTCGCAGGCTGCAGAGGAT,45,1185522
fldAp,4.571428571428571,37,6,CGTACCACAGTAACCTATTC,31,1121593
fldAp,0.42857142857142855,8,6,CGGTGAGCGGAGACATGTAC,2,1116414
fldAp,5.285714285714286,42,6,CGGTCGGATTATGGGTTAGT,36,1166212
fldAp,7.714285714285714,59,6,CGGTAGACCGAGCCCATATT,53,1183014
fldAp,6.142857142857143,48,6,CGGCTCGGAATGCCGGACTG,42,1151562
fldAp,3.4285714285714284,29,6,CGGCCTAAGGTAAGGCCTAC,23,1180844
fldAp,0.2857142857142857,7,6,CGGAGGCTTAAGCGTGTTTT,1,1089401
fldAp,3.2857142857142856,28,6,CGGAAAAACGTCCAGCAATG,22,1142442
fldAp,7.571428571428571,58,6,CGCCTCCTAAGGTCGTGGGT,52,1176286
fldAp,5.428571428571429,43,6,CGCCGCAATATACAATCGTT,37,1174213
fldAp,2.5714285714285716,23,6,CGCCCGGCTAGCTTGCCACA,17,1138439
fldAp,12.285714285714286,91,6,CGCATTTGGACACTTGTCGT,85,1087857
fldAp,0.42857142857142855,8,6,CGCATAGTTCAATAAGGGGA,2,1146070
fldAp,7.714285714285714,59,6,CGCATAGGCTCACAATCTAA,53,1112370
fldAp,7.714285714285714,59,6,CGCAGGGGGCCAATACAGTA,53,1112754
fldAp,3.142857142857143,27,6,CGATGACCCTGGAATTCAGA,21,1158254
fldAp,3.2857142857142856,28,6,CGATCTCAATCAGCCTCCAA,22,1170276
fldAp,0.2857142857142857,7,6,CGATCGCGTAGGTGGACAGT,1,1067619
fldAp,0.2857142857142857,7,6,CGATCAGGTCTAGTAGCTTT,1,1074849
fldAp,3.5714285714285716,30,6,CGAGTGTCTGTTCTGAATCA,24,1144703
fldAp,2.2857142857142856,21,6,CGAGGATCGTCACGAGCTAT,15,1154068
fldAp,4.0,33,6,CGACGTGAATTTCAAGACAT,27,1106137
fldAp,8.571428571428571,65,6,CGACGTACTTCGAGACCCCT,59,1178638
fldAp,7.571428571428571,58,6,CGAATGGTTTCAAACACTGC,52,1135005
fldAp,0.5714285714285714,9,6,CCTTTGACTCGCTCCTAAGA,3,1068552
fldAp,3.7142857142857144,31,6,CCTTCACGCAATAGTGAAGG,25,1126406
fldAp,0.2857142857142857,7,6,CCTTAGCACTGAATTACTAC,1,1079835
fldAp,8.142857142857142,62,6,CCTGTTCTATGGCTGCAACT,56,1180439
fldAp,19.142857142857142,139,6,CCTGAAATTCCTGGCTTCCC,133,1084530
fldAp,0.2857142857142857,7,6,CCTGAAAGTGCGGTCGTGCT,1,1076169
fldAp,3.4285714285714284,29,6,CCTCGGAAGTTAATAGGCCA,23,1141988
fldAp,3.5714285714285716,30,6,CCTCACCCGGCGGTCACTCT,24,1083579
fldAp,2.142857142857143,20,6,CCTAGCTCCCTACAACTGAA,14,1104279
fldAp,7.0,54,6,CCTAATTTGACGTGGTACCT,48,1075155
fldAp,7.428571428571429,57,6,CCTAAACTGTGTTACCCAAA,51,1096329
fldAp,2.7142857142857144,24,6,CCGTCTCGGGATGTGGTCAT,18,1132911
fldAp,4.0,33,6,CCGTACTACAAGGCGGCATG,27,1127723
fldAp,5.285714285714286,42,6,CCGGTCCTACGGGGCAAGCT,36,1166200
fldAp,1.4285714285714286,15,6,CCGGTAGCTCCTAACAAACT,9,1123975
fldAp,0.2857142857142857,7,6,CCGGCCAAATACCGGAGACC,1,1064675
fldAp,34.857142857142854,249,6,CCGCTTCTGATGCTGCCGTA,243,1186654
fldAp,2.2857142857142856,21,6,CCGCTTATTTCTCTATCGAC,15,1186254
fldAp,0.2857142857142857,7,6,CCGCTGAGTCATATTTCGGC,1,1177787
fldAp,2.857142857142857,25,6,CCGCGGCGTAGAGACGTCAC,19,1064145
fldAp,13.428571428571429,99,6,CCGCGGATTACTATGGACTG,93,1126221
fldAp,6.571428571428571,51,6,CCGCGACGACTTATTATTTT,45,1138415
fldAp,1.4285714285714286,15,6,CCGCCTTGGCAAGTTCACAG,9,1135212
fldAp,11.285714285714286,84,6,CCGCCGAGGCTTGCATCGTT,78,1139232
fldAp,5.142857142857143,41,6,CCGATGCCGTGAATCGTTAG,35,1126111
fldAp,4.0,33,6,CCGAGGTCCCTGAACCGATT,27,1166176
fldAp,3.142857142857143,27,6,CCGAGACTGAGTATGGTGCA,21,1134135
fldAp,2.5714285714285716,23,6,CCGACCCCTCGCATGGGGAA,17,1103457
fldAp,0.2857142857142857,7,6,CCGACCATAGCCATAGGGAC,1,1077856
fldAp,3.7142857142857144,31,6,CCCTGTTCGGGATGGCCCAG,25,1072405
fldAp,3.0,26,6,CCCTGAGAGGAGTAAGTGTG,20,1164941
fldAp,4.0,33,6,CCCGTTTTGACTCCATCGGT,27,1086757
fldAp,2.0,19,6,CCCGTGCAGGGGTGGTGCGA,13,1088804
fldAp,5.428571428571429,43,6,CCCGGTGGACTCGCAGAGAT,37,1093450
fldAp,2.857142857142857,25,6,CCCGCCAAATGTGGTTACCC,19,1156118
fldAp,0.5714285714285714,9,6,CCCCTTAAAGCTCCCTTGTG,3,1076379
fldAp,3.857142857142857,32,6,CCCCATACTGGTCCCCTTCC,26,1092564
fldAp,1.2857142857142858,14,6,CCCCACTTAACTTATGTTTA,8,1115819
fldAp,0.2857142857142857,7,6,CCCATATGCTAAGGCGTAAA,1,1150273
fldAp,6.142857142857143,48,6,CCATTCCGGACTTGGGGCGG,42,1115047
fldAp,3.5714285714285716,30,6,CCATCCAAGGCCTCAGGAAG,24,1165269
fldAp,14.285714285714286,105,6,CCATAATATAGGCCAGTACA,99,1167394
fldAp,2.5714285714285716,23,6,CCAGCACGACACCTCGGGTC,17,1182037
fldAp,3.2857142857142856,28,6,CCAGATATGTGTGGGCACCG,22,1100747
fldAp,9.142857142857142,69,6,CCACGTCGGCATGTATATGG,63,1143544
fldAp,2.5714285714285716,23,6,CCAATGAATCTACTGCGTTA,17,1125412
fldAp,2.7142857142857144,24,6,CCAACTGGCATTCGACGTCG,18,1085052
fldAp,5.285714285714286,42,6,CCAACACGTTCCACAGACGA,36,1070539
fldAp,3.2857142857142856,28,6,CATTAGTACTGGCGCACCTA,22,1181043
fldAp,16.571428571428573,121,6,CATTAGGCGTTCTCTAGCCA,115,1088192
fldAp,0.2857142857142857,7,6,CATGGTCGTTCACTTGGAGA,1,1090713
fldAp,0.2857142857142857,7,6,CATGGGGAGGCCCCCCGTCC,1,1176643
fldAp,3.857142857142857,32,6,CATCCTTGAGTGCCGGAAAA,26,1107299
fldAp,3.0,26,6,CATCCGGGTATGGCAGCCAT,20,1120045
fldAp,4.0,33,6,CATACTGACATAATATTAGA,27,1070177
fldAp,0.2857142857142857,7,6,CAGTTACGACTCTCAACATT,1,1148297
fldAp,3.5714285714285716,30,6,CAGTCAACCGGGGTCCTATT,24,1079200
fldAp,4.0,33,6,CAGTATTTCCACGGGGGAGG,27,1162810
fldAp,4.428571428571429,36,6,CAGTAGCCGATCAGGGTGGA,30,1165995
fldAp,5.0,40,6,CAGCTTCCAACGAAAAGTGG,34,1088488
fldAp,3.2857142857142856,28,6,CAGCGTGCATGGTTGGATGG,22,1144482
fldAp,3.857142857142857,32,6,CAGCGCTGGACGCGCATGAT,26,1179222
fldAp,0.2857142857142857,7,6,CAGACAGCGCCCTCATAGAA,1,1071533
fldAp,4.0,33,6,CAGAACCCTGGTTCTGCGAA,27,1113411
fldAp,3.4285714285714284,29,6,CACTTCAATTATCTCCCCAC,23,1128046
fldAp,0.2857142857142857,7,6,CACTCACATCGGACGCCCGG,1,1065242
fldAp,0.5714285714285714,9,6,CACGTCGATGTGCCATAGAC,3,1132617
fldAp,9.285714285714286,70,6,CACCTATCAATCTTGATTGA,64,1066741
fldAp,11.142857142857142,83,6,CACCTAGGTGCATGTGATGA,77,1080410
fldAp,3.5714285714285716,30,6,CACCATAATAACACAGTTCT,24,1159997
fldAp,0.42857142857142855,8,6,CACAGCCTCAATTTGAACCA,2,1099619
fldAp,3.7142857142857144,31,6,CAATCGCCGCGACTCCTGGT,25,1140982
fldAp,0.2857142857142857,7,6,CAATCCTGGTCAAGGCAAAT,1,1093090
fldAp,4.142857142857143,34,6,CAAGGCTGAGCGGCAGACCT,28,1158810
fldAp,6.571428571428571,51,6,CAAGCCTCTCACTGTGAGTT,45,1108073
fldAp,1.1428571428571428,13,6,CAAGATCGATTGAAGTCATT,7,1178254
fldAp,5.428571428571429,43,6,CAACGTGTCGGCGACAGTAC,37,1126381
fldAp,9.428571428571429,71,6,CAAAGACGGTATCGTCCGAA,65,1119155
fldAp,2.2857142857142856,21,6,ATTTGGTGGCACCGCGTTAG,15,1090993
fldAp,4.142857142857143,34,6,ATTTGCGCTATATTTCGCCT,28,1124284
fldAp,5.714285714285714,45,6,ATTTCGGTGCTCCGAGTTTA,39,1086542
fldAp,0.42857142857142855,8,6,ATTGTTACCGATGGTTCAAA,2,1172715
fldAp,4.0,33,6,ATTGGGTCACCGCCCTTTAT,27,1155883
fldAp,3.5714285714285716,30,6,ATTGCCAAATGCGTCCAGGC,24,1099776
fldAp,1.4285714285714286,15,6,ATTCGGACGGAGTAGGACCC,9,1133945
fldAp,7.0,54,6,ATTCGCTGGGCCTACCATAT,48,1134524
fldAp,5.285714285714286,42,6,ATTATTGGACACACGTCCAA,36,1104795
fldAp,4.857142857142857,39,6,ATTACCCCTACACTTTCGCA,33,1175599
fldAp,0.2857142857142857,7,6,ATGTCCCCCTAGGCACCTAA,1,1083027
fldAp,4.285714285714286,35,6,ATGTATCGTATATGGGAGAA,29,1088150
fldAp,3.2857142857142856,28,6,ATGGTGTTGCCGTAGTCGGA,22,1140781
fldAp,1.1428571428571428,13,6,ATGGGGTCCAAACAAGTCAT,7,1172351
fldAp,7.285714285714286,56,6,ATGCACTGTGCCTGGCGGCA,50,1132670
fldAp,2.0,19,6,ATGAGGTAGGAATGGGGGAA,13,1071052
fldAp,4.0,33,6,ATGAAGGTATAGAGATATTC,27,1086493
fldAp,5.285714285714286,42,6,ATCGTGTGCTCGGTATTACT,36,1124078
fldAp,9.428571428571429,71,6,ATCGTAAGAGAGTTTCAGCG,65,1180440
fldAp,7.142857142857143,55,6,ATCGCGTCCAAACAGATCAG,49,1137959
fldAp,2.5714285714285716,23,6,ATCCCATGTCACGTTCTCAT,17,1148202
fldAp,1.8571428571428572,18,6,ATCCCACCCAGCCGGTTCTG,12,1167559
fldAp,4.285714285714286,35,6,ATCATCGTGGACATTAGCCC,29,1152596
fldAp,0.7142857142857143,10,6,ATCAATACTAATTACTTTGA,4,1186689
fldAp,7.428571428571429,57,6,ATAGTGTACAGTCAGTTGAG,51,1074782
fldAp,6.571428571428571,51,6,ATAGGGGCTCTAAGAGCACT,45,1074311
fldAp,1.2857142857142858,14,6,ATAGCGTTAACAGGTTGAGG,8,1125797
fldAp,6.0,47,6,ATAGAGGACCATTAAAGGGG,41,1139346
fldAp,3.5714285714285716,30,6,ATAGACGATGGGGTGCGCAT,24,1108633
fldAp,5.142857142857143,41,6,ATAATTCGAGATTAGCTGGG,35,1110201
fldAp,0.2857142857142857,7,6,ATAAGGCCACAACAGATTCT,1,1173226
fldAp,3.857142857142857,32,6,ATAAACACCGGTGGCGGGAA,26,1108112
fldAp,0.2857142857142857,7,6,ATAAACACATATAGATAGGC,1,1184567
fldAp,11.285714285714286,84,6,AGTTTGGAACAGCGTGAGGT,78,1132573
fldAp,4.714285714285714,38,6,AGTTTAAGATGTAGAAAGAC,32,1155008
fldAp,3.4285714285714284,29,6,AGTTATTAATGGGTGCTAAT,23,1138513
fldAp,4.857142857142857,39,6,AGTGTTTCTTGTGGGGTTTG,33,1109322
fldAp,0.2857142857142857,7,6,AGTGCGGCGTCAATCCGGAT,1,1163290
fldAp,4.142857142857143,34,6,AGTGAAAAACTGACATTAAC,28,1156198
fldAp,5.142857142857143,41,6,AGTCTTATCAACAGAATGAT,35,1157303
fldAp,6.0,47,6,AGTCTAATGCTGCAGAGCGT,41,1166660
fldAp,1.2857142857142858,14,6,AGTCGTGTCACGGCCGAGGC,8,1064036
fldAp,5.285714285714286,42,6,AGTCGGCGTTTTTACGTCTG,36,1092128
fldAp,5.0,40,6,AGTAGGACACGACCCTAGTG,34,1103728
fldAp,4.714285714285714,38,6,AGTAGAGGATAGTAAGTATG,32,1159420
fldAp,1.1428571428571428,13,6,AGTACCCTAGACCCCTACGG,7,1144335
fldAp,2.7142857142857144,24,6,AGTAAGTGACAACGGTTCCG,18,1127807
fldAp,2.0,19,6,AGTAACTCGCAACGTGCGAA,13,1093048
fldAp,0.2857142857142857,7,6,AGGTTGTCCGGTGGACCCCC,1,1111747
fldAp,2.0,19,6,AGGTATCTCGGATACATTAC,13,1089302
fldAp,3.5714285714285716,30,6,AGGTAATTGGGACCGATTAG,24,1116286
fldAp,3.7142857142857144,31,6,AGGGGACACCTCGCACGCGT,25,1096187
fldAp,4.857142857142857,39,6,AGGGAATAGTACATCGGCTG,33,1178474
fldAp,5.714285714285714,45,6,AGGCTGCGGCGGTGCCTTTC,39,1127328
fldAp,9.0,68,6,AGGCGCGTTCAGTTGACAAT,62,1134670
fldAp,7.285714285714286,56,6,AGGATCAGGTCTGTCTCGTG,50,1105967
fldAp,2.7142857142857144,24,6,AGGAACACGCAATGCTACGG,18,1134610
fldAp,13.285714285714286,98,6,AGCTGTGCAAATTGGATTTT,92,1154918
fldAp,9.571428571428571,72,6,AGCTGAGCGACAGACATTGG,66,1127395
fldAp,0.2857142857142857,7,6,AGCTAACGTACACGGCCCTA,1,1082324
fldAp,5.714285714285714,45,6,AGCGGGGAGGACTGCCCAAC,39,1096703
fldAp,5.857142857142857,46,6,AGCGGCTGCCAGAGCAGGGT,40,1112343
fldAp,13.714285714285714,101,6,AGCCTAGACAGAGGGTATTG,95,1063687
fldAp,3.2857142857142856,28,6,AGCCTACAAATTTCATTAAC,22,1154897
fldAp,12.857142857142858,95,6,AGCCGAGCGTATAAGACCAG,89,1137643
fldAp,12.428571428571429,92,6,AGCCCTCTCTGGTTTTCCTT,86,1073337
fldAp,6.857142857142857,53,6,AGCAGGTTCACTCGAATGAA,47,1102948
fldAp,26.857142857142858,193,6,AGATGGAGTGACAGCGAATC,187,1165471
fldAp,0.2857142857142857,7,6,AGAGTCAGCAGCAGTCATTA,1,1080308
fldAp,1.7142857142857142,17,6,AGAGTCACCTCGATGCGTTG,11,1074648
fldAp,7.285714285714286,56,6,AGACTCGTGTGTACGGTGCC,50,1081644
fldAp,3.0,26,6,AGACGAAATCACATGGGTCT,20,1135318
fldAp,1.2857142857142858,14,6,AGACATTTGTGCGAGCCCCT,8,1069726
fldAp,0.5714285714285714,9,6,AGAAAGCACACAGCGGCTGG,3,1156199
fldAp,3.2857142857142856,28,6,AGAAACATTGTGCATTTTGA,22,1121882
fldAp,7.285714285714286,56,6,ACTTTCGAAAACGGATCATT,50,1119701
fldAp,4.142857142857143,34,6,ACTGGGGTCGTCTAAGTATT,28,1136613
fldAp,5.857142857142857,46,6,ACTGGAGTTACTTATTGGTT,40,1072083
fldAp,3.5714285714285716,30,6,ACTCGAGATTCCCATCAACC,24,1104191
fldAp,0.2857142857142857,7,6,ACTATAGATAGTTCTCACTA,1,1133515
fldAp,0.2857142857142857,7,6,ACGTTAGGTATGTGAGCGGT,1,1093019
fldAp,3.2857142857142856,28,6,ACGTCCCAACGCTTTATGCA,22,1164734
fldAp,5.0,40,6,ACGGAAATATGCGGTTATAA,34,1140337
fldAp,2.5714285714285716,23,6,ACGCACATTCTACTCATTCT,17,1165270
fldAp,4.0,33,6,ACGAGAAAGAATAAGTTCGC,27,1110366
fldAp,5.428571428571429,43,6,ACGACGGTGGGGCGCTTATT,37,1082300
fldAp,2.857142857142857,25,6,ACGACAGGCGGAAAAGGCGA,19,1111394
fldAp,0.5714285714285714,9,6,ACGAAGCATCTGCGGTTTGC,3,1182008
fldAp,2.2857142857142856,21,6,ACCGTGTATTTAATTTGCTC,15,1114585
fldAp,3.7142857142857144,31,6,ACCGGTCCAATTTCAGGGTC,25,1122792
fldAp,0.2857142857142857,7,6,ACCGCGTCCCGATTGTTGGT,1,1097649
fldAp,0.2857142857142857,7,6,ACCGCCCGTTCGTACACTCT,1,1101381
fldAp,5.428571428571429,43,6,ACCGACTTGCTGAATCTGAA,37,1152565
fldAp,0.2857142857142857,7,6,ACCCAGAACGAACTGTACAG,1,1171450
fldAp,8.857142857142858,67,6,ACCATTGGCCTTCTCGTCTC,61,1149574
fldAp,6.142857142857143,48,6,ACCACAAGTGCCGCGACAAC,42,1145646
fldAp,0.2857142857142857,7,6,ACACTCCGTTAGTCATAGTG,1,1085797
fldAp,6.428571428571429,50,6,ACACGAGTATTGGTTTTTAG,44,1081759
fldAp,0.5714285714285714,9,6,ACAATTGAAGTAAACGGAGG,3,1110406
fldAp,0.2857142857142857,7,6,ACAATCGATCGCCGAGTATG,1,1093779
fldAp,0.8571428571428571,11,6,ACAAGGGTCTTTTTCGTACT,5,1186840
fldAp,6.0,47,6,ACAACAGGTAAAGTTGACGT,41,1148708
fldAp,3.142857142857143,27,6,ACAACAGCTGTTGAGTCACT,21,1165594
fldAp,4.0,33,6,AATGTCATATGAGTGCCCCC,27,1168040
fldAp,2.0,19,6,AATGCGCGCGTAGTGAGGGG,13,1166666
fldAp,5.285714285714286,42,6,AATCTGACAGGCCTGTTACT,36,1109341
fldAp,0.42857142857142855,8,6,AATATTTCACATAAGCTGTG,2,1147550
fldAp,3.5714285714285716,30,6,AATACGGATTACAGAGATCA,24,1137371
fldAp,4.714285714285714,38,6,AAGTTCCACTAAACCGGAGA,32,1168214
fldAp,1.1428571428571428,13,6,AAGTCTGACCTAACACAGTT,7,1138587
fldAp,7.428571428571429,57,6,AAGGTTTGGTTCATCTAGAA,51,1137288
fldAp,0.2857142857142857,7,6,AAGGCAATCCCGATGCCGAA,1,1123379
fldAp,4.428571428571429,36,6,AAGGATTCAATAATCTAGGT,30,1149158
fldAp,0.2857142857142857,7,6,AAGCGGAATCACGGTCTGTC,1,1162483
fldAp,0.5714285714285714,9,6,AAGATTATACTTGTTGTAAT,3,1181191
fldAp,1.5714285714285714,16,6,AAGAGGTGAACCACGACTAG,10,1092368
fldAp,8.428571428571429,64,6,AAGAGGCAGGCGATCACGTT,58,1118420
fldAp,0.2857142857142857,7,6,AAGAGCCAGCCAGTATACAT,1,1075323
fldAp,3.2857142857142856,28,6,AAGACGAAGGGAGTTCTAAT,22,1163377
fldAp,2.857142857142857,25,6,AACTTTCAGAGTAATGATGA,19,1138194
fldAp,6.857142857142857,53,6,AACTGCCCGCTCGCTTTCAT,47,1110333
fldAp,2.7142857142857144,24,6,AACGTAGGTCCCGGTCTGGT,18,1164136
fldAp,2.4285714285714284,22,6,AACGACTTGGATTGTGTACA,16,1142923
fldAp,5.857142857142857,46,6,AACCTGGTCGCGCGGGTTAA,40,1130660
fldAp,17.142857142857142,125,6,AACCCCGCCAAGTTAAGAGC,119,1146662
fldAp,2.5714285714285716,23,6,AACCAAGGTCTTTGTTCAGC,17,1183480
fldAp,4.857142857142857,39,6,AACATGGGTTCCCGTTGGGT,33,1108096
fldAp,5.285714285714286,42,6,AACATACTTCTAGAGTTAAT,36,1070876
fldAp,3.857142857142857,32,6,AACACCCAAGAGCAAAGGAC,26,1117009
fldAp,3.5714285714285716,30,6,AACAACAACATTTCGGTTGC,24,1102848
fldAp,2.4285714285714284,22,6,AAATAGCTGGTTGTCTGATA,16,1128645
fldAp,4.571428571428571,37,6,AAAGTATTTCTTTGGGGCGG,31,1179353
fldAp,6.285714285714286,49,6,AAACTGAATAAAGCGTGAGC,43,1103597
fldAp,0.3333333333333333,6,5,TTTTGAAACGGCCGAGAAAC,1,1081063
fldAp,5.166666666666667,35,5,TTTTATGCTTCACAGGGTCA,30,1146585
fldAp,6.0,40,5,TTTGTATGGTAATGATCAAC,35,1073389
fldAp,4.5,31,5,TTTCGTGGGCTTGCCAAAAG,26,1179550
fldAp,2.8333333333333335,21,5,TTTCGGATTCTACGCCTAAC,16,1157613
fldAp,0.3333333333333333,6,5,TTTCCTTTTCTAGAAGCGAT,1,1148410
fldAp,4.833333333333333,33,5,TTTCCGTGTAGCTTAATACG,28,1159206
fldAp,11.333333333333334,72,5,TTTAGTTTAAGAAGCAACGA,67,1164785
fldAp,15.5,97,5,TTTAGTTATCGCCCGCTGCC,92,1111368
fldAp,8.0,52,5,TTTAGCTTTCTACGAGACCT,47,1113657
fldAp,3.3333333333333335,24,5,TTTAATTCGTAATTTCGATG,19,1118103
fldAp,5.166666666666667,35,5,TTGTGCAATGCAGGATTTAT,30,1186491
fldAp,0.3333333333333333,6,5,TTGTCGCTTCCCAGCTATAT,1,1071931
fldAp,1.6666666666666667,14,5,TTGGTTCTTCGAGCTCATCT,9,1103168
fldAp,9.666666666666666,62,5,TTGGGGGACTTGCGTGGCGT,57,1133828
fldAp,1.6666666666666667,14,5,TTGGATGAGGGTGCGTTACC,9,1074586
fldAp,0.3333333333333333,6,5,TTGGAGAGGGTGTCTTGGTT,1,1067707
fldAp,11.666666666666666,74,5,TTGCTCGTATAGTGCTTAAT,69,1063304
fldAp,0.3333333333333333,6,5,TTGCTATTCGTGACGACTTT,1,1087130
fldAp,11.0,70,5,TTGCTAATCGCTTATGAATT,65,1067690
fldAp,2.6666666666666665,20,5,TTGCGCCTCGTTTCCATCAC,15,1088151
fldAp,21.833333333333332,135,5,TTGAGTCTCGGCATCATGCA,130,1066048
fldAp,7.833333333333333,51,5,TTGACCGCCAACTTCGCTTG,46,1081997
fldAp,1.5,13,5,TTGACAGTAGTACTTATGAT,8,1117740
fldAp,2.8333333333333335,21,5,TTGAATTAATTCCGGGGTTC,16,1076667
fldAp,4.833333333333333,33,5,TTGAAGGTCTGCTAAGTGTC,28,1123252
fldAp,0.3333333333333333,6,5,TTCTATCTCAGTCGTGGCCA,1,1076912
fldAp,3.6666666666666665,26,5,TTCGTGCCACTTCCCACCTC,21,1074448
fldAp,7.666666666666667,50,5,TTCGGAAGTACCGACTATCA,45,1088398
fldAp,1.6666666666666667,14,5,TTCGCTGATTTCACAGCTTG,9,1181322
fldAp,7.833333333333333,51,5,TTCGCGGTTTCGGGAGAGTT,46,1151278
fldAp,3.1666666666666665,23,5,TTAGTGCCAAACCCAAGATC,18,1108324
fldAp,6.333333333333333,42,5,TTAGATATACAAACTTCTAT,37,1131562
fldAp,0.3333333333333333,6,5,TTACTTGGTGTCCAATAGGT,1,1149465
fldAp,14.833333333333334,93,5,TTACGTCACACACGCTGCGG,88,1107658
fldAp,2.1666666666666665,17,5,TTACATGCGTTTCTTATCAC,12,1063360
fldAp,3.3333333333333335,24,5,TTAACCATCTTTCAGCGCTG,19,1078748
fldAp,2.8333333333333335,21,5,TTAAACCTCCATTGTCTGTA,16,1088425
fldAp,3.3333333333333335,24,5,TTAAAAGCCGCGGCAACGGT,19,1165264
fldAp,3.1666666666666665,23,5,TGTTAGCCTACGCGCTCGTA,18,1089936
fldAp,0.3333333333333333,6,5,TGTCCTGACCCTGGTTCAGG,1,1125182
fldAp,4.0,28,5,TGTCCCAGCTACAGAAGATC,23,1097897
fldAp,5.666666666666667,38,5,TGTCATGGTTTGAAACTCTG,33,1076060
fldAp,1.6666666666666667,14,5,TGTCAGGCTGGGCTCAGTAC,9,1168613
fldAp,13.166666666666666,83,5,TGTAGCGCTGGGGTGGCCGC,78,1140483
fldAp,2.8333333333333335,21,5,TGTAGCCAGAACAATGTCCT,16,1149524
fldAp,3.6666666666666665,26,5,TGTACTCGGATGCCCTCGGA,21,1172498
fldAp,0.3333333333333333,6,5,TGGTTGCTATGCCGGCTAAC,1,1067784
fldAp,3.1666666666666665,23,5,TGGTTAAGGGAGAAGACATC,18,1067617
fldAp,7.0,46,5,TGGTGGGAATTGATCGTCCG,41,1119464
fldAp,1.8333333333333333,15,5,TGGTCTAGGGAATTCAAGGT,10,1146885
fldAp,5.333333333333333,36,5,TGGTCGTAAATTATCCAATG,31,1086008
fldAp,0.3333333333333333,6,5,TGGTATAACATTTAGCTGCC,1,1169546
fldAp,0.3333333333333333,6,5,TGGGTTGTGTGTGGCTATAA,1,1147981
fldAp,14.666666666666666,92,5,TGGGCCGATGTGACCCGGTT,87,1118370
fldAp,2.8333333333333335,21,5,TGGGAGGGTGTGTATGTAGA,16,1150037
fldAp,6.666666666666667,44,5,TGGGACCTTACATGAGACCG,39,1158776
fldAp,4.5,31,5,TGGCAGTTCGCCCCTGCCGT,26,1147001
fldAp,16.0,100,5,TGGATCATGGAATAATAGTC,95,1135306
fldAp,5.0,34,5,TGGACGGGCAATAAAAAACA,29,1104493
fldAp,4.166666666666667,29,5,TGCTTTTGGTTGTAGAGGCT,24,1097064
fldAp,5.0,34,5,TGCTTCCGGGCAAAGTGCCC,29,1065060
fldAp,0.3333333333333333,6,5,TGCGGGAACGTTGCCCCAGA,1,1159634
fldAp,6.0,40,5,TGCCTGGTAGCCGTTCCACG,35,1173297
fldAp,3.5,25,5,TGCCACGTCTGGTAACCACA,20,1113397
fldAp,6.0,40,5,TGCCACAGTGCAGAAACATT,35,1086472
fldAp,0.3333333333333333,6,5,TGCATTGCCGATACTTAAAT,1,1138244
fldAp,24.833333333333332,153,5,TGCACGACACTGTGTCACTC,148,1126545
fldAp,0.3333333333333333,6,5,TGCAACCGTGTGCGAATTCT,1,1119692
fldAp,5.5,37,5,TGATTACAACTACGCCCACA,32,1181459
fldAp,12.833333333333334,81,5,TGAGAGTCAAGCAGCTCTCG,76,1109622
fldAp,1.8333333333333333,15,5,TGACGCCCGGTAACACACTC,10,1096042
fldAp,4.833333333333333,33,5,TCTTGTACAAGATTTACTCC,28,1140900
fldAp,2.0,16,5,TCTGTCCACGCTCGCGAGTT,11,1154185
fldAp,3.0,22,5,TCTGGAATACTGGGACCGTT,17,1161840
fldAp,4.833333333333333,33,5,TCTCGGCTCTTCCGTGCATA,28,1069994
fldAp,5.833333333333333,39,5,TCTATATATATAGAGAAAGG,34,1126653
fldAp,4.166666666666667,29,5,TCTACTACTTGCAAAATACG,24,1092301
fldAp,3.3333333333333335,24,5,TCTAACTAGCGCCATCAGCC,19,1117737
fldAp,4.333333333333333,30,5,TCTAACAGTAAGATTCACAA,25,1132338
fldAp,7.333333333333333,48,5,TCTAAAATCGCGTTCCGGAG,43,1135676
fldAp,3.0,22,5,TCGTGCAATCCCTGCCACCA,17,1085349
fldAp,6.333333333333333,42,5,TCGTCATCGACGGGTAGGTA,37,1105859
fldAp,5.333333333333333,36,5,TCGGTAAGCTTTGTAAGTCG,31,1092103
fldAp,14.833333333333334,93,5,TCGGGACATATATAGGCGAT,88,1078160
fldAp,4.0,28,5,TCGGATTGACCCAGACCATC,23,1093293
fldAp,4.166666666666667,29,5,TCGGAGACAATGGGTAGGAG,24,1118626
fldAp,7.0,46,5,TCGCGCAAGCCCTTCCCGCT,41,1063043
fldAp,3.5,25,5,TCGATACTACTATCCCAAGC,20,1097845
fldAp,3.5,25,5,TCGAAGCTCGATTGGGTACT,20,1160343
fldAp,31.5,193,5,TCCTTGCTTGGTCTCTGTTA,188,1082576
fldAp,43.333333333333336,264,5,TCCTTGCTGAGTACGTTCGC,259,1114225
fldAp,6.333333333333333,42,5,TCCTGGCCAATTTCCCCACG,37,1121066
fldAp,0.3333333333333333,6,5,TCCTCTCATTGCACGTATGG,1,1145996
fldAp,0.5,7,5,TCCTCCCCTGTTGTGAAGGG,2,1114592
fldAp,2.5,19,5,TCCGGGCTCTAAGCACTCGC,14,1127022
fldAp,0.3333333333333333,6,5,TCCGCCATACTTTCTAAGGA,1,1163807
fldAp,0.3333333333333333,6,5,TCCGATTTTCGGTGCGCCGG,1,1093692
fldAp,8.333333333333334,54,5,TCCAGAGGCGTGTCTGCGTC,49,1121098
fldAp,1.8333333333333333,15,5,TCATTCAGAGCTCTGGCGCC,10,1088730
fldAp,11.0,70,5,TCATGGTTCACGTATTCTGA,65,1077842
fldAp,4.0,28,5,TCATATTTGGCATGTAGCGT,23,1111152
fldAp,1.0,10,5,TCAGAGCAGCGTTCTATCTT,5,1098741
fldAp,6.166666666666667,41,5,TCAGAACATGTGGACGGAGG,36,1132707
fldAp,5.333333333333333,36,5,TCACGACAGGCTTCATCGGG,31,1130868
fldAp,9.166666666666666,59,5,TCACCTTCATATTCGGCTGC,54,1182941
fldAp,9.5,61,5,TCAAAGCAGGACGTCTTTGG,56,1114123
fldAp,5.833333333333333,39,5,TATTTTCTCGTGACATGAGC,34,1082462
fldAp,0.3333333333333333,6,5,TATTTACCGGGGATGACGGC,1,1174314
fldAp,7.0,46,5,TATTGGCACGTTCGCAGATC,41,1137806
fldAp,0.3333333333333333,6,5,TATTGATAGAGACGTCATAA,1,1091597
fldAp,4.5,31,5,TATTACGAGATCCCGAAGGA,26,1096261
fldAp,3.3333333333333335,24,5,TATGTTATTTGCGGAGAGCT,19,1070976
fldAp,4.666666666666667,32,5,TATGTTAGGGTTGGAGGTGT,27,1147279
fldAp,6.166666666666667,41,5,TATGGCAGTGGGGACGAATA,36,1178103
fldAp,2.0,16,5,TATGGAGTACCCAATTGTTC,11,1072877
fldAp,3.3333333333333335,24,5,TATGACAGTACGGTGTGAAA,19,1113963
fldAp,24.0,148,5,TATCGTTCCCCGGATATGCT,143,1166687
fldAp,4.166666666666667,29,5,TATCGGCTAACAGTCGTATT,24,1113309
fldAp,4.5,31,5,TATCGATCTATGCATCGTTA,26,1150467
fldAp,3.3333333333333335,24,5,TATAAAATAGTAACATATTG,19,1097097
fldAp,7.833333333333333,51,5,TAGGTTTCGTAACATGGCCA,46,1164514
fldAp,5.5,37,5,TAGGCATACTAGGGTCAGAA,32,1168162
fldAp,0.3333333333333333,6,5,TAGCGTTCGAATCTGGACAC,1,1138914
fldAp,3.0,22,5,TAGCCGCCCATCTACTAGAA,17,1127860
fldAp,4.5,31,5,TAGATATACTCATTCTCTCC,26,1162486
fldAp,3.6666666666666665,26,5,TAGAGAAGGAAACACGGCAT,21,1128280
fldAp,8.166666666666666,53,5,TACTGGTAGCCTTCCAACCC,48,1178909
fldAp,5.333333333333333,36,5,TACTCGACGATAGGAGCCAG,31,1146655
fldAp,1.5,13,5,TACTAGATCTCGAGGTTGCG,8,1080273
fldAp,8.833333333333334,57,5,TACGGGGCTCCATAAAATGC,52,1124362
fldAp,3.1666666666666665,23,5,TACGAGTTAGAAAGGGTCAT,18,1078064
fldAp,4.833333333333333,33,5,TACCGCTGGGTTAGGCGTAT,28,1070957
fldAp,0.3333333333333333,6,5,TACAAAGCAGAAAGCATGTC,1,1109524
fldAp,0.3333333333333333,6,5,TACAAAAGCATGCTAACTCA,1,1078645
fldAp,8.833333333333334,57,5,TAATACGCAAGCCAAATCAC,52,1154916
fldAp,2.0,16,5,TAAGTTCCGTATCATCCTTG,11,1171046
fldAp,0.3333333333333333,6,5,TAAGTAATGGATGGGGCAGA,1,1171289
fldAp,1.3333333333333333,12,5,TAAGGCCTTGTGCCGAAGGA,7,1115044
fldAp,3.1666666666666665,23,5,TAAGCAGCTAAGACTCGCGA,18,1155691
fldAp,0.3333333333333333,6,5,TAACATTAAGAGATAGATTA,1,1148800
fldAp,0.3333333333333333,6,5,TAACAAGGGAGGGATTTGTT,1,1169554
fldAp,9.333333333333334,60,5,TAAAATAACATAGAAAGTTT,55,1115497
fldAp,4.333333333333333,30,5,GTTTTTTCATCCAATGAATG,25,1152950
fldAp,5.833333333333333,39,5,GTTTTTCCAGAAGTCTAGGT,34,1141391
fldAp,10.833333333333334,69,5,GTTTGGTATTTTAGATACAT,64,1062981
fldAp,6.833333333333333,45,5,GTTTACCTGCGCGTACTTCT,40,1077212
fldAp,0.3333333333333333,6,5,GTTGTGAAAGGGCGAGCTCT,1,1106880
fldAp,1.3333333333333333,12,5,GTTGTCTATTCCTGGGAGAC,7,1082410
fldAp,9.666666666666666,62,5,GTTGGACGCGGGATCTTACA,57,1080275
fldAp,0.3333333333333333,6,5,GTTGCGTGCCGGCAGTCTAC,1,1147102
fldAp,4.666666666666667,32,5,GTTGCGTGAGGCATCATGAT,27,1126442
fldAp,3.3333333333333335,24,5,GTTAACTCCCAACACTAAAA,19,1094262
fldAp,4.833333333333333,33,5,GTGTTGAGAGGAAGCCGCGC,28,1110588
fldAp,1.8333333333333333,15,5,GTGTTCTGACTGTAGCCTCA,10,1115352
fldAp,0.6666666666666666,8,5,GTGTAAAATCAGGCTGGTTG,3,1168144
fldAp,7.833333333333333,51,5,GTGGGGCTTATTTTACTAAA,46,1139673
fldAp,3.1666666666666665,23,5,GTGGAGTTACGCGGCATAGC,18,1114314
fldAp,0.3333333333333333,6,5,GTGCTACCGTGGACGGCCAC,1,1089958
fldAp,4.333333333333333,30,5,GTGCGAGACGGTTTATTGGA,25,1148652
fldAp,4.666666666666667,32,5,GTGATACGTATCTGACGAGC,27,1183176
fldAp,5.166666666666667,35,5,GTCTTGCAAACGCCACGGTA,30,1070522
fldAp,6.166666666666667,41,5,GTCGCTGGTCCTGGCTAGAA,36,1154175
fldAp,0.3333333333333333,6,5,GTCGAATTGGTCCCGATATA,1,1090708
fldAp,0.3333333333333333,6,5,GTCCCGAGCCCGATAATAGT,1,1092489
fldAp,3.1666666666666665,23,5,GTCCCCAAACGTGCTCATGG,18,1175978
fldAp,3.0,22,5,GTCCATTTGTATCTGAACAA,17,1158563
fldAp,16.5,103,5,GTCCAATCTATGCATACATA,98,1063699
fldAp,6.833333333333333,45,5,GTCAGACTTCAAAATTCCTT,40,1179466
fldAp,0.3333333333333333,6,5,GTCACGGCCCCCTGACATCC,1,1162865
fldAp,0.3333333333333333,6,5,GTCACCTGTTATAAGTTTCC,1,1095523
fldAp,3.1666666666666665,23,5,GTATTGAATCACTGTTTTGG,18,1108881
fldAp,0.3333333333333333,6,5,GTATGCTCCTTTGATTAGCT,1,1100732
fldAp,0.3333333333333333,6,5,GTAGTAGCGCCAAGAAAGAC,1,1114388
fldAp,4.5,31,5,GTAGCAGGGGTTCTGAAAGC,26,1186916
fldAp,5.333333333333333,36,5,GTAGCAGACGTGGTGTCATA,31,1099368
fldAp,7.5,49,5,GTAACTGAAAGGCCGGGAGG,44,1133805
fldAp,4.666666666666667,32,5,GTAACTCTGGCACTCGTCTC,27,1082584
fldAp,6.833333333333333,45,5,GTAACGCGTCACAGTCAGAA,40,1105512
fldAp,0.6666666666666666,8,5,GGTTTTCCCCCGGAGCCAAC,3,1158169
fldAp,6.166666666666667,41,5,GGTTTGCTATGGCCCACTAT,36,1186023
fldAp,4.5,31,5,GGTTTCATGGGAGAAATGTA,26,1081833
fldAp,4.833333333333333,33,5,GGTTGCTTCATACACTTCCA,28,1070828
fldAp,2.5,19,5,GGTGCTTTATAGGGGCTTCA,14,1077620
fldAp,2.1666666666666665,17,5,GGTCGGTGTCTATAAGGGGT,12,1142638
fldAp,3.0,22,5,GGTCGGGCAGGCTTACATTC,17,1090890
fldAp,4.333333333333333,30,5,GGTCGGGACTCCCACTTTGT,25,1182781
fldAp,0.3333333333333333,6,5,GGTCACCATAAGCCTGAGCC,1,1160510
fldAp,0.3333333333333333,6,5,GGTATAAGATTCGTTGCTTG,1,1134329
fldAp,3.0,22,5,GGTAGTCTAGGTACTTATGC,17,1106532
fldAp,6.666666666666667,44,5,GGTAGAACGGCCGATGTACG,39,1065764
fldAp,10.166666666666666,65,5,GGGTTCGCGCTGTCTTGTGA,60,1150963
fldAp,3.8333333333333335,27,5,GGGTAGGAAAGTAACTCAAC,22,1098452
fldAp,7.333333333333333,48,5,GGGGTTCCGCGGCTTCGAAA,43,1115482
fldAp,4.166666666666667,29,5,GGGGTCAGTCAATACATCGG,24,1119749
fldAp,10.166666666666666,65,5,GGGGGATGCCGCCTTGGCAT,60,1167389
fldAp,4.0,28,5,GGGGCAATGCGATCTCAGGG,23,1086776
fldAp,4.0,28,5,GGGCCGCGACTGAGATATTT,23,1184268
fldAp,28.666666666666668,176,5,GGGCACGTGTCACAAATTGT,171,1135664
fldAp,0.3333333333333333,6,5,GGGCAAAGGATCTCCACCGA,1,1074765
fldAp,0.3333333333333333,6,5,GGGACTCTCACGGGCGTTTT,1,1173139
fldAp,5.166666666666667,35,5,GGCTTCTGACTACTAGGTAA,30,1079977
fldAp,1.0,10,5,GGCTTCATACAGACCCCATG,5,1145084
fldAp,2.5,19,5,GGCTGTATTGCGATGGGTCC,14,1180295
fldAp,7.666666666666667,50,5,GGCTAGCCACTCACCAACCC,45,1069130
fldAp,3.1666666666666665,23,5,GGCGGAAGCGCACGAGTTGC,18,1106878
fldAp,2.8333333333333335,21,5,GGCGCGAATAATACTACGGC,16,1113434
fldAp,6.666666666666667,44,5,GGCGACGCACTTCCGGGACT,39,1149970
fldAp,7.333333333333333,48,5,GGCGACGATGACCGAAGAAG,43,1111907
fldAp,0.3333333333333333,6,5,GGCCCGGGGTTTGTATGTCT,1,1129337
fldAp,6.333333333333333,42,5,GGCACGGCCCCCGGGCAATC,37,1068202
fldAp,3.6666666666666665,26,5,GGCACCCTCAGTATGTCAAA,21,1073215
fldAp,5.166666666666667,35,5,GGCAAAGAAACACCTGGCGG,30,1183730
fldAp,5.0,34,5,GGATACACGCTTTTCCGAAT,29,1078199
fldAp,9.833333333333334,63,5,GGATACAAGGGGCGGTTCAC,58,1097574
fldAp,4.833333333333333,33,5,GGAGTCTCACTTCGACCTGA,28,1073569
fldAp,3.6666666666666665,26,5,GGAGTATATAGCGTAAGTAG,21,1109442
fldAp,0.3333333333333333,6,5,GGAGCTGATAGACAAATTAT,1,1100703
fldAp,3.0,22,5,GGACTCTTTACCAATGAGGT,17,1093439
fldAp,6.833333333333333,45,5,GGACAGTTGGTCGTTTCACG,40,1155363
fldAp,10.833333333333334,69,5,GGAATCTTGACAAAGGCACA,64,1111372
fldAp,0.3333333333333333,6,5,GGAAGAGTGGTAATACACGC,1,1109625
fldAp,3.8333333333333335,27,5,GCTTGCTAGTAACGTAATTA,22,1098449
fldAp,3.8333333333333335,27,5,GCTGAGTGTACTCCCTGCTG,22,1163985
fldAp,2.3333333333333335,18,5,GCTCCGCTTTCGCGTGCGGA,13,1126390
fldAp,0.3333333333333333,6,5,GCTACACGGTGGCTATCTGT,1,1096830
fldAp,8.333333333333334,54,5,GCGTACAACCATTGGTGAGT,49,1141420
fldAp,5.833333333333333,39,5,GCGGGTAGAGCGGGCTGTAC,34,1146580
fldAp,9.5,61,5,GCGGCATAACTTACACGTCG,56,1159311
fldAp,4.5,31,5,GCGCTTGTCTACATCATGTC,26,1166563
fldAp,5.5,37,5,GCGCTCAAGTGGGCTGCTGC,32,1072560
fldAp,1.1666666666666667,11,5,GCGCGATTCCAAGGCTGTAG,6,1078468
fldAp,4.166666666666667,29,5,GCGCCGTAAGATCGTGAACC,24,1140466
fldAp,7.166666666666667,47,5,GCGCAACCTACCTATGATTA,42,1093283
fldAp,2.5,19,5,GCCCGAGACTCAGGGGCGCC,14,1113585
fldAp,3.0,22,5,GCCCATATGAATGTACCGCT,17,1092464
fldAp,2.8333333333333335,21,5,GCCAGGATAATCTCCTGGAA,16,1131780
fldAp,4.166666666666667,29,5,GCCAGAGCCAGACTTCTCTT,24,1075418
fldAp,0.3333333333333333,6,5,GCCACTAGATCAGTTCAATA,1,1168764
fldAp,6.0,40,5,GCCACCTTGCCAAGAATTGT,35,1097344
fldAp,3.1666666666666665,23,5,GCATTTAATATAAGATACAC,18,1135665
fldAp,4.833333333333333,33,5,GCATGCTATCACTAGGCGTT,28,1074171
fldAp,0.6666666666666666,8,5,GCATGACGACAACATCCTCT,3,1139913
fldAp,8.5,55,5,GCAGATTGCGGGTACCGTTT,50,1093390
fldAp,3.6666666666666665,26,5,GCAGACCGCAGCTGCCGTTC,21,1137664
fldAp,6.833333333333333,45,5,GCACTTGGGATTACATGTAG,40,1182731
fldAp,5.5,37,5,GCACGGGCCACATAAATCGG,32,1147682
fldAp,2.6666666666666665,20,5,GCACCGACGGGATGGAGTGC,15,1141843
fldAp,2.6666666666666665,20,5,GCAACGCCCTTTAGGGATCT,15,1138332
fldAp,4.833333333333333,33,5,GCAAAGGTAAGGGCTTTGTC,28,1170802
fldAp,3.8333333333333335,27,5,GATTTCTAGGCCTGGTGCGA,22,1142719
fldAp,1.5,13,5,GATGGCATCACCAAGGCGCT,8,1092772
fldAp,2.3333333333333335,18,5,GATCGCCAAGGAAGGAGCTT,13,1089415
fldAp,4.166666666666667,29,5,GATCCTATACACGAGGTTGA,24,1156193
fldAp,4.333333333333333,30,5,GAGGTCAACCCGTACCGACC,25,1106115
fldAp,0.3333333333333333,6,5,GAGGAGGTTTGTCTATTAAC,1,1091173
fldAp,4.166666666666667,29,5,GAGCGGGTTCACGGTTACCT,24,1176553
fldAp,6.333333333333333,42,5,GAGCGAGTGGGCTGGAAAGA,37,1121965
fldAp,3.6666666666666665,26,5,GAGCATAGACCGACCTTCCG,21,1185034
fldAp,4.833333333333333,33,5,GAGATCATGGGACGCCCTCC,28,1100743
fldAp,7.833333333333333,51,5,GAGACCTAACCTCACCTACG,46,1186105
fldAp,1.0,10,5,GAGACCAAGCGATTTGGTTA,5,1178304
fldAp,3.1666666666666665,23,5,GAGAAACTAAGAGGTGACCC,18,1180166
fldAp,3.5,25,5,GACTAAGCGTAGAGGCTGCT,20,1184709
fldAp,5.833333333333333,39,5,GACTAAGATCACAATCCGTA,34,1169987
fldAp,4.166666666666667,29,5,GACGGTGGAGTTCGTATGAT,24,1140972
fldAp,6.833333333333333,45,5,GACGGTCTTTTTAGGGTTGA,40,1175469
fldAp,4.0,28,5,GACCCTTTACACGGGTTCAG,23,1167154
fldAp,4.5,31,5,GACCCGTGCCTCAGCGCAGA,26,1079525
fldAp,9.0,58,5,GACATGATGGTACGGGGTGA,53,1097570
fldAp,0.3333333333333333,6,5,GAATGCAGCTTGACTAGACT,1,1079328
fldAp,10.5,67,5,GAATCTCATCTCTGGTTCGC,62,1085031
fldAp,0.3333333333333333,6,5,GAAGCTCAAAGGTTACATAC,1,1133733
fldAp,2.6666666666666665,20,5,GAACTTCGGCTATTCGAACT,15,1134927
fldAp,14.5,91,5,GAACATTTTCGACAAGGGAT,86,1107682
fldAp,4.666666666666667,32,5,GAAATTGCGTCTCCTAGACA,27,1150218
fldAp,2.3333333333333335,18,5,GAAAACCACTCGGTATGTTG,13,1093245
fldAp,9.166666666666666,59,5,CTTTTCGGATCTCTGATGCC,54,1077569
fldAp,2.3333333333333335,18,5,CTTTGCAACACTGCCTACCT,13,1167173
fldAp,1.6666666666666667,14,5,CTTTCGCACAACGGTTTTCC,9,1163081
fldAp,10.166666666666666,65,5,CTTTAAATGCAGCATTCCTC,60,1142602
fldAp,0.3333333333333333,6,5,CTTGGGCCTTCGGGGCTCTA,1,1105568
fldAp,4.0,28,5,CTTCGGAGAGGCCTACGTAA,23,1094045
fldAp,15.5,97,5,CTTCCTGTGCAGGACGGTTA,92,1135690
fldAp,2.5,19,5,CTTCCTAGCGGCCTCTAGCA,14,1145186
fldAp,3.1666666666666665,23,5,CTTCAGGTCTTCGAGCGAAA,18,1128421
fldAp,2.8333333333333335,21,5,CTTATCTAGAGTTCATTTAA,16,1108599
fldAp,4.833333333333333,33,5,CTTATACGTCTTACTTAACT,28,1171050
fldAp,5.5,37,5,CTTAAAGAGCCGCCGAGGTT,32,1142655
fldAp,8.166666666666666,53,5,CTGGGTTCATACTTGGCGCC,48,1168964
fldAp,3.3333333333333335,24,5,CTGGGGTACGGTTTAGATTA,19,1134591
fldAp,3.5,25,5,CTGGATGTAACTTTTATGCC,20,1070205
fldAp,3.1666666666666665,23,5,CTGCGCTGTTATGAAAGGTT,18,1152022
fldAp,4.666666666666667,32,5,CTGCCAAGTGCAGCCCTGTC,27,1179448
fldAp,8.666666666666666,56,5,CTGCACTTGGCCGTCTATAA,51,1094600
fldAp,4.0,28,5,CTGAATACACGTACCCGTTG,23,1142521
fldAp,3.5,25,5,CTCGTGATCTTCGCAGTCAT,20,1161776
fldAp,0.3333333333333333,6,5,CTCGTCCTCATCGATAAGTT,1,1074048
fldAp,0.5,7,5,CTCGCATTTAATACAAGAAC,2,1123639
fldAp,5.833333333333333,39,5,CTCCTCTGAGTATTTTGCCT,34,1177412
fldAp,4.666666666666667,32,5,CTCCTAAGGTTCTGGTGTGA,27,1160991
fldAp,3.5,25,5,CTCAGCTCCTCCAAGAGGAA,20,1091017
fldAp,6.666666666666667,44,5,CTCAGATTCTCCCAGTGTTT,39,1129859
fldAp,1.5,13,5,CTCAAGGTCTGCTATCATAT,8,1106429
fldAp,0.3333333333333333,6,5,CTCAAGAATTCCACGTATGT,1,1115035
fldAp,1.3333333333333333,12,5,CTCAACCGATACTGCAGGAA,7,1114602
fldAp,4.166666666666667,29,5,CTATTAGGGTTGACGCCGGT,24,1176513
fldAp,3.5,25,5,CTATGCTAGGGGGTGCTGCC,20,1186165
fldAp,13.166666666666666,83,5,CTATCACTGAGAATTTTTTA,78,1164449
fldAp,0.3333333333333333,6,5,CTATACATATCGTTCCCGGG,1,1076057
fldAp,17.5,109,5,CTAGGTCTACCGTGGTCTTC,104,1155140
fldAp,5.0,34,5,CTAATATTTCGGTTCGAGCG,29,1139695
fldAp,5.0,34,5,CTAAGGATTCAACTTATCAT,29,1129857
fldAp,28.166666666666668,173,5,CGTTTGCCTGACGGCTGGGT,168,1147689
fldAp,2.8333333333333335,21,5,CGTTAATACCAGAGCGAGGC,16,1141058
fldAp,4.5,31,5,CGTGTGTGCGTGGGAAATGA,26,1074677
fldAp,0.3333333333333333,6,5,CGTGGAACTTATGGTGCCAT,1,1162798
fldAp,2.5,19,5,CGTGATTCCCTCCGTATAAA,14,1140401
fldAp,6.333333333333333,42,5,CGTGACACGTCGGGCACGGA,37,1087773
fldAp,3.5,25,5,CGTCTTGCTCCCGCTTCAAG,20,1070960
fldAp,6.5,43,5,CGTACCGGTCTCCTCGGGGA,38,1179502
fldAp,1.8333333333333333,15,5,CGTACCACAAAAGCTGGTCA,10,1089293
fldAp,5.5,37,5,CGGTGCCGATCCATCTCGGA,32,1147893
fldAp,0.5,7,5,CGGTGAGCGCCCAGTAAGAT,2,1114870
fldAp,4.166666666666667,29,5,CGGTGACCATGCACAAGGGT,24,1094758
fldAp,0.3333333333333333,6,5,CGGGGTTTTAGGTGGGGCGA,1,1105637
fldAp,9.666666666666666,62,5,CGGCCGTTAAACGCTATCTG,57,1095720
fldAp,2.0,16,5,CGGCCCACGAGATAAGCGGG,11,1064788
fldAp,3.5,25,5,CGGCCAGCAGAGTGCCTAAT,20,1186761
fldAp,4.666666666666667,32,5,CGGATCCGCCCATCTCGGGA,27,1156577
fldAp,0.3333333333333333,6,5,CGCTGATGCGTATGAAAGTG,1,1111560
fldAp,9.5,61,5,CGCGTTGCAAGGGGCCGTAG,56,1135838
fldAp,3.0,22,5,CGCGCTCACCTCCTGATATG,17,1076310
fldAp,2.8333333333333335,21,5,CGCCTCCGCCAACGCTTGTT,16,1101107
fldAp,2.5,19,5,CGCCGCTTGTCCCGAGTCAT,14,1137390
fldAp,0.3333333333333333,6,5,CGCCCCGGGTATGGTCCACA,1,1165267
fldAp,5.0,34,5,CGCCAACATAAAGGGTCCAG,29,1146551
fldAp,3.5,25,5,CGCATGGCGGGCCACAGTAG,20,1139440
fldAp,3.6666666666666665,26,5,CGCAGTTCCGACTTTATGTA,21,1092344
fldAp,0.3333333333333333,6,5,CGCAGTAGTCTGTAGGTGAC,1,1159700
fldAp,0.3333333333333333,6,5,CGCACCCTACGGACTCGTGA,1,1090930
fldAp,0.3333333333333333,6,5,CGCAATTGCCCAATATCCCC,1,1134921
fldAp,1.5,13,5,CGATTGGAGCAGAAACCCTA,8,1074956
fldAp,15.0,94,5,CGAGACTAGAGAAACCTGGT,89,1146180
fldAp,5.166666666666667,35,5,CGACTTAGTCATGGTAACGT,30,1178150
fldAp,16.833333333333332,105,5,CGACGTGTTCCGCATCAGCA,100,1106116
fldAp,7.666666666666667,50,5,CGACGTAGCTCAGGGCGTCC,45,1179698
fldAp,3.8333333333333335,27,5,CCTTTGATGCCCCTATGTCC,22,1157219
fldAp,10.333333333333334,66,5,CCTTGCCAATGAATCGTAGT,61,1117372
fldAp,8.833333333333334,57,5,CCTGATGCGTTCTACAAGCT,52,1083885
fldAp,7.666666666666667,50,5,CCTCTCCTGAGAGAATAAAT,45,1127464
fldAp,9.5,61,5,CCTCTAATAGCTAGGGGTCA,56,1116472
fldAp,3.6666666666666665,26,5,CCTCGCTTGCACTTTGTACG,21,1171458
fldAp,4.166666666666667,29,5,CCTCCCGAATCTTAACGCCA,24,1107844
fldAp,0.3333333333333333,6,5,CCTCATGAGCGAGTTCGTGT,1,1174251
fldAp,5.166666666666667,35,5,CCTAGCAGCGCGCCGATGCC,30,1069688
fldAp,3.3333333333333335,24,5,CCGTCCGCTAGCTCAACGGC,19,1130647
fldAp,3.5,25,5,CCGTAGGCAAGTTCTGTGCT,20,1085304
fldAp,5.666666666666667,38,5,CCGTAAGGGGACAGTGAATT,33,1130330
fldAp,2.0,16,5,CCGGTGTAGTTGCACATTCA,11,1073825
fldAp,0.3333333333333333,6,5,CCGGTGCTGTCGGACTGCGT,1,1110824
fldAp,7.333333333333333,48,5,CCGGCTGGTGCTAGAAGGAT,43,1104086
fldAp,0.3333333333333333,6,5,CCGCTGTAAATATAATCATC,1,1130789
fldAp,0.5,7,5,CCGCCCGTTTTTGTTGCGCA,2,1132002
fldAp,3.3333333333333335,24,5,CCGCAAAGAGCTAATAGAGA,19,1154021
fldAp,3.0,22,5,CCGCAAAAGTCCACTATGCT,17,1174170
fldAp,8.333333333333334,54,5,CCGATGGCATTCGGGCCTAC,49,1102350
fldAp,6.333333333333333,42,5,CCGATGCATAGATCCCGCGT,37,1119644
fldAp,0.5,7,5,CCGAGCTTTTGGGGGTGCAT,2,1157015
fldAp,5.833333333333333,39,5,CCGAGCCAATAGTCACCTCA,34,1089952
fldAp,3.8333333333333335,27,5,CCGACTGGTCGGTCTCATGA,22,1091729
fldAp,4.166666666666667,29,5,CCGAAGCAGTATTCCGCCAC,24,1155407
fldAp,1.6666666666666667,14,5,CCCTTCAGTTCAGTTATATG,9,1102785
fldAp,7.666666666666667,50,5,CCCTGTTAGCCCATGCGTTA,45,1132250
fldAp,3.0,22,5,CCCTCTACGCACACATGGGG,17,1078202
fldAp,0.5,7,5,CCCTCCAAATTGGGGGAACT,2,1090208
fldAp,7.0,46,5,CCCTATGTTCGCCCTGACTA,41,1152972
fldAp,13.0,82,5,CCCTAAATACGGCCAATCAG,77,1082581
fldAp,9.166666666666666,59,5,CCCGCAATGAAGGTTTGCCC,54,1139467
fldAp,0.3333333333333333,6,5,CCCCGGCTCAGCTCACTCCC,1,1186828
fldAp,4.333333333333333,30,5,CCCCAGCCGTCTAACCTTAG,25,1121387
fldAp,0.3333333333333333,6,5,CCCCAGACGGAAGCACAGGG,1,1101736
fldAp,3.5,25,5,CCCCAGACAGATTCGGCACC,20,1109620
fldAp,4.0,28,5,CCCCACCAACGAATGATATA,23,1104272
fldAp,2.5,19,5,CCCATTTCCCGTCGTGAATT,14,1124304
fldAp,5.666666666666667,38,5,CCATTGCTGGGCTAGTGGGT,33,1088100
fldAp,5.333333333333333,36,5,CCATGTCTGGCAGTTCTAGC,31,1100713
fldAp,7.166666666666667,47,5,CCATCGGGCATCTTCCGAGT,42,1094235
fldAp,1.3333333333333333,12,5,CCATCGCATCCCGGCGGAGT,7,1151698
fldAp,6.833333333333333,45,5,CCATAGGAGATATGATCGGC,40,1121449
fldAp,0.3333333333333333,6,5,CCATACGGCTAGTGTGACGA,1,1173124
fldAp,2.6666666666666665,20,5,CCAGGGCCAGGTCCGCAAGA,15,1081784
fldAp,2.5,19,5,CCAGCAAACACCTCAGCCGA,14,1106894
fldAp,8.833333333333334,57,5,CCACTGCCGCATGCGTCATC,52,1087494
fldAp,5.5,37,5,CCACGCCTCGATTGACGGGG,32,1141746
fldAp,3.0,22,5,CCAATGGTGAACTGTGGGGG,17,1066276
fldAp,5.0,34,5,CATTTTATTCCCGTGGGAGG,29,1124498
fldAp,6.0,40,5,CATTTTACTATAGCGTCTCA,35,1134617
fldAp,9.666666666666666,62,5,CATTACCAGGTCAAGGAGCA,57,1125920
fldAp,2.3333333333333335,18,5,CATGTGGCCAACTGATGGCA,13,1100716
fldAp,2.1666666666666665,17,5,CATGAAACTATGCGGCCTTA,12,1132049
fldAp,9.666666666666666,62,5,CATGAAAAGGTGTAAATATG,57,1087106
fldAp,2.8333333333333335,21,5,CATCTGTTGCGCTTATAATA,16,1142635
fldAp,5.166666666666667,35,5,CATCCCGGTACTGGTGTGTG,30,1153984
fldAp,8.666666666666666,56,5,CATCAAGGGGTAGCACGTCG,51,1110369
fldAp,2.5,19,5,CATAGACAACATTCAATCAA,14,1067383
fldAp,40.666666666666664,248,5,CATAACCCTCTCGATTGAGC,243,1107705
fldAp,1.0,10,5,CATAAAATCATCGCGATCTT,5,1102063
fldAp,6.5,43,5,CAGTCTCGGGAGGCAGCTTT,38,1107702
fldAp,0.5,7,5,CAGTCGGCCCTCCCAAGGTG,2,1111251
fldAp,3.8333333333333335,27,5,CAGTCCTTCGGCGCCACGGT,22,1116205
fldAp,15.0,94,5,CAGGCTGACGTGTACAGTTA,89,1063676
fldAp,3.1666666666666665,23,5,CAGGCGAATTCGCGTACCAA,18,1106588
fldAp,3.8333333333333335,27,5,CAGGAGTTCTTCGTCCCCTA,22,1166150
fldAp,4.166666666666667,29,5,CAGCTGATGGTTGTCTAGCC,24,1102073
fldAp,1.5,13,5,CAGCGGGAACTTGCAGGTAA,8,1136863
fldAp,8.333333333333334,54,5,CAGCCTGTAATGAGAGGGCT,49,1127957
fldAp,12.166666666666666,77,5,CAGCCCTCTTGGAGTCGTCG,72,1077537
fldAp,0.3333333333333333,6,5,CAGCACATGCGCGGGTTCTA,1,1084701
fldAp,3.0,22,5,CAGAGTTGTTACCCGGTGCT,17,1083175
fldAp,3.8333333333333335,27,5,CAGACTGCAGCCGCCTTTAT,22,1186872
fldAp,5.333333333333333,36,5,CAGACCGCTAAATACAAGCA,31,1141259
fldAp,7.0,46,5,CACCGACTCATCATATTAGC,41,1125677
fldAp,3.3333333333333335,24,5,CACAGCCTGTTGTTGGGCTT,19,1138251
fldAp,0.3333333333333333,6,5,CACAGCAAGAATTCTTTTTG,1,1155043
fldAp,9.333333333333334,60,5,CACACGGCTCAGCAGCGGAT,55,1155037
fldAp,0.3333333333333333,6,5,CACACCGGGCGGTATTCGTT,1,1115920
fldAp,5.833333333333333,39,5,CAATTTGCCAACGGGCAGAC,34,1120882
fldAp,4.0,28,5,CAAGGAAAAAGGAAAGCGGT,23,1100885
fldAp,3.3333333333333335,24,5,CAACCATTCATAGGGCACCT,19,1067085
fldAp,0.3333333333333333,6,5,CAACCAGTCTGGATAATTTT,1,1066993
fldAp,0.5,7,5,CAAACCGGGCCGCCCTATCG,2,1067026
fldAp,7.0,46,5,ATTTTTACCATGTCCTCCTG,41,1141431
fldAp,7.333333333333333,48,5,ATTTTCTGCGCTATCGGCCT,43,1182541
fldAp,3.8333333333333335,27,5,ATTTCGTTGCTTAACACTAG,22,1067476
fldAp,2.5,19,5,ATTGGTCACTGATCCCGGAA,14,1083026
fldAp,4.666666666666667,32,5,ATTGGGGATTCTTGCTGCCA,27,1145201
fldAp,6.166666666666667,41,5,ATTGGCGCGACCACCAATCT,36,1126437
fldAp,15.5,97,5,ATTCTAGATGGTCGGTAATA,92,1064182
fldAp,3.8333333333333335,27,5,ATTCCGTATATCGAATCGCC,22,1083499
fldAp,4.833333333333333,33,5,ATTCCGGGCGACAGTCTATG,28,1142567
fldAp,1.6666666666666667,14,5,ATTAGGATCGGTAGATTGTT,9,1180739
fldAp,6.0,40,5,ATTACGAGTTACTCGAGAGT,35,1143447
fldAp,9.333333333333334,60,5,ATGTGCGTTACCAATACCTC,55,1134622
fldAp,4.166666666666667,29,5,ATGTGCGGAAATGGGCCTGA,24,1073672
fldAp,3.6666666666666665,26,5,ATGTCATTCGGTTAGGGTGA,21,1122999
fldAp,0.3333333333333333,6,5,ATGTATCGCGAACTTAGTCA,1,1176563
fldAp,0.3333333333333333,6,5,ATGGTTCGCGTTTCTCTGCT,1,1066662
fldAp,0.5,7,5,ATGGTACGGGCGCTTGGCTG,2,1161670
fldAp,5.166666666666667,35,5,ATGCTTTCCTTAAGATGATT,30,1163106
fldAp,3.3333333333333335,24,5,ATGCGGCTGTCATCGCGTGT,19,1171160
fldAp,3.3333333333333335,24,5,ATGCAGACACTCCCCGGTAT,19,1171124
fldAp,18.5,115,5,ATGCACATGAGATGCCATCT,110,1140899
fldAp,3.6666666666666665,26,5,ATGAGAACGGATGGTAACGC,21,1141483
fldAp,8.833333333333334,57,5,ATCTTTACACACGTACGCGA,52,1182512
fldAp,4.333333333333333,30,5,ATCTGGTCAGTGTCCTGTAT,25,1179456
fldAp,0.3333333333333333,6,5,ATCGGTAAGTTCGCAGCTTC,1,1146543
fldAp,0.3333333333333333,6,5,ATCGCGATCTGTCAGTTGGC,1,1121402
fldAp,6.833333333333333,45,5,ATCCTAACGCGGGTCACCGA,40,1066119
fldAp,4.666666666666667,32,5,ATCCGTACCATTAACGCAAT,27,1140017
fldAp,11.166666666666666,71,5,ATCCGGGGGAATTGGATCTT,66,1107730
fldAp,9.5,61,5,ATCCAAAAGCGCCATTTAAA,56,1172478
fldAp,1.8333333333333333,15,5,ATATTAAGGCGAATTGGTAC,10,1090786
fldAp,10.666666666666666,68,5,ATATCGGACCGGTTGGACGC,63,1084832
fldAp,5.0,34,5,ATATCATTTGTCGCACATCT,29,1179930
fldAp,6.0,40,5,ATATATTGAATGACGAGTGC,35,1134574
fldAp,2.1666666666666665,17,5,ATAGTTTATATCTGCCAGGG,12,1107833
fldAp,14.166666666666666,89,5,ATAGGCAATATTCATCAATC,84,1109053
fldAp,8.0,52,5,ATAGCCCTTGTTCCGAGCAA,47,1167164
fldAp,5.166666666666667,35,5,ATACTCGGCCCTTCAGATGC,30,1125016
fldAp,0.3333333333333333,6,5,ATACGTACGGCGAGAGAAGC,1,1066663
fldAp,3.3333333333333335,24,5,ATAATTGGAAGAACCCAACA,19,1063237
fldAp,9.166666666666666,59,5,AGTTTAAGTTTGTCTGGATC,54,1097142
fldAp,0.3333333333333333,6,5,AGTTGCGAAGCTCACTGTGA,1,1184112
fldAp,3.5,25,5,AGTGGCCAATCAAGGAGAGT,20,1143642
fldAp,4.333333333333333,30,5,AGTGATCGGTATTTTCACTC,25,1110326
fldAp,11.666666666666666,74,5,AGTCTTGTGGTGTCAGTACG,69,1066065
fldAp,4.833333333333333,33,5,AGTCCCGAGTCCCGACGCCT,28,1071299
fldAp,5.833333333333333,39,5,AGTATTTAGGGTCTCGTTAA,34,1067482
fldAp,1.0,10,5,AGTATTGGATACCTTCTCCC,5,1098316
fldAp,5.0,34,5,AGTACTGGAGGATAGTTGTC,29,1106590
fldAp,0.3333333333333333,6,5,AGTAAGCTTTATATTTTCGG,1,1179529
fldAp,4.5,31,5,AGGTTCCAGTTGGTTCACAA,26,1185985
fldAp,10.166666666666666,65,5,AGGTTCCAGCTACGCACGGC,60,1077559
fldAp,4.166666666666667,29,5,AGGGCCTAACTATCCTAGAC,24,1107490
fldAp,0.3333333333333333,6,5,AGGGCCGACCATACTATAAC,1,1140518
fldAp,0.3333333333333333,6,5,AGGCGCCTATGACTTTATAG,1,1096318
fldAp,4.333333333333333,30,5,AGGCGCCACAGGCAGAGCAG,25,1081034
fldAp,5.5,37,5,AGGCAGAGGTTATACTGCTT,32,1094398
fldAp,9.166666666666666,59,5,AGGATCCCACGCTTAAATCA,54,1128550
fldAp,3.6666666666666665,26,5,AGCTCCCCCACGTGCGAAAT,21,1092516
fldAp,8.833333333333334,57,5,AGCGGTAATGTTCGATGTTA,52,1083903
fldAp,2.3333333333333335,18,5,AGCGGGGTACAAGCTCCCTG,13,1097301
fldAp,0.3333333333333333,6,5,AGCCTTCGCCTGAGTTACAC,1,1143202
fldAp,4.833333333333333,33,5,AGCCTTATGCTTTAAAGCGG,28,1169913
fldAp,0.3333333333333333,6,5,AGCCTAGATGAGACTTTTTA,1,1124293
fldAp,0.8333333333333334,9,5,AGCAGCAAGTACTTGGCCAT,4,1146247
fldAp,0.3333333333333333,6,5,AGCACACTGATGATTTAAGT,1,1101380
fldAp,4.0,28,5,AGCAAGGACGAGCGTCGCGG,23,1158800
fldAp,14.166666666666666,89,5,AGATTTATGTACCGGAACAC,84,1157394
fldAp,0.3333333333333333,6,5,AGATTTATCTCGTAATTACT,1,1070036
fldAp,3.1666666666666665,23,5,AGACTGGACGTGTAGATTCA,18,1080327
fldAp,6.833333333333333,45,5,AGACATGCGTGAGGCCGAAC,40,1082487
fldAp,5.5,37,5,AGACAGAGGAAAGATTATTG,32,1106255
fldAp,3.0,22,5,AGACAACGCATGTCTTACTC,17,1105071
fldAp,0.3333333333333333,6,5,ACTTTCTTGGCGATTCGCGT,1,1086921
fldAp,20.5,127,5,ACTTTATTATCGCTACTGTT,122,1116492
fldAp,3.1666666666666665,23,5,ACTGCTAATTACTGTGGTGT,18,1172407
fldAp,17.666666666666668,110,5,ACTCTTTTCTATGGAAGGAT,105,1067692
fldAp,2.1666666666666665,17,5,ACTCTTTGCCTGTTTTCTAG,12,1160609
fldAp,18.666666666666668,116,5,ACTCGGCCTCCTAGTCGCTT,111,1174599
fldAp,4.666666666666667,32,5,ACTCGATACGTATCGATTAA,27,1186922
fldAp,23.0,142,5,ACTCCTCATTGCGTGAAAAA,137,1164709
fldAp,0.3333333333333333,6,5,ACTCCGTACGAGCTACCGCA,1,1185267
fldAp,6.666666666666667,44,5,ACTCCCTGTTTGCCACAAAA,39,1079450
fldAp,0.8333333333333334,9,5,ACTCAAGATGAAGCTTGATC,4,1074457
fldAp,0.3333333333333333,6,5,ACTCAACCTAGGGTATCGAT,1,1173383
fldAp,2.5,19,5,ACTATGCTTAGACTTTCTGG,14,1084539
fldAp,4.166666666666667,29,5,ACTAGCGGAGTTTCATGACA,24,1082495
fldAp,5.166666666666667,35,5,ACTAACGCGAACTGTGAAAT,30,1158813
fldAp,0.8333333333333334,9,5,ACGGGGTTAGTGTGAGCTGA,4,1106305
fldAp,5.666666666666667,38,5,ACGGCGATAGGATATCAGTT,33,1186500
fldAp,4.333333333333333,30,5,ACGCTAGCTACGTCACGTGA,25,1148993
fldAp,0.5,7,5,ACGCGATTTATAGCGTCACT,2,1129752
fldAp,3.3333333333333335,24,5,ACGAGAGTGAGCCGAATCGG,19,1121141
fldAp,3.1666666666666665,23,5,ACGACCTCCATATGTATATC,18,1174298
fldAp,6.833333333333333,45,5,ACGAACCTCGCGGGTCTATG,40,1145486
fldAp,7.5,49,5,ACCTTTGGCCTTCAAGAGGT,44,1148705
fldAp,4.833333333333333,33,5,ACCTCTCGATCTGCTCGATC,28,1133268
fldAp,3.1666666666666665,23,5,ACCTCAACTAGGGATGAAAC,18,1146001
fldAp,1.1666666666666667,11,5,ACCTACTTCCAATAGTGTAT,6,1085289
fldAp,5.0,34,5,ACCTACCGAAGGACTTCCGG,29,1081230
fldAp,0.5,7,5,ACCGGGGATAGGTGGGCGGG,2,1090339
fldAp,3.1666666666666665,23,5,ACCCTACACTCTGGGTAACT,18,1120100
fldAp,10.333333333333334,66,5,ACCACCGGATTTCATTCTGG,61,1067611
fldAp,15.333333333333334,96,5,ACCACCACCTGTTTCCAAAC,91,1063599
fldAp,6.833333333333333,45,5,ACCAATAAGTGTAGCGCTCA,40,1067382
fldAp,5.0,34,5,ACATTTGCTCCCGGCCAGGA,29,1155410
fldAp,0.3333333333333333,6,5,ACATGAAACAGAGCGTACTG,1,1161926
fldAp,3.6666666666666665,26,5,ACATATTGTCCGCGCCAACA,21,1136488
fldAp,0.3333333333333333,6,5,ACATACGCTCACATGGAGCG,1,1115465
fldAp,4.833333333333333,33,5,ACAGTTTTGGTGGAAATATT,28,1081006
fldAp,4.833333333333333,33,5,ACAGTCTGTTATCACCAAAT,28,1100246
fldAp,10.333333333333334,66,5,ACACCGTATGTTATCAAGCA,61,1094061
fldAp,3.5,25,5,ACACCGCCAATGGAGGGCCC,20,1180324
fldAp,0.3333333333333333,6,5,ACAAAGTTGATTCGTAAAAT,1,1139992
fldAp,5.5,37,5,AATTCGCGCTGACGTCGATG,32,1167094
fldAp,4.166666666666667,29,5,AATTCCCGGCCATTCACGCT,24,1134231
fldAp,8.666666666666666,56,5,AATCTCAAGGCACTCATCAA,51,1095287
fldAp,2.0,16,5,AATCTAATGTGCGCCCCCTC,11,1096175
fldAp,10.0,64,5,AAGTTGCGCGTCGAAAAGAC,59,1095003
fldAp,2.1666666666666665,17,5,AAGGTGCCGGTCTAGGATAG,12,1102242
fldAp,2.6666666666666665,20,5,AAGGGCTTGCACACCATTGA,15,1158432
fldAp,6.833333333333333,45,5,AAGCGGGATACGGGGTTCAG,40,1105044
fldAp,6.5,43,5,AAGCCGTTAAGTTCGGTCCT,38,1088418
fldAp,0.3333333333333333,6,5,AACTAGGAAAGGGTTGAGGC,1,1110847
fldAp,0.8333333333333334,9,5,AACGGTCTTAACCAGACTAG,4,1064917
fldAp,2.3333333333333335,18,5,AACGGGAATATCGGGGCGCG,13,1094889
fldAp,3.1666666666666665,23,5,AACGCACAACGATCCAGGTG,18,1163371
fldAp,5.166666666666667,35,5,AACCTTTCGCCCGTCTAACT,30,1184881
fldAp,8.833333333333334,57,5,AACATCGGATGGCAGAATAC,52,1116524
fldAp,0.3333333333333333,6,5,AACACACGCAGATTTCACTA,1,1087380
fldAp,0.6666666666666666,8,5,AAATGGCTTCTTTTATCTCC,3,1130085
fldAp,3.5,25,5,AAATCATTAGAAAGGCGGCG,20,1098333
fldAp,7.0,46,5,AAAGCAATTTTCGTTCCTCA,41,1111212
fldAp,3.0,22,5,AAAGAAGTGTTATCTATGTA,17,1084999
fldAp,4.833333333333333,33,5,AAACGGACTTTAGCGTGCCA,28,1066744
fldAp,17.666666666666668,110,5,AAACCGGCGGGCCACTGGCT,105,1107704
fldAp,9.5,61,5,AAAAGACAGATAACAATCTA,56,1085909
fldAp,2.8333333333333335,21,5,AAAACGAAGGATCACACAGT,16,1105821
fldAp,5.0,28,4,TTTTTATGGGCTTTGGTGAG,24,1112516
fldAp,0.4,5,4,TTTTTAGCAATGCCTCTGAA,1,1171720
fldAp,3.8,22,4,TTTTACACAGGTGTCACGAC,18,1147173
fldAp,0.4,5,4,TTTGGCATCACGCTAGATTT,1,1134133
fldAp,3.0,18,4,TTTGATGATTTTAAATACCG,14,1162957
fldAp,9.2,49,4,TTTCTGTCCCCCCTGGCTCC,45,1157341
fldAp,3.2,19,4,TTTCGATGAAAAGCGGTTAA,15,1083857
fldAp,8.8,47,4,TTGTTGTAGACTCCACTTGG,43,1157088
fldAp,17.8,92,4,TTGGGCTGATATACTTGTGA,88,1118336
fldAp,5.8,32,4,TTGGCTATCTTTTCAATCGG,28,1156325
fldAp,7.6,41,4,TTGCTGGGATATAATAGCCT,37,1118374
fldAp,9.2,49,4,TTGCGTAAATCTCTCCGTTA,45,1161439
fldAp,6.4,35,4,TTGCGACAGCGCCGTCGAGA,31,1171462
fldAp,0.4,5,4,TTGCCTCATTGTGATAATCG,1,1150845
fldAp,15.4,80,4,TTGCCGCCGGAACTTGACTC,76,1078621
fldAp,4.6,26,4,TTGAGGGAGATTATTTAGTG,22,1148997
fldAp,5.2,29,4,TTGAGCGGTAAGTTGAGACT,25,1085820
fldAp,10.4,55,4,TTGACGGTACTGTAAGGCAA,51,1164948
fldAp,7.0,38,4,TTGACAGGTTCTATCCACCT,34,1143303
fldAp,6.4,35,4,TTCTGTCTGGGTTTGCCACC,31,1066198
fldAp,15.8,82,4,TTCTCCCGTCCCCGTAATGC,78,1078047
fldAp,4.0,23,4,TTCTCAACTAATGGAAATCG,19,1148895
fldAp,5.6,31,4,TTCTACACTTCGAACGCGAC,27,1072638
fldAp,8.4,45,4,TTCGTTGGTTGAATATTTGT,41,1113438
fldAp,14.8,77,4,TTCGGCAGGGACTTATCAAT,73,1111151
fldAp,5.0,28,4,TTCGCAAATTATCGTCACCA,24,1139480
fldAp,1.6,11,4,TTCCTAATCCACCAATGTAT,7,1160247
fldAp,17.2,89,4,TTCCGTGCGTTGTGTTGTCC,85,1108504
fldAp,8.6,46,4,TTCCGTCAGAAGTGCTTTCC,42,1165221
fldAp,1.2,9,4,TTCCGGACGAATTAACATGA,5,1178014
fldAp,8.6,46,4,TTCCAATGTCATTATTACCT,42,1111744
fldAp,4.8,27,4,TTCATACTTGCCGTGTCTGA,23,1067718
fldAp,4.8,27,4,TTATGTCCACGGGCTAAAGA,23,1125130
fldAp,5.0,28,4,TTATATTTCAACCGGTACCA,24,1158285
fldAp,5.4,30,4,TTATACCCAGTCCAGGGACG,26,1148820
fldAp,7.6,41,4,TTATAAACCCCCCCAACGTG,37,1128201
fldAp,12.8,67,4,TTAGCCACCCAATGACCCAT,63,1143460
fldAp,4.4,25,4,TTACTTTATAGATGGATGCC,21,1095504
fldAp,6.6,36,4,TTACAGGCTTAGACCGACGT,32,1169566
fldAp,2.0,13,4,TTAACATTTTCAGGACCAAA,9,1073259
fldAp,4.0,23,4,TGTTGGCCCGGTATAGGTCG,19,1140492
fldAp,6.2,34,4,TGTTGGAGATGGCCTTAGGA,30,1154563
fldAp,13.8,72,4,TGTTGAGTGGAATGGCACAG,68,1085530
fldAp,6.6,36,4,TGTTCATGTGGACGAATGCT,32,1073819
fldAp,1.0,8,4,TGTGGAGCATTGGATGTTAT,4,1122670
fldAp,11.6,61,4,TGTGCATACATGTGTGTTAT,57,1104008
fldAp,0.4,5,4,TGTGCAAGTACCGCAACAGT,1,1075868
fldAp,7.6,41,4,TGTCAGAACCAAAATTTACG,37,1132226
fldAp,35.2,179,4,TGTATACACCATTCTCCGAA,175,1127728
fldAp,4.6,26,4,TGGTGTTTCTCGTTCAGTCA,22,1070135
fldAp,5.8,32,4,TGGTGGCTCCGTGAGTCCTT,28,1064207
fldAp,0.4,5,4,TGGCTGAGGAATTGGGAAAG,1,1106945
fldAp,4.4,25,4,TGGCCTTGGTGTAAAGCATG,21,1153562
fldAp,17.6,91,4,TGGACCCTGGATAGCGGAAT,87,1137775
fldAp,7.4,40,4,TGCGGGCTGCTTACAGGAAA,36,1175254
fldAp,0.4,5,4,TGCGACCACCTTTTTGTATG,1,1139412
fldAp,2.8,17,4,TGCCCGGTAGCGAGCTTAAC,13,1075146
fldAp,27.2,139,4,TGCCATAAAGCATGTTGTGT,135,1176936
fldAp,4.4,25,4,TGCCAATCCAAGGGATCCTC,21,1155501
fldAp,3.4,20,4,TGCATGGGGGGTGTCTCCAT,16,1085313
fldAp,6.6,36,4,TGCAGATTGATAGCATTTTA,32,1110608
fldAp,7.8,42,4,TGATGTGATCATAGGCTAGC,38,1172649
fldAp,4.6,26,4,TGAGCCCTCAGAACGTAGTA,22,1147968
fldAp,0.4,5,4,TGAGATACTTATAAGCTGAG,1,1132677
fldAp,6.0,33,4,TGACTATTAAAACCAGACCT,29,1099652
fldAp,1.8,12,4,TGACGGGTAAGAGTTTATGC,8,1153253
fldAp,6.8,37,4,TGACATTAGATATTCAATCA,33,1125356
fldAp,0.4,5,4,TCTTGCCCAACAGAGGGATT,1,1085282
fldAp,5.6,31,4,TCTGGAAGAATTTCCCCGGA,27,1075159
fldAp,0.4,5,4,TCTGCGCGGACCATTATCCT,1,1127595
fldAp,4.6,26,4,TCTCTCACCCGGAAACTAAA,22,1110187
fldAp,6.8,37,4,TCTCCCTAGCGGACCAGTGG,33,1090375
fldAp,11.0,58,4,TCTATGTTAGTAACAGTAGT,54,1095356
fldAp,2.0,13,4,TCTATGGGCTGCATGCTTGC,9,1131761
fldAp,0.6,6,4,TCGTGTGGGATTGATGAGAG,2,1128275
fldAp,3.8,22,4,TCGTAGTATGTCTAATGTGG,18,1091897
fldAp,0.4,5,4,TCGTAACGGTGCTCAGTCTC,1,1125727
fldAp,9.0,48,4,TCGGTTCTCAGACCACCACG,44,1064776
fldAp,6.4,35,4,TCGGATACAGTATCCAAATT,31,1185934
fldAp,5.4,30,4,TCGGAGGTCTACCTCACTTA,26,1072508
fldAp,3.4,20,4,TCGGACTCAGGACTTAGTAG,16,1071376
fldAp,6.8,37,4,TCGGAAATTTTCTGACTTGC,33,1179528
fldAp,12.4,65,4,TCGCATTACGCTATGGCGAA,61,1121070
fldAp,0.4,5,4,TCCGATGGCATCGGACTCGA,1,1069265
fldAp,9.8,52,4,TCCCCTACTCGGCGATCGGC,48,1134711
fldAp,0.4,5,4,TCCATTGATCGCTTCTGTGA,1,1163916
fldAp,5.6,31,4,TCCAAACCCCCGAAAGGACA,27,1108089
fldAp,5.8,32,4,TCAGTTCTCAAGCATGTAGC,28,1157010
fldAp,3.6,21,4,TCACGTGTGGCGTGTGGTAC,17,1152572
fldAp,0.4,5,4,TCACCGCTCAGGTAGACCAT,1,1066297
fldAp,6.6,36,4,TCAACGCACTGATATCTGGT,32,1163379
fldAp,4.6,26,4,TATTGCAGGTACAGCACAAC,22,1112335
fldAp,10.8,57,4,TATTCTCTGGGTATGGCCAC,53,1115099
fldAp,3.2,19,4,TATTCTAACCACCTGCGACA,15,1114603
fldAp,11.6,61,4,TATGGTATATCATTTACCGG,57,1101864
fldAp,15.2,79,4,TATGCTCCCTGATGTCATTG,75,1080504
fldAp,1.6,11,4,TATGATAGCTCCATCCAGGA,7,1185462
fldAp,4.0,23,4,TATCGAAAGTCACGTCCACC,19,1090068
fldAp,6.4,35,4,TATAGGTGTTGAAAGGGTAT,31,1091194
fldAp,16.4,85,4,TAGGTCGGGTGTACCCAAAC,81,1144008
fldAp,0.4,5,4,TAGGGATGAACGGCTTGAAC,1,1065974
fldAp,10.4,55,4,TAGCTTCGCAGTAACCCCGC,51,1105870
fldAp,7.8,42,4,TAGAATTACCGTCCCTGTAC,38,1147727
fldAp,3.0,18,4,TACGGGCGTATTTTATCTTA,14,1108080
fldAp,6.4,35,4,TACGGCGTACGGTTACCAGT,31,1118930
fldAp,9.6,51,4,TACGAGGGCGCGCGGCACTC,47,1118821
fldAp,0.6,6,4,TACCACTAGCTTGGATGTGC,2,1133376
fldAp,2.8,17,4,TACATCAGTGGCCCGACGTT,13,1170555
fldAp,6.0,33,4,TACAATTGTTCGCAGGTGCT,29,1141435
fldAp,6.2,34,4,TACAAGCATCTCGGTCCGCA,30,1128456
fldAp,5.6,31,4,TAATGTAACGGACGCGAAGC,27,1143475
fldAp,0.4,5,4,TAATCGCCATTCGTCCTCTA,1,1117085
fldAp,6.6,36,4,TAAGTCTGCATACACATAAT,32,1158782
fldAp,0.4,5,4,TAAGGTCCTGGTGCGTTAAA,1,1108258
fldAp,0.4,5,4,TAAGCGAGCTCATCTAACTA,1,1116726
fldAp,17.2,89,4,TAAGCAACGAAGCACTGCGT,85,1115049
fldAp,0.4,5,4,TAACGGTTTACAGCTCAGAA,1,1098132
fldAp,0.4,5,4,TAACCGGTGTATACGTCCAT,1,1140424
fldAp,5.2,29,4,TAAATTCGAGTAGGTCCTTT,25,1166199
fldAp,6.8,37,4,TAAACTGCGCGCCACGTCTC,33,1096654
fldAp,7.6,41,4,TAAACGACGGCTATCCGGCC,37,1121238
fldAp,3.6,21,4,GTTGAGTACGCTTTGCTGAG,17,1087356
fldAp,5.8,32,4,GTTCTGGGATTGACAATGAC,28,1163092
fldAp,0.4,5,4,GTGTGATATAAGCTTATAGT,1,1124041
fldAp,6.4,35,4,GTGTAGGTGAGCCTGTGTCC,31,1136670
fldAp,2.6,16,4,GTGGGCAGAGCTGTCGGTCA,12,1121392
fldAp,12.2,64,4,GTGCGCTTGCGGCCATTACA,60,1145072
fldAp,6.2,34,4,GTGCAAGCCTCAGCGGCGTT,30,1092231
fldAp,0.4,5,4,GTGAGTCATGCGTACGGGCA,1,1081545
fldAp,2.8,17,4,GTGAGAAAAAGATTTAGATC,13,1124848
fldAp,2.4,15,4,GTGACTTCAGAAGAGAGTGC,11,1120332
fldAp,1.4,10,4,GTGAAAAGGTTAGAAGTGGT,6,1089541
fldAp,0.4,5,4,GTCTCCGTTCTCAATTCAAA,1,1070004
fldAp,1.0,8,4,GTCTACTGTAGCACCTGTTT,4,1161692
fldAp,3.2,19,4,GTCGGTGCTCATCCTTTCTA,15,1067323
fldAp,5.8,32,4,GTCGATTATCAGTACCTAGA,28,1126876
fldAp,0.4,5,4,GTCGAAGTATGGCCCATGAC,1,1178249
fldAp,5.2,29,4,GTCCGCCACGCAATTGACAG,25,1064694
fldAp,3.8,22,4,GTCCCTGTCAAGCTGACAGA,18,1108975
fldAp,7.6,41,4,GTCCCTACCTCCTCTGGGCA,37,1169090
fldAp,1.2,9,4,GTCCAGCAGGTCATCCGTTT,5,1073987
fldAp,5.8,32,4,GTATGGGAAACCTATTCGAT,28,1100834
fldAp,0.4,5,4,GTATGCTGGCCAATGATCCA,1,1156495
fldAp,13.4,70,4,GTATAATTCGGGTCCCGCCC,66,1076419
fldAp,6.6,36,4,GTAGGTCAGGCTATTCGATC,32,1087606
fldAp,3.6,21,4,GTAGGGGCCGAGGCCAAGAG,17,1085912
fldAp,2.6,16,4,GTAGCCTACATGCACCTACC,12,1106060
fldAp,4.8,27,4,GTACTGAGACCGATAATATA,23,1089454
fldAp,3.4,20,4,GTACCACGTTCAACCGCTCA,16,1149583
fldAp,15.4,80,4,GTAAAGACATAATATATATC,76,1140280
fldAp,7.8,42,4,GGTTCAGCATTTGCCGGGGT,38,1119711
fldAp,14.8,77,4,GGTGTAATATTACTGATCAT,73,1126231
fldAp,4.0,23,4,GGTATTCAGATTGTATCGAT,19,1070181
fldAp,8.2,44,4,GGTATGACTTGATTTTTATT,40,1160171
fldAp,8.6,46,4,GGTATCCCTGGTTCTTACTA,42,1172089
fldAp,0.4,5,4,GGGTTGAGGATGGCCATTTC,1,1167191
fldAp,8.2,44,4,GGGTGGCGGATCGAAGGTGT,40,1161199
fldAp,12.6,66,4,GGGTCGGGGAGCCAGAAATC,62,1096453
fldAp,2.0,13,4,GGGTCGATCCCCTTGGCCGC,9,1177168
fldAp,7.0,38,4,GGGTCAACTTGGCCCCGGCG,34,1144094
fldAp,6.4,35,4,GGGGGATCAGTATACAACGC,31,1143611
fldAp,6.6,36,4,GGGGAAGTCGCAGAGTTGCG,32,1110151
fldAp,0.4,5,4,GGGGAAGGGCGAAAAATTAG,1,1111867
fldAp,3.2,19,4,GGGCTTTCTCGTGAATGGTC,15,1117954
fldAp,4.0,23,4,GGGCTGATTAAAGAACATAG,19,1107194
fldAp,11.8,62,4,GGGCTCAAGGTCTTGTAATC,58,1084508
fldAp,9.8,52,4,GGGCGCCTGCTATGCTTCGT,48,1162135
fldAp,1.4,10,4,GGGCATTCTACTGTCGTTCT,6,1179283
fldAp,2.4,15,4,GGGATGCAATGGACTGCTAA,11,1081573
fldAp,0.4,5,4,GGGACGCGCGTGCCTCACGC,1,1115383
fldAp,10.0,53,4,GGCTGGTAACTCCGTTGGAA,49,1166667
fldAp,12.6,66,4,GGCGTCCTGCAAACGCTCTA,62,1078615
fldAp,2.2,14,4,GGCGTAAACACTCAATTTTC,10,1176441
fldAp,4.8,27,4,GGCGAAATACCCGCTTAGAT,23,1161265
fldAp,6.8,37,4,GGCCTGCCCGAATTCGGTCA,33,1139945
fldAp,7.0,38,4,GGCCCGTGTTTTAAGTGCCA,34,1159807
fldAp,0.4,5,4,GGCATCCCGTAGGTAACGTA,1,1154309
fldAp,8.0,43,4,GGCAGTGGCCAGTCGTCTCG,39,1075261
fldAp,4.0,23,4,GGCAATGAGTTTGCCCTTAC,19,1164439
fldAp,0.4,5,4,GGCAACATGTACGGCGCAAC,1,1126732
fldAp,12.0,63,4,GGATTGTTAGCATAACGAAT,59,1100678
fldAp,2.4,15,4,GGATTCGAAGAGACTCCTTG,11,1120845
fldAp,30.0,153,4,GGATGCGGAACTTACTACTA,149,1103962
fldAp,5.4,30,4,GGATGCCAAACATGTGGGAT,26,1121712
fldAp,3.2,19,4,GGATAGAGGGGCCTACGCTC,15,1065411
fldAp,6.2,34,4,GGAGGGGCACGAAGCGACCC,30,1063878
fldAp,5.4,30,4,GGAGACAACAAAAAAGATGG,26,1157934
fldAp,5.6,31,4,GGACGCGAGCACACAGGACC,27,1142150
fldAp,12.6,66,4,GGAATTCGTGGATGTCCGGA,62,1128559
fldAp,1.0,8,4,GGAAAACGATTCGAGTGCCA,4,1153958
fldAp,0.4,5,4,GCTTTATGGATAGTAGGGCT,1,1132121
fldAp,0.4,5,4,GCTTAGGTGAAGCAATTAAG,1,1177164
fldAp,0.4,5,4,GCTGTTGTATGTCCAGAAGG,1,1105264
fldAp,9.6,51,4,GCTGCGTAGTTGCTGCAGTA,47,1182696
fldAp,5.2,29,4,GCTGAAGGGATCGGCACGCC,25,1067622
fldAp,0.6,6,4,GCTCCTCATTGATATGCCAA,2,1159951
fldAp,0.6,6,4,GCTCACGGTCAGAACAGGCC,2,1125692
fldAp,15.6,81,4,GCTATTTGGTCCATCCCAGA,77,1104890
fldAp,0.6,6,4,GCTAGTGGTAACTGTGCGTT,2,1107182
fldAp,2.6,16,4,GCTAGAAGCTTGAGCTTCCA,12,1074477
fldAp,0.4,5,4,GCGTCTATAGTAGTACTACA,1,1114884
fldAp,13.0,68,4,GCGTCCCATTTCGTACTAAT,64,1094717
fldAp,5.4,30,4,GCGGCAAGGCTTCTTGTACC,26,1161097
fldAp,10.4,55,4,GCGGCAAACGTTGTCCGGAC,51,1066052
fldAp,5.8,32,4,GCGGACGCGATCCGAACGGC,28,1161511
fldAp,5.2,29,4,GCGCTAGGCAACGCTGGGAA,25,1099601
fldAp,2.2,14,4,GCGCACTGGAATCGAATTAT,10,1092868
fldAp,11.6,61,4,GCCGTTTCGGTTCGCGGAGA,57,1181551
fldAp,10.8,57,4,GCCGACCAGAGCACGGTCAT,53,1094707
fldAp,4.2,24,4,GCCCCGTGCTCCTTCCCAAG,20,1141158
fldAp,14.2,74,4,GCCCAGTAGTTCACCGGCCT,70,1086519
fldAp,6.0,33,4,GCCCAGCCCTGATAGGAAAC,29,1095932
fldAp,4.8,27,4,GCCCAACTGAGCTGCACTTA,23,1127724
fldAp,0.4,5,4,GCAGCGTTGCTGACAAGGGA,1,1082419
fldAp,6.4,35,4,GCACTAATTACAGTGGCCTA,31,1148854
fldAp,3.6,21,4,GCACCGGGTTGTGGTGTCCA,17,1167395
fldAp,2.8,17,4,GCACCGCCACGGATGTATCT,13,1069812
fldAp,2.4,15,4,GCAATGGCGAAGGCACTGGA,11,1111391
fldAp,0.4,5,4,GATTGGATTTGGTGTAATCT,1,1074700
fldAp,5.4,30,4,GATGTGAACGCGACTCTCTT,26,1123073
fldAp,3.4,20,4,GATGATGCGTGGGTACATAG,16,1109711
fldAp,6.4,35,4,GATGACCTTGGTCTTGCACA,31,1143920
fldAp,1.8,12,4,GATCGGTCACCAGATACTAT,8,1146847
fldAp,7.2,39,4,GATCGATATCATGAATAACT,35,1156811
fldAp,2.2,14,4,GATATGCTGTCGGCCTCGAG,10,1112174
fldAp,0.4,5,4,GATAAGGCCCGGAGGCTCGC,1,1085738
fldAp,0.4,5,4,GAGGCATGTCGTCTTAGGCC,1,1166677
fldAp,0.4,5,4,GAGCTGATGTTATGCCTAAG,1,1127729
fldAp,16.6,86,4,GAGCGAGCCTGGGGTTTGAA,82,1111378
fldAp,5.4,30,4,GAGATGCTCCCAGATGGCAA,26,1127007
fldAp,5.0,28,4,GAGAGATTGGTAACGCATCC,24,1100222
fldAp,0.4,5,4,GAGACCCGCACTGACCCGTA,1,1101982
fldAp,0.4,5,4,GACTTTGTCGTCCATTACAA,1,1147036
fldAp,0.8,7,4,GACTTTAATAAGCATCGTAA,3,1144641
fldAp,7.2,39,4,GACTGCTAAAAAATATGGTC,35,1123628
fldAp,5.8,32,4,GACTATGGGCGCACGCGTAT,28,1107831
fldAp,11.8,62,4,GACGGATATAGCTGGGAAGT,58,1172098
fldAp,0.4,5,4,GACGGAAGCACCCCACGAGG,1,1101776
fldAp,14.8,77,4,GACGACCAGTGTCTCTAATT,73,1167377
fldAp,5.6,31,4,GACGAAATATTCAACTTAAG,27,1132133
fldAp,4.6,26,4,GACCGATTCACGTAAGTTGG,22,1151463
fldAp,6.2,34,4,GACCACGTTACGGCTATGCT,30,1082945
fldAp,4.4,25,4,GAATTTTAGAAAAGAGGGGT,21,1153981
fldAp,9.4,50,4,GAATATTCGGACAGGAGTAC,46,1063645
fldAp,8.8,47,4,GAAGTTAACCGTTGGTGCTA,43,1166377
fldAp,2.0,13,4,GAAGTCTTCCACAATATAGT,9,1149277
fldAp,40.2,204,4,GAAGGACGGCCCATTCGTGT,200,1126536
fldAp,4.2,24,4,GAAGAAAACTCTGATTAACG,20,1151260
fldAp,3.0,18,4,GAACTGACCGGTCCGGCGCA,14,1141167
fldAp,3.0,18,4,GAACTCTAATGTGTGCTATC,14,1146002
fldAp,5.2,29,4,GAACGGGGCTTATCCGTTGC,25,1121080
fldAp,7.0,38,4,GAACAGGGAACAGACGGATC,34,1097637
fldAp,13.2,69,4,GAAATTAGCCCTCCTAAAAG,65,1131460
fldAp,2.6,16,4,CTTTTGATCAATGGGGTACT,12,1097268
fldAp,5.2,29,4,CTTTTATAAAGTGTTCTTCT,25,1134942
fldAp,4.4,25,4,CTTTTAGCGCGATTCAGCCG,21,1125052
fldAp,7.6,41,4,CTTTTACTTTAAGCACTCCT,37,1158550
fldAp,2.0,13,4,CTTTTACCGTCCTCTCTGTG,9,1167500
fldAp,21.4,110,4,CTTTTAATGGAAAAGGCCTA,106,1146153
fldAp,30.8,157,4,CTTTGGTTGCGGTTATCGCC,153,1174597
fldAp,12.0,63,4,CTTTAGAGTGCGGATAAGAA,59,1106674
fldAp,5.4,30,4,CTTTAATTCCCGGAGGTGGC,26,1144073
fldAp,0.4,5,4,CTTGTATAATGAGCTGATGT,1,1140181
fldAp,3.0,18,4,CTTGTAGTCTAAAATGGTGG,14,1124087
fldAp,23.2,119,4,CTTCCAGGTGAGACCCCACG,115,1078602
fldAp,8.4,45,4,CTTATATTTTAATCAGCGGA,41,1114959
fldAp,3.8,22,4,CTTAGGGATCAAAGTACTTA,18,1094701
fldAp,3.8,22,4,CTTAGCTAAATTCGGCGATA,18,1136578
fldAp,2.0,13,4,CTTACTATGGCGAACGAGGT,9,1184860
fldAp,7.0,38,4,CTGTGCTCGTTTCATGTCAA,34,1092235
fldAp,12.6,66,4,CTGTAAGTAGAAGTCAATAT,62,1100344
fldAp,1.8,12,4,CTGGGTGTGCTTCTAAGTTG,8,1102983
fldAp,6.2,34,4,CTGGCATGCAGCTATAAAAA,30,1149575
fldAp,11.4,60,4,CTGCGCAAACCGTAAGGGTA,56,1179452
fldAp,3.0,18,4,CTGCACTGGTTTCCCCACTA,14,1114648
fldAp,0.6,6,4,CTGATTAGGGGGAGCCGAAA,2,1073868
fldAp,3.8,22,4,CTGACCATTCTTTCGCCGAT,18,1182939
fldAp,0.4,5,4,CTCTCCTTCCTAAAATCTTA,1,1165477
fldAp,2.2,14,4,CTCTATCGGAGAATGGCCGC,10,1172562
fldAp,5.6,31,4,CTCGGTTGCCAATTAAATCT,27,1182015
fldAp,2.0,13,4,CTCGGATAATATTGAATCAA,9,1135409
fldAp,8.6,46,4,CTCGGAGATAGCCCGTTTAA,42,1174872
fldAp,2.6,16,4,CTCCTCCTACAGTTTCCCAA,12,1133608
fldAp,4.0,23,4,CTCCTAAGTCGATCCGTAGG,19,1068927
fldAp,18.0,93,4,CTCCGGAAATGTTACTGAAA,89,1167035
fldAp,3.6,21,4,CTCCGCCTCCGGACCCGAAC,17,1076209
fldAp,13.6,71,4,CTCATGCACAATTAATCCAT,67,1149093
fldAp,6.6,36,4,CTCATGAATCGGTTTTGTCG,32,1158054
fldAp,4.2,24,4,CTCAAGTCGTTATGATAGCT,20,1157047
fldAp,0.4,5,4,CTATGTGGAACCGGAACAGA,1,1121859
fldAp,6.4,35,4,CTATAGCGGTCGGTATTGTG,31,1158650
fldAp,0.4,5,4,CTAGTTCTGAGAAAAGAAGA,1,1135482
fldAp,5.0,28,4,CTAGTGACTCGATACTCACT,24,1139550
fldAp,10.6,56,4,CTAGGGGCATTAAACAGAGG,52,1118340
fldAp,5.2,29,4,CTAGGCAGATCGGAAATTTT,25,1103830
fldAp,3.2,19,4,CTAGATGGGCACTGGTGAGG,15,1166810
fldAp,2.6,16,4,CTAGACGCCTCTTAAATTAG,12,1173116
fldAp,4.0,23,4,CTACCGCTCAACCGTTTAGA,19,1089611
fldAp,1.8,12,4,CTAAGGACAGGAATAACGCA,8,1125416
fldAp,6.2,34,4,CGTTTAGGCCCGCGATTCAT,30,1122150
fldAp,4.0,23,4,CGTTTAAATATTTCTCCTTT,19,1077136
fldAp,14.4,75,4,CGTGGCTTGTTGTTCCCAAC,71,1101289
fldAp,3.4,20,4,CGTGCCGAACTCACACCGGA,16,1108286
fldAp,5.2,29,4,CGTGCAAACCAGCTTCCGTT,25,1070342
fldAp,3.0,18,4,CGTGATCACATGAGACATCA,14,1134412
fldAp,1.6,11,4,CGTCTATACTCTCTGACTAA,7,1095529
fldAp,6.0,33,4,CGTCCTTTGTCAGTTATCGT,29,1067376
fldAp,7.4,40,4,CGTCCTCTTGGCCGCTACAA,36,1165648
fldAp,4.4,25,4,CGTCATGATCTAGCGAATCG,21,1135703
fldAp,5.8,32,4,CGTCACCTCGCGGTCAACGT,28,1157883
fldAp,2.2,14,4,CGTATTTTTTGAACCAAAAG,10,1148816
fldAp,6.6,36,4,CGTATAAGCGTGCCCGATGT,32,1156742
fldAp,7.0,38,4,CGTACATTTGCTTTTAAGAC,34,1125368
fldAp,4.0,23,4,CGGTTAAAGGCCGGACATTT,19,1105259
fldAp,4.8,27,4,CGGTCACCGTGGTTGGTTTT,23,1106881
fldAp,0.4,5,4,CGGGGGGTGAGTGCCATGGC,1,1121174
fldAp,6.4,35,4,CGGGCGATTGATCCCTCCTG,31,1147124
fldAp,13.2,69,4,CGGGCCTGTTGAGCTTTTGA,65,1078613
fldAp,0.6,6,4,CGGGAGACCATGGTTTGTTC,2,1179897
fldAp,3.2,19,4,CGGGACCGGGATATGGCGGG,15,1081832
fldAp,0.4,5,4,CGGCCGGGGGGACCACGTAT,1,1124028
fldAp,4.2,24,4,CGGCCATTGGTGGCCAGTTG,20,1170756
fldAp,5.4,30,4,CGGAAGCGTTGACCTTGCGA,26,1082896
fldAp,15.6,81,4,CGCTGGGTACCAGAACTATA,77,1140902
fldAp,5.4,30,4,CGCTGCAGAATTATGGCTAG,26,1178389
fldAp,1.0,8,4,CGCTCTGAATTCTTCTAGGA,4,1140501
fldAp,8.6,46,4,CGCGTCACTCTTACGGTCAA,42,1112749
fldAp,2.4,15,4,CGCGCCGGCGAGTAATGGTA,11,1109695
fldAp,4.8,27,4,CGCGCACATGTAGGTCCTTT,23,1145003
fldAp,8.0,43,4,CGCCGGCTTACGGGACACGC,39,1065623
fldAp,0.4,5,4,CGCCGCATCTATGCATCGAA,1,1131369
fldAp,3.4,20,4,CGCATCTGGCCTTCCCAGGT,16,1121173
fldAp,2.8,17,4,CGCACCTAAAAATGATCAGA,13,1104241
fldAp,6.8,37,4,CGAGGATACCAGTGCCTCCT,33,1182452
fldAp,5.0,28,4,CGAGATATAGTGCCGGCCGA,24,1132236
fldAp,9.0,48,4,CGACGCGTTAATTTATCCCT,44,1063664
fldAp,37.2,189,4,CGACGAATCCCAGCAGCCAT,185,1176944
fldAp,4.8,27,4,CGACCGCGGCTACAATCCCT,23,1110412
fldAp,0.6,6,4,CGACATATTTTAGATATTAG,2,1099370
fldAp,6.0,33,4,CGACACAGCCCCGGATGCGG,29,1159514
fldAp,0.4,5,4,CGAAGGTTCCGCTGAGACAT,1,1148846
fldAp,3.6,21,4,CGAAGATTACTGCTCCAAAC,17,1113016
fldAp,11.4,60,4,CGAACTTGACATGCGATCTT,56,1173459
fldAp,8.8,47,4,CGAACAGGTGTGCGAAAGTT,43,1143074
fldAp,2.2,14,4,CCTTTTGGATATGAGTCTTT,10,1146980
fldAp,6.6,36,4,CCTTAGTTACAGGGTATGTC,32,1084677
fldAp,4.4,25,4,CCTGGCGGTGGGTAAAAGAA,21,1099428
fldAp,7.4,40,4,CCTGGACCCTACGGTGGACT,36,1074303
fldAp,11.4,60,4,CCTCGACTTAATGAGGGGCT,56,1074890
fldAp,0.4,5,4,CCTACTTTATGTACTCCGGA,1,1166468
fldAp,5.0,28,4,CCGTGCATGCGCCGGATCGC,24,1176730
fldAp,13.6,71,4,CCGGGGATTAAGGCGCAATT,67,1107662
fldAp,7.4,40,4,CCGGGGACGTCGTGACGTCG,36,1141534
fldAp,4.2,24,4,CCGGCCGGCGTTTTTCAGAA,20,1081551
fldAp,5.8,32,4,CCGCCTTGCATGGGACTACA,28,1088154
fldAp,6.8,37,4,CCGCATGCAAACTGATAGCC,33,1097467
fldAp,14.4,75,4,CCGATGTCTGGCCTCCCGTG,71,1119161
fldAp,8.4,45,4,CCGAGCAGTACGTTGAGTTC,41,1086410
fldAp,8.0,43,4,CCCTTCCGGATGGGGTAGCA,39,1108115
fldAp,11.6,61,4,CCCGCATCACGGAAAGAAGA,57,1077750
fldAp,3.2,19,4,CCCCATTTTTTCCATTCATG,15,1139802
fldAp,0.4,5,4,CCCAACTTCAGGTCGGTTCA,1,1185814
fldAp,10.8,57,4,CCATTCGCACGTTAGTAATT,53,1145239
fldAp,4.0,23,4,CCATTCCGAAAATGCCTGTT,19,1173068
fldAp,2.8,17,4,CCACGTTGGTCAACCCATGT,13,1096604
fldAp,7.0,38,4,CCACCCCTCCGCCAACCTGT,34,1132243
fldAp,0.4,5,4,CCAATGGCCGGGGTCTGGGA,1,1145234
fldAp,0.4,5,4,CCAAGTTTGTACGTCAAGTG,1,1152734
fldAp,4.0,23,4,CCAAGCTCGCAAGTGCGGCA,19,1121770
fldAp,0.4,5,4,CCAAGATGGTCTCAGGGCCA,1,1166836
fldAp,12.8,67,4,CCAACTTCGGGTGAGGCGTA,63,1150110
fldAp,8.2,44,4,CATTTCTTAGTACAAACGCT,40,1116509
fldAp,23.8,122,4,CATTTCCGCGTTGCCTGTCG,118,1107685
fldAp,5.6,31,4,CATTGGTGCCGAGCTCGGGA,27,1127169
fldAp,0.4,5,4,CATGTATCGTATTAGCCTTG,1,1172922
fldAp,3.8,22,4,CATGGGCGTTTAGCACGGGT,18,1105519
fldAp,5.0,28,4,CATGATTTTTTCCGTAAGAA,24,1131852
fldAp,0.4,5,4,CATGAGTTCACTAGATATAA,1,1163878
fldAp,9.0,48,4,CATAGGCTTTCGGCAGCTAG,44,1102787
fldAp,0.4,5,4,CATAGCTGTGATTTCAAGAT,1,1066225
fldAp,0.4,5,4,CATACGATGACATGGGTTGT,1,1083896
fldAp,4.6,26,4,CAGTTAGGGCCTTTGTAATA,22,1105836
fldAp,8.0,43,4,CAGTTAACACGGGTATTCTC,39,1063732
fldAp,4.6,26,4,CAGTCGCTCGAGGTCACTGC,22,1109068
fldAp,6.2,34,4,CAGGTAATACGCGGTTGGCT,30,1153516
fldAp,4.8,27,4,CAGCGCTCGTTCCCGGCTTC,23,1176617
fldAp,2.6,16,4,CAGCGCCGAGGCCGACCGAT,12,1089120
fldAp,2.6,16,4,CAGATTGGTAGATTGCGTAC,12,1090039
fldAp,4.6,26,4,CAGACTGTTACTAAAATTGC,22,1146583
fldAp,2.4,15,4,CAGAAGTTGTCTTATTAGCT,11,1169763
fldAp,8.8,47,4,CACTTAAGGAATGATGAGTA,43,1173530
fldAp,11.2,59,4,CACTCCTCGGTTAAGAATAC,55,1161260
fldAp,4.2,24,4,CACTATACGATTGGTGGCGG,20,1149664
fldAp,6.0,33,4,CACATCCCATTTGCGAGTGT,29,1168942
fldAp,8.4,45,4,CACAGATGAACCTCCAATCT,41,1171988
fldAp,3.4,20,4,CAATGTCGGCAAAATCACCC,16,1123493
fldAp,3.0,18,4,CAATCTGGCACAGCGATGCG,14,1176080
fldAp,4.2,24,4,CAAGTGGGTGACAATCCGTT,20,1104509
fldAp,0.4,5,4,CAAGTATGGTCACTGCTCCT,1,1181868
fldAp,0.6,6,4,CAAGGTCAATCGAATCCTTG,2,1133803
fldAp,4.4,25,4,CAAGGACGTCCCACTTCCTT,21,1101377
fldAp,1.2,9,4,CAAGCCTATAACATTGTTAG,5,1093430
fldAp,5.6,31,4,CAAGATCACGTAGCTTACGC,27,1129571
fldAp,0.4,5,4,CAAGAATCAGTATAAAGTAG,1,1171351
fldAp,0.4,5,4,CAACGTAATCACAGTGTCGC,1,1180943
fldAp,3.8,22,4,CAACGGTACGACAGGCGACG,18,1095832
fldAp,0.6,6,4,CAAAGTCGGGTGAAGGTAAT,2,1064102
fldAp,7.8,42,4,CAAAGCCACGCAGGTGGCGT,38,1164354
fldAp,0.4,5,4,CAAACGTGAGCTAGTGCACA,1,1091915
fldAp,0.4,5,4,ATTTTTCCGACAGTCATTTA,1,1176554
fldAp,8.4,45,4,ATTTTAGATCGGGTCGGGAC,41,1081049
fldAp,2.4,15,4,ATTTGATTATCCTAACAATC,11,1175456
fldAp,4.2,24,4,ATTTCCCGGAAAGTCGGAAT,20,1183451
fldAp,0.4,5,4,ATTGTCCCATAGTGATAAAC,1,1118189
fldAp,12.6,66,4,ATTCATCAAACGGGCGGGCA,62,1153818
fldAp,5.2,29,4,ATTAGTCGTGTCAAACATAA,25,1076059
fldAp,2.8,17,4,ATTAGTAAAGACCTAGAGGA,13,1154037
fldAp,0.4,5,4,ATTAATTATATGCTTACAAA,1,1121462
fldAp,6.0,33,4,ATTAAGTATGGCGTTTTACG,29,1165876
fldAp,0.6,6,4,ATGTGGGTCGCGCCCTGCGA,2,1113412
fldAp,0.4,5,4,ATGTGCTCTAGGAAAAGTTA,1,1072843
fldAp,0.4,5,4,ATGTCTTGTAGACGGACGGG,1,1071380
fldAp,2.0,13,4,ATGTAGTGTTTCATCGTGCA,9,1135003
fldAp,5.2,29,4,ATGGTTCTCGGCCACTGCGC,25,1108187
fldAp,4.6,26,4,ATGGCGGCGTGCTTAGGTGG,22,1083539
fldAp,5.2,29,4,ATGGAGCGACTCTTTTGCAG,25,1145208
fldAp,8.4,45,4,ATGCGTGACCGAGAAGGGTG,41,1169669
fldAp,9.6,51,4,ATGCGTAAGTACTTCGTTAC,47,1105538
fldAp,8.2,44,4,ATGCACAGGAGTTAGGGAGA,40,1074133
fldAp,6.4,35,4,ATGAGCTTAAGGTGCTCGCT,31,1080693
fldAp,0.8,7,4,ATCTGCTTTACTCCCTACGT,3,1125725
fldAp,0.4,5,4,ATCTCCTATCGACAAGGTGC,1,1110092
fldAp,0.4,5,4,ATCTAGAATGCAATTCTGCC,1,1081853
fldAp,4.4,25,4,ATCGGTGCTCGATCGGGGAC,21,1109417
fldAp,5.4,30,4,ATCGGCTAAGAGCTGCAGGG,26,1186296
fldAp,0.4,5,4,ATCGCGTGAGGATCTCAATG,1,1088868
fldAp,3.0,18,4,ATCGCAACCGTTAAATGCCC,14,1166100
fldAp,3.2,19,4,ATCCTCGTCTCCGCCGTAGT,15,1093297
fldAp,39.6,201,4,ATCCACAAGGTAGATATTAT,197,1107659
fldAp,6.0,33,4,ATCAGCATCTGCCATCGTAA,29,1174585
fldAp,3.0,18,4,ATATTCATCTGGGTTACGCC,14,1152391
fldAp,4.2,24,4,ATATTCAGCTTTCGACGGGG,20,1131022
fldAp,3.4,20,4,ATAGTTTTCGAGAACTCTGT,16,1165136
fldAp,3.4,20,4,ATAGTTAATCACTAAACAAT,16,1175700
fldAp,2.8,17,4,ATAGCAATGTTAAAGACCAT,13,1104077
fldAp,5.2,29,4,ATACTGGCGTCTTAGTCGCA,25,1069471
fldAp,0.4,5,4,ATACGCAAACGTCTGTAAAT,1,1155273
fldAp,2.2,14,4,ATACATGGCCTTAAACTCGG,10,1158175
fldAp,21.6,111,4,ATAAGCGTCGGACCCCGTCG,107,1084548
fldAp,4.0,23,4,ATAACTCTGGAGATAATTAC,19,1122133
fldAp,8.0,43,4,AGTTGAGTAACCGCATTATA,39,1139139
fldAp,0.4,5,4,AGTTCCTGGAAAGCTCTTTA,1,1098933
fldAp,37.6,191,4,AGTTCCGCCCTTTTGTGGTT,187,1126526
fldAp,0.8,7,4,AGTTCCCAATGCGAACCATC,3,1175606
fldAp,11.2,59,4,AGTGTTACTCTCCGTTTAGA,55,1070422
fldAp,10.2,54,4,AGTGTAAATGAATTAGGGCA,50,1114875
fldAp,6.2,34,4,AGTGGGCAAGTTAGCGGGTC,30,1159239
fldAp,1.8,12,4,AGTGGCCAGACCACGGCACA,8,1147733
fldAp,10.2,54,4,AGTGCAGTATAAGCATCCTG,50,1174586
fldAp,6.2,34,4,AGTCTCATGAGGTTTCATGC,30,1136591
fldAp,2.8,17,4,AGTCGCAGTTAGCCTGGTGG,13,1129604
fldAp,2.2,14,4,AGTCCTCATAATACCCTCCT,10,1124049
fldAp,3.6,21,4,AGTCAAGGGATCGATTCGTT,17,1139156
fldAp,2.4,15,4,AGTATGATGAAAAGAGAGAA,11,1159144
fldAp,4.4,25,4,AGGGTCCCGATCGGGACTTT,21,1092207
fldAp,3.8,22,4,AGGGGCGTTGTAAATTTAAC,18,1186293
fldAp,2.0,13,4,AGGGCTAGGATAGAGGTAGA,9,1067793
fldAp,5.2,29,4,AGGGAGTCGAGGGATGACGA,25,1064296
fldAp,5.8,32,4,AGGCTTGCAGTGTACACAAC,28,1157636
fldAp,5.4,30,4,AGGCTGGTTCATTCATCGGA,26,1114862
fldAp,12.2,64,4,AGGCGTCTGGTTCGAGCTAC,60,1137783
fldAp,8.6,46,4,AGGCGAACAAAATTTAAGGA,42,1133624
fldAp,4.8,27,4,AGGCATTGTAATTTTTACAT,23,1140066
fldAp,6.8,37,4,AGGAACACTCTGTGCCGCAG,33,1109655
fldAp,6.0,33,4,AGCTTTGGTAGGGGGACTAA,29,1162725
fldAp,8.4,45,4,AGCTTAAAGGTTCATAAGGC,41,1081880
fldAp,0.4,5,4,AGCTGGGCCACTCGGTTCGA,1,1159580
fldAp,5.8,32,4,AGCTAGTGCGGCTATGTTTG,28,1094044
fldAp,9.6,51,4,AGCGTTAAACGGATAATGGA,47,1157441
fldAp,0.6,6,4,AGCGTAAAGCGTGCCTTGCG,2,1143084
fldAp,8.8,47,4,AGCGGGGACTTAGGGTCGGA,43,1144256
fldAp,0.4,5,4,AGCATATTGTTACCGGACGA,1,1167858
fldAp,3.6,21,4,AGATTAATGTCGCAATTGTT,17,1115185
fldAp,8.2,44,4,AGATGAACGAAGTACGGCCC,40,1155225
fldAp,0.4,5,4,AGAGCGGAGACCGTGGTTTG,1,1069475
fldAp,6.8,37,4,AGACGGAGCCGCCTCGTTAT,33,1065476
fldAp,6.2,34,4,AGACCGCAGGCCTTAACTAG,30,1075770
fldAp,9.0,48,4,AGAAGGCTCCGGCATCAACG,44,1084551
fldAp,4.2,24,4,AGAACGGACGGAAATTTAAG,20,1095441
fldAp,4.8,27,4,AGAAATCAATATAGCCCGGA,23,1073805
fldAp,6.6,36,4,ACTTTCCAATTTCCGAAGAA,32,1084532
fldAp,11.2,59,4,ACTTGTCGAGTCCACAGCAG,55,1077980
fldAp,2.4,15,4,ACTTGCGTTCGTCTGACTAA,11,1166789
fldAp,5.4,30,4,ACTCTGGTTGCTAGTAGAGT,26,1087355
fldAp,3.6,21,4,ACTCTCTCTTCTAGGCAGCA,17,1077951
fldAp,4.2,24,4,ACTCTCCGGCGTGTATGAAC,20,1177706
fldAp,3.6,21,4,ACTCGCGTCGGACCCCGGTT,17,1106277
fldAp,3.8,22,4,ACTCGCAAAATGTGGGTTGT,18,1109699
fldAp,6.0,33,4,ACTCAATTAATCCCGGGGGC,29,1080534
fldAp,6.4,35,4,ACTATTCGGAGCGCATTTCT,31,1137139
fldAp,3.6,21,4,ACGTTGCAGAGTCAATCCTT,17,1157225
fldAp,3.2,19,4,ACGTGTTTTCTTCCTCTCGA,15,1114495
fldAp,3.0,18,4,ACGTGCGTATGACAACGTGG,14,1180696
fldAp,3.6,21,4,ACGTACATAAAAACTAATGT,17,1150226
fldAp,3.2,19,4,ACGGAGGCCCCGGACAAGGC,15,1180432
fldAp,10.6,56,4,ACGGACGCTTCTGCGCTTTA,52,1125820
fldAp,4.0,23,4,ACGCTGTTAACCACCCCAAG,19,1130462
fldAp,2.6,16,4,ACCTGCACTGTTGCGCTTAT,12,1068579
fldAp,0.4,5,4,ACCTGCACGGTACTCGAAAG,1,1141062
fldAp,12.2,64,4,ACCTCTCACACAGCCGTTTA,60,1072064
fldAp,7.6,41,4,ACCTCGGACATCAAAGGGAA,37,1160648
fldAp,7.6,41,4,ACCGGTCCCGCTATAGGTTC,37,1104173
fldAp,8.4,45,4,ACCGGAGACGTAAGGATTTA,41,1078726
fldAp,10.0,53,4,ACCCCGATTGGTACGCCGGT,49,1069205
fldAp,8.4,45,4,ACCCACGTCGGGGATTGCTC,41,1168667
fldAp,0.4,5,4,ACAGTCATTGTTTAGGCCAT,1,1170405
fldAp,8.0,43,4,ACAGTAGCGGGATCACATTG,39,1080686
fldAp,4.6,26,4,ACAGGCGCCACTCGAGTTCT,22,1143105
fldAp,2.8,17,4,ACACTCGAATTTACCTTTGA,13,1182007
fldAp,0.4,5,4,ACACGGAGAATGGGAAACGT,1,1080304
fldAp,10.8,57,4,ACACGCAGAGTCAGTATTTA,53,1169008
fldAp,6.8,37,4,ACACCTCTGACGGATCGCAC,33,1144027
fldAp,5.6,31,4,ACACAGCAGTGCCAGTCCTC,27,1148086
fldAp,22.2,114,4,ACAAGGGAGTAGATATGAAT,110,1111119
fldAp,2.0,13,4,ACAACTAAAAGTGCTGTAAG,9,1168999
fldAp,0.4,5,4,AATTTTTACGTTTTGCTCTA,1,1159046
fldAp,6.6,36,4,AATCTCTCTATTGGGTGCCG,32,1069574
fldAp,23.4,120,4,AATCGGGGGTAGCCATTATT,116,1064774
fldAp,1.0,8,4,AATCCCCTTAGGGACACATA,4,1106527
fldAp,7.4,40,4,AATCATTTTGCTGACCCATT,36,1069568
fldAp,14.2,74,4,AATATATAGAATCGTATACG,70,1138421
fldAp,6.0,33,4,AATAACGCATATTTATTCAT,29,1122200
fldAp,7.2,39,4,AAGTGATGTAAGGCAGCTTT,35,1103978
fldAp,21.6,111,4,AAGTAGGCTCCCGTGTACAG,107,1100410
fldAp,4.0,23,4,AAGGTATTTTGTGGAAGTGC,19,1166367
fldAp,1.8,12,4,AAGGGCACCCGAAAAGCTTG,8,1136666
fldAp,7.8,42,4,AAGGCACGGTGTGGTAGTTA,38,1107461
fldAp,2.0,13,4,AAGCACGGAGTCGCTGAGAT,9,1162585
fldAp,6.6,36,4,AAGATGGTACTGTAGAGAGG,32,1065934
fldAp,0.6,6,4,AAGAGTCGGACCAATGACAG,2,1074446
fldAp,3.6,21,4,AAGAGTAACTACAGAATGGG,17,1130620
fldAp,4.6,26,4,AAGACAGGGAGCCTCGTTTC,22,1151876
fldAp,3.0,18,4,AAGAACAAGTTAGTTCTTAG,14,1126268
fldAp,0.4,5,4,AACGTGAATCCCCAGAGCTT,1,1161343
fldAp,5.6,31,4,AACGTGAACCCGCCTAATTT,27,1176173
fldAp,7.2,39,4,AACGTCCTACAATTCGATCT,35,1113424
fldAp,0.4,5,4,AACGCTTAGACTCGAGCTTA,1,1075027
fldAp,5.8,32,4,AACCATTATGGATGTTCCGT,28,1084456
fldAp,6.2,34,4,AACATTTACTGCAAAAGATT,30,1106438
fldAp,0.4,5,4,AACATTCACACCATTGCAAC,1,1120065
fldAp,7.2,39,4,AAATGGTCCTAGTGGGATAA,35,1159309
fldAp,2.2,14,4,AAATCCAGGTTTTAACAATG,10,1066620
fldAp,3.0,18,4,AAATCAGTATCGTGTGGGGG,14,1075903
fldAp,1.4,10,4,AAAGTCATTGGATCCAGGAA,6,1183203
fldAp,0.4,5,4,AAAATTTCGTATCAGTCTTG,1,1177470
fldAp,12.4,65,4,AAAAGCCGATGGCACGCGTA,61,1126542
fldAp,19.8,102,4,AAAACTTTCATAGGCGGGAG,98,1151178
fldAp,4.0,23,4,AAAAACTAAGACATGTATAT,19,1169793
fldAp,4.75,21,3,TTTTAGCTGTGCTGTCACCT,18,1078248
fldAp,6.75,29,3,TTTGAATTCGAGCACTGCCA,26,1113198
fldAp,2.5,12,3,TTTGAAATATCCAAGGTGAA,9,1166012
fldAp,0.75,5,3,TTTCTCTCGACTTACGGGTC,2,1183595
fldAp,0.5,4,3,TTTCGCACTCTTGTTATGGA,1,1085695
fldAp,0.75,5,3,TTTCCATTCGTTGGCATGAC,2,1120785
fldAp,11.25,47,3,TTTCACGCCGAATGTTATGA,44,1174330
fldAp,10.75,45,3,TTTCAAGGCGGTGCCAGGTA,42,1149532
fldAp,12.25,51,3,TTTACAAACCTTAACGGATG,48,1166540
fldAp,6.5,28,3,TTGTTAATGACAGTGCAGAC,25,1142856
fldAp,0.5,4,3,TTGTGGATAGGAGGTCAGGA,1,1105303
fldAp,14.5,60,3,TTGGTGGTGCTTGCTGCAAG,57,1137641
fldAp,3.75,17,3,TTGGGGTTCCCACGCAACAA,14,1114983
fldAp,0.5,4,3,TTGGAGAGCGGGTACAAATC,1,1130697
fldAp,0.5,4,3,TTGGAATTATGATTCTGGCC,1,1095649
fldAp,9.5,40,3,TTGCTTTCGTATGGTTGGGT,37,1101522
fldAp,23.5,96,3,TTGCCTGTTGTACCCCGTAT,93,1177219
fldAp,10.0,42,3,TTGCCGCGATTATGCGTTTT,39,1066283
fldAp,6.75,29,3,TTGCATAGATTCAGGTACCC,26,1112951
fldAp,6.0,26,3,TTGCACCTCGGACGTATATT,23,1096034
fldAp,6.25,27,3,TTGAGAACGGAATAACTTCT,24,1161557
fldAp,17.25,71,3,TTGAAGTTTGGCTGGATAAG,68,1114573
fldAp,0.5,4,3,TTGAAAATTTAACCAGGGTC,1,1168521
fldAp,5.5,24,3,TTCTTCTCACATCATTAATC,21,1101582
fldAp,2.5,12,3,TTCGTTGAAGGCTTCACGGA,9,1131319
fldAp,6.0,26,3,TTCGTGTGTGCTGGGTTTGG,23,1170154
fldAp,8.5,36,3,TTCGGAACGCATTCAGGAGG,33,1108985
fldAp,1.5,8,3,TTCGAGAATTCGCGTACCTA,5,1172954
fldAp,5.5,24,3,TTCCTTTGGAAATCTGCTTC,21,1090479
fldAp,8.5,36,3,TTCCACCACTTCCAACTTCC,33,1140203
fldAp,1.5,8,3,TTCATCAGTATGTGCCAAGC,5,1111833
fldAp,7.25,31,3,TTCACTAAGGCCAAACCAAT,28,1183467
fldAp,1.75,9,3,TTATTAACGCGACATGGTGT,6,1178139
fldAp,4.25,19,3,TTATCCCGCAATTTGCGGTT,16,1071940
fldAp,9.0,38,3,TTAGGCCTGGCCAAGCACGC,35,1133762
fldAp,0.5,4,3,TTAGCTTCTGGCCGACAGGA,1,1073109
fldAp,7.25,31,3,TTAGCAGGCGGAAGTTAACC,28,1063469
fldAp,5.0,22,3,TTAGATTCAGGTCACTGGCG,19,1080162
fldAp,8.25,35,3,TTACACCGGCACAAAAAGTA,32,1152770
fldAp,7.5,32,3,TTAATTTTCGCGCACCTCAA,29,1136328
fldAp,0.5,4,3,TTAACACTAGTTTACCACAT,1,1157937
fldAp,12.75,53,3,TGTTTAGTCGAAGGGGACAG,50,1140892
fldAp,14.0,58,3,TGTTCCTACGGAACACCTCG,55,1140566
fldAp,1.75,9,3,TGTGCTTTGCTGCCAACACC,6,1155465
fldAp,17.25,71,3,TGTGCTGACGCAATCGGGAT,68,1155664
fldAp,6.0,26,3,TGTGAAGGCAAGCGTGGTCT,23,1063391
fldAp,7.0,30,3,TGTCTTTTTATGCCGTTGTC,27,1095513
fldAp,7.5,32,3,TGTCTGTTTAGGGGCCGTCT,29,1186782
fldAp,4.5,20,3,TGTCGAGCACACCGACACAA,17,1144643
fldAp,4.75,21,3,TGTAGAAACCGACGCGTCTT,18,1165490
fldAp,6.5,28,3,TGTACTTTACCCTATAATTA,25,1166549
fldAp,33.25,135,3,TGGTTGTACATTAAAAGGGG,132,1135662
fldAp,4.75,21,3,TGGTGTAGGGGTGCATCCAA,18,1115103
fldAp,8.25,35,3,TGGTGCAAGGTACCATAGCC,32,1137393
fldAp,18.0,74,3,TGGTGAGGTTAGGCCGCTGA,71,1147732
fldAp,18.25,75,3,TGGGGGGCCTTTTACGTACT,72,1085515
fldAp,10.75,45,3,TGGCTAAGTCGAAACCGGCA,42,1178703
fldAp,6.5,28,3,TGGCCGCACAACAAACGCCC,25,1181510
fldAp,11.25,47,3,TGGCATCCGCGCGTATGTTT,44,1146239
fldAp,9.0,38,3,TGGCAGTCTTACGAGTGGGT,35,1136115
fldAp,5.5,24,3,TGGCAACAGCGTTAGCAGCA,21,1166744
fldAp,3.5,16,3,TGGATCTTGAGACCAAGAGT,13,1110174
fldAp,0.5,4,3,TGGACTGCGTCCCGCGGACT,1,1069395
fldAp,11.0,46,3,TGCTTTGGAGGTGTTGCAGC,43,1171891
fldAp,36.25,147,3,TGCTTGTGGGCGTATCAGAC,144,1066026
fldAp,9.25,39,3,TGCGTTCCCACAACGGCGGT,36,1081770
fldAp,6.0,26,3,TGCGTCATAAATTTGGGATC,23,1168171
fldAp,1.75,9,3,TGCGCTCAAGACGCCCGGTC,6,1157008
fldAp,7.0,30,3,TGCGCTACATGGCCGTGCTT,27,1077796
fldAp,0.5,4,3,TGCGCCTTTTTTGAATCGGA,1,1147719
fldAp,5.5,24,3,TGCGAGGCGCCTGTCTTAAC,21,1093876
fldAp,6.5,28,3,TGCGAGAAGAGAGATTGAAG,25,1162593
fldAp,3.75,17,3,TGCCTGGGACAGTTAAATAA,14,1085301
fldAp,0.75,5,3,TGCCGGATCCGCATTATGCA,2,1091046
fldAp,2.25,11,3,TGCCCCCGAGCCGGACCGCT,8,1184359
fldAp,9.0,38,3,TGCCACGGCCTTCTTTGGGA,35,1140547
fldAp,16.5,68,3,TGCATTCATGCTGATTCTCA,65,1094232
fldAp,7.5,32,3,TGCAATTCAGCTCGGGAGGA,29,1077170
fldAp,16.25,67,3,TGCAAGAAGATCCAGCGTTG,64,1065999
fldAp,8.5,36,3,TGATGTTGAGCGGAACGAGC,33,1097153
fldAp,26.25,107,3,TGATGCCAACTGGCTGCATG,104,1150944
fldAp,0.5,4,3,TGAGGGCTATAGTTAGGACT,1,1131883
fldAp,15.25,63,3,TGACTCGACTGTTTATCGGT,60,1165495
fldAp,1.0,6,3,TGACGAAGAGCCCAGACTAT,3,1179803
fldAp,0.5,4,3,TGACCTGAAAGGCATTCCGA,1,1158799
fldAp,6.5,28,3,TGAACATCGCTTATCGCTGG,25,1135892
fldAp,6.5,28,3,TCTTTTTCAATTAAGGCACA,25,1076739
fldAp,5.5,24,3,TCTTCCCCCAGCAATACGCC,21,1165519
fldAp,4.0,18,3,TCTGTCGCAGAGTGTCTGAT,15,1164465
fldAp,8.25,35,3,TCTGGTGATCAGATGGCACA,32,1124338
fldAp,5.25,23,3,TCTGCGCGCAAAATAGATAA,20,1168822
fldAp,12.75,53,3,TCTCGGTTCGGGAGGAGAGG,50,1109783
fldAp,19.75,81,3,TCTCACCCTACTACGCATAG,78,1124140
fldAp,10.25,43,3,TCTATGCGTACGTCTCTCAT,40,1117214
fldAp,1.5,8,3,TCTATGCGGAGTTAAGGTGG,5,1077549
fldAp,2.25,11,3,TCTATAACGGTGCTAACAAA,8,1063997
fldAp,5.5,24,3,TCGTTCGGCCACATGCTTTT,21,1166315
fldAp,74.25,299,3,TCGTCAGATTAGCGGTCCGT,296,1118365
fldAp,3.5,16,3,TCGTAGACGTGAGTTGATTA,13,1172546
fldAp,7.0,30,3,TCGGAAAGGCAAGCCGTCGG,27,1066623
fldAp,11.75,49,3,TCGCATGGCTACATGACATC,46,1168315
fldAp,8.25,35,3,TCGATTTATAGAGCGGCAAC,32,1141984
fldAp,15.5,64,3,TCGATCACAGTTGCCGACAA,61,1158013
fldAp,4.75,21,3,TCCTGCGTATTCCTACACAT,18,1099318
fldAp,1.0,6,3,TCCTCCAGTGCTGCCTTAAA,3,1179888
fldAp,1.0,6,3,TCCTCCAATATTAATATGGC,3,1106298
fldAp,9.0,38,3,TCCTCAGTCTTCCTACGCAG,35,1115719
fldAp,56.0,226,3,TCCGTAATGCTATCTGACGA,223,1063642
fldAp,5.75,25,3,TCCGGGGACCTTATCCCGGA,22,1163005
fldAp,6.25,27,3,TCCGAATATTCACGTGCATA,24,1074143
fldAp,15.0,62,3,TCCCTCGTTACGGTATGGTG,59,1144252
fldAp,20.5,84,3,TCCCTATAGGATGGAGGGTC,81,1184862
fldAp,9.75,41,3,TCCCGGCGCCCATCACGTGT,38,1124601
fldAp,2.0,10,3,TCCCGGATCCCCTCCTGAGC,7,1129735
fldAp,5.75,25,3,TCCACGCGCGATTTTGATCG,22,1182917
fldAp,7.75,33,3,TCCAAAGTGGTACGAATTGT,30,1105413
fldAp,3.5,16,3,TCATTTGCTGCGTTTACGGA,13,1129933
fldAp,2.5,12,3,TCATTCGGGCGACTAGACCC,9,1080851
fldAp,5.0,22,3,TCATGAATGCCAATGAAGGG,19,1140893
fldAp,3.25,15,3,TCATGAACGCCCCCAGCCCA,12,1154500
fldAp,6.75,29,3,TCATCGAGTCGTGTCCATTC,26,1092312
fldAp,0.5,4,3,TCATCCCTGGAGTGGCCGTT,1,1173341
fldAp,0.75,5,3,TCATCACTGCGATTCATTTT,2,1161202
fldAp,0.75,5,3,TCATACTAATATGACAGAAT,2,1168941
fldAp,1.25,7,3,TCAATCAGCCGCCGGTACCA,4,1181177
fldAp,3.0,14,3,TCAACATTCCTCCACGGCAT,11,1069491
fldAp,18.5,76,3,TCAACAAGAGTAGGCTATGA,73,1178672
fldAp,8.25,35,3,TCAAATAACCCAGGATAAGA,32,1166169
fldAp,8.25,35,3,TCAAAATCGGCCCCAGTGAG,32,1161294
fldAp,0.5,4,3,TATGCGGCCCGTCTAGAGTT,1,1097911
fldAp,0.5,4,3,TATGCATGTCTTTGAGAGTG,1,1072155
fldAp,0.5,4,3,TATGCAAAAACTATACGGTT,1,1149980
fldAp,8.75,37,3,TATCGTCGTGCTATCTAACC,34,1065998
fldAp,3.5,16,3,TATCATTTCCCATCTGTAAC,13,1161396
fldAp,7.75,33,3,TATCATTGCCGGAAGTTGTC,30,1108876
fldAp,2.75,13,3,TATCAGCTCGAACTGACAAG,10,1076420
fldAp,5.25,23,3,TATATGAATGTCCAATAAAC,20,1126218
fldAp,5.75,25,3,TATATCCCTGGTTTGCCAAT,22,1155714
fldAp,24.25,99,3,TATATCATGCGGGTTGGCGC,96,1135708
fldAp,0.5,4,3,TAGGGCAGTTATTGCTTAGC,1,1152054
fldAp,2.0,10,3,TAGGCACACAATACCACGCA,7,1127937
fldAp,11.25,47,3,TAGCTTAACAACAGAAGCTT,44,1082572
fldAp,4.25,19,3,TAGCGTTCGCACAAAGCTTC,16,1167388
fldAp,1.75,9,3,TAGCCGCTATAATCGGTATG,6,1138846
fldAp,3.0,14,3,TAGCATAACTCGTCGCCTAA,11,1161285
fldAp,6.5,28,3,TAGAGTTGGAGACTGAAGGA,25,1163532
fldAp,25.75,105,3,TACTGGAACAAGTATTGCGT,102,1166695
fldAp,4.5,20,3,TACTGCATTGGTAGATAATT,17,1153866
fldAp,0.5,4,3,TACTACTCGGTGTTGTGGTT,1,1131759
fldAp,5.25,23,3,TACGTATCCATATCCCTTGT,20,1114189
fldAp,6.75,29,3,TACGTACGGTGGCGTATTAG,26,1139419
fldAp,6.75,29,3,TACGGAAAAGGCTACTGGGC,26,1109324
fldAp,9.25,39,3,TACCGCACGCAGTAGGACTA,36,1121874
fldAp,5.75,25,3,TACCCTTGAGTGATGCATGT,22,1110368
fldAp,4.0,18,3,TACCCCAATTGCTCCCACCC,15,1120837
fldAp,7.0,30,3,TACAGTTTATCTTACCCAGT,27,1156566
fldAp,5.0,22,3,TACAAGTCATGACGATTCCA,19,1071231
fldAp,7.25,31,3,TAATGTAAAGGACTCCGGGG,28,1174610
fldAp,0.5,4,3,TAATCACGGGCACGTCCTAC,1,1133529
fldAp,6.5,28,3,TAATACTTACGCTCATCATC,25,1093766
fldAp,16.0,66,3,TAAGGTACTCGAGGATCCCA,63,1123221
fldAp,1.25,7,3,TAAGGAATTTCGTTGCCGGG,4,1079087
fldAp,3.0,14,3,TAAATTCGGGCCGCTACGAT,11,1174827
fldAp,13.25,55,3,TAAAATTAGTGCTTAAGACT,52,1128031
fldAp,17.25,71,3,TAAAATAGCGTTTCAGATTA,68,1066045
fldAp,9.0,38,3,GTTTTCGCGAACACAGCAGC,35,1067719
fldAp,6.5,28,3,GTTTTACCATTGGCGTAATG,25,1077547
fldAp,9.25,39,3,GTTTGGGATCATGCCCGTAT,36,1067857
fldAp,4.75,21,3,GTTTAGTCTTTAGAGTGGCG,18,1186372
fldAp,7.0,30,3,GTTGTGAGGCCGCTTAGGAT,27,1110819
fldAp,0.5,4,3,GTTGGTGGTGTTTCTGGGTG,1,1170427
fldAp,0.5,4,3,GTTGCCCCTAACGCATCGCG,1,1141426
fldAp,23.75,97,3,GTTGAACAAGTTTACGTGGG,94,1162489
fldAp,5.5,24,3,GTTCAGGTTACGTGCATGAT,21,1171744
fldAp,5.75,25,3,GTTACGTCGCTTCTGGCTTC,22,1090344
fldAp,9.25,39,3,GTGGTGTATCAATCATACAA,36,1146488
fldAp,9.5,40,3,GTGGCCCCATCAACATCTAG,37,1160507
fldAp,10.0,42,3,GTGGCATCACCCCAGAGGTA,39,1185931
fldAp,4.5,20,3,GTGGATGCTGTTTGAGTTCT,17,1127878
fldAp,7.75,33,3,GTGACGACTTCATGGCGGTT,30,1097243
fldAp,16.5,68,3,GTGACAGGAAGTCGAGCAGG,65,1079214
fldAp,5.75,25,3,GTCGTGGTTGACATATGATT,22,1066670
fldAp,0.5,4,3,GTCCCGACGCGCTTGGGATG,1,1119801
fldAp,6.25,27,3,GTCCATCTAAACTATACGTC,24,1103508
fldAp,9.25,39,3,GTCATCTCCCGCTTCTGTCC,36,1096986
fldAp,8.0,34,3,GTCATCCTGCGTGTAGGCCC,31,1137558
fldAp,5.0,22,3,GTCACCAATGATTGGCGACC,19,1166032
fldAp,2.5,12,3,GTCAATGGTCCCAGTGATTT,9,1161213
fldAp,1.5,8,3,GTATGGCAAGAATCAAAAAT,5,1162119
fldAp,1.0,6,3,GTATAGTAGGTTGCCACCCC,3,1151270
fldAp,3.5,16,3,GTATAAGGACGCTGTCCACT,13,1149180
fldAp,6.75,29,3,GTAGGTCTGCAGTGAAACAG,26,1127306
fldAp,0.5,4,3,GTAGGACTCCACAGTAGATC,1,1079810
fldAp,4.5,20,3,GTAGCCGAGTCGGCCGATAG,17,1080196
fldAp,1.25,7,3,GTAGACCGTCGCAGTTAATC,4,1183590
fldAp,2.0,10,3,GTACCTATCAGGGACGAGGC,7,1089304
fldAp,13.0,54,3,GTACCGCGTAACCAGCGCTT,51,1168931
fldAp,10.0,42,3,GTACCACGGTGAGGGCGTTT,39,1171558
fldAp,7.0,30,3,GTAAGTAAGAAGTGAGGGTG,27,1165996
fldAp,8.0,34,3,GTAAGCGACGTAGCAGCAAG,31,1151297
fldAp,9.5,40,3,GGTTTTGTTGTGGCCGTAAT,37,1067706
fldAp,27.75,113,3,GGTTTGAACGGTTCCAATAC,110,1173551
fldAp,8.0,34,3,GGTTGGGTCTACCGGGAGGG,31,1156736
fldAp,5.25,23,3,GGTTGAAGTTGTAGTGCCGC,20,1122735
fldAp,2.5,12,3,GGTTCTGGTTTCTGTCCAGC,9,1065833
fldAp,0.5,4,3,GGTGGCCAGAAACGTGGAAG,1,1069792
fldAp,0.5,4,3,GGTCGCGCAAACAACGCTGT,1,1118852
fldAp,9.5,40,3,GGTCCTAGTAAAATCGGTTA,37,1080200
fldAp,4.25,19,3,GGTCCAGGAATTTACCCTTT,16,1089786
fldAp,6.5,28,3,GGTATTGGGAGTTCATTACT,25,1182860
fldAp,2.25,11,3,GGGTTTCGGAATCGGTCGTA,8,1117033
fldAp,0.5,4,3,GGGTGCTCGCTGCGTGAGCT,1,1075173
fldAp,3.75,17,3,GGGGAGGTAAGCGCACCACC,14,1156462
fldAp,19.0,78,3,GGGGAGATGTTATACCGTTT,75,1114248
fldAp,6.25,27,3,GGGCGTATTATTCCGCGGTA,24,1070865
fldAp,53.75,217,3,GGGCGATTCTCAAATGGCAT,214,1140895
fldAp,12.5,52,3,GGGCACAGGTAATCGATTCA,49,1104984
fldAp,9.75,41,3,GGGATACTCATCGTAGCAAG,38,1159424
fldAp,0.5,4,3,GGGACGAGAACTAACGCGGA,1,1182940
fldAp,4.75,21,3,GGGAATCGGGGAACCTACGA,18,1066383
fldAp,12.5,52,3,GGCTCTAGTCGATCTGAGAT,49,1109418
fldAp,5.0,22,3,GGCTCAAGGGTGCACGGACC,19,1139365
fldAp,0.5,4,3,GGCGCGCGTCACTGTATCCG,1,1169803
fldAp,0.75,5,3,GGCGAGTTAATGGCCAATCT,2,1139155
fldAp,2.25,11,3,GGCGAGCACGCGACCGAAAT,8,1076459
fldAp,5.75,25,3,GGCCTGTGGCTCTGTTGAAC,22,1090342
fldAp,8.75,37,3,GGCCGTGACTCAGGCTCAAT,34,1094314
fldAp,9.75,41,3,GGCCGAGTGGCAGGATACCA,38,1078598
fldAp,7.75,33,3,GGCCGAAACTACCGTCATAT,30,1143687
fldAp,4.5,20,3,GGCAGGATTATGTGGAAAAA,17,1143063
fldAp,10.0,42,3,GGCAGCCCCGACCCGGACTT,39,1142267
fldAp,2.5,12,3,GGATTGCTAGTCCAAAGTTC,9,1156030
fldAp,7.25,31,3,GGATTAAGCAGTACTCCATC,28,1095905
fldAp,0.5,4,3,GGAGCATGCCCAAAGCTGCG,1,1088661
fldAp,43.0,174,3,GGAGACGTTCCACGCGTAGG,171,1078616
fldAp,15.0,62,3,GGAAGAACTCTGATAGGCTG,59,1165572
fldAp,8.75,37,3,GGAACAGAGATCTTTTTAGC,34,1126048
fldAp,4.0,18,3,GCTTGACAGAGCCATTGGGA,15,1119976
fldAp,0.5,4,3,GCTTCTTCCGCTGACAGCGC,1,1083101
fldAp,7.0,30,3,GCTTCCTTTTTCCAGTATTA,27,1119861
fldAp,0.5,4,3,GCTGTAGCGGGGCTCAACCA,1,1114873
fldAp,5.75,25,3,GCTGTAATCGCTGCGTTACA,22,1120334
fldAp,0.5,4,3,GCTGGAGGAAGCTGCCAAGG,1,1103492
fldAp,10.5,44,3,GCTGCGGGCAAGTAACTAGG,41,1158405
fldAp,16.25,67,3,GCTCATCACCTCGTTATGCG,64,1149173
fldAp,0.5,4,3,GCTACGCGACCCCTAAGGGA,1,1185044
fldAp,6.0,26,3,GCGTTTAGTTGCCTCCACAA,23,1073432
fldAp,0.5,4,3,GCGTGCTCTCGGCTGGAGAT,1,1137033
fldAp,0.5,4,3,GCGTATACGATGTAGGTAGC,1,1106990
fldAp,15.5,64,3,GCGGTACCTCCATATATCTC,61,1158786
fldAp,5.5,24,3,GCGGGGGGTAGTAAGAGGAT,21,1072952
fldAp,6.5,28,3,GCGGGGCGCCTCACGCTGTT,25,1153094
fldAp,7.25,31,3,GCGGGCGCAATCGCCGCCTG,28,1139201
fldAp,6.5,28,3,GCGGCGAGTGGGGGTGCGTG,25,1133064
fldAp,7.75,33,3,GCGCGTGACGAGCAAACACC,30,1181959
fldAp,7.75,33,3,GCGAGGCCGCCAATCCGGTG,30,1163202
fldAp,4.25,19,3,GCGAGACGATGGACTGTCGA,16,1103113
fldAp,8.5,36,3,GCGACCTCCGTTGGTTAGAA,33,1141795
fldAp,17.5,72,3,GCCTTTTGAGTATACGACGC,69,1112711
fldAp,0.75,5,3,GCCTGTGAAGGGCCGCGCTA,2,1088167
fldAp,2.5,12,3,GCCTGCGGCAAAGTTCCCCT,9,1074585
fldAp,3.25,15,3,GCCTCGGAAACCCTAATTGC,12,1164090
fldAp,8.25,35,3,GCCTCAACCTATCGGGCCTG,32,1133918
fldAp,11.0,46,3,GCCCGCGGAAAGATTTGCGG,43,1147556
fldAp,10.5,44,3,GCCCCAAATTGAAAGGCTAC,41,1162491
fldAp,8.5,36,3,GCCAATGGTTTTTGAGGCTT,33,1094057
fldAp,10.5,44,3,GCATCTCGGACCGCTCACGC,41,1109631
fldAp,4.0,18,3,GCATAGGGGTGGTTGAGGGA,15,1137818
fldAp,0.5,4,3,GCATAAAAGGGCTTGCACGG,1,1138126
fldAp,1.25,7,3,GCAGGAATCCTCCGGAGGCC,4,1148564
fldAp,9.75,41,3,GCAGCTAAATTTTTACGCCC,38,1155213
fldAp,2.0,10,3,GCAGAAAGTACTGCCACGGG,7,1167706
fldAp,4.5,20,3,GCACTCTGCGCTATAATGTC,17,1066076
fldAp,4.5,20,3,GCACTCGAACGAGGGGAACC,17,1146817
fldAp,14.0,58,3,GCACGTCTACGCGAGGCTAA,55,1067380
fldAp,0.75,5,3,GCACCTAAGACACAAACATA,2,1141837
fldAp,4.0,18,3,GCACCACGCGCGTCGTTTAA,15,1113152
fldAp,6.5,28,3,GCAAGGCGCTCGCGCCGTGA,25,1133525
fldAp,8.0,34,3,GCAAACGGAGGGATGGCCTG,31,1076068
fldAp,35.75,145,3,GATTGTGATATACTTTGAAG,142,1127326
fldAp,8.0,34,3,GATGGAATAGTACCCACAAG,31,1184737
fldAp,0.5,4,3,GATGCTTGGTAATCGTTGCT,1,1163862
fldAp,3.25,15,3,GATGCAACTGATAGATTAGT,12,1085290
fldAp,9.25,39,3,GATGATTTTACGCGTAGCTG,36,1069487
fldAp,9.75,41,3,GATGAAAAATCGCTACTAGG,38,1139140
fldAp,7.0,30,3,GATCGAATAATTCAGATAAC,27,1169912
fldAp,15.75,65,3,GATCAAGGAAGACTAGATGG,62,1096715
fldAp,4.25,19,3,GATACGTCAACGTTCGGACT,16,1063013
fldAp,8.25,35,3,GAGTCCTTACCGGTAGCGAG,32,1151997
fldAp,3.75,17,3,GAGTATCCTAATCCGTGTGC,14,1073534
fldAp,2.0,10,3,GAGGTAGGCCACCCCACCCT,7,1124032
fldAp,7.0,30,3,GAGGCCACACGTCGAATCCA,27,1136364
fldAp,15.5,64,3,GAGCCCTTACACTGAGCCGT,61,1063647
fldAp,1.75,9,3,GAGCACCAGCGTATGCTGGA,6,1135964
fldAp,9.0,38,3,GAGATTTTGTTAAAGTCGCC,35,1108327
fldAp,11.25,47,3,GAGAGGGTCTCGTCGTGTAC,44,1070138
fldAp,5.0,22,3,GAGACTTAAATGCTTGCGAC,19,1181820
fldAp,7.75,33,3,GAGAATCGGCAAATGGTCAC,30,1165596
fldAp,3.75,17,3,GAGAACAGTAGGCCCCAACA,14,1144702
fldAp,5.0,22,3,GACTGGTCGCGATCCGCTCT,19,1156448
fldAp,6.0,26,3,GACTGAGCCGCAAGCTAGTT,23,1093951
fldAp,13.5,56,3,GACTCTGGGAATCTTGCACT,53,1159784
fldAp,0.5,4,3,GACTACACCGTGCGGCGTCT,1,1069611
fldAp,0.5,4,3,GACGAGGGGCTACGAGGTCT,1,1069118
fldAp,0.5,4,3,GACCCGGCCGACGTCGGCGA,1,1087808
fldAp,17.75,73,3,GACCCCTCCATCTAAGCCAT,70,1166146
fldAp,13.0,54,3,GACCCCGGAAAGCTAGCGCT,51,1093377
fldAp,2.0,10,3,GACCACAGTAACATTGTCGG,7,1095054
fldAp,13.25,55,3,GACCACAGATTCCGGCAGGG,52,1135484
fldAp,9.25,39,3,GACATATGCCACTCATTATG,36,1103147
fldAp,15.0,62,3,GAAGCGGGGTGCATGAAGCC,59,1113955
fldAp,1.25,7,3,GAAGAGCTTGGAACTAGCTG,4,1150839
fldAp,6.0,26,3,GAAGACGATCTCCAGGAGCT,23,1130590
fldAp,3.75,17,3,GAACTTTACCAGGGATCGCC,14,1157023
fldAp,22.5,92,3,GAACGCCAAGATTCAGATGT,89,1110322
fldAp,5.0,22,3,GAACGACGACGCTCATTGAA,19,1119156
fldAp,4.5,20,3,GAACCAGCAACACCTATGGG,17,1138430
fldAp,2.75,13,3,GAAATCGTAGGAGATTAATT,10,1161185
fldAp,8.75,37,3,GAAATCGAAGTCTATTGTTC,34,1064924
fldAp,10.75,45,3,CTTTGCACGAGCTACCTAGG,42,1080947
fldAp,6.5,28,3,CTTTCGACAATAGGTATAGT,25,1067625
fldAp,3.5,16,3,CTTGTCTTATTTAGCCTTAA,13,1138330
fldAp,6.0,26,3,CTTGCCGGTCCCTTAAAAGC,23,1149105
fldAp,0.5,4,3,CTTCATGGATAGGTCTAGCA,1,1176749
fldAp,11.0,46,3,CTTCAGGGCTAGAGCGGAGA,43,1087152
fldAp,7.25,31,3,CTTATGTTATTCGGGCGGTT,28,1097424
fldAp,10.75,45,3,CTTATGGAGCCGAGTGAATC,42,1168605
fldAp,27.25,111,3,CTTATAAGAGCGTACCTCTA,108,1176951
fldAp,0.5,4,3,CTTAGTAGCGTCTGCCTCAA,1,1124742
fldAp,4.25,19,3,CTTACGCAGCTCATCAAAAC,16,1132318
fldAp,0.5,4,3,CTGTCCCCTCGTCGCGTGCA,1,1131999
fldAp,0.5,4,3,CTGTCCACATCCTGACGACC,1,1131465
fldAp,4.0,18,3,CTGTAAGCCCTTTCAATGCA,15,1178174
fldAp,6.5,28,3,CTGGTCGTTGACATCTTGCG,25,1178035
fldAp,6.5,28,3,CTGGCGACTGGAGACTTTCT,25,1066655
fldAp,9.75,41,3,CTGCTGCTGCATAAGAACTT,38,1063239
fldAp,17.0,70,3,CTGCCTGATGGTTTTTAGGA,67,1109060
fldAp,7.5,32,3,CTGCACCACTTCCTGCCACC,29,1097726
fldAp,6.25,27,3,CTGACGATCCGTTAGATTTA,24,1139794
fldAp,3.25,15,3,CTCTTCTTCATTGGGCAGGA,12,1078965
fldAp,9.0,38,3,CTCTTAACACCATGTGTGAT,35,1133009
fldAp,9.5,40,3,CTCTCTGGAGTTTCTACAGA,37,1121386
fldAp,5.0,22,3,CTCGGCCCTGGGCTCGTGGG,19,1122449
fldAp,5.5,24,3,CTCGGACGCCACGCGCCAAA,21,1090369
fldAp,10.25,43,3,CTCCTAAGTTAAATCCCAGA,40,1148733
fldAp,9.75,41,3,CTCCACAGTTAAGAGCTCCG,38,1113540
fldAp,4.75,21,3,CTCAGCGCAGAATTTGCACA,18,1070315
fldAp,0.5,4,3,CTCAATGAGTGATTCCTGCA,1,1071869
fldAp,8.75,37,3,CTATTGAGCAGAACCATATA,34,1123431
fldAp,13.25,55,3,CTATGTACATCCGTTTTCTG,52,1111335
fldAp,5.25,23,3,CTAGGAGGCGGGTCGTGGGA,20,1074179
fldAp,7.75,33,3,CTAGCCGCAGACACTAGGAT,30,1106941
fldAp,6.25,27,3,CTACGCATGATGGCTAGAGT,24,1103600
fldAp,5.5,24,3,CTACCGGGAGATGCGTTAGG,21,1186533
fldAp,5.0,22,3,CTAATCGGTAATGGGCGGAT,19,1152573
fldAp,8.5,36,3,CTAACGTCATCATCGAGACA,33,1106865
fldAp,8.25,35,3,CGTGAAACACGGCAGATCTA,32,1184471
fldAp,2.5,12,3,CGTCTGCTGGGTTATACTGT,9,1089544
fldAp,8.75,37,3,CGTCCCGTGCATGGTCAAAA,34,1178580
fldAp,0.5,4,3,CGTATTGCAACAAAGGTACT,1,1180460
fldAp,4.5,20,3,CGTAACTCAGCCACCTTGAC,17,1152948
fldAp,16.75,69,3,CGTAACGCTTCTCGTTTATT,66,1141585
fldAp,15.5,64,3,CGTAACACCGCTCAGCATTG,61,1073332
fldAp,5.75,25,3,CGGTAACTACTGCTAGTTAA,22,1104423
fldAp,4.5,20,3,CGGGCAATCCGTCTGTAAAC,17,1152755
fldAp,9.25,39,3,CGGCTCCGCTGGCACGTCTT,36,1169549
fldAp,12.5,52,3,CGGCGAGGGTGGCTTCCGAC,49,1157928
fldAp,5.25,23,3,CGGCCAGGCGACCCCCATGG,20,1157369
fldAp,5.5,24,3,CGGCACTCAATGGAGATGAG,21,1113022
fldAp,5.25,23,3,CGGATGCTACCTGAACCCTG,20,1144035
fldAp,9.75,41,3,CGGATACGGATGACTTAAGG,38,1085307
fldAp,7.25,31,3,CGGAGATGATAGCTTGGGCA,28,1179058
fldAp,7.0,30,3,CGCTTGTATTGGACGCACGG,27,1157387
fldAp,6.5,28,3,CGCTTATATAGTAGTCGTCT,25,1097477
fldAp,7.25,31,3,CGCTGGCTCCTTCTTCGCGG,28,1156605
fldAp,2.0,10,3,CGCTGCTGCTGCGTCTCTCT,7,1154283
fldAp,4.25,19,3,CGCTCGGTAGAGTAACTTAC,16,1184073
fldAp,8.75,37,3,CGCTATTGGGTTCAATAGAA,34,1135537
fldAp,9.25,39,3,CGCGGCTATCGGCAAACAGC,36,1109536
fldAp,8.5,36,3,CGCGATAAGCCTGGAAAGTT,33,1136041
fldAp,4.25,19,3,CGCGAGTGTCGTTAGGCCCC,16,1101733
fldAp,8.75,37,3,CGCCGTCGAGCGCTGGTTAA,34,1140372
fldAp,0.5,4,3,CGCCGCGTGATCACACCAAT,1,1162151
fldAp,10.25,43,3,CGCCAGCAAGGAGCGGTAAG,40,1136680
fldAp,0.75,5,3,CGCATTTAGCAGCACCTAAA,2,1083844
fldAp,0.75,5,3,CGCATTGTGTATAGCGGCCA,2,1149898
fldAp,13.5,56,3,CGCAAAGCCGTACTCTCCGC,53,1167343
fldAp,0.75,5,3,CGATTGTTGTTATCCGACTA,2,1090767
fldAp,9.5,40,3,CGATGACAAGTCGAACTCCC,37,1181828
fldAp,57.75,233,3,CGAGCGTATGAAATATTCCT,230,1146165
fldAp,5.25,23,3,CGAGACCACGGGACAGCAAC,20,1107453
fldAp,11.0,46,3,CGACTACTCGAACCATAAGC,43,1116572
fldAp,4.0,18,3,CGACTAAGTATCTCAGTTTC,15,1070343
fldAp,13.75,57,3,CGACAAGCTAGCGAATTGGT,54,1072052
fldAp,8.25,35,3,CGAATCCAGATCCGTTCAGA,32,1093232
fldAp,2.75,13,3,CGAACTGGCGAAGGTTATGG,10,1150665
fldAp,9.25,39,3,CGAAAAGCGTCCACGATCTA,36,1182200
fldAp,3.75,17,3,CGAAAACGCGAATTCCTGGC,14,1072249
fldAp,30.0,122,3,CCTTTTGCCCTTTCAGTAAT,119,1104034
fldAp,11.0,46,3,CCTTCTACTTGGGTTGGTTT,43,1084445
fldAp,16.75,69,3,CCTTCTACCCGAAGAGCGCA,66,1082634
fldAp,4.0,18,3,CCTTCGTTAGTGAGACCTCA,15,1068439
fldAp,0.5,4,3,CCTTAGTTCCGCGCAATCCA,1,1150185
fldAp,6.25,27,3,CCTGTTTTCGGAATTAATTA,24,1120331
fldAp,8.75,37,3,CCTGGACGGCGCTCTGAACT,34,1076609
fldAp,0.5,4,3,CCTGCGAGCACTACACTTCG,1,1066625
fldAp,3.0,14,3,CCTCGTACTATACACCTCTT,11,1166084
fldAp,5.0,22,3,CCTCGGTACATCATGTCAAA,19,1084545
fldAp,3.25,15,3,CCTAGCGATACCGTCATATC,12,1176240
fldAp,2.75,13,3,CCTACCCACGAACGCACAGG,10,1128467
fldAp,7.25,31,3,CCGTTAGCTGATCCAGCAGT,28,1182821
fldAp,0.5,4,3,CCGTGCTGAGCACACTACAG,1,1126720
fldAp,6.5,28,3,CCGTGCAATTGTGACCTCAA,25,1067668
fldAp,7.25,31,3,CCGTACGCGCATCAACGTAA,28,1175749
fldAp,5.75,25,3,CCGTAAAAACAAATGGCGGG,22,1083075
fldAp,15.75,65,3,CCGGCTGCATATTGGATTAC,62,1173085
fldAp,11.25,47,3,CCGGCGTGCTAGCATTGGCA,44,1146169
fldAp,0.5,4,3,CCGGCCGTCCAAAGAACACG,1,1151280
fldAp,9.5,40,3,CCGGCAGATGATACAGGAAA,37,1068851
fldAp,10.75,45,3,CCGGAATGACGATGGCTTAG,42,1170948
fldAp,6.5,28,3,CCGCTATCACGTCTATTCGA,25,1078779
fldAp,4.75,21,3,CCGCGGCAGTATGGTATTAC,18,1172721
fldAp,2.75,13,3,CCGCCATGATGATGTACGTG,10,1068337
fldAp,7.5,32,3,CCGAGTGTCAAACCTGTATG,29,1070136
fldAp,0.75,5,3,CCGACTTGGCAATTATCAAG,2,1075919
fldAp,6.5,28,3,CCCGGGTAGGTAGAGATTTA,25,1067621
fldAp,8.25,35,3,CCCGCTGCGGTCTATTGAGA,32,1141626
fldAp,4.5,20,3,CCCGCGACGCCCCTCAACGA,17,1148732
fldAp,0.5,4,3,CCCGCCTCATTTGGAGCCTC,1,1082197
fldAp,0.5,4,3,CCCGATGGACCACTATTTAC,1,1098218
fldAp,21.0,86,3,CCCCTTTGCAATTACGTGTC,83,1063501
fldAp,5.75,25,3,CCCCGGGTTACCCATAGCAG,22,1172477
fldAp,2.25,11,3,CCCCGAAAGCTTAAAGGTTC,8,1139004
fldAp,16.25,67,3,CCCCCAGGGACAATGGTACT,64,1107714
fldAp,6.75,29,3,CCCATTCAAAGGGGAGCACT,26,1130406
fldAp,4.0,18,3,CCCATCACAATACAAAAATG,15,1113948
fldAp,7.5,32,3,CCCAGCTCGCAGTCCTAAAA,29,1166630
fldAp,3.25,15,3,CCCAAGGCATTAAGTACGTA,12,1131127
fldAp,8.0,34,3,CCATTACTAGAGCTGATAGA,31,1120771
fldAp,10.25,43,3,CCATCAGTTTCCCGGAACCC,40,1125289
fldAp,0.5,4,3,CCAGTATTATCGTGATGTCC,1,1145076
fldAp,0.5,4,3,CCAGAGTCGGTACCAACACC,1,1085791
fldAp,26.75,109,3,CCAGAGCTGAGCAACCAGAT,106,1118363
fldAp,5.75,25,3,CCACAGCTCCGTCCCACTAC,22,1129981
fldAp,21.25,87,3,CCAATGGTATAACTAGATCA,84,1111359
fldAp,0.75,5,3,CCAACGGTCGAGATTCCATC,2,1133516
fldAp,0.75,5,3,CCAAAATGCAGCCCTTGTGG,2,1133634
fldAp,5.75,25,3,CATTTTACCAGTTACGCGCA,22,1132408
fldAp,1.75,9,3,CATTTCGGGCCAAGTTTGGT,6,1178613
fldAp,9.0,38,3,CATTGCGGACGCTGTCCGAC,35,1084740
fldAp,8.5,36,3,CATTGAAGTTCGGCTTTGAG,33,1110352
fldAp,10.5,44,3,CATTATGTAAACGATCCTAG,41,1155472
fldAp,16.0,66,3,CATGTCGGACCATGTTCGAG,63,1171137
fldAp,32.5,132,3,CATGCTTTTTCCCAGCAAAA,129,1117310
fldAp,5.0,22,3,CATCTCTGGCGAGCTGGTGA,19,1144505
fldAp,17.0,70,3,CATCGCCGCTGTATGAATCA,67,1095711
fldAp,8.25,35,3,CATAACTCGCGCATATAAAT,32,1159504
fldAp,7.5,32,3,CAGTTCTTGCCAAGTATTAG,29,1172092
fldAp,7.75,33,3,CAGTCCCATGTGGGTGAGAT,30,1102172
fldAp,5.5,24,3,CAGGTCTTGGTACCTTCTAT,21,1098505
fldAp,8.75,37,3,CAGGTAAAGATATTATCCAT,34,1165474
fldAp,8.25,35,3,CAGGGCATGCCGGGCGTTTC,32,1121057
fldAp,13.5,56,3,CAGCTCTGTACAGGGCTAAA,53,1080271
fldAp,8.0,34,3,CAGCGTGATGACCGTAGGCT,31,1182620
fldAp,5.75,25,3,CAGCGCCTACAGGCGTCTGA,22,1065460
fldAp,6.5,28,3,CACTATAACGCGCAGGGGCA,25,1139161
fldAp,10.0,42,3,CACGTCAGTGTCCTTTTGAA,39,1084766
fldAp,6.5,28,3,CACGGTTTCCTGCACGTGAT,25,1066647
fldAp,11.0,46,3,CACCAAGTCATATAACAGGA,43,1154187
fldAp,0.5,4,3,CACAGGCCTGGCATATCTCT,1,1144808
fldAp,12.5,52,3,CACACGTTCCGAGTTTATCC,49,1137488
fldAp,12.25,51,3,CAAGCATAGGGATTTGAAAC,48,1125299
fldAp,5.5,24,3,CAACGTATTAATCTGGCTTA,21,1126220
fldAp,13.0,54,3,CAACGGTGTTCGCGGAGTAT,51,1143952
fldAp,6.5,28,3,CAACAGAGCAGAAATAATGA,25,1178119
fldAp,8.25,35,3,CAACAATCCAGACGACCCTT,32,1121704
fldAp,0.75,5,3,CAAATTGCCTCTCACTGGTT,2,1126257
fldAp,6.5,28,3,CAAATGGTGTTGTTGTGGTA,25,1121314
fldAp,4.0,18,3,CAAACGTTTGACTAGCAAGA,15,1116627
fldAp,9.75,41,3,CAAACCCAGAGTACAGCGAT,38,1111490
fldAp,2.0,10,3,CAAAAGTTATGCCTAGAGTG,7,1148459
fldAp,6.5,28,3,CAAAACCCAGGCCGGTTGAC,25,1105991
fldAp,3.25,15,3,ATTTGTGTGGTGCCCATAGC,12,1098208
fldAp,3.75,17,3,ATTTCTCACTAACTTGAAAG,14,1080959
fldAp,5.25,23,3,ATTTCACTATAAGTCTGAAT,20,1146646
fldAp,19.25,79,3,ATTGTCCATGGACTGTTGAG,76,1085997
fldAp,13.5,56,3,ATTGCCTATAGAAGTTTTAA,53,1167049
fldAp,0.5,4,3,ATTCATGCCACACTATTTGG,1,1178250
fldAp,4.75,21,3,ATTCAATGATTGTCACGAAA,18,1153833
fldAp,16.25,67,3,ATTATACTCACCCTTGGACT,64,1069376
fldAp,4.0,18,3,ATGTCCCTATCGGGGTCCAC,15,1157623
fldAp,4.75,21,3,ATGTAGTGACATATCCCCGC,18,1109806
fldAp,6.75,29,3,ATGGCGCCAGCTCTTACGCG,26,1077272
fldAp,2.5,12,3,ATGGCCACCAATCCTCGAAA,9,1085996
fldAp,0.5,4,3,ATGCTTTCTCCAAATGGTCC,1,1082116
fldAp,1.75,9,3,ATGCGAGCGAGTCATAACAG,6,1126127
fldAp,5.0,22,3,ATGATCGGTTTAGACAGGGT,19,1164496
fldAp,15.5,64,3,ATGATAGGCTCAGAAACTGT,61,1080096
fldAp,19.5,80,3,ATGACAACTCGAAGTCTATT,77,1083906
fldAp,8.75,37,3,ATGAATTCTTCCCGCCCGGA,34,1155535
fldAp,5.75,25,3,ATGAACTGAATTCTATACTC,22,1131611
fldAp,7.0,30,3,ATCTCAATACTCCTAGAGTT,27,1078157
fldAp,0.75,5,3,ATCGTGATGGTCTAGTGTAC,2,1125409
fldAp,8.75,37,3,ATCGGCTTGGACTCAAAAAT,34,1085824
fldAp,7.25,31,3,ATCGGCGAAGGGCACGGGAG,28,1147999
fldAp,8.25,35,3,ATCGGCAACGGAACAGGATA,32,1076598
fldAp,0.75,5,3,ATCGCGCGGCTTTGTGCATC,2,1105063
fldAp,11.75,49,3,ATCCTCACATTAGCATTTGC,46,1137639
fldAp,0.5,4,3,ATCACTCGGATACCGGCAGG,1,1098241
fldAp,5.5,24,3,ATCAAAGTGTGGCTGTGTGA,21,1157960
fldAp,6.25,27,3,ATATTGGAAAGTGCTAACAA,24,1109062
fldAp,12.25,51,3,ATATGTCTGCGGAACATTGA,48,1121194
fldAp,14.25,59,3,ATATGTCCATTTAAGGCAGC,56,1066077
fldAp,0.5,4,3,ATATGGTGTGAGCCTAAGTG,1,1096435
fldAp,0.75,5,3,ATATGAGTTGGGACTGTGTG,2,1153369
fldAp,6.0,26,3,ATAGTATCTATCACAGCAGT,23,1146376
fldAp,3.5,16,3,ATAGGACGTCTTCGGGTGGG,13,1127800
fldAp,15.75,65,3,ATAATGGTGTGGTATTGCCT,62,1097059
fldAp,6.75,29,3,ATAATAAAAGCGAGAGGGAT,26,1100227
fldAp,10.25,43,3,ATAAGTTTCCCCGCAGTGCA,40,1144488
fldAp,20.0,82,3,ATAAGAACAGGTATGTCAGA,79,1126539
fldAp,8.75,37,3,ATAACTTAAAAGAGTTGTTA,34,1184859
fldAp,0.5,4,3,ATAAATCCTGGTGTCTTTAA,1,1142218
fldAp,3.25,15,3,ATAAAAGCACGAGAGAAGCC,12,1147698
fldAp,2.25,11,3,AGTTCCGTGCTCCGAACAGA,8,1106381
fldAp,0.5,4,3,AGTTCACCTATAAGCGTGCT,1,1118823
fldAp,0.5,4,3,AGTTATAAAGTGCAAGTAGT,1,1109318
fldAp,5.5,24,3,AGTGGAGTTAAAGTGTAAGG,21,1081036
fldAp,2.75,13,3,AGTGGAGGACAGTACGGATT,10,1162221
fldAp,5.5,24,3,AGTCCTACGGAGGACCGGGC,21,1102220
fldAp,3.25,15,3,AGTATGCTTTAAATAAAGGT,12,1163291
fldAp,0.5,4,3,AGGTTGCCCAAGGCGTTAAC,1,1100660
fldAp,9.0,38,3,AGGTGGACGTCTGTGCGGGG,35,1157813
fldAp,15.75,65,3,AGGTCTCGGAACCGAAGAAG,62,1075869
fldAp,6.5,28,3,AGGTCCCAGGTGACACACTA,25,1125428
fldAp,4.75,21,3,AGGTCCAGCCTTCGCTCAGA,18,1109378
fldAp,7.25,31,3,AGGTAGAGTTAATGTATAAG,28,1132517
fldAp,5.0,22,3,AGGGGGCCGCGCCGATCGAA,19,1110967
fldAp,14.75,61,3,AGGGCCGAGTTGTAACAGCT,58,1112504
fldAp,0.5,4,3,AGGGCACATCAGTAGCGCGT,1,1098216
fldAp,8.0,34,3,AGGGACTTGATGACAAAGGT,31,1168599
fldAp,5.5,24,3,AGGCCTAATCGCGGCGTGTC,21,1071225
fldAp,0.5,4,3,AGGATTCGCAGAACCGTAGT,1,1136848
fldAp,3.75,17,3,AGGATGGCATATAAACGAGA,14,1102019
fldAp,7.75,33,3,AGGATCGTCGCAGCGATTAA,30,1156051
fldAp,4.75,21,3,AGGAATAGTATAAAAGGTGA,18,1138990
fldAp,8.0,34,3,AGCTTCAAGACCTCGTTACA,31,1074497
fldAp,6.5,28,3,AGCTGCTCCATCTACCGCCG,25,1143742
fldAp,8.0,34,3,AGCTGCTAATAATTTTGTAG,31,1153821
fldAp,4.0,18,3,AGCGTCGCCTGAGGGATTAA,15,1088311
fldAp,5.5,24,3,AGCGCCCCCGTACAGTCCGC,21,1169698
fldAp,14.75,61,3,AGCATGCTATCACCCTTCGC,58,1097704
fldAp,11.75,49,3,AGCAACGGAATTAGCGGCCT,46,1105505
fldAp,6.25,27,3,AGATTAGTTCCGCGCGGAGA,24,1135513
fldAp,9.75,41,3,AGATACCCCTTATCGCTCTC,38,1182114
fldAp,0.5,4,3,AGAGGCGAAGTTCGTATATG,1,1089810
fldAp,14.5,60,3,AGAGCAGCTCTACAGGTGCA,57,1157025
fldAp,2.25,11,3,AGACCAGGAGCTCGAGGGAC,8,1169942
fldAp,16.25,67,3,AGAATGATATCCCCCTTCTT,64,1146637
fldAp,3.25,15,3,AGAAATAACAGCGTTATTTG,12,1112359
fldAp,3.5,16,3,AGAAACTGTATCCATGGTTG,13,1173404
fldAp,0.5,4,3,AGAAAAACACGGGGCCAAGA,1,1176223
fldAp,3.25,15,3,ACTTGTTACCCATTGCTTTT,12,1069318
fldAp,1.0,6,3,ACTTGGGGGTCTACACGTTC,3,1135607
fldAp,9.0,38,3,ACTTACTGCACCTCGTTAGT,35,1122148
fldAp,7.25,31,3,ACTGTGTAGAGAGTCCAGAC,28,1115780
fldAp,9.5,40,3,ACTGGGGAACTAGGGATCTT,37,1102642
fldAp,13.0,54,3,ACTGGGCGAGTTCAGCGGAT,51,1105475
fldAp,8.0,34,3,ACTGGCAGCACCCGGGAGAG,31,1093510
fldAp,13.75,57,3,ACTGAGGTATGGCAAGTGCT,54,1151200
fldAp,7.75,33,3,ACTCGTTGGAGCCGGCTGGG,30,1138958
fldAp,6.25,27,3,ACTCCTAAACGGGAATTACA,24,1132889
fldAp,3.5,16,3,ACTCACTTAGGTCATGGAAG,13,1172480
fldAp,22.5,92,3,ACTCACACCATCAGCCTGAA,89,1147695
fldAp,27.25,111,3,ACTATGGGACACTCGCCAAC,108,1127713
fldAp,7.5,32,3,ACGTTGCTATCACAAACTGT,29,1070986
fldAp,6.75,29,3,ACGTAATGGCATCGGGGCTT,26,1078623
fldAp,8.5,36,3,ACGGAATCACTTAGCTCGTG,33,1111826
fldAp,6.25,27,3,ACGGAACGGCGACACTATGT,24,1073506
fldAp,10.25,43,3,ACGATCCCCTTCATCTAAGT,40,1070131
fldAp,16.75,69,3,ACGAGAATGCCCATCTAACG,66,1114572
fldAp,0.5,4,3,ACGACTGTAACATATCTATA,1,1078182
fldAp,4.5,20,3,ACGAACACTTGTCCGTGCGA,17,1101836
fldAp,0.5,4,3,ACCTTGGTTCTGGCCGTTCC,1,1176373
fldAp,3.25,15,3,ACCTGTTTGACCTGAGTCAC,12,1128180
fldAp,5.75,25,3,ACCGGTCAGTGAACTACTTG,22,1067378
fldAp,3.75,17,3,ACCGGGATGCTCCAGACTTT,14,1133337
fldAp,0.5,4,3,ACCGCTCGTAACCGTGCTAG,1,1168602
fldAp,6.5,28,3,ACCGATGGCTAACCCACGAT,25,1139678
fldAp,2.25,11,3,ACCATCTGAGGTTCGGAAAC,8,1179569
fldAp,5.25,23,3,ACATCGAGCATGTCGGTTCC,20,1151384
fldAp,0.5,4,3,ACATCAAGACGGTTGATGAT,1,1154622
fldAp,7.0,30,3,ACAGTCCATTGGGTAGTATA,27,1112562
fldAp,0.5,4,3,ACAGGAAGCGATAGGCGACG,1,1161889
fldAp,7.0,30,3,ACAGAACCTCATTACTGGGT,27,1102026
fldAp,0.5,4,3,ACACGATGTGGGTGATGTTT,1,1097789
fldAp,7.5,32,3,ACACAACGTTTCTATCATTG,29,1127953
fldAp,22.25,91,3,ACAATCCGACGGGAGGCGAG,88,1092365
fldAp,61.5,248,3,ACAAGGTGGTATGATCGAAT,245,1114264
fldAp,1.0,6,3,ACAAGATCGGCCAGTGCTCA,3,1111952
fldAp,8.75,37,3,AATTCTGTTGTTAGGGCTAT,34,1077447
fldAp,0.5,4,3,AATTCCGACATTTAATGGGG,1,1159636
fldAp,7.75,33,3,AATGGTGCGAAGATCTATGA,30,1104031
fldAp,7.75,33,3,AATGGTCGTACTAAAGGGAA,30,1114263
fldAp,0.5,4,3,AATGCAAAATCTCCCAACCA,1,1136007
fldAp,4.75,21,3,AATCCAGCGGCTGATTTGTT,18,1162495
fldAp,2.5,12,3,AAGTTACCGCTATACGGTCT,9,1131247
fldAp,4.25,19,3,AAGTCGGCGAATGGCAGCAT,16,1151583
fldAp,3.75,17,3,AAGTCGAGCAGTGGGGCAAA,14,1094317
fldAp,7.5,32,3,AAGGTTCGCCTACAGTGTTA,29,1163444
fldAp,4.25,19,3,AAGGGGTAAGGCCGGAGTTC,16,1113225
fldAp,3.0,14,3,AAGCGAGGGACTTCCTACCG,11,1080117
fldAp,9.75,41,3,AAGCCTATTTTAAAAAAACA,38,1179972
fldAp,2.0,10,3,AAGACTGCGGGGTGTGCATG,7,1092721
fldAp,11.5,48,3,AACTTATCTTCGCCAGAATT,45,1146157
fldAp,5.75,25,3,AACTATGTCGTTTTATCAGA,22,1095425
fldAp,9.25,39,3,AACGTTACGAAGCGCTCTAT,36,1091836
fldAp,11.0,46,3,AACGTGTTCGGTACAGAGGC,43,1132152
fldAp,0.5,4,3,AACGAAGTTAGCCGGGATTT,1,1127119
fldAp,61.0,246,3,AACCGCGAAATTTCGAGGCA,243,1174579
fldAp,7.0,30,3,AACCGCAGCGCAGGAACGCT,27,1100319
fldAp,7.25,31,3,AACCGATGTCATCTATCGAA,28,1076417
fldAp,0.5,4,3,AACCCAAGGATCGTGCGCGG,1,1120849
fldAp,5.25,23,3,AACCATTAAGGATCACCTTG,20,1176967
fldAp,15.75,65,3,AACCAGGCTACGCCGCGTGA,62,1124123
fldAp,30.0,122,3,AACATCTTTTTCTTTCAGTA,119,1159194
fldAp,7.0,30,3,AACAGGTCAGTGGCTACCAT,27,1118510
fldAp,8.25,35,3,AAAGTCTAGTGGGCCGCTGT,32,1090367
fldAp,0.5,4,3,AAAGGTTCTAGAAATGCGAG,1,1147320
fldAp,11.5,48,3,AAACGTGGTGCCCCAGCCGA,45,1105894
fldAp,8.0,34,3,AAACCTCAGCTCTCTTTGAG,31,1105652
fldAp,0.5,4,3,AAAAGCTAGCTAACGCGTGT,1,1081329
fldAp,2.0,10,3,AAAAAGAGAAAAGTTTGCGT,7,1134462
fldAp,21.75,89,3,AAAAAATCAGGTGAACATTG,86,1143112
fldAp,8.333333333333334,26,2,TTTTGGGGGACGCCACCACA,24,1130251
fldAp,13.0,40,2,TTTTGACAGTGCAAAGTGCG,38,1166340
fldAp,8.0,25,2,TTTGGTTACGAATGGATAGT,23,1169542
fldAp,11.0,34,2,TTTGGGACCTTGCCCGAAGC,32,1077996
fldAp,7.0,22,2,TTTCTCAAGTGAACACTTAT,20,1115024
fldAp,0.6666666666666666,3,2,TTTAAAGTACCGGAATCACC,1,1094078
fldAp,6.0,19,2,TTGTGGACGCCGGGCGCTTT,17,1146020
fldAp,0.6666666666666666,3,2,TTGTGCGCAGTCACTCGGTG,1,1156117
fldAp,11.0,34,2,TTGGTGCATATTTATTCTAA,32,1184871
fldAp,3.6666666666666665,12,2,TTGGTCCCCGGACAGTGAAA,10,1171532
fldAp,2.3333333333333335,8,2,TTGGGTGGCGCCCTCGTACT,6,1158461
fldAp,5.333333333333333,17,2,TTGCACTACAGTATTCTGGT,15,1117973
fldAp,2.6666666666666665,9,2,TTGATAGAAAAGCTTTATTC,7,1125693
fldAp,0.6666666666666666,3,2,TTCTTATCGTTATCTGAATA,1,1125390
fldAp,9.666666666666666,30,2,TTCTGTCTAACTTTGTACGG,28,1117022
fldAp,11.666666666666666,36,2,TTCTCCGGCCCTTAACTGCT,34,1186094
fldAp,12.333333333333334,38,2,TTCTAGAACCAGATGCGTCT,36,1130409
fldAp,13.333333333333334,41,2,TTCGTTTCCGATGACTTCCT,39,1177700
fldAp,6.333333333333333,20,2,TTCCGAATTCCCTGAGCCTT,18,1066279
fldAp,1.6666666666666667,6,2,TTCCCGGCGCCTTGCAGCCT,4,1077844
fldAp,11.333333333333334,35,2,TTCCACCTGAGACCCAACAA,33,1071811
fldAp,10.666666666666666,33,2,TTCATAAGGTTGTCAGGGAT,31,1177358
fldAp,0.6666666666666666,3,2,TTATGGGTCTATTTATGCTA,1,1181318
fldAp,31.333333333333332,95,2,TTATGCCTCCCCAATAGATC,93,1156663
fldAp,13.333333333333334,41,2,TTATCGTTAACATACAAAGG,39,1166019
fldAp,1.0,4,2,TTATCAGCTGCCGAGTAAGT,2,1064975
fldAp,5.333333333333333,17,2,TTAGTGTGTTAATGCATGCG,15,1065757
fldAp,7.0,22,2,TTAGCTTCTGCAGCGCACCA,20,1106146
fldAp,9.0,28,2,TTAGAGACGGTGGGAGCGAG,26,1073808
fldAp,10.666666666666666,33,2,TTACGCGGAGTGGGTTCAGG,31,1151313
fldAp,15.333333333333334,47,2,TTACAAGGATAATGATCACG,45,1178653
fldAp,0.6666666666666666,3,2,TTAAAAAGGCTTCTCGATGA,1,1077284
fldAp,10.0,31,2,TGTTTCTTGCCGACGCCGAT,29,1143065
fldAp,10.333333333333334,32,2,TGTTCATGTTAAGTATCTTT,30,1164104
fldAp,5.666666666666667,18,2,TGTTAGGTTCGGTAGTGAAG,16,1111971
fldAp,9.333333333333334,29,2,TGTCTATTTTTTATAGGTTG,27,1092785
fldAp,8.333333333333334,26,2,TGTAGTGGCTAGAACATACG,24,1135761
fldAp,0.6666666666666666,3,2,TGTAGCCGACTGCAACGGCC,1,1123300
fldAp,5.0,16,2,TGTACTTCAAAGTCAAAGCA,14,1103281
fldAp,1.3333333333333333,5,2,TGTACTGCCCCTGGGATCGA,3,1148633
fldAp,13.666666666666666,42,2,TGGTTCAGGTCGTTTCCCAC,40,1064947
fldAp,1.6666666666666667,6,2,TGGGGGATCTCATTCGCTTA,4,1099333
fldAp,11.333333333333334,35,2,TGGGGGACATGGCTAATTTT,33,1086154
fldAp,0.6666666666666666,3,2,TGGGCTTAAGTAATTTGGCA,1,1091755
fldAp,6.333333333333333,20,2,TGGCTCCGATATTGCCCACA,18,1091459
fldAp,20.333333333333332,62,2,TGGACGTTTATATACCCTCG,60,1073356
fldAp,10.0,31,2,TGGACCGGTGTTCCCCACGG,29,1114559
fldAp,0.6666666666666666,3,2,TGCTTGGAGTGTGACGTGTT,1,1148621
fldAp,7.333333333333333,23,2,TGCTACCAAACTTAACTGCT,21,1183602
fldAp,28.666666666666668,87,2,TGCGGGGTGCATAGCCCAAA,85,1094689
fldAp,6.0,19,2,TGCCCAACTGCGGCGCGAGT,17,1076744
fldAp,12.666666666666666,39,2,TGCATGGGTGCTGGAGTATA,37,1082587
fldAp,4.0,13,2,TGCACCTCGCTGGTTAAGAA,11,1115481
fldAp,7.0,22,2,TGCAAATGTACTTTCCCCAG,20,1132529
fldAp,11.666666666666666,36,2,TGATGCAGGATTGCACACAC,34,1091344
fldAp,14.333333333333334,44,2,TGAGTCTAGTCCAGTCCGCA,42,1093291
fldAp,6.0,19,2,TGAGATACCAGGTTTTCATA,17,1148483
fldAp,6.333333333333333,20,2,TGACTCTGATACCTTAGAGG,18,1084196
fldAp,9.666666666666666,30,2,TGACGTGGGAAGAAGCGCCA,28,1089506
fldAp,0.6666666666666666,3,2,TGACAAGCGGTCACATTATG,1,1119069
fldAp,11.0,34,2,TGACAAACAAGGCCCTTGTG,32,1171079
fldAp,10.0,31,2,TGAACAGTTGAGCAGAAGTA,29,1185539
fldAp,6.666666666666667,21,2,TCTTTCACGTACAAGGCACT,19,1115552
fldAp,5.0,16,2,TCTTAAGTAGCCTAAATACT,14,1130165
fldAp,13.0,40,2,TCTGGGCTGGGGTGTCAAGG,38,1127564
fldAp,13.666666666666666,42,2,TCTGCGGGCCTATGCGGGCT,40,1162397
fldAp,18.666666666666668,57,2,TCTGATCGTATTATGCACTT,55,1103011
fldAp,4.0,13,2,TCTCCGAACAAGTCTATGGT,11,1146737
fldAp,36.666666666666664,111,2,TCGTTGAATCCCAGCAAAAT,109,1176942
fldAp,0.6666666666666666,3,2,TCGTCGGACGTCAAGGGACG,1,1067840
fldAp,0.6666666666666666,3,2,TCGGATGAACACAGGTGACC,1,1135848
fldAp,2.0,7,2,TCGGAATATACAATAGGTAG,5,1091576
fldAp,12.666666666666666,39,2,TCGCTCTCTGGCGGGGGAAT,37,1178664
fldAp,9.333333333333334,29,2,TCGCGTTCAACACGTTGATC,27,1146173
fldAp,12.333333333333334,38,2,TCGATAACATCGTAGAGAGA,36,1063671
fldAp,8.333333333333334,26,2,TCGACCATATAGATTTTGTT,24,1154282
fldAp,0.6666666666666666,3,2,TCCTGGGTGGTGGAATCAAA,1,1093231
fldAp,7.666666666666667,24,2,TCCGCTCCAACTTCATTGTT,22,1113945
fldAp,6.0,19,2,TCCGCGTGACGGCTGCCGAA,17,1108893
fldAp,5.333333333333333,17,2,TCCCGTTATAGGAAGCGAAC,15,1086117
fldAp,16.333333333333332,50,2,TCCCGTAAGGCGCGCGGATC,48,1065400
fldAp,6.333333333333333,20,2,TCCCGGATCAAAATAACTAC,18,1079884
fldAp,12.0,37,2,TCCCGGAGCAGCATATATAT,35,1111612
fldAp,6.333333333333333,20,2,TCCCGCGTAATCGCTGAGTA,18,1075662
fldAp,1.0,4,2,TCCATAGGATCTATGAGTTA,2,1140897
fldAp,8.333333333333334,26,2,TCCACAGGGATGTCATCAGA,24,1127250
fldAp,7.0,22,2,TCCAAGAGGTATCCTGTCAA,20,1100782
fldAp,9.666666666666666,30,2,TCCAAGACCAATGCTTGTAC,28,1076289
fldAp,0.6666666666666666,3,2,TCATTCAGCGGCTATCCTCC,1,1105986
fldAp,9.0,28,2,TCAGTCATCCTCCGAATTCT,26,1067526
fldAp,4.0,13,2,TCACTTCTGTTAAGGGCCTA,11,1112899
fldAp,0.6666666666666666,3,2,TCACTCTGAATGTCTGAAGA,1,1129227
fldAp,5.0,16,2,TCACGATTTCGAAGCTGCAT,14,1126630
fldAp,7.666666666666667,24,2,TCACAACCTCCCGGGGATAT,22,1073208
fldAp,8.0,25,2,TCAAGTAGCTTGGGATCTAA,23,1109124
fldAp,9.333333333333334,29,2,TATCTGCTAAGCAGTGACGA,27,1113105
fldAp,7.666666666666667,24,2,TATCGCGACAATATGAGCAA,22,1132986
fldAp,11.333333333333334,35,2,TATCGAGGCGTATGACCCGG,33,1148571
fldAp,28.666666666666668,87,2,TATATTGGTGGCGTCGCTGT,85,1098693
fldAp,11.666666666666666,36,2,TATACGAACCACTCGTCAGG,34,1171136
fldAp,6.666666666666667,21,2,TATACCTAGTCTTCTCTCAA,19,1127853
fldAp,8.666666666666666,27,2,TATACCGTCTAAGGTGGAAA,25,1077545
fldAp,1.3333333333333333,5,2,TAGGGGCCACTGAGGTGTGG,3,1132959
fldAp,10.666666666666666,33,2,TAGGCTTGAATCCGATAAGG,31,1109720
fldAp,11.666666666666666,36,2,TAGGCTTAACCCCATTCAAA,34,1115493
fldAp,13.333333333333334,41,2,TAGGCCCGCATGACTGACGA,39,1166708
fldAp,6.666666666666667,21,2,TAGGAGCCGGAGAATGACAA,19,1088034
fldAp,20.333333333333332,62,2,TAGCGCAAACCCCAGATATG,60,1102015
fldAp,10.333333333333334,32,2,TAGATGTCATGAATACAGTG,30,1177911
fldAp,29.0,88,2,TAGATGAATTCGGTATTGTC,86,1126557
fldAp,8.333333333333334,26,2,TAGACATTGGTCTATTAAGG,24,1170809
fldAp,8.0,25,2,TACTTCAGTTTGCTGCCCTG,23,1080407
fldAp,11.0,34,2,TACTAGACTTTAGGAAGCAT,32,1130254
fldAp,10.0,31,2,TACTAAGTTTCGGCCTGGGC,29,1145207
fldAp,17.666666666666668,54,2,TACGCAGTGTATCCTCGTCA,52,1125443
fldAp,9.333333333333334,29,2,TACCACCCGCACGGAAGACT,27,1100028
fldAp,9.0,28,2,TACACTACGGGACGGTGATC,26,1136694
fldAp,4.333333333333333,14,2,TACAATTTCGAAACCTTCTT,12,1158700
fldAp,19.666666666666668,60,2,TACAATTTATAGACCGTTGA,58,1155660
fldAp,8.0,25,2,TAATTTGCAGACGCTCAAGT,23,1183458
fldAp,0.6666666666666666,3,2,TAATTGGGTTTCATTTTCAT,1,1136566
fldAp,20.333333333333332,62,2,TAATCCTATTTACGCCTCGT,60,1115019
fldAp,4.666666666666667,15,2,TAAGCTCGCTCCCTTGTTCG,13,1152152
fldAp,3.3333333333333335,11,2,TAAGCGGAACAGTCTCTCTC,9,1144240
fldAp,13.666666666666666,42,2,TAAGATGGTAGTTCACGCCC,40,1090875
fldAp,11.0,34,2,TAAATGAGCCTGCGCAGCTT,32,1151477
fldAp,10.0,31,2,TAAAGCCTTTTCCATCAGGG,29,1086502
fldAp,11.333333333333334,35,2,TAAACTCACGATCACCGCCC,33,1147351
fldAp,9.333333333333334,29,2,GTTTGGCCATGTAAGCAGCG,27,1068931
fldAp,6.0,19,2,GTTTCGAATAGGCTCCGGGG,17,1086470
fldAp,11.0,34,2,GTTTACTTTTCCCGTGTCTT,32,1154909
fldAp,2.0,7,2,GTTGGAGCGATCCGGTAAGG,5,1095166
fldAp,17.0,52,2,GTTGAGTCGTTCTGATTGAC,50,1143083
fldAp,5.0,16,2,GTTCACAGCACAGGCTGGGG,14,1130526
fldAp,11.333333333333334,35,2,GTTAACTCTATGGGAGTTAC,33,1095600
fldAp,2.6666666666666665,9,2,GTGTTTCTAATACGGCTTAT,7,1104113
fldAp,5.666666666666667,18,2,GTGTAAGTTGTTGCAGGTGC,16,1144912
fldAp,7.0,22,2,GTGGTAAGAGACACGTTAAG,20,1183728
fldAp,10.0,31,2,GTGCACGTAACATTAGCTGC,29,1111799
fldAp,14.333333333333334,44,2,GTGATCGTCCTTCCTTGACT,42,1074636
fldAp,8.333333333333334,26,2,GTCTTTGGGTTGAACGGTTG,24,1073371
fldAp,5.333333333333333,17,2,GTCTGCCCTCCGAGGTGCCA,15,1175698
fldAp,9.666666666666666,30,2,GTCTGCCCGTTATTTTTGCA,28,1077601
fldAp,0.6666666666666666,3,2,GTCTCGTCCGGTTAGCAGGC,1,1181747
fldAp,1.0,4,2,GTCTCCTCTTGGCCCTAACG,2,1137095
fldAp,0.6666666666666666,3,2,GTCGTTAGTGAGCCGTTTTT,1,1105203
fldAp,7.666666666666667,24,2,GTCGAACGTTAGTCCCAACT,22,1107467
fldAp,7.666666666666667,24,2,GTCGAAACATTGTATATCAT,22,1185536
fldAp,10.666666666666666,33,2,GTCATATTTTTCCTTATGAA,31,1086005
fldAp,0.6666666666666666,3,2,GTCACCTGATTATAATACTG,1,1123033
fldAp,13.666666666666666,42,2,GTATGGGAGCCGACGGGTAT,40,1109707
fldAp,5.0,16,2,GTACGTATCAAATCGGATTT,14,1144065
fldAp,9.333333333333334,29,2,GTACGCATAGTTTTCGGCCT,27,1185139
fldAp,1.0,4,2,GTAATGGTCCCTACATATTC,2,1080395
fldAp,7.0,22,2,GTAACATTCTCATGTGACCC,20,1149409
fldAp,11.666666666666666,36,2,GTAACAACAATTAATAAGAC,34,1092323
fldAp,7.333333333333333,23,2,GTAAAAACGATGACGGTTGT,21,1108853
fldAp,3.0,10,2,GGTGGTATTCAACGGCTGTT,8,1142027
fldAp,9.0,28,2,GGTGGGAGTGGCGGGCCATT,26,1118144
fldAp,19.666666666666668,60,2,GGTCTCCTATGTTTATGGGT,58,1086696
fldAp,7.666666666666667,24,2,GGTCTACCGATAAATTCATT,22,1102691
fldAp,2.3333333333333335,8,2,GGTCACGATAGATGCATTTT,6,1174102
fldAp,6.666666666666667,21,2,GGTAGGCGGCGCTCTAATTG,19,1152143
fldAp,8.0,25,2,GGTAAACGGGGGAGCAGCCT,23,1128626
fldAp,10.333333333333334,32,2,GGGTCCGCTACCCTGCACGT,30,1176898
fldAp,10.0,31,2,GGGTCAGAGAGAGCCGGGGA,29,1098389
fldAp,21.0,64,2,GGGTCAAGTCCTCTGGGGCG,62,1084470
fldAp,6.666666666666667,21,2,GGGTCAAGCCACGTGGTCTA,19,1112336
fldAp,19.0,58,2,GGGGTGGACGACCAATCATT,56,1084570
fldAp,10.666666666666666,33,2,GGGGTGACGACGGCACTTGC,31,1074104
fldAp,11.333333333333334,35,2,GGGGTAATATGGCGACCAAC,33,1123909
fldAp,4.666666666666667,15,2,GGGGTAACGCCAGCCAGAAG,13,1083335
fldAp,5.666666666666667,18,2,GGGGACTTGGCTACTATCGG,16,1169125
fldAp,2.6666666666666665,9,2,GGGCATACTTGCAAATTCTC,7,1181878
fldAp,6.0,19,2,GGGACCGAGTTGTTCTGTCC,17,1126445
fldAp,0.6666666666666666,3,2,GGGACATCGGGCACGGTGTA,1,1084466
fldAp,9.333333333333334,29,2,GGGAAGGCATCTTCACAGGA,27,1064492
fldAp,8.666666666666666,27,2,GGGAACATATGCTAGATTCC,25,1063232
fldAp,4.333333333333333,14,2,GGCGAACGATGTATCAAGGA,12,1133112
fldAp,5.333333333333333,17,2,GGCCTGCGCGTACCGCTTCT,15,1112684
fldAp,0.6666666666666666,3,2,GGCCTGAGGATCGCACTATT,1,1163080
fldAp,9.333333333333334,29,2,GGCCGTCCGATTGAATAGGT,27,1173473
fldAp,27.333333333333332,83,2,GGCCAGCTTTGGGACGATGG,81,1107669
fldAp,0.6666666666666666,3,2,GGCAGTTGCCGCTTTAGCGT,1,1088603
fldAp,1.0,4,2,GGCAGACTCAAGCAGAACGT,2,1069522
fldAp,10.666666666666666,33,2,GGCAGACATAGCTCTGCTTA,31,1145081
fldAp,10.333333333333334,32,2,GGCACCGACAACGAATGACT,30,1146428
fldAp,5.666666666666667,18,2,GGATTATCGACGGTTACACT,16,1068309
fldAp,15.666666666666666,48,2,GGATATCCCATCCTCGAACG,46,1066024
fldAp,3.3333333333333335,11,2,GGAGTTAGTAGAGGGAAATG,9,1101661
fldAp,4.333333333333333,14,2,GGACTGATTAATTGGGGCAT,12,1159566
fldAp,3.0,10,2,GGACGAGGAAAGAGTACATT,8,1151919
fldAp,7.333333333333333,23,2,GGAATTTCATTGAAAACTGT,21,1122978
fldAp,31.333333333333332,95,2,GGAAAGTAGTGCTGCCATAA,93,1110379
fldAp,8.666666666666666,27,2,GCTTCTTCTCGGAGAAAACA,25,1122024
fldAp,8.0,25,2,GCTTCTAAATGCGCGCCCCT,23,1146183
fldAp,0.6666666666666666,3,2,GCTTCGGGCTCACGCTCACT,1,1105567
fldAp,3.6666666666666665,12,2,GCTTATACTAACACAATGAT,10,1160613
fldAp,0.6666666666666666,3,2,GCTGTTGGCCGACGCGTATA,1,1168923
fldAp,0.6666666666666666,3,2,GCTGTACAGCGATTAACGCA,1,1106415
fldAp,6.0,19,2,GCTGGAACGGACAAATAACA,17,1151870
fldAp,4.0,13,2,GCTGCAGTGGTAACCAGTAG,11,1115462
fldAp,33.333333333333336,101,2,GCTGAGGAGAATTGTACTTC,99,1169914
fldAp,11.0,34,2,GCTCGGGGGCACCTTCGAAC,32,1116886
fldAp,9.666666666666666,30,2,GCTCGCGGGGGAACCGTACC,28,1156963
fldAp,2.0,7,2,GCTCCTACTGTACGAGGGGG,5,1182593
fldAp,6.333333333333333,20,2,GCTACTTACCGGAAGAGCCT,18,1155361
fldAp,7.333333333333333,23,2,GCGTTTGGCACAGAGCGTAA,21,1107350
fldAp,9.0,28,2,GCGTGATATCATTCTGGTAC,26,1159895
fldAp,8.666666666666666,27,2,GCGTAGGTCTAGTGGGACCG,25,1119222
fldAp,0.6666666666666666,3,2,GCGCCGAAAATAAGACGCGG,1,1131067
fldAp,8.0,25,2,GCGCATTAGGAGGGGCGGTA,23,1083322
fldAp,2.0,7,2,GCGCAACCTGCGTCGCATGC,5,1104253
fldAp,2.0,7,2,GCGATCTAGCAAGTCTCCAA,5,1139297
fldAp,6.333333333333333,20,2,GCGAGCCGACATTCAATTGT,18,1115559
fldAp,10.666666666666666,33,2,GCGAGACAACATGTTAAGGG,31,1134695
fldAp,0.6666666666666666,3,2,GCGACCGTGGCAGGAAGCCT,1,1069806
fldAp,10.333333333333334,32,2,GCCTCGCGTAATGTCATCCA,30,1078364
fldAp,11.0,34,2,GCCGGTAGGTTGAATCCTAT,32,1124058
fldAp,1.6666666666666667,6,2,GCCCCTACGGAAGCAGATAA,4,1113210
fldAp,26.666666666666668,81,2,GCCAGGTTTAATTGGCAACT,79,1066033
fldAp,10.666666666666666,33,2,GCATAGTCCGTCAGGAGGCA,31,1117123
fldAp,5.333333333333333,17,2,GCAGTTGTTGATCCGTGTCC,15,1147428
fldAp,1.6666666666666667,6,2,GCAGCTACTGGCCTGATCGA,4,1107248
fldAp,7.0,22,2,GCAGCGGTCAATGAGAGTAC,20,1082522
fldAp,0.6666666666666666,3,2,GCAGCGGCAGGGGATTGCGC,1,1117282
fldAp,11.0,34,2,GCACGGTCAAAAACCGTGAT,32,1103271
fldAp,10.333333333333334,32,2,GCACATGGCGACAAACTCGG,30,1169336
fldAp,48.333333333333336,146,2,GCACATACCTCTGCTAGCTG,144,1126535
fldAp,15.333333333333334,47,2,GCACAGTCTATCCCCGTATC,45,1184705
fldAp,8.666666666666666,27,2,GCAATTCCCAGCATTTCGGG,25,1074480
fldAp,6.0,19,2,GATTTAGTTCGGTGGGATAT,17,1084465
fldAp,0.6666666666666666,3,2,GATTCCTTTCCTAAAACTCA,1,1068043
fldAp,7.666666666666667,24,2,GATTCCGTTCGGATGGGGTA,22,1077588
fldAp,5.666666666666667,18,2,GATTACACGCTGAAAATTCT,16,1076678
fldAp,0.6666666666666666,3,2,GATATGCAGGATCCATAATC,1,1181402
fldAp,6.0,19,2,GATATCCTATATATGATCTA,17,1158819
fldAp,1.6666666666666667,6,2,GATATACTGAGGGACAGCGG,4,1067488
fldAp,18.666666666666668,57,2,GATAACTTGCCGGCACACAC,55,1063114
fldAp,5.666666666666667,18,2,GAGTTCCGTCTCAATATGGC,16,1070807
fldAp,0.6666666666666666,3,2,GAGGCCGCTGCGAATACCGG,1,1154642
fldAp,12.666666666666666,39,2,GAGGATGGCACGCATGTAGC,37,1103810
fldAp,5.0,16,2,GAGGAGGGGGATTTACAAAC,14,1125399
fldAp,0.6666666666666666,3,2,GAGCGTTACGCGGGAGTCCA,1,1147222
fldAp,5.333333333333333,17,2,GAGCGACCCGTATAATGCTA,15,1140487
fldAp,11.666666666666666,36,2,GAGATCAGGTTGCAGGTCTC,34,1122913
fldAp,2.0,7,2,GAGATAGTTAGCACAGGGTC,5,1084800
fldAp,8.666666666666666,27,2,GAGAGAATATATCCACGTAT,25,1083837
fldAp,6.0,19,2,GAGAAGGCCTGGGCTCGTTA,17,1070617
fldAp,5.666666666666667,18,2,GACTGCTTTGGGTATGTATT,16,1104645
fldAp,9.666666666666666,30,2,GACTAACGAGTCACGGAAGA,28,1182948
fldAp,3.6666666666666665,12,2,GACGGCTTCTTTGGCCGTTC,10,1100493
fldAp,8.333333333333334,26,2,GACGAACAGTCCCCGCTGTG,24,1105536
fldAp,11.0,34,2,GACCTTGGCAGGGGTGAACG,32,1116022
fldAp,15.666666666666666,48,2,GACCGAATTCAATATGCTTA,46,1100481
fldAp,17.333333333333332,53,2,GACCCTAGGACCGCGTACCC,51,1085780
fldAp,12.333333333333334,38,2,GACATAAGACTGCCGATTTT,36,1091825
fldAp,9.333333333333334,29,2,GACAGTGCGAAATTAGACGG,27,1128830
fldAp,10.333333333333334,32,2,GAATGCATAGGCTGCAGCTC,30,1072553
fldAp,9.0,28,2,GAAGCAGATGTATATGTCAA,26,1092313
fldAp,7.0,22,2,GAACGGGTACGTGTCAACCT,20,1097095
fldAp,11.333333333333334,35,2,GAAATGCCGAGCGTCCAGTG,33,1137319
fldAp,7.666666666666667,24,2,GAAAGCGCTGGGTATTGTCA,22,1079730
fldAp,37.333333333333336,113,2,CTTTGGCGCCAACACAAGCG,111,1126540
fldAp,2.0,7,2,CTTTCGTCTGTAATTCTCGG,5,1107447
fldAp,4.333333333333333,14,2,CTTTCGAAGCAACGTATTAG,12,1146965
fldAp,9.666666666666666,30,2,CTTTAATCCGTTTCGCGACC,28,1141175
fldAp,16.666666666666668,51,2,CTTGATCGATACGACACTGG,49,1130833
fldAp,0.6666666666666666,3,2,CTTCGAGCTTATTTTAGATA,1,1152687
fldAp,8.0,25,2,CTTACGTGCAGGTTCCTGCA,23,1150096
fldAp,0.6666666666666666,3,2,CTTACGGTGAAGTCTAAATA,1,1150060
fldAp,0.6666666666666666,3,2,CTTAACGAATAGCCCGGGGA,1,1118504
fldAp,14.333333333333334,44,2,CTGTACGCGCCTTCTGGGGG,42,1122592
fldAp,0.6666666666666666,3,2,CTGTACCAGTTCAGGGCCAA,1,1178028
fldAp,9.666666666666666,30,2,CTGTAAACATTCACGGCTAA,28,1167167
fldAp,6.0,19,2,CTGGGATACTACGAGTTGAC,17,1084569
fldAp,1.0,4,2,CTGGCGAAGTACTGCGGTCA,2,1169685
fldAp,8.0,25,2,CTGCGGTACCAGATCGTCCA,23,1063499
fldAp,4.0,13,2,CTGATCACTCGGCATCGAAC,11,1141419
fldAp,0.6666666666666666,3,2,CTCTGGCCCGGGCCGGACAG,1,1140812
fldAp,1.3333333333333333,5,2,CTCTGACATACGCCGCAACC,3,1123023
fldAp,5.333333333333333,17,2,CTCGGGCCGGCCAGCCAAGC,15,1137562
fldAp,7.0,22,2,CTCGCAGCTCCCTTGGATGT,20,1181691
fldAp,10.0,31,2,CTCCTGAGGCCAGCTATGTC,29,1178641
fldAp,0.6666666666666666,3,2,CTCCCAGGCTCATCGGCTGG,1,1082915
fldAp,0.6666666666666666,3,2,CTCCATGTTGCCTTTACGAG,1,1077622
fldAp,2.3333333333333335,8,2,CTCAGTGTGACTCGAGTGAC,6,1136497
fldAp,9.666666666666666,30,2,CTCAATTTTACATTGCCTCC,28,1070019
fldAp,14.333333333333334,44,2,CTCAAACCGTGGGGGTTTCT,42,1151182
fldAp,16.0,49,2,CTATTGTCCTACAGCGGGGT,47,1086706
fldAp,4.666666666666667,15,2,CTATTCCCCACTTAGACAGC,13,1172626
fldAp,11.333333333333334,35,2,CTATTCAGTGCATTCGTCCT,33,1152002
fldAp,9.0,28,2,CTATCTTTTGGCTATTGAGG,26,1174551
fldAp,11.0,34,2,CTATATCCTTCGGACCGTCA,32,1176495
fldAp,49.0,148,2,CTAGTTCCATCGGGTGACTT,146,1066002
fldAp,9.666666666666666,30,2,CTACTGGAGGCGAATTTTGG,28,1176359
fldAp,11.0,34,2,CTACGAAGCCAAGGATTGGT,32,1114245
fldAp,2.3333333333333335,8,2,CTAATCACCGGCCCCCTCGG,6,1084162
fldAp,8.0,25,2,CTAATAAGACGTTTTCAGTC,23,1171320
fldAp,0.6666666666666666,3,2,CTAAGGTACGTCAGGAGAGC,1,1151339
fldAp,0.6666666666666666,3,2,CTAAGCCATGCTTGCGGTTC,1,1093631
fldAp,0.6666666666666666,3,2,CTAAATTCGGGAATATATCT,1,1088008
fldAp,1.3333333333333333,5,2,CGTTTATACGGATAGAAGTT,3,1166258
fldAp,7.0,22,2,CGTTGTGTCCACTGAATGTC,20,1099075
fldAp,8.0,25,2,CGTTAATTTCTATCAAGACT,23,1161649
fldAp,1.3333333333333333,5,2,CGTGCCTCAGGACACACCGC,3,1129743
fldAp,11.666666666666666,36,2,CGTCTGGGGGCGAATTCATG,34,1118773
fldAp,0.6666666666666666,3,2,CGTCGCCGTTTAGTTGAGCG,1,1108361
fldAp,6.333333333333333,20,2,CGTCCCCCACGGAAGAAGTC,18,1137301
fldAp,9.0,28,2,CGTCATTCTGTGTACCTTGA,26,1143657
fldAp,8.333333333333334,26,2,CGTCAATCGTACGACTGAAT,24,1102367
fldAp,9.666666666666666,30,2,CGTACGCATGGTGTATTGGT,28,1085430
fldAp,7.0,22,2,CGGTTTAACAGGCCTGTACG,20,1116896
fldAp,11.0,34,2,CGGTGAGGTCAGGAATCAGC,32,1083928
fldAp,22.666666666666668,69,2,CGGTCTAATTGTTTTATGGA,67,1181520
fldAp,0.6666666666666666,3,2,CGGTATCGTGGGTGGTTGGG,1,1090437
fldAp,0.6666666666666666,3,2,CGGGTATTCGCAGAGAGATG,1,1127753
fldAp,1.3333333333333333,5,2,CGGGAATTTTGTGACAACCA,3,1184267
fldAp,8.333333333333334,26,2,CGGCTACTAGCTCGGCCCCG,24,1127319
fldAp,10.666666666666666,33,2,CGGCCAATCGGATCCTACCA,31,1098818
fldAp,0.6666666666666666,3,2,CGGAGAAGTAAGACACCGCG,1,1095280
fldAp,7.666666666666667,24,2,CGGACATAGTATAGGGTTCA,22,1116292
fldAp,7.0,22,2,CGCTTTGCGTTTACTTTTAT,20,1089984
fldAp,16.333333333333332,50,2,CGCTTGCGAAGTTACCTGCT,48,1072948
fldAp,6.666666666666667,21,2,CGCTTGAAGATATGAGGGAC,19,1073346
fldAp,13.0,40,2,CGCTGCCATGCTTTGTCCCA,38,1093416
fldAp,9.666666666666666,30,2,CGCTCGGCACGGAGACCGCG,28,1106598
fldAp,1.0,4,2,CGCTAACATGCGTGTCGCTC,2,1124113
fldAp,10.666666666666666,33,2,CGCGTTTGAATCAGCTTATA,31,1076497
fldAp,7.333333333333333,23,2,CGCGTCCCTGTGTACAGGGG,21,1082516
fldAp,10.0,31,2,CGCGCCCGGAAAAACCTATT,29,1142344
fldAp,7.666666666666667,24,2,CGCGACTACGGGGCTGTCAC,22,1171534
fldAp,0.6666666666666666,3,2,CGCGAATGGCGTTTCTATGC,1,1071982
fldAp,11.333333333333334,35,2,CGCCGAGTGGCCCCTATCCA,33,1165347
fldAp,15.333333333333334,47,2,CGCCCATCGGCTCCTCCCCA,45,1117221
fldAp,0.6666666666666666,3,2,CGCATGTCGCTCAAACCTTT,1,1169516
fldAp,19.333333333333332,59,2,CGCAGGCAAAGAAAAGCGAA,57,1167408
fldAp,3.0,10,2,CGCACTATAGCGGGAAGAGC,8,1178505
fldAp,2.3333333333333335,8,2,CGCACCGTTAGTTCTGGTAG,6,1076745
fldAp,7.0,22,2,CGAGTATGAGGGGCTTGCCC,20,1111176
fldAp,3.3333333333333335,11,2,CGAGGAACTCCTAAATCAAA,9,1119220
fldAp,13.0,40,2,CGACTATCACGATTTCCTCT,38,1179867
fldAp,6.666666666666667,21,2,CGACCCCGCCCGGTAAGCGT,19,1148549
fldAp,11.666666666666666,36,2,CGACAGCGGCCGTTCGGAAG,34,1145197
fldAp,8.0,25,2,CGAAGGGTCCACCTCTATTA,23,1127757
fldAp,9.666666666666666,30,2,CGAAGGACAGAGCACGTGTG,28,1135152
fldAp,8.0,25,2,CCTTGGAAGTACATATTTTA,23,1126739
fldAp,8.666666666666666,27,2,CCTGGGGTGCAAGGTCTCCG,25,1101754
fldAp,9.0,28,2,CCTGCCCGCAACGGTCAAAT,26,1147720
fldAp,0.6666666666666666,3,2,CCTGACCCAGTCCCCCGTTC,1,1122125
fldAp,0.6666666666666666,3,2,CCTGAAGGGCTCGAGAGCCC,1,1153969
fldAp,8.0,25,2,CCTCCTTGTCTGAAAAATGG,23,1082606
fldAp,7.333333333333333,23,2,CCTCCGGATTGTGTACCGTT,21,1166670
fldAp,0.6666666666666666,3,2,CCTCCGACGGCCTACCGACT,1,1167038
fldAp,8.0,25,2,CCTAGCGTATCGTCATCCAC,23,1159306
fldAp,11.333333333333334,35,2,CCTAGCGGGTGGCTACATAC,33,1064083
fldAp,6.0,19,2,CCTAAGAGTCCCAGGTCTAA,17,1165934
fldAp,0.6666666666666666,3,2,CCGTTCCATTCAAAGGCCAC,1,1123118
fldAp,30.333333333333332,92,2,CCGTGCCCGCCGGCGGGGGC,90,1078982
fldAp,12.333333333333334,38,2,CCGTAGCAGTCCTTTTAACT,36,1071650
fldAp,5.333333333333333,17,2,CCGGTGCGTCTTCACTCGGG,15,1120200
fldAp,11.0,34,2,CCGGATCCTGAAAATCCGCT,32,1093675
fldAp,12.0,37,2,CCGCCCCTGTAAGGAGATGT,35,1136793
fldAp,22.666666666666668,69,2,CCGCCAATGCTAAACGGGGA,67,1064795
fldAp,7.333333333333333,23,2,CCGAGTGAACCGGTGGAGAG,21,1176497
fldAp,16.333333333333332,50,2,CCCGGCTCTAGGCCAAGTGT,48,1184755
fldAp,24.333333333333332,74,2,CCCGAGGAGGTGTTCGGCGA,72,1146156
fldAp,11.333333333333334,35,2,CCCCTATTATGTATAAACTA,33,1144051
fldAp,1.6666666666666667,6,2,CCCCGTTAAATTTTTGAAGC,4,1148305
fldAp,5.0,16,2,CCCATCTTGCCAATTAACGG,14,1112360
fldAp,5.666666666666667,18,2,CCCACTGTTTTGGAAGCCCG,16,1126248
fldAp,9.333333333333334,29,2,CCCAAAACCAGACTATGACT,27,1179265
fldAp,8.666666666666666,27,2,CCATGGACTTTTCGTCCGTG,25,1178409
fldAp,7.333333333333333,23,2,CCAGCGATACATGTACTCGA,21,1082617
fldAp,6.0,19,2,CCAGAGACGGTGCGTGGGCA,17,1080964
fldAp,13.0,40,2,CCAGACTTCCCCCCGGCCTT,38,1139315
fldAp,23.666666666666668,72,2,CCACGGGGCACTTCCTCTGA,70,1078627
fldAp,5.666666666666667,18,2,CCACGCTGGCTAGTACGGTC,16,1129505
fldAp,8.333333333333334,26,2,CCACCCCGCTTATGTGACAA,24,1170754
fldAp,9.333333333333334,29,2,CCACCCAACCAGTTGGCTAC,27,1120499
fldAp,64.66666666666667,195,2,CCACATTCCATTCTAGTGGT,193,1064784
fldAp,7.0,22,2,CCAATAAGCGAGAGCTCCTT,20,1159906
fldAp,3.6666666666666665,12,2,CCAAGCCGCCCAAGGGGCGG,10,1136510
fldAp,11.0,34,2,CCAACTGCTGGAATATCCCC,32,1132308
fldAp,14.333333333333334,44,2,CATGTTGGGCATTCTTGCCT,42,1112129
fldAp,2.3333333333333335,8,2,CATGGAATACCGGATTTGGG,6,1178676
fldAp,12.0,37,2,CATGCTTGTGCGCCGTGTGA,35,1119166
fldAp,11.333333333333334,35,2,CATCTCACCATGGGCAATGG,33,1154031
fldAp,3.3333333333333335,11,2,CATCCGCAGGGACTCAATTT,9,1095127
fldAp,9.666666666666666,30,2,CATAGGTGGAAGACAATGTC,28,1111156
fldAp,0.6666666666666666,3,2,CATAGGGCGACTACGCGTGG,1,1186878
fldAp,8.0,25,2,CATAATCGACAACGCCCGGC,23,1104057
fldAp,27.0,82,2,CAGTTTTGCCCTTACTTGCA,80,1127820
fldAp,4.666666666666667,15,2,CAGTTCGCAAACTATAGTCT,13,1064140
fldAp,5.666666666666667,18,2,CAGTTACGGGTGCAGTATAG,16,1186567
fldAp,9.666666666666666,30,2,CAGTGTCCAACGGATTATGC,28,1129543
fldAp,11.333333333333334,35,2,CAGGGCAAGGAACTGAAAGT,33,1170628
fldAp,23.0,70,2,CAGGGACTTGTTTACCTTCC,68,1109059
fldAp,0.6666666666666666,3,2,CAGGCGTTTTTTAAAAAATA,1,1119439
fldAp,6.333333333333333,20,2,CAGGCATACAACGCCAAATC,18,1109046
fldAp,22.333333333333332,68,2,CAGGATTCGGCTCGACCAGT,66,1176935
fldAp,1.6666666666666667,6,2,CAGCCTTACATTTCGTGTAT,4,1186280
fldAp,0.6666666666666666,3,2,CAGCATACAGTAGGTGAGTA,1,1115868
fldAp,15.0,46,2,CAGCAAGAAGCGAGGGAACG,44,1152078
fldAp,7.333333333333333,23,2,CAGACGGTGTCATCTTAGCA,21,1153757
fldAp,1.0,4,2,CAGAAATGGTGGGAATGAAT,2,1096130
fldAp,0.6666666666666666,3,2,CACTTGACATACTGTCTGAG,1,1115407
fldAp,9.666666666666666,30,2,CACTCTGGAAGAACCTGAAA,28,1079224
fldAp,6.333333333333333,20,2,CACGGTCTCCGTGGGCGCCA,18,1154323
fldAp,9.666666666666666,30,2,CACGCGTCTGGTCATGTTCT,28,1180444
fldAp,5.333333333333333,17,2,CACCTAGTCGTTGCTTTTCG,15,1123651
fldAp,8.333333333333334,26,2,CACATAGATCGGTCCGAGTC,24,1137502
fldAp,7.333333333333333,23,2,CACAATAAGCCCGTCAACGC,21,1167161
fldAp,8.333333333333334,26,2,CACAAACCTGGTGTACGTCT,24,1153651
fldAp,5.333333333333333,17,2,CAATGGGCAGACTCCTGCTT,15,1174063
fldAp,2.0,7,2,CAATGCCACCGAAGCTCCTT,5,1184093
fldAp,6.0,19,2,CAATAAAAAACAACGTAGGG,17,1161666
fldAp,1.6666666666666667,6,2,CAAGGAGGACAACTATTAGT,4,1086805
fldAp,7.333333333333333,23,2,CAAGCTATTTCCATACTGCG,21,1133057
fldAp,8.333333333333334,26,2,CAACAGGGATATAATAGGTG,24,1119147
fldAp,16.666666666666668,51,2,CAACACTAAGCGGTCGTTGA,49,1064766
fldAp,12.333333333333334,38,2,CAAAGATCCATCCATCACAA,36,1071414
fldAp,10.666666666666666,33,2,ATTTCGAGTCTACAAACTCT,31,1144490
fldAp,1.0,4,2,ATTGTTCATGAGAGCTATGG,2,1116370
fldAp,3.3333333333333335,11,2,ATTGGTATTCCCCGCTTTTC,9,1072409
fldAp,0.6666666666666666,3,2,ATTGCGGCTAAATTATATAA,1,1077815
fldAp,15.0,46,2,ATTCTCTGACCTGTCAGTAC,44,1097717
fldAp,2.6666666666666665,9,2,ATTCGGCGATCGAACTAGAT,7,1123072
fldAp,39.333333333333336,119,2,ATTCCTGCGGCTCTAAGTCC,117,1108111
fldAp,28.0,85,2,ATTCCTCACCTTGATAACGG,83,1125714
fldAp,4.333333333333333,14,2,ATTCATACTAGGTCGTGTAA,12,1146596
fldAp,9.0,28,2,ATTAGTCGATGCCCTTCGGG,26,1184994
fldAp,29.0,88,2,ATGTTCTTGGAGGTACGCCC,86,1064769
fldAp,0.6666666666666666,3,2,ATGTGCCTTCGTTGAACTAG,1,1102735
fldAp,18.333333333333332,56,2,ATGTGAAGAAGGCATTGTAT,54,1078600
fldAp,15.333333333333334,47,2,ATGTCAACTGCCGAAGTTTA,45,1118976
fldAp,37.0,112,2,ATGTATCGTGCCCCCGAGTA,110,1064764
fldAp,4.333333333333333,14,2,ATGTATACTCGTTGACGAGG,12,1115027
fldAp,3.0,10,2,ATGTAGCACACCGGCGCTTG,8,1124859
fldAp,4.333333333333333,14,2,ATGTACTGAAGTTCACATCT,12,1081534
fldAp,13.666666666666666,42,2,ATGGTTGGAGGGCAGTACAG,40,1143761
fldAp,25.666666666666668,78,2,ATGGGCAATTAACGAACCGC,76,1139666
fldAp,10.333333333333334,32,2,ATGGCCTTAAATATTGGAAT,30,1098306
fldAp,6.666666666666667,21,2,ATGCGTTCTAAGCCGAGCTG,19,1104702
fldAp,5.666666666666667,18,2,ATGAATTCACCCGTTGGCTA,16,1154313
fldAp,4.666666666666667,15,2,ATCTTATGAGGGATGGGCAT,13,1138747
fldAp,2.6666666666666665,9,2,ATCTTATCTGAGCGCCACTG,7,1133617
fldAp,7.0,22,2,ATCTCGTGAAGACTATTTAT,20,1070235
fldAp,12.666666666666666,39,2,ATCTCACGTGTTGTGGTTCT,37,1124257
fldAp,11.666666666666666,36,2,ATCGAGGACGGGCGCCACCG,34,1089175
fldAp,9.0,28,2,ATCCTCAGCAGTACGTCACC,26,1135797
fldAp,0.6666666666666666,3,2,ATCATTCGGGTCCCCGCATT,1,1186281
fldAp,4.0,13,2,ATCACGGAGTCCCCCTCTTC,11,1182219
fldAp,12.0,37,2,ATCAATATACCAATGTGACA,35,1098830
fldAp,17.666666666666668,54,2,ATATCATGCAGCGGGTATAA,52,1087426
fldAp,5.666666666666667,18,2,ATAGGTATCGTTCACAAGCC,16,1133431
fldAp,1.0,4,2,ATACGGCAGCTCGCACCGTG,2,1143538
fldAp,10.0,31,2,ATACGACGGCGATCGATTGA,29,1162949
fldAp,0.6666666666666666,3,2,ATACAAGACGGTCGTCCTTG,1,1079969
fldAp,0.6666666666666666,3,2,ATAAGTCCCCGTTGGAAATA,1,1184362
fldAp,11.333333333333334,35,2,ATAAGGGATTATTGTTAAGC,33,1103995
fldAp,9.0,28,2,ATAACATTCACATAATCCAA,26,1169784
fldAp,16.0,49,2,ATAAAGGTGCATACTATAGG,47,1165478
fldAp,15.666666666666666,48,2,AGTTGTTTTCCAACGAATTT,46,1130456
fldAp,0.6666666666666666,3,2,AGTTGTTGGTACCCAAGTGC,1,1137784
fldAp,23.666666666666668,72,2,AGTTCTCGAGCCTAGACTCT,70,1172111
fldAp,6.333333333333333,20,2,AGTTATATAACAACCCGTCT,18,1184854
fldAp,8.0,25,2,AGTGTATTCTCCCGGGGGAG,23,1107440
fldAp,11.0,34,2,AGTGCTGAGGATAATTCCGG,32,1069246
fldAp,12.0,37,2,AGTGATACTTCGTTTCGAGC,35,1095291
fldAp,0.6666666666666666,3,2,AGTCTGAAGTTGTTAGAAGG,1,1088409
fldAp,8.666666666666666,27,2,AGTCCTAAACCTATCGATGA,25,1137385
fldAp,16.666666666666668,51,2,AGTATCGTGGGTCGTAAGGA,49,1124936
fldAp,5.333333333333333,17,2,AGGTTCCCATATTCCAATGG,15,1063832
fldAp,0.6666666666666666,3,2,AGGTTCAGTATCGTCCGCAA,1,1111289
fldAp,26.666666666666668,81,2,AGGTGTGAATATCTGCCAGG,79,1145099
fldAp,10.0,31,2,AGGTGGACAGGGACACAGCC,29,1067627
fldAp,11.666666666666666,36,2,AGGTCAACAAGGACTTCGAT,34,1112373
fldAp,0.6666666666666666,3,2,AGGGTACAGCAGCCCAGGGC,1,1120155
fldAp,14.333333333333334,44,2,AGGGGTGACGTATCAGGACT,42,1125730
fldAp,2.0,7,2,AGGGACGTGCTACGATTTAA,5,1166046
fldAp,0.6666666666666666,3,2,AGGCTTTTCCCTCCAGAGAC,1,1124285
fldAp,9.333333333333334,29,2,AGGCTTTATTCATTAAGTAG,27,1141794
fldAp,1.6666666666666667,6,2,AGGCTCGGACGAGCGGATCA,4,1093657
fldAp,18.0,55,2,AGGCGTGGACAAGGACATCA,53,1066050
fldAp,8.333333333333334,26,2,AGGCGTAACCATGCTGCGGT,24,1154587
fldAp,15.0,46,2,AGGATTACTCGTACGGTCAT,44,1143171
fldAp,1.3333333333333333,5,2,AGGAGGTGCACCTACTGTCA,3,1095503
fldAp,0.6666666666666666,3,2,AGGACATAACTATTTCAGCG,1,1109552
fldAp,30.333333333333332,92,2,AGGACAACGAGGCCCAACGC,90,1124029
fldAp,24.666666666666668,75,2,AGCTTCCATTACTTTCACGT,73,1169556
fldAp,8.666666666666666,27,2,AGCTAGTGACCTGGGTGCTT,25,1106124
fldAp,5.666666666666667,18,2,AGCGTGCATGAATGCGCTCC,16,1106953
fldAp,5.333333333333333,17,2,AGCGGAGGGCACCGAGCTTC,15,1160092
fldAp,12.666666666666666,39,2,AGCCGGATGTTTCCGATAGT,37,1153534
fldAp,12.666666666666666,39,2,AGCCCCGGCATGCAGTTTAT,37,1107104
fldAp,25.666666666666668,78,2,AGCCAGACAGGGCCAAGCCC,76,1133341
fldAp,10.0,31,2,AGATTAACCCTACGACATGC,29,1104244
fldAp,13.666666666666666,42,2,AGATGTACGATTGTGGCTAA,40,1166912
fldAp,11.333333333333334,35,2,AGATAGGTCCGCGCATAGGG,33,1179998
fldAp,7.666666666666667,24,2,AGAGGTGGTTAGGGGATAAT,22,1162925
fldAp,6.666666666666667,21,2,AGAGCTACCAAGCCATGATA,19,1152021
fldAp,2.3333333333333335,8,2,AGAAATGTATTTCCTTTAGG,6,1141841
fldAp,19.666666666666668,60,2,AGAAAGGGTAACAGCCGGCT,58,1158749
fldAp,7.0,22,2,ACTTTTCCTATTCGGCACAC,20,1162790
fldAp,7.666666666666667,24,2,ACTTACCCCATAGCACACCT,22,1094469
fldAp,0.6666666666666666,3,2,ACTGCGTGGGTCCTGAAAGA,1,1084181
fldAp,8.0,25,2,ACTCTGACTGCTAAAAGCAA,23,1094697
fldAp,15.0,46,2,ACTCATGGAGTGACGCGCGT,44,1124349
fldAp,32.333333333333336,98,2,ACTCATACTATGTTGGGGAA,96,1118335
fldAp,8.333333333333334,26,2,ACGTTTCATATATAGTCCCA,24,1174878
fldAp,22.0,67,2,ACGTTACCCATTCTGGCTGC,65,1083916
fldAp,6.666666666666667,21,2,ACGGCTACGCGCACTTCCTA,19,1167560
fldAp,0.6666666666666666,3,2,ACGGCATCTCAACGGTAAGT,1,1084926
fldAp,1.0,4,2,ACGGACTAATTATATGTCGT,2,1125430
fldAp,7.333333333333333,23,2,ACGCTATATGTCTACAGCAT,21,1180758
fldAp,7.333333333333333,23,2,ACGCAGGTCATCTCTCCGCC,21,1145083
fldAp,16.666666666666668,51,2,ACGATAGTCCCCAGTGGCGA,49,1077544
fldAp,10.333333333333334,32,2,ACCTTGATGGTGCCGAAGCC,30,1119710
fldAp,11.666666666666666,36,2,ACCGATCTAAACGGGGTAAT,34,1159048
fldAp,0.6666666666666666,3,2,ACCCCAAGGCTGTTCAGGAG,1,1085801
fldAp,66.33333333333333,200,2,ACCAACGGTGAAGTGGTCGC,198,1126530
fldAp,0.6666666666666666,3,2,ACATTTCGTCAAGTCGGTGA,1,1136523
fldAp,3.0,10,2,ACATACCGTAACCGCTCCAT,8,1179503
fldAp,7.0,22,2,ACATAAGTCAGACTACGACC,20,1144031
fldAp,7.666666666666667,24,2,ACATAAGAAAGGCAATGATC,22,1166718
fldAp,10.666666666666666,33,2,ACAGTTGGAGCGCAGTCGAA,31,1143938
fldAp,0.6666666666666666,3,2,ACACGTTGACGAGGTTCACT,1,1164262
fldAp,15.666666666666666,48,2,ACACACTTCTTTTACACATC,46,1082325
fldAp,12.0,37,2,ACAACACAACGTCCCGAGAA,35,1080435
fldAp,0.6666666666666666,3,2,ACAAAAGCCGAGAGAGTAAA,1,1063029
fldAp,11.0,34,2,AATTTTGCATATCGAGATCA,32,1180591
fldAp,7.666666666666667,24,2,AATTGGTGCCGCCGGGATAG,22,1155202
fldAp,7.0,22,2,AATTGCAAACTCCGCGGGAG,20,1142509
fldAp,7.333333333333333,23,2,AATTCCTCGTTCAAGCGAAA,21,1096764
fldAp,2.3333333333333335,8,2,AATGGTCGATACCTGAGAGA,6,1126560
fldAp,7.666666666666667,24,2,AATGACACAGCGCGGACGGA,22,1111364
fldAp,2.3333333333333335,8,2,AATCGTGCCGCTTCCCTCGG,6,1171986
fldAp,12.0,37,2,AATCGGGTGTACACTCGTTC,35,1080467
fldAp,14.0,43,2,AATCATGAAATCCTACAGTT,41,1081931
fldAp,44.333333333333336,134,2,AATCAAAAACGGCAACGAAA,132,1107684
fldAp,10.333333333333334,32,2,AATATCCAGTAACCCAGACA,30,1137828
fldAp,22.0,67,2,AATATAGAGCAACCGATATG,65,1092472
fldAp,11.0,34,2,AATAGAGGACTGTGCTATTA,32,1071746
fldAp,0.6666666666666666,3,2,AATACAACCTCCTATCCGGT,1,1131655
fldAp,22.666666666666668,69,2,AAGTGTTACCTGGTGCCTCT,67,1092309
fldAp,3.0,10,2,AAGTAGAAGTACGCAAACGA,8,1161436
fldAp,7.666666666666667,24,2,AAGGCCTTTATGGGTCCCCC,22,1157012
fldAp,8.666666666666666,27,2,AAGAAGTGAATAGTTTCTGT,25,1132008
fldAp,16.0,49,2,AACTTGGTTTGAACCCCATC,47,1074366
fldAp,6.333333333333333,20,2,AACTCGAGTGGCCGTGATAC,18,1067393
fldAp,41.333333333333336,125,2,AACGGTCCCTAATCTCAGGG,123,1077539
fldAp,34.333333333333336,104,2,AACGCGGATTAAGGCTAGTA,102,1177946
fldAp,9.666666666666666,30,2,AAATGAACGCTCACAGCGGA,28,1177589
fldAp,0.6666666666666666,3,2,AAATCAAGGTCCATCTACGA,1,1137148
fldAp,18.0,55,2,AAAGACGGAGGTCTCCAGAA,53,1174880
fldAp,3.0,10,2,AAAGAACTTCCTTTTTCCTT,8,1087237
fldAp,6.0,19,2,AAACCGCTCCGAGCCAATAA,17,1076091
fldAp,32.0,97,2,AAACCCCCGTGCGCCCTGTC,95,1141536
fldAp,4.333333333333333,14,2,AAACACATCGAATCGCAACT,12,1065875
fldAp,9.5,19,1,TTTTGGTAGGCTCGACTACT,18,1082309
fldAp,64.5,129,1,TTTGTGCTATGTCCACTTAA,128,1135689
fldAp,7.0,14,1,TTTGGATTGCTTTCTAACGA,13,1137539
fldAp,15.0,30,1,TTTGCAGCAGTAGTATGAAG,29,1156780
fldAp,16.5,33,1,TTTGAAATTGAAACTAATGG,32,1124609
fldAp,15.0,30,1,TTTGAAATCCTATAACTGTC,29,1090064
fldAp,37.5,75,1,TTTCTTAGGGCCGGAATATC,74,1123296
fldAp,15.0,30,1,TTTAACCATTACCGGACCAA,29,1178584
fldAp,19.0,38,1,TTGTCACATGCACTCGTTTA,37,1079706
fldAp,17.5,35,1,TTGTATGGTACACCGTAGCC,34,1064789
fldAp,1.0,2,1,TTGGTTCACCAGTTCCCCGG,1,1172862
fldAp,15.0,30,1,TTGGGCTGAAACTGTGCCAA,29,1101014
fldAp,15.0,30,1,TTGGCGTTCGGGTTACGTTC,29,1072976
fldAp,1.0,2,1,TTGGCGTGTTTGCTTTACTG,1,1136096
fldAp,22.5,45,1,TTGCTGGCCGCGAATGTAGT,44,1065348
fldAp,16.0,32,1,TTGCGATCTGGTTGAGTAAA,31,1113308
fldAp,1.5,3,1,TTGCCTGGGTTTGATTAGGA,2,1134315
fldAp,8.5,17,1,TTGCCTCCGTACTAGATTAG,16,1126256
fldAp,15.0,30,1,TTGACTCTGATCCCTTTCTT,29,1160412
fldAp,37.5,75,1,TTGACTCCACGGGATAGCTT,74,1181755
fldAp,30.0,60,1,TTGACCCAGTTCAGGACGCC,59,1139677
fldAp,13.5,27,1,TTGACATGTTATAGCATCGC,26,1102762
fldAp,18.5,37,1,TTCGTATATCACGTTCTATT,36,1088318
fldAp,9.0,18,1,TTCGACAGGCGGTTTATAAG,17,1151878
fldAp,8.5,17,1,TTCCTAACCTGAAGTCTTGA,16,1063014
fldAp,2.5,5,1,TTCCGTTTGGGCGATATAGT,4,1078109
fldAp,14.5,29,1,TTCCCGTTTTTATTCCATAT,28,1162543
fldAp,14.0,28,1,TTCATGTGCTCCGGGCTCCA,27,1141055
fldAp,123.5,247,1,TTCATCACGCAGAATGATGA,246,1107683
fldAp,3.5,7,1,TTCAGTGGGGATAAAGAGAA,6,1103093
fldAp,14.5,29,1,TTCAGGGCTTGGGCAACATA,28,1071134
fldAp,16.0,32,1,TTCAGCACCTCGCTGTAGCT,31,1162257
fldAp,13.0,26,1,TTATAGCAAAGATCTGGCCA,25,1173232
fldAp,12.0,24,1,TTAGTGACTGTCAGGCATAC,23,1171974
fldAp,10.0,20,1,TTACGTCGCTCTATTGGCTA,19,1181592
fldAp,12.5,25,1,TTACGTCCTTGTTAAATTTT,24,1159678
fldAp,1.0,2,1,TTAATGGCTTACTTATTTTA,1,1136726
fldAp,1.5,3,1,TTAACAGTGATTTTCTTTGG,2,1124486
fldAp,1.0,2,1,TTAAAGCCCAGAGAGGGTAG,1,1095542
fldAp,7.5,15,1,TGTTTACTGTGGTATCATTC,14,1118681
fldAp,48.5,97,1,TGTTCTGTTATAGGGTTTCA,96,1162387
fldAp,12.5,25,1,TGTGCTACTTCTAGTAGCGT,24,1174592
fldAp,15.0,30,1,TGTGACTGCTTTTGGCACCA,29,1166357
fldAp,13.5,27,1,TGTCGGCCCAAGTTCCACGC,26,1122877
fldAp,1.0,2,1,TGTCAGAGCCACGACACAAC,1,1127951
fldAp,10.5,21,1,TGTATTACCGCCGGCCGGTT,20,1081953
fldAp,1.0,2,1,TGTAGAAGGTGATAACCATC,1,1185237
fldAp,3.5,7,1,TGTACCTAATTGTTCTCCTA,6,1152554
fldAp,1.0,2,1,TGTAAGTTTCCTTACAGAGC,1,1166287
fldAp,3.0,6,1,TGGGCTATATTCCCGACCTG,5,1119887
fldAp,1.0,2,1,TGGCTTTTTAGTATATAACC,1,1129930
fldAp,11.0,22,1,TGGACGTCCTGCTCAAACCC,21,1159241
fldAp,1.0,2,1,TGCTGAATGTACAGGGACAT,1,1104268
fldAp,9.5,19,1,TGCTCTTGTCATGACGCAAG,18,1130754
fldAp,14.0,28,1,TGCTACTAGCGCCCTGACTG,27,1082688
fldAp,30.5,61,1,TGCTACAGTGCAAATAACGT,60,1173908
fldAp,5.0,10,1,TGCTAAATCGATGACGTAAC,9,1153127
fldAp,25.0,50,1,TGCGGTCGTACGTACAGTTT,49,1118332
fldAp,4.5,9,1,TGCGATCTGTTCCGACAGAT,8,1174218
fldAp,15.0,30,1,TGCGAGTATCGTACAGTTAT,29,1128108
fldAp,4.0,8,1,TGCCGAGTGCGGGGAACGTG,7,1078101
fldAp,11.0,22,1,TGCCCTGGGGACAACAGCAA,21,1106268
fldAp,9.5,19,1,TGCCACAGTTGGCACCCGTT,18,1092889
fldAp,25.0,50,1,TGCATTGTGGCGACTATAAT,49,1146160
fldAp,8.0,16,1,TGCAGCCCTCACTTTCCTAG,15,1150052
fldAp,14.0,28,1,TGCACTCGAACTCCAACGCA,27,1085450
fldAp,9.0,18,1,TGCAACTTCTACCGCAATTA,17,1137792
fldAp,1.0,2,1,TGATTTCGGATGAAACAACC,1,1147585
fldAp,12.0,24,1,TGATGGCACGTATTGCGACG,23,1133530
fldAp,14.5,29,1,TGATGATTGATGGGGCTGTT,28,1146664
fldAp,1.0,2,1,TGAGTGTGCGATATGGGGGT,1,1167798
fldAp,11.5,23,1,TGAGTCGATTACTTTATTCC,22,1094741
fldAp,41.5,83,1,TGAGAGTTTAGCAGTTAATT,82,1076144
fldAp,7.0,14,1,TGAGAGGAATCTCCATTGGT,13,1161380
fldAp,15.5,31,1,TGACTTGCGGAACGATCGAC,30,1179894
fldAp,12.0,24,1,TGACTCAGCAAGTGGCCCGT,23,1164032
fldAp,1.0,2,1,TCTTTTACAGGTGTGGGCGC,1,1096640
fldAp,18.5,37,1,TCTTGTCACTATTAGAGACA,36,1139709
fldAp,6.5,13,1,TCTTCATCTGGCAACTCCCG,12,1184386
fldAp,12.0,24,1,TCTTACAAGACTCTCCTATA,23,1113969
fldAp,14.0,28,1,TCTCGAATGTATACCGTCGC,27,1162652
fldAp,1.5,3,1,TCTCAAACCGCGTGCGCAAA,2,1096952
fldAp,17.0,34,1,TCTAGGACCAAGTTTCAGTA,33,1159574
fldAp,12.5,25,1,TCGTGGTAATATTAAGTCCC,24,1169543
fldAp,13.0,26,1,TCGGTGCGGACAGGAAGTAT,25,1100873
fldAp,12.5,25,1,TCGGCCTTCTTCCGGAGGTA,24,1169026
fldAp,16.0,32,1,TCGCAGGTTGTCAGACACAT,31,1178566
fldAp,6.5,13,1,TCGACGTCATGCCGTTCCTG,12,1076416
fldAp,18.0,36,1,TCGAAAGATCTGCGAATGGT,35,1073125
fldAp,10.0,20,1,TCCTGCGCGTGCCTCACGTG,19,1124141
fldAp,18.5,37,1,TCCTCTTTTGATGGCCCCGC,36,1169916
fldAp,13.0,26,1,TCCTATTACGGACTCAGGTA,25,1128289
fldAp,9.5,19,1,TCCGTAGTTGTGTTTAGCGG,18,1180553
fldAp,12.0,24,1,TCCGTACCGATAGTAAAAGT,23,1077948
fldAp,13.5,27,1,TCCGGGGGATGATCTATAGG,26,1066009
fldAp,33.5,67,1,TCCGCGAGAGGCCCAAGCTT,66,1126576
fldAp,17.5,35,1,TCCGCATCAGAGTGAGAGGA,34,1090347
fldAp,4.5,9,1,TCCAGGTAAGTCGTCATACT,8,1126131
fldAp,14.5,29,1,TCCAGCTGTTTTAGGTCCCA,28,1147488
fldAp,1.0,2,1,TCCAGCGTGCGTTTTCTGCC,1,1114769
fldAp,1.0,2,1,TCCACCTGTGCCCGGGGGGA,1,1074445
fldAp,17.5,35,1,TCATTTTCGCGGGTGGGTGT,34,1099840
fldAp,29.5,59,1,TCATCCGTGAACTTAAAAGG,58,1116149
fldAp,16.5,33,1,TCAGTGAATATATTTCGGTG,32,1178133
fldAp,10.5,21,1,TCACGGTATTTTTCTATTCT,20,1158228
fldAp,2.5,5,1,TCACGAGTAATTGTAAATTG,4,1082002
fldAp,13.0,26,1,TCACGAGAACAATTACTATC,25,1185511
fldAp,1.0,2,1,TCACCCGATTCACTGTGAGC,1,1120053
fldAp,33.5,67,1,TCACAGCCGACCGTCTAGCA,66,1121069
fldAp,31.5,63,1,TCAACGATACACAGGGAGCG,62,1082649
fldAp,14.0,28,1,TATTTTTATAATCCGAATCG,27,1110831
fldAp,20.5,41,1,TATTTGCTAAAGCAGATATG,40,1128130
fldAp,12.5,25,1,TATTGCGTAGATGGAGCCTT,24,1106537
fldAp,11.0,22,1,TATTGCACGGTTAATTTATC,21,1115417
fldAp,8.0,16,1,TATTCATGTAATGGACGGCG,15,1186642
fldAp,14.0,28,1,TATTAGGGGATCTGACGAAT,27,1139157
fldAp,1.0,2,1,TATAGCTTTTCCTTCACACT,1,1152522
fldAp,14.0,28,1,TATAGCTTTGTAACTACAAT,27,1147039
fldAp,12.5,25,1,TATAGCATTCGGGAAGCAAG,24,1173859
fldAp,11.5,23,1,TATAGACAAACGGCTTGTGT,22,1120477
fldAp,9.5,19,1,TATAAGATACACGATGTTAT,18,1185005
fldAp,19.5,39,1,TAGTAACGATGGTTGTTAAG,38,1080298
fldAp,19.0,38,1,TAGGGCGCGCTGCTTCCCAT,37,1094042
fldAp,7.0,14,1,TAGGGAGGTCCTCCAGGCGT,13,1152416
fldAp,12.5,25,1,TAGGGAAGGGGGCAGTCGCG,24,1156437
fldAp,6.5,13,1,TAGGGAACAAGAAATCTGTT,12,1154317
fldAp,11.0,22,1,TAGGCTAATATAGGAGTAGC,21,1080671
fldAp,11.5,23,1,TAGGCGGATAAAGGGACGGT,22,1112605
fldAp,14.0,28,1,TAGGAAGCCCTATGACTTTA,27,1104312
fldAp,16.0,32,1,TAGGAACAGTCGGCAAGTGC,31,1119723
fldAp,12.5,25,1,TAGGAAATCTCGCGAAAACG,24,1135542
fldAp,16.0,32,1,TAGCGCGTGGTAGATGTACA,31,1137402
fldAp,3.0,6,1,TAGCCCGGTCAGTGTTTAGT,5,1064330
fldAp,19.5,39,1,TAGAGTCATAGGATTGGTGA,38,1087625
fldAp,1.0,2,1,TAGACTCGAAGTGGCCCACG,1,1083520
fldAp,22.5,45,1,TACTTTGCGCTACACGGAAA,44,1063871
fldAp,6.5,13,1,TACTTTGCGCGTCGCGCCTC,12,1162822
fldAp,13.0,26,1,TACGGTGTTACTGGACCCGT,25,1150737
fldAp,17.5,35,1,TACCGTTATCCGCACAGTCC,34,1155604
fldAp,1.5,3,1,TACAGCTTTCAATACGTCTG,2,1150703
fldAp,1.0,2,1,TACAAGGGGTTGAAGCTAAG,1,1143296
fldAp,17.5,35,1,TAATTCTTCCCGGGACATAT,34,1073758
fldAp,9.0,18,1,TAATTCTGCAAGGCCTCGAT,17,1134836
fldAp,21.5,43,1,TAATCGCTGCCGCCGAGTTA,42,1174340
fldAp,9.5,19,1,TAATCGCGACATCTATTCAA,18,1099569
fldAp,4.0,8,1,TAATAGCTGATAACCTCCAT,7,1150962
fldAp,8.5,17,1,TAAGTTGTGGCAAATCATAT,16,1087927
fldAp,5.5,11,1,TAAGCGGTACCCAACCGACA,10,1101111
fldAp,8.5,17,1,TAAGCGGAGCGCAGGCGAAA,16,1167208
fldAp,11.0,22,1,TAAGATTAGCGGAGTGATTC,21,1157791
fldAp,8.5,17,1,TAAGAGCTAGGTGAAGGAGA,16,1114963
fldAp,1.0,2,1,TAACGGTGGGGTGAGTGCGT,1,1105937
fldAp,27.0,54,1,TAACCGGGCCAATCTTCAAC,53,1137387
fldAp,15.0,30,1,TAAAAACCGTCCACGCATCG,29,1113959
fldAp,15.0,30,1,GTTTTCGGTTACTTGGCGCG,29,1184142
fldAp,37.5,75,1,GTTTTCACCGGTGTCCATGC,74,1174578
fldAp,60.5,121,1,GTTTCGCGGTCGTCGTCTAT,120,1154306
fldAp,2.5,5,1,GTTGTTAACAATTTCAGACG,4,1169689
fldAp,1.5,3,1,GTTGGGCAACGGATGAATTT,2,1167283
fldAp,10.0,20,1,GTTCGCTCACCCCATCTCTG,19,1065053
fldAp,1.0,2,1,GTTCCGAAGACTATCTTGGC,1,1113651
fldAp,6.5,13,1,GTTCCCGAGATGGGTCGCGA,12,1104765
fldAp,13.0,26,1,GTTCCATCGGTGAAATTGAG,25,1075541
fldAp,3.0,6,1,GTTCATGCCCGGCGACGAGG,5,1124277
fldAp,14.5,29,1,GTTACGATTATACGTGTTGG,28,1105079
fldAp,12.0,24,1,GTGTGGCAAAGTTCAAACGT,23,1166668
fldAp,12.5,25,1,GTGTGACCAATCGCATTAGC,24,1153594
fldAp,22.0,44,1,GTGTGAAAGTTCGTGTGCCC,43,1145765
fldAp,14.5,29,1,GTGGGTCTAGGCTAAGTGCT,28,1077553
fldAp,5.5,11,1,GTGCTTGCCTCATTGGGAGG,10,1135501
fldAp,4.5,9,1,GTGACCTGCTCCGGTCAGGG,8,1160820
fldAp,12.5,25,1,GTGACCTGCCTCAACTCTGT,24,1139163
fldAp,1.0,2,1,GTGACATTTAGCCCAGGGCA,1,1110685
fldAp,1.0,2,1,GTCTTGACCTAAATCTCGAG,1,1106576
fldAp,70.5,141,1,GTCTGTGTGGGAAACCGATA,140,1107660
fldAp,14.0,28,1,GTCTATGGAGTTGCGACCTC,27,1065622
fldAp,1.0,2,1,GTCTATCTACGTCATGCGAG,1,1146550
fldAp,18.0,36,1,GTCTAGGCTGTTGTGCAACT,35,1091521
fldAp,14.5,29,1,GTCGGCGTGGCGTTAGTTCT,28,1097699
fldAp,10.5,21,1,GTCGATACTCCTCTTTATGA,20,1070310
fldAp,16.0,32,1,GTCCGTACGTTTCGACGCCA,31,1129939
fldAp,13.0,26,1,GTCCGAGGCCTTCTACCGGG,25,1139497
fldAp,11.0,22,1,GTCAGATGGTGTTCATTAAG,21,1185461
fldAp,16.5,33,1,GTCACCAAGAATACTGACAA,32,1079220
fldAp,10.5,21,1,GTCAAAGGATTAACGAGTAC,20,1124353
fldAp,8.0,16,1,GTATTGCAACTTGTAATTGG,15,1159281
fldAp,16.5,33,1,GTATGTCACTTAGACTTTTG,32,1072310
fldAp,15.0,30,1,GTATGAGCCCGCGATCCCTG,29,1074968
fldAp,14.0,28,1,GTAGTTCCTAGGCCGGACGC,27,1114947
fldAp,14.5,29,1,GTAGGCCTTATGTGTATGCT,28,1088162
fldAp,21.0,42,1,GTAGACATTAGGTCGTATCA,41,1076542
fldAp,1.0,2,1,GTAGAAATCGACTCAGGAGC,1,1138059
fldAp,30.0,60,1,GTACGGTGTGCAATAAGCCT,59,1151217
fldAp,10.5,21,1,GTAATATGGAAAATCCGGCT,20,1161764
fldAp,23.0,46,1,GTAATATCCCAGGAGCCGCT,45,1120439
fldAp,17.5,35,1,GTAAACGTCGGCGGGGTTAG,34,1118778
fldAp,17.0,34,1,GGTTTCAGTGCCTTCGTTGG,33,1133687
fldAp,8.5,17,1,GGTTAGGCCTCTGGTCATAG,16,1094039
fldAp,9.5,19,1,GGTTAACAAAGTGCATTTAT,18,1143759
fldAp,1.0,2,1,GGTTAAATGTGGCATCCAAT,1,1141056
fldAp,19.0,38,1,GGTGCGCCTGGAGAACGGCG,37,1119151
fldAp,1.5,3,1,GGTGCCCAATATAGGGCTCT,2,1082857
fldAp,3.5,7,1,GGTGAGCAGCCGTTGTGCTG,6,1133572
fldAp,35.5,71,1,GGTCTTTCACGAACGATATT,70,1157016
fldAp,7.0,14,1,GGTATGCTTATAGGCCAGCC,13,1100720
fldAp,17.0,34,1,GGTAATGACAGCGTCGTCAT,33,1161152
fldAp,5.0,10,1,GGGTACATCGGATAGAGTTC,9,1122651
fldAp,8.0,16,1,GGGGGCAAGATTAGAGACAT,15,1108068
fldAp,1.0,2,1,GGGGGATTGGAACGACCACC,1,1092303
fldAp,11.0,22,1,GGGGCTTATATTTTAAACAT,21,1145094
fldAp,11.5,23,1,GGGGAAGAGCATAAATTCGA,22,1185456
fldAp,1.0,2,1,GGGCGTGGATAACCCCATGA,1,1071237
fldAp,93.5,187,1,GGGCGTAATGGCAACTTTGA,186,1135678
fldAp,10.5,21,1,GGGACTGGACTGCAGAGTGC,20,1177805
fldAp,1.0,2,1,GGGAATGTGTTTGGATCGTA,1,1158638
fldAp,3.5,7,1,GGCTGGCCTTGGACGAGCCG,6,1130998
fldAp,10.0,20,1,GGCTCGCAAAGTCCATGATC,19,1068975
fldAp,30.5,61,1,GGCTCCCAGATGGATTATAA,60,1176941
fldAp,1.0,2,1,GGCTCAGATGGACTTAATGG,1,1142221
fldAp,9.0,18,1,GGCTACAGTTCCGGTTGCTT,17,1103426
fldAp,1.0,2,1,GGCGGAAACCGGATGTAACA,1,1077075
fldAp,1.5,3,1,GGCGACCAGCAGGCTCCCTC,2,1063974
fldAp,57.5,115,1,GGCCCTATGTTAAAGACCGT,114,1082644
fldAp,26.0,52,1,GGCCATTCAAAGATTTCTTA,51,1066032
fldAp,14.0,28,1,GGCCATAGGTGCGGCGGCTA,27,1138856
fldAp,8.0,16,1,GGCAATGCCACACGCGGGGA,15,1137060
fldAp,23.0,46,1,GGATTAACAGTTAGTGGGCA,45,1083910
fldAp,27.5,55,1,GGATAGTTAGTGTGCGATTT,54,1185251
fldAp,51.5,103,1,GGATAATCATGGTTCCACCT,102,1119167
fldAp,6.0,12,1,GGAGGTTATAGGACATAGTC,11,1183776
fldAp,10.5,21,1,GGAGGGTCGGGGGGGGTACG,20,1181701
fldAp,10.5,21,1,GGAGATCCGACACTATCCTC,20,1137498
fldAp,10.5,21,1,GGACTGGATCTGTCGGCAAT,20,1109308
fldAp,18.0,36,1,GGACGTGACAGCATGCTGAT,35,1071395
fldAp,18.0,36,1,GGAACAGGGGAATAACTGCC,35,1089432
fldAp,3.5,7,1,GCTTGGTAATTAGACCCTCC,6,1082599
fldAp,8.5,17,1,GCTTGGCTGGGCTCGTTGTT,16,1136341
fldAp,9.0,18,1,GCTTAAACTGACCTGACGGT,17,1174068
fldAp,1.0,2,1,GCTGTTGCTTTACCCAGGTC,1,1132312
fldAp,1.5,3,1,GCTCTTTTCGCTAACCAGAC,2,1117264
fldAp,23.0,46,1,GCTCTTGATGTGTAGGGGGC,45,1077278
fldAp,70.0,140,1,GCTCGTTATTAATGAGGGAG,139,1135671
fldAp,7.5,15,1,GCTCGCAGTCGCCCATAGCC,14,1102014
fldAp,26.5,53,1,GCTCGATACGACCCTTTGAG,52,1068093
fldAp,14.0,28,1,GCGTGCAGTCCTTACCTCCT,27,1139473
fldAp,18.0,36,1,GCGGTGGATCCGGATCACTC,35,1120533
fldAp,16.0,32,1,GCGGTACTAGGAGGGAAGCC,31,1135887
fldAp,28.0,56,1,GCGGGCACAGTCATCCGAAC,55,1128929
fldAp,12.5,25,1,GCGCGTCCCCGACCAGTGTC,24,1167045
fldAp,9.5,19,1,GCGCACAGAATTCGGTGTGG,18,1073001
fldAp,4.0,8,1,GCCTCTAAGGGCGAACCGTG,7,1145177
fldAp,6.5,13,1,GCCTCCCCTGTTAGGGAGAA,12,1082248
fldAp,8.0,16,1,GCCTACCGGGGAAGGGTAGT,15,1093313
fldAp,16.5,33,1,GCCGTAAGCGTACCGGGGAG,32,1173381
fldAp,11.5,23,1,GCCGGGTAGGGCTGCGGCTC,22,1177651
fldAp,10.0,20,1,GCCGCCTGTGGCTGGATAAA,19,1123584
fldAp,5.5,11,1,GCCGCCGGCACGGCCTCTTT,10,1092373
fldAp,1.0,2,1,GCCGCAGCGGGTAATCACAT,1,1128588
fldAp,11.5,23,1,GCCGATAACGTGTGTCTAAA,22,1135879
fldAp,13.5,27,1,GCCCCAACGCAATACAGGGG,26,1095525
fldAp,14.5,29,1,GCCAGGCAAGGCTTTTCAGT,28,1075010
fldAp,1.0,2,1,GCCACTTCTGGAGAATGTTG,1,1173495
fldAp,22.5,45,1,GCCACAGTTGACGCATTTAA,44,1111277
fldAp,11.0,22,1,GCCAACTTTAGTGTCCTATG,21,1064089
fldAp,19.0,38,1,GCATTGCAATGCCGAAGTCT,37,1103303
fldAp,13.5,27,1,GCATGGACCCCATCGCTTGT,26,1128307
fldAp,6.5,13,1,GCAGATGTGGTCGTTGACAT,12,1125308
fldAp,1.0,2,1,GCAGATCGAAAATCGACACC,1,1143299
fldAp,10.0,20,1,GCACGTTGTGTTATTATAGA,19,1088198
fldAp,15.0,30,1,GCACGCCTAGAGGTGATGTC,29,1098929
fldAp,25.5,51,1,GCACGACCCAGAATGTTTGA,50,1109641
fldAp,19.0,38,1,GCACCACCTCGGGGAACTAT,37,1111852
fldAp,9.5,19,1,GCAAGTCCAATTTACAAACA,18,1067501
fldAp,7.5,15,1,GCAAGGGGGGATGCACTCGC,14,1101298
fldAp,6.5,13,1,GATTCGGTGAACGCCCGTTG,12,1149891
fldAp,65.5,131,1,GATGTTTGCCAAGTCCGATC,130,1186631
fldAp,1.0,2,1,GATGTGGGTCTTCAATGCCT,1,1095158
fldAp,8.5,17,1,GATGTCATGTAAAAGCTAGG,16,1158831
fldAp,15.5,31,1,GATCTGGCCAGGGATTTGCA,30,1073634
fldAp,1.0,2,1,GATCCCCGAGGATAGGTCTT,1,1108986
fldAp,12.5,25,1,GATCATTGCAATTCGAACTC,24,1068047
fldAp,13.5,27,1,GATCATCGGCAATATTTTAT,26,1131831
fldAp,5.0,10,1,GATATCGATACAGAGCCCCA,9,1161218
fldAp,6.5,13,1,GAGTTTCCTTGAGTCTCGTC,12,1075736
fldAp,3.5,7,1,GAGGTAGTTACAGGCAATCA,6,1178661
fldAp,7.0,14,1,GAGGGCCTCACATCGTGCCG,13,1173330
fldAp,13.5,27,1,GAGGACCAGGGTGGTATCGC,26,1185558
fldAp,15.0,30,1,GAGCCAAGCTTCCGCCAAGG,29,1063683
fldAp,2.5,5,1,GACTGCGAGGCGATATACAA,4,1108279
fldAp,11.5,23,1,GACGCGCTGTGTGGTAATTG,22,1143307
fldAp,9.0,18,1,GACGATCCAGGTTATCGACA,17,1119316
fldAp,12.0,24,1,GACGAGTTTCCTTGTGAATG,23,1169690
fldAp,12.5,25,1,GACCTTCGGAAAGTAACGGG,24,1089398
fldAp,3.5,7,1,GACAGGGTCGCGCAGATTTC,6,1095376
fldAp,39.5,79,1,GAATGTGCCTCATCGAAACC,78,1133946
fldAp,1.0,2,1,GAATCACTTTAGCCTGGAAA,1,1116015
fldAp,14.0,28,1,GAATATCCAGGGCAGCGGCC,27,1064206
fldAp,1.0,2,1,GAATAGCCTTTGCTCTCTGA,1,1158859
fldAp,12.5,25,1,GAAGAAAGTGATTCTATTGT,24,1169921
fldAp,22.0,44,1,GAACTGCGTCGCGCCAATGA,43,1169174
fldAp,12.5,25,1,GAACTCCGAGGTATTGTAAA,24,1090130
fldAp,5.0,10,1,GAACCTTTTATATAATGTAA,9,1161651
fldAp,12.5,25,1,GAAATGCCAGCGGCGGATTA,24,1081370
fldAp,24.0,48,1,GAAAGCAATGGCTCGAATTA,47,1150671
fldAp,12.0,24,1,GAAACATCCTCGACAAGCCC,23,1145839
fldAp,22.0,44,1,CTTTCAATAATTTCCGCTCG,43,1143654
fldAp,15.5,31,1,CTTTACTGATGGACCTTGGT,30,1131009
fldAp,27.0,54,1,CTTGTTATACAGGCTATACT,53,1088147
fldAp,14.0,28,1,CTTGCAGATACGTCACATTG,27,1152409
fldAp,1.0,2,1,CTTGACGGGCTCGCTCTCTC,1,1152067
fldAp,15.5,31,1,CTTGACGCTGGCGAAACTGA,30,1175146
fldAp,28.0,56,1,CTTGAAAAAGTGTATCTAGT,55,1065235
fldAp,23.0,46,1,CTTCTGGTTGTCATAGGTTC,45,1063635
fldAp,13.5,27,1,CTTCTAGAGATCACGTACTC,26,1186919
fldAp,16.5,33,1,CTTCAATGGAACAGTGAAGC,32,1168630
fldAp,1.0,2,1,CTTCAACTATACTAACCCGC,1,1153009
fldAp,1.0,2,1,CTTCAACGGTCCGCAATCAG,1,1130725
fldAp,1.0,2,1,CTTAGTTCTTTGCGTTAGAA,1,1149531
fldAp,1.0,2,1,CTTAAAACCCGATGTTAGCA,1,1094201
fldAp,1.0,2,1,CTGTTCGTGCCTGCAATATG,1,1076165
fldAp,7.5,15,1,CTGTGTCTCTTCCTCCCGGA,14,1159978
fldAp,12.0,24,1,CTGTGCCTTACTAGCATGGG,23,1109081
fldAp,44.5,89,1,CTGTCGGAAATGCATATAAG,88,1111160
fldAp,1.5,3,1,CTGTCACGCCGATCACGGTT,2,1167782
fldAp,8.5,17,1,CTGTAATTCTAACAAACGTT,16,1135714
fldAp,22.0,44,1,CTGGCGCGTAGAGTGCATGC,43,1093618
fldAp,15.5,31,1,CTGCAGAACTACGTGGTGAT,30,1101242
fldAp,72.0,144,1,CTGATTGTAATACTGTATCT,143,1118377
fldAp,6.5,13,1,CTCTGGATGTTTGTGCCCCT,12,1181046
fldAp,41.5,83,1,CTCTGAGACGTGAGCCACAA,82,1113804
fldAp,1.0,2,1,CTCTATGAACAGTCATAAAA,1,1183536
fldAp,1.0,2,1,CTCCTTTTATCTGTCGCCGT,1,1169367
fldAp,23.0,46,1,CTCCTAGCATGGACTATTTT,45,1082609
fldAp,18.0,36,1,CTCCGCAGTTGTCTTATCAA,35,1125792
fldAp,7.5,15,1,CTCCACCATAGGAGTCCCCC,14,1182193
fldAp,6.0,12,1,CTCATCATTTCCTTCGTAGG,11,1174600
fldAp,8.5,17,1,CTCAGAAGAGTTAGTCGCCA,16,1153438
fldAp,1.0,2,1,CTCAAATAAAGAGGTGGGCA,1,1133502
fldAp,19.5,39,1,CTATAGGTCCAGAATCCAAT,38,1079739
fldAp,9.5,19,1,CTATACGAGAGGCGCCTACC,18,1113261
fldAp,1.0,2,1,CTAGATGCATGATGAATTTT,1,1091183
fldAp,24.5,49,1,CTAGATAAATTACGGGGACG,48,1108521
fldAp,9.0,18,1,CTAGAGTTTTGTACTTAGAA,17,1108059
fldAp,1.0,2,1,CTACTACGGACCCGGTTCAC,1,1116624
fldAp,21.0,42,1,CTACGACGCAACTTTTCACA,41,1112356
fldAp,12.0,24,1,CTACCTCTTGCTTCCGGGAT,23,1154964
fldAp,2.5,5,1,CTACATGAGGCACATGGCTA,4,1147049
fldAp,9.0,18,1,CTACAGTGACATCCTCGCCT,17,1092736
fldAp,17.0,34,1,CTACAACTGAAGGTTTCGCA,33,1093374
fldAp,25.0,50,1,CTAAGGTTACGGGGTTGGGC,49,1138071
fldAp,8.5,17,1,CGTTTGTTGCTGATGTCTAT,16,1146229
fldAp,1.0,2,1,CGTTCTTATTTGCCCAATGG,1,1063970
fldAp,19.5,39,1,CGTTACTGAACCCTAATAAT,38,1112870
fldAp,23.0,46,1,CGTGTAGTCACAAAGCAAGT,45,1147043
fldAp,19.5,39,1,CGTGGAGACCCCGTTGTAAA,38,1102865
fldAp,15.0,30,1,CGTCGGTTCGAATCCTTTAC,29,1179993
fldAp,50.0,100,1,CGTCCCATATCTGGGTAATT,99,1146172
fldAp,19.0,38,1,CGTCCCACCGCGCTGTGTTA,37,1177811
fldAp,12.5,25,1,CGTATCATACTCGCATCTCG,24,1111167
fldAp,21.0,42,1,CGTAGAACAACAAGTTACTT,41,1081066
fldAp,1.0,2,1,CGTAAACCGTCATTCCACAA,1,1069526
fldAp,10.0,20,1,CGGTGCAGCTGTGTGGGAGA,19,1130418
fldAp,24.0,48,1,CGGTCCGTACTGGTTGGGGT,47,1167581
fldAp,4.5,9,1,CGGTAATTTTTTATCTATAT,8,1064583
fldAp,9.5,19,1,CGGGGTTGGTAAGTTGAAAT,18,1156047
fldAp,8.5,17,1,CGGCCTCTTGGAAAGTCGGA,16,1111259
fldAp,11.5,23,1,CGGCACACTGTTTCACAGGA,22,1076660
fldAp,8.0,16,1,CGGAGATGCCTTAGGTCCCC,15,1084416
fldAp,12.5,25,1,CGGAATTTTTGTTCTAACAT,24,1076596
fldAp,1.0,2,1,CGCTTGAGTATTCAAGGCTA,1,1111191
fldAp,9.5,19,1,CGCTATCACATGAACATTTT,18,1088713
fldAp,20.0,40,1,CGCGAGGGATCTATTAGAAC,39,1082861
fldAp,1.0,2,1,CGCCTTTAATTCAAGGCCAC,1,1119074
fldAp,11.0,22,1,CGCCACGCCCATCTATAATT,21,1161976
fldAp,16.5,33,1,CGATGTTCTTGATAGCGCCC,32,1083530
fldAp,1.0,2,1,CGATCTTCTTTCATTTCCGG,1,1106437
fldAp,10.0,20,1,CGATCAAGTACCTAGCATAT,19,1098827
fldAp,40.5,81,1,CGAGCTCTGCTCCCTCGACC,80,1147687
fldAp,8.0,16,1,CGACTGCTAGGCAGGCGTAA,15,1102194
fldAp,16.5,33,1,CGACTGCACCCCGCTCTGTC,32,1105074
fldAp,30.5,61,1,CGACCTGGGTTATAGGGATA,60,1171673
fldAp,1.0,2,1,CGACCGACTACAAGAAGCAG,1,1177549
fldAp,14.5,29,1,CGACATCTAGCAGATTGTCC,28,1080437
fldAp,1.0,2,1,CGAATTTGATGCCTTTACCC,1,1159120
fldAp,14.5,29,1,CGAACTGCATGTTGCGGGCA,28,1184751
fldAp,12.0,24,1,CCTTCCACAACCACGCGCCC,23,1081756
fldAp,15.0,30,1,CCTTATCTGGCCATAGGTGC,29,1089309
fldAp,15.5,31,1,CCTGTGTTATTACGTTTGAC,30,1157533
fldAp,10.5,21,1,CCTGGTCGGTGGACGGCTGG,20,1166663
fldAp,35.0,70,1,CCTGGAGTTTCCAGAAATTA,69,1111341
fldAp,1.5,3,1,CCTGCGCGCGTACCGCCCTG,2,1150868
fldAp,1.0,2,1,CCTGATGTACCAACACGCTC,1,1064455
fldAp,25.0,50,1,CCTGAGCCGAATGGATGCTA,49,1146178
fldAp,1.0,2,1,CCTGACTATAAGCTTAAAGG,1,1063966
fldAp,2.0,4,1,CCTGAATTGTCTCCCCTTCC,3,1076539
fldAp,14.5,29,1,CCTCGCTTGTCACCTCTATG,28,1117883
fldAp,11.5,23,1,CCTATGATGCGCGTTTAAGT,22,1139629
fldAp,12.5,25,1,CCTACGCTGTACGTTACAAG,24,1162666
fldAp,30.5,61,1,CCTACAACTTCAGCCATGTG,60,1077137
fldAp,13.5,27,1,CCTAAAGCGTCGGCCAGCTG,26,1171036
fldAp,8.0,16,1,CCGGTCCACGCCATCTGTGA,15,1085038
fldAp,6.5,13,1,CCGGGGCATTGAAAGCTTGG,12,1134511
fldAp,19.5,39,1,CCGGAGAAGTTTCATGTGAT,38,1169981
fldAp,18.0,36,1,CCGGAAGATGGCTTCGCAAG,35,1087444
fldAp,14.5,29,1,CCGCTTTGATTCACTTATAC,28,1102025
fldAp,12.5,25,1,CCGCTCTTTAGGCCTGGCCC,24,1124396
fldAp,13.0,26,1,CCGAGATAGTCGCCGCCATA,25,1127474
fldAp,16.0,32,1,CCGACCTGCGTGGGCGTCTA,31,1105301
fldAp,14.0,28,1,CCGACCGTAATGTAGAGACT,27,1182497
fldAp,20.5,41,1,CCGACCACGGTAAAATTGCA,40,1095716
fldAp,10.0,20,1,CCCTTTTAGTCCAGATCAGG,19,1063015
fldAp,16.0,32,1,CCCTTTGAAGTGCACGGGAC,31,1078547
fldAp,20.0,40,1,CCCTGGGCCTGTGCTCTCGA,39,1151898
fldAp,38.5,77,1,CCCTCGGGCCTTTCAGGACC,76,1066016
fldAp,13.5,27,1,CCCTCCCATTTCGGTGGCCT,26,1132073
fldAp,7.5,15,1,CCCGGGCCACGAGGGCATCG,14,1116786
fldAp,3.0,6,1,CCCGCTTCGAGGATGCCCGC,5,1139823
fldAp,8.5,17,1,CCCCCATGCGGTCTGTACAG,16,1092345
fldAp,1.0,2,1,CCCATCTCGGCATAACCTAG,1,1168925
fldAp,7.5,15,1,CCCACGGCCGTTGAACGAAA,14,1104262
fldAp,1.0,2,1,CCATTAATGCCTACATATAG,1,1066681
fldAp,10.5,21,1,CCACTCAGGGTTCAGTCCGA,20,1080159
fldAp,1.0,2,1,CCACCTACAACTGTTATGGA,1,1156751
fldAp,24.0,48,1,CCAAGTTCTCCGGAATGGAC,47,1175010
fldAp,17.0,34,1,CCAAGCTGGTGAAGGATAAC,33,1078825
fldAp,14.0,28,1,CCAACGAGACAGCTTGTAGG,27,1131997
fldAp,14.0,28,1,CATTTCCTTTTACGTCGTGT,27,1138297
fldAp,18.0,36,1,CATTGTGACGATTGTTCTGA,35,1091363
fldAp,16.0,32,1,CATTGCGGGAATTCTACTGC,31,1094765
fldAp,9.5,19,1,CATTCTGGCACCGCACATCG,18,1151756
fldAp,24.0,48,1,CATTATAAAAACATAGGTAC,47,1135675
fldAp,17.5,35,1,CATGGACAGTTAGCCGTTGG,34,1110276
fldAp,1.0,2,1,CATGCCACGGAAGTCTCTCT,1,1141282
fldAp,19.0,38,1,CATGCATGACGGCCACTGTC,37,1096107
fldAp,1.0,2,1,CATAGGAATTCCACTATATC,1,1180626
fldAp,3.0,6,1,CATACGGTCGCTACACGTCG,5,1070124
fldAp,66.0,132,1,CATAATGTCGGGTTGGCCGA,131,1126554
fldAp,13.0,26,1,CAGTGAGACTGCGTTTACCT,25,1178130
fldAp,13.5,27,1,CAGTCCGCGTCAGAGCGCAT,26,1162795
fldAp,24.5,49,1,CAGCGAAGTTACAGCCTTTG,48,1091479
fldAp,53.5,107,1,CAGCCTGTGCAGGGTGCGTA,106,1126562
fldAp,4.5,9,1,CAGCAGCGGACGACTTGCAG,8,1114587
fldAp,5.5,11,1,CAGAGGCGCGCACCCGTTGC,10,1093180
fldAp,1.0,2,1,CAGACGCGGGGTCGAAGCGC,1,1128720
fldAp,14.0,28,1,CAGAATTTTCGGGGATGTTA,27,1186468
fldAp,1.0,2,1,CAGAAGGTCCCCACCAAGTC,1,1071295
fldAp,19.5,39,1,CACGTTCCTCTGGTTAAATT,38,1135920
fldAp,13.0,26,1,CACGGGCTCGTCAAGGGTGC,25,1136520
fldAp,13.0,26,1,CACGAAATCCGAAGCTTGCA,25,1109531
fldAp,32.0,64,1,CACCACTCTACCGGTACCCT,63,1098086
fldAp,1.0,2,1,CACCAAGAACTTGGACCTGT,1,1088244
fldAp,18.5,37,1,CACACTCGGAGACCAATCTA,36,1104353
fldAp,2.0,4,1,CAATGTGTAATAGCCGGAGA,3,1142073
fldAp,1.0,2,1,CAATGGCGGCTTTATTCTAT,1,1080498
fldAp,23.0,46,1,CAATGCGTGGGCGGAATCGG,45,1127906
fldAp,14.5,29,1,CAATCTGGAACCAGAAGTAA,28,1088948
fldAp,3.5,7,1,CAATCGTTGCGGTACGATAC,6,1084567
fldAp,11.0,22,1,CAATCATACGCGGTTGTGCA,21,1067629
fldAp,40.0,80,1,CAATCACTTTGGCAGAAAAC,79,1119790
fldAp,9.0,18,1,CAAGAGAGGCATCGACGAGT,17,1103468
fldAp,1.0,2,1,CAACTCAGAACTTCTGATTC,1,1185241
fldAp,18.5,37,1,CAACGTATCCCGAAGAAGAA,36,1143693
fldAp,1.0,2,1,CAACGCTCCTACAATGGGTA,1,1101670
fldAp,13.0,26,1,CAACAGAGTCATATTAAGTA,25,1110184
fldAp,9.5,19,1,CAAATCATTTCTCTTGGATT,18,1172933
fldAp,1.5,3,1,CAAACTCAGTGGAATGTCCA,2,1093373
fldAp,1.0,2,1,ATTTAAAATGTCGCCATCAC,1,1148190
fldAp,18.0,36,1,ATTGAGCGCCCAATATATTG,35,1103436
fldAp,11.0,22,1,ATTCTCTTTACCACTAACCT,21,1127811
fldAp,7.0,14,1,ATTCTCGAGCTTGCTATTAA,13,1094737
fldAp,20.5,41,1,ATTCTATCCTGTGAATCGAT,40,1103272
fldAp,14.5,29,1,ATTAGTGAGCTCCCATAATA,28,1067475
fldAp,39.0,78,1,ATTACTGCGTGCCGCAGACA,77,1126548
fldAp,30.0,60,1,ATGTTTTCGTCCACAGACGT,59,1155215
fldAp,14.0,28,1,ATGTTTATATGCGTCATCTT,27,1069149
fldAp,1.5,3,1,ATGCTTAGACAACCTTACGG,2,1182858
fldAp,7.5,15,1,ATGCTATGAGTATATTCGTC,14,1099740
fldAp,1.0,2,1,ATGACTTTACGCCCTTGATT,1,1115672
fldAp,11.0,22,1,ATCTGCTGGCGGTGCCGCAT,21,1076321
fldAp,29.5,59,1,ATCTGCGCTACGATCCGAGC,58,1077754
fldAp,14.0,28,1,ATCTATTGGACTTGACGACT,27,1159330
fldAp,27.5,55,1,ATCGCTACATTTTGTCTCAG,54,1178663
fldAp,10.5,21,1,ATCCTTCATCCGGCGCACTT,20,1138107
fldAp,12.0,24,1,ATCCGTCGCAAAAGGCCGGC,23,1110178
fldAp,2.0,4,1,ATCCGATTCTATCCCCGCGG,3,1183106
fldAp,23.5,47,1,ATCCGATCTTCTCACTGAGT,46,1157419
fldAp,6.5,13,1,ATCCAGGAGTCAGGGTTTTG,12,1082778
fldAp,18.0,36,1,ATCATTGTTCCCCTGGTAAA,35,1155295
fldAp,26.5,53,1,ATCACCATTGTATGCTAGTT,52,1129412
fldAp,10.0,20,1,ATATGTGGCAGGGGCCCCTG,19,1141528
fldAp,12.0,24,1,ATAGGTTGACCTTGAGACTC,23,1114677
fldAp,8.5,17,1,ATAGCGTCGGCGAATCCCGT,16,1169149
fldAp,44.0,88,1,ATACGGGCCACGACTTAAGA,87,1186653
fldAp,14.0,28,1,ATACGCCGTACGCGGGGCTC,27,1120146
fldAp,15.5,31,1,ATACGACTCGGTGAGCTTAT,30,1076427
fldAp,18.0,36,1,ATACCTCTTGCCGTTGACTA,35,1112201
fldAp,1.0,2,1,ATACCAATCGTGAGGCCAGA,1,1098708
fldAp,31.0,62,1,ATAATAGGCGACAAGGTCCT,61,1107656
fldAp,62.5,125,1,ATAAGTGCATCATTGTTCAG,124,1135718
fldAp,19.0,38,1,ATAAGTCCTCGCGTTGGGTA,37,1173224
fldAp,14.0,28,1,ATAAGGAGGGATAAGTTTTA,27,1108063
fldAp,11.5,23,1,ATAACCTGGCCCGCTCCACA,22,1159488
fldAp,1.0,2,1,AGTTGAGGAAATCTCGCAGA,1,1078774
fldAp,23.5,47,1,AGTTCACTAAGGGGTTACCG,46,1085419
fldAp,16.5,33,1,AGTGGCTGGATAGGATTACT,32,1125410
fldAp,1.0,2,1,AGTGCCGAGGCAATTCCGTG,1,1186752
fldAp,27.0,54,1,AGTCTGGTATGATGAAATGT,53,1074163
fldAp,3.5,7,1,AGTCTATTGCATGCCGAAGT,6,1131266
fldAp,4.5,9,1,AGTCCCCTCTAATTGTACGC,8,1102818
fldAp,1.5,3,1,AGTATTTGCGACCCTTCGGA,2,1093286
fldAp,9.0,18,1,AGTATAATATCATTTGTGAT,17,1178411
fldAp,14.5,29,1,AGGTGTTCTAAGCTCAAGGC,28,1102214
fldAp,12.5,25,1,AGGTGCTATGGGAGACAGAC,24,1108710
fldAp,8.5,17,1,AGGTAGAAATCGTTTCTAAA,16,1064961
fldAp,20.5,41,1,AGGGGCTTTGGTTGACTCTA,40,1073353
fldAp,13.5,27,1,AGGGGCAGGTCTCGTTCTCA,26,1137545
fldAp,12.0,24,1,AGGGCTTGGAATAGGCTGGA,23,1142388
fldAp,22.5,45,1,AGGGCATCTTAGAGATGGTG,44,1088800
fldAp,1.0,2,1,AGGGCAGTTTGACCAGAATA,1,1127427
fldAp,9.0,18,1,AGGCCATATTGGTTATCAGT,17,1126515
fldAp,23.0,46,1,AGGCAGTTCCGATACTGCCG,45,1146179
fldAp,1.5,3,1,AGGAACTTTGCCTCTGTATA,2,1120564
fldAp,12.0,24,1,AGCTTTTCTGAGTATTCTTC,23,1114906
fldAp,7.0,14,1,AGCTCACCGAGGCGCTTTCG,13,1095444
fldAp,14.5,29,1,AGCTCAAGCGCTCGGAGAAG,28,1073504
fldAp,14.5,29,1,AGCTAGCTGAGCTGAACAAT,28,1079530
fldAp,2.0,4,1,AGATTGAACGACGCCGGGGT,3,1123897
fldAp,2.0,4,1,AGATCGCCCTTGGCGGTCAA,3,1167775
fldAp,25.5,51,1,AGAGGTCAGGATTGTCCCAT,50,1186633
fldAp,10.0,20,1,AGAGGACAAGGCCGGGGATC,19,1139045
fldAp,1.0,2,1,AGAGATGTGTCCGAGTGAGG,1,1064171
fldAp,16.0,32,1,AGAGATAAGAATCGGCGTAG,31,1117868
fldAp,13.5,27,1,AGACTAGGCTTAGCGTATTG,26,1101783
fldAp,1.0,2,1,AGAAGCTTTGCTCCAAGGCA,1,1093332
fldAp,15.5,31,1,AGAACCTCAATACTGTGGTC,30,1145103
fldAp,18.0,36,1,ACTTGTCGCGGAGGTTAATG,35,1136005
fldAp,18.0,36,1,ACTTGGTAAATGGGGGGGCG,35,1121082
fldAp,13.0,26,1,ACTGTAGTTGGCGTATATCC,25,1080690
fldAp,5.5,11,1,ACTGGCCTGCGCCGCTAGGG,10,1114783
fldAp,8.5,17,1,ACTGCCCACGGACCCATCAG,16,1099661
fldAp,8.0,16,1,ACTGAGGTCTAAAGACACTC,15,1082845
fldAp,1.0,2,1,ACTCTCCCACTGTGTTTTCC,1,1169539
fldAp,11.0,22,1,ACTCTAATAATAACTTTTAA,21,1113839
fldAp,1.0,2,1,ACTCATATCGTCAACCGGAC,1,1127055
fldAp,13.5,27,1,ACTATTCCGTGCCTAGAGTT,26,1136099
fldAp,12.5,25,1,ACTATGGGGACTATGTGCAA,24,1112880
fldAp,8.0,16,1,ACTAGAGGCAAGAAAAGGTT,15,1141147
fldAp,34.0,68,1,ACTAAGTACCCACACAGTCC,67,1094764
fldAp,1.0,2,1,ACGTTCGTCGCAGTGACAAC,1,1106507
fldAp,5.5,11,1,ACGGGGGCCGGCGAGTAGGT,10,1066269
fldAp,1.0,2,1,ACGGCGCTCCATGTGTAGAT,1,1079736
fldAp,32.0,64,1,ACGCCGTCTTCGGATGGCAA,63,1172086
fldAp,1.5,3,1,ACGCCACCGCGCGGTTTCGA,2,1143602
fldAp,1.0,2,1,ACGATCGCGATCTTTGGCCG,1,1165064
fldAp,15.0,30,1,ACGAAGAGTGGGGACGACCT,29,1127355
fldAp,18.5,37,1,ACCTTTGGGGGTTTATACGT,36,1141749
fldAp,1.0,2,1,ACCTAGAATTGGAGGAGATA,1,1150269
fldAp,12.5,25,1,ACCGTTTTGTACAGTACATC,24,1174072
fldAp,4.5,9,1,ACCGCATGTCGCTCCCAGGA,8,1084447
fldAp,14.0,28,1,ACCGCATCAGGCGATGGGCG,27,1067498
fldAp,1.0,2,1,ACCGAAACAAGGATTGGTAA,1,1081854
fldAp,14.0,28,1,ACCCACAAAGATCGTGTTGC,27,1075787
fldAp,2.5,5,1,ACCAGTGGGGCTACAATACT,4,1181706
fldAp,16.0,32,1,ACCAGGAAGTTGTGAATTAT,31,1159339
fldAp,9.0,18,1,ACCAGAGTAATTCCGGTGAC,17,1112902
fldAp,18.0,36,1,ACCACAGCATGCTTTCTCCC,35,1172794
fldAp,1.0,2,1,ACATAGACGATCAAGCGATA,1,1120707
fldAp,14.0,28,1,ACAGGTATAAATACGTGCCA,27,1076779
fldAp,10.5,21,1,ACAGCCGATCGACGAAAAGC,20,1125449
fldAp,11.0,22,1,ACAGCAACCCCTGGAAGGTA,21,1073885
fldAp,13.5,27,1,ACAGACTGGATGACCACAAT,26,1171115
fldAp,1.0,2,1,ACAATCCAAACCGATTGTGG,1,1094695
fldAp,3.0,6,1,ACAAGTTGCAAAGCGAGGTT,5,1073343
fldAp,1.0,2,1,AATTGGAATGTACCGGGGCG,1,1099651
fldAp,1.0,2,1,AATTGCCTTCATCGGGTTAA,1,1102957
fldAp,14.0,28,1,AATGGTCCGTTTGTTTATGA,27,1163451
fldAp,25.0,50,1,AATGATTAGGGAAACGCCAC,49,1178693
fldAp,1.0,2,1,AATGAAGTTTAAACGTCCGA,1,1116756
fldAp,20.0,40,1,AATCTCATCTATAGGGCTAA,39,1109738
fldAp,1.0,2,1,AATCGGATGTAAGTCCGATA,1,1065626
fldAp,24.5,49,1,AATCAGGATAGAACAGTTAA,48,1139531
fldAp,18.5,37,1,AATATGTTTATTCCAGGCAG,36,1069221
fldAp,1.0,2,1,AATAGGTAGCCTTGAGTTGA,1,1166552
fldAp,29.5,59,1,AATAAATCCTTCTGCTACCA,58,1087854
fldAp,36.0,72,1,AATAAAGGGGGGGTGCCAGT,71,1158438
fldAp,28.5,57,1,AAGTGTAGTTATGGGGGTGA,56,1174593
fldAp,25.5,51,1,AAGGTTGAATTCCCTGACCC,50,1078652
fldAp,4.5,9,1,AAGGTAACGGACTGGGATGG,8,1129573
fldAp,14.5,29,1,AAGGACATACGGACCCCCTT,28,1134509
fldAp,12.0,24,1,AAGCTTCTGAACACTACCAG,23,1151198
fldAp,25.5,51,1,AAGCTCGTGCTGTGATGAAC,50,1110725
fldAp,11.0,22,1,AAGACTTGAATTAAAATTTG,21,1133682
fldAp,29.0,58,1,AAGAACCCATGCCTTTAAAA,57,1139170
fldAp,1.0,2,1,AACTTGGTTTTAGCAATACT,1,1132026
fldAp,10.5,21,1,AACTTATCTCAGGCCTCGTT,20,1114278
fldAp,22.0,44,1,AACTGGGTTAAGTACTCAGC,43,1121067
fldAp,1.0,2,1,AACTCGGAACCTGGCTATCA,1,1107587
fldAp,1.0,2,1,AACTAATCCCTTTTGAAAGC,1,1084275
fldAp,73.5,147,1,AACGGGCATGAGCGAACCTG,146,1107654
fldAp,25.0,50,1,AACGGATCCGCGCGGGGCAG,49,1093300
fldAp,20.5,41,1,AACGCGCATAAAGTGTAAAA,40,1121247
fldAp,6.0,12,1,AACGAAGGCTCTGTGCAATC,11,1170776
fldAp,1.0,2,1,AACCTGCAAGGCCGGGGTAA,1,1145073
fldAp,1.0,2,1,AACCCGGTTATTAAAAAGCG,1,1170702
fldAp,17.0,34,1,AACCCATTATAAGCGCCGAT,33,1129732
fldAp,69.0,138,1,AACAGTAACCCCAAGAGGCC,137,1126590
fldAp,1.0,2,1,AACAGCGGACAGAACTACGC,1,1107359
fldAp,40.5,81,1,AACACGGACCATGTTCTGGT,80,1118369
fldAp,3.0,6,1,AAATCCGTAGGTAGTAACGA,5,1156299
fldAp,17.0,34,1,AAAGGAGAGGCTAGCTGTGT,33,1087362
fldAp,9.0,18,1,AAAATCGCTGCACACCTTCT,17,1074643
fldAp,22.0,44,1,AAAACTGGACTGGTATAGTT,43,1119148
fldAp,0.00980392156862745,101,101,GTGCTGCTACGTGTATACCA,0,1079704
fldAp,0.01098901098901099,90,90,GGCGTAGATGCTATTGTAGA,0,1144540
fldAp,0.012195121951219513,81,81,TGTCAGTTTTTTCTGGAATG,0,1120352
fldAp,0.01282051282051282,77,77,GGACGTGACGGCCGTAGGGG,0,1063955
fldAp,0.014285714285714285,69,69,GACGCTACTGTAAGGCAATT,0,1163596
fldAp,0.014492753623188406,68,68,CTTACATCTGTAAGCCTAGG,0,1081028
fldAp,0.014705882352941176,67,67,CGACGCAAATCCTGGAAGCA,0,1073607
fldAp,0.01639344262295082,60,60,CTAACACTTATACCAAGCTA,0,1094938
fldAp,0.016666666666666666,59,59,TCCGGCTTCTAGGAGGGCGT,0,1162730
fldAp,0.016666666666666666,59,59,GCGACGCGCTAGGTTAAATA,0,1137191
fldAp,0.016666666666666666,59,59,CTAATTGTGGCACGGACATA,0,1070660
fldAp,0.01694915254237288,58,58,TGTTTGCGGTTCTGCGGACA,0,1089736
fldAp,0.01694915254237288,58,58,CTTGCGAACACCTGGCTCTA,0,1083611
fldAp,0.017241379310344827,57,57,TGCCTCGAATCCATGACGGC,0,1160392
fldAp,0.017543859649122806,56,56,TAGACTGGATACTAACCAGC,0,1096172
fldAp,0.017857142857142856,55,55,CACTTGGATACGAGTTAATC,0,1118508
fldAp,0.01818181818181818,54,54,TTGGCTGAAATCGTAGTTGC,0,1073251
fldAp,0.01818181818181818,54,54,TCGAGGGGCGCGTTCCAATG,0,1133052
fldAp,0.01818181818181818,54,54,GGGAGTACTCGACTTCTGCT,0,1173961
fldAp,0.01818181818181818,54,54,AATAACCCGAAAGGCTCATG,0,1144475
fldAp,0.018518518518518517,53,53,GGGAGACTTCGAACGAAGCT,0,1113554
fldAp,0.018518518518518517,53,53,CGGTGTTCTATGGGTCACGG,0,1172633
fldAp,0.018867924528301886,52,52,TCAGTTGGTCATCGATGCGA,0,1073417
fldAp,0.018867924528301886,52,52,GTAGACCGTTGTTGCTGCCA,0,1082416
fldAp,0.019230769230769232,51,51,CCGAGCTGTCTATACGGACA,0,1124749
fldAp,0.019230769230769232,51,51,ATACATTGTATAGTCCGGCC,0,1149741
fldAp,0.0196078431372549,50,50,GTCGAGAACCGTGACTCAAA,0,1091348
fldAp,0.0196078431372549,50,50,ACCTCGGTTAGACAGTTAAG,0,1127235
fldAp,0.02,49,49,TAGCTTTAAGGGAATAGCCT,0,1115312
fldAp,0.02,49,49,GAACAACATTACGACCGAGA,0,1184113
fldAp,0.02,49,49,CAGGGGACACGATCGATCTG,0,1087004
fldAp,0.02,49,49,CAATCCGAGACAACGTACAC,0,1099050
fldAp,0.02040816326530612,48,48,GCAGGTGGTCGCGGGGCATC,0,1163486
fldAp,0.02040816326530612,48,48,GACTCTGACGATCAAGAAAT,0,1094487
fldAp,0.02040816326530612,48,48,CCATCATGCATACCCTTGGT,0,1086914
fldAp,0.020833333333333332,47,47,TGGTTCCCCAAAGCTAGGGA,0,1134220
fldAp,0.020833333333333332,47,47,TGGCCTCTTGAGTGCTCTTC,0,1094563
fldAp,0.020833333333333332,47,47,TGCTATCTGTCCGGACGCTC,0,1118236
fldAp,0.020833333333333332,47,47,TGATTCATCGATGGAGTTAT,0,1167530
fldAp,0.020833333333333332,47,47,GCTTAGTCAAGTTGCGTAAC,0,1142257
fldAp,0.020833333333333332,47,47,GCGCCGACCCGAGCCCTGCA,0,1084380
fldAp,0.020833333333333332,47,47,GATCGTCTAGTTGAGGTGGC,0,1167621
fldAp,0.020833333333333332,47,47,ATTCACGCGTCTCTAGAACG,0,1090572
fldAp,0.020833333333333332,47,47,AGATTCACACGATCGAGTTT,0,1141226
fldAp,0.020833333333333332,47,47,ACTTTTTATTCATAAACGTA,0,1148282
fldAp,0.020833333333333332,47,47,AAATTCAGATCGAGTCACTG,0,1131948
fldAp,0.02127659574468085,46,46,TCGCACGTGCTACTAAGACG,0,1110915
fldAp,0.02127659574468085,46,46,GCACCCAGCTAAACACTGGC,0,1084396
fldAp,0.02127659574468085,46,46,CCGGTGACCCCCTACTTTAG,0,1122196
fldAp,0.021739130434782608,45,45,TATGATCCCAATTTTATATA,0,1112276
fldAp,0.021739130434782608,45,45,TAGAGTCGCCCTGCACATGA,0,1155026
fldAp,0.021739130434782608,45,45,GCTGTGGAGGGGGAAGTGAT,0,1100490
fldAp,0.021739130434782608,45,45,CTATACTCAGCCTAACAGCA,0,1087616
fldAp,0.021739130434782608,45,45,CCAACAGATTCAAGTGCACA,0,1133607
fldAp,0.022222222222222223,44,44,TCTGCCCGCTTCATTATAAT,0,1095119
fldAp,0.022222222222222223,44,44,TATTGTACGCCATGGAGCGA,0,1144978
fldAp,0.022222222222222223,44,44,GGGCCAGTTTTAGAGCGCCT,0,1185677
fldAp,0.022222222222222223,44,44,CAGGAGCACTTCTCTTGGGA,0,1102406
fldAp,0.022222222222222223,44,44,ATTTCCTCAGCCTCAGAACA,0,1142324
fldAp,0.022222222222222223,44,44,AGACGACGGGATGAGCCCAT,0,1081536
fldAp,0.022727272727272728,43,43,TTCATTTGTCCTGGTTGCAT,0,1097458
fldAp,0.022727272727272728,43,43,TGTCCATGGCATTTTCTAAT,0,1163625
fldAp,0.022727272727272728,43,43,TATGGAGGAGAGGTGCTAAT,0,1064237
fldAp,0.022727272727272728,43,43,TAGAGAGAGCACATCGGCGC,0,1110680
fldAp,0.022727272727272728,43,43,GTAAACCCGTGCTGCAACGA,0,1154233
fldAp,0.022727272727272728,43,43,GCGGGGGTAGCGTCCTCACG,0,1143448
fldAp,0.022727272727272728,43,43,GAGTCACGCGGGTTGGACTA,0,1108620
fldAp,0.022727272727272728,43,43,CTTGATGCTGTCGTGGGTTT,0,1138671
fldAp,0.022727272727272728,43,43,CTAAGGCATTTTGTGAGGAC,0,1149314
fldAp,0.022727272727272728,43,43,CGTCCAACGCAGCACCTTTA,0,1125017
fldAp,0.022727272727272728,43,43,CGCGGCACTAGGGATCGCTC,0,1166880
fldAp,0.022727272727272728,43,43,AATTGAGTGGCAGGAGACAC,0,1099039
fldAp,0.022727272727272728,43,43,AAACATCCGGCAAAGGGGAC,0,1166475
fldAp,0.023255813953488372,42,42,TTTCGTACTCGATTCTAGTG,0,1081307
fldAp,0.023255813953488372,42,42,TGATCGCGTTCGTAGCCGAA,0,1165650
fldAp,0.023255813953488372,42,42,TAGCGGAAGACAGTTTAGAT,0,1176354
fldAp,0.023255813953488372,42,42,GGGGCGAAGACTAGAAAATA,0,1175856
fldAp,0.023255813953488372,42,42,GGCAGGCCTGGGTCGTATGT,0,1152748
fldAp,0.023255813953488372,42,42,GAGACCGGCCGTTATCGGTT,0,1173932
fldAp,0.023255813953488372,42,42,CGTAGGAACCCTACGATTGT,0,1079374
fldAp,0.023255813953488372,42,42,CGCCAGCTAGCACACGCATA,0,1083071
fldAp,0.023255813953488372,42,42,CCGATCTTCTCATCGAGGTA,0,1120937
fldAp,0.023255813953488372,42,42,CCACTACTGTGTCCGAAGTA,0,1088593
fldAp,0.023255813953488372,42,42,CAAAGAATTCGAATGAGGGT,0,1089878
fldAp,0.023255813953488372,42,42,ATCAGTGGGCTTATCCACTC,0,1088297
fldAp,0.023255813953488372,42,42,AACGGACTCGTCTTCAGGAC,0,1079088
fldAp,0.023809523809523808,41,41,TTAAAAGCATATCGCGGACA,0,1144759
fldAp,0.023809523809523808,41,41,GACTGTAGGTCATTCGCGTT,0,1073419
fldAp,0.023809523809523808,41,41,CTGATTACTGGGCTAAAGAT,0,1168749
fldAp,0.023809523809523808,41,41,CGGCTCCCAACCCGCCGATG,0,1092037
fldAp,0.023809523809523808,41,41,CAGGACTACGGGGGGTAGAC,0,1158529
fldAp,0.023809523809523808,41,41,ATGTGTTGTTGCCGTTGAAC,0,1159985
fldAp,0.023809523809523808,41,41,AGTGAGAGAGCTGCCTGTCA,0,1097894
fldAp,0.023809523809523808,41,41,ACTGTATACAAGGGGCGCGC,0,1098866
fldAp,0.023809523809523808,41,41,AAGCCTGCCAGTATGCCCGT,0,1110681
fldAp,0.024390243902439025,40,40,TTGGTCGGAGTTGGCAGTTG,0,1079980
fldAp,0.024390243902439025,40,40,GCAATTAGTAAATCGCGGCT,0,1126718
fldAp,0.024390243902439025,40,40,GAGGGGAGTGATTGGACACA,0,1065915
fldAp,0.024390243902439025,40,40,CTTTTCACCTTGTAACATCA,0,1167759
fldAp,0.024390243902439025,40,40,CTATCGCACGGCTTTGACGG,0,1078046
fldAp,0.024390243902439025,40,40,CGCGCACGCGTTGTCGCTGT,0,1166350
fldAp,0.024390243902439025,40,40,AATAGTGGATGCACGTTCAA,0,1069098
fldAp,0.025,39,39,TTTATCCAAGGGGCAATGCT,0,1179822
fldAp,0.025,39,39,TTAACGAAAATTCTGTACAC,0,1128728
fldAp,0.025,39,39,TCGCCGCTCCACATTAGTAA,0,1112192
fldAp,0.025,39,39,TAGCAGTAACACACTCGTGG,0,1124751
fldAp,0.025,39,39,GTACGCAGGTATAATCTCAT,0,1138185
fldAp,0.025,39,39,GGTCAGGTCGAGTGGGTCAC,0,1091900
fldAp,0.025,39,39,GGGTACAGTGATAGCAATCC,0,1116094
fldAp,0.025,39,39,GCACCGCCCGATTGGTTATG,0,1150563
fldAp,0.025,39,39,GATGGGGGTACATCTCAGGT,0,1101028
fldAp,0.025,39,39,CGGTTAGCCGGTCGAGTGCT,0,1070663
fldAp,0.025,39,39,CATGTGTAACACCCATCTCA,0,1108572
fldAp,0.025,39,39,CATGGGCTGGATTAAGGCTA,0,1106666
fldAp,0.025,39,39,ATCAATCGAGAATAACTGGA,0,1105404
fldAp,0.025,39,39,AGTTCCGTAATGGCTATAGT,0,1082391
fldAp,0.025,39,39,ACTGGGGCATTTCAGACTCT,0,1142121
fldAp,0.025,39,39,ACATCAGCAAAGTTACGTGA,0,1118163
fldAp,0.025,39,39,ACAGATTTGGTTTTATACTG,0,1090988
fldAp,0.025,39,39,AAGCGTTGAGTTTAATGTAA,0,1165069
fldAp,0.02564102564102564,38,38,TTCAGGCTCACATTCTAGCT,0,1163205
fldAp,0.02564102564102564,38,38,TGACAAGGGCTGCCCCCCGA,0,1164531
fldAp,0.02564102564102564,38,38,GTCCTCCAAGGCAATTGCTG,0,1101173
fldAp,0.02564102564102564,38,38,GGGCGACTGGTGTTACCAGT,0,1183312
fldAp,0.02564102564102564,38,38,GGACTAGGCATTTTGATTCC,0,1136899
fldAp,0.02564102564102564,38,38,GATGGCGACGGGTAGAACCC,0,1097460
fldAp,0.02564102564102564,38,38,CTAGTTAATAAGTGCTGGGG,0,1169405
fldAp,0.02564102564102564,38,38,CGCCAGAAGGGAAAGGTGTG,0,1099741
fldAp,0.02564102564102564,38,38,ATTTAGTCAACAGGGTACTA,0,1150896
fldAp,0.02564102564102564,38,38,ATCACGAATGCTAGGTGATG,0,1171322
fldAp,0.02564102564102564,38,38,ACAACAGTCCGGGTTCATGC,0,1093162
fldAp,0.02564102564102564,38,38,AATTCAAACAGCCAGCGAAA,0,1171332
fldAp,0.02564102564102564,38,38,AATACACAACATAGGGGGTC,0,1098307
fldAp,0.02631578947368421,37,37,TTGGACACGAACGGAACATC,0,1160892
fldAp,0.02631578947368421,37,37,TTCGGGTGCTTTTTTAGGGA,0,1122494
fldAp,0.02631578947368421,37,37,TTATAGCCTAGCGTGTTGCG,0,1120326
fldAp,0.02631578947368421,37,37,TAGAGCTAAGTTGAACGGAG,0,1084613
fldAp,0.02631578947368421,37,37,GGTGGTTATTGGTCAAGTGA,0,1075105
fldAp,0.02631578947368421,37,37,CCCATCAACAGTTACTCTCA,0,1150824
fldAp,0.02631578947368421,37,37,ATTGATCGCCCGCAATCAAT,0,1070031
fldAp,0.02631578947368421,37,37,ATGGACAGTCTCCAAGTTGG,0,1120128
fldAp,0.02631578947368421,37,37,ATGAGGGTAAGTACGTGTCT,0,1180099
fldAp,0.02631578947368421,37,37,ATACGGATAAATCCGCTCCA,0,1099392
fldAp,0.02631578947368421,37,37,ATACCATTTGACTGCACCTA,0,1168281
fldAp,0.02631578947368421,37,37,AGTAAAAAAGTTGCCCCGGT,0,1085025
fldAp,0.02631578947368421,37,37,ACGAACAAATTCAGTCATCC,0,1099255
fldAp,0.02631578947368421,37,37,AAGGCGACTCATCTTTTTCA,0,1186978
fldAp,0.02631578947368421,37,37,AAATGAAATCGCTAACGTCT,0,1153365
fldAp,0.02702702702702703,36,36,TTAGCCCACAAAGTGGGTGA,0,1094351
fldAp,0.02702702702702703,36,36,TGCGGCCAGGTATTCCCCGT,0,1145825
fldAp,0.02702702702702703,36,36,TATTTAATTGTCAACTTCCG,0,1076146
fldAp,0.02702702702702703,36,36,TAATTTCTAGGGATGATAAC,0,1112108
fldAp,0.02702702702702703,36,36,GTTGTCGTATATGCTGTTAC,0,1148080
fldAp,0.02702702702702703,36,36,GGCCGGCAGTACGGGTTAGA,0,1163514
fldAp,0.02702702702702703,36,36,GGCCATTCGTTTGCTTTCCA,0,1117452
fldAp,0.02702702702702703,36,36,GGACCCTCGTGGCCCCTTAG,0,1073617
fldAp,0.02702702702702703,36,36,GCACGTGCATCCACAACCAA,0,1148116
fldAp,0.02702702702702703,36,36,GATGCGCGTCGTCTTTCGCT,0,1185466
fldAp,0.02702702702702703,36,36,GATACAGTACAACCTCCTGT,0,1075446
fldAp,0.02702702702702703,36,36,GAAGGAAACCAGACTGGTAT,0,1064290
fldAp,0.02702702702702703,36,36,CGACAATTTGTCATCGTGAA,0,1090569
fldAp,0.02702702702702703,36,36,ATCGATGATTTCAGTGCATG,0,1132620
fldAp,0.02702702702702703,36,36,ACCCTATATTCGTGAACGGT,0,1094859
fldAp,0.02702702702702703,36,36,AAGTGCCGGCACTAACCTCA,0,1137950
fldAp,0.02702702702702703,36,36,AAAAAGACAAGTGCTGCCGT,0,1100188
fldAp,0.027777777777777776,35,35,TGTGTGAGAATGGGGCATGA,0,1077164
fldAp,0.027777777777777776,35,35,TGACCCATGTTATCGGTATT,0,1156652
fldAp,0.027777777777777776,35,35,TCTTATGTCTGGCATTTAGG,0,1100509
fldAp,0.027777777777777776,35,35,TCGCAGTGATCCTATCCTTG,0,1114680
fldAp,0.027777777777777776,35,35,TACCCAGGCTCATTACCTTT,0,1105328
fldAp,0.027777777777777776,35,35,GTGCGCTAGTCTACGCTACA,0,1065250
fldAp,0.027777777777777776,35,35,GGTGGTTTCACTATGACCGT,0,1119579
fldAp,0.027777777777777776,35,35,GGTGGGAGGAAATTCGCCCT,0,1180692
fldAp,0.027777777777777776,35,35,GGTATTGATGCGGAGGTATC,0,1068736
fldAp,0.027777777777777776,35,35,GGGGGCTGGCCTGCATCACA,0,1183389
fldAp,0.027777777777777776,35,35,GGGGAGCTCGATGTTGCATG,0,1093642
fldAp,0.027777777777777776,35,35,GGACTTTCACCTTGCCTCAT,0,1134342
fldAp,0.027777777777777776,35,35,GGACCCTAGTGTCTGCTTAA,0,1118534
fldAp,0.027777777777777776,35,35,GCCGGGTGCCTGGTTTGGGT,0,1077373
fldAp,0.027777777777777776,35,35,GCACTGCCCTCAAAACCCGG,0,1164174
fldAp,0.027777777777777776,35,35,GAGGTTAAGTGAGCTATCAC,0,1150537
fldAp,0.027777777777777776,35,35,CGGGCTCATTCCTCAGCGCT,0,1100030
fldAp,0.027777777777777776,35,35,CGGCTAAGACCGCATCTCCT,0,1066373
fldAp,0.027777777777777776,35,35,CCGTGGGAACCATGGCGTAA,0,1160570
fldAp,0.027777777777777776,35,35,CCGGATTTTAGGATCCCAAA,0,1121653
fldAp,0.027777777777777776,35,35,CCAAAAGTTTAGCCGCCTAA,0,1164577
fldAp,0.027777777777777776,35,35,CATTTCATGCGAGTCCTCGT,0,1181121
fldAp,0.027777777777777776,35,35,CAGGCGATCAGCAACCCCTC,0,1167331
fldAp,0.027777777777777776,35,35,CACCGTTGAATCTTGTGTAC,0,1184572
fldAp,0.027777777777777776,35,35,ATGACGTGTCTACGACCGCT,0,1097265
fldAp,0.027777777777777776,35,35,AGGGTGCTAGCCCTTAAGAC,0,1126717
fldAp,0.027777777777777776,35,35,AGGAGGCAAACTACTAGATC,0,1148161
fldAp,0.027777777777777776,35,35,AGCATTTTACTACGGAGACA,0,1177577
fldAp,0.027777777777777776,35,35,ACCGAATAACTCTCGTCGAT,0,1081114
fldAp,0.027777777777777776,35,35,AATTGTGAGGAGGGCGATTG,0,1101130
fldAp,0.02857142857142857,34,34,TTGTTGCCATCAAGAGCAGC,0,1114660
fldAp,0.02857142857142857,34,34,TTAGTGAATATTCGCTTAGA,0,1181269
fldAp,0.02857142857142857,34,34,TTAAGGGGATGTTAATACGA,0,1120960
fldAp,0.02857142857142857,34,34,TGTTCCAGTACCGTAAAGTA,0,1146741
fldAp,0.02857142857142857,34,34,TGTCCCCCACTCGGCTCATC,0,1180602
fldAp,0.02857142857142857,34,34,TGGCGGTATGCTGGCAAAGC,0,1093627
fldAp,0.02857142857142857,34,34,TCGCTAGCTTGATCCGTATA,0,1167752
fldAp,0.02857142857142857,34,34,TCGATCTCCGCTTTCCTATT,0,1117058
fldAp,0.02857142857142857,34,34,TCACGGAATGTGCTATACAG,0,1063283
fldAp,0.02857142857142857,34,34,GTTCTATGGTCCTGCTGCGC,0,1069774
fldAp,0.02857142857142857,34,34,GTGGATCAAAGTTGACTTAA,0,1071219
fldAp,0.02857142857142857,34,34,GGTGAGAAATCCCTTGGGGC,0,1073675
fldAp,0.02857142857142857,34,34,GGCTACCAATTCAGGAGCCC,0,1104773
fldAp,0.02857142857142857,34,34,GGCTAATCTAGGTTTATTGC,0,1173293
fldAp,0.02857142857142857,34,34,GGATTCATGTAAGCATAGCA,0,1074368
fldAp,0.02857142857142857,34,34,GGACTTCGTCGTCAGTATCT,0,1155201
fldAp,0.02857142857142857,34,34,GCTAGATGCAAGGTACGCGT,0,1136897
fldAp,0.02857142857142857,34,34,GCCCGCCAAGTCAGGCCTTT,0,1073247
fldAp,0.02857142857142857,34,34,GCCATTCCTCGAAACCACTC,0,1170255
fldAp,0.02857142857142857,34,34,GCATAAAACGAGTACTAGAT,0,1162923
fldAp,0.02857142857142857,34,34,GCACCCCAAGGCACACCGAC,0,1143077
fldAp,0.02857142857142857,34,34,CTCCCAAGGGTCAATGTGAA,0,1103173
fldAp,0.02857142857142857,34,34,CCGAGACTTTCGCGTAGCCT,0,1144196
fldAp,0.02857142857142857,34,34,CCAGGTTCATTCAAAAGACG,0,1099380
fldAp,0.02857142857142857,34,34,CAACCCTGGAACGAATGCCA,0,1174867
fldAp,0.02857142857142857,34,34,ATTTCCTGCTCGCGGTGGCA,0,1114705
fldAp,0.02857142857142857,34,34,ATGAACGTCAGGCGGAAAGA,0,1147759
fldAp,0.02857142857142857,34,34,ATCGTACGGTGGTACTCATG,0,1100145
fldAp,0.02857142857142857,34,34,ATAAGTTAACTTAAATGTAT,0,1121586
fldAp,0.02857142857142857,34,34,AGTACCCTAACCTAACGTAT,0,1113714
fldAp,0.02857142857142857,34,34,ACGCCCAACGGGCAAAGTCT,0,1063565
fldAp,0.02857142857142857,34,34,AATTTCGTCTGACTCGTCAT,0,1112274
fldAp,0.02857142857142857,34,34,AACAACCCAGCTGGTTCCTA,0,1134767
fldAp,0.029411764705882353,33,33,TTCCCGTCTATTAGACAGCT,0,1177715
fldAp,0.029411764705882353,33,33,TTATATATTTTGGGCATATC,0,1130648
fldAp,0.029411764705882353,33,33,TTAGCAGCAGATGTCTCGGT,0,1118175
fldAp,0.029411764705882353,33,33,TTAGATCTTTAAGGCTGATT,0,1070306
fldAp,0.029411764705882353,33,33,TGATGGACGGACGGGAATCA,0,1145729
fldAp,0.029411764705882353,33,33,TATTCACCACTTGCGAGTTC,0,1124413
fldAp,0.029411764705882353,33,33,TATATAAGCCATCGCTTCGT,0,1107973
fldAp,0.029411764705882353,33,33,GTTCACTCCACGATCCCTAC,0,1073107
fldAp,0.029411764705882353,33,33,GTGGTTCATGGGGTTAGCTG,0,1151378
fldAp,0.029411764705882353,33,33,GGGATTAGCAATGGAAGGAT,0,1118637
fldAp,0.029411764705882353,33,33,GGCCGCAGCCCGTCGGCGAG,0,1157021
fldAp,0.029411764705882353,33,33,GGATGTTACGAGATGTCAGG,0,1102212
fldAp,0.029411764705882353,33,33,GCGTCATAGTGAACGCCCTC,0,1074338
fldAp,0.029411764705882353,33,33,GCAAATGTAAGTATCTGCGA,0,1076658
fldAp,0.029411764705882353,33,33,GACTATTAGTAGGGCAAACA,0,1116817
fldAp,0.029411764705882353,33,33,GACACTACCCACCCACCTCA,0,1096487
fldAp,0.029411764705882353,33,33,GAAGGTTTAGGTAGCCACTG,0,1115289
fldAp,0.029411764705882353,33,33,GAAGGCCGCGGGAGGAGAAG,0,1095233
fldAp,0.029411764705882353,33,33,CTGCACCGGAAAGTCCTCAG,0,1111155
fldAp,0.029411764705882353,33,33,CTCGGGGGAGAATACAGGAC,0,1113986
fldAp,0.029411764705882353,33,33,CGTAGCCAGGGTTGTACCCA,0,1133345
fldAp,0.029411764705882353,33,33,CGCTCGAGGGTCAGCTCTGG,0,1132131
fldAp,0.029411764705882353,33,33,CCATCTTGCGGCGGCGGGAT,0,1078541
fldAp,0.029411764705882353,33,33,CATTTAAGTTGAAGTAATTG,0,1117124
fldAp,0.029411764705882353,33,33,CATCACAAGCAGTGTCGATA,0,1178325
fldAp,0.029411764705882353,33,33,CATACTCGACGGGAGCCTCT,0,1073258
fldAp,0.029411764705882353,33,33,CAGGGCCACACTACGTTTCT,0,1100382
fldAp,0.029411764705882353,33,33,CAGCCAGGGCGTTCTAAGTT,0,1164242
fldAp,0.029411764705882353,33,33,CAAGGAGATTAAATACAAGG,0,1136909
fldAp,0.029411764705882353,33,33,ATCGCGCATCATCTTTGGAT,0,1078668
fldAp,0.029411764705882353,33,33,ATCATACTAATAGTCTGGAA,0,1095769
fldAp,0.029411764705882353,33,33,ATATACTTTTAAATGTGATA,0,1070032
fldAp,0.029411764705882353,33,33,ATATAAAATATTTCTACTTG,0,1185133
fldAp,0.029411764705882353,33,33,AGGTTCTTGGTCTGCATATA,0,1174876
fldAp,0.029411764705882353,33,33,AGGTAGTATATATGAGGGCG,0,1138855
fldAp,0.029411764705882353,33,33,AGGACCTGTGGAACAGCTTC,0,1135429
fldAp,0.029411764705882353,33,33,AGCCTTTTACGATTCTCAAG,0,1160132
fldAp,0.029411764705882353,33,33,ACTAAGAACAGAAATCACGT,0,1081448
fldAp,0.029411764705882353,33,33,ACGTATGGGCTCGCACGGGA,0,1095935
fldAp,0.029411764705882353,33,33,ACCAAGTGTCGTCAAATCCC,0,1087041
fldAp,0.029411764705882353,33,33,ACATTTGCAATTCAGCCGTT,0,1124419
fldAp,0.029411764705882353,33,33,ACATTATAATGCCAGGGCTT,0,1165083
fldAp,0.029411764705882353,33,33,ACAACTCTAGGATCCTACAC,0,1095223
fldAp,0.029411764705882353,33,33,AATAATTCTCCCCGGATGCG,0,1130310
fldAp,0.029411764705882353,33,33,AAGGCTAAGTAGGGCACGAG,0,1174731
fldAp,0.029411764705882353,33,33,AAGGCCGTAACAGCAGGAGA,0,1115828
fldAp,0.029411764705882353,33,33,AACCCGACCCGAGACTCCGT,0,1094811
fldAp,0.029411764705882353,33,33,AAATTGTTTCAACTAGCCTA,0,1088389
fldAp,0.030303030303030304,32,32,TTTGATTCCCTGACGTTTGA,0,1165058
fldAp,0.030303030303030304,32,32,TTGCGTGAAGGTCATTATAG,0,1085983
fldAp,0.030303030303030304,32,32,TTATTCCGCCAGTCGCCTTA,0,1152221
fldAp,0.030303030303030304,32,32,TGCGCTACGAGTCCCTGTTT,0,1140951
fldAp,0.030303030303030304,32,32,TGATTAAGCGACCTGTCGTA,0,1093797
fldAp,0.030303030303030304,32,32,TCTAGCGATTTCAGAAACTT,0,1130076
fldAp,0.030303030303030304,32,32,TCGTGTCACATCAACTTCCA,0,1155784
fldAp,0.030303030303030304,32,32,TCCTTATGATAAAATAGGCA,0,1123405
fldAp,0.030303030303030304,32,32,TCCAGTGATCCGGGCTCACT,0,1088486
fldAp,0.030303030303030304,32,32,TATAATAGCCGGTCGCCTAT,0,1077249
fldAp,0.030303030303030304,32,32,TAATGTAAGTGTCTCGGACT,0,1100852
fldAp,0.030303030303030304,32,32,GTTGGAGGGCGTGCATAACA,0,1181235
fldAp,0.030303030303030304,32,32,GTTCATGACTGGCAGATCCT,0,1103430
fldAp,0.030303030303030304,32,32,GTGGTAGGTGCTGTCCCTTG,0,1083280
fldAp,0.030303030303030304,32,32,GGTTCAATATGTGCGAGCTT,0,1120686
fldAp,0.030303030303030304,32,32,GGTAAGGACTATTGCTACTT,0,1067966
fldAp,0.030303030303030304,32,32,GGAAATTCGGGGAGCTGTAC,0,1182840
fldAp,0.030303030303030304,32,32,GACATCATCAAATGTGCCTT,0,1099176
fldAp,0.030303030303030304,32,32,CTGTCGAGCCTTCTACCGCG,0,1128967
fldAp,0.030303030303030304,32,32,CTGAGAGGGATCGACATCAA,0,1098390
fldAp,0.030303030303030304,32,32,CGGAACTCGGTGGCGACATG,0,1091198
fldAp,0.030303030303030304,32,32,CGATGATGCTGCTCGCCGTC,0,1074352
fldAp,0.030303030303030304,32,32,CGAACCGATAAGGACGCACG,0,1111730
fldAp,0.030303030303030304,32,32,CCTTTAGGTGTTCTTGTGTG,0,1104916
fldAp,0.030303030303030304,32,32,CCTCTCCAACCGGTTAGAAG,0,1096626
fldAp,0.030303030303030304,32,32,CATGGCTGTAGCGCAGGTAG,0,1074757
fldAp,0.030303030303030304,32,32,CAGGTATCCGTGTGTAATGT,0,1157831
fldAp,0.030303030303030304,32,32,ATCGTCGGGCTATGTAACTT,0,1175534
fldAp,0.030303030303030304,32,32,AGTCATCATGTTCGCAGTTA,0,1123844
fldAp,0.030303030303030304,32,32,AGCGGGGGGGTGCCTTCGGC,0,1067089
fldAp,0.030303030303030304,32,32,ACGGAGTGTCCATACATAGA,0,1120129
fldAp,0.030303030303030304,32,32,ACCGGGGCAAGTAGCAAGCG,0,1115813
fldAp,0.030303030303030304,32,32,AATTAGTTCTCGGATGGCCA,0,1074927
fldAp,0.030303030303030304,32,32,AAACGAGGATTAGAAAGCAT,0,1079389
fldAp,0.03125,31,31,TGGGGCCAACATCACAAGCT,0,1185182
fldAp,0.03125,31,31,TGAGAGACAAACTTAGGGTT,0,1080882
fldAp,0.03125,31,31,TCTTGGTCTACATCGACTCA,0,1143765
fldAp,0.03125,31,31,TCGTCGGTCTGTTCGTTCAT,0,1119477
fldAp,0.03125,31,31,TATGTCAGGTGGGGCGGGGT,0,1111731
fldAp,0.03125,31,31,TACCGTTATCGGCCGGGTTC,0,1065322
fldAp,0.03125,31,31,TACAGCGTTTTCTATCAACC,0,1118226
fldAp,0.03125,31,31,TAATAACTCCAACGGGAGTA,0,1116908
fldAp,0.03125,31,31,GTTGGGCCACCCACGCCTCT,0,1174817
fldAp,0.03125,31,31,GTGACCCGCGGCCTTTGCTT,0,1128439
fldAp,0.03125,31,31,GTCAAACATAGAGTTGTAAC,0,1125557
fldAp,0.03125,31,31,GTATCGTTCGCTCAACGGTA,0,1151468
fldAp,0.03125,31,31,GGTCGCGGACAGTCCACAAA,0,1089003
fldAp,0.03125,31,31,GGTATGGGCAAATCAGATCT,0,1079993
fldAp,0.03125,31,31,GGCCAGCGCGATCGGCTAAT,0,1136008
fldAp,0.03125,31,31,GCGGCAGAGACACGAGCTAG,0,1144706
fldAp,0.03125,31,31,GATACCTACTATCGTTCAAA,0,1101108
fldAp,0.03125,31,31,GAGCTATAATTCGCTGCCGT,0,1119881
fldAp,0.03125,31,31,GACTTCATTTCCTTGGGCTA,0,1116011
fldAp,0.03125,31,31,CTTAAGTAACCGGAGTCCAG,0,1180808
fldAp,0.03125,31,31,CTCCTCTCGCACCACGCGAC,0,1162738
fldAp,0.03125,31,31,CGCTGGAGCAAGACACAACA,0,1158259
fldAp,0.03125,31,31,CGAATAGGCAAATTGCAGGC,0,1081529
fldAp,0.03125,31,31,CCTGCCGTTAACGTCTAAGT,0,1182836
fldAp,0.03125,31,31,CCGACAGATGATTAGTTCAG,0,1080586
fldAp,0.03125,31,31,CCCATCAGTACTATGCGCCT,0,1104598
fldAp,0.03125,31,31,CCACTATGGCTCACCTATAC,0,1130918
fldAp,0.03125,31,31,CAAATCGGCTCGTATCCGGT,0,1095824
fldAp,0.03125,31,31,ATTAGCCCATCAGCAGACAA,0,1114025
fldAp,0.03125,31,31,ATGTGAGGATTTACGGACAC,0,1094441
fldAp,0.03125,31,31,ATGCGCTGCGTCATTACCAA,0,1144333
fldAp,0.03125,31,31,ATGCAACACCTTTGTTGCAA,0,1162008
fldAp,0.03125,31,31,ATACAAGCTGGTATTAAAAG,0,1157808
fldAp,0.03125,31,31,AGGGGGGGACATTTCAAATA,0,1120690
fldAp,0.03125,31,31,AGGGACCCTTATGTGGGCTG,0,1078890
fldAp,0.03125,31,31,AGCACGAGGATGATGCGCCC,0,1159045
fldAp,0.03125,31,31,AGACCGACAGGTGTCTTACC,0,1168502
fldAp,0.03125,31,31,ACCGGCAACACGGAACGTTC,0,1070661
fldAp,0.03125,31,31,ACCGACACTCACAATGTGCC,0,1091308
fldAp,0.03125,31,31,ACAGGGAGGTAACCAGGAAA,0,1088230
fldAp,0.03125,31,31,AAGCGACGGTGGGGCACCAC,0,1065628
fldAp,0.03125,31,31,AAACTGGGCGAAAGCCGGTT,0,1165160
fldAp,0.03125,31,31,AAAATGAAGACTCTGTTTCC,0,1083610
fldAp,0.03225806451612903,30,30,TTGATAAGCGGCATACGAAA,0,1158465
fldAp,0.03225806451612903,30,30,TTATACGTCCTGCAGTTATT,0,1132416
fldAp,0.03225806451612903,30,30,TTAGTATTATATTGAGGGGT,0,1166790
fldAp,0.03225806451612903,30,30,TTAGCGTAAAAATACGTGTT,0,1117435
fldAp,0.03225806451612903,30,30,TGTGGGTGTTAGTAGCAAGG,0,1071903
fldAp,0.03225806451612903,30,30,TCTGGGAGCATGTCACGTCA,0,1075320
fldAp,0.03225806451612903,30,30,TCGTCAAGACGCGAAGCTCT,0,1175521
fldAp,0.03225806451612903,30,30,TCATAATGTGCGCCCCAGTA,0,1072495
fldAp,0.03225806451612903,30,30,TATCAGTTTAAGATTGTGAC,0,1158407
fldAp,0.03225806451612903,30,30,TAGCATGGGTTTAAACCAAA,0,1089421
fldAp,0.03225806451612903,30,30,TACGTCCGGTCGTCAGAGCC,0,1143220
fldAp,0.03225806451612903,30,30,GTCCAACACTTCCGAACGTA,0,1172557
fldAp,0.03225806451612903,30,30,GGTATGCACCGTGATCGCTA,0,1065230
fldAp,0.03225806451612903,30,30,GGCAGACGGCATACCCACTG,0,1159551
fldAp,0.03225806451612903,30,30,GGAGTCGTAGTAGAAGAGAT,0,1066833
fldAp,0.03225806451612903,30,30,GCGCCCGGGAAATCTTGCAT,0,1162442
fldAp,0.03225806451612903,30,30,GCACGCGTTAGGTGTTGCGC,0,1163173
fldAp,0.03225806451612903,30,30,GCAAGACAGTGCGCCGGTGA,0,1067172
fldAp,0.03225806451612903,30,30,GAGGTGTCGCCTGCACAGGT,0,1074387
fldAp,0.03225806451612903,30,30,GAGGTACCAATACTGATCGT,0,1139233
fldAp,0.03225806451612903,30,30,GAGAAGTAATGCGCACGGAG,0,1103820
fldAp,0.03225806451612903,30,30,GACCTGTCACGTTACCGGCG,0,1131293
fldAp,0.03225806451612903,30,30,CTTTATTAGAATCCTAGGAA,0,1172163
fldAp,0.03225806451612903,30,30,CTTGCACCAGCGACCGCATA,0,1098213
fldAp,0.03225806451612903,30,30,CTGCCGACCTCGCGACCAGT,0,1081578
fldAp,0.03225806451612903,30,30,CTGCAGCACAACAAAGGACC,0,1153955
fldAp,0.03225806451612903,30,30,CTATCGCGATGCAGTAGCGG,0,1136957
fldAp,0.03225806451612903,30,30,CGTGCGGGAACACTGGACCA,0,1067108
fldAp,0.03225806451612903,30,30,CGCAGGCAGAGTAATAATTA,0,1164177
fldAp,0.03225806451612903,30,30,CCGATGTCGTGAGTGCAACA,0,1104393
fldAp,0.03225806451612903,30,30,CAGTGGGGCCTGGGGAGCCC,0,1185766
fldAp,0.03225806451612903,30,30,AGTTGTTGCCTGATATCGCG,0,1088240
fldAp,0.03225806451612903,30,30,AGTGATCGGACTCAAGAGCC,0,1142211
fldAp,0.03225806451612903,30,30,AGTGAAATACCCTGTTATGA,0,1092975
fldAp,0.03225806451612903,30,30,AGTATCTAGGATTCTATTGA,0,1119484
fldAp,0.03225806451612903,30,30,AGAGCTAAAATTTGATCCCG,0,1123471
fldAp,0.03225806451612903,30,30,ACCTCGACGCGAAAAGCATA,0,1163275
fldAp,0.03225806451612903,30,30,ACAGGGTTTGCCATCCGCTT,0,1159158
fldAp,0.03225806451612903,30,30,ACAGCACCCGGCCGGTCCCG,0,1114406
fldAp,0.03333333333333333,29,29,TTGAAACTTCCAGTGGGTAT,0,1123225
fldAp,0.03333333333333333,29,29,TTCCGTCAACGAGATAAATC,0,1128524
fldAp,0.03333333333333333,29,29,TGCGACAACTCACCTGGTGA,0,1186157
fldAp,0.03333333333333333,29,29,TGCCGTACATAATCAGGCCG,0,1170137
fldAp,0.03333333333333333,29,29,TGCACGTCGCGGATTACGAG,0,1092561
fldAp,0.03333333333333333,29,29,TGCAAAAGGTGTCCCCTCTG,0,1159328
fldAp,0.03333333333333333,29,29,TGAGCGAGCGCCCTAGAGGC,0,1130512
fldAp,0.03333333333333333,29,29,TCTGGTTTGTATCAGCAAGA,0,1069047
fldAp,0.03333333333333333,29,29,TCGTGAATTCCTCCGGTGAC,0,1147773
fldAp,0.03333333333333333,29,29,TCGCTCCACGGACTTCTCGA,0,1172637
fldAp,0.03333333333333333,29,29,TCCCTGAACGAAGGGTAGTA,0,1159561
fldAp,0.03333333333333333,29,29,TCATTGGGGCTGCATACCTC,0,1104979
fldAp,0.03333333333333333,29,29,TACGCTTGTACGGATGTAGA,0,1075976
fldAp,0.03333333333333333,29,29,TACGCTTAAGCAGTTGCAGA,0,1165852
fldAp,0.03333333333333333,29,29,GTCTTTATTTCGAATAGGAG,0,1128057
fldAp,0.03333333333333333,29,29,GTCCACTTCGCACGTAATTG,0,1065048
fldAp,0.03333333333333333,29,29,GTACGTCAAGGTGGGGACGC,0,1067071
fldAp,0.03333333333333333,29,29,GGGTTCGGTTTGGTCTAACC,0,1180705
fldAp,0.03333333333333333,29,29,GGAGCGTTATACCTCTGGAA,0,1092463
fldAp,0.03333333333333333,29,29,GGACAGTTTGTTTACGATGC,0,1102404
fldAp,0.03333333333333333,29,29,GCTAGGCAGCCGATCTCCGT,0,1153509
fldAp,0.03333333333333333,29,29,GCGGGCAGGATCTTTCGCAA,0,1185300
fldAp,0.03333333333333333,29,29,GCAGGCACCTGGCTCGAAAT,0,1143459
fldAp,0.03333333333333333,29,29,GATTCCGACCCCAATAAACA,0,1081690
fldAp,0.03333333333333333,29,29,GAGTGCCCCTGGTCTGCGGG,0,1139904
fldAp,0.03333333333333333,29,29,GACAGAGGGTTATCCTCAGT,0,1163043
fldAp,0.03333333333333333,29,29,GAATTCGTTCTGTATCTGTC,0,1074748
fldAp,0.03333333333333333,29,29,CTTTCATTCGCATAATGTTG,0,1174727
fldAp,0.03333333333333333,29,29,CTTCATGGGTAAATGAATAG,0,1117862
fldAp,0.03333333333333333,29,29,CTAATTCCTTGAACTCGTCG,0,1156646
fldAp,0.03333333333333333,29,29,CGTTCACTTGGACACATATA,0,1099838
fldAp,0.03333333333333333,29,29,CGGTGGCACAGTATGTGTGC,0,1112297
fldAp,0.03333333333333333,29,29,CGGAATCTGTAGTGCGACGA,0,1155451
fldAp,0.03333333333333333,29,29,CGATACTGACTCTATGGCCC,0,1095773
fldAp,0.03333333333333333,29,29,CGACATGTCAGTTGGAAGTA,0,1100142
fldAp,0.03333333333333333,29,29,CCTTTCTACTGGTCATACCG,0,1098122
fldAp,0.03333333333333333,29,29,CCGAGATTATGACGCTCACG,0,1074532
fldAp,0.03333333333333333,29,29,CCCTGCCTAGGTTTTGACGA,0,1175334
fldAp,0.03333333333333333,29,29,CATATGTGACTGGTCATAGT,0,1183684
fldAp,0.03333333333333333,29,29,CAAGGATGGTGGGTCAAGTA,0,1075330
fldAp,0.03333333333333333,29,29,ATTGACTCGTACAAGCGATG,0,1117279
fldAp,0.03333333333333333,29,29,ATGATGTTAATTCGGGTCCA,0,1156947
fldAp,0.03333333333333333,29,29,AGGGGGTCTCACTAACTACA,0,1074859
fldAp,0.03333333333333333,29,29,AGCGCGAATGTGTGACTCCG,0,1142727
fldAp,0.03333333333333333,29,29,AGCCCTGAACCAATAATCAA,0,1141266
fldAp,0.03333333333333333,29,29,AGAGTCTGAAGAAAATGCTA,0,1159579
fldAp,0.03333333333333333,29,29,AGAGAATTCTTCTGTTCATT,0,1099060
fldAp,0.03333333333333333,29,29,ACTCCAGTGTTACTACAGGA,0,1164067
fldAp,0.03333333333333333,29,29,ACGGGGCTAAACCCATAATA,0,1118167
fldAp,0.03333333333333333,29,29,AATAAATAATCCCACAGGGT,0,1069728
fldAp,0.03333333333333333,29,29,AAGGGTCAGTGTTACAGGCA,0,1174726
fldAp,0.03333333333333333,29,29,AAGAGGCGCCGCGTGCGTTG,0,1184027
fldAp,0.03333333333333333,29,29,AACGTCCGACCGTGAGTGAT,0,1158404
fldAp,0.03333333333333333,29,29,AACCTTACGCGCCGACTAAG,0,1073522
fldAp,0.03333333333333333,29,29,AACAGAGAATTCGGGCTTCA,0,1132780
fldAp,0.03333333333333333,29,29,AACACTTTTTAAGCGGGACA,0,1068935
fldAp,0.03333333333333333,29,29,AAATCGGATTAGACTCTAGT,0,1110381
fldAp,0.034482758620689655,28,28,TTTTAGGAGCCAGAAGAATT,0,1128684
fldAp,0.034482758620689655,28,28,TTTATCGTTGGCTCTAGAGA,0,1104343
fldAp,0.034482758620689655,28,28,TTCGCGGCGGCTCAGTCCTA,0,1169145
fldAp,0.034482758620689655,28,28,TTATCCCCGGCCAGCTAGCA,0,1063726
fldAp,0.034482758620689655,28,28,TGGTATTCACTACACTGGCT,0,1155208
fldAp,0.034482758620689655,28,28,TGGCAGAGGTTCCCAAGCCG,0,1179370
fldAp,0.034482758620689655,28,28,TGGATCTCATACGTATGTTG,0,1103347
fldAp,0.034482758620689655,28,28,TGGAGGCATGAACTGTTGAT,0,1073423
fldAp,0.034482758620689655,28,28,TGAAGGGATCTGCTCGAGGA,0,1064578
fldAp,0.034482758620689655,28,28,TCTTCCGCGCGGGTCATCGC,0,1167764
fldAp,0.034482758620689655,28,28,TCTCTAATGGCAACATGTGC,0,1116682
fldAp,0.034482758620689655,28,28,TCGAGCCACCGTAGTATTTT,0,1141904
fldAp,0.034482758620689655,28,28,TCGACTAGACTGTGAGTAGG,0,1164026
fldAp,0.034482758620689655,28,28,TATTATATCGCACCTAGGCA,0,1141297
fldAp,0.034482758620689655,28,28,TAGGCATCGTACGATCGCGT,0,1070034
fldAp,0.034482758620689655,28,28,TAGCTAATGCCACACGGCGA,0,1080866
fldAp,0.034482758620689655,28,28,GTTAACTCAATTATGCTTTC,0,1170206
fldAp,0.034482758620689655,28,28,GTAAGGGACTTGGCGTCGCA,0,1172014
fldAp,0.034482758620689655,28,28,GGACCTATCGGGGGGTAAAG,0,1093140
fldAp,0.034482758620689655,28,28,GCGGATTTGGTGGGGTACAG,0,1107003
fldAp,0.034482758620689655,28,28,GCCTATCGTGGTTAGTCTTT,0,1082059
fldAp,0.034482758620689655,28,28,GCCCAGCGGTGGCTTGAATA,0,1103529
fldAp,0.034482758620689655,28,28,GCAGACGTAAGGATTCATGA,0,1160564
fldAp,0.034482758620689655,28,28,GATAGCTGAAGGGTATGAGT,0,1178430
fldAp,0.034482758620689655,28,28,GAGATTATCTCTGCGTACTT,0,1167606
fldAp,0.034482758620689655,28,28,GACATTTGCTTAAAAAGAGC,0,1078041
fldAp,0.034482758620689655,28,28,CTGGTAAGCACACCCGCTTA,0,1068073
fldAp,0.034482758620689655,28,28,CTCTGCGTTTCTCGGCACTA,0,1131232
fldAp,0.034482758620689655,28,28,CTATTCGCTTCATGGTCTGA,0,1109928
fldAp,0.034482758620689655,28,28,CGGCAGCCTAGGACTGCGGG,0,1109367
fldAp,0.034482758620689655,28,28,CGCTCTTAGCCGACCAGGCT,0,1118278
fldAp,0.034482758620689655,28,28,CGCCCTTCTGCTCCATCTTC,0,1148994
fldAp,0.034482758620689655,28,28,CGAATTAGGGTATACAACAT,0,1123409
fldAp,0.034482758620689655,28,28,CCGGTGATGGGGTGAGCCTA,0,1162043
fldAp,0.034482758620689655,28,28,CCGGGAGAGGCCAACTTTAG,0,1150862
fldAp,0.034482758620689655,28,28,CCATCCCAAGGTATGTGTGA,0,1072300
fldAp,0.034482758620689655,28,28,CCACGCGAGGAAGCAAGGGA,0,1183525
fldAp,0.034482758620689655,28,28,CATACAGCTTACCCTCAGAC,0,1178308
fldAp,0.034482758620689655,28,28,ATTAGTCATGATGATGCTTC,0,1103338
fldAp,0.034482758620689655,28,28,ATCCTGGCTGTTTCGATCTC,0,1175971
fldAp,0.034482758620689655,28,28,ATCCGCCATCCGGGGCTAAA,0,1155358
fldAp,0.034482758620689655,28,28,ATATAGCTGTCGCACAATGA,0,1137787
fldAp,0.034482758620689655,28,28,ATAGGTCTGACGTTCTCAGG,0,1173282
fldAp,0.034482758620689655,28,28,ATAAACGCTCCGCGTGATTT,0,1065115
fldAp,0.034482758620689655,28,28,AGTATAACGGGGCAACTATT,0,1065323
fldAp,0.034482758620689655,28,28,AGTAGGAAAAATCCGGAAGG,0,1076985
fldAp,0.034482758620689655,28,28,AGCTTTTGCAAGGTTGGTAA,0,1083046
fldAp,0.034482758620689655,28,28,AGAGTAACTCACTGATGAAT,0,1092021
fldAp,0.034482758620689655,28,28,AGACTCTGCTGCAACATGAA,0,1169161
fldAp,0.034482758620689655,28,28,AGACCATCTGTCAGACCTTA,0,1095215
fldAp,0.034482758620689655,28,28,ACTGGACCGCATGGTCCCAA,0,1098292
fldAp,0.034482758620689655,28,28,ACTGCGCACACGTGCGACAA,0,1167270
fldAp,0.034482758620689655,28,28,AATAGCGGCTTGGCTTCACA,0,1116107
fldAp,0.034482758620689655,28,28,AACGAGGGCAGAGGCGATTG,0,1131657
fldAp,0.034482758620689655,28,28,AACAGCTAACCTACCGCACC,0,1121412
fldAp,0.03571428571428571,27,27,TTGGTAGTGCAGGTCCAGTC,0,1165382
fldAp,0.03571428571428571,27,27,TTGAGGAACCGAGAAGGAGT,0,1081453
fldAp,0.03571428571428571,27,27,TGTGTTGAGCTGTGCATCAT,0,1122105
fldAp,0.03571428571428571,27,27,TGCCGGGGTCACCATCCGAA,0,1099253
fldAp,0.03571428571428571,27,27,TGCAGCTGCAATGTTTAGAA,0,1157144
fldAp,0.03571428571428571,27,27,TGAGAACGACTGAAGACTTC,0,1164173
fldAp,0.03571428571428571,27,27,TCGCAAGACTCACGGAGGAC,0,1102401
fldAp,0.03571428571428571,27,27,TCACACCAAGCTAATAGTAT,0,1092859
fldAp,0.03571428571428571,27,27,GTCGGGGCATGGATCTGTCT,0,1103716
fldAp,0.03571428571428571,27,27,GTCCAGGAGAATGTTTGGAC,0,1117617
fldAp,0.03571428571428571,27,27,GTACTATTAACCTGCTGTGC,0,1148157
fldAp,0.03571428571428571,27,27,GGTTATCAAGCCATAACACG,0,1140137
fldAp,0.03571428571428571,27,27,GGTCCCCGGTCCCATCTAGT,0,1103604
fldAp,0.03571428571428571,27,27,GGTAACTAAAGAATTACTGG,0,1107876
fldAp,0.03571428571428571,27,27,GGGTCTATCACTAGAAGCAA,0,1184146
fldAp,0.03571428571428571,27,27,GGGTAAAACTCTGCAAGCAG,0,1100718
fldAp,0.03571428571428571,27,27,GGCTTCCGAGACGGCGTTGG,0,1183313
fldAp,0.03571428571428571,27,27,GGATCGTGGATTTTTTGTAC,0,1140063
fldAp,0.03571428571428571,27,27,GGAACCTTGGGAAACTCCGA,0,1181744
fldAp,0.03571428571428571,27,27,GCCTGGACACCACTCACGCC,0,1097573
fldAp,0.03571428571428571,27,27,GCAAAATGCGCTTATCGTTT,0,1077849
fldAp,0.03571428571428571,27,27,GATGTGTCTGGAGTAGTTAG,0,1186278
fldAp,0.03571428571428571,27,27,GATCGTCCTCGCAGGTCCTT,0,1102403
fldAp,0.03571428571428571,27,27,GAGAATGCGACGTTATTTGA,0,1098149
fldAp,0.03571428571428571,27,27,GACTCACAATCCAGCCACCG,0,1143006
fldAp,0.03571428571428571,27,27,GAATCTAGATTTTCATAACG,0,1078773
fldAp,0.03571428571428571,27,27,CTGCCTGAAGAAGTCTCTCT,0,1096039
fldAp,0.03571428571428571,27,27,CTCCGACTATATGGCCATTC,0,1171233
fldAp,0.03571428571428571,27,27,CTCCCTGTGGCTTCTCTGAG,0,1110466
fldAp,0.03571428571428571,27,27,CGTTTTTGTGCTGCCTTATG,0,1071170
fldAp,0.03571428571428571,27,27,CGTGCAGGGTTAGACTCGAT,0,1145671
fldAp,0.03571428571428571,27,27,CGGGGTTTCGATGTTCGTCT,0,1182376
fldAp,0.03571428571428571,27,27,CGGCTAACACCAGGAATCTG,0,1155449
fldAp,0.03571428571428571,27,27,CGCGCGTCAATGTTGGGAAG,0,1071524
fldAp,0.03571428571428571,27,27,CCTTTACACGGCGCTAATCT,0,1120154
fldAp,0.03571428571428571,27,27,CCGTATGCGCGGTTATAGTT,0,1130513
fldAp,0.03571428571428571,27,27,CCGGTAGGATGCATGGCATA,0,1181500
fldAp,0.03571428571428571,27,27,CCCCTCTTGTTTTCCCGGCA,0,1074254
fldAp,0.03571428571428571,27,27,CAGATCCAAGTTGGTCTGGA,0,1137137
fldAp,0.03571428571428571,27,27,CACTAGGTCAGTATTCCGGC,0,1063765
fldAp,0.03571428571428571,27,27,CACGTAGCATTTGGTTCTCC,0,1108262
fldAp,0.03571428571428571,27,27,CAACTGCACAGGACTTGATC,0,1152746
fldAp,0.03571428571428571,27,27,ATTCATTGATGGCTTAAAGT,0,1153003
fldAp,0.03571428571428571,27,27,ATTCAGCCCGTTCAAAAGGT,0,1131504
fldAp,0.03571428571428571,27,27,ATGCTGTACCGGGCACTTCT,0,1171326
fldAp,0.03571428571428571,27,27,ATGCCATGAGCTTCGCCCTG,0,1073176
fldAp,0.03571428571428571,27,27,ATCTGCTGCAACAGGTACAG,0,1179221
fldAp,0.03571428571428571,27,27,ATCGAGAACTCTACGTCGTA,0,1076175
fldAp,0.03571428571428571,27,27,ATCAATGCACGGGTGTCGCG,0,1077250
fldAp,0.03571428571428571,27,27,ATATCATGGTTTATCCTGCG,0,1145903
fldAp,0.03571428571428571,27,27,ATACCACAAATAGTGTGATG,0,1176604
fldAp,0.03571428571428571,27,27,ATAACTGAGTCAATTAACCA,0,1099852
fldAp,0.03571428571428571,27,27,ATAAAAAACGCTACAAAACA,0,1159749
fldAp,0.03571428571428571,27,27,AGTTCCGCGTAGTGAATCAC,0,1096799
fldAp,0.03571428571428571,27,27,AGCGGTTGCGACTCTCCCAT,0,1087086
fldAp,0.03571428571428571,27,27,AGCCATGGCTGGTCTCAGAA,0,1099573
fldAp,0.03571428571428571,27,27,ACTTTTCTTGTTGCCAATCA,0,1128628
fldAp,0.03571428571428571,27,27,ACTGACCGCGTCGGCGCGGG,0,1083533
fldAp,0.03571428571428571,27,27,ACGTGCTCGCGTAATTTATA,0,1170643
fldAp,0.03571428571428571,27,27,ACGTCTTCGGTCAGGGTTTA,0,1090851
fldAp,0.03571428571428571,27,27,ACGCGGAGCACGTGAAATCC,0,1177593
fldAp,0.03571428571428571,27,27,ACGCAGTTCTGATACTCCCA,0,1090985
fldAp,0.03571428571428571,27,27,ACGAGAAGACTACCAGAACC,0,1080841
fldAp,0.03571428571428571,27,27,ACCTAATAGTACCATTCGGT,0,1136175
fldAp,0.03571428571428571,27,27,ACCCAAAGGAAGAGAGTGTT,0,1119471
fldAp,0.03571428571428571,27,27,AATCTGAAGGACTTTACCCA,0,1145512
fldAp,0.037037037037037035,26,26,TTGCGAGCTCGTGGGACATC,0,1107766
fldAp,0.037037037037037035,26,26,TTATCGAAAGGAGTCTAGGT,0,1079742
fldAp,0.037037037037037035,26,26,TTATAGTAAATGGCTGAACA,0,1112223
fldAp,0.037037037037037035,26,26,TTAATTCACCTATTAGTTCG,0,1067283
fldAp,0.037037037037037035,26,26,TGGGAGAACTGAAGTCGTTA,0,1172712
fldAp,0.037037037037037035,26,26,TGCATAGGTGGAAACATATC,0,1107340
fldAp,0.037037037037037035,26,26,TGCAGGCTCCGGTGGGACTT,0,1114385
fldAp,0.037037037037037035,26,26,TGAGTTTAGCCTTGGACAAT,0,1083126
fldAp,0.037037037037037035,26,26,TGAACATGCGCTGCGGGTAC,0,1147421
fldAp,0.037037037037037035,26,26,TCTGGTGTCTTCTTACAATA,0,1068650
fldAp,0.037037037037037035,26,26,TCTCTGTAGCTTGGATCGGA,0,1115489
fldAp,0.037037037037037035,26,26,TCTAACGGGATGACGATTAG,0,1069691
fldAp,0.037037037037037035,26,26,TCGTATGGCTAGCCCATTAC,0,1114381
fldAp,0.037037037037037035,26,26,TCGCAGCTACAGGTCTAGGG,0,1108440
fldAp,0.037037037037037035,26,26,TCATCCCCTTTAGCCCTCGT,0,1078562
fldAp,0.037037037037037035,26,26,TAGGCCCGAGGCTTTATGTT,0,1065901
fldAp,0.037037037037037035,26,26,TACAAGTCACGATATACTAC,0,1066268
fldAp,0.037037037037037035,26,26,GTGAAGAGCGTTATCAGCTC,0,1104440
fldAp,0.037037037037037035,26,26,GTCGCGGACGTATTTTCGAA,0,1115171
fldAp,0.037037037037037035,26,26,GTCCGACCTCAGATTATCAT,0,1175862
fldAp,0.037037037037037035,26,26,GTATCAATTTGTCAGCAGGA,0,1078496
fldAp,0.037037037037037035,26,26,GGTCATCGAGGTAGTACGCT,0,1140554
fldAp,0.037037037037037035,26,26,GGGCTCAAAGGTTCATCAAG,0,1155060
fldAp,0.037037037037037035,26,26,GGCATTAGCATATGCTGCAC,0,1122033
fldAp,0.037037037037037035,26,26,GCTTCGTTTGTTTACGTTTC,0,1081698
fldAp,0.037037037037037035,26,26,GCGTCCAATTGGCCGTCGGA,0,1115891
fldAp,0.037037037037037035,26,26,GCGATCATCGCTACAGATCC,0,1118157
fldAp,0.037037037037037035,26,26,GATTCCCTGTCCAGACGCAA,0,1178854
fldAp,0.037037037037037035,26,26,GATGGACTCTTGTGTGAGTA,0,1103743
fldAp,0.037037037037037035,26,26,GAGGAGAGCCATATCCAAAG,0,1156351
fldAp,0.037037037037037035,26,26,GAGCGTTTTTTCGAATATCT,0,1112709
fldAp,0.037037037037037035,26,26,GAGACGCATTGAGCTGGTTA,0,1158909
fldAp,0.037037037037037035,26,26,GAATTTGCCCTTCACAAGCA,0,1180114
fldAp,0.037037037037037035,26,26,GAATGGACACGAGTCACTTA,0,1063885
fldAp,0.037037037037037035,26,26,GAATGACCAGCGTCGGCTGT,0,1077452
fldAp,0.037037037037037035,26,26,GAAGTGCATGCATCTCTCGT,0,1091428
fldAp,0.037037037037037035,26,26,GAAGCTTCCATCTAGCGGAT,0,1103901
fldAp,0.037037037037037035,26,26,CTTCAGGTGCGTTACGCGAG,0,1096600
fldAp,0.037037037037037035,26,26,CTGCCGCAAGCACAACCTCC,0,1176986
fldAp,0.037037037037037035,26,26,CTCTCAGAGGCCTATGAACG,0,1110279
fldAp,0.037037037037037035,26,26,CTCAGTTGCCTGAGTTACGC,0,1102059
fldAp,0.037037037037037035,26,26,CTCACCCCCGAAGGTTCACA,0,1082765
fldAp,0.037037037037037035,26,26,CGTTCGAGAAACGGATGCTT,0,1169524
fldAp,0.037037037037037035,26,26,CGGTTTGCGATCGTCTGGAG,0,1102636
fldAp,0.037037037037037035,26,26,CGGCTATAGGTGGTTGCCGG,0,1101537
fldAp,0.037037037037037035,26,26,CGCCTGGGGATAGGGAAAAG,0,1084728
fldAp,0.037037037037037035,26,26,CGCATCTTTTAGCACGAGCG,0,1104501
fldAp,0.037037037037037035,26,26,CGATCACAAGGGTCCTGACG,0,1120425
fldAp,0.037037037037037035,26,26,CCCCAACCTGGTGAAAAACC,0,1158255
fldAp,0.037037037037037035,26,26,CATTCCTAGACACCCATTCT,0,1142255
fldAp,0.037037037037037035,26,26,CATTAAACGTAGCGCAAGAA,0,1114712
fldAp,0.037037037037037035,26,26,CATATCAGGCCGGGGCTTGT,0,1149257
fldAp,0.037037037037037035,26,26,CATAAGTGAGGGAGAGACCC,0,1121142
fldAp,0.037037037037037035,26,26,CAGTGTGTTGCATCATTACT,0,1096399
fldAp,0.037037037037037035,26,26,CAGTACGCAGGCGCGTGTCG,0,1097139
fldAp,0.037037037037037035,26,26,CACCGAAAAATACTTGGGTT,0,1170450
fldAp,0.037037037037037035,26,26,CACATGCGCGGCAGTTAGGT,0,1066836
fldAp,0.037037037037037035,26,26,CAATAGCGCGCGAGTGAATT,0,1065341
fldAp,0.037037037037037035,26,26,CAAGTGATCTCGAACCCGCG,0,1094443
fldAp,0.037037037037037035,26,26,ATATAGGAGTCCGGGCACTG,0,1163177
fldAp,0.037037037037037035,26,26,ATACGGCGTACGTCGAGTAT,0,1112785
fldAp,0.037037037037037035,26,26,AGTCTTAACCTGGGATCGTG,0,1087255
fldAp,0.037037037037037035,26,26,AGAGAGAAGATAGCTTTACC,0,1075975
fldAp,0.037037037037037035,26,26,AGAGACACCACCGAACACGC,0,1071867
fldAp,0.037037037037037035,26,26,ACGCGTGGCTCACTCGACTA,0,1137093
fldAp,0.037037037037037035,26,26,ACCTCATAGGGTAGCGACGT,0,1137613
fldAp,0.037037037037037035,26,26,ACCGGATTCGCTTGCCTCTT,0,1097168
fldAp,0.037037037037037035,26,26,ACACTCCGTTCTATGGGATA,0,1128044
fldAp,0.037037037037037035,26,26,AATCAGATGTCGAGCACCAC,0,1120192
fldAp,0.037037037037037035,26,26,AAGGGTCGTTCGAAGCCCGT,0,1170028
fldAp,0.037037037037037035,26,26,AAGCTACGAGGGGTCTCAAC,0,1079895
fldAp,0.037037037037037035,26,26,AACGAGGAACAAGCTGCATA,0,1143931
fldAp,0.037037037037037035,26,26,AAATACTTACAATTGCTTCC,0,1084218
fldAp,0.037037037037037035,26,26,AAAGAGTAGAGGCGTGCCTG,0,1154419
fldAp,0.038461538461538464,25,25,TTGACCCGTACTTAGATAGA,0,1066452
fldAp,0.038461538461538464,25,25,TTGAAAAGCAACGCAGATGC,0,1125878
fldAp,0.038461538461538464,25,25,TTCGTTGAGTTAATGTTTGT,0,1185354
fldAp,0.038461538461538464,25,25,TTCGATTCCCCACTGGAGAG,0,1102237
fldAp,0.038461538461538464,25,25,TTCCCACACTGAGGTCGAGT,0,1174535
fldAp,0.038461538461538464,25,25,TTACGATCCTGTTGACGTCT,0,1086697
fldAp,0.038461538461538464,25,25,TTAAGTAAGGTTCACGTTAT,0,1075979
fldAp,0.038461538461538464,25,25,TTAAACATTCTTCGGTCATT,0,1120397
fldAp,0.038461538461538464,25,25,TGGGACTTCTTACACGGAAT,0,1118625
fldAp,0.038461538461538464,25,25,TGGCCGCTTCCGGCTGGTGC,0,1130064
fldAp,0.038461538461538464,25,25,TGCCCTCAGTTTGCTAAAGT,0,1074353
fldAp,0.038461538461538464,25,25,TGAAAGGCATCGTTTGTAAC,0,1064189
fldAp,0.038461538461538464,25,25,TCTGCAATTGCGGATACGTC,0,1175697
fldAp,0.038461538461538464,25,25,TCGCGCTCTAGTCGGCATCA,0,1122696
fldAp,0.038461538461538464,25,25,TCCGGTTAAGCTAACAACAT,0,1174732
fldAp,0.038461538461538464,25,25,TCAGTAGTTCCTAGAACAAA,0,1132980
fldAp,0.038461538461538464,25,25,TCAGCCGCGAATCCACCGAT,0,1128187
fldAp,0.038461538461538464,25,25,TAGCTGGGACAGAGTATAGA,0,1071092
fldAp,0.038461538461538464,25,25,TACTTAAACTCGGACCTCTG,0,1122149
fldAp,0.038461538461538464,25,25,TACCGGTAGACTCAGGTCAC,0,1162324
fldAp,0.038461538461538464,25,25,TAATACAGATGGTAACGGTA,0,1120682
fldAp,0.038461538461538464,25,25,GTTGTGTGGTGAGTATGGAC,0,1158124
fldAp,0.038461538461538464,25,25,GTTCTGTTGGGATCGTAGTA,0,1139907
fldAp,0.038461538461538464,25,25,GTGTCCCTCAGTTTAATGCC,0,1143937
fldAp,0.038461538461538464,25,25,GTGCTCACCACCGAGTGCCC,0,1121609
fldAp,0.038461538461538464,25,25,GGTCACGAATTATGTCATGC,0,1114032
fldAp,0.038461538461538464,25,25,GGTAGGTTGTCACCATTTAC,0,1116280
fldAp,0.038461538461538464,25,25,GGGTTCCAGGCGCCTTGCGA,0,1067200
fldAp,0.038461538461538464,25,25,GGGGTCCCACTAATCTTAGG,0,1140253
fldAp,0.038461538461538464,25,25,GGGCGTCTCGCCTACCCCGC,0,1140562
fldAp,0.038461538461538464,25,25,GGGCAGTGGAAAAGCAGTAT,0,1089012
fldAp,0.038461538461538464,25,25,GGCTACGAGTTGAGAATAAG,0,1163856
fldAp,0.038461538461538464,25,25,GGCGGCGGTATCAGATGCTG,0,1063619
fldAp,0.038461538461538464,25,25,GGCCAGTGAGTAGAGCGCAA,0,1174089
fldAp,0.038461538461538464,25,25,GGAGGAATACGGCGGCATCA,0,1160328
fldAp,0.038461538461538464,25,25,GGAAGGGTTAGAGTCGGGAA,0,1170139
fldAp,0.038461538461538464,25,25,GCTGCTTACGTCCAATGATG,0,1084994
fldAp,0.038461538461538464,25,25,GCCCACGCCTGCAACTTAAA,0,1097784
fldAp,0.038461538461538464,25,25,GCAGTTTCGACCACGCTCAC,0,1083264
fldAp,0.038461538461538464,25,25,GCAGATAGGTAACGCATTGG,0,1136900
fldAp,0.038461538461538464,25,25,GATTCCTGGCGGTTTTAAGG,0,1155344
fldAp,0.038461538461538464,25,25,GATCTACGGGTAGAGAGAAC,0,1099089
fldAp,0.038461538461538464,25,25,GAGTGCTATGAAAGCTGGCC,0,1112477
fldAp,0.038461538461538464,25,25,GAGTAGTTATTCTAGATTTG,0,1071294
fldAp,0.038461538461538464,25,25,GAGGGTTCAAGTGGCTGACT,0,1071081
fldAp,0.038461538461538464,25,25,GACTCTGGCCGAGAGCGGTA,0,1098500
fldAp,0.038461538461538464,25,25,GACGGGGGCTTTTACTACAA,0,1123082
fldAp,0.038461538461538464,25,25,GACCCTTACTGAATAGAATA,0,1170977
fldAp,0.038461538461538464,25,25,GAAACGGGGCATAGCGACCA,0,1068081
fldAp,0.038461538461538464,25,25,CTGTAAGAGCCATGTTTTAT,0,1139231
fldAp,0.038461538461538464,25,25,CTACCAAAGACTCACCGGTG,0,1080867
fldAp,0.038461538461538464,25,25,CGCTAAGTGGATGTCGGATA,0,1086844
fldAp,0.038461538461538464,25,25,CGATTTGCATGTCTAACTTA,0,1122583
fldAp,0.038461538461538464,25,25,CCTCTAAGTCTAGAGCGGGG,0,1102343
fldAp,0.038461538461538464,25,25,CCGGCCATGGGGTAAGAGAC,0,1098429
fldAp,0.038461538461538464,25,25,CCGCTGGGCAGGGAGGCGTT,0,1169360
fldAp,0.038461538461538464,25,25,CCGAGGTTAGCGTCGCTCCT,0,1122428
fldAp,0.038461538461538464,25,25,CCCTTCTCGGGGATCACGAG,0,1063286
fldAp,0.038461538461538464,25,25,CCCGGAATGTACCCGACTGT,0,1063476
fldAp,0.038461538461538464,25,25,CCCAGCGCTTGATGCGTTAC,0,1105167
fldAp,0.038461538461538464,25,25,CCCAGAGCCGGCTCCTATTG,0,1163739
fldAp,0.038461538461538464,25,25,CACGCGCTCATCGAAGACCT,0,1134413
fldAp,0.038461538461538464,25,25,CAATCTGTCTCTCCGCATCC,0,1173073
fldAp,0.038461538461538464,25,25,CAAACGCAGTCTTCCGCGGA,0,1094507
fldAp,0.038461538461538464,25,25,ATTGGGTGATCCTTAACTCT,0,1105683
fldAp,0.038461538461538464,25,25,ATTCGATCGACGAGGAGAAA,0,1105062
fldAp,0.038461538461538464,25,25,ATTCACAAACGTAGTCAGGG,0,1067972
fldAp,0.038461538461538464,25,25,ATTATAGATCACCGACACAT,0,1133060
fldAp,0.038461538461538464,25,25,ATGGGTTTACAGGCTCACAA,0,1160663
fldAp,0.038461538461538464,25,25,ATGGGTCCTCACCGTACAAT,0,1173847
fldAp,0.038461538461538464,25,25,ATAGCAAGTTTTCAGGGCCC,0,1081306
fldAp,0.038461538461538464,25,25,AGTTGGCCAGGCTATCGCGT,0,1147008
fldAp,0.038461538461538464,25,25,AGTCTTATCACAGGACCTTT,0,1070162
fldAp,0.038461538461538464,25,25,AGGTGGTCGGCCAGCTTCTC,0,1138814
fldAp,0.038461538461538464,25,25,AGGCGAACCCCAGTAGTTAG,0,1181173
fldAp,0.038461538461538464,25,25,AGCTAATGAGGCAGTAAGGA,0,1064679
fldAp,0.038461538461538464,25,25,ACTGCACGGGAATGAGACCA,0,1114676
fldAp,0.038461538461538464,25,25,ACTAACCTTCGCCATTAGCG,0,1073280
fldAp,0.038461538461538464,25,25,ACGGAGGCCATCGCACGTGG,0,1183948
fldAp,0.038461538461538464,25,25,ACGGACGTATTAAGCACGAA,0,1071673
fldAp,0.038461538461538464,25,25,AATGTCCCAGGTAGGGCCTC,0,1109110
fldAp,0.038461538461538464,25,25,AAGCCCTCTCTCCGGCCGCC,0,1122693
fldAp,0.038461538461538464,25,25,AACTATCGCTCCTGCACACA,0,1072408
fldAp,0.038461538461538464,25,25,AAAGGTGTTGTAGTCCCATG,0,1185626
fldAp,0.04,24,24,TTTTTAGCAGCAACTATCTG,0,1126725
fldAp,0.04,24,24,TTTTGTACTTCTCGGCCGGG,0,1158883
fldAp,0.04,24,24,TTTGTGAACTTCGTTAGATT,0,1093471
fldAp,0.04,24,24,TTTCCAAGGGTCCGCCGTGC,0,1163667
fldAp,0.04,24,24,TTTCAAGTAATCGGTTAGCC,0,1087164
fldAp,0.04,24,24,TTCTAATCTGTGCCTGTTCG,0,1123294
fldAp,0.04,24,24,TTAGACCGCGGGCAAGCCGT,0,1088378
fldAp,0.04,24,24,TGTGTCGTTGCGTTTAGGTT,0,1073682
fldAp,0.04,24,24,TGTCGGCCCGGGCCAAGATA,0,1184485
fldAp,0.04,24,24,TGGGTGGCGTGCGGAAAGGT,0,1079082
fldAp,0.04,24,24,TGGCCCTGGCAAAGTTCGTT,0,1110416
fldAp,0.04,24,24,TGGAATTGGAAATACAATAC,0,1087175
fldAp,0.04,24,24,TGCCTCCGCAGGTCAGACCT,0,1075240
fldAp,0.04,24,24,TGCCGTCATCTGCATGGCCA,0,1161426
fldAp,0.04,24,24,TGCATCCCGCTACTGCCATT,0,1186006
fldAp,0.04,24,24,TGATATCAACGGTGGCATTA,0,1179602
fldAp,0.04,24,24,TGAGAGTTCATTTTCATATC,0,1165066
fldAp,0.04,24,24,TCTCCTGCTCTATGCACTGG,0,1181948
fldAp,0.04,24,24,TCTCAACAGGCCCTGTTTTA,0,1128815
fldAp,0.04,24,24,TCTAGCCGGGGCACATTGGC,0,1075425
fldAp,0.04,24,24,TCGTTAAGCTAAAATACCTA,0,1119048
fldAp,0.04,24,24,TCGGGGGCTACGAACCTAAT,0,1150907
fldAp,0.04,24,24,TCGGGAAAAACGGCTAGCTT,0,1092968
fldAp,0.04,24,24,TCGACGGCCGTGCGCCGGTC,0,1106582
fldAp,0.04,24,24,TCGAACAGTGACACCCGAAG,0,1183662
fldAp,0.04,24,24,TCAGCAGAGTCTCATGCCTC,0,1103328
fldAp,0.04,24,24,TATTATTCTGTTGCACGCGT,0,1167511
fldAp,0.04,24,24,TAGCTGCTCACGTGGGGGCA,0,1143292
fldAp,0.04,24,24,TACAAATAAGGGTAGACTAT,0,1120606
fldAp,0.04,24,24,TAAGCCAGCTGGGTCCGGTC,0,1155852
fldAp,0.04,24,24,GTTCAACGAAGGACGCGATC,0,1101021
fldAp,0.04,24,24,GTGGAGAATATGCGTGTGAT,0,1090210
fldAp,0.04,24,24,GTGCAATCGGAATGGTTGGA,0,1132704
fldAp,0.04,24,24,GTCAAGGTTCGTTGGCTCTG,0,1166456
fldAp,0.04,24,24,GTATTATCAACGTCTTGAAC,0,1178726
fldAp,0.04,24,24,GTAGCCTTTTCGCCCACCCA,0,1092707
fldAp,0.04,24,24,GGTATGCTTGTAAGCTTGTA,0,1144244
fldAp,0.04,24,24,GGGTCAACAACCTTTACTCA,0,1104893
fldAp,0.04,24,24,GGGGCCAAATGGCATCCGGT,0,1087594
fldAp,0.04,24,24,GGGGCAGACTTTTACCCAAT,0,1123548
fldAp,0.04,24,24,GGGAAGAGGGGGGTTTCGAA,0,1079890
fldAp,0.04,24,24,GGCGAGCGTTTCGCAGGGGG,0,1110712
fldAp,0.04,24,24,GGAGGGGCAAGGCCGACCCC,0,1181841
fldAp,0.04,24,24,GGACGACCGTCAACCTATCA,0,1174806
fldAp,0.04,24,24,GGACAGGGCTCAGCGGCGTT,0,1069125
fldAp,0.04,24,24,GGACACCGACTACGCGTACG,0,1106836
fldAp,0.04,24,24,GCTGCGCAAAAGTCAAAGAT,0,1098397
fldAp,0.04,24,24,GCTCCCCTGATATGGGAGAG,0,1152308
fldAp,0.04,24,24,GCGTTGGCAGGCCAGAAACG,0,1102493
fldAp,0.04,24,24,GCCCCTTGAGTGATTGTGTA,0,1147193
fldAp,0.04,24,24,GCCATTGGGACGCGGTCCTT,0,1081836
fldAp,0.04,24,24,GCCAGAATTTAGAACGAAGG,0,1129253
fldAp,0.04,24,24,GAGTAATGTGGGTAAACATC,0,1116311
fldAp,0.04,24,24,GAGGGCGCTGAACACGTTAT,0,1172718
fldAp,0.04,24,24,GAATGTGGGCTGGGCCTTTT,0,1131468
fldAp,0.04,24,24,CTTTGTTTCATCTTCGCTAT,0,1123093
fldAp,0.04,24,24,CTTGTGGGTGTGGGGTTCAA,0,1092642
fldAp,0.04,24,24,CTTGTACCATTAGGAACTAT,0,1140542
fldAp,0.04,24,24,CTTCTCACTGTTGGTCCATA,0,1177739
fldAp,0.04,24,24,CTGTTCTACGTAGCTCAGTG,0,1090581
fldAp,0.04,24,24,CTCCGGGCCGTACCACGCAT,0,1142857
fldAp,0.04,24,24,CTCATTACTGCGCGATTGTA,0,1147547
fldAp,0.04,24,24,CTCATGCGGCTGGTCTAAAG,0,1157227
fldAp,0.04,24,24,CTATCTTGCTCTTGAAGTAC,0,1170461
fldAp,0.04,24,24,CTAACGCAATGTCTACCGAG,0,1096982
fldAp,0.04,24,24,CTAACCGACTCTCAGGGCAG,0,1074741
fldAp,0.04,24,24,CGTTTCATTTTTCCCGATTC,0,1065471
fldAp,0.04,24,24,CGCTCGTATTAGGCAAGGAG,0,1130017
fldAp,0.04,24,24,CGATGGAAACCGCGGTCTCA,0,1115644
fldAp,0.04,24,24,CGACGAGGACCGTAGGCAGT,0,1171896
fldAp,0.04,24,24,CCTTAAGGGACTTTTCATCC,0,1088537
fldAp,0.04,24,24,CCGTATTAAGTACGGTCATA,0,1163590
fldAp,0.04,24,24,CCCACTCACTGCTCACCGTG,0,1072561
fldAp,0.04,24,24,CCAAGGGCGCATATGTGTGG,0,1182602
fldAp,0.04,24,24,CATCATAGTGTAAAAGACCG,0,1156508
fldAp,0.04,24,24,CATAACGACGGACCCCGAGT,0,1100725
fldAp,0.04,24,24,CATAAACATAAAAGCTGGAC,0,1101667
fldAp,0.04,24,24,CAGGTAACCCGTGGCCCTGA,0,1145515
fldAp,0.04,24,24,CACTGGTCGCGGTCTCGTTC,0,1094946
fldAp,0.04,24,24,CACATGTCTCCATCAACAAT,0,1065754
fldAp,0.04,24,24,CAACACGTGAAAGGAAGCGC,0,1115713
fldAp,0.04,24,24,ATTGGCCCTTGCGGGGGGCG,0,1088587
fldAp,0.04,24,24,ATTCAGTAGGGCATCGGTCA,0,1076241
fldAp,0.04,24,24,ATTCAGGGAGTTACGCTTAA,0,1124249
fldAp,0.04,24,24,ATGTGTGGTTATTGTAAGTA,0,1141887
fldAp,0.04,24,24,ATGGGTTTCTTCAAGGCAAG,0,1107983
fldAp,0.04,24,24,ATCGTCATGTCGATGGGCGT,0,1081118
fldAp,0.04,24,24,ATATGGGGCGAACGATTGAA,0,1079081
fldAp,0.04,24,24,ATAGTCTGACTTGCTTGGAT,0,1148793
fldAp,0.04,24,24,AGTAGTTACCGAGAGGCACA,0,1115354
fldAp,0.04,24,24,AGCGTGGCACCTCCGTGCTT,0,1072308
fldAp,0.04,24,24,AGAGCCTGGATCGGGTTTGT,0,1065952
fldAp,0.04,24,24,AGAAACCCCGGGCCTGGCAG,0,1064717
fldAp,0.04,24,24,ACTTGCTGGTAGGTCAGGTA,0,1115292
fldAp,0.04,24,24,ACTGATCGGCCTGGTTGGTT,0,1113886
fldAp,0.04,24,24,ACTGACCGGTATGTTACACA,0,1071731
fldAp,0.04,24,24,ACCCGGACTTAGGTGCAGTT,0,1175011
fldAp,0.04,24,24,ACCCATGGTCGGCGCACGGT,0,1159196
fldAp,0.04,24,24,ACATACCATACCCTCGGGAG,0,1131029
fldAp,0.04,24,24,ACACGTGCGTCTATATATGG,0,1078240
fldAp,0.04,24,24,AATGGTCTATAATTCCACTC,0,1084374
fldAp,0.04,24,24,AATGACTGGGCAAAGTTTTG,0,1131442
fldAp,0.04,24,24,AATCCCGGTATTAGCTGTGT,0,1135758
fldAp,0.04,24,24,AATAGATCCGTAAGACTAGA,0,1170449
fldAp,0.04,24,24,AATACGCCGTAGATTGTGGC,0,1148429
fldAp,0.04,24,24,AAGGTACGCTGCCCCAGACA,0,1117704
fldAp,0.04,24,24,AAGGCGGAATAAATATAAGT,0,1130080
fldAp,0.04,24,24,AACTGATTCCCGTCAGACTA,0,1166607
fldAp,0.04,24,24,AACGGCAGGGCTACTGAACT,0,1142804
fldAp,0.04,24,24,AACCCCTAAGCAAGGTCCGA,0,1087609
fldAp,0.04,24,24,AACAGCTACATTAGAGCGGA,0,1109370
fldAp,0.04,24,24,AAACACCCACCAGCAGCCGT,0,1146301
fldAp,0.04,24,24,AAAAGATAGCGATCATTCCC,0,1079392
fldAp,0.041666666666666664,23,23,TTTCATCATGGCGCACGGAA,0,1096396
fldAp,0.041666666666666664,23,23,TTGCCCCGCTCATGCCACGG,0,1164523
fldAp,0.041666666666666664,23,23,TTGATACGCTCTAAGTGAGT,0,1151620
fldAp,0.041666666666666664,23,23,TTCGGTGACGGCCCCCTGCT,0,1141229
fldAp,0.041666666666666664,23,23,TTAGTGCGGAGGATCCTAAA,0,1142060
fldAp,0.041666666666666664,23,23,TTAGCACTAATGCGGTTCCA,0,1176304
fldAp,0.041666666666666664,23,23,TTACTCTGGTCGATGGTCAA,0,1179446
fldAp,0.041666666666666664,23,23,TGTACGACCGCGTGAATACG,0,1124662
fldAp,0.041666666666666664,23,23,TGGTGTTTAGCAGGTTTTGG,0,1097782
fldAp,0.041666666666666664,23,23,TGGGTAGGCTACGCGGCTTT,0,1155219
fldAp,0.041666666666666664,23,23,TGGCTGCGTGGACACACAGA,0,1063568
fldAp,0.041666666666666664,23,23,TGCTTTTGGTATACGGACGC,0,1119206
fldAp,0.041666666666666664,23,23,TGCCCTCTTACTTCTTACTA,0,1159554
fldAp,0.041666666666666664,23,23,TGCCCCAATAGTTATACAGT,0,1068738
fldAp,0.041666666666666664,23,23,TGCAAGTAAGTGACTAGTGG,0,1149743
fldAp,0.041666666666666664,23,23,TGATTCTTGGTCTTATAGAC,0,1126252
fldAp,0.041666666666666664,23,23,TGAGATGCACACGAACAAAT,0,1083977
fldAp,0.041666666666666664,23,23,TCTTCCCTAGTCACGCCAGC,0,1072604
fldAp,0.041666666666666664,23,23,TCGGTTGGTGAAGTACGACA,0,1170839
fldAp,0.041666666666666664,23,23,TCGCTCCAGGGGTTTCGGCA,0,1075428
fldAp,0.041666666666666664,23,23,TCGAAAACTACCGCCCACTA,0,1131296
fldAp,0.041666666666666664,23,23,TCCTAATGCGCCTGGTAGCG,0,1183858
fldAp,0.041666666666666664,23,23,TCCGGAATCCTAACATCATG,0,1091711
fldAp,0.041666666666666664,23,23,TCCCATAGAGCTACGACTCT,0,1112877
fldAp,0.041666666666666664,23,23,TATACCCTCGCGGCTTGGCT,0,1080009
fldAp,0.041666666666666664,23,23,TAGGCCTTTACAGTGTGCCA,0,1083897
fldAp,0.041666666666666664,23,23,TAGCCTTCCCATTTAAGACA,0,1079899
fldAp,0.041666666666666664,23,23,TAGATGTAAGGAGGTTTAGT,0,1114828
fldAp,0.041666666666666664,23,23,TACTGCAAAGAACAGTGCGT,0,1114675
fldAp,0.041666666666666664,23,23,TACTACGTAGAAAACCGAGG,0,1156855
fldAp,0.041666666666666664,23,23,TAAGGGTTCACAATAGTCAG,0,1168826
fldAp,0.041666666666666664,23,23,GTGTACCTAAGGCGATTGAG,0,1164844
fldAp,0.041666666666666664,23,23,GTGCGGTATGTTCGTCAGGA,0,1104400
fldAp,0.041666666666666664,23,23,GTCTTGTGTGATGAGTGCGT,0,1080411
fldAp,0.041666666666666664,23,23,GTCCCACACAAAATGAAGTA,0,1096391
fldAp,0.041666666666666664,23,23,GTACCGGTTCGATTAAGAAG,0,1068060
fldAp,0.041666666666666664,23,23,GTAACTTATCGCTTAGCGCA,0,1100212
fldAp,0.041666666666666664,23,23,GTAACTACCATACAACACTC,0,1171713
fldAp,0.041666666666666664,23,23,GGTGAGAAACATTCTAAGCT,0,1124168
fldAp,0.041666666666666664,23,23,GGTAGGCTTTGATTGGTCTT,0,1091161
fldAp,0.041666666666666664,23,23,GGGTTTCCCCTTTGGATATC,0,1170387
fldAp,0.041666666666666664,23,23,GGGTCCGTACGTAGTGGAAT,0,1170647
fldAp,0.041666666666666664,23,23,GGGTCAATTGCGCATTTAAT,0,1182222
fldAp,0.041666666666666664,23,23,GGGCGGTGCGATGGGCCGTT,0,1073421
fldAp,0.041666666666666664,23,23,GGGATTAGCGTGGTAAGACC,0,1156211
fldAp,0.041666666666666664,23,23,GGCTTGCGATAGGTTACTGT,0,1128891
fldAp,0.041666666666666664,23,23,GGCGAGGCACTCCGCATAGA,0,1128347
fldAp,0.041666666666666664,23,23,GGCACCTGCTGGTGCTTCTA,0,1182922
fldAp,0.041666666666666664,23,23,GCGGACCCGATCCTCTCTAA,0,1169900
fldAp,0.041666666666666664,23,23,GCGAGGTCCAAGTTACTAAC,0,1186967
fldAp,0.041666666666666664,23,23,GCCCCCCCATCCTTTACTAA,0,1172737
fldAp,0.041666666666666664,23,23,GCCACCAGGTCTATCGGTAT,0,1090846
fldAp,0.041666666666666664,23,23,GCACTTTCTTGTGAATGCTG,0,1157143
fldAp,0.041666666666666664,23,23,GCACGTTATCCCAGAAGCTG,0,1078363
fldAp,0.041666666666666664,23,23,GCACCGGATGGGCATTTGCA,0,1159121
fldAp,0.041666666666666664,23,23,GCAATCATAGATGACGAAGG,0,1069194
fldAp,0.041666666666666664,23,23,GATAAGTACTTCATCAATAT,0,1137222
fldAp,0.041666666666666664,23,23,GAGTACTTCAGTCTGGTAAA,0,1148990
fldAp,0.041666666666666664,23,23,GACTTTAGACGCCGGGACGA,0,1090515
fldAp,0.041666666666666664,23,23,GAATATCAGGGTCCAGACCT,0,1095262
fldAp,0.041666666666666664,23,23,GAAGCAAGATCAGTTGTTGT,0,1103742
fldAp,0.041666666666666664,23,23,CTTTTCCAGGCATAGCCGAA,0,1097461
fldAp,0.041666666666666664,23,23,CTTGTCGGATGGCAGTGAAG,0,1105448
fldAp,0.041666666666666664,23,23,CTGTTCTTCTTAAACTCAGA,0,1065327
fldAp,0.041666666666666664,23,23,CTGTCCCAGATTGTCTCCCA,0,1109131
fldAp,0.041666666666666664,23,23,CTCTGGTAGCGTAGTTTGTA,0,1085418
fldAp,0.041666666666666664,23,23,CTCTAATCGGGATGGGTAGA,0,1079975
fldAp,0.041666666666666664,23,23,CTCCGGGAGAGTATTACGAG,0,1103349
fldAp,0.041666666666666664,23,23,CTCCGGCACAGAAATCAGCG,0,1132634
fldAp,0.041666666666666664,23,23,CTCCGCGAATTTGGAGGGTC,0,1169331
fldAp,0.041666666666666664,23,23,CTCAATATGTGTATTACAGA,0,1073420
fldAp,0.041666666666666664,23,23,CTAGCAATGCTTCGCCTATT,0,1072885
fldAp,0.041666666666666664,23,23,CGTTTGTTTGTTGAGAGCTT,0,1063129
fldAp,0.041666666666666664,23,23,CGTCGGGCATCGTGCGGAGA,0,1174865
fldAp,0.041666666666666664,23,23,CGTCACCGCTCGGGAACTAC,0,1090858
fldAp,0.041666666666666664,23,23,CGGGACGGCTGGAATCTATA,0,1121956
fldAp,0.041666666666666664,23,23,CGGAGTACCTTGTTTAATCT,0,1098424
fldAp,0.041666666666666664,23,23,CGGAATGCATGAATTTATGT,0,1137849
fldAp,0.041666666666666664,23,23,CGCTTTGCCACATGGGTGAT,0,1119232
fldAp,0.041666666666666664,23,23,CGCGTGGAGTGCGTGACGGC,0,1091833
fldAp,0.041666666666666664,23,23,CGCGTAACATATAGAAGATG,0,1144761
fldAp,0.041666666666666664,23,23,CGCCGAACCCCCAAGGCAGC,0,1125967
fldAp,0.041666666666666664,23,23,CGAGGGAAGAGTTTTCGAAG,0,1153705
fldAp,0.041666666666666664,23,23,CCTTTGGATGTTTAAGTCGT,0,1111136
fldAp,0.041666666666666664,23,23,CCTGTTTTTAAATACATAAA,0,1165864
fldAp,0.041666666666666664,23,23,CCGTAGTCTTAGCCGGGTAC,0,1155462
fldAp,0.041666666666666664,23,23,CCGGCTGGAATGTGATACCA,0,1107992
fldAp,0.041666666666666664,23,23,CCGCTCGGCAGTTAGATAAT,0,1103317
fldAp,0.041666666666666664,23,23,CCCATTAAAGCCCAATAGCT,0,1162096
fldAp,0.041666666666666664,23,23,CATAGACATCAATCAGGGTG,0,1152905
fldAp,0.041666666666666664,23,23,CATAACACTTGTACGTTCGG,0,1109117
fldAp,0.041666666666666664,23,23,CAGTGCATCGTCCCGGCGAA,0,1167159
fldAp,0.041666666666666664,23,23,CAGCATCTTCAGCATTGTGG,0,1148624
fldAp,0.041666666666666664,23,23,CAGCAAACGCTTGGCTATAG,0,1079710
fldAp,0.041666666666666664,23,23,CAGAATTGCTCGGATTTACA,0,1154980
fldAp,0.041666666666666664,23,23,CAAGACAAACCGATCGAATT,0,1182729
fldAp,0.041666666666666664,23,23,CAACGCTGGGAGTTGGGGGT,0,1143876
fldAp,0.041666666666666664,23,23,ATTTTAACGTCTGAGAACAT,0,1133190
fldAp,0.041666666666666664,23,23,ATTTACACTCACCCTCTTTG,0,1063466
fldAp,0.041666666666666664,23,23,ATGGGAGTTGTTTAAAGATG,0,1133970
fldAp,0.041666666666666664,23,23,ATCGGAGTTTTACGCAGAGA,0,1178807
fldAp,0.041666666666666664,23,23,ATCATTATATCAGCTATCAA,0,1175687
fldAp,0.041666666666666664,23,23,AGTGTCTGAGTCTGGGGAGC,0,1124272
fldAp,0.041666666666666664,23,23,AGTATTCACTATTGAAGTTG,0,1159790
fldAp,0.041666666666666664,23,23,AGTACACGTCTATCACTCGT,0,1143928
fldAp,0.041666666666666664,23,23,AGGAATGCGCTTTCGCCGGC,0,1078361
fldAp,0.041666666666666664,23,23,AGCTCGATATGTCGCTGCCA,0,1107777
fldAp,0.041666666666666664,23,23,AGCGTTCAAGATCTGCCGTA,0,1157936
fldAp,0.041666666666666664,23,23,AGATCGATGACCTCCTCGCA,0,1081116
fldAp,0.041666666666666664,23,23,AGAGGAGATCTTGTGGTAAA,0,1088992
fldAp,0.041666666666666664,23,23,AGAACATGTCGGATCAGATA,0,1136936
fldAp,0.041666666666666664,23,23,ACTTGCGAAGAGCTTTTAAC,0,1162108
fldAp,0.041666666666666664,23,23,ACTGGTTGCACTTTGAATAG,0,1122246
fldAp,0.041666666666666664,23,23,ACTGCGCGCCTTCAATGTAG,0,1182972
fldAp,0.041666666666666664,23,23,ACTAAACATTCGGGCGGACA,0,1142919
fldAp,0.041666666666666664,23,23,ACATTCGCCCTCGCTGGTGT,0,1154176
fldAp,0.041666666666666664,23,23,ACACCGCAGAGGTGTCTGGA,0,1078528
fldAp,0.041666666666666664,23,23,ACAAAGGACTAATATGGGTC,0,1148178
fldAp,0.041666666666666664,23,23,AATGTCACCGTCGTGTGATC,0,1131838
fldAp,0.041666666666666664,23,23,AACTCCACCGCAACGAGGGA,0,1079036
fldAp,0.041666666666666664,23,23,AACACACAGTGGTGTACGCA,0,1078549
fldAp,0.041666666666666664,23,23,AAAGCGCAGTACCGTGTTAA,0,1119354
fldAp,0.041666666666666664,23,23,AAACCTCTCGGGTCTACCAT,0,1073773
fldAp,0.041666666666666664,23,23,AAACCCGCTAGTACCTTATG,0,1112715
fldAp,0.043478260869565216,22,22,TTTTTATGGTATCATCACTC,0,1175340
fldAp,0.043478260869565216,22,22,TTTCGTTCGCTTGGGTTTTT,0,1066818
fldAp,0.043478260869565216,22,22,TTTCACGACATCCCATTTGA,0,1176550
fldAp,0.043478260869565216,22,22,TTGACACAAAGAAGCGTCAG,0,1130246
fldAp,0.043478260869565216,22,22,TTCGGGTCAGTCGGACGTTT,0,1139580
fldAp,0.043478260869565216,22,22,TTCGACGAGAGGTTGGACCC,0,1075739
fldAp,0.043478260869565216,22,22,TTATACGTTTACCCGATTGG,0,1063369
fldAp,0.043478260869565216,22,22,TTAACGTGACGTATAGCTAG,0,1116568
fldAp,0.043478260869565216,22,22,TGTTAATTAGTAAGTCATGT,0,1154633
fldAp,0.043478260869565216,22,22,TGTCATCATAATGTCAATGA,0,1071097
fldAp,0.043478260869565216,22,22,TGTATCCATCGTCGAGATCA,0,1169030
fldAp,0.043478260869565216,22,22,TGCGGTCTTAAGACCGTAGA,0,1087160
fldAp,0.043478260869565216,22,22,TGCCGACAAGAGACAGGGTT,0,1132015
fldAp,0.043478260869565216,22,22,TGCCACACGTTCTAACCAAG,0,1102622
fldAp,0.043478260869565216,22,22,TGAGTAAGGTCCGCCTGCTA,0,1085544
fldAp,0.043478260869565216,22,22,TGAAAGGCGAACGTAAGCGA,0,1136902
fldAp,0.043478260869565216,22,22,TGAAACGCCGGAAAAGTGAA,0,1086621
fldAp,0.043478260869565216,22,22,TCTTGGTCATCTTTATAGCG,0,1091430
fldAp,0.043478260869565216,22,22,TCTGGGTCACCTTCGTTTAT,0,1130842
fldAp,0.043478260869565216,22,22,TCTGCAGTATAAAGGCCGCC,0,1086451
fldAp,0.043478260869565216,22,22,TCTCTAATAGATCATTAATG,0,1086528
fldAp,0.043478260869565216,22,22,TCTCATCCCTACAGGAGGTC,0,1071874
fldAp,0.043478260869565216,22,22,TCTCAGCCTGATCCCTAGGT,0,1167040
fldAp,0.043478260869565216,22,22,TCTATTCTCCCTTATAATGT,0,1086695
fldAp,0.043478260869565216,22,22,TCGTTTTAGGTTACCCACTG,0,1080398
fldAp,0.043478260869565216,22,22,TCGTATCGCCCTTTTGTACA,0,1098711
fldAp,0.043478260869565216,22,22,TCGCTCGTGTGCGTGACCAG,0,1155447
fldAp,0.043478260869565216,22,22,TCACGGAGGTGTAGCAGGGA,0,1070766
fldAp,0.043478260869565216,22,22,TCAACGTGGTTTTGTGGGAT,0,1087652
fldAp,0.043478260869565216,22,22,TAGGCTCAGCACCCTTCTCG,0,1085694
fldAp,0.043478260869565216,22,22,TAGAGACAGTTGCCGAATGT,0,1138195
fldAp,0.043478260869565216,22,22,TACTAAATGTGTTTGTAACT,0,1064218
fldAp,0.043478260869565216,22,22,TAAATATCGTAAAGGGCAGA,0,1078859
fldAp,0.043478260869565216,22,22,GTTTATATCATCGGTCTTAT,0,1091231
fldAp,0.043478260869565216,22,22,GTTCGCGGCTCAATCAAGTC,0,1135593
fldAp,0.043478260869565216,22,22,GTTAAAAATGCCATTCACAT,0,1127944
fldAp,0.043478260869565216,22,22,GTGGCAAGGCCGAGCACATC,0,1066362
fldAp,0.043478260869565216,22,22,GTGCCCCGCGGAGCAGATCC,0,1089562
fldAp,0.043478260869565216,22,22,GTGATCGCTTCATTAGTAGA,0,1151779
fldAp,0.043478260869565216,22,22,GTGAACGGATCCGTCTGGTT,0,1182699
fldAp,0.043478260869565216,22,22,GTCGTGAGGGGCTGCCCAGC,0,1077183
fldAp,0.043478260869565216,22,22,GTAGGGTCTGTGACTAACAC,0,1088499
fldAp,0.043478260869565216,22,22,GTAGACTACGCTGGGGCCAA,0,1102407
fldAp,0.043478260869565216,22,22,GTACCGGGAAGGAGTAGAAT,0,1097508
fldAp,0.043478260869565216,22,22,GTACACCTAAGGGCGATAAA,0,1149152
fldAp,0.043478260869565216,22,22,GGTTGCACGAACCGGGGACA,0,1150863
fldAp,0.043478260869565216,22,22,GGTGTGCAGTCCTTTTAAAC,0,1182374
fldAp,0.043478260869565216,22,22,GGTCAGGTCGTCTCAGGTTA,0,1106221
fldAp,0.043478260869565216,22,22,GGGGCTTAAAAAACAGTACC,0,1091464
fldAp,0.043478260869565216,22,22,GGGAGGTAAAGGAAGCTTAA,0,1112489
fldAp,0.043478260869565216,22,22,GGGAGAACTTGGTAGCTACA,0,1135225
fldAp,0.043478260869565216,22,22,GGGACAACATACCCTTACAT,0,1145204
fldAp,0.043478260869565216,22,22,GGCGCGGCTAATACTTATTG,0,1119678
fldAp,0.043478260869565216,22,22,GGCCTAGAAACAGTCCTCTA,0,1114398
fldAp,0.043478260869565216,22,22,GGCCATTTAAATTGTTAGAA,0,1071532
fldAp,0.043478260869565216,22,22,GGCAAATATGCTGAGAGGCA,0,1136107
fldAp,0.043478260869565216,22,22,GGATTTTAGCTCACACTAGC,0,1164719
fldAp,0.043478260869565216,22,22,GGATGACTGCTAGAGACGGC,0,1123547
fldAp,0.043478260869565216,22,22,GGACGCGTTCGTGGTCGAAG,0,1129976
fldAp,0.043478260869565216,22,22,GGAAAATTGAAAAAACGTAG,0,1091250
fldAp,0.043478260869565216,22,22,GCGTTCACCAGAATCGTTTT,0,1156366
fldAp,0.043478260869565216,22,22,GCCTGAGTGCTGCTGTTGTA,0,1152240
fldAp,0.043478260869565216,22,22,GCCCGGTTTTGAAACGGTAG,0,1129362
fldAp,0.043478260869565216,22,22,GCCAAGCTTAGCTATGCCTC,0,1096462
fldAp,0.043478260869565216,22,22,GCATCGGGCGGACAGCGTCA,0,1166335
fldAp,0.043478260869565216,22,22,GCATAATAAGTCCAGTCCGA,0,1169425
fldAp,0.043478260869565216,22,22,GCAGAGTACTGCAGAGCTGG,0,1152575
fldAp,0.043478260869565216,22,22,GCACTGACGGTCTAAATAAG,0,1152227
fldAp,0.043478260869565216,22,22,GCACCTAAAGCCCACGGTAG,0,1166332
fldAp,0.043478260869565216,22,22,GAGTTCCCCATCGAAACCCG,0,1119597
fldAp,0.043478260869565216,22,22,GAGTGTCCTTATACGATAGT,0,1171801
fldAp,0.043478260869565216,22,22,GAGGTTTTCTCTCTCCTGGA,0,1092666
fldAp,0.043478260869565216,22,22,GAGCTCCCGTCAACTCTTTG,0,1072960
fldAp,0.043478260869565216,22,22,GACTTCAACCTCAGCGTAGC,0,1145992
fldAp,0.043478260869565216,22,22,GAATGCGGAAGTACGGAATG,0,1164528
fldAp,0.043478260869565216,22,22,GAAGAGCAACGTGCCATTGG,0,1167572
fldAp,0.043478260869565216,22,22,GAACGTGACAGAAACATAAA,0,1075030
fldAp,0.043478260869565216,22,22,GAAATCATTAACATTATCGA,0,1126675
fldAp,0.043478260869565216,22,22,GAAATATCAAGGTTCACAAC,0,1136765
fldAp,0.043478260869565216,22,22,CTTTGCCTAGCAGAATACAA,0,1152740
fldAp,0.043478260869565216,22,22,CTTAGCATGTGGTCTAGCGA,0,1183807
fldAp,0.043478260869565216,22,22,CTTAATGATTGACCGCGAGT,0,1089876
fldAp,0.043478260869565216,22,22,CTGTTTCACCTAACCAGCGT,0,1065066
fldAp,0.043478260869565216,22,22,CTGTGCTTTGCTTCACGTAT,0,1127025
fldAp,0.043478260869565216,22,22,CTGCCGGTTGAGGGTGCGGT,0,1181658
fldAp,0.043478260869565216,22,22,CTGCCCCTCCCCGTTCAAGG,0,1185673
fldAp,0.043478260869565216,22,22,CTATGCTTATTTAATGTTAC,0,1148090
fldAp,0.043478260869565216,22,22,CTAGTTCAAGGGGAATCCAG,0,1112878
fldAp,0.043478260869565216,22,22,CTAGGTACGTTGTAAAGATT,0,1152853
fldAp,0.043478260869565216,22,22,CGTGCCATTGTTAGTTCCGA,0,1143179
fldAp,0.043478260869565216,22,22,CGGTTCGCTAATTTAGGTAC,0,1166215
fldAp,0.043478260869565216,22,22,CGGGTCACTGCCTTCATAAA,0,1165319
fldAp,0.043478260869565216,22,22,CGCGGGGACTCGGCAAGAAC,0,1075327
fldAp,0.043478260869565216,22,22,CCTTGGTGCGTAAGGGGGCA,0,1065775
fldAp,0.043478260869565216,22,22,CCTGACGAGATTGCAGCGGG,0,1068647
fldAp,0.043478260869565216,22,22,CCTCAGTTGGCGGAAAAATC,0,1071593
fldAp,0.043478260869565216,22,22,CCTCAAAAAGTTCCACGGCA,0,1097112
fldAp,0.043478260869565216,22,22,CCTAGCCTAGACCATACTTT,0,1067970
fldAp,0.043478260869565216,22,22,CCGCGGGTGATGGGACGAAG,0,1094849
fldAp,0.043478260869565216,22,22,CCCGCAAGGTTAGTATTTCT,0,1147322
fldAp,0.043478260869565216,22,22,CCCAAGCCATCAAGAAGGTT,0,1092563
fldAp,0.043478260869565216,22,22,CCCAAAACCCGCAATAACCT,0,1066985
fldAp,0.043478260869565216,22,22,CCATAAACACGTGCATATCC,0,1080516
fldAp,0.043478260869565216,22,22,CATGTTTTGACGAAGAAACA,0,1122787
fldAp,0.043478260869565216,22,22,CATGGTCCTGATCGATTGGG,0,1094506
fldAp,0.043478260869565216,22,22,CACTGCATGGGAACTCATCA,0,1160571
fldAp,0.043478260869565216,22,22,CACCCAAATGCGCTCTAGGA,0,1142794
fldAp,0.043478260869565216,22,22,CACAGGTATGTAAGCGTGTT,0,1092348
fldAp,0.043478260869565216,22,22,ATATACGTTCCCTTTGGGGT,0,1131661
fldAp,0.043478260869565216,22,22,AGTGTACAGCCCAAATGCAG,0,1075895
fldAp,0.043478260869565216,22,22,AGTCCTGACAAAGGCTTGTA,0,1117031
fldAp,0.043478260869565216,22,22,AGTAGATGTGCTATCAGTTT,0,1100556
fldAp,0.043478260869565216,22,22,AGGGTTAACTCCGCGTCGTT,0,1158642
fldAp,0.043478260869565216,22,22,AGGGACGTTCGGCGGGATAT,0,1088585
fldAp,0.043478260869565216,22,22,AGGCCCAGCTCAGGAAGGCA,0,1118526
fldAp,0.043478260869565216,22,22,AGCTTCCGGCCAAGACCCCT,0,1101917
fldAp,0.043478260869565216,22,22,AGCCGGTTCTACGCTGATGC,0,1148957
fldAp,0.043478260869565216,22,22,ACTTTTACGGCGATGCATCT,0,1081146
fldAp,0.043478260869565216,22,22,ACTCCCATTTGTTGAGCGCA,0,1120950
fldAp,0.043478260869565216,22,22,ACCTAGTCTAAAATACACAT,0,1148292
fldAp,0.043478260869565216,22,22,ACCGGGCAATATAAAAGTCG,0,1075423
fldAp,0.043478260869565216,22,22,ACCGCGTTCAATCCGTCCCG,0,1118888
fldAp,0.043478260869565216,22,22,ACATGCCCTCCGACCGGTAA,0,1071915
fldAp,0.043478260869565216,22,22,ACATAACCAATGGATGAGAT,0,1133264
fldAp,0.043478260869565216,22,22,ACAGCTGCAGCGGCTAGAGT,0,1069518
fldAp,0.043478260869565216,22,22,AATTCGTGGGGCAACGCATT,0,1167654
fldAp,0.043478260869565216,22,22,AATACTTACATAGGTTGCCG,0,1184087
fldAp,0.043478260869565216,22,22,AAGTTGATTTCAAGCTTGAA,0,1132014
fldAp,0.043478260869565216,22,22,AAGGCAGGTGAAGAGAAATC,0,1173711
fldAp,0.043478260869565216,22,22,AAGACGGGGACCATTGAACA,0,1128889
fldAp,0.043478260869565216,22,22,AACTGTACTGCTGTTCTGAC,0,1071488
fldAp,0.043478260869565216,22,22,AAAGCCGTGGAATTTTCGCC,0,1127056
fldAp,0.043478260869565216,22,22,AAACGTTTCTGACAAATCGT,0,1138682
fldAp,0.045454545454545456,21,21,TTTTCGCTACGAAAGCTGTG,0,1124335
fldAp,0.045454545454545456,21,21,TTTTAAATAGTCTCCAAACA,0,1176989
fldAp,0.045454545454545456,21,21,TTTGGTTACGGCTTTTTTCT,0,1099139
fldAp,0.045454545454545456,21,21,TTTATACGACAGACGGCGTA,0,1124651
fldAp,0.045454545454545456,21,21,TTGCAATCATCAATCGGTAT,0,1127497
fldAp,0.045454545454545456,21,21,TTCTTTATTCAAGCGTCACA,0,1144735
fldAp,0.045454545454545456,21,21,TTCCTACATTAGCGGGTACT,0,1183179
fldAp,0.045454545454545456,21,21,TTATTGGAGTGGGTTGCCAA,0,1149397
fldAp,0.045454545454545456,21,21,TTATCCTGCCCGCCGATTTC,0,1122994
fldAp,0.045454545454545456,21,21,TTAGCGGTAAACGGAAGTAA,0,1147285
fldAp,0.045454545454545456,21,21,TGGGATCCGCTCAGTGTTCT,0,1122677
fldAp,0.045454545454545456,21,21,TGCTGCACCTGGGACACCGC,0,1161601
fldAp,0.045454545454545456,21,21,TGCGAGGTACAATAGATCCA,0,1065108
fldAp,0.045454545454545456,21,21,TGCAGGGGCTAGACCTGTCG,0,1169187
fldAp,0.045454545454545456,21,21,TGACTGAACCTTACGTAAAA,0,1067001
fldAp,0.045454545454545456,21,21,TCTATCTCGTTCTCGTGTGG,0,1106269
fldAp,0.045454545454545456,21,21,TCTAGGGGTCACAGATTTGG,0,1075235
fldAp,0.045454545454545456,21,21,TCTAATTTGTATTTACACGG,0,1148185
fldAp,0.045454545454545456,21,21,TCGGTGCGTCGGAAGACTAA,0,1139958
fldAp,0.045454545454545456,21,21,TCGAAGGACGATGGAAACAT,0,1131459
fldAp,0.045454545454545456,21,21,TCCTGGATTAGACTACCTCA,0,1107418
fldAp,0.045454545454545456,21,21,TCCTGCGGAGCGCCGGGAGG,0,1128178
fldAp,0.045454545454545456,21,21,TCCGTCACACGCGCCTAGTT,0,1159731
fldAp,0.045454545454545456,21,21,TCCGGTCCGTTCGACGACAA,0,1176069
fldAp,0.045454545454545456,21,21,TCACGGGATGTGGGCTTAGA,0,1176143
fldAp,0.045454545454545456,21,21,TATTGGTTGTAACTTATATT,0,1100027
fldAp,0.045454545454545456,21,21,TATAGATGTAATAGTTGATA,0,1177298
fldAp,0.045454545454545456,21,21,TATACTCTGCGGAGTGGCGC,0,1148182
fldAp,0.045454545454545456,21,21,TAGGAGTAAGGTCGCCCAAC,0,1087767
fldAp,0.045454545454545456,21,21,TAGCAGCAAATCTTTAGGCT,0,1080389
fldAp,0.045454545454545456,21,21,TAGAGACGCTCGACGAAAGA,0,1104677
fldAp,0.045454545454545456,21,21,TACTGCCCGTAGTAGCATAG,0,1148818
fldAp,0.045454545454545456,21,21,TACGGCGGCTATAGATGGAA,0,1068302
fldAp,0.045454545454545456,21,21,TACCGTAATCGTCAAGTAGA,0,1131870
fldAp,0.045454545454545456,21,21,TACATGGGGTAAGGTGTTTA,0,1110042
fldAp,0.045454545454545456,21,21,TAAGGCCTCTGAAGCAGGTC,0,1174520
fldAp,0.045454545454545456,21,21,GTTGTAATCCTCGCCGTTGG,0,1135585
fldAp,0.045454545454545456,21,21,GTTAGGTCTTTAGATCGCTA,0,1114696
fldAp,0.045454545454545456,21,21,GTGGCTTCTTTAAAAGAAAA,0,1153185
fldAp,0.045454545454545456,21,21,GTGCCCATCTTACCCCACAT,0,1097583
fldAp,0.045454545454545456,21,21,GTGAGTAGGTATTTTATGGA,0,1129901
fldAp,0.045454545454545456,21,21,GTGAAGCACACCAACATCAG,0,1065704
fldAp,0.045454545454545456,21,21,GTAGGGATTTCTAATTACTA,0,1108188
fldAp,0.045454545454545456,21,21,GGTCCGCAACATTGCGGTCT,0,1137541
fldAp,0.045454545454545456,21,21,GGGAGGCAAAATCGACCATG,0,1175867
fldAp,0.045454545454545456,21,21,GGGAGACGCCTCCAGCGACG,0,1146736
fldAp,0.045454545454545456,21,21,GGCCGGAAAGGGAAACTTAC,0,1127572
fldAp,0.045454545454545456,21,21,GGCCAACAAGTGAAACGAGT,0,1090259
fldAp,0.045454545454545456,21,21,GGCAGCGCTTTTTAGGAGCT,0,1171349
fldAp,0.045454545454545456,21,21,GGAGGGGTCAGTAGTGGAAA,0,1095365
fldAp,0.045454545454545456,21,21,GGAAGTTCGTCCAAAAACAG,0,1094964
fldAp,0.045454545454545456,21,21,GGAAGGGCAGCATTCGTATA,0,1078791
fldAp,0.045454545454545456,21,21,GGAAAACCGCATTCACCGGT,0,1169157
fldAp,0.045454545454545456,21,21,GCTCTGAATAGGTTTGTAGC,0,1141530
fldAp,0.045454545454545456,21,21,GCTAGGCATCGGTCCGTGTA,0,1128366
fldAp,0.045454545454545456,21,21,GCTAGACAGCACTGTTCCTG,0,1122389
fldAp,0.045454545454545456,21,21,GCGTGGGGGGCCACAGGGAT,0,1176230
fldAp,0.045454545454545456,21,21,GCGGTAAATCGGGGGTAAGA,0,1077962
fldAp,0.045454545454545456,21,21,GCGCGCGGGAGTCCTACCGC,0,1122047
fldAp,0.045454545454545456,21,21,GCCCCTTAACGTTCTTTCGA,0,1099829
fldAp,0.045454545454545456,21,21,GCCAGGTGGTTTCCCCCCGT,0,1079096
fldAp,0.045454545454545456,21,21,GCATGTCGGTTGAGTATTGT,0,1080877
fldAp,0.045454545454545456,21,21,GATTGCGCCCCCCGCATTAA,0,1084112
fldAp,0.045454545454545456,21,21,GATCTTAAGTGGGCGGGAAA,0,1083229
fldAp,0.045454545454545456,21,21,GATCGCGACCCTCAGCAAGC,0,1109431
fldAp,0.045454545454545456,21,21,GAGGATAAGCATTATTCGGT,0,1118520
fldAp,0.045454545454545456,21,21,GAGCTTGAAGGCGGAGCTTC,0,1113900
fldAp,0.045454545454545456,21,21,GAGCCCCAACGGAGCACGAA,0,1119667
fldAp,0.045454545454545456,21,21,GAGAAGTCCTAATGCTTATC,0,1154040
fldAp,0.045454545454545456,21,21,GACACAGTCACTCGCCCTAC,0,1137326
fldAp,0.045454545454545456,21,21,GAACGTGACCGCGAATTTGT,0,1149944
fldAp,0.045454545454545456,21,21,CTGGACAACCCCTCGGGTCC,0,1173575
fldAp,0.045454545454545456,21,21,CTGAGGCCCTAATATAGTTG,0,1121700
fldAp,0.045454545454545456,21,21,CTGAGCAATCGGATGCTAAT,0,1102330
fldAp,0.045454545454545456,21,21,CTGACCTAGAAGGAAGAGCT,0,1149340
fldAp,0.045454545454545456,21,21,CTCCAAACAGTCGTGAGGCC,0,1138732
fldAp,0.045454545454545456,21,21,CTACTATCACAATGGAGATC,0,1097927
fldAp,0.045454545454545456,21,21,CTACGCTATAAAGGCATGTC,0,1120474
fldAp,0.045454545454545456,21,21,CTACCTATCGTTTACCGGGT,0,1101845
fldAp,0.045454545454545456,21,21,CTAATCAGTGATTCGCATCA,0,1083281
fldAp,0.045454545454545456,21,21,CTAACCCAAGATGTCAAACC,0,1109781
fldAp,0.045454545454545456,21,21,CGTTGACATCTATCAGTATT,0,1095502
fldAp,0.045454545454545456,21,21,CGTAATTCAGTATGCTTTTG,0,1109453
fldAp,0.045454545454545456,21,21,CGTAAATCACGTCTGAACGT,0,1142722
fldAp,0.045454545454545456,21,21,CGCTGTTTGAGCTCTGCTGA,0,1144110
fldAp,0.045454545454545456,21,21,CGCTCTACTCCTGTTTTCAA,0,1160039
fldAp,0.045454545454545456,21,21,CGCCCCGCTCCAATCCGTCT,0,1111273
fldAp,0.045454545454545456,21,21,CGCACACCGGGGAAGGCGAG,0,1148310
fldAp,0.045454545454545456,21,21,CGACGTTCAGAATAAACGTT,0,1075738
fldAp,0.045454545454545456,21,21,CCTCCGGCGCCACATAGGAA,0,1152379
fldAp,0.045454545454545456,21,21,CCTCAAGGAAACACGATCGA,0,1140701
fldAp,0.045454545454545456,21,21,CCGTGTGCATGGGCGGCGGC,0,1072235
fldAp,0.045454545454545456,21,21,CCGTGACATTGTATTAAGTG,0,1128916
fldAp,0.045454545454545456,21,21,CCCACTCACTTGATATCAAT,0,1186022
fldAp,0.045454545454545456,21,21,CCATGTACCCCAGAGCAGAC,0,1171438
fldAp,0.045454545454545456,21,21,CCAGAAGAGCAACGAACAAC,0,1175695
fldAp,0.045454545454545456,21,21,CCAAGGCAACCGTACGCGTT,0,1108252
fldAp,0.045454545454545456,21,21,CATCCTCTGTGACTCTACAA,0,1148975
fldAp,0.045454545454545456,21,21,CATCAGCCTGAGGGGAAGTT,0,1160937
fldAp,0.045454545454545456,21,21,CAGCAGAACACGAAAAGGAT,0,1126806
fldAp,0.045454545454545456,21,21,CAGAAGTTGGATGTGATAGC,0,1104187
fldAp,0.045454545454545456,21,21,CACCCTATGTATCGATACAT,0,1110271
fldAp,0.045454545454545456,21,21,CACCACATGTCATTGAGAAT,0,1152810
fldAp,0.045454545454545456,21,21,CAACAGTTGGACCATTCTGT,0,1154928
fldAp,0.045454545454545456,21,21,CAAACTTATGTCGCGATGGG,0,1114670
fldAp,0.045454545454545456,21,21,ATTTTCAGCGAAATGGAACC,0,1084283
fldAp,0.045454545454545456,21,21,ATTTGGTCTATCGCGAGACT,0,1100368
fldAp,0.045454545454545456,21,21,ATTGTTCGAACTTGCCACTG,0,1068928
fldAp,0.045454545454545456,21,21,ATTCAGAGGGCGGCTAAAAT,0,1176883
fldAp,0.045454545454545456,21,21,ATTCACAGATTGATGGTAAA,0,1176620
fldAp,0.045454545454545456,21,21,ATTATTTCAATACTAATGTT,0,1185454
fldAp,0.045454545454545456,21,21,ATGGGCGGTCCCGACTTATG,0,1144930
fldAp,0.045454545454545456,21,21,ATGCGAGTTCTCAATCGTGC,0,1177297
fldAp,0.045454545454545456,21,21,ATGATCGGGCGATGGAGTAG,0,1115098
fldAp,0.045454545454545456,21,21,ATGAGCGGCGTCAAGACACT,0,1109521
fldAp,0.045454545454545456,21,21,ATCTTAGCGGTAGAAAAAGA,0,1083425
fldAp,0.045454545454545456,21,21,ATCGTCCCGATGAATGAGGC,0,1160317
fldAp,0.045454545454545456,21,21,ATCGTAATTCTAAACGTTCC,0,1078667
fldAp,0.045454545454545456,21,21,ATATGGTTATAGCATCGGTT,0,1186367
fldAp,0.045454545454545456,21,21,ATAGTAATTTATGGACAGCA,0,1066411
fldAp,0.045454545454545456,21,21,ATAGGGATTCTCGAAGTCCT,0,1134304
fldAp,0.045454545454545456,21,21,ATAGGAGGCATTCAGGCGGA,0,1071678
fldAp,0.045454545454545456,21,21,ATAGCCTTGCCAGTTAGCTT,0,1122242
fldAp,0.045454545454545456,21,21,ATAGACCGGGCTACGGAACA,0,1176210
fldAp,0.045454545454545456,21,21,ATAGAACTTCTTCTACCAAG,0,1128971
fldAp,0.045454545454545456,21,21,ATACGAGGGAACTACTTCCT,0,1175923
fldAp,0.045454545454545456,21,21,ATACCTATCCTAACCGATCG,0,1072574
fldAp,0.045454545454545456,21,21,ATAAGCCGAGAATGTACCTT,0,1163265
fldAp,0.045454545454545456,21,21,ATAAATTGTAGAGCATTTTT,0,1145619
fldAp,0.045454545454545456,21,21,AGTTTTCTTTAACACAAGCA,0,1120329
fldAp,0.045454545454545456,21,21,AGTTGTCGGAAGGTTGGATC,0,1113498
fldAp,0.045454545454545456,21,21,AGGTTCTTGTAAATAACGTT,0,1074940
fldAp,0.045454545454545456,21,21,AGGTCGTGAGGCGCCATGAA,0,1178334
fldAp,0.045454545454545456,21,21,AGGGCCAACGATGACTGCTT,0,1151626
fldAp,0.045454545454545456,21,21,AGGGATCACGTTACGGGGTG,0,1135754
fldAp,0.045454545454545456,21,21,AGGAGGGGGGCGCACTCAAT,0,1085714
fldAp,0.045454545454545456,21,21,AGGACAACAGGCAGGTTTAG,0,1183315
fldAp,0.045454545454545456,21,21,AGCTACATGGACTGAGACTG,0,1111260
fldAp,0.045454545454545456,21,21,AGCCGGTCGTCCGGAATTCC,0,1081447
fldAp,0.045454545454545456,21,21,AGCCGATTCATACCTATATT,0,1083802
fldAp,0.045454545454545456,21,21,AGCAGGATTTAGGAAGCCAG,0,1127861
fldAp,0.045454545454545456,21,21,AGATCGGTAACCAAGTGCCA,0,1115637
fldAp,0.045454545454545456,21,21,AGAGCCTATTATACAGTAAC,0,1110315
fldAp,0.045454545454545456,21,21,AGACTGTCGAGCAAAAGGGA,0,1156583
fldAp,0.045454545454545456,21,21,ACTCGCTGGTTAATAATGCA,0,1121764
fldAp,0.045454545454545456,21,21,ACTAATTTACGTGAGGGATA,0,1129907
fldAp,0.045454545454545456,21,21,ACGGCCGGCCCCGGACCATA,0,1092226
fldAp,0.045454545454545456,21,21,ACCGTGTGTGTCATGGCGCT,0,1083633
fldAp,0.045454545454545456,21,21,ACCGGGACCAGGTGCATCGC,0,1088650
fldAp,0.045454545454545456,21,21,ACCATGCGAGGGCGCTGTCT,0,1070734
fldAp,0.045454545454545456,21,21,ACCAAATAACTGGGTCAAGA,0,1066371
fldAp,0.045454545454545456,21,21,ACATATTACATTCGACGTTT,0,1136181
fldAp,0.045454545454545456,21,21,ACAACAATAAGGTAGCAAAC,0,1112982
fldAp,0.045454545454545456,21,21,AATTCCTCTCCTGTTGGCAG,0,1138463
fldAp,0.045454545454545456,21,21,AAGTGATGTCAGTCGGCCAT,0,1107796
fldAp,0.045454545454545456,21,21,AAGCGGGTCTAACGATGTGT,0,1142185
fldAp,0.045454545454545456,21,21,AAGCCAGATTGTTCCATTTC,0,1167344
fldAp,0.045454545454545456,21,21,AAGAGTGGGTTATCATGTAA,0,1146731
fldAp,0.045454545454545456,21,21,AACCTGCCACCTTGCATCAT,0,1176746
fldAp,0.045454545454545456,21,21,AAACTGTAGGAGGCGTAAGC,0,1067767
fldAp,0.047619047619047616,20,20,TTTTGCGGCGGGGAATTTTT,0,1113374
fldAp,0.047619047619047616,20,20,TTTGATGTGGAAGGAAGGCG,0,1065032
fldAp,0.047619047619047616,20,20,TTTCAAAACGTGTGCGGGTT,0,1067681
fldAp,0.047619047619047616,20,20,TTGCGTTAGGATTGTCACAA,0,1084718
fldAp,0.047619047619047616,20,20,TTGCCTAGTTCGATATGCGA,0,1136333
fldAp,0.047619047619047616,20,20,TTCCGGACCTTCAGTTCTGT,0,1174197
fldAp,0.047619047619047616,20,20,TTATTACCTAAGCTGGTCAG,0,1099928
fldAp,0.047619047619047616,20,20,TGTTACGTTCGCCGTGTGGA,0,1142748
fldAp,0.047619047619047616,20,20,TGCTTATGTTGCACGCAGGT,0,1095239
fldAp,0.047619047619047616,20,20,TGCTGACTGATACAGGGGGA,0,1088874
fldAp,0.047619047619047616,20,20,TGCATACCTCTTCCATGCTT,0,1148072
fldAp,0.047619047619047616,20,20,TGATGACCAATCTTATTCCT,0,1084393
fldAp,0.047619047619047616,20,20,TGAGTGTTATGGTGAACCAG,0,1155206
fldAp,0.047619047619047616,20,20,TCTTTCACCGGTTGAGTGAC,0,1166892
fldAp,0.047619047619047616,20,20,TCTAGGACTAGACATCCGGA,0,1067868
fldAp,0.047619047619047616,20,20,TCTAAGAGAGATGTACCGTA,0,1105270
fldAp,0.047619047619047616,20,20,TCGCTCCAGCTACTACTTGG,0,1164241
fldAp,0.047619047619047616,20,20,TCGAGACGGCTAAAGGGCCA,0,1082849
fldAp,0.047619047619047616,20,20,TCCTGGTAGTAGGTCAAGCG,0,1124674
fldAp,0.047619047619047616,20,20,TCATGAAATAGCGAGTTGTC,0,1122784
fldAp,0.047619047619047616,20,20,TCAGTGCAGCGCCGGGCCTG,0,1147079
fldAp,0.047619047619047616,20,20,TCACATTGGAGGTGTTAGTA,0,1079546
fldAp,0.047619047619047616,20,20,TCAAATCTGGTTACACAGCC,0,1099059
fldAp,0.047619047619047616,20,20,TATTTAGAAGTTAGAGCGAT,0,1124755
fldAp,0.047619047619047616,20,20,TATTCCTCCGCGACTGAGAA,0,1173707
fldAp,0.047619047619047616,20,20,TATCAGCGAGTTCTTACGGT,0,1086842
fldAp,0.047619047619047616,20,20,TACTGGATCTTTCAGAATGA,0,1149473
fldAp,0.047619047619047616,20,20,TACAAACGAAAACTCTCTAA,0,1117115
fldAp,0.047619047619047616,20,20,TAAGTTTGCGGAGTCGCAGT,0,1071164
fldAp,0.047619047619047616,20,20,TAAGCGGCACATGGCTGCTG,0,1103087
fldAp,0.047619047619047616,20,20,GTTGGTTAGATTTCTCCTAG,0,1152292
fldAp,0.047619047619047616,20,20,GTTGCGCAATGGCCACGCAG,0,1101888
fldAp,0.047619047619047616,20,20,GTGTCCGCATACAGCTTTCT,0,1068140
fldAp,0.047619047619047616,20,20,GTGACGTGTATCGTCATCTC,0,1162227
fldAp,0.047619047619047616,20,20,GTCGTCTCTCTATAGGACAA,0,1175623
fldAp,0.047619047619047616,20,20,GTCGCCCGGTGGAAGTCCAA,0,1178811
fldAp,0.047619047619047616,20,20,GTCAGATCAGGTCAGCGAAA,0,1149946
fldAp,0.047619047619047616,20,20,GTATTTCAGGCCTTGAAGAC,0,1075251
fldAp,0.047619047619047616,20,20,GTATGTATCATGCCGGCTCC,0,1127513
fldAp,0.047619047619047616,20,20,GTATATGGGTTCGCATCTGC,0,1166472
fldAp,0.047619047619047616,20,20,GTAGTATCGAGATAGCGGCC,0,1111737
fldAp,0.047619047619047616,20,20,GGTCACACGGACAACGCGCT,0,1116618
fldAp,0.047619047619047616,20,20,GGTACAAAGATCTAGAAGAG,0,1166886
fldAp,0.047619047619047616,20,20,GGGGTACACGGGTGACAGTG,0,1112110
fldAp,0.047619047619047616,20,20,GGGCCTGGTGAAACTTTAAC,0,1070827
fldAp,0.047619047619047616,20,20,GGCTGCAATGTCACGAGATC,0,1095981
fldAp,0.047619047619047616,20,20,GGCGTAAAACTAGGTGAAGG,0,1079001
fldAp,0.047619047619047616,20,20,GGCCCACATGGGGGGAGTCT,0,1144323
fldAp,0.047619047619047616,20,20,GGATGGAACTCGGTAATCTA,0,1149998
fldAp,0.047619047619047616,20,20,GGATCCCACTAGACTGGCAA,0,1110947
fldAp,0.047619047619047616,20,20,GGAGCCACGCTGCCCAGCGA,0,1163263
fldAp,0.047619047619047616,20,20,GGAAATTGTGGGCGAGTCAT,0,1079134
fldAp,0.047619047619047616,20,20,GCTAACGCTTGAGCGGCCTG,0,1076547
fldAp,0.047619047619047616,20,20,GCGTATACAGTCCAGCGTGA,0,1070662
fldAp,0.047619047619047616,20,20,GCGCTCCATCGGCATCAAGA,0,1094572
fldAp,0.047619047619047616,20,20,GCGACAACCTAAAGGATAAT,0,1161044
fldAp,0.047619047619047616,20,20,GCCGTACGAACTAGGTGGAT,0,1165573
fldAp,0.047619047619047616,20,20,GCCCTTGCATGGGGTGTCAT,0,1167749
fldAp,0.047619047619047616,20,20,GCCCCCAACCTGCCGAGCCG,0,1087587
fldAp,0.047619047619047616,20,20,GCAATAACTCTATTGTAGGG,0,1067191
fldAp,0.047619047619047616,20,20,GATTACCTTCACATCGTCGT,0,1183130
fldAp,0.047619047619047616,20,20,GATGGGTGTGAAGCGGTATT,0,1072485
fldAp,0.047619047619047616,20,20,GAGCTTAAACAGGCTCTACA,0,1089683
fldAp,0.047619047619047616,20,20,GAGCTAAACATCTTCAGGGG,0,1158710
fldAp,0.047619047619047616,20,20,GAGCGCGATTTTGGGAATGA,0,1113961
fldAp,0.047619047619047616,20,20,GACGGCGCGCGTAAAGTGTT,0,1155832
fldAp,0.047619047619047616,20,20,GACGCTCGGCTCAGTGCCAC,0,1151452
fldAp,0.047619047619047616,20,20,GAACACCCGCGCAGGCCTGA,0,1114479
fldAp,0.047619047619047616,20,20,CTTTGTTCTCGGACGTAGAT,0,1132826
fldAp,0.047619047619047616,20,20,CTTTCGACGGCACTGGTCTA,0,1080514
fldAp,0.047619047619047616,20,20,CTGGCGTTGACCTTCGACGG,0,1095230
fldAp,0.047619047619047616,20,20,CTGATCGGGATTCAGTCTAG,0,1110462
fldAp,0.047619047619047616,20,20,CTCGGGGCATCCGAAATGGT,0,1175465
fldAp,0.047619047619047616,20,20,CTCCTTTCGGGGTCGAGGTA,0,1182918
fldAp,0.047619047619047616,20,20,CTCAAACTTCATTGCACTCT,0,1078558
fldAp,0.047619047619047616,20,20,CTATTTAGCAAGCAACGGAT,0,1071046
fldAp,0.047619047619047616,20,20,CGGCTTGTATTATTCGCATC,0,1069779
fldAp,0.047619047619047616,20,20,CGGCATCAGCGGTTGCATGG,0,1073452
fldAp,0.047619047619047616,20,20,CGGATCTCAAAGCTCGCGAA,0,1090279
fldAp,0.047619047619047616,20,20,CGGACAATGGGATCAGTACT,0,1119483
fldAp,0.047619047619047616,20,20,CGGAAGAATACCGCGAGTAC,0,1116742
fldAp,0.047619047619047616,20,20,CGGAACCGGGATGGCATGCT,0,1148011
fldAp,0.047619047619047616,20,20,CGCTTTAAGATCTGCACCTT,0,1151418
fldAp,0.047619047619047616,20,20,CGCTTGGTAAGAAGAGCACA,0,1067613
fldAp,0.047619047619047616,20,20,CGCGAACTGACATGTACATA,0,1088084
fldAp,0.047619047619047616,20,20,CGAGCTTTCATGAAAAACAT,0,1081449
fldAp,0.047619047619047616,20,20,CGACCACATAGTTCTTTCTG,0,1166526
fldAp,0.047619047619047616,20,20,CCTGGGGTCCTTATAAACAA,0,1115992
fldAp,0.047619047619047616,20,20,CCTGCCAGTCTCCTAGATTC,0,1143389
fldAp,0.047619047619047616,20,20,CCTCGTGGTCACGGGGGCTA,0,1078475
fldAp,0.047619047619047616,20,20,CCTCACTTCCGAAACGTCTG,0,1109923
fldAp,0.047619047619047616,20,20,CCTAGGGTCTGCTCTTCCAC,0,1171814
fldAp,0.047619047619047616,20,20,CCTAACACCTTGGGTACGAG,0,1106421
fldAp,0.047619047619047616,20,20,CCGTTGTATAATTCTGCGCT,0,1107984
fldAp,0.047619047619047616,20,20,CCGTCTTCGTTGGCTTGGGA,0,1129459
fldAp,0.047619047619047616,20,20,CCGTCGCTGCCCAGTCGCGA,0,1183529
fldAp,0.047619047619047616,20,20,CCGGGAGCCATCTCGACGAT,0,1096897
fldAp,0.047619047619047616,20,20,CCCTATCAGCCTAAACGCTA,0,1127526
fldAp,0.047619047619047616,20,20,CCCGGTTGGTCGTGCGGCAA,0,1176391
fldAp,0.047619047619047616,20,20,CCCAACTTGCCACTGACACA,0,1136336
fldAp,0.047619047619047616,20,20,CCCAAACAACCCAGCTAAAA,0,1073426
fldAp,0.047619047619047616,20,20,CCAGTGGGGGGGACGAGTGA,0,1121451
fldAp,0.047619047619047616,20,20,CCACCCTAGAGGTTATTTTC,0,1127421
fldAp,0.047619047619047616,20,20,CATTCCAGGATGTAAAAACC,0,1148335
fldAp,0.047619047619047616,20,20,CATCGGTCAGGCGTCGATCA,0,1068162
fldAp,0.047619047619047616,20,20,CATCGAAGTCCAAGGCCCCG,0,1167598
fldAp,0.047619047619047616,20,20,CATCAAAAAGGGTGGCAGGG,0,1156458
fldAp,0.047619047619047616,20,20,CAGGTAGTGAGACTCCCAAC,0,1073803
fldAp,0.047619047619047616,20,20,CAGCACGTTACGCTAATCAG,0,1162207
fldAp,0.047619047619047616,20,20,CAGATGTCCATTGGCTATAT,0,1164616
fldAp,0.047619047619047616,20,20,CACTGATTTGGTCTGTGATC,0,1113919
fldAp,0.047619047619047616,20,20,CACTAAGTGCAATCCGGCAG,0,1138076
fldAp,0.047619047619047616,20,20,CACGTTAAAAACTAATCTTT,0,1070962
fldAp,0.047619047619047616,20,20,CACCCTGAAGGGTACTGGTG,0,1078376
fldAp,0.047619047619047616,20,20,CACCCCGTGTCTCAAAAACC,0,1071888
fldAp,0.047619047619047616,20,20,CAATTCCACGTACATAGGCC,0,1135064
fldAp,0.047619047619047616,20,20,CAAGACAGCTTAACATCTTT,0,1176727
fldAp,0.047619047619047616,20,20,CAAATAACGCCGCAATACGT,0,1074084
fldAp,0.047619047619047616,20,20,ATTGCCACGTTCTACTGCCA,0,1158952
fldAp,0.047619047619047616,20,20,ATTATATTGGTCGTGAGTTT,0,1069567
fldAp,0.047619047619047616,20,20,ATTATAACGCGTGTGAAAGC,0,1172992
fldAp,0.047619047619047616,20,20,ATGTATCCGGCGTCACGGAG,0,1083396
fldAp,0.047619047619047616,20,20,ATGTAGAATGAACGCGGTGG,0,1131405
fldAp,0.047619047619047616,20,20,ATGGTAATTGTTTGTTCAGC,0,1071968
fldAp,0.047619047619047616,20,20,ATGATAGGCTTAATATTTCA,0,1181886
fldAp,0.047619047619047616,20,20,ATGACCTATAACACAGTACA,0,1096470
fldAp,0.047619047619047616,20,20,ATCTCGATTGTCGGACTTTC,0,1154907
fldAp,0.047619047619047616,20,20,ATCCCCTGCTGGGTAGTAAT,0,1131869
fldAp,0.047619047619047616,20,20,ATCATGTCACCTATATTCAC,0,1145824
fldAp,0.047619047619047616,20,20,ATCAATCTAGCCTTCACATT,0,1120672
fldAp,0.047619047619047616,20,20,ATCAACGAGTACGTGACATA,0,1091440
fldAp,0.047619047619047616,20,20,ATAGTTGCACCTCAGGGGAT,0,1180089
fldAp,0.047619047619047616,20,20,ATACGGTCCCGTGCCGCCGG,0,1090300
fldAp,0.047619047619047616,20,20,ATACCAAGGTGACTCCTTCA,0,1110371
fldAp,0.047619047619047616,20,20,ATACCAAATCTGCGTAGCGG,0,1100069
fldAp,0.047619047619047616,20,20,ATAATGGTTTGACTGTTCAA,0,1160563
fldAp,0.047619047619047616,20,20,AGTGTGTCCGAATACGGACA,0,1123736
fldAp,0.047619047619047616,20,20,AGTGGCTTCACTGACCATGC,0,1163294
fldAp,0.047619047619047616,20,20,AGTAAAGTGGAAGGTTGGAT,0,1131145
fldAp,0.047619047619047616,20,20,AGGTGGTAGAGTGTCGTGGT,0,1177158
fldAp,0.047619047619047616,20,20,AGGTCGGCGAAGTACCACTT,0,1146066
fldAp,0.047619047619047616,20,20,AGGCGCCTGTCGGGCCATGG,0,1118091
fldAp,0.047619047619047616,20,20,AGGCCGAAGCTGAGTGCATG,0,1153170
fldAp,0.047619047619047616,20,20,AGGAATTTTATGAGAGTGCA,0,1085157
fldAp,0.047619047619047616,20,20,AGCCGTCCTAGTCCCGAGTC,0,1074653
fldAp,0.047619047619047616,20,20,AGCCCTCAATTTTAATGATC,0,1119044
fldAp,0.047619047619047616,20,20,AGCCCGTTTTACGGCATAAC,0,1133133
fldAp,0.047619047619047616,20,20,AGACTCTTGCCGGTGCGATC,0,1115466
fldAp,0.047619047619047616,20,20,AGAATGAATTTCTAGGGAAC,0,1104496
fldAp,0.047619047619047616,20,20,ACTTCCACGTTAATTATTTT,0,1074712
fldAp,0.047619047619047616,20,20,ACCGCCTGTAAGTTCAGGGT,0,1102400
fldAp,0.047619047619047616,20,20,ACATAGGGCATTGTGTATTT,0,1081173
fldAp,0.047619047619047616,20,20,ACAGTTCAGCAATGTTGGCA,0,1092906
fldAp,0.047619047619047616,20,20,ACAGAAAGCAGTCTTACTGG,0,1096104
fldAp,0.047619047619047616,20,20,ACAAGAGGTCTCGGACCTGT,0,1173854
fldAp,0.047619047619047616,20,20,AATCTGATAGTGTTTGGGCA,0,1072113
fldAp,0.047619047619047616,20,20,AATCTACTATATGTTGGTTG,0,1064685
fldAp,0.047619047619047616,20,20,AAGTGCACTTGCCCAGCCCG,0,1115377
fldAp,0.047619047619047616,20,20,AAGGCGCTAATTGATTCCTG,0,1149256
fldAp,0.047619047619047616,20,20,AAGGAATCAACGATATTCTT,0,1108267
fldAp,0.047619047619047616,20,20,AAGGAAATTCTGGAGTTGGA,0,1170837
fldAp,0.047619047619047616,20,20,AAGATGCGGCTATAAGTGAT,0,1079297
fldAp,0.047619047619047616,20,20,AACTTGATTGCACGCGATTG,0,1150953
fldAp,0.047619047619047616,20,20,AACTCACGACCGCATCACAA,0,1101739
fldAp,0.047619047619047616,20,20,AACCTAGATGATTTTGGCTC,0,1091557
fldAp,0.047619047619047616,20,20,AACCGAGTCATACCAGCTTA,0,1117469
fldAp,0.047619047619047616,20,20,AACCATGACCCTCTACACGG,0,1170968
fldAp,0.047619047619047616,20,20,AACACTTCGGGCTGCATTCA,0,1153273
fldAp,0.047619047619047616,20,20,AAAGTTGAAGAGCTTACCAG,0,1063126
fldAp,0.05,19,19,TTTTGGTACTCCCGAGACAT,0,1064626
fldAp,0.05,19,19,TTTGCCATTGACTCCGTATA,0,1071094
fldAp,0.05,19,19,TTTCGGCGTCATAGAATAAA,0,1067761
fldAp,0.05,19,19,TTTCCAGAAAGAACTGCACT,0,1125892
fldAp,0.05,19,19,TTGGTAATTTGTTTGCCGCG,0,1153542
fldAp,0.05,19,19,TTATAAGATAACCGCCAGGT,0,1177321
fldAp,0.05,19,19,TTAGGTCTGCACGGGTTAGG,0,1123559
fldAp,0.05,19,19,TGTGTAAGGGGATTCCACGT,0,1140958
fldAp,0.05,19,19,TGTGCGCGCGCAATGACGGC,0,1101594
fldAp,0.05,19,19,TGTGAGCAGTGGCGCGAGTA,0,1068763
fldAp,0.05,19,19,TGTCCGAAGCGGAAGGCTGT,0,1162098
fldAp,0.05,19,19,TGGTGAATTGTGGGGCGCTG,0,1131015
fldAp,0.05,19,19,TGGGAATCAGTTAACTTTGG,0,1125989
fldAp,0.05,19,19,TGGCGAGGTGATACTGTGCA,0,1084050
fldAp,0.05,19,19,TGGCAAGGAAATTCGTGTCA,0,1072177
fldAp,0.05,19,19,TGCTATCTTTAATGGAAATT,0,1087613
fldAp,0.05,19,19,TGCAAGATCGTGGCGATACG,0,1133182
fldAp,0.05,19,19,TGATCTATTGCTCCGACTGA,0,1121873
fldAp,0.05,19,19,TGAGATCGGGTAGTACGCAG,0,1102355
fldAp,0.05,19,19,TGACTAAATATCACTTACTG,0,1119860
fldAp,0.05,19,19,TGAAGTACCTCCGCCATGTC,0,1185743
fldAp,0.05,19,19,TCTACTCGGTATCCGCCTCC,0,1169727
fldAp,0.05,19,19,TCGTTGAGTTATTTGGGAGT,0,1149267
fldAp,0.05,19,19,TCGTCGCGAATCTTTGCGTC,0,1080612
fldAp,0.05,19,19,TCGGCCTATCCTATGACGGT,0,1104356
fldAp,0.05,19,19,TCGAGGAGGGCACTGTTTTA,0,1106278
fldAp,0.05,19,19,TCGACTCTGTGAACGTTTTC,0,1136668
fldAp,0.05,19,19,TCCTTGTGAGAAAGTTACGT,0,1180092
fldAp,0.05,19,19,TCCTTAGCGAGCATACTGAT,0,1100843
fldAp,0.05,19,19,TCCAGTTGTTTTTAATCACA,0,1092641
fldAp,0.05,19,19,TCCAAGTCTGGGGCCGAGCT,0,1159738
fldAp,0.05,19,19,TCATGAGTGTTCAAAAGGAA,0,1181018
fldAp,0.05,19,19,TCAGTAATCTTTCATCGTCA,0,1077322
fldAp,0.05,19,19,TCACCGCTCCGTATTCAACA,0,1068219
fldAp,0.05,19,19,TATTCACGCGTCACGCTCAG,0,1097488
fldAp,0.05,19,19,TATTAGCTAACCAAGAGGCT,0,1166820
fldAp,0.05,19,19,TATTACAATATGCTAAAGAT,0,1171976
fldAp,0.05,19,19,TATGCCCACTGGGCATCCTC,0,1181950
fldAp,0.05,19,19,TATCGAAAAGCTAACGATGA,0,1153953
fldAp,0.05,19,19,TATATGATAGAGCATGGCCA,0,1169411
fldAp,0.05,19,19,TAGCTCCACAAACACGTAGT,0,1140758
fldAp,0.05,19,19,TAGCCTCACCGCTGTACTTA,0,1088934
fldAp,0.05,19,19,TAGCATGATCACTCACTACT,0,1158493
fldAp,0.05,19,19,TACGTCCACCGTTATCTCAA,0,1091003
fldAp,0.05,19,19,TACGACGCGATATAATATGT,0,1081846
fldAp,0.05,19,19,TACCCTGTCGGGAGGAAGAC,0,1070410
fldAp,0.05,19,19,TAATTGACCCGGGTCGGCCT,0,1123582
fldAp,0.05,19,19,TAATCACATGCACCAGTCAT,0,1128383
fldAp,0.05,19,19,TAAGTTCGCAGGCTGCCGTA,0,1139228
fldAp,0.05,19,19,TAAGCAAGCTGTCGCTTGCA,0,1093708
fldAp,0.05,19,19,TAACGAAACCATTTGGGTCC,0,1096173
fldAp,0.05,19,19,TAAATTAGAGCCGCTGGTTC,0,1064359
fldAp,0.05,19,19,GTTTGGTGGCGACTCGAAAA,0,1113074
fldAp,0.05,19,19,GTTCGTCTGGCCTCAGATGG,0,1132881
fldAp,0.05,19,19,GTTCGCCTGTGTAGCCGGGG,0,1115894
fldAp,0.05,19,19,GTTCAGTAAACTACTTTGGC,0,1175952
fldAp,0.05,19,19,GTTAAGAGATCCCTCACCGA,0,1142758
fldAp,0.05,19,19,GTGTGATGTATTTGGCCTGG,0,1071048
fldAp,0.05,19,19,GTGTATCCTAAGGAAGCGAA,0,1180960
fldAp,0.05,19,19,GTGGTGTAATTCAGAGTTCT,0,1113946
fldAp,0.05,19,19,GTGCGGGCGAAGTCTTCCAT,0,1137196
fldAp,0.05,19,19,GTGAGTGCAGACGGAGCCAT,0,1073979
fldAp,0.05,19,19,GTGAGCACGCTGGTGGTTAA,0,1083565
fldAp,0.05,19,19,GTGAGAATGCTCAGCTTCTG,0,1094488
fldAp,0.05,19,19,GTGACATCTCTTGGAATTAA,0,1149945
fldAp,0.05,19,19,GTCAGGCTCGGGTATGATCA,0,1178013
fldAp,0.05,19,19,GTCAATATCTTGACCGAATA,0,1162945
fldAp,0.05,19,19,GTACCCACGAATCAACGTAA,0,1123347
fldAp,0.05,19,19,GTACACGCGCTTGCTCGGTT,0,1088371
fldAp,0.05,19,19,GGTTACCTCTTGCTTTAGTC,0,1086824
fldAp,0.05,19,19,GGTGGCTCTAGTGGCTCGGT,0,1132724
fldAp,0.05,19,19,GGTCTTAGTCGAAGACAAAA,0,1118630
fldAp,0.05,19,19,GGTCCCGAGCATGGAGCTGA,0,1063316
fldAp,0.05,19,19,GGTCACTCAAGATATGGAAG,0,1177151
fldAp,0.05,19,19,GGTATCTTTAGCTGGCAGAA,0,1121393
fldAp,0.05,19,19,GGTAACGGCGCTGTATTTTC,0,1144979
fldAp,0.05,19,19,GGGTCCACGGAAATAACATA,0,1094566
fldAp,0.05,19,19,GGGATCGCCAGTGCGTATCT,0,1064579
fldAp,0.05,19,19,GGGAACGGCTCGTAGAACAT,0,1081369
fldAp,0.05,19,19,GGCTAGGTTATAGTTCCAGG,0,1140320
fldAp,0.05,19,19,GGCCGAGTCCTATCGGAAAT,0,1065955
fldAp,0.05,19,19,GGCCCCATTACTCCAGGCCC,0,1159828
fldAp,0.05,19,19,GGCAGATGCCTTATTCGCCT,0,1143076
fldAp,0.05,19,19,GGATAAACTGAGAAGGTTTT,0,1109512
fldAp,0.05,19,19,GGACGCATGACTGGATACCC,0,1125962
fldAp,0.05,19,19,GGAATGCGTGAATATTTCAG,0,1130644
fldAp,0.05,19,19,GGAACCATATTACAGATTTA,0,1123959
fldAp,0.05,19,19,GGAACAGCCCGGGGATAGCG,0,1105162
fldAp,0.05,19,19,GCTTTGTGGATGTTTAATCC,0,1179999
fldAp,0.05,19,19,GCTGCCCCTCCCGCTCACAC,0,1120600
fldAp,0.05,19,19,GCTAGCGCGCCGCTGATTAT,0,1142318
fldAp,0.05,19,19,GCTACGATGATTTGTCCTAC,0,1146482
fldAp,0.05,19,19,GCTAAGTGACTACGGAATTG,0,1089081
fldAp,0.05,19,19,GCGTGCAAGTGAACCGCAAG,0,1178079
fldAp,0.05,19,19,GCGGACACGTCAGCGTAGAA,0,1092139
fldAp,0.05,19,19,GCGCGGGTCTTGGGGTTTCA,0,1116123
fldAp,0.05,19,19,GCGACCGTGTCAGTAGAGGT,0,1115350
fldAp,0.05,19,19,GCGAAAATTCCTATCATGGT,0,1111468
fldAp,0.05,19,19,GCCCGCTTGAGAGCCATCAT,0,1134018
fldAp,0.05,19,19,GCCATCGTTACGGGACTTGA,0,1108704
fldAp,0.05,19,19,GCCAAAAAGGTAGATGGGGC,0,1156630
fldAp,0.05,19,19,GATTTGAGCACAGGTGACGT,0,1104060
fldAp,0.05,19,19,GATTGTCGGCACCGTTTAAC,0,1183311
fldAp,0.05,19,19,GATTCAACTATATCATAAAT,0,1134044
fldAp,0.05,19,19,GATGTAAGGGTCGGATGACT,0,1178805
fldAp,0.05,19,19,GATGGCACACGAAACGTATT,0,1142386
fldAp,0.05,19,19,GATCGTCGTGAATCGTTATT,0,1153596
fldAp,0.05,19,19,GATCGCTATAGCTGTGGGCT,0,1121473
fldAp,0.05,19,19,GATCCTCGCGTAAATAGAGT,0,1089013
fldAp,0.05,19,19,GATCCCGGAACGGGTTGTTT,0,1170225
fldAp,0.05,19,19,GATAACTGTGTGGTAGCCTT,0,1067969
fldAp,0.05,19,19,GAGGTCGAATTCCGACGATT,0,1070666
fldAp,0.05,19,19,GAGCGGTTGATTAACAAGAT,0,1146088
fldAp,0.05,19,19,GAGCCGTTCCCTTTTTAATA,0,1108415
fldAp,0.05,19,19,GAGCCCTTAATTCTCCTACC,0,1102887
fldAp,0.05,19,19,GACTTGGTTGGTTAGGTGAA,0,1101020
fldAp,0.05,19,19,GACTCGTCTCTTAGACGATT,0,1148983
fldAp,0.05,19,19,GACGCACACCCGGGACGTCA,0,1125508
fldAp,0.05,19,19,GACCTGAGTGCTGCTGAAGG,0,1097898
fldAp,0.05,19,19,GACCGCACAATCCCGGATAA,0,1081431
fldAp,0.05,19,19,GACAGCATCAGGTCGCGGGA,0,1158141
fldAp,0.05,19,19,GACAAACAGGGGAGAGCTCT,0,1100034
fldAp,0.05,19,19,GAATGCGCCGGTATAATAAG,0,1163521
fldAp,0.05,19,19,GAATGAGGTCAAGGCATTCA,0,1104138
fldAp,0.05,19,19,GAATCGGCTACCGTTTACCA,0,1175384
fldAp,0.05,19,19,GAAGGGTTTAGCTCCTCAGT,0,1064131
fldAp,0.05,19,19,GAAGGAAGGGGTCTCACGCT,0,1065715
fldAp,0.05,19,19,GAAAGCATGCGAGAGGCACC,0,1146729
fldAp,0.05,19,19,CTTTCCGCTGAAAGACTGTA,0,1075005
fldAp,0.05,19,19,CTTTCCCAAGCCGGAAGATT,0,1094213
fldAp,0.05,19,19,CTTGGGGTCAGTGAAGGAGT,0,1176280
fldAp,0.05,19,19,CTGGTACGGGCAGGCATATT,0,1071737
fldAp,0.05,19,19,CTGACGATTGCCCAATAATG,0,1081925
fldAp,0.05,19,19,CTGAATGCGTTTGGCTCGTT,0,1075079
fldAp,0.05,19,19,CTGAAAGTTCGCTCTTCACA,0,1108619
fldAp,0.05,19,19,CTCTTTCCAATATTTGAGAG,0,1147073
fldAp,0.05,19,19,CTCGAGAAGTGAATGGTTTG,0,1128623
fldAp,0.05,19,19,CTCCCAACTGCTTTGGAGCT,0,1096016
fldAp,0.05,19,19,CTATCGGTGTCGGTCCTGAT,0,1127939
fldAp,0.05,19,19,CTATACCTTTCTGAGCCTTG,0,1110628
fldAp,0.05,19,19,CTAGCAACAGGCTACTAATA,0,1071526
fldAp,0.05,19,19,CTACGTCTCCAATCGTGCTC,0,1117999
fldAp,0.05,19,19,CTACGTATAGCAAACAGATT,0,1128606
fldAp,0.05,19,19,CTAACCGGGGATTATTCCTA,0,1142270
fldAp,0.05,19,19,CGTTAAGACGCAGGACTGTA,0,1063300
fldAp,0.05,19,19,CGTGTGAAATACGGTACACC,0,1139478
fldAp,0.05,19,19,CGTGGTGTAGAAGTCTCAAG,0,1106284
fldAp,0.05,19,19,CGTGCACCGCGTTACTCCGT,0,1098507
fldAp,0.05,19,19,CGTCCAGGGGTCATTCCAAC,0,1186507
fldAp,0.05,19,19,CGTACAGGGGCATCGTTAAG,0,1169792
fldAp,0.05,19,19,CGGTTATTATTGGAGGTAGA,0,1126985
fldAp,0.05,19,19,CGGTAACGATCAAGCGGTCA,0,1152065
fldAp,0.05,19,19,CGGGTTACCTAGTAAGGGCT,0,1095783
fldAp,0.05,19,19,CGGGGCGACCGCGGATGCCA,0,1146672
fldAp,0.05,19,19,CGCTGTACTTTTACGGACAT,0,1063377
fldAp,0.05,19,19,CGCATCTGGACACACAGGTC,0,1084716
fldAp,0.05,19,19,CGCATCGGTTCCACCGCGAG,0,1144859
fldAp,0.05,19,19,CGATTCCTGGGGGTGCCAGA,0,1062979
fldAp,0.05,19,19,CGAGACGGACAGCCCATGTC,0,1089934
fldAp,0.05,19,19,CGACGCAGTGAAAGCTACTG,0,1077451
fldAp,0.05,19,19,CGACCCGACCGCGGACAGCA,0,1087768
fldAp,0.05,19,19,CGACCATCACGTTTAACAAG,0,1186185
fldAp,0.05,19,19,CGAATTACTGATGGCGGTTT,0,1126669
fldAp,0.05,19,19,CCTTGGCAGCGGCGGAAATT,0,1102222
fldAp,0.05,19,19,CCTGTCTATATTGGGTCATT,0,1140647
fldAp,0.05,19,19,CCTCCCCCTCACGTGCTCTG,0,1087497
fldAp,0.05,19,19,CCGTTCGAGAATGCTAGAGT,0,1140462
fldAp,0.05,19,19,CCGTCCCGCTTCCAAACAGC,0,1077171
fldAp,0.05,19,19,CCGGTATAGCGCTATATTAC,0,1135741
fldAp,0.05,19,19,CCGAAGGATACGTGCCGCAT,0,1177747
fldAp,0.05,19,19,CCCGTTTAGGTCCTGAGACT,0,1075037
fldAp,0.05,19,19,CCAGTTCGACACTCTTGACT,0,1130594
fldAp,0.05,19,19,CCAGAACCGAGCCATCTATT,0,1137042
fldAp,0.05,19,19,CCACTGGGCTCAGAGCTAGT,0,1179461
fldAp,0.05,19,19,CCACCCGGGTTGGTTGCATC,0,1109778
fldAp,0.05,19,19,CATTTGGGACCTGGATTCAC,0,1140537
fldAp,0.05,19,19,CAGGACCATGACCGGTACAG,0,1139672
fldAp,0.05,19,19,CAGCCAACCCGTCCAGGGCA,0,1149178
fldAp,0.05,19,19,CAGAACCGAACAGATGGACA,0,1070831
fldAp,0.05,19,19,CACTCCGTCCACTTCGCACG,0,1183804
fldAp,0.05,19,19,CACGACGCCCACCTATTTGT,0,1177710
fldAp,0.05,19,19,CACGACCGATGTCACTAGGT,0,1178331
fldAp,0.05,19,19,CACCTGCAATCGTTCGCCGC,0,1096019
fldAp,0.05,19,19,CAAGTAGATTGCGCTCAGTT,0,1150358
fldAp,0.05,19,19,CAACTGAACCTGGCGCTTGT,0,1138169
fldAp,0.05,19,19,CAAATCGCATATTAGACTGA,0,1123629
fldAp,0.05,19,19,ATTGGCAGGGTGATCGCAGC,0,1073513
fldAp,0.05,19,19,ATTCACGGTACATGTGGAAT,0,1163520
fldAp,0.05,19,19,ATGGCAACTATGAAGGGATA,0,1084521
fldAp,0.05,19,19,ATGATACCCGGTAGTCTTGT,0,1157594
fldAp,0.05,19,19,ATGAGCCCATCAAGTTGTCT,0,1110671
fldAp,0.05,19,19,ATCCCAGTGGAGTGTGCAAT,0,1094445
fldAp,0.05,19,19,ATATCTTTTACTTCTTACGC,0,1067017
fldAp,0.05,19,19,ATACCAAGCCTTACCTTTTC,0,1136425
fldAp,0.05,19,19,ATAATCGCGAAGAGTCAAGA,0,1078709
fldAp,0.05,19,19,ATAACGCCTGAAACACCCGT,0,1158417
fldAp,0.05,19,19,AGGGTGACAGCCATCTTCAC,0,1078466
fldAp,0.05,19,19,AGGCTTTCTAATATGTGAGC,0,1101788
fldAp,0.05,19,19,AGGAACTTCGCGAACAACAC,0,1112933
fldAp,0.05,19,19,AGCTTTCAATGTTACACGCT,0,1109791
fldAp,0.05,19,19,AGCTTGGTGGGCCATTATAT,0,1133083
fldAp,0.05,19,19,AGCGCTACACCGCAGCAAGT,0,1125988
fldAp,0.05,19,19,AGCCCGTTGGGCGAGCTACA,0,1126727
fldAp,0.05,19,19,AGACTTAGTCTGCACTTGGG,0,1144348
fldAp,0.05,19,19,AGACCTCCAACGAAGGACCT,0,1097792
fldAp,0.05,19,19,ACTCGTCGCGGACGCTAACT,0,1127479
fldAp,0.05,19,19,ACTATTGCAAAAAATTGGTT,0,1185265
fldAp,0.05,19,19,ACTACCGACACACAATCGTA,0,1108448
fldAp,0.05,19,19,ACTACACCGGGTGAGCGGGG,0,1099108
fldAp,0.05,19,19,ACGGCATCCCGGGGACAGGG,0,1180860
fldAp,0.05,19,19,ACGCACCTCAAGACGGAGTC,0,1098836
fldAp,0.05,19,19,ACCGTGGCAGGAGGTGGAAG,0,1133191
fldAp,0.05,19,19,ACCCGCGTGTCCGGAGCAGG,0,1122927
fldAp,0.05,19,19,ACCAACTCTGGTGAGCGGAT,0,1141339
fldAp,0.05,19,19,ACATCCAGCTTCCTATTATT,0,1112573
fldAp,0.05,19,19,ACAGTGTGCACACGGTTATC,0,1099274
fldAp,0.05,19,19,AATTAATTAATGCCATGAAT,0,1069138
fldAp,0.05,19,19,AATGTTACGCAGGTAGACAG,0,1098392
fldAp,0.05,19,19,AATGTATACAACAACGGCAT,0,1162740
fldAp,0.05,19,19,AATGTAGGGCATTGCGCGAC,0,1164704
fldAp,0.05,19,19,AATGTACTCGCCCATCCAAC,0,1075342
fldAp,0.05,19,19,AAGGGCAAGGGATTGGGTTG,0,1182958
fldAp,0.05,19,19,AAGGACTTTAGCGACGGACG,0,1089948
fldAp,0.05,19,19,AACGGACTAACGGGGCATAT,0,1186208
fldAp,0.05,19,19,AACGCCGGGTTTTCGGGCGA,0,1087663
fldAp,0.05,19,19,AACCTCACTCGGGGTGCACG,0,1154388
fldAp,0.05,19,19,AACCAGTCAGCACGGCTCTT,0,1144655
fldAp,0.05,19,19,AACAGGAGCTGCTCGTGCGG,0,1068249
fldAp,0.05,19,19,AACACTAAAGTGTCCTTGAT,0,1155348
fldAp,0.05,19,19,AAATTAACCTGCCCCCGTTA,0,1170124
fldAp,0.05,19,19,AAAAATACATAGCCTCTAGT,0,1074974
fldAp,0.05263157894736842,18,18,TTTTTCGTTGGTGATGTAGT,0,1107543
fldAp,0.05263157894736842,18,18,TTTGCCGAAAATTTGGAGCC,0,1124766
fldAp,0.05263157894736842,18,18,TTTCGGGAAGGTGTGTATTG,0,1167410
fldAp,0.05263157894736842,18,18,TTTAAGGGGGTCCAATAGCG,0,1145354
fldAp,0.05263157894736842,18,18,TTGGTCGGAAGAGGCGTGGC,0,1138792
fldAp,0.05263157894736842,18,18,TTGGTCCAAGGTTTTTGAAG,0,1135222
fldAp,0.05263157894736842,18,18,TTGGGTCTACTGTTGCGATG,0,1114133
fldAp,0.05263157894736842,18,18,TTGGACGCGGTGGCTAGCAT,0,1114753
fldAp,0.05263157894736842,18,18,TTGCACAGATTGGGTACTGA,0,1154790
fldAp,0.05263157894736842,18,18,TTGAGGTGCATAGGAATTTG,0,1068459
fldAp,0.05263157894736842,18,18,TTGAATAGCGGCCCTCCGCC,0,1070863
fldAp,0.05263157894736842,18,18,TTCTGATTGCTCTCGCTGCC,0,1092206
fldAp,0.05263157894736842,18,18,TTCTCCAAGTACCCATTGAG,0,1140979
fldAp,0.05263157894736842,18,18,TTCCATGGTTCTGCCTCATC,0,1072038
fldAp,0.05263157894736842,18,18,TTAAAGGGGAAGTCCCCCTC,0,1070850
fldAp,0.05263157894736842,18,18,TGTTCGTCAGTAGATCGGTA,0,1165318
fldAp,0.05263157894736842,18,18,TGTGATCGATCTCACTGCTG,0,1163699
fldAp,0.05263157894736842,18,18,TGTGACTGTTGGGTCGCCGT,0,1063062
fldAp,0.05263157894736842,18,18,TGTCCTATAGGGTCCCTGTT,0,1123631
fldAp,0.05263157894736842,18,18,TGTCCAGCTCCTAAAGATAT,0,1151658
fldAp,0.05263157894736842,18,18,TGTAGGTCGTACCCGCATGC,0,1137189
fldAp,0.05263157894736842,18,18,TGGGCGCGAAATAGGTCACA,0,1169307
fldAp,0.05263157894736842,18,18,TGGGAATTCTGCGAGGCACA,0,1173148
fldAp,0.05263157894736842,18,18,TGGAGTTTTTGGACCGTCAA,0,1183971
fldAp,0.05263157894736842,18,18,TGGAAGAAAGAATTATGCGA,0,1115893
fldAp,0.05263157894736842,18,18,TGCTCTGACTCCGCAAATCT,0,1087596
fldAp,0.05263157894736842,18,18,TGCGTCTACACCGGGGATTG,0,1137858
fldAp,0.05263157894736842,18,18,TGCGTACTACTGATTATAGG,0,1158031
fldAp,0.05263157894736842,18,18,TGCGCCTTGCTTTTTCCCGA,0,1099276
fldAp,0.05263157894736842,18,18,TGCGATCCCGGAATGTGCTA,0,1078588
fldAp,0.05263157894736842,18,18,TGATGCAGGACCCTGGTAGA,0,1171336
fldAp,0.05263157894736842,18,18,TGATGACACACAGTGAGCGT,0,1120938
fldAp,0.05263157894736842,18,18,TGACAGCCGCATTCCCACTG,0,1172789
fldAp,0.05263157894736842,18,18,TCTGAGACGCTGAAGCTCAG,0,1133422
fldAp,0.05263157894736842,18,18,TCTCGCGTTGATCGGCTGGA,0,1095770
fldAp,0.05263157894736842,18,18,TCGTTTGCTTGGCTCTAATG,0,1166195
fldAp,0.05263157894736842,18,18,TCGTTGGTTAGTAGAGCGAC,0,1130194
fldAp,0.05263157894736842,18,18,TCGGGTGGTCACAGTGCGGA,0,1102079
fldAp,0.05263157894736842,18,18,TCGCGCTATGTACAAGAGTC,0,1068440
fldAp,0.05263157894736842,18,18,TCGAGGTTAACTGCGGTTAC,0,1178529
fldAp,0.05263157894736842,18,18,TCGACCGTCACATTCCAAAA,0,1138216
fldAp,0.05263157894736842,18,18,TCCTTGAGACCCAAGCGACC,0,1169505
fldAp,0.05263157894736842,18,18,TCCTGACATAGGTTAGACCA,0,1154354
fldAp,0.05263157894736842,18,18,TCCTCGATGGTGGGCATTTA,0,1167260
fldAp,0.05263157894736842,18,18,TCCGACAACCGATCCGGATT,0,1185602
fldAp,0.05263157894736842,18,18,TCCATTCGGTAGCCAAAGCT,0,1139835
fldAp,0.05263157894736842,18,18,TCCAAGACCTTCGGTTGCCC,0,1129542
fldAp,0.05263157894736842,18,18,TCACTGTCTAGCTCCTTTCG,0,1169600
fldAp,0.05263157894736842,18,18,TCACTGGAGCCATCTTGCTG,0,1136287
fldAp,0.05263157894736842,18,18,TCAACAGCATCTACTCCTAG,0,1068360
fldAp,0.05263157894736842,18,18,TCAAATGATACATAACGATT,0,1139665
fldAp,0.05263157894736842,18,18,TAGCATACAACAGTTGCTGA,0,1074764
fldAp,0.05263157894736842,18,18,TAGAGTTGAATCTCTAGACG,0,1098573
fldAp,0.05263157894736842,18,18,TACCTATATATGTAGGACAC,0,1076819
fldAp,0.05263157894736842,18,18,TACCCAAGCTCCATACTGTC,0,1170838
fldAp,0.05263157894736842,18,18,TACCAGATGGAATCCTGACT,0,1076937
fldAp,0.05263157894736842,18,18,TACATTGCGCCCGAGCGCAA,0,1104392
fldAp,0.05263157894736842,18,18,TAATTCGCAGCGCACGCATT,0,1116243
fldAp,0.05263157894736842,18,18,TAAGTACTATATGAATTCGT,0,1109139
fldAp,0.05263157894736842,18,18,TAACCCGATGAGTTAGATCA,0,1134915
fldAp,0.05263157894736842,18,18,TAAATCCCAGTTCGTTTACC,0,1159473
fldAp,0.05263157894736842,18,18,TAAATAATTAGGTGTCAAAC,0,1093525
fldAp,0.05263157894736842,18,18,TAAACGGGGCCAGTCCAGAC,0,1065215
fldAp,0.05263157894736842,18,18,GTGGTAAGAAAACGTACGGG,0,1186279
fldAp,0.05263157894736842,18,18,GTGCGCATAGAGCGACCGAA,0,1165309
fldAp,0.05263157894736842,18,18,GTGAAGGAACACAATGTATA,0,1184527
fldAp,0.05263157894736842,18,18,GTCCATGCTACTCGGGGCTT,0,1179064
fldAp,0.05263157894736842,18,18,GTATTGAGCGCGATGAGCCT,0,1179815
fldAp,0.05263157894736842,18,18,GTATTAGTCCACTAGAACGG,0,1070130
fldAp,0.05263157894736842,18,18,GTAGGCTCAAGCAACTTCCA,0,1079528
fldAp,0.05263157894736842,18,18,GTAGCCCTTCGACCAACCTT,0,1139081
fldAp,0.05263157894736842,18,18,GGTTGTTCCGAGCATTTGGA,0,1144882
fldAp,0.05263157894736842,18,18,GGTTCGTGAGTCGGTATCTA,0,1171802
fldAp,0.05263157894736842,18,18,GGTGGTTACGTGTTCACGAT,0,1108437
fldAp,0.05263157894736842,18,18,GGTGCTGCAGTTGACACTTG,0,1150743
fldAp,0.05263157894736842,18,18,GGTATTAGACAGAACCTCGC,0,1144725
fldAp,0.05263157894736842,18,18,GGTAGGCGGGCAGTCTCGCT,0,1168535
fldAp,0.05263157894736842,18,18,GGTAGCTCGAGCACACCCGC,0,1101174
fldAp,0.05263157894736842,18,18,GGTAGAGGGCTCACCCCATA,0,1182959
fldAp,0.05263157894736842,18,18,GGTACTTCTTTGCCCTCTGA,0,1066474
fldAp,0.05263157894736842,18,18,GGGGCGTTTTGTTTGTCCCT,0,1151942
fldAp,0.05263157894736842,18,18,GGCTCACGATATCGACACTG,0,1160217
fldAp,0.05263157894736842,18,18,GGCGCGTCAATCACGAGCGC,0,1158235
fldAp,0.05263157894736842,18,18,GGCAGCGCTAAATCTCTACG,0,1153090
fldAp,0.05263157894736842,18,18,GGATCGACTGATATTGAAAA,0,1079786
fldAp,0.05263157894736842,18,18,GGATATCTACCCGGTGAAAT,0,1132310
fldAp,0.05263157894736842,18,18,GGACCCGTTGTGGGCTCTAC,0,1066983
fldAp,0.05263157894736842,18,18,GGACCCCCAAGACTTACTAC,0,1145540
fldAp,0.05263157894736842,18,18,GGAAACCGACGCGCGATTGT,0,1085605
fldAp,0.05263157894736842,18,18,GCTTTAGAGCGGTATTGTTA,0,1082542
fldAp,0.05263157894736842,18,18,GCTTGCTTGCTTGCTCGGCT,0,1124213
fldAp,0.05263157894736842,18,18,GCTTGATAGGCATATTTGTT,0,1166480
fldAp,0.05263157894736842,18,18,GCTTCTATGCGACAGGGACC,0,1075599
fldAp,0.05263157894736842,18,18,GCTTAGATCGATTTGATTGC,0,1152140
fldAp,0.05263157894736842,18,18,GCTGTGATGGTAATTGTGCA,0,1120280
fldAp,0.05263157894736842,18,18,GCTGGCCAGGCTTTCACGAA,0,1131688
fldAp,0.05263157894736842,18,18,GCTACTGTCCACATGTAACT,0,1131754
fldAp,0.05263157894736842,18,18,GCTAATTACCGGGCTATTGT,0,1121290
fldAp,0.05263157894736842,18,18,GCGGCTCTGCACGAGTGCGC,0,1184495
fldAp,0.05263157894736842,18,18,GCCAGGCAGTCCGCCCCCGG,0,1085938
fldAp,0.05263157894736842,18,18,GCCAAGTAAACGGACGAAGG,0,1079243
fldAp,0.05263157894736842,18,18,GCACTGGCATGCCCGACCGA,0,1140033
fldAp,0.05263157894736842,18,18,GCACGGTAGTAACAAATAAA,0,1073989
fldAp,0.05263157894736842,18,18,GCACGGAGTCACGTCAATTC,0,1100838
fldAp,0.05263157894736842,18,18,GATTAACATACCTGGACATT,0,1085509
fldAp,0.05263157894736842,18,18,GATCCTTGCTGATTCGGGTC,0,1146669
fldAp,0.05263157894736842,18,18,GAGGGCATACAGCGAACTCA,0,1149259
fldAp,0.05263157894736842,18,18,GAGGCGGCGTAACTGAAACG,0,1140326
fldAp,0.05263157894736842,18,18,GAGGCCGTACAGATTTTGTA,0,1103240
fldAp,0.05263157894736842,18,18,GAGCGAGAAGTAGCGACTCA,0,1128357
fldAp,0.05263157894736842,18,18,GACTTTTGGGCCTCCAGTGG,0,1072660
fldAp,0.05263157894736842,18,18,GACTGAGCTGCAAGTACTAA,0,1074870
fldAp,0.05263157894736842,18,18,GACGTGAGTACTCTATGAAC,0,1145364
fldAp,0.05263157894736842,18,18,GAATTGACACTAGCAGCCAA,0,1126619
fldAp,0.05263157894736842,18,18,GAATATTTACCTTATTGATT,0,1111261
fldAp,0.05263157894736842,18,18,GAAGCTAATATCTGTATCGG,0,1176131
fldAp,0.05263157894736842,18,18,CTTTTACCGAGTAGCGTAAC,0,1083019
fldAp,0.05263157894736842,18,18,CTTTGTCGATGTGGAGGCAA,0,1165054
fldAp,0.05263157894736842,18,18,CTTCATCTATGACTATCGTA,0,1093886
fldAp,0.05263157894736842,18,18,CTGTTCTGCAAATCAGCGGA,0,1094616
fldAp,0.05263157894736842,18,18,CTGTCGGGGTCGGCTAACCA,0,1063914
fldAp,0.05263157894736842,18,18,CTGAGGGTATCGTGCCTCAG,0,1079076
fldAp,0.05263157894736842,18,18,CTCTTCGCGACGACTCGACT,0,1139956
fldAp,0.05263157894736842,18,18,CTCTAGTGGGAACTGTGCGT,0,1102325
fldAp,0.05263157894736842,18,18,CTCAGCCGTCAGTAAATATA,0,1137204
fldAp,0.05263157894736842,18,18,CTATCTGGAACATCGCATGG,0,1134928
fldAp,0.05263157894736842,18,18,CTATAGGAGTTTTTTGCCGG,0,1125697
fldAp,0.05263157894736842,18,18,CTATAATCTTAGGACATGAA,0,1125682
fldAp,0.05263157894736842,18,18,CTAGACAGGTTGAATGAGAA,0,1125903
fldAp,0.05263157894736842,18,18,CTAATGAGAACTGCGGAGCA,0,1166460
fldAp,0.05263157894736842,18,18,CTAATGACAACTGCTGTTGC,0,1098823
fldAp,0.05263157894736842,18,18,CGTCCATCACGGCTGCCTGG,0,1160654
fldAp,0.05263157894736842,18,18,CGGGAGCCACACACGATGGT,0,1114664
fldAp,0.05263157894736842,18,18,CGGCTCCTCATGGCATTTGG,0,1132628
fldAp,0.05263157894736842,18,18,CGGCCAGTCTTTAGGACACA,0,1067469
fldAp,0.05263157894736842,18,18,CGGAACAAACGTTAAGACCG,0,1136350
fldAp,0.05263157894736842,18,18,CGCTGAGACCCGGTTGAAGG,0,1182172
fldAp,0.05263157894736842,18,18,CGCTAAACTGCGTTACAGGT,0,1159348
fldAp,0.05263157894736842,18,18,CGCGTCATTATGACCACAGT,0,1098373
fldAp,0.05263157894736842,18,18,CGCGTATTCTGATGGGTTTT,0,1064876
fldAp,0.05263157894736842,18,18,CGCCTCCCTCGCTAATCTTA,0,1143907
fldAp,0.05263157894736842,18,18,CGCCTAAGTATAAAGCTTCG,0,1158028
fldAp,0.05263157894736842,18,18,CGCACTCCTTACAGTATTTT,0,1106279
fldAp,0.05263157894736842,18,18,CGATGGAGGGTGGACATCAG,0,1106678
fldAp,0.05263157894736842,18,18,CGATGCACGTTGTATTGAGC,0,1085588
fldAp,0.05263157894736842,18,18,CCTGGCAGTTCTTATGATAA,0,1177588
fldAp,0.05263157894736842,18,18,CCTCCCTGAGTGACCATGGT,0,1160845
fldAp,0.05263157894736842,18,18,CCTCATGGGCAGAGATTCTG,0,1089034
fldAp,0.05263157894736842,18,18,CCTAAGGCGAGATAGCCACC,0,1135951
fldAp,0.05263157894736842,18,18,CCTAAAATTTTCTTGGAGCA,0,1146735
fldAp,0.05263157894736842,18,18,CCGTGCAAGCTCTCAGGTCT,0,1175392
fldAp,0.05263157894736842,18,18,CCGTAGGATTGACTTAGCCC,0,1080075
fldAp,0.05263157894736842,18,18,CCGGTTCCTAAATTCGAATC,0,1087016
fldAp,0.05263157894736842,18,18,CCGGTCCTTTTTGGACCCGA,0,1118841
fldAp,0.05263157894736842,18,18,CCGGGTATGCTTCGTTTGTG,0,1173954
fldAp,0.05263157894736842,18,18,CCGGCATTGGCAGAGTGGGT,0,1118419
fldAp,0.05263157894736842,18,18,CCGAGCTATAAACCAGAGAT,0,1181330
fldAp,0.05263157894736842,18,18,CCGAATATATTCACTCACTA,0,1180531
fldAp,0.05263157894736842,18,18,CCCTTGTGTAACCGATTCGA,0,1132541
fldAp,0.05263157894736842,18,18,CCCTCTATGATTGTGGGCAT,0,1102322
fldAp,0.05263157894736842,18,18,CCCGTATTGCACTGCATCAC,0,1114293
fldAp,0.05263157894736842,18,18,CCCGGTCGATCGCAACATCC,0,1066992
fldAp,0.05263157894736842,18,18,CCCGGTACAGTATCGACCAC,0,1145544
fldAp,0.05263157894736842,18,18,CCCGAGCACAATAACCTAGG,0,1098273
fldAp,0.05263157894736842,18,18,CCCCTTTCCTTCCTACCGCT,0,1119393
fldAp,0.05263157894736842,18,18,CCCATGGCCGTTTGGTGGTA,0,1153136
fldAp,0.05263157894736842,18,18,CCACGTTCGAGGAATGCCGG,0,1117111
fldAp,0.05263157894736842,18,18,CCACGTCATCGCCATCTAAC,0,1070835
fldAp,0.05263157894736842,18,18,CCACGTACCAACGGCGCTTG,0,1113295
fldAp,0.05263157894736842,18,18,CCACGGGGATGAGAATGTGT,0,1136204
fldAp,0.05263157894736842,18,18,CCACCATCGAACAAACCTAG,0,1088363
fldAp,0.05263157894736842,18,18,CATGGCGACGGGGTAGTACT,0,1066610
fldAp,0.05263157894736842,18,18,CATCAGAAAATTTTAAGGAG,0,1075032
fldAp,0.05263157894736842,18,18,CAGTGGCAAGGGTAGTTCAC,0,1175110
fldAp,0.05263157894736842,18,18,CAGGGTTGAGACTATGGTGG,0,1090439
fldAp,0.05263157894736842,18,18,CAGGGGTATTAGATTTCAGA,0,1095511
fldAp,0.05263157894736842,18,18,CAGGCACGTTACAGACCAGT,0,1149653
fldAp,0.05263157894736842,18,18,CAGCTTACAGCGCAAGTGTC,0,1124778
fldAp,0.05263157894736842,18,18,CAGCTCGCGTGGTAACACGT,0,1112791
fldAp,0.05263157894736842,18,18,CAGCGCTCTGGTATCCGAAA,0,1186288
fldAp,0.05263157894736842,18,18,CAGCGAGTGCACTTGGACCG,0,1115876
fldAp,0.05263157894736842,18,18,CAGATACATTTCGAGTGTCA,0,1132398
fldAp,0.05263157894736842,18,18,CACTATGTCTTGCCGGCTGA,0,1135507
fldAp,0.05263157894736842,18,18,CACATACGGGGCATGGTCAA,0,1110405
fldAp,0.05263157894736842,18,18,CACAGGCAGACTGTGACGAG,0,1186561
fldAp,0.05263157894736842,18,18,CACAAACCAGAGACAGCGGC,0,1157485
fldAp,0.05263157894736842,18,18,CAATATATGAGCTTTGCAAT,0,1108629
fldAp,0.05263157894736842,18,18,CAACGGCAGGGCGTGAATCT,0,1071736
fldAp,0.05263157894736842,18,18,CAAATTTGCTTTCAGTACTA,0,1073496
fldAp,0.05263157894736842,18,18,CAAAGCCACCTATCGCCATA,0,1131512
fldAp,0.05263157894736842,18,18,CAAAATCAGCAAAGCAGACA,0,1122599
fldAp,0.05263157894736842,18,18,CAAAAGATACTTGATGTCTT,0,1090525
fldAp,0.05263157894736842,18,18,ATTTTGGGGGATCCTCACAG,0,1108800
fldAp,0.05263157894736842,18,18,ATTTGGACGATAAGAACTCT,0,1140963
fldAp,0.05263157894736842,18,18,ATTGCACCCCGAAGGGAGGA,0,1091846
fldAp,0.05263157894736842,18,18,ATTCTTTGGGAGAGCCATTG,0,1103507
fldAp,0.05263157894736842,18,18,ATTCCTCGTCATTCCTCCCG,0,1088269
fldAp,0.05263157894736842,18,18,ATTATAATACCTTGACATTC,0,1064474
fldAp,0.05263157894736842,18,18,ATGTCTATTGTTACGGACTC,0,1183544
fldAp,0.05263157894736842,18,18,ATGGCGGGAGGCGAACCGAT,0,1092987
fldAp,0.05263157894736842,18,18,ATGCCATAAACCTGTGAATA,0,1118900
fldAp,0.05263157894736842,18,18,ATCTATTTGCCTGGGGCGGT,0,1075328
fldAp,0.05263157894736842,18,18,ATCCGCTTATCCTGACAACA,0,1103816
fldAp,0.05263157894736842,18,18,ATCCGATTTTAAAGGTTGTC,0,1181013
fldAp,0.05263157894736842,18,18,ATCATAAGTACACCAGGCTC,0,1065761
fldAp,0.05263157894736842,18,18,ATAGAGGCTGACGCGTCTGT,0,1146888
fldAp,0.05263157894736842,18,18,ATAATGGATATTTGTTGATA,0,1156190
fldAp,0.05263157894736842,18,18,ATAAGGGGAAACCGCACGAC,0,1153893
fldAp,0.05263157894736842,18,18,AGTGTTACAGGGGCCGGTGC,0,1087314
fldAp,0.05263157894736842,18,18,AGTAATACAGAACGTGGTCT,0,1095890
fldAp,0.05263157894736842,18,18,AGGTTTCTGTATCTTTGCAC,0,1069311
fldAp,0.05263157894736842,18,18,AGGACTGTGGGCTCGTGGCT,0,1118301
fldAp,0.05263157894736842,18,18,AGCTCGTGCTGTGGCTGTAA,0,1071317
fldAp,0.05263157894736842,18,18,AGCCTGTATCGGTCTGGAGC,0,1096839
fldAp,0.05263157894736842,18,18,AGCAAAACATTTCCAAATGG,0,1156426
fldAp,0.05263157894736842,18,18,AGATACGCCGGATCCCAACT,0,1093783
fldAp,0.05263157894736842,18,18,AGATAAATTATTGTGAAAAC,0,1073726
fldAp,0.05263157894736842,18,18,AGAGCGAGGATTGGCATCGG,0,1142071
fldAp,0.05263157894736842,18,18,ACTGCGAGTACCACCCATTT,0,1180616
fldAp,0.05263157894736842,18,18,ACTATTCTCTAGTTCTCGGG,0,1146725
fldAp,0.05263157894736842,18,18,ACGTCCGCATCGGTCCATGC,0,1131839
fldAp,0.05263157894736842,18,18,ACGGCTGACTGGCGGGAGTA,0,1181448
fldAp,0.05263157894736842,18,18,ACGATGCCGCTCTTAGTCAG,0,1150213
fldAp,0.05263157894736842,18,18,ACGAGGGAGCTATGAGACAT,0,1177138
fldAp,0.05263157894736842,18,18,ACGACTACGGCATACAGAGC,0,1148629
fldAp,0.05263157894736842,18,18,ACCTCCTTGGTTAGTTTGTT,0,1143444
fldAp,0.05263157894736842,18,18,ACCATTGCGCAGTGTATCAT,0,1163465
fldAp,0.05263157894736842,18,18,ACCAAGTAAACCGTTAAACC,0,1177318
fldAp,0.05263157894736842,18,18,ACATGCGCCCAGCGCTGTTT,0,1160109
fldAp,0.05263157894736842,18,18,ACATCTATATACGGAAACCT,0,1138660
fldAp,0.05263157894736842,18,18,ACACGTGACATGAATCTCGA,0,1154166
fldAp,0.05263157894736842,18,18,ACACGGTTCCTCACAGGTTA,0,1119078
fldAp,0.05263157894736842,18,18,AATTGTTGTGCATCCACCAG,0,1097517
fldAp,0.05263157894736842,18,18,AATTATGCAGATGCGTCCAG,0,1123588
fldAp,0.05263157894736842,18,18,AATGGGGTCTAACTTAGGTA,0,1072656
fldAp,0.05263157894736842,18,18,AATGCGCTACATGGTACATA,0,1143958
fldAp,0.05263157894736842,18,18,AATGACATCGTGAATACGTT,0,1124444
fldAp,0.05263157894736842,18,18,AATCTCGACAACTAATGTGT,0,1103232
fldAp,0.05263157894736842,18,18,AATCGCCTGGCTGCAAACAG,0,1181323
fldAp,0.05263157894736842,18,18,AACGCCTTCCGGGACGGACA,0,1079700
fldAp,0.05263157894736842,18,18,AACGAGTACACGGCGAGTGT,0,1135230
fldAp,0.05263157894736842,18,18,AACAGCATGATCCCAATTGG,0,1090528
fldAp,0.05263157894736842,18,18,AAAGATGTGCAGATGGTACC,0,1165674
fldAp,0.05263157894736842,18,18,AAAGAACAGTGGGTACCCCG,0,1107799
fldAp,0.05263157894736842,18,18,AAACGTTGACCTGGGTGGTT,0,1164624
fldAp,0.05263157894736842,18,18,AAACAAGAGAACTTGACTTG,0,1072234
fldAp,0.05555555555555555,17,17,TTTTATCGCGGAGCTGATAT,0,1138764
fldAp,0.05555555555555555,17,17,TTTGGGACAGAGCACGTCGG,0,1085692
fldAp,0.05555555555555555,17,17,TTTGCTATAGAGCATACGGA,0,1092218
fldAp,0.05555555555555555,17,17,TTGTTACCAGCCCTAAGTCA,0,1099379
fldAp,0.05555555555555555,17,17,TTGGGATGCAGTTCTCCGGT,0,1144854
fldAp,0.05555555555555555,17,17,TTGGGAATCTGTAAAAAATA,0,1180838
fldAp,0.05555555555555555,17,17,TTGCCCTCAGACGGTCGAAC,0,1087251
fldAp,0.05555555555555555,17,17,TTCGGCAGTCGTATGTGAGA,0,1086749
fldAp,0.05555555555555555,17,17,TTCGCGCTGTTTATGTATAT,0,1155464
fldAp,0.05555555555555555,17,17,TTCCTTGGGACAGTATGACA,0,1146742
fldAp,0.05555555555555555,17,17,TTCCCGCCGCGACCGGAACA,0,1065268
fldAp,0.05555555555555555,17,17,TTCCACATCTGCGAAACGAC,0,1103428
fldAp,0.05555555555555555,17,17,TTCAAGCACTGAGCAAAGTG,0,1163006
fldAp,0.05555555555555555,17,17,TTAGTCTCGCCAGTGTCCTG,0,1135029
fldAp,0.05555555555555555,17,17,TTAGATGCAATCTTGTACCT,0,1116853
fldAp,0.05555555555555555,17,17,TTACTCAGCATGTAGCCGCA,0,1173079
fldAp,0.05555555555555555,17,17,TTACGTTACGGCCGAGTTAA,0,1125126
fldAp,0.05555555555555555,17,17,TTACACAGCAGACGCCTCCC,0,1067489
fldAp,0.05555555555555555,17,17,TTAATTCCGCGACGGCGTCG,0,1102958
fldAp,0.05555555555555555,17,17,TTAAGGTCGCAGCCCCGCCT,0,1154403
fldAp,0.05555555555555555,17,17,TTAAGGACATCTGCTTCTAC,0,1152623
fldAp,0.05555555555555555,17,17,TGTGGACTGCCGGCTAGCTT,0,1140433
fldAp,0.05555555555555555,17,17,TGTGCGAAGGGGGGCACGGA,0,1126136
fldAp,0.05555555555555555,17,17,TGGCGTGCTCTCCGTACATG,0,1116556
fldAp,0.05555555555555555,17,17,TGGCCGTAACAGCGGAAGAT,0,1115102
fldAp,0.05555555555555555,17,17,TGAGCGCGACGTGGAGCCTG,0,1184297
fldAp,0.05555555555555555,17,17,TCTCGTTTACCTCCAGCCAC,0,1150220
fldAp,0.05555555555555555,17,17,TCTCATACGGCGGAAGCTCT,0,1083422
fldAp,0.05555555555555555,17,17,TCTATCAGTGGTTCCGTACT,0,1176657
fldAp,0.05555555555555555,17,17,TCGTTCCATCCGCGTACTAT,0,1098517
fldAp,0.05555555555555555,17,17,TCGTATGAACTCGACTTAGA,0,1145548
fldAp,0.05555555555555555,17,17,TCGGTTAACCATACTGTGGT,0,1148318
fldAp,0.05555555555555555,17,17,TCGGCCAAGATCGTTGTCTC,0,1153956
fldAp,0.05555555555555555,17,17,TCCATAGGGGTAAATTCCTA,0,1100463
fldAp,0.05555555555555555,17,17,TCCAGTTTCTTCGAAAGGCG,0,1185865
fldAp,0.05555555555555555,17,17,TCAGTTAACGGCGTAATTGC,0,1136994
fldAp,0.05555555555555555,17,17,TCAGTAACAGGCCCGAGTCT,0,1154378
fldAp,0.05555555555555555,17,17,TCAGGCCAAATAATTAATGT,0,1177473
fldAp,0.05555555555555555,17,17,TCAGCTACCAAGGCGTGCAA,0,1158280
fldAp,0.05555555555555555,17,17,TATTCGATTCCCGCAGTGTT,0,1089981
fldAp,0.05555555555555555,17,17,TATGTTATAGCACTTAACGA,0,1115980
fldAp,0.05555555555555555,17,17,TATAGCCGCGGGCTGCCGCA,0,1128727
fldAp,0.05555555555555555,17,17,TATACTACCGGCGGCCTATT,0,1134649
fldAp,0.05555555555555555,17,17,TAGGTCAGTGTTCTTCACTA,0,1121607
fldAp,0.05555555555555555,17,17,TAGGGTGTATGTGACTGGGG,0,1171321
fldAp,0.05555555555555555,17,17,TAGCGGCTCTGCGAAAGATG,0,1069685
fldAp,0.05555555555555555,17,17,TAGACTGATGGGCTTTGCAA,0,1178007
fldAp,0.05555555555555555,17,17,TACTCCTAGCATAGGAAGGG,0,1142136
fldAp,0.05555555555555555,17,17,TACTACGGAGCCCAGAACAG,0,1154008
fldAp,0.05555555555555555,17,17,TACCGCTTCAGGCCCTTTCA,0,1065796
fldAp,0.05555555555555555,17,17,TACATAAGGGGTATCGCATC,0,1131281
fldAp,0.05555555555555555,17,17,TAAGTTATGCGCAACGCTTG,0,1176824
fldAp,0.05555555555555555,17,17,TAAGCGAAGGGAATACGGGG,0,1122384
fldAp,0.05555555555555555,17,17,TAACCGAGGGGACATTCCGG,0,1092738
fldAp,0.05555555555555555,17,17,TAAAACTTGCAGTATCGCAG,0,1181125
fldAp,0.05555555555555555,17,17,GTTTTACTTTCCTAAACTGG,0,1175332
fldAp,0.05555555555555555,17,17,GTTGTGACGTGTTAAAGCAG,0,1140762
fldAp,0.05555555555555555,17,17,GTTGGGATCCCACCTGAATT,0,1092977
fldAp,0.05555555555555555,17,17,GTTGAAGCAGCTCTTAAATC,0,1183104
fldAp,0.05555555555555555,17,17,GTTCTGTAATGCGAACAGCC,0,1156944
fldAp,0.05555555555555555,17,17,GTTCAAGGGAGTGGGGCCGC,0,1142368
fldAp,0.05555555555555555,17,17,GTGTACGATTCGTACGCCAA,0,1119454
fldAp,0.05555555555555555,17,17,GTGTAATTACCCCACGTAGC,0,1163578
fldAp,0.05555555555555555,17,17,GTGGCGCACATCTGGCATCA,0,1113632
fldAp,0.05555555555555555,17,17,GTGGAACTACGTCCGGCAAC,0,1095984
fldAp,0.05555555555555555,17,17,GTGCTCTCGGGGTGACTGTG,0,1167822
fldAp,0.05555555555555555,17,17,GTGCGGATACTGTTGATCTC,0,1075922
fldAp,0.05555555555555555,17,17,GTGACTCACACTCAGCGGCC,0,1160938
fldAp,0.05555555555555555,17,17,GTCTGATGGTGAGGGACGTT,0,1101119
fldAp,0.05555555555555555,17,17,GTCGCATCCCTCGCCCCTTT,0,1088715
fldAp,0.05555555555555555,17,17,GTCCGGAATAAACGATGGAT,0,1064397
fldAp,0.05555555555555555,17,17,GTAGATATAAGCAATTGATG,0,1172523
fldAp,0.05555555555555555,17,17,GTACCTAAGGAGAATAGTAA,0,1127445
fldAp,0.05555555555555555,17,17,GGTTTCCGAGTTCAGCTCAG,0,1091008
fldAp,0.05555555555555555,17,17,GGTTGCGGGAACTCCAGCTC,0,1084281
fldAp,0.05555555555555555,17,17,GGTGGTACAGCTAATCTGGA,0,1144760
fldAp,0.05555555555555555,17,17,GGTCTCCATCGCTACCCATA,0,1119687
fldAp,0.05555555555555555,17,17,GGTCCCGAATTCTGGGTTTG,0,1069714
fldAp,0.05555555555555555,17,17,GGTCATCACAGCTGCACAAG,0,1115366
fldAp,0.05555555555555555,17,17,GGTCAAAAACTCCCGGACTA,0,1186282
fldAp,0.05555555555555555,17,17,GGGTCGTATTACCATTCAGC,0,1091103
fldAp,0.05555555555555555,17,17,GGGCTCCATTGGACAGAGAG,0,1087427
fldAp,0.05555555555555555,17,17,GGGCAATCTTTCGGAGAATG,0,1082788
fldAp,0.05555555555555555,17,17,GGGAGGTATTGATAGTTATT,0,1141723
fldAp,0.05555555555555555,17,17,GGGAGCGTACAGCTGTCATG,0,1167339
fldAp,0.05555555555555555,17,17,GGCTTTGTCTCAAATCTGTA,0,1178871
fldAp,0.05555555555555555,17,17,GGCTCGATTGTCTTGGGACA,0,1146390
fldAp,0.05555555555555555,17,17,GGCGCGCTGAGTAGGTAGGG,0,1065696
fldAp,0.05555555555555555,17,17,GGCCTTCAAGGTCTCGGTGC,0,1075029
fldAp,0.05555555555555555,17,17,GGCCCAAAGTGTGACGTCCC,0,1171277
fldAp,0.05555555555555555,17,17,GGATACCGTTGTAAAAAGTA,0,1158157
fldAp,0.05555555555555555,17,17,GGAGGTGTACCTACGCACTT,0,1090983
fldAp,0.05555555555555555,17,17,GGAGGGATAGGTCTGCTAAA,0,1138992
fldAp,0.05555555555555555,17,17,GGAGCGAACTGGCCTTAGGT,0,1097143
fldAp,0.05555555555555555,17,17,GCTCCAGACGCGTGCCGTGG,0,1155274
fldAp,0.05555555555555555,17,17,GCTACTCTAGAGGGAGTTCA,0,1157930
fldAp,0.05555555555555555,17,17,GCGTGCATGTTATTGGGAAC,0,1102870
fldAp,0.05555555555555555,17,17,GCGTACCCAGTCATAGTCTC,0,1079787
fldAp,0.05555555555555555,17,17,GCGTAACGTGGCCCTGTACA,0,1168059
fldAp,0.05555555555555555,17,17,GCGGTGTCCAGGCGTCTGCG,0,1150735
fldAp,0.05555555555555555,17,17,GCGCTATCGATAGACTCTTC,0,1162545
fldAp,0.05555555555555555,17,17,GCGACGTCTGTCATTGAGGA,0,1148154
fldAp,0.05555555555555555,17,17,GCGAATCTACATTTAGCTGC,0,1176501
fldAp,0.05555555555555555,17,17,GCCCCACAGAACTGGTCCAC,0,1090730
fldAp,0.05555555555555555,17,17,GCCCAGACAAGGGGGCCATG,0,1077786
fldAp,0.05555555555555555,17,17,GCCCACGTGTCGAATCCTCG,0,1155823
fldAp,0.05555555555555555,17,17,GCCATATGCAGCCCATAATT,0,1116309
fldAp,0.05555555555555555,17,17,GCCAGCCTAAACGTAACGAA,0,1064574
fldAp,0.05555555555555555,17,17,GCATTAGCCTGCCGAGAGAC,0,1134422
fldAp,0.05555555555555555,17,17,GCATCTACAGCTCTAGTCAC,0,1109527
fldAp,0.05555555555555555,17,17,GCACGCCAGGAACAGGGTAA,0,1147561
fldAp,0.05555555555555555,17,17,GCACAGCTAGAGGCACCAAC,0,1116620
fldAp,0.05555555555555555,17,17,GATCCGGGTTCCGGAGTTTG,0,1082785
fldAp,0.05555555555555555,17,17,GATCACTCCCAAGGACCCGA,0,1149792
fldAp,0.05555555555555555,17,17,GATAGATTAATATCGCTCCT,0,1166321
fldAp,0.05555555555555555,17,17,GATACTTTGGAAATAGGCCC,0,1096610
fldAp,0.05555555555555555,17,17,GAGTGTCTCAACAATGATAA,0,1183951
fldAp,0.05555555555555555,17,17,GAGTACAAGGCTATGGACCT,0,1116172
fldAp,0.05555555555555555,17,17,GAGCTTGGGGACGAAGGGTG,0,1147763
fldAp,0.05555555555555555,17,17,GAGCAAGGGTAGCTGTGACT,0,1086071
fldAp,0.05555555555555555,17,17,GACTAGGTGTACACGCCCCA,0,1071796
fldAp,0.05555555555555555,17,17,GACGTGTGTCATGCGAGACT,0,1101291
fldAp,0.05555555555555555,17,17,GACGTGAAATTGCGTACCTT,0,1075622
fldAp,0.05555555555555555,17,17,GACACTATACGCTTTATATA,0,1152644
fldAp,0.05555555555555555,17,17,GAATGTTACAACTCCTGGAT,0,1103083
fldAp,0.05555555555555555,17,17,GAATATAGCGCCGATGTGGG,0,1113876
fldAp,0.05555555555555555,17,17,GAAACATTATTAGCGCTTCA,0,1090428
fldAp,0.05555555555555555,17,17,CTTGGTTGGTGCCTCAGGTC,0,1124800
fldAp,0.05555555555555555,17,17,CTTCGACTCGATAGCAGCTC,0,1151110
fldAp,0.05555555555555555,17,17,CTTCGACACCCATGAGAGTT,0,1184457
fldAp,0.05555555555555555,17,17,CTTATGCAAGGCTCTTATGG,0,1158133
fldAp,0.05555555555555555,17,17,CTTAAATGGGAAAACTTCTG,0,1066106
fldAp,0.05555555555555555,17,17,CTGCGGGCGAGGTGTATATG,0,1110468
fldAp,0.05555555555555555,17,17,CTGATGGAGCATTCCAGGTT,0,1076179
fldAp,0.05555555555555555,17,17,CTCGAGCAAGTGAGATAAGA,0,1153153
fldAp,0.05555555555555555,17,17,CTCCCCAACGTGTCACGCGA,0,1181458
fldAp,0.05555555555555555,17,17,CTCCATAGATCAGCACTACA,0,1098637
fldAp,0.05555555555555555,17,17,CTCAGCCTGTCCTCGATTGA,0,1130414
fldAp,0.05555555555555555,17,17,CTATCCAACAAACGCATTCT,0,1088634
fldAp,0.05555555555555555,17,17,CTAGTACGCGTGGCTGGTAT,0,1126631
fldAp,0.05555555555555555,17,17,CTACTCTACTTATGCTCGTT,0,1152518
fldAp,0.05555555555555555,17,17,CGTTTTTCCGCGATGCGGTG,0,1182378
fldAp,0.05555555555555555,17,17,CGTTGGTAGCACAGTACCTT,0,1099411
fldAp,0.05555555555555555,17,17,CGTAGCGACTGCCATGAACT,0,1082486
fldAp,0.05555555555555555,17,17,CGGTTAGATGCATCACTAGC,0,1123543
fldAp,0.05555555555555555,17,17,CGGTCTAGTCGAGGCAATGA,0,1152383
fldAp,0.05555555555555555,17,17,CGGGTTACGTCACGTTTGAA,0,1074372
fldAp,0.05555555555555555,17,17,CGGGGTGTCTTCAAACTTCG,0,1068490
fldAp,0.05555555555555555,17,17,CGGGCTTGCACCAGACACGA,0,1096476
fldAp,0.05555555555555555,17,17,CGGGATAGCAATCCTGGGGA,0,1072297
fldAp,0.05555555555555555,17,17,CGGCCGGTACTTTACCCTAC,0,1167266
fldAp,0.05555555555555555,17,17,CGGAAAGTGATTTGCTCTAC,0,1113211
fldAp,0.05555555555555555,17,17,CGCTCACTTAAGAACCGGTT,0,1070736
fldAp,0.05555555555555555,17,17,CGCCTGCATGGTCGGATTGC,0,1160864
fldAp,0.05555555555555555,17,17,CGCCTATTCACCTTGGTTTA,0,1166459
fldAp,0.05555555555555555,17,17,CGCAGCTATTGGCAGCCGGC,0,1110155
fldAp,0.05555555555555555,17,17,CGCACGGTCGCTGATTCAAC,0,1171991
fldAp,0.05555555555555555,17,17,CGAGCTGTTGACGTGGAAGT,0,1114301
fldAp,0.05555555555555555,17,17,CGACTAACCACGCAGCTAAC,0,1148468
fldAp,0.05555555555555555,17,17,CGACCGCGTTACGGTTTCTA,0,1151035
fldAp,0.05555555555555555,17,17,CGAATGGCGGATAAAAAAGC,0,1081535
fldAp,0.05555555555555555,17,17,CCTTTCAGGGCAAGTTACGT,0,1140406
fldAp,0.05555555555555555,17,17,CCTTGTTCATGGTAGCAAAA,0,1155826
fldAp,0.05555555555555555,17,17,CCTCTGGTGCACCGGCAAGT,0,1084843
fldAp,0.05555555555555555,17,17,CCTCGGGAGTTCCTAAAGAT,0,1114383
fldAp,0.05555555555555555,17,17,CCTCGCTCACCAGTCTATTG,0,1138594
fldAp,0.05555555555555555,17,17,CCTCACGGACAGCCCACCTA,0,1089117
fldAp,0.05555555555555555,17,17,CCGTGCATGGTGGTCGAAAA,0,1095651
fldAp,0.05555555555555555,17,17,CCGTCATCCTACAACGAAGA,0,1138254
fldAp,0.05555555555555555,17,17,CCCTTGGGGGAGTTCAACCA,0,1092971
fldAp,0.05555555555555555,17,17,CCCTCCATATCATTTCGTGA,0,1117615
fldAp,0.05555555555555555,17,17,CCCGTTCCATCCTGATCCAT,0,1157373
fldAp,0.05555555555555555,17,17,CCCGAAGACCCAAGTGCCTC,0,1163687
fldAp,0.05555555555555555,17,17,CCCATGTGGACGCCGTAAAC,0,1119683
fldAp,0.05555555555555555,17,17,CCATCTGCCAGAAGCCATGT,0,1120817
fldAp,0.05555555555555555,17,17,CCAGGCTAGGTAACAAATGC,0,1123872
fldAp,0.05555555555555555,17,17,CCACGGATCATGGCGCTTAT,0,1130567
fldAp,0.05555555555555555,17,17,CCACGAGGAAACACGGTAGT,0,1112273
fldAp,0.05555555555555555,17,17,CCACCACCTATCCCGTTATT,0,1138989
fldAp,0.05555555555555555,17,17,CCACACACAGTCAGTAAAAT,0,1172980
fldAp,0.05555555555555555,17,17,CCAAGTGAATACGGTGGATC,0,1156007
fldAp,0.05555555555555555,17,17,CATTCACGGTAGCGGTTTTT,0,1065620
fldAp,0.05555555555555555,17,17,CATTATGCGATTGCAGCGTT,0,1097902
fldAp,0.05555555555555555,17,17,CATTATAATGTCAGGAGGCT,0,1150337
fldAp,0.05555555555555555,17,17,CATCTGTTTCATAACGGTGC,0,1152117
fldAp,0.05555555555555555,17,17,CAGTGAGCCTATGCTTCAGC,0,1100943
fldAp,0.05555555555555555,17,17,CAGGCCGGGTGAGTCTTGTT,0,1082132
fldAp,0.05555555555555555,17,17,CAGCATACCAGGATCAAGGC,0,1108632
fldAp,0.05555555555555555,17,17,CAGAGTTTAAGGTCACACGC,0,1121301
fldAp,0.05555555555555555,17,17,CACGGGATGCAAGCATTCGA,0,1167754
fldAp,0.05555555555555555,17,17,CAAGGGCATGCAATAAAGAT,0,1098821
fldAp,0.05555555555555555,17,17,CAAATTCCCCAGTGACGACT,0,1078780
fldAp,0.05555555555555555,17,17,CAAACCGCGCCTAAAAGTAA,0,1105589
fldAp,0.05555555555555555,17,17,ATTCACAATTACCTGAATGT,0,1083645
fldAp,0.05555555555555555,17,17,ATTCAACGCTGACCGAGGCG,0,1131505
fldAp,0.05555555555555555,17,17,ATTAGTTGGCTAGCGTATAT,0,1168348
fldAp,0.05555555555555555,17,17,ATTACCCGCGCTTAATGGCA,0,1179832
fldAp,0.05555555555555555,17,17,ATTAATGCGCTGGGGGTTAT,0,1093759
fldAp,0.05555555555555555,17,17,ATGGTGTTGGCTTTAAGTGG,0,1112635
fldAp,0.05555555555555555,17,17,ATCTTCTATATTGCTCTAAC,0,1184114
fldAp,0.05555555555555555,17,17,ATCTCCAGCCATAGTTACTC,0,1125895
fldAp,0.05555555555555555,17,17,ATCGCAGTACGAGTGTCTGG,0,1139367
fldAp,0.05555555555555555,17,17,ATCCGTCAGGACCACAAAAA,0,1185256
fldAp,0.05555555555555555,17,17,ATCCACACAGACGCGGAGTT,0,1167761
fldAp,0.05555555555555555,17,17,ATCAAAGCAGAACAAGCATT,0,1074753
fldAp,0.05555555555555555,17,17,ATAGTAAGAGATACCATGTT,0,1133253
fldAp,0.05555555555555555,17,17,ATACCCGATCCGGCCGTCAA,0,1125601
fldAp,0.05555555555555555,17,17,ATAAGCCTGGCGTGTGTTAC,0,1139883
fldAp,0.05555555555555555,17,17,AGTGCAATGAGGCAGGACAG,0,1152676
fldAp,0.05555555555555555,17,17,AGTCGCTTTTAGCGAAGTAA,0,1073812
fldAp,0.05555555555555555,17,17,AGTACTCTACAAGACGAGGA,0,1174223
fldAp,0.05555555555555555,17,17,AGTACAACTTACTCAGAGAC,0,1148974
fldAp,0.05555555555555555,17,17,AGTAAGAAACTTTCGTGGAT,0,1094148
fldAp,0.05555555555555555,17,17,AGGTTTGTGGACAGAACCGA,0,1158950
fldAp,0.05555555555555555,17,17,AGGTCGTTAACTCGAATTGT,0,1106056
fldAp,0.05555555555555555,17,17,AGGGAATCTAGGTGAACTGA,0,1105186
fldAp,0.05555555555555555,17,17,AGGCGTTTGCCATTGTCTCT,0,1178877
fldAp,0.05555555555555555,17,17,AGGCGTTTCGCCGGAGAGCA,0,1133835
fldAp,0.05555555555555555,17,17,AGGAGTGGAAGGGAGTCAAA,0,1120006
fldAp,0.05555555555555555,17,17,AGCGTGATGGCGAGATAGGG,0,1092016
fldAp,0.05555555555555555,17,17,AGCGTAAGACGTTTTACGCT,0,1089955
fldAp,0.05555555555555555,17,17,AGCATATACTAGCCGCCCGT,0,1149761
fldAp,0.05555555555555555,17,17,AGAGGCCAGGGCGCTCGAGA,0,1077334
fldAp,0.05555555555555555,17,17,AGAGCCAACACAGCTAGCTT,0,1175925
fldAp,0.05555555555555555,17,17,ACTTAGAAAATAACAGAGTT,0,1158322
fldAp,0.05555555555555555,17,17,ACTCAAAGGCACTTGGTTGA,0,1140399
fldAp,0.05555555555555555,17,17,ACTACACACCCGGACCCTCT,0,1136914
fldAp,0.05555555555555555,17,17,ACGTGTATACAAGCGTATAA,0,1091463
fldAp,0.05555555555555555,17,17,ACGCACTCCTATTAGCTGGA,0,1175564
fldAp,0.05555555555555555,17,17,ACCGTCGCGCTGTCGTACTA,0,1125553
fldAp,0.05555555555555555,17,17,ACCCTAGCCGACTCTGAGGT,0,1114681
fldAp,0.05555555555555555,17,17,ACCCACCTCCGATGAAATAT,0,1153967
fldAp,0.05555555555555555,17,17,ACCAGAACCCTCACGAGCTA,0,1172122
fldAp,0.05555555555555555,17,17,ACCACGTAGGGTGTAATCCC,0,1167039
fldAp,0.05555555555555555,17,17,ACACTAGAATAGGCCTGTCA,0,1087612
fldAp,0.05555555555555555,17,17,ACAATTGGTGAATAAAACCA,0,1072566
fldAp,0.05555555555555555,17,17,AATTTTAACGCCGGGGCTAT,0,1163853
fldAp,0.05555555555555555,17,17,AATGTGAACGTGTGCCATAT,0,1136332
fldAp,0.05555555555555555,17,17,AATGTCATAGTATTCCCGTG,0,1170409
fldAp,0.05555555555555555,17,17,AATGCGTAGGGTGCCGGGAC,0,1161761
fldAp,0.05555555555555555,17,17,AATGCGGCCACCTCGTACAA,0,1152569
fldAp,0.05555555555555555,17,17,AATCGTTACGGGGTCTACTA,0,1129270
fldAp,0.05555555555555555,17,17,AATAACCCCTTTTTACATTA,0,1153307
fldAp,0.05555555555555555,17,17,AAGGTATATATAGTAAGCTT,0,1133065
fldAp,0.05555555555555555,17,17,AAGGCTCTCGCAGCACGCAA,0,1185651
fldAp,0.05555555555555555,17,17,AAGGAACCCGGAAGACCGGA,0,1106040
fldAp,0.05555555555555555,17,17,AAGCGGTAGGCGTCGCGTAC,0,1083516
fldAp,0.05555555555555555,17,17,AAGACTGTGTATTTCCAGTC,0,1121588
fldAp,0.05555555555555555,17,17,AAGAAGGAGCATAGATCTTT,0,1108134
fldAp,0.05555555555555555,17,17,AAGAAGCTTAAAGCATAGAG,0,1103368
fldAp,0.05555555555555555,17,17,AACTTGTCTCCAGCTACAGA,0,1138053
fldAp,0.05555555555555555,17,17,AACTATTTTCTAATGCAGGT,0,1177533
fldAp,0.05555555555555555,17,17,AACTAACGCACAACTGTTAC,0,1126222
fldAp,0.05555555555555555,17,17,AACGGTGTCCCTAGGGAACT,0,1176786
fldAp,0.05555555555555555,17,17,AACGGCCGCATTCCCGCCAA,0,1121510
fldAp,0.05555555555555555,17,17,AACGCGAGCGTGAATAGGGT,0,1070934
fldAp,0.05555555555555555,17,17,AACCCGCAGACGGAACGTTA,0,1123637
fldAp,0.05555555555555555,17,17,AACATGGACACTCCTTTGAT,0,1143280
fldAp,0.05555555555555555,17,17,AACAGGATTGCTCTGTCTCT,0,1121952
fldAp,0.05555555555555555,17,17,AAATAAAAAAGACGTAAAGA,0,1090574
fldAp,0.05555555555555555,17,17,AAAGGGACGGATCGGGTGCA,0,1158838
fldAp,0.058823529411764705,16,16,TTTTAGTAGAGAATGGGCCT,0,1130199
fldAp,0.058823529411764705,16,16,TTTATGCCCCTAGAAACACT,0,1157014
fldAp,0.058823529411764705,16,16,TTGTTTTAGCTTGAACCCGT,0,1073614
fldAp,0.058823529411764705,16,16,TTGTTACGTACAAGCTCAAA,0,1085606
fldAp,0.058823529411764705,16,16,TTGGTGAAAAACAACAACCC,0,1143651
fldAp,0.058823529411764705,16,16,TTGCTAATGCTGCACCCCGT,0,1065722
fldAp,0.058823529411764705,16,16,TTGCCCGGTATTCAAGTTGC,0,1146827
fldAp,0.058823529411764705,16,16,TTGAGTGGTTGGGGTGTTAC,0,1151002
fldAp,0.058823529411764705,16,16,TTGAGGGGGCGGACGCATAA,0,1119755
fldAp,0.058823529411764705,16,16,TTGAAGCTGGTACCTCCGCT,0,1116212
fldAp,0.058823529411764705,16,16,TTGAACCATTAGGTTGGTGT,0,1104676
fldAp,0.058823529411764705,16,16,TTCTTTGGTATAGATTCCAT,0,1092672
fldAp,0.058823529411764705,16,16,TTCTGTCCTGCGGGATAGAC,0,1137977
fldAp,0.058823529411764705,16,16,TTCTCTATAGATTTGGTAAT,0,1093637
fldAp,0.058823529411764705,16,16,TTCGTGTATGAGTGTGCGTT,0,1094064
fldAp,0.058823529411764705,16,16,TTCGGGGGAGCGAGGGGTCC,0,1071535
fldAp,0.058823529411764705,16,16,TTCGGCGGAAAGGGCCAGGG,0,1096056
fldAp,0.058823529411764705,16,16,TTCCCTGCAATATCACGGAT,0,1091273
fldAp,0.058823529411764705,16,16,TTCCACTATAACGCCGGCCA,0,1175600
fldAp,0.058823529411764705,16,16,TTCATTCCCGAACATTTTAC,0,1100837
fldAp,0.058823529411764705,16,16,TTCAACGAGCGCTATTCCCA,0,1181757
fldAp,0.058823529411764705,16,16,TTATCGAATTTGGACGCCAC,0,1149680
fldAp,0.058823529411764705,16,16,TTATCAGCGGGGATGATAGT,0,1080585
fldAp,0.058823529411764705,16,16,TTAGGATTGGAGAAAGTGTC,0,1095938
fldAp,0.058823529411764705,16,16,TTAGCTGGCCAGCGGGCGGA,0,1132010
fldAp,0.058823529411764705,16,16,TTAGACCTGCTTATTAGAGG,0,1110540
fldAp,0.058823529411764705,16,16,TTAGAACGACGGTGCCTGTA,0,1065919
fldAp,0.058823529411764705,16,16,TTAAGCCGCACAGTGTATCT,0,1145813
fldAp,0.058823529411764705,16,16,TTAACCAAGGGTTCTGCCAG,0,1145527
fldAp,0.058823529411764705,16,16,TTAAATACGTCGGCTTGCCG,0,1147332
fldAp,0.058823529411764705,16,16,TGTTGGCACGACCCACGAGT,0,1132175
fldAp,0.058823529411764705,16,16,TGTTCTTTGAAGTCATTTCT,0,1159646
fldAp,0.058823529411764705,16,16,TGTATCAGCTGCACTCGTTG,0,1091270
fldAp,0.058823529411764705,16,16,TGGTGGGACACACGGCGCTG,0,1114967
fldAp,0.058823529411764705,16,16,TGGTCTCTCATGCGGAGAGA,0,1144784
fldAp,0.058823529411764705,16,16,TGGTCGGATCCGATATATGA,0,1077318
fldAp,0.058823529411764705,16,16,TGGCTGTCCACAGCTCCCGC,0,1102893
fldAp,0.058823529411764705,16,16,TGGCGGCGCGCTAGCATTTC,0,1165854
fldAp,0.058823529411764705,16,16,TGGATATCGTGAACGGAGTT,0,1109401
fldAp,0.058823529411764705,16,16,TGCGCTACTCAAGTAGAGTC,0,1110934
fldAp,0.058823529411764705,16,16,TGCATTTAACCGGGCCGAGT,0,1100324
fldAp,0.058823529411764705,16,16,TGATTCACATGCAACTATTC,0,1096905
fldAp,0.058823529411764705,16,16,TGATGCAGCGCCGCGCCTCA,0,1093960
fldAp,0.058823529411764705,16,16,TGATGACGTCGATTGTGGGA,0,1180227
fldAp,0.058823529411764705,16,16,TGATCTGCTGAATAAGAAGT,0,1164250
fldAp,0.058823529411764705,16,16,TGATAATATGAAGAGGCGAG,0,1183947
fldAp,0.058823529411764705,16,16,TGAGTTTAGAGTGGTAAAGG,0,1157556
fldAp,0.058823529411764705,16,16,TGACTTACTGATCTACATGC,0,1161483
fldAp,0.058823529411764705,16,16,TGACTCCATAGCTTTCCAGA,0,1176637
fldAp,0.058823529411764705,16,16,TGACATGGCCTGATGTACCC,0,1115568
fldAp,0.058823529411764705,16,16,TCTTCGAGCTCGTCGTCCCG,0,1067080
fldAp,0.058823529411764705,16,16,TCTGAATCGATCAGAGCGTA,0,1086243
fldAp,0.058823529411764705,16,16,TCTCTATGGGGTACTCTTGC,0,1116550
fldAp,0.058823529411764705,16,16,TCTCGGGTTGAATATTTGAT,0,1081504
fldAp,0.058823529411764705,16,16,TCGTTCCTTGGTAAAATGAT,0,1085583
fldAp,0.058823529411764705,16,16,TCGGTCGGCACGTGTCTCCA,0,1151428
fldAp,0.058823529411764705,16,16,TCGGCCATGCTTCGGATTGC,0,1084154
fldAp,0.058823529411764705,16,16,TCGCTCGGCAAATACGAACC,0,1159823
fldAp,0.058823529411764705,16,16,TCGACAGGCGCACCACGGGC,0,1065862
fldAp,0.058823529411764705,16,16,TCGAATTGACACGTGGACTT,0,1122596
fldAp,0.058823529411764705,16,16,TCCTTCGGATGCTAGCTATG,0,1119877
fldAp,0.058823529411764705,16,16,TCCTGTTGTTCTTTGGACGT,0,1133267
fldAp,0.058823529411764705,16,16,TCCGCGTGGACGCATACAAG,0,1180145
fldAp,0.058823529411764705,16,16,TCCCCCGCACTTTCAGCCTA,0,1180950
fldAp,0.058823529411764705,16,16,TCCCACATGATACGCCAACA,0,1134788
fldAp,0.058823529411764705,16,16,TCCCAAATTCGGGCACACTG,0,1066848
fldAp,0.058823529411764705,16,16,TCATGGAGCGTGCAAGCATT,0,1181187
fldAp,0.058823529411764705,16,16,TCATGGACTTAAGGCAAAAT,0,1114102
fldAp,0.058823529411764705,16,16,TCATCTATATATCACGCGGT,0,1155791
fldAp,0.058823529411764705,16,16,TCATCGTCCAATCTGCTTGA,0,1086751
fldAp,0.058823529411764705,16,16,TCATCAGCCGGGAGTTGGTT,0,1109111
fldAp,0.058823529411764705,16,16,TCAAGGCAGACTTTTTTATC,0,1074760
fldAp,0.058823529411764705,16,16,TATGACACCCGCGGATTGGA,0,1088941
fldAp,0.058823529411764705,16,16,TATCATGTCTAATGTACGTA,0,1070406
fldAp,0.058823529411764705,16,16,TATATTAATGTTCGACTGTG,0,1109638
fldAp,0.058823529411764705,16,16,TAGTTGGACACTGCACTCAT,0,1092754
fldAp,0.058823529411764705,16,16,TAGTCACGCGACATAGAATC,0,1160931
fldAp,0.058823529411764705,16,16,TAGCCAAGGAAGCGGTTCAT,0,1132715
fldAp,0.058823529411764705,16,16,TAGACCTATGACCCATGCGC,0,1088627
fldAp,0.058823529411764705,16,16,TACTCCGTAGGAGATGAAGA,0,1095531
fldAp,0.058823529411764705,16,16,TACTCAGGATTGCATGGTCA,0,1112047
fldAp,0.058823529411764705,16,16,TACTATCTCCTGGAAGATCA,0,1083170
fldAp,0.058823529411764705,16,16,TACTAGAGAATGGAGACTCA,0,1170018
fldAp,0.058823529411764705,16,16,TACCCGCTGGAAGAAATAGG,0,1130990
fldAp,0.058823529411764705,16,16,TACCACTTGGAAACGACAGA,0,1161556
fldAp,0.058823529411764705,16,16,TACAGTGAGTAATTACTCTG,0,1077186
fldAp,0.058823529411764705,16,16,TAATCGTGCTAGTATCGACA,0,1069872
fldAp,0.058823529411764705,16,16,TAAGATTCGTTTAGGTGGGT,0,1088995
fldAp,0.058823529411764705,16,16,TAACTGCAAGACCGGGTTGA,0,1071910
fldAp,0.058823529411764705,16,16,TAACGCAGGAGGCGATAGAT,0,1103813
fldAp,0.058823529411764705,16,16,TAAATCCGACGCAGGCGGAG,0,1171283
fldAp,0.058823529411764705,16,16,GTTTTGCGTACGCTTTGACT,0,1179829
fldAp,0.058823529411764705,16,16,GTTTCACTGATTATTTGGCG,0,1071227
fldAp,0.058823529411764705,16,16,GTTCCGTCATGTCTTTTCTC,0,1121530
fldAp,0.058823529411764705,16,16,GTTATCCGGATAGTCGGCCC,0,1080289
fldAp,0.058823529411764705,16,16,GTTATCAATATAAGTCTTAA,0,1086289
fldAp,0.058823529411764705,16,16,GTTAACAACTATATCTCACT,0,1067523
fldAp,0.058823529411764705,16,16,GTGTCTCATTCATTTGCCCT,0,1126407
fldAp,0.058823529411764705,16,16,GTGTATCTGGAACTGACTCC,0,1066217
fldAp,0.058823529411764705,16,16,GTGGTCTGCGGATCTCATTA,0,1169167
fldAp,0.058823529411764705,16,16,GTGGGTACGAGTGTGGAATA,0,1105645
fldAp,0.058823529411764705,16,16,GTGCCAAGACCACCACAGGT,0,1179985
fldAp,0.058823529411764705,16,16,GTGATATGGCAGGGGTGATC,0,1123103
fldAp,0.058823529411764705,16,16,GTGAGAATACTAACTCCAAG,0,1186941
fldAp,0.058823529411764705,16,16,GTCTCTTGGGTTACACGAGG,0,1087600
fldAp,0.058823529411764705,16,16,GTCTAGGACCGTAGCTCACT,0,1077704
fldAp,0.058823529411764705,16,16,GTCCCAGAAAGCCGACGAAA,0,1069032
fldAp,0.058823529411764705,16,16,GTATTTATCGGTTTTCCAGC,0,1081374
fldAp,0.058823529411764705,16,16,GTAGCCGGGCAACAAGTAAT,0,1185987
fldAp,0.058823529411764705,16,16,GTAGAAATCGGTCCAGCTGG,0,1112040
fldAp,0.058823529411764705,16,16,GTAACGATAAGTGTAAAGTC,0,1147569
fldAp,0.058823529411764705,16,16,GGTTGCACAGGCTTCTCGGC,0,1143266
fldAp,0.058823529411764705,16,16,GGTTCGTAATGAGTTAAGGC,0,1071664
fldAp,0.058823529411764705,16,16,GGTGCCATTAATAACTCATA,0,1132890
fldAp,0.058823529411764705,16,16,GGTGAACATTGGAGGACATA,0,1175851
fldAp,0.058823529411764705,16,16,GGTCTCGGTACTCGACTTAT,0,1128204
fldAp,0.058823529411764705,16,16,GGTCGCGAGGGACGTGCTGG,0,1154987
fldAp,0.058823529411764705,16,16,GGTACACTTAGGGTGGCGTA,0,1079733
fldAp,0.058823529411764705,16,16,GGTAAGTGCGGCACTAAAGA,0,1069800
fldAp,0.058823529411764705,16,16,GGGTACTGGGAACTTGATGG,0,1124053
fldAp,0.058823529411764705,16,16,GGGTACCGAGAAACTCAAAT,0,1109784
fldAp,0.058823529411764705,16,16,GGGTAATCCACAGGTCGCGA,0,1183132
fldAp,0.058823529411764705,16,16,GGGGAGCCGGATGATGCTGA,0,1171325
fldAp,0.058823529411764705,16,16,GGGCCGAGGTTAAGTCCCAT,0,1088594
fldAp,0.058823529411764705,16,16,GGGCCAAGCTGATCACAATT,0,1154390
fldAp,0.058823529411764705,16,16,GGGATGCCTCCGTACCTTAT,0,1167456
fldAp,0.058823529411764705,16,16,GGCTGCCTCCGTCACGTAAG,0,1105740
fldAp,0.058823529411764705,16,16,GGCGCTAGTAGCAAAATATG,0,1154977
fldAp,0.058823529411764705,16,16,GGCGATGCGCGAATAAGTAA,0,1186958
fldAp,0.058823529411764705,16,16,GGCATCGCCGGAAAGGTCAA,0,1162181
fldAp,0.058823529411764705,16,16,GGCAGGAAACCGGACGCTCA,0,1101270
fldAp,0.058823529411764705,16,16,GGCAATTTTCATTTTAACTT,0,1178917
fldAp,0.058823529411764705,16,16,GGAGTTGCCCATCCTGACCC,0,1164642
fldAp,0.058823529411764705,16,16,GGAGGATCGCGACGTACGAG,0,1120403
fldAp,0.058823529411764705,16,16,GGACAGTACTGCGTCGAGTA,0,1181767
fldAp,0.058823529411764705,16,16,GGAAGCCGGGGGAGTCAATC,0,1123823
fldAp,0.058823529411764705,16,16,GCTTATATAATGTGAATAGG,0,1140971
fldAp,0.058823529411764705,16,16,GCTCGTATCCGGATCGGGGG,0,1134144
fldAp,0.058823529411764705,16,16,GCTAGTAATTCTACTAATAA,0,1085439
fldAp,0.058823529411764705,16,16,GCTAGGTAAGAGGACGGACG,0,1128110
fldAp,0.058823529411764705,16,16,GCTAGCGCCGAATTCGTGAT,0,1112946
fldAp,0.058823529411764705,16,16,GCGTTAACGTCTGTCAAGTG,0,1159886
fldAp,0.058823529411764705,16,16,GCGGTGAGCCCTAGTAATAG,0,1127011
fldAp,0.058823529411764705,16,16,GCGGGGATAGCGGGCCGCCA,0,1088728
fldAp,0.058823529411764705,16,16,GCGGCCTTGATGTGAAGCGC,0,1182377
fldAp,0.058823529411764705,16,16,GCGGCCTTCAATGTTCTTGC,0,1098426
fldAp,0.058823529411764705,16,16,GCGCTTGTGTAAGTGGTGTG,0,1063055
fldAp,0.058823529411764705,16,16,GCGATCCTTAGTGTTTACCA,0,1066822
fldAp,0.058823529411764705,16,16,GCGAGTAAGTAAAGCGTCAC,0,1163397
fldAp,0.058823529411764705,16,16,GCCTGTACATATGGTCAGTT,0,1116696
fldAp,0.058823529411764705,16,16,GCCTCAGTCTTTACGACGAT,0,1147076
fldAp,0.058823529411764705,16,16,GCCGTCTATGTATGTTGCTC,0,1131565
fldAp,0.058823529411764705,16,16,GCCAGTTTTACCTTTAGCCA,0,1176605
fldAp,0.058823529411764705,16,16,GCCACGTATTGCGGACCGCA,0,1074752
fldAp,0.058823529411764705,16,16,GCATTCCGCGGAAGCTCAGT,0,1158639
fldAp,0.058823529411764705,16,16,GCATCGAGTTAGTCCCGACT,0,1082042
fldAp,0.058823529411764705,16,16,GCAGCTCCACCAGAGGTTGA,0,1183528
fldAp,0.058823529411764705,16,16,GCACCCCGATCGAAACCAAG,0,1090766
fldAp,0.058823529411764705,16,16,GCAAGCGCAATTCTGTTTTC,0,1080803
fldAp,0.058823529411764705,16,16,GCAACGTCCGGCCGGGTGCG,0,1124669
fldAp,0.058823529411764705,16,16,GATTCCCCCAGGGTTGAGCG,0,1097906
fldAp,0.058823529411764705,16,16,GATGAGAATTTGGCCAGGGT,0,1110418
fldAp,0.058823529411764705,16,16,GATCTGTGGGATACGTGGGA,0,1181319
fldAp,0.058823529411764705,16,16,GATCTCGGACAATATCGGAG,0,1179981
fldAp,0.058823529411764705,16,16,GAGGACAGAGCTCCTGTCCA,0,1170681
fldAp,0.058823529411764705,16,16,GAGCAGGTCTCGGAAGATCA,0,1086942
fldAp,0.058823529411764705,16,16,GAGCACCTTCCGTACCGGGA,0,1065483
fldAp,0.058823529411764705,16,16,GACGCAGCCAAGTTAAACCA,0,1100842
fldAp,0.058823529411764705,16,16,GACGATCCACCCTAATTGCT,0,1100928
fldAp,0.058823529411764705,16,16,GACCCCGAACATCAGTCTTT,0,1105782
fldAp,0.058823529411764705,16,16,GACAGGGACGGATCTCGTCG,0,1176437
fldAp,0.058823529411764705,16,16,GAATCCTGGTAGGAATTGTA,0,1150658
fldAp,0.058823529411764705,16,16,GAAGTCGTGCGGGGAAGAAG,0,1150869
fldAp,0.058823529411764705,16,16,GAACGGGTTCGCCCATATAT,0,1084292
fldAp,0.058823529411764705,16,16,GAAAGTATTCACCGAAGCTG,0,1131000
fldAp,0.058823529411764705,16,16,GAAAGCTTTGTACTTGTACG,0,1100564
fldAp,0.058823529411764705,16,16,CTTTCGACCCATGACGTATG,0,1131443
fldAp,0.058823529411764705,16,16,CTTCGAACTGTGCAAAATAC,0,1183133
fldAp,0.058823529411764705,16,16,CTTCCTTGTGACCTCGCACT,0,1069299
fldAp,0.058823529411764705,16,16,CTTCATAAGCTAGCATCGAT,0,1167166
fldAp,0.058823529411764705,16,16,CTTAAATCGAGAGCCCGATT,0,1141824
fldAp,0.058823529411764705,16,16,CTGTTGGGACCCCAACTCAA,0,1175150
fldAp,0.058823529411764705,16,16,CTGTTGACAACCCTTGCAAA,0,1088717
fldAp,0.058823529411764705,16,16,CTGTCACGGAAGACACGACA,0,1126816
fldAp,0.058823529411764705,16,16,CTGTAGGATGGTAGTAGTCA,0,1173782
fldAp,0.058823529411764705,16,16,CTGGTCCAACCCACACGCTG,0,1126184
fldAp,0.058823529411764705,16,16,CTGGCGATCTTGTGTGGCGT,0,1134013
fldAp,0.058823529411764705,16,16,CTGGCCAAACAGATTCCTTA,0,1122121
fldAp,0.058823529411764705,16,16,CTGGATAGGCTATCGTTTCG,0,1153013
fldAp,0.058823529411764705,16,16,CTGCACCAGAGACTACTTCG,0,1075742
fldAp,0.058823529411764705,16,16,CTCTCAGTAAACGGCTCCGG,0,1173652
fldAp,0.058823529411764705,16,16,CTCCTTTGACGTTCTCAGGT,0,1088915
fldAp,0.058823529411764705,16,16,CTCCGTTGAGATGAACGAGA,0,1165055
fldAp,0.058823529411764705,16,16,CTCCCCCACGTCTGATCATG,0,1175243
fldAp,0.058823529411764705,16,16,CTCATGATGGTAGCACGACG,0,1161118
fldAp,0.058823529411764705,16,16,CTCACTCGATGTAAAAATCA,0,1079979
fldAp,0.058823529411764705,16,16,CTAGGGAACTCGTATATAAT,0,1158430
fldAp,0.058823529411764705,16,16,CTACTCGAGGCGGCCTTGAT,0,1101854
fldAp,0.058823529411764705,16,16,CTACGTGCGTAGACGGCTCA,0,1065472
fldAp,0.058823529411764705,16,16,CTACATCGGTTATCTCTCAA,0,1146084
fldAp,0.058823529411764705,16,16,CTACAATGGTCGGAGTTTCA,0,1117980
fldAp,0.058823529411764705,16,16,CGTGAACATAAAAGACTAAT,0,1081292
fldAp,0.058823529411764705,16,16,CGTCTTTACCGGCCGAAAAT,0,1169500
fldAp,0.058823529411764705,16,16,CGTCTGGATAGTTCGCGCCT,0,1127402
fldAp,0.058823529411764705,16,16,CGTCCGGTAATAATTTGTTT,0,1136647
fldAp,0.058823529411764705,16,16,CGGTTGTCATTACCCCATCC,0,1141345
fldAp,0.058823529411764705,16,16,CGGTATATTGAGTCTTGAGA,0,1130903
fldAp,0.058823529411764705,16,16,CGGCTGACGTCATTCACAAT,0,1157816
fldAp,0.058823529411764705,16,16,CGGCCCCTGTTCTTAGTGAT,0,1137043
fldAp,0.058823529411764705,16,16,CGGCATTCTCAAAGGGTGAG,0,1186383
fldAp,0.058823529411764705,16,16,CGGACCCGGGGGCCAGACAA,0,1091905
fldAp,0.058823529411764705,16,16,CGCTGGCTGCCATCGTAAGA,0,1081838
fldAp,0.058823529411764705,16,16,CGCTGGAGCCGTTAAATTTT,0,1168161
fldAp,0.058823529411764705,16,16,CGCTGGAAGAATTGTAAAGC,0,1114745
fldAp,0.058823529411764705,16,16,CGCTATAAATTTATAGGGCT,0,1178059
fldAp,0.058823529411764705,16,16,CGCTAGTGTGTACGATTGCT,0,1169094
fldAp,0.058823529411764705,16,16,CGCGGCAGGTGAGTAGGCAT,0,1065343
fldAp,0.058823529411764705,16,16,CGCCACTAAGCATGAGAAGT,0,1162155
fldAp,0.058823529411764705,16,16,CGCACAGATAACTCTGAGAG,0,1129988
fldAp,0.058823529411764705,16,16,CGAGTACTTTCAACACCATT,0,1184616
fldAp,0.058823529411764705,16,16,CGAGGATACACAGTTTACTA,0,1165489
fldAp,0.058823529411764705,16,16,CGACGACTGTAACAGTATTT,0,1114328
fldAp,0.058823529411764705,16,16,CGAACACGCGAGGCTAAATG,0,1117963
fldAp,0.058823529411764705,16,16,CGAAAATCTAGCGCACGGAT,0,1129271
fldAp,0.058823529411764705,16,16,CCTGATACTCTAGACGATAG,0,1116866
fldAp,0.058823529411764705,16,16,CCTGACTTCACAAGGCGGTA,0,1091818
fldAp,0.058823529411764705,16,16,CCGTCTCGGCGAGCCCGAAT,0,1066370
fldAp,0.058823529411764705,16,16,CCGGTTATCCGCTGCGAAAC,0,1080028
fldAp,0.058823529411764705,16,16,CCGGGAAGATTGGGAGGGTA,0,1156666
fldAp,0.058823529411764705,16,16,CCGGCATGAACGTGGGTTCT,0,1157300
fldAp,0.058823529411764705,16,16,CCGCATCATAAACCAAGGCT,0,1083519
fldAp,0.058823529411764705,16,16,CCCTGGCTGAAAGCTAAACC,0,1074354
fldAp,0.058823529411764705,16,16,CCCTATAACCTCCAATTCCA,0,1124416
fldAp,0.058823529411764705,16,16,CCCGCATGACACCTACCTTG,0,1098129
fldAp,0.058823529411764705,16,16,CCATCGTGGGGGTATGCAGC,0,1085696
fldAp,0.058823529411764705,16,16,CCAGGGGCATCCGTTACATG,0,1095080
fldAp,0.058823529411764705,16,16,CCAGGCCTGAAAGTCACAGT,0,1120178
fldAp,0.058823529411764705,16,16,CCAGATCTCCTTAGTATGCC,0,1080946
fldAp,0.058823529411764705,16,16,CCACCCCGACTGGCGTCAAG,0,1184328
fldAp,0.058823529411764705,16,16,CATTGGCAAAATTCAATTAT,0,1074774
fldAp,0.058823529411764705,16,16,CATTAGCTTAATTTGTGGTT,0,1140300
fldAp,0.058823529411764705,16,16,CATCGTTAATGTTCGATTGT,0,1136100
fldAp,0.058823529411764705,16,16,CATAAGGGTCGCCGACCTTC,0,1089798
fldAp,0.058823529411764705,16,16,CAGTTGTTGTGTATAGAGGT,0,1089205
fldAp,0.058823529411764705,16,16,CAGGCGTGCTACGATGGTGC,0,1140301
fldAp,0.058823529411764705,16,16,CAGCTGTAGGAATAGGCCGA,0,1184539
fldAp,0.058823529411764705,16,16,CAGCGGTTCTTTTATCCGGA,0,1117118
fldAp,0.058823529411764705,16,16,CAGCGAAAGTCTGCCTTGGA,0,1154973
fldAp,0.058823529411764705,16,16,CAGAGAGGCCATCTTATTCT,0,1142506
fldAp,0.058823529411764705,16,16,CACTGCCGCAGTCGTGAGTC,0,1141018
fldAp,0.058823529411764705,16,16,CACTAGATCATTTCGCTTAT,0,1152401
fldAp,0.058823529411764705,16,16,CACAGTTGGACAGAACACTC,0,1153024
fldAp,0.058823529411764705,16,16,CACACGACGGGTGCTTCAGT,0,1075707
fldAp,0.058823529411764705,16,16,CAATTCTTCGTGTGGGCATT,0,1082396
fldAp,0.058823529411764705,16,16,CAATTCAAACTTACAGGAAT,0,1071860
fldAp,0.058823529411764705,16,16,CAACCTAGAAACCACATCAT,0,1119681
fldAp,0.058823529411764705,16,16,CAAATTCCCGAATCGCACGT,0,1086857
fldAp,0.058823529411764705,16,16,CAAATACTACCATGTATCCC,0,1106583
fldAp,0.058823529411764705,16,16,ATTTTATAGGGTTATTTCTA,0,1076832
fldAp,0.058823529411764705,16,16,ATTTTAACACGATTCGCGCT,0,1100562
fldAp,0.058823529411764705,16,16,ATTTAACGCGATCGGGATAA,0,1183661
fldAp,0.058823529411764705,16,16,ATTGACGAAATCAGGTGGTT,0,1070397
fldAp,0.058823529411764705,16,16,ATTATTCTCTCAAGCAAAAT,0,1143183
fldAp,0.058823529411764705,16,16,ATGTTTGCGTTGGTTCTCTC,0,1170907
fldAp,0.058823529411764705,16,16,ATGTTCTGGTACCTAGATCT,0,1074569
fldAp,0.058823529411764705,16,16,ATGTTCTATCTCCGAATTTC,0,1131363
fldAp,0.058823529411764705,16,16,ATGTGAGGGGTATCGCTTCT,0,1143269
fldAp,0.058823529411764705,16,16,ATGGTCGTCGCAGTTTTCCA,0,1152376
fldAp,0.058823529411764705,16,16,ATGGTCACTCTGCATCTAAC,0,1145370
fldAp,0.058823529411764705,16,16,ATGGCGACGAATTACATTCG,0,1096800
fldAp,0.058823529411764705,16,16,ATGGCATTATAAACTAACGT,0,1073519
fldAp,0.058823529411764705,16,16,ATGCGAGGTATCCTCTCCCG,0,1182928
fldAp,0.058823529411764705,16,16,ATGATACTCCTAGATTATTC,0,1080417
fldAp,0.058823529411764705,16,16,ATGAGCGGGTCTGGGTATTA,0,1064187
fldAp,0.058823529411764705,16,16,ATCTGACATCAAGTCGCACC,0,1175327
fldAp,0.058823529411764705,16,16,ATCGTAACAAATCCATGACG,0,1168766
fldAp,0.058823529411764705,16,16,ATCGCTCTGGAAGCAAGCAT,0,1091721
fldAp,0.058823529411764705,16,16,ATCCGGATCAATCAGGTCAA,0,1182393
fldAp,0.058823529411764705,16,16,ATCCCGCGGACTGGCAGCGA,0,1115827
fldAp,0.058823529411764705,16,16,ATCATTTTTATTCAAGACTT,0,1121526
fldAp,0.058823529411764705,16,16,ATCACGACTCGTAATGATAG,0,1072595
fldAp,0.058823529411764705,16,16,ATCACACGATGCCCAGAATT,0,1110088
fldAp,0.058823529411764705,16,16,ATAGTCTTGCAACGGACAGA,0,1088797
fldAp,0.058823529411764705,16,16,ATAGACAATTAGGTGGCAAG,0,1149034
fldAp,0.058823529411764705,16,16,ATACCAGCGTAGTTAAGGTT,0,1165668
fldAp,0.058823529411764705,16,16,ATACAGTGGGGAATCCCGGC,0,1172926
fldAp,0.058823529411764705,16,16,ATAAGCCAAGTCATATGCCT,0,1163022
fldAp,0.058823529411764705,16,16,ATAAATGATGATTCAACGCA,0,1111739
fldAp,0.058823529411764705,16,16,AGTGTCTTGCGTGGTACGTC,0,1118433
fldAp,0.058823529411764705,16,16,AGTGCTGTGGCACGAAATTA,0,1066546
fldAp,0.058823529411764705,16,16,AGTCTCTACCAGTCAAGGCA,0,1087481
fldAp,0.058823529411764705,16,16,AGTCGCGCCCAACACGGGTG,0,1130304
fldAp,0.058823529411764705,16,16,AGTCAGTAGCTTAAGTGCTG,0,1099760
fldAp,0.058823529411764705,16,16,AGTATATCGCTCCACTCTAA,0,1080074
fldAp,0.058823529411764705,16,16,AGTATATAAAGTTCACCCTC,0,1163295
fldAp,0.058823529411764705,16,16,AGGTTCCGGACACATAAGGA,0,1088783
fldAp,0.058823529411764705,16,16,AGGTCGTAAACATTATTACT,0,1105698
fldAp,0.058823529411764705,16,16,AGGTCAGTCAATGTCAATGT,0,1122905
fldAp,0.058823529411764705,16,16,AGGTAAGACTTAGCGTCTTC,0,1099729
fldAp,0.058823529411764705,16,16,AGGGTTAAGCGAATTTGCTC,0,1089114
fldAp,0.058823529411764705,16,16,AGGCCAGGATATGGCTCGTA,0,1125698
fldAp,0.058823529411764705,16,16,AGCTTTAAAGTCGCGTAAGT,0,1130183
fldAp,0.058823529411764705,16,16,AGCTCTCTATGCTTTGCGCA,0,1079886
fldAp,0.058823529411764705,16,16,AGCGTTTCGTCACGGTTGTG,0,1164699
fldAp,0.058823529411764705,16,16,AGCGGCAACTGAGACCAGGC,0,1165793
fldAp,0.058823529411764705,16,16,AGCCTTTCGTACATCGCTAC,0,1104906
fldAp,0.058823529411764705,16,16,AGCCGTCCGCAACCACGCAT,0,1076911
fldAp,0.058823529411764705,16,16,AGCCGGTTAATCTAGTGGCT,0,1146660
fldAp,0.058823529411764705,16,16,AGCCAAGGGGCGGAATTAAG,0,1133491
fldAp,0.058823529411764705,16,16,AGATGCGTGGCCGATCCGCA,0,1170512
fldAp,0.058823529411764705,16,16,AGATCTGCTGAACAAGGGCA,0,1103809
fldAp,0.058823529411764705,16,16,AGATCTGACGGCTCGTTCGT,0,1148089
fldAp,0.058823529411764705,16,16,AGATATGAATTTCTAGGCTG,0,1126224
fldAp,0.058823529411764705,16,16,AGATATCGGAGAAACTTCTG,0,1168217
fldAp,0.058823529411764705,16,16,AGAGTACTAGGTTCGGATTG,0,1064247
fldAp,0.058823529411764705,16,16,AGAGGCCCTTAGATGAAACG,0,1135125
fldAp,0.058823529411764705,16,16,AGACTATACGTGGCGCACCT,0,1091616
fldAp,0.058823529411764705,16,16,AGACCAAAACTATGGTGCTC,0,1086631
fldAp,0.058823529411764705,16,16,AGAATTGATACTAGCCTGTT,0,1145385
fldAp,0.058823529411764705,16,16,AGAAAAGGAAGCCTACACTT,0,1078165
fldAp,0.058823529411764705,16,16,ACTTGCTAACTGAACGATTA,0,1161098
fldAp,0.058823529411764705,16,16,ACTCTGTGGCCCACCGGGCA,0,1092190
fldAp,0.058823529411764705,16,16,ACGTTTCCAGCGGGCATCTT,0,1148457
fldAp,0.058823529411764705,16,16,ACGTCGTGGCATGCAGCCGG,0,1120722
fldAp,0.058823529411764705,16,16,ACGTACCTAACGCTCCGAAG,0,1088535
fldAp,0.058823529411764705,16,16,ACGCGCCTCTAGGAGGCGGA,0,1171575
fldAp,0.058823529411764705,16,16,ACGCGCCCGTAGACGTAGCT,0,1101202
fldAp,0.058823529411764705,16,16,ACGATCCTAGCATTTGAGAA,0,1160974
fldAp,0.058823529411764705,16,16,ACCGCAGGCTCACTCATGGA,0,1173453
fldAp,0.058823529411764705,16,16,ACCAAGGCGGTCTGCCGCGG,0,1151390
fldAp,0.058823529411764705,16,16,ACATTGTAATAAGTTTTGGC,0,1097905
fldAp,0.058823529411764705,16,16,ACAGTTCTGAGGCTCAATGC,0,1120333
fldAp,0.058823529411764705,16,16,ACAGGCCCGCGACTTCTGAT,0,1096901
fldAp,0.058823529411764705,16,16,ACACCCCGACCCTTATAACA,0,1102213
fldAp,0.058823529411764705,16,16,AATTTGTCCGCACTTGTTCG,0,1070842
fldAp,0.058823529411764705,16,16,AATTGTGCTTCGGAAAGGAG,0,1088070
fldAp,0.058823529411764705,16,16,AATGAGCTCGTGCCAGCTCT,0,1104189
fldAp,0.058823529411764705,16,16,AATCTGTCAACGGACCACTT,0,1149066
fldAp,0.058823529411764705,16,16,AATATTATTGCGACAAACGT,0,1128800
fldAp,0.058823529411764705,16,16,AATATGTTTGGAGGGTAGCG,0,1078545
fldAp,0.058823529411764705,16,16,AATAGGGGGGGGATTATACA,0,1136436
fldAp,0.058823529411764705,16,16,AATAGCTCGCTCGCCAGTGT,0,1133714
fldAp,0.058823529411764705,16,16,AATACCACCGGTGTCCCACC,0,1181049
fldAp,0.058823529411764705,16,16,AAGTTGCAGTATTGTGCAGT,0,1165561
fldAp,0.058823529411764705,16,16,AAGGGGTCGACATTCAGTTA,0,1063049
fldAp,0.058823529411764705,16,16,AAGGAGGAAAACGCTGTACG,0,1085007
fldAp,0.058823529411764705,16,16,AAGCTGCTTCGCGGACATTC,0,1113641
fldAp,0.058823529411764705,16,16,AACTCCATTCGCGGAAGATG,0,1085599
fldAp,0.058823529411764705,16,16,AACGTTTGCTGCGCGAAGCT,0,1098199
fldAp,0.058823529411764705,16,16,AACGCGGCTTTAGACCCAAT,0,1065111
fldAp,0.058823529411764705,16,16,AACCTTCCGGTCGTTAGATG,0,1096111
fldAp,0.058823529411764705,16,16,AACCTCAAGACTACAGTCTC,0,1073268
fldAp,0.058823529411764705,16,16,AACCTATGCGTTTTTGGTCA,0,1088068
fldAp,0.058823529411764705,16,16,AACATCCGATGCTTGTTGGC,0,1132927
fldAp,0.058823529411764705,16,16,AACACAAGCACTCAGCTAGC,0,1091229
fldAp,0.058823529411764705,16,16,AAATTATCCATAATCGGGGA,0,1167750
fldAp,0.058823529411764705,16,16,AAATGTGAGTTTTCGCAGTG,0,1087391
fldAp,0.058823529411764705,16,16,AAATGGTAGTGAAGATCTTT,0,1147381
fldAp,0.058823529411764705,16,16,AAATAGATTGAACTGGACTG,0,1169155
fldAp,0.058823529411764705,16,16,AAAGTTTGACCAGTGTTACT,0,1123453
fldAp,0.058823529411764705,16,16,AAAGCTTGATAGCGGAGTCG,0,1076219
fldAp,0.058823529411764705,16,16,AAACTTAGGCTCTTCAGGTT,0,1159545
fldAp,0.058823529411764705,16,16,AAACACATTGGCTAGTCGGA,0,1097154
fldAp,0.0625,15,15,TTTTCGTCTTTTGCGTGGGA,0,1064959
fldAp,0.0625,15,15,TTTGGTATACTCGTCTTCGT,0,1134080
fldAp,0.0625,15,15,TTTCTGTGAGCCTGTAGCCT,0,1104059
fldAp,0.0625,15,15,TTTATGCCCGGGTGAAACTT,0,1145738
fldAp,0.0625,15,15,TTTACTGGCTTCATTCCGCA,0,1130728
fldAp,0.0625,15,15,TTTACTATCCGAAGAAGTAT,0,1125969
fldAp,0.0625,15,15,TTGTTAGACTACTGACGATG,0,1122892
fldAp,0.0625,15,15,TTGTCTTGTGAAAATAAGAA,0,1158755
fldAp,0.0625,15,15,TTGTATAGGGGTGTGCAGAG,0,1130909
fldAp,0.0625,15,15,TTGGTCCTATGGGTCTTCGA,0,1170570
fldAp,0.0625,15,15,TTGGCCCGCCGACCATTCTC,0,1139336
fldAp,0.0625,15,15,TTGGAACTGCCCTTAAAGCG,0,1119618
fldAp,0.0625,15,15,TTGCCGCCCTAAAGTAAACT,0,1106301
fldAp,0.0625,15,15,TTGCACAGACTCCTCAGTCG,0,1153313
fldAp,0.0625,15,15,TTCCGTAAGTTCTAAGAACA,0,1184266
fldAp,0.0625,15,15,TTCATGTCTCTCCGCTTAAC,0,1100384
fldAp,0.0625,15,15,TTCAGGGCAGCTCCTGAGCA,0,1073618
fldAp,0.0625,15,15,TTCACGTTCAGAAACATCCT,0,1094846
fldAp,0.0625,15,15,TTCAAGGGAAAAGGCAGGGA,0,1078161
fldAp,0.0625,15,15,TTCAAACCCCGGAGAGCAGT,0,1099397
fldAp,0.0625,15,15,TTATTCGCACGTGGTAGTGC,0,1093442
fldAp,0.0625,15,15,TTAGGTGTGAAAAGGAATTT,0,1134647
fldAp,0.0625,15,15,TTAGGACCAGTCGGTAGTAG,0,1156953
fldAp,0.0625,15,15,TTACTTTACTGTTGTATTAT,0,1074591
fldAp,0.0625,15,15,TTACTGCCGATACGGAACGG,0,1113399
fldAp,0.0625,15,15,TTACCTGCCCTCACACATAC,0,1130152
fldAp,0.0625,15,15,TTAATAGCTGAGTCTTCACA,0,1127470
fldAp,0.0625,15,15,TTAAATGTAAACCACAGGTT,0,1160566
fldAp,0.0625,15,15,TGTTCGGGTCATTAGAATAC,0,1146294
fldAp,0.0625,15,15,TGTTACGGTTGTTGTACGGC,0,1177660
fldAp,0.0625,15,15,TGTGGGATACGGCGCAAGCC,0,1086063
fldAp,0.0625,15,15,TGGTTACGATATACCTATAA,0,1165794
fldAp,0.0625,15,15,TGGTCTTCCGCGGGTGGAGA,0,1145889
fldAp,0.0625,15,15,TGGTCACATACGGAGGAAGA,0,1105273
fldAp,0.0625,15,15,TGGTACTATCACCAGGGTTA,0,1178168
fldAp,0.0625,15,15,TGGGAGTTTACGTTCCCCGA,0,1075424
fldAp,0.0625,15,15,TGGCTCCATAGTTGATAATC,0,1155233
fldAp,0.0625,15,15,TGGCACCGTAGGCGCGCTTG,0,1178403
fldAp,0.0625,15,15,TGGACGGTAAAGGGCATAGT,0,1151016
fldAp,0.0625,15,15,TGCTTAGTCAGAACAGAAAG,0,1175502
fldAp,0.0625,15,15,TGCCCGCTTGGGCAGGATGT,0,1179892
fldAp,0.0625,15,15,TGCCATTGGGGTCTAATACG,0,1089202
fldAp,0.0625,15,15,TGCATCCTTTCCTGCGACCC,0,1170534
fldAp,0.0625,15,15,TGCATCACTACCCCTTAAGT,0,1143008
fldAp,0.0625,15,15,TGCAGTGATCCTCGTTTTAA,0,1147337
fldAp,0.0625,15,15,TGCACCGCCCGTCCCTGTCG,0,1064196
fldAp,0.0625,15,15,TGATTAGCCTGACGACAAGA,0,1135141
fldAp,0.0625,15,15,TGATGATTGTGTCCGTTTAA,0,1133963
fldAp,0.0625,15,15,TGATAGGCCCCATCTTTCAA,0,1167605
fldAp,0.0625,15,15,TGATAAGGAAACGAGCGCGT,0,1138191
fldAp,0.0625,15,15,TGAGTTTTAAACACCCGGCC,0,1069971
fldAp,0.0625,15,15,TGAGTCCTATGAGAGTATTT,0,1160195
fldAp,0.0625,15,15,TGAGCTCCTCGATCTATGCG,0,1093031
fldAp,0.0625,15,15,TCTTTCTGAGAACCTGGCGA,0,1138941
fldAp,0.0625,15,15,TCTGTCCTCAACTAGAGTCG,0,1063076
fldAp,0.0625,15,15,TCTGTACTTCCGCGGGAAAG,0,1072164
fldAp,0.0625,15,15,TCTGCACCCAACTGTTTTGA,0,1173219
fldAp,0.0625,15,15,TCTGATGAGTCTTAGAGACT,0,1077873
fldAp,0.0625,15,15,TCTAGTCCGCCTCTGATCTC,0,1121573
fldAp,0.0625,15,15,TCGTCATGGAAGGAACGGTA,0,1167769
fldAp,0.0625,15,15,TCGTCACTAATATTGTTTTT,0,1085697
fldAp,0.0625,15,15,TCGGTATAATATAGGGGGTT,0,1132291
fldAp,0.0625,15,15,TCGGGCGAATAAGCGATCGA,0,1176264
fldAp,0.0625,15,15,TCGGAGTCGCGTACAGAGGC,0,1177890
fldAp,0.0625,15,15,TCGGAGCAGATGGGGACGAA,0,1118898
fldAp,0.0625,15,15,TCGGACTGGGAGAATGCAGT,0,1121078
fldAp,0.0625,15,15,TCGGAAGCATATCTTAGTTC,0,1100219
fldAp,0.0625,15,15,TCGCTTTGCGGGGGTATTTT,0,1071550
fldAp,0.0625,15,15,TCGATCTCTAGGCAGGATCG,0,1147347
fldAp,0.0625,15,15,TCGACCGTAGAATAATTGGT,0,1168508
fldAp,0.0625,15,15,TCCTTCAGCCTGAAGATGCT,0,1134703
fldAp,0.0625,15,15,TCCGACTCGCAACGAAATCC,0,1136762
fldAp,0.0625,15,15,TCCCTGACTTGACTATTAGA,0,1090583
fldAp,0.0625,15,15,TCCAATAGCTACTTCAGAAT,0,1151567
fldAp,0.0625,15,15,TCAGGTACAAGCATTAACTT,0,1160085
fldAp,0.0625,15,15,TCACCCCCGCGAGTGTCCCT,0,1093758
fldAp,0.0625,15,15,TATTGGCGCACTTGTTAATC,0,1162231
fldAp,0.0625,15,15,TATCCCTAGTATCCTTGTGA,0,1149050
fldAp,0.0625,15,15,TATAGCAAGGCGGCCATCGA,0,1114140
fldAp,0.0625,15,15,TAGGTCCTTTCAACGGGGTA,0,1155245
fldAp,0.0625,15,15,TAGGTATATACAAGACGGGT,0,1144028
fldAp,0.0625,15,15,TAGCTAAAATGGATTTAATG,0,1104301
fldAp,0.0625,15,15,TAGCGTCGGGGCGGGCGGGA,0,1160411
fldAp,0.0625,15,15,TAGCAATATAAAAAAAAACT,0,1141068
fldAp,0.0625,15,15,TAGATACACATATGGGCAGG,0,1116778
fldAp,0.0625,15,15,TACGTACGCTGGAGACACAA,0,1164900
fldAp,0.0625,15,15,TACCCGGCGGGTGAGATCGT,0,1125839
fldAp,0.0625,15,15,TACCAGGCGGATTTCGAAAT,0,1095640
fldAp,0.0625,15,15,TAATACGACGCTATTTAGGT,0,1165376
fldAp,0.0625,15,15,TAAGCGGAAGAGGTGTTACT,0,1122983
fldAp,0.0625,15,15,TAAGAATTCCGAATCCGGAG,0,1073921
fldAp,0.0625,15,15,TAACAGGGAACCACGAGCGA,0,1154676
fldAp,0.0625,15,15,TAAAGTGAACCGAGAACGTA,0,1069027
fldAp,0.0625,15,15,TAAAGGGAAACCCATAATAC,0,1099341
fldAp,0.0625,15,15,TAAAGCACAAACCCAATGTC,0,1162403
fldAp,0.0625,15,15,GTTTGACACATTATGCAGGC,0,1184207
fldAp,0.0625,15,15,GTTCTGATGCGGCTCCGAGG,0,1134238
fldAp,0.0625,15,15,GTTCAATATGGTTCGCGGGT,0,1161358
fldAp,0.0625,15,15,GTGTGCGTGCATTCCTATGG,0,1184405
fldAp,0.0625,15,15,GTGTGCGACGGGCGAGCGTT,0,1184166
fldAp,0.0625,15,15,GTGGTTAGTGCCCATAGTTG,0,1063744
fldAp,0.0625,15,15,GTGACCCGTAATTCAGATTG,0,1156308
fldAp,0.0625,15,15,GTGAAAATGGAAGTATCAAA,0,1069642
fldAp,0.0625,15,15,GTCTTGATGCGAACTGCGAA,0,1155790
fldAp,0.0625,15,15,GTCCGGCTCTTCAGGGAAGC,0,1184408
fldAp,0.0625,15,15,GTCATTACCGTTCATCAGGC,0,1120798
fldAp,0.0625,15,15,GTCAGATTCTGTACTTCCTC,0,1110392
fldAp,0.0625,15,15,GTCACTGATCCGTGGTGATC,0,1128975
fldAp,0.0625,15,15,GTCACCAAGCGTTCTCCTAG,0,1139548
fldAp,0.0625,15,15,GTATTGTACTCAGTGATTAG,0,1104127
fldAp,0.0625,15,15,GTATGAGCTATTACATCTGA,0,1155212
fldAp,0.0625,15,15,GTAGGTAGTGAAACAATAGT,0,1165861
fldAp,0.0625,15,15,GTAGAGTGACCAGGCAACGT,0,1160590
fldAp,0.0625,15,15,GTACGGTGTATCATGTCGTT,0,1124350
fldAp,0.0625,15,15,GTACGGCCCTACCCGTTGTG,0,1134514
fldAp,0.0625,15,15,GTACGATGCGGGAAGGACAT,0,1079126
fldAp,0.0625,15,15,GTAAACGTATGTGTCTAGCT,0,1106322
fldAp,0.0625,15,15,GGTTATCCAAGAGATGGGTT,0,1074392
fldAp,0.0625,15,15,GGTTACTGATGCGTGACGCT,0,1183527
fldAp,0.0625,15,15,GGTTACAATGGGACCCAGAA,0,1133493
fldAp,0.0625,15,15,GGTCTACGCCAAAGATCATC,0,1154435
fldAp,0.0625,15,15,GGTCGGTTGCCGATGAGTAG,0,1101649
fldAp,0.0625,15,15,GGTCCGTAAAGAGCGCTCCA,0,1130765
fldAp,0.0625,15,15,GGTCATTATGTCATACCGTA,0,1090586
fldAp,0.0625,15,15,GGGTTCATACCGGATATATC,0,1141840
fldAp,0.0625,15,15,GGGTCATCGGCCGCTCTCTT,0,1094491
fldAp,0.0625,15,15,GGGTATCTAAAATAGCGCCG,0,1098402
fldAp,0.0625,15,15,GGGGTCAAGCACGCCTGACT,0,1174029
fldAp,0.0625,15,15,GGGGGGTCAGGCAGGACTAC,0,1093704
fldAp,0.0625,15,15,GGGGGAGTCACTTGATAGTG,0,1153363
fldAp,0.0625,15,15,GGGCTAGGCCCCTTACCCAA,0,1132721
fldAp,0.0625,15,15,GGGCAGGGAACATTGGTGGC,0,1067364
fldAp,0.0625,15,15,GGCGTAAAAGCGGGTGCATT,0,1119197
fldAp,0.0625,15,15,GGCGCGTGGCATGTCGATTG,0,1138209
fldAp,0.0625,15,15,GGCGAAGTTACCGCAGGCAG,0,1139018
fldAp,0.0625,15,15,GGCCTCAGCTAGCGTCGGAT,0,1113954
fldAp,0.0625,15,15,GGCCATGAGGGAGCCAGAGT,0,1156072
fldAp,0.0625,15,15,GGCAAAAACTGTACCTATGG,0,1135213
fldAp,0.0625,15,15,GGATGTGGACGTAGCGGTAA,0,1119207
fldAp,0.0625,15,15,GGATCTTGCGTGCTTTCCGT,0,1074533
fldAp,0.0625,15,15,GGATCTTAAATTCAGTAGGT,0,1160942
fldAp,0.0625,15,15,GGAGAGCACTGGAAACGGCA,0,1176666
fldAp,0.0625,15,15,GGACCTTTACGTTTTTGGCT,0,1137372
fldAp,0.0625,15,15,GGAACACATACTCACGCGGC,0,1184212
fldAp,0.0625,15,15,GGAAAGGCGACCGTGATGGG,0,1076173
fldAp,0.0625,15,15,GCTTGCGATCGGGTCAGATT,0,1121233
fldAp,0.0625,15,15,GCTGGATAGCAAGGTTGGAT,0,1125742
fldAp,0.0625,15,15,GCTAGCGCAAACATGCGTTG,0,1111170
fldAp,0.0625,15,15,GCGGCCAACCTGCCTAACCT,0,1165015
fldAp,0.0625,15,15,GCGGAGGTAACTTGATCGCA,0,1132669
fldAp,0.0625,15,15,GCGGAAGCCTAACTGGGACT,0,1121160
fldAp,0.0625,15,15,GCGCTCTTGTGTAAGATTTG,0,1093106
fldAp,0.0625,15,15,GCGCGCTAGAATGGCATGTT,0,1156429
fldAp,0.0625,15,15,GCCGGAACTCATTGCGGTCT,0,1094510
fldAp,0.0625,15,15,GCCCTGGCCCCATGAAGCTG,0,1082408
fldAp,0.0625,15,15,GCCCTCGTAACATTGAACGT,0,1185017
fldAp,0.0625,15,15,GCCCTCCAGATATTATGAGC,0,1145521
fldAp,0.0625,15,15,GCCCTACATCCAGGTGTGTA,0,1150825
fldAp,0.0625,15,15,GCCATACATGGGGTAATATG,0,1080053
fldAp,0.0625,15,15,GCATTGAGTATTTATGGCTA,0,1098851
fldAp,0.0625,15,15,GCAGCTGTTGACCTTTGTTT,0,1183010
fldAp,0.0625,15,15,GCAATCATCACTGACAACTT,0,1161978
fldAp,0.0625,15,15,GCAACGTCGAGTCTCTACTC,0,1079075
fldAp,0.0625,15,15,GCAAAATTAATCGCAATTTG,0,1168726
fldAp,0.0625,15,15,GATTAGCTTCCTTGTTCTTT,0,1064201
fldAp,0.0625,15,15,GATGTAGGGGTAGGGTAGTT,0,1111875
fldAp,0.0625,15,15,GATGTACGACGTCGAGTTTT,0,1128314
fldAp,0.0625,15,15,GATGGTCAGCGTACGACCGA,0,1103711
fldAp,0.0625,15,15,GATCTCTGTCATGGCGCCGG,0,1160042
fldAp,0.0625,15,15,GATCGAGATAAATACAATCG,0,1117717
fldAp,0.0625,15,15,GATCCGAGCAAGTAGGTATA,0,1183356
fldAp,0.0625,15,15,GAGTTCTACTGACGTCTGTT,0,1125983
fldAp,0.0625,15,15,GAGTGGCCGTGAGCACCGCG,0,1148753
fldAp,0.0625,15,15,GAGTGGCCAGTACGTGATCG,0,1091349
fldAp,0.0625,15,15,GAGTAAGCGGGAGGGAGGGC,0,1131523
fldAp,0.0625,15,15,GAGGCTAAAAAGCGTTGCCT,0,1074744
fldAp,0.0625,15,15,GAGGCGGATTCGCTTAATTC,0,1107274
fldAp,0.0625,15,15,GAGGACTGTCGGCCATGTGA,0,1065113
fldAp,0.0625,15,15,GAGGACCTCTCAGAGTGGGA,0,1124275
fldAp,0.0625,15,15,GAGCTTCTGGGCGAGCTCGT,0,1117007
fldAp,0.0625,15,15,GAGCTCAGCGGTTTCCGTCC,0,1112518
fldAp,0.0625,15,15,GAGAGAACTGTCTTGTCTGA,0,1172683
fldAp,0.0625,15,15,GAGAACATGGATCCGGAAAG,0,1090427
fldAp,0.0625,15,15,GACGGGGGCGGTCCCCGCAG,0,1107209
fldAp,0.0625,15,15,GACGCCAGATTAAGGTGTTA,0,1154840
fldAp,0.0625,15,15,GAATAATAGTTATTTGCAGC,0,1065916
fldAp,0.0625,15,15,GAAGCATCTGTCTCCGACGT,0,1134745
fldAp,0.0625,15,15,GAACGTGCGGCGTTTCTTCC,0,1086769
fldAp,0.0625,15,15,GAACCGTGAAATGAACACAT,0,1133845
fldAp,0.0625,15,15,GAACATCAACGCCCTTCGTT,0,1079016
fldAp,0.0625,15,15,GAACAGTCACCACAGCTTTT,0,1103166
fldAp,0.0625,15,15,CTTGCGTTCGCCTGAATTCT,0,1071807
fldAp,0.0625,15,15,CTTGCATCTAATGTAATGAT,0,1152266
fldAp,0.0625,15,15,CTTCTTATCCCAATAGCGAT,0,1113722
fldAp,0.0625,15,15,CTTCCCGTAGTGACCTTCCA,0,1110922
fldAp,0.0625,15,15,CTTAAGGAAGGAACGATAAA,0,1139948
fldAp,0.0625,15,15,CTGTCCCAGCGCCAGCCTCA,0,1114436
fldAp,0.0625,15,15,CTGTATGGGTTATCCGCACA,0,1110474
fldAp,0.0625,15,15,CTGTATAGGGCCACAGGAAT,0,1155003
fldAp,0.0625,15,15,CTGGGGGCATAGCAGGGCAA,0,1121752
fldAp,0.0625,15,15,CTGGCGACTGCTCTAAGCCA,0,1084253
fldAp,0.0625,15,15,CTGGAGGTAGACATCGTCGT,0,1166547
fldAp,0.0625,15,15,CTGCTTGAGAACCGACCCTT,0,1170090
fldAp,0.0625,15,15,CTGCTGTTAATGGGTCCTCG,0,1186442
fldAp,0.0625,15,15,CTGAGGCCACCCCTAGGCTT,0,1161901
fldAp,0.0625,15,15,CTGACTTTCAGTGTGGTGTT,0,1072810
fldAp,0.0625,15,15,CTGACTAAAGTGATTCAGTC,0,1183111
fldAp,0.0625,15,15,CTCTTGTCCCGATGTTGATG,0,1069969
fldAp,0.0625,15,15,CTCTTACAGGGGCGGGTCCG,0,1126622
fldAp,0.0625,15,15,CTCGATGGCATTCGTCTACT,0,1113897
fldAp,0.0625,15,15,CTCGAGGCATCTCCATCCAT,0,1074306
fldAp,0.0625,15,15,CTCGACTCCGCGGAGATCTC,0,1105202
fldAp,0.0625,15,15,CTCCTAGCCGCCGCGTTGGC,0,1098243
fldAp,0.0625,15,15,CTATGAATCGCTTGCTAAAG,0,1125109
fldAp,0.0625,15,15,CTAGAGCTGCAAGGGTATTG,0,1174384
fldAp,0.0625,15,15,CTACCTCGAATGTCATCAAG,0,1157044
fldAp,0.0625,15,15,CTAAGATCACTGGGGCATGA,0,1121751
fldAp,0.0625,15,15,CGTGTGAAGACTGAGCCTCA,0,1078529
fldAp,0.0625,15,15,CGTGAAAAGGAGTGACCGAA,0,1155332
fldAp,0.0625,15,15,CGTCGAAGTGCCTGGCTCAT,0,1098714
fldAp,0.0625,15,15,CGTCGAACAACGTAGAAATT,0,1135451
fldAp,0.0625,15,15,CGTCAAGGCAGTGACGGTTT,0,1146379
fldAp,0.0625,15,15,CGTATCTACGTGTGCGGAAT,0,1096927
fldAp,0.0625,15,15,CGGGGGATTTACGAGCGGGA,0,1090040
fldAp,0.0625,15,15,CGGCTCTTTGGGCTCGGTTC,0,1141902
fldAp,0.0625,15,15,CGGCCGTTCGAGGTTTCAGC,0,1089201
fldAp,0.0625,15,15,CGGACAGGGTACAAGGTCGT,0,1099834
fldAp,0.0625,15,15,CGGAACACCTTGGGTCAACC,0,1160573
fldAp,0.0625,15,15,CGCTGCGAGGGGGGTCACAC,0,1155237
fldAp,0.0625,15,15,CGCGTGTTTATAATCGGGGT,0,1181660
fldAp,0.0625,15,15,CGCGTGCACGGCCAGGCGAA,0,1170094
fldAp,0.0625,15,15,CGCCGCTGACGCCCAGAATA,0,1153511
fldAp,0.0625,15,15,CGCAGAGTTTCGTCGCTCCC,0,1161904
fldAp,0.0625,15,15,CGCACATGCATCGTCTGTAG,0,1171762
fldAp,0.0625,15,15,CGATTTCTAATGCGTTGCGT,0,1065529
fldAp,0.0625,15,15,CGATGGTCTTTATTATATGT,0,1170997
fldAp,0.0625,15,15,CGACATGTACAAGTAGCCGT,0,1076538
fldAp,0.0625,15,15,CGACATATCTAAAATCCAGA,0,1170395
fldAp,0.0625,15,15,CCTTCGAATTCAATTAACAG,0,1095837
fldAp,0.0625,15,15,CCTGCCGGGTTCATCCGGGT,0,1103886
fldAp,0.0625,15,15,CCGTGTCTTCTGTAGGCGCT,0,1078824
fldAp,0.0625,15,15,CCGCAAAAGATAGGAAGCTA,0,1066978
fldAp,0.0625,15,15,CCCGGTCCAGGATGGCAGGA,0,1167812
fldAp,0.0625,15,15,CCCGGGAGGGCCGGTATACT,0,1130780
fldAp,0.0625,15,15,CCCCTTCCCCACGGAGCAAT,0,1139027
fldAp,0.0625,15,15,CCCATCTCCCAATATATGCT,0,1068842
fldAp,0.0625,15,15,CCATCAAGAATCTAATACTC,0,1155082
fldAp,0.0625,15,15,CCATATAGAATTTTGTTCTT,0,1168547
fldAp,0.0625,15,15,CCATACGTTCGTCAAAATAG,0,1181888
fldAp,0.0625,15,15,CCAGTGATGTTTTGGCTAGT,0,1111664
fldAp,0.0625,15,15,CCAGCTAGACGGGCCGTCCT,0,1151366
fldAp,0.0625,15,15,CCAAGAGGTGGGAGCAGGAC,0,1161948
fldAp,0.0625,15,15,CCAACCCCTCCCAGCACCAA,0,1142116
fldAp,0.0625,15,15,CATTGGGTACGCCAGACAGA,0,1169848
fldAp,0.0625,15,15,CATTATCGTCTCCCGGCTGA,0,1151793
fldAp,0.0625,15,15,CATGGAATAGTTCCTGGTAA,0,1147410
fldAp,0.0625,15,15,CATGCTCTTTGTCATGTGCA,0,1068248
fldAp,0.0625,15,15,CATGCAACGTACCCTTAGCT,0,1098499
fldAp,0.0625,15,15,CATGAGTTTATTCATAAGCT,0,1122142
fldAp,0.0625,15,15,CATCTTCATATAACGGACCA,0,1176428
fldAp,0.0625,15,15,CATCGCGCAATGAAGTTTAC,0,1078268
fldAp,0.0625,15,15,CATCAATCCTATGTGCGTTG,0,1178246
fldAp,0.0625,15,15,CATACCCACTGGTTTCTGTT,0,1131713
fldAp,0.0625,15,15,CATAATAGAAGACGACGGCG,0,1151009
fldAp,0.0625,15,15,CATAACGGTGATTCATAATC,0,1101538
fldAp,0.0625,15,15,CAGTGTGTTTGTGTTGGTGG,0,1180225
fldAp,0.0625,15,15,CAGGTAGCCCCGCCTCTTTT,0,1081930
fldAp,0.0625,15,15,CAGGGGATACTCATATACGT,0,1116401
fldAp,0.0625,15,15,CAGGGAACATCGCCCGACTC,0,1120441
fldAp,0.0625,15,15,CAGCGCGCCGACACCAGTTA,0,1075128
fldAp,0.0625,15,15,CAGCGCATTCATCCACGCCA,0,1123907
fldAp,0.0625,15,15,CAGCCGCGGGACATATCAGG,0,1082155
fldAp,0.0625,15,15,CAGCACTTACTCCTGCATTT,0,1157198
fldAp,0.0625,15,15,CAGATTTACGGAATAGGTTC,0,1093947
fldAp,0.0625,15,15,CAGAGTCTTCCATTATGCAT,0,1170126
fldAp,0.0625,15,15,CACCGTAAACCCGCCAGTCA,0,1145357
fldAp,0.0625,15,15,CACATAAGTGTAATCCAATT,0,1122127
fldAp,0.0625,15,15,CACAAACAATTAGGCCTGCA,0,1109610
fldAp,0.0625,15,15,CAATGCCGTCTAACTGCTTT,0,1145006
fldAp,0.0625,15,15,CAATCAGATCGGTGTATGAA,0,1118963
fldAp,0.0625,15,15,CAACGTCACCGAAGTTGATT,0,1133272
fldAp,0.0625,15,15,CAACCATCATGAGATTGTGG,0,1131940
fldAp,0.0625,15,15,CAACAGGGCCGATGGGAAGT,0,1064482
fldAp,0.0625,15,15,CAAAGTTCGTGATCGTACGG,0,1105735
fldAp,0.0625,15,15,ATTTGGGACTACGAGATCAA,0,1130333
fldAp,0.0625,15,15,ATTGTTAGCCGATTGAGGAG,0,1117919
fldAp,0.0625,15,15,ATTGTCTTTCACAAGCACGT,0,1112137
fldAp,0.0625,15,15,ATTGGATACAGCACGTCGGT,0,1063752
fldAp,0.0625,15,15,ATTGGACAATGAATGAGCCT,0,1097575
fldAp,0.0625,15,15,ATTGAATTTCTTCGTCGGAT,0,1161763
fldAp,0.0625,15,15,ATTCGAATTTCTTTTCTTAA,0,1169172
fldAp,0.0625,15,15,ATTATATCACGGCGGAAACT,0,1182157
fldAp,0.0625,15,15,ATTAGCTGCAGGCCATGAGT,0,1115186
fldAp,0.0625,15,15,ATGTTGAATAGTCCAACAAA,0,1149114
fldAp,0.0625,15,15,ATGTTAAGAACGGTGGTATA,0,1080885
fldAp,0.0625,15,15,ATGGAGCCACTTATGTTTGA,0,1099587
fldAp,0.0625,15,15,ATGGACCGGGGTACATCATT,0,1183002
fldAp,0.0625,15,15,ATGCTAGTAACGTGGCATGG,0,1097895
fldAp,0.0625,15,15,ATGCTACTATTTCCTTTTCC,0,1182458
fldAp,0.0625,15,15,ATGATAATAGGGACCCACAT,0,1152845
fldAp,0.0625,15,15,ATGAGTATGGATGCGAACTA,0,1084400
fldAp,0.0625,15,15,ATGAGACTTTGTCGGCGCGG,0,1154684
fldAp,0.0625,15,15,ATCGGACATGTGCGCCCACC,0,1120345
fldAp,0.0625,15,15,ATCGATTACTACTTCGAACT,0,1158730
fldAp,0.0625,15,15,ATCATTTCTCCGTGTGACTG,0,1097048
fldAp,0.0625,15,15,ATATTGCAGGACAGGAATAT,0,1147346
fldAp,0.0625,15,15,ATATTGATTTGAGATTGCTC,0,1094815
fldAp,0.0625,15,15,ATATCCCGGGTAGGAGCGAG,0,1161484
fldAp,0.0625,15,15,ATATACGACGGACGTTAGAT,0,1080601
fldAp,0.0625,15,15,ATAGTCATCTATCTGCGCCC,0,1066368
fldAp,0.0625,15,15,ATAGCAGGGGAACAGCGAAT,0,1099141
fldAp,0.0625,15,15,ATAAGCTTAGGAACCCTCTA,0,1095420
fldAp,0.0625,15,15,ATAACGAAACGAATAGTGTG,0,1155795
fldAp,0.0625,15,15,ATAACCATTGGAACACTAGC,0,1137217
fldAp,0.0625,15,15,AGTTCGGTATCTGCCACGGT,0,1146396
fldAp,0.0625,15,15,AGTTCGGCGTTACGCAATAC,0,1077333
fldAp,0.0625,15,15,AGTGTGTCAAAGGTCGCTGA,0,1139236
fldAp,0.0625,15,15,AGTCAGACAGAACGCAGCGA,0,1110266
fldAp,0.0625,15,15,AGTATGTTAGCGAAAACCCA,0,1181309
fldAp,0.0625,15,15,AGTAATGTCTTTGTGCCTTA,0,1117889
fldAp,0.0625,15,15,AGGTGCGAGGCTAGCTGAAA,0,1171826
fldAp,0.0625,15,15,AGGTCAAGGACATCGCAACC,0,1178390
fldAp,0.0625,15,15,AGGGGTCCCGTGTAAAACCT,0,1141614
fldAp,0.0625,15,15,AGGGGGCCTCCAAGAAGTAG,0,1127569
fldAp,0.0625,15,15,AGGGGCCTATTATTGGATAG,0,1070156
fldAp,0.0625,15,15,AGGCCATACCCATCGATCGG,0,1158532
fldAp,0.0625,15,15,AGGAGTCTCCAACACCCTGT,0,1173097
fldAp,0.0625,15,15,AGGACCGACGACGTGCCCTC,0,1121164
fldAp,0.0625,15,15,AGCTAGATTTTGGGAAAGTC,0,1084746
fldAp,0.0625,15,15,AGCGTGGTGCTCTAGCGTTA,0,1116702
fldAp,0.0625,15,15,AGCCGTCTCCTACCGTTCGG,0,1118460
fldAp,0.0625,15,15,AGCATGCAGCGTCGGCCTTG,0,1117846
fldAp,0.0625,15,15,AGCACCGACACCGGAAGAAA,0,1084401
fldAp,0.0625,15,15,AGATTTGGACTCCTCAGGAG,0,1141235
fldAp,0.0625,15,15,AGATTATATCCCTTAGAAGG,0,1133274
fldAp,0.0625,15,15,AGATCGTACGATACACGTGA,0,1130707
fldAp,0.0625,15,15,AGACCTCGTGATGTACGAGG,0,1086066
fldAp,0.0625,15,15,AGAAGTGCAAAGACCTACTG,0,1147610
fldAp,0.0625,15,15,AGAAAAAGCATGGCTAAATT,0,1109925
fldAp,0.0625,15,15,ACTCTTATATCTGCTCACAG,0,1067193
fldAp,0.0625,15,15,ACTCGCATGTATGTCTTTCG,0,1177289
fldAp,0.0625,15,15,ACTCAAACATCAAGGATAGC,0,1140695
fldAp,0.0625,15,15,ACTACAACCTTAGCTTAGGG,0,1160334
fldAp,0.0625,15,15,ACTAAGCTGGCAGCCCTCTA,0,1169448
fldAp,0.0625,15,15,ACTAACTTAAGTGCCCGTCT,0,1182746
fldAp,0.0625,15,15,ACGTGGTCTTGAGAGCCTCT,0,1094158
fldAp,0.0625,15,15,ACGTCAAATATCGCGAATGT,0,1090098
fldAp,0.0625,15,15,ACGGTTCTCGTGGTCCGGAA,0,1106663
fldAp,0.0625,15,15,ACGGTAAGAAGCTCCGGGGG,0,1097901
fldAp,0.0625,15,15,ACGGAGTCACCCTCCGAGGA,0,1126230
fldAp,0.0625,15,15,ACGCCATACCGAGCTATAAC,0,1183585
fldAp,0.0625,15,15,ACGATTATACTCAAGAGGCA,0,1096128
fldAp,0.0625,15,15,ACCTTTGTGTGCTGTAGCGT,0,1081902
fldAp,0.0625,15,15,ACCTGGTGCGGGGTTGGGCA,0,1179908
fldAp,0.0625,15,15,ACCGTCCTAGAAATAAAAAT,0,1114019
fldAp,0.0625,15,15,ACCGCTCGGGGGAGCTGCGT,0,1113394
fldAp,0.0625,15,15,ACCGCCCAGGCCACGTGCTC,0,1130919
fldAp,0.0625,15,15,ACCATAGGACTTCGACCCGA,0,1116571
fldAp,0.0625,15,15,ACCAGGTAAAATCGCGCGAA,0,1093151
fldAp,0.0625,15,15,ACCACAACTGCCTACACCTC,0,1147758
fldAp,0.0625,15,15,ACCAAGGGGATCATCATTAT,0,1180633
fldAp,0.0625,15,15,ACATGGGAGAGGTGTGGTAA,0,1150827
fldAp,0.0625,15,15,ACATGGACCGCTTTTACATG,0,1080951
fldAp,0.0625,15,15,ACATGCGGTATACAGGTTCT,0,1183877
fldAp,0.0625,15,15,ACAGTAAGACTATGTGAAAG,0,1086778
fldAp,0.0625,15,15,ACAGAATGCGGTAGCTTCGG,0,1097799
fldAp,0.0625,15,15,ACACGCCCTGCATCCTTGAT,0,1121988
fldAp,0.0625,15,15,ACACGCCAGGTACACCTTTT,0,1136482
fldAp,0.0625,15,15,ACACGATGAGCTTTTCTAAA,0,1130345
fldAp,0.0625,15,15,ACAATATATCAAACGCACTG,0,1125873
fldAp,0.0625,15,15,ACAAGGAACAAAGCGGCGAA,0,1178954
fldAp,0.0625,15,15,AATTGTATACCAACGCTGTA,0,1119886
fldAp,0.0625,15,15,AATCGTTAGTCGCCCGGACT,0,1151813
fldAp,0.0625,15,15,AATCCGGTCGGACTCCCTGC,0,1071943
fldAp,0.0625,15,15,AATCATTCAATTCCCCTGTC,0,1140068
fldAp,0.0625,15,15,AATCAGTCCACAGTCTCAGG,0,1077744
fldAp,0.0625,15,15,AATAGGACACAAGATACTAC,0,1157701
fldAp,0.0625,15,15,AATAGCTCTGTTTGGGAATC,0,1071039
fldAp,0.0625,15,15,AATACCTTCCCCGTCGCTAA,0,1141842
fldAp,0.0625,15,15,AAGTCTCCTGAGCAACTAAC,0,1095363
fldAp,0.0625,15,15,AAGGTTATGGTGCCTTCTGA,0,1180506
fldAp,0.0625,15,15,AAGGGCAGGAGTTTAGATGC,0,1179229
fldAp,0.0625,15,15,AAGGCTTGTAGCCACGCCCC,0,1069114
fldAp,0.0625,15,15,AAGGCACGGGTGGAGATGTA,0,1151012
fldAp,0.0625,15,15,AAGCTACCGAAATTTATGTC,0,1126114
fldAp,0.0625,15,15,AAGCGGCGATGTTCGGACTA,0,1176656
fldAp,0.0625,15,15,AAGCAAGTGACAGGTTTACG,0,1123989
fldAp,0.0625,15,15,AAGAGCGTCGCGAAACATGC,0,1137880
fldAp,0.0625,15,15,AACTGTCCTGGTCCCGGGCG,0,1120133
fldAp,0.0625,15,15,AACGTTTATCCATTGGCCTA,0,1122589
fldAp,0.0625,15,15,AACGCATCCGAATTACCGAG,0,1142076
fldAp,0.0625,15,15,AACCATCTTCATGGGGGGTC,0,1085918
fldAp,0.0625,15,15,AAATGCACCCAAACGTGGGT,0,1131599
fldAp,0.0625,15,15,AAACGCGACGAACCAGAGAC,0,1133263
fldAp,0.0625,15,15,AAAAGATCTCGATCACGATA,0,1170108
fldAp,0.06666666666666667,14,14,TTTTTATTTCGAGCAGCTAT,0,1096816
fldAp,0.06666666666666667,14,14,TTTTCTTCGTAATCACTGAA,0,1161896
fldAp,0.06666666666666667,14,14,TTTGTTCTCACAGTTTAGAA,0,1088520
fldAp,0.06666666666666667,14,14,TTTGCTACGGCTTGCAACAA,0,1102879
fldAp,0.06666666666666667,14,14,TTTGCAGTGTAGCTGCCTGG,0,1073257
fldAp,0.06666666666666667,14,14,TTTCTAGACTTTTTTCGCGG,0,1068740
fldAp,0.06666666666666667,14,14,TTTCGCACGCGGGATCTCAC,0,1132776
fldAp,0.06666666666666667,14,14,TTTCGAATACACCGTAGACG,0,1157590
fldAp,0.06666666666666667,14,14,TTTCATCGTGCTCCGGTTTG,0,1141248
fldAp,0.06666666666666667,14,14,TTTATCTCAGGCGTATTGTC,0,1136093
fldAp,0.06666666666666667,14,14,TTGTCATGTCGTCTCTATTC,0,1174380
fldAp,0.06666666666666667,14,14,TTGCTTTACGTGTCAGCCAT,0,1087047
fldAp,0.06666666666666667,14,14,TTGCTACCACCTGACCCAGA,0,1142069
fldAp,0.06666666666666667,14,14,TTGCTAACAACTTGTGCAGT,0,1124268
fldAp,0.06666666666666667,14,14,TTGCCTGCTTAGCAAGAACT,0,1167091
fldAp,0.06666666666666667,14,14,TTGCCCCCGGACACTCTTTC,0,1147048
fldAp,0.06666666666666667,14,14,TTGAAGGAGGGACTGCGTTT,0,1074649
fldAp,0.06666666666666667,14,14,TTCTTTGATTCAGGATGAAT,0,1101400
fldAp,0.06666666666666667,14,14,TTCTGGGTGGTGGCTAGGGG,0,1085978
fldAp,0.06666666666666667,14,14,TTCCTTAAGAGAGACCAACA,0,1122146
fldAp,0.06666666666666667,14,14,TTCCTCAGGCTCGTGGACTA,0,1103026
fldAp,0.06666666666666667,14,14,TTCCTAAAGCCTTCGATTGG,0,1093026
fldAp,0.06666666666666667,14,14,TTCCGGGGGCCAACCCGACA,0,1149166
fldAp,0.06666666666666667,14,14,TTCCAAGCGTTAAGAGCCAA,0,1096904
fldAp,0.06666666666666667,14,14,TTCATATTGTAGGGCATGTG,0,1156513
fldAp,0.06666666666666667,14,14,TTCAGCTGAACTCCCTCCCC,0,1074728
fldAp,0.06666666666666667,14,14,TTATCTTAGTCGTACGTGGA,0,1118649
fldAp,0.06666666666666667,14,14,TTATATAATGCCAGTATCGC,0,1159079
fldAp,0.06666666666666667,14,14,TTAGTCGCCACGAGTAGTGG,0,1149894
fldAp,0.06666666666666667,14,14,TTAACGTCGTACAACAACTT,0,1068254
fldAp,0.06666666666666667,14,14,TGTTTAAGAATATGGGGGTA,0,1140829
fldAp,0.06666666666666667,14,14,TGTCGCCGCTGGTGTCATCT,0,1144185
fldAp,0.06666666666666667,14,14,TGTCCGTGAAACGTCTGGGC,0,1070040
fldAp,0.06666666666666667,14,14,TGTAACGGGTTCGTTTACGG,0,1153418
fldAp,0.06666666666666667,14,14,TGGTCATCAAAGAGTACGGC,0,1116258
fldAp,0.06666666666666667,14,14,TGGGTGGCGCCAGCTGCGAC,0,1084286
fldAp,0.06666666666666667,14,14,TGGCAGCGAGCGAGGTTACA,0,1110268
fldAp,0.06666666666666667,14,14,TGGACGAGCCAAATATTAGT,0,1136593
fldAp,0.06666666666666667,14,14,TGGAATCAGTTGATGTCTTT,0,1066107
fldAp,0.06666666666666667,14,14,TGCTAGTTGGAAGCAGCTAT,0,1155659
fldAp,0.06666666666666667,14,14,TGCTAAGTCTTGGTGCCCGG,0,1104597
fldAp,0.06666666666666667,14,14,TGCGTGTCCAGAGAGGATGC,0,1159728
fldAp,0.06666666666666667,14,14,TGCCCTTACAATGCACGCTC,0,1110689
fldAp,0.06666666666666667,14,14,TGATGCCCGTGGCATAAATG,0,1102358
fldAp,0.06666666666666667,14,14,TGATCGTCAGAAACACAGTC,0,1123485
fldAp,0.06666666666666667,14,14,TGAGCGGTCACCTAAACGGA,0,1142476
fldAp,0.06666666666666667,14,14,TGAGCACGCGTCAACGAGGA,0,1076822
fldAp,0.06666666666666667,14,14,TGAGAGTCCTAAAACCCTTA,0,1161983
fldAp,0.06666666666666667,14,14,TGAGAGCACCACGTAGTATA,0,1184123
fldAp,0.06666666666666667,14,14,TGACGCGTGGGCAGAGGGAG,0,1088235
fldAp,0.06666666666666667,14,14,TGACATTGCAGTTTTAATAC,0,1073804
fldAp,0.06666666666666667,14,14,TGAAGTGCACTGCTCTACGC,0,1066921
fldAp,0.06666666666666667,14,14,TGAACGCCGGACTTCAAGTT,0,1161492
fldAp,0.06666666666666667,14,14,TCTTTAGGAGTCGGCGTGTT,0,1114020
fldAp,0.06666666666666667,14,14,TCTTGACAAAGACAGTCACT,0,1169607
fldAp,0.06666666666666667,14,14,TCTTCTGCCGTCGAAAGCCC,0,1123983
fldAp,0.06666666666666667,14,14,TCTTCAGCAAACGGACTCTT,0,1074652
fldAp,0.06666666666666667,14,14,TCTGTGCAACGGAAATAAGT,0,1068673
fldAp,0.06666666666666667,14,14,TCTGCACCTTCTGGGCGGTC,0,1166843
fldAp,0.06666666666666667,14,14,TCTCTTTCAGTGTGCATTTA,0,1178729
fldAp,0.06666666666666667,14,14,TCTAGTGCTTATACTCATTT,0,1142631
fldAp,0.06666666666666667,14,14,TCTAGCCACATGCGGATCTA,0,1068926
fldAp,0.06666666666666667,14,14,TCGTTCAATGAGAAGGAGAG,0,1079002
fldAp,0.06666666666666667,14,14,TCGGGCGCAACGGTTATGGT,0,1085010
fldAp,0.06666666666666667,14,14,TCGGCATTAAGGGCTGACAT,0,1076825
fldAp,0.06666666666666667,14,14,TCGGACGACCGCGTAGGCGA,0,1086615
fldAp,0.06666666666666667,14,14,TCGCCGGTATGCGGTTTTGA,0,1084865
fldAp,0.06666666666666667,14,14,TCGAATGCGTGAACGGGGGG,0,1123934
fldAp,0.06666666666666667,14,14,TCGAACGAGAGTTTTCGGTT,0,1123309
fldAp,0.06666666666666667,14,14,TCCTGGTGTAGGCGATACAC,0,1151000
fldAp,0.06666666666666667,14,14,TCCGGCCAACCCCAGTAGGC,0,1097523
fldAp,0.06666666666666667,14,14,TCCGCAGTAACTCTGTCCAA,0,1181054
fldAp,0.06666666666666667,14,14,TCCCCCCAATCACTAATGCA,0,1137788
fldAp,0.06666666666666667,14,14,TCCCCATGTATGAGCGTTGG,0,1135392
fldAp,0.06666666666666667,14,14,TCCCACGCACATATTGATTT,0,1077779
fldAp,0.06666666666666667,14,14,TCATAGATCCGGTTCGAGGG,0,1084937
fldAp,0.06666666666666667,14,14,TCAGCGCTATGCACGAAATC,0,1140467
fldAp,0.06666666666666667,14,14,TCACGTTCATAATAGTTTTC,0,1089580
fldAp,0.06666666666666667,14,14,TCACGGGGTATGTACTGGGC,0,1075282
fldAp,0.06666666666666667,14,14,TCACGATCTGTGCTCGTAGC,0,1186757
fldAp,0.06666666666666667,14,14,TCAATTTCGGACACGGACCA,0,1131776
fldAp,0.06666666666666667,14,14,TCAATGGATTGCTGGTTTAT,0,1083023
fldAp,0.06666666666666667,14,14,TCAATCTGCTAACCAAGTCC,0,1104103
fldAp,0.06666666666666667,14,14,TATTTTTCGATCCAGAGTGT,0,1142507
fldAp,0.06666666666666667,14,14,TATTTCAAGCACTTGGGTTC,0,1098088
fldAp,0.06666666666666667,14,14,TATTGTATGCTAGTGGTCTG,0,1081218
fldAp,0.06666666666666667,14,14,TATTCCGAAACGACGCATAA,0,1138108
fldAp,0.06666666666666667,14,14,TATTCATGCACGAGGCGTCT,0,1156023
fldAp,0.06666666666666667,14,14,TATGGTAGTTATCAAGTATC,0,1185587
fldAp,0.06666666666666667,14,14,TATCGAGCAGAGAGTAAGGT,0,1113286
fldAp,0.06666666666666667,14,14,TATATTAGAGTTTCAAAAGA,0,1185366
fldAp,0.06666666666666667,14,14,TATACAGCGCCAGATCCCGG,0,1176735
fldAp,0.06666666666666667,14,14,TATAACCCGCACGGACGACT,0,1185759
fldAp,0.06666666666666667,14,14,TAGGGTATTATCATGTTAGT,0,1092180
fldAp,0.06666666666666667,14,14,TAGCGTACATCGGGTCGATA,0,1099934
fldAp,0.06666666666666667,14,14,TAGCCGAGCTGCATTGCAAC,0,1157440
fldAp,0.06666666666666667,14,14,TAGCCAACTATGTGCTGCTA,0,1185476
fldAp,0.06666666666666667,14,14,TAGCAGTGTAATAATCGTTA,0,1185192
fldAp,0.06666666666666667,14,14,TAGATCCTACACTAGCGGTC,0,1073980
fldAp,0.06666666666666667,14,14,TAGACACTTAGCAGTAGATG,0,1073536
fldAp,0.06666666666666667,14,14,TACTTCCCGGTATGCACCTG,0,1102055
fldAp,0.06666666666666667,14,14,TACTGGTGAGTCACGAGATT,0,1079715
fldAp,0.06666666666666667,14,14,TACGATTTGCGATTTAGTCA,0,1087820
fldAp,0.06666666666666667,14,14,TACCTACACTATGAACCAAG,0,1114974
fldAp,0.06666666666666667,14,14,TACCCTCACCAATGCCCCTT,0,1146807
fldAp,0.06666666666666667,14,14,TACAAGCACAGCTGTAGTGG,0,1146734
fldAp,0.06666666666666667,14,14,TAACTTCGATGCTGGTCAGT,0,1167644
fldAp,0.06666666666666667,14,14,GTTTTTAGCAATTTAGGCCC,0,1102964
fldAp,0.06666666666666667,14,14,GTTTATCCGTGGCCGACTCT,0,1084930
fldAp,0.06666666666666667,14,14,GTTGTCGAGTAAGTCCGCTA,0,1124596
fldAp,0.06666666666666667,14,14,GTTGCGATCACATACGTTGC,0,1179130
fldAp,0.06666666666666667,14,14,GTTCGGTCACCGCATCAAGT,0,1152423
fldAp,0.06666666666666667,14,14,GTTAGGGGGACTAAATACAA,0,1130543
fldAp,0.06666666666666667,14,14,GTGTTCTGTAGGCGCCCGCT,0,1111851
fldAp,0.06666666666666667,14,14,GTGTGGTAGTGCACCCAGAT,0,1175231
fldAp,0.06666666666666667,14,14,GTGTGGACATTCGGCCCGGT,0,1069793
fldAp,0.06666666666666667,14,14,GTGGGTCAGTACTAGAGATA,0,1163816
fldAp,0.06666666666666667,14,14,GTGAAGCAGTGCGGCATCGT,0,1152069
fldAp,0.06666666666666667,14,14,GTCTTTCCTGGAGGGTTCTA,0,1067480
fldAp,0.06666666666666667,14,14,GTCTGTGAATATGATGTGAC,0,1154917
fldAp,0.06666666666666667,14,14,GTCTCTTCTAAATTCCGCGC,0,1080163
fldAp,0.06666666666666667,14,14,GTCGTCAAGACCGCTCTAGG,0,1100106
fldAp,0.06666666666666667,14,14,GTCGCGTCATTTCCATTCAT,0,1098957
fldAp,0.06666666666666667,14,14,GTCCTGCGCAATTCCCGGTC,0,1081940
fldAp,0.06666666666666667,14,14,GTCCGACTCGTGCAAGGAGG,0,1183899
fldAp,0.06666666666666667,14,14,GTCCCGTGGGGTAAACCTTT,0,1162973
fldAp,0.06666666666666667,14,14,GTCAATATTAAAGAGAGGTG,0,1147054
fldAp,0.06666666666666667,14,14,GTCAAGATGTTCTGAACCGC,0,1125990
fldAp,0.06666666666666667,14,14,GTAGTAATCACCGGGTCGAG,0,1101602
fldAp,0.06666666666666667,14,14,GTAGGTGAGTTCCGTCGGCA,0,1076963
fldAp,0.06666666666666667,14,14,GTAGGGTCTTATGAGTCTAT,0,1071525
fldAp,0.06666666666666667,14,14,GTACGTAGGGGTCGAAACAT,0,1068142
fldAp,0.06666666666666667,14,14,GTACGCTCGTCCAGACAGTT,0,1150999
fldAp,0.06666666666666667,14,14,GTACAGGCACCAGAAAGAAC,0,1065643
fldAp,0.06666666666666667,14,14,GTAACGTGGACAATGACGTT,0,1114382
fldAp,0.06666666666666667,14,14,GGTGTGTAGCGAACTTCGAT,0,1074814
fldAp,0.06666666666666667,14,14,GGTGCGGCTCTCGGATAGGA,0,1067171
fldAp,0.06666666666666667,14,14,GGTCTCTCTATCCTCTCAGC,0,1092903
fldAp,0.06666666666666667,14,14,GGTCTCAAGGTGTTATCGTG,0,1173902
fldAp,0.06666666666666667,14,14,GGTCCCTTGCAATGTCGGCA,0,1170655
fldAp,0.06666666666666667,14,14,GGTCACGCGAATGGCCATAT,0,1071060
fldAp,0.06666666666666667,14,14,GGTCAATGAGAATAAATCAA,0,1168526
fldAp,0.06666666666666667,14,14,GGTATGGCTTGTGTTAAGTG,0,1084854
fldAp,0.06666666666666667,14,14,GGTAATGCTGTACAGCTGTT,0,1072324
fldAp,0.06666666666666667,14,14,GGGGTTCTGGCAGCTGGGCT,0,1176659
fldAp,0.06666666666666667,14,14,GGGGTATACTCACCTCAATC,0,1094129
fldAp,0.06666666666666667,14,14,GGGCTCTTCGTCCGCCAGGT,0,1074260
fldAp,0.06666666666666667,14,14,GGGCGGTGGACGCATTGAAA,0,1083100
fldAp,0.06666666666666667,14,14,GGGAGCATGTCCATCAGCAT,0,1073173
fldAp,0.06666666666666667,14,14,GGGACATGTATCAAAGTATT,0,1103433
fldAp,0.06666666666666667,14,14,GGGACATGGGCGTGACAACG,0,1172826
fldAp,0.06666666666666667,14,14,GGGACAAATCAGTTACGTTA,0,1151795
fldAp,0.06666666666666667,14,14,GGGAATATGGTCTAGGTAAT,0,1153576
fldAp,0.06666666666666667,14,14,GGCTGGCACTGGACCTATGT,0,1132789
fldAp,0.06666666666666667,14,14,GGCCGGGGGGCACTGGGGTG,0,1180186
fldAp,0.06666666666666667,14,14,GGCCGGAATAACTCATATGT,0,1074795
fldAp,0.06666666666666667,14,14,GGCCCTTGGTCCTACGGTGC,0,1165014
fldAp,0.06666666666666667,14,14,GGCCCCAATGCCTCAAAATA,0,1069594
fldAp,0.06666666666666667,14,14,GGCCCACATACAAAGGTGCA,0,1148637
fldAp,0.06666666666666667,14,14,GGCATAAACCATGTTCTTTA,0,1158916
fldAp,0.06666666666666667,14,14,GGATCCAAGGCTAAGTAGCT,0,1128060
fldAp,0.06666666666666667,14,14,GGATACCAGGCTTATGACCC,0,1132928
fldAp,0.06666666666666667,14,14,GGAGCATGCTATTAGTTGTA,0,1106274
fldAp,0.06666666666666667,14,14,GGACACCCTCTTGTTCCGGT,0,1154242
fldAp,0.06666666666666667,14,14,GGAATCCGTCTATTAGTTTC,0,1092638
fldAp,0.06666666666666667,14,14,GCTTTCTGCTCAGTAAAATG,0,1181435
fldAp,0.06666666666666667,14,14,GCTTCATGCAGTGGAGCTCT,0,1149221
fldAp,0.06666666666666667,14,14,GCTTACGCGATATGGGCAGA,0,1132985
fldAp,0.06666666666666667,14,14,GCTCTTGTATCCAAAGCTGA,0,1114480
fldAp,0.06666666666666667,14,14,GCTCCTCTGGGACTAAGAAC,0,1090366
fldAp,0.06666666666666667,14,14,GCTCCAGTGCAGCAGAAAAA,0,1128822
fldAp,0.06666666666666667,14,14,GCGTCTGGTAAGTGATGGAA,0,1069893
fldAp,0.06666666666666667,14,14,GCGTATTAGGCCCATCAGTT,0,1068652
fldAp,0.06666666666666667,14,14,GCGTAGGCCCCTGCACGTCG,0,1157090
fldAp,0.06666666666666667,14,14,GCGGCCGCTCGTTTCCGTTA,0,1165315
fldAp,0.06666666666666667,14,14,GCGGATCACCCTCACACGTT,0,1169862
fldAp,0.06666666666666667,14,14,GCGAGGCGCATAGCCTCAAT,0,1110046
fldAp,0.06666666666666667,14,14,GCCTGTGATCGGCTGCTCCT,0,1126805
fldAp,0.06666666666666667,14,14,GCCTGGGGGCTGAGTTAATC,0,1066633
fldAp,0.06666666666666667,14,14,GCCGGCTAGTGTCACCGTGC,0,1154613
fldAp,0.06666666666666667,14,14,GCCGCTTCCTCCGCCCGGGG,0,1110779
fldAp,0.06666666666666667,14,14,GCCCTTAACGCTCGGGGCTA,0,1148822
fldAp,0.06666666666666667,14,14,GCCCGTGATTGTAGGTTATC,0,1066363
fldAp,0.06666666666666667,14,14,GCCATAGGACAAACCTATCA,0,1117605
fldAp,0.06666666666666667,14,14,GCAGGTAGTCGGCACGGACA,0,1126509
fldAp,0.06666666666666667,14,14,GCAGAGAGTCGCGCGAAAAT,0,1151466
fldAp,0.06666666666666667,14,14,GCAATTGCCGGGTCATTGCT,0,1115290
fldAp,0.06666666666666667,14,14,GCAAACCTAAGGTTTACATC,0,1087661
fldAp,0.06666666666666667,14,14,GATTTAGGTGGTCTCCGAAG,0,1064804
fldAp,0.06666666666666667,14,14,GATTCTAACACCTCGTCAGA,0,1182771
fldAp,0.06666666666666667,14,14,GATCAGCATTTGTGCTCCTT,0,1091719
fldAp,0.06666666666666667,14,14,GATAACGCCCTCTGCGGTGT,0,1138030
fldAp,0.06666666666666667,14,14,GAGTTGTCTGACAGCAAATA,0,1155203
fldAp,0.06666666666666667,14,14,GAGAAGAGGTCGATGTGGAG,0,1068870
fldAp,0.06666666666666667,14,14,GAGAAATACATAATTGGCCT,0,1179081
fldAp,0.06666666666666667,14,14,GAGAAAAGCGGTGGAAAGGT,0,1074754
fldAp,0.06666666666666667,14,14,GACTGGTTCCCAATTAGGTG,0,1156497
fldAp,0.06666666666666667,14,14,GACTACACCACAAGGTGGGT,0,1161112
fldAp,0.06666666666666667,14,14,GACGGTCTTACCTGCCACGA,0,1123849
fldAp,0.06666666666666667,14,14,GACGGGGGGGATAAGGCGCA,0,1133188
fldAp,0.06666666666666667,14,14,GACAATTAAGAAATGTGAGA,0,1069115
fldAp,0.06666666666666667,14,14,GAATGTCCAGGTCGGTCGTA,0,1126658
fldAp,0.06666666666666667,14,14,GAATATGCATACACGCCAAG,0,1082397
fldAp,0.06666666666666667,14,14,GAATATACGGCCGATGGGAT,0,1122975
fldAp,0.06666666666666667,14,14,GAAGTCCGAGTAGCTTGCAT,0,1092496
fldAp,0.06666666666666667,14,14,GAACGCGGGAGTCGTTATAA,0,1087782
fldAp,0.06666666666666667,14,14,GAACACAGCTTGCACCATCG,0,1184943
fldAp,0.06666666666666667,14,14,GAAACTTACGGTCCCGACTA,0,1143361
fldAp,0.06666666666666667,14,14,GAAACACCGAATGCGCCAAC,0,1086767
fldAp,0.06666666666666667,14,14,GAAAAGCGTGTTCGTAAGTA,0,1083522
fldAp,0.06666666666666667,14,14,GAAAAATTCTAGCTGATGCT,0,1135159
fldAp,0.06666666666666667,14,14,CTTTTATGGGTTCTCGGATC,0,1117259
fldAp,0.06666666666666667,14,14,CTTTGGACAGAGCCTCCCGT,0,1152863
fldAp,0.06666666666666667,14,14,CTTTCCCGAGGAGCACATTC,0,1137870
fldAp,0.06666666666666667,14,14,CTTTCCAAACAGAGATCTCG,0,1116662
fldAp,0.06666666666666667,14,14,CTTTCAAGCAACGTGTTTAG,0,1074309
fldAp,0.06666666666666667,14,14,CTTGTAAATCTCTCTCAAAG,0,1139257
fldAp,0.06666666666666667,14,14,CTTGGAGGCGCTGCACCCTC,0,1101376
fldAp,0.06666666666666667,14,14,CTTCGCATGGGGCACTGGTC,0,1130072
fldAp,0.06666666666666667,14,14,CTTCCGTGGGTCTTACGTTA,0,1119816
fldAp,0.06666666666666667,14,14,CTTCCGTGCAATGGAGTTCG,0,1173911
fldAp,0.06666666666666667,14,14,CTTCCGCAGAACGTCACGTT,0,1160086
fldAp,0.06666666666666667,14,14,CTTCAGAAGAACAAGAGCGA,0,1118635
fldAp,0.06666666666666667,14,14,CTTATTTTTTGTGGCCTATA,0,1152520
fldAp,0.06666666666666667,14,14,CTTATTTTTGCCGGCAGATT,0,1167751
fldAp,0.06666666666666667,14,14,CTTACCTGGTTACAGTTGGT,0,1100325
fldAp,0.06666666666666667,14,14,CTTAATTCGACACATCAGGA,0,1170388
fldAp,0.06666666666666667,14,14,CTGTTTCGGTTTTCAACATA,0,1162174
fldAp,0.06666666666666667,14,14,CTGTGTCGCCGATCCAACCC,0,1116095
fldAp,0.06666666666666667,14,14,CTGTCCAATAGCCTAGTAGG,0,1076626
fldAp,0.06666666666666667,14,14,CTGTCAAGTCCTTCATTGGA,0,1161965
fldAp,0.06666666666666667,14,14,CTGGTGTCCAGGTAAAGAAA,0,1119456
fldAp,0.06666666666666667,14,14,CTGGTCAAATGTGGGCAGCA,0,1066652
fldAp,0.06666666666666667,14,14,CTGGATAACTCTATTTTTTT,0,1119589
fldAp,0.06666666666666667,14,14,CTGGACATACTTTGTGCACC,0,1185008
fldAp,0.06666666666666667,14,14,CTGGAATTGTCGGTTTGCTG,0,1088744
fldAp,0.06666666666666667,14,14,CTGCTCACACTGAGGTGGCG,0,1120211
fldAp,0.06666666666666667,14,14,CTGCTAGTCACCTTGATAAC,0,1140427
fldAp,0.06666666666666667,14,14,CTGCCGGAACAGTCAAGAGA,0,1158324
fldAp,0.06666666666666667,14,14,CTGCATTGTCCCTGCCTACA,0,1156664
fldAp,0.06666666666666667,14,14,CTGATTTTTGTTATACTTTT,0,1106001
fldAp,0.06666666666666667,14,14,CTGATACGCTTGGTCTCTTG,0,1063507
fldAp,0.06666666666666667,14,14,CTGAAAGTCTTGATTTACAC,0,1134630
fldAp,0.06666666666666667,14,14,CTCTCAAGATCAACTTTTAT,0,1121450
fldAp,0.06666666666666667,14,14,CTCGCTACGGTAACTGGTCA,0,1097800
fldAp,0.06666666666666667,14,14,CTCGAAGCTGTAATCACGTC,0,1132752
fldAp,0.06666666666666667,14,14,CTCCTATGATAGGCACCGAC,0,1174511
fldAp,0.06666666666666667,14,14,CTCCGATAGAAATCCGGGAT,0,1094206
fldAp,0.06666666666666667,14,14,CTCCAGTGCCCGCTCCACAA,0,1097476
fldAp,0.06666666666666667,14,14,CTCCAGTATTACAAGTCCCA,0,1135241
fldAp,0.06666666666666667,14,14,CTCAGTTGAAAGTGCCTTTA,0,1073996
fldAp,0.06666666666666667,14,14,CTATGACGTCCCTCCAGTCT,0,1163132
fldAp,0.06666666666666667,14,14,CTATAGCGGGGATATCAATT,0,1157111
fldAp,0.06666666666666667,14,14,CTAGTTTGCCGACAGAAAGA,0,1129914
fldAp,0.06666666666666667,14,14,CTAGGGGCTTGTGCTTTCAA,0,1075621
fldAp,0.06666666666666667,14,14,CTACGCGGCTCCCAAGGGTT,0,1070580
fldAp,0.06666666666666667,14,14,CTACCTTACTCAGATGGATG,0,1113580
fldAp,0.06666666666666667,14,14,CGTTGTTTATTGGTGCCTTG,0,1075734
fldAp,0.06666666666666667,14,14,CGTTGTGGGGTGCAGATTCG,0,1079699
fldAp,0.06666666666666667,14,14,CGTGGAGGCCTAGTTTGTGA,0,1090520
fldAp,0.06666666666666667,14,14,CGTCTTTACCGACCCTAGAA,0,1137130
fldAp,0.06666666666666667,14,14,CGTCAAGTGCAACGTGGCTA,0,1072819
fldAp,0.06666666666666667,14,14,CGTAGGTACCTTCCTAATCA,0,1143660
fldAp,0.06666666666666667,14,14,CGGTTGAGGCATCATTGGAT,0,1135002
fldAp,0.06666666666666667,14,14,CGGTATGAACGGGTTAATTG,0,1134905
fldAp,0.06666666666666667,14,14,CGGGTCGGTATCAAAGAGGA,0,1074521
fldAp,0.06666666666666667,14,14,CGGGGCATGCAAGAGTCGTA,0,1186069
fldAp,0.06666666666666667,14,14,CGGCTCCAATGGAGCAGTAA,0,1109202
fldAp,0.06666666666666667,14,14,CGGCACAAAGGCCCCACACA,0,1162735
fldAp,0.06666666666666667,14,14,CGCTTTGTACACCTAACTAC,0,1112872
fldAp,0.06666666666666667,14,14,CGCTGTAAAGACCACATGGT,0,1085422
fldAp,0.06666666666666667,14,14,CGCCTCTCATTACGAAAGTT,0,1179450
fldAp,0.06666666666666667,14,14,CGCCGTTCCACCACTCGCCT,0,1120488
fldAp,0.06666666666666667,14,14,CGCCCCTCTAACTCTAAGTA,0,1141722
fldAp,0.06666666666666667,14,14,CGCAGTCGCGGCGTTGACGC,0,1074276
fldAp,0.06666666666666667,14,14,CGCAGGAAGATGCAGCTTGG,0,1079622
fldAp,0.06666666666666667,14,14,CGCAGCGAATAGTTAGGAGT,0,1131794
fldAp,0.06666666666666667,14,14,CGCAGCACACGCGTAACGTG,0,1158566
fldAp,0.06666666666666667,14,14,CGATATCACGTGCATGGCTC,0,1100057
fldAp,0.06666666666666667,14,14,CGACTAATCAGCACATTTCT,0,1063941
fldAp,0.06666666666666667,14,14,CGACGCGTTGCGGACCAGAA,0,1118507
fldAp,0.06666666666666667,14,14,CGAACAAGTGGGACCATATA,0,1068088
fldAp,0.06666666666666667,14,14,CCTGAGATTTTCATCCGGGA,0,1153378
fldAp,0.06666666666666667,14,14,CCTCTCAAGTTCCTTTCAAA,0,1146806
fldAp,0.06666666666666667,14,14,CCTCGTATCTAACTCCCATT,0,1154687
fldAp,0.06666666666666667,14,14,CCTCAAGTGTAGCACGATGG,0,1148082
fldAp,0.06666666666666667,14,14,CCTATCGTTGGATTGAAGTT,0,1120687
fldAp,0.06666666666666667,14,14,CCTATCGTGTGGGAACGGAC,0,1102234
fldAp,0.06666666666666667,14,14,CCTAGACTCTATTGAGTCCA,0,1116514
fldAp,0.06666666666666667,14,14,CCGTTCGTACAGGCCGGGAT,0,1170171
fldAp,0.06666666666666667,14,14,CCGTGCTCGAGGGGCGCGAG,0,1069196
fldAp,0.06666666666666667,14,14,CCGGTAGAGAACCCATGGCG,0,1082947
fldAp,0.06666666666666667,14,14,CCGGCTAAGATTCCTACACC,0,1142640
fldAp,0.06666666666666667,14,14,CCGCCGGCTCCTCAGCGTAC,0,1147970
fldAp,0.06666666666666667,14,14,CCGATGAGGAGTGACGGTTC,0,1107977
fldAp,0.06666666666666667,14,14,CCGAGGCTCGGCCAAGTCAT,0,1164722
fldAp,0.06666666666666667,14,14,CCCGTTGCTTCCGTGCTTTC,0,1086852
fldAp,0.06666666666666667,14,14,CCCGCTTTCCCAGTAGGGTC,0,1075252
fldAp,0.06666666666666667,14,14,CCCATGCCAATATCGAGAAA,0,1122519
fldAp,0.06666666666666667,14,14,CCCAGAGTTGAAGGTCGTGG,0,1101054
fldAp,0.06666666666666667,14,14,CCCACCGACCACGGCGTTCC,0,1173004
fldAp,0.06666666666666667,14,14,CCCACATCTCACTTAAACTG,0,1076697
fldAp,0.06666666666666667,14,14,CCATTACGGCTTAGTGCGTT,0,1079382
fldAp,0.06666666666666667,14,14,CCATCGCTCAGTGTCCACGA,0,1107764
fldAp,0.06666666666666667,14,14,CCATAGGGTGATGACTGTAT,0,1107609
fldAp,0.06666666666666667,14,14,CCAGAGAGAGACTGATTCTT,0,1150401
fldAp,0.06666666666666667,14,14,CCACGCAAGACCCCTACTTC,0,1181579
fldAp,0.06666666666666667,14,14,CCACAGTACAAGCACTCTGA,0,1131321
fldAp,0.06666666666666667,14,14,CCAACGGCCGGTACGAGCTA,0,1071398
fldAp,0.06666666666666667,14,14,CATGGATTGTTGTGCTTCCC,0,1177472
fldAp,0.06666666666666667,14,14,CATGCACTACTGGGGTGGGA,0,1119116
fldAp,0.06666666666666667,14,14,CATCTTGAGTTATTACGTAC,0,1145762
fldAp,0.06666666666666667,14,14,CATCGTAGTATTATGGCCGT,0,1138887
fldAp,0.06666666666666667,14,14,CATCCGAAATCTTTGAACAT,0,1111735
fldAp,0.06666666666666667,14,14,CATCATAACAGTAATACGCC,0,1120530
fldAp,0.06666666666666667,14,14,CAGTTTCTTACTATAGGAGA,0,1178840
fldAp,0.06666666666666667,14,14,CAGTCACCTCCGTTAGTCTG,0,1080387
fldAp,0.06666666666666667,14,14,CAGGTTGCGTTATTGATCGC,0,1163474
fldAp,0.06666666666666667,14,14,CAGCGCCATACACTGAGACA,0,1126422
fldAp,0.06666666666666667,14,14,CAGCCCTCGTATACCAATTC,0,1088074
fldAp,0.06666666666666667,14,14,CAGACTCACGGGCTATTAGT,0,1158409
fldAp,0.06666666666666667,14,14,CACTGTACTATGGCGAGTTC,0,1184708
fldAp,0.06666666666666667,14,14,CACTAGCACAGTGAGCCATG,0,1128420
fldAp,0.06666666666666667,14,14,CACTACCACCCTCAAGAAGG,0,1151588
fldAp,0.06666666666666667,14,14,CACCGAGCGGTTATGCGTAA,0,1106671
fldAp,0.06666666666666667,14,14,CACAGTTGGATGAGATGTAT,0,1072287
fldAp,0.06666666666666667,14,14,CACACAGACTTATGCGTTGC,0,1158991
fldAp,0.06666666666666667,14,14,CACAAGGAGGGAAAGCTGTC,0,1147941
fldAp,0.06666666666666667,14,14,CAAGTCTTACCAAACTTTGG,0,1123454
fldAp,0.06666666666666667,14,14,CAAATTAGTACGTCTAGTGT,0,1160251
fldAp,0.06666666666666667,14,14,CAAATGGAGTGGCCGTTCCT,0,1156205
fldAp,0.06666666666666667,14,14,ATTTTCTGGTGCGTCTTGCT,0,1179902
fldAp,0.06666666666666667,14,14,ATTTTCAGTACCATAGCTTG,0,1170399
fldAp,0.06666666666666667,14,14,ATTTTAGGGCTGTATCCCCA,0,1119495
fldAp,0.06666666666666667,14,14,ATTTGGTACTGAGACGTTTT,0,1156591
fldAp,0.06666666666666667,14,14,ATTGTACGCTAGCGAGTCAT,0,1100409
fldAp,0.06666666666666667,14,14,ATTGGGTACTTATCTAGGAA,0,1183272
fldAp,0.06666666666666667,14,14,ATTCTTACAGCCGTTACTTT,0,1185027
fldAp,0.06666666666666667,14,14,ATTCGCTGACACTGCTTGTC,0,1116871
fldAp,0.06666666666666667,14,14,ATTCCGTACCTTTAAGGATA,0,1168887
fldAp,0.06666666666666667,14,14,ATTCCACGTATGTACAACCA,0,1091163
fldAp,0.06666666666666667,14,14,ATTCCACCTCCTTAGCCAGA,0,1140761
fldAp,0.06666666666666667,14,14,ATTCATAAATTAGAAAAATG,0,1162942
fldAp,0.06666666666666667,14,14,ATTAAGTACGACCGTGGCTA,0,1107271
fldAp,0.06666666666666667,14,14,ATTAAGGGAGTCAAAGTCGA,0,1123720
fldAp,0.06666666666666667,14,14,ATGTCTTAGCACATCCGTTC,0,1069105
fldAp,0.06666666666666667,14,14,ATGGTAGCTTCTAGCCAGAT,0,1126722
fldAp,0.06666666666666667,14,14,ATGGCTGGTCACGTGGTACA,0,1185693
fldAp,0.06666666666666667,14,14,ATGGCGCTAGGGCTAGTACA,0,1168128
fldAp,0.06666666666666667,14,14,ATGCGTTGGCGCCATAGCCA,0,1083132
fldAp,0.06666666666666667,14,14,ATGCGGTCACAGATTACACT,0,1165804
fldAp,0.06666666666666667,14,14,ATGCAATGACTCGCCCGATA,0,1180272
fldAp,0.06666666666666667,14,14,ATCTTTACCATAGCGCAAGT,0,1171324
fldAp,0.06666666666666667,14,14,ATCTAAAAGACCAAGGGGTA,0,1124867
fldAp,0.06666666666666667,14,14,ATCGGATCATTCATTCAGGG,0,1168924
fldAp,0.06666666666666667,14,14,ATCGCAGGGCGAGCAGAGCG,0,1139044
fldAp,0.06666666666666667,14,14,ATCGAACTGGCGCCAACAAC,0,1063456
fldAp,0.06666666666666667,14,14,ATCCCGCCATATGGGCCAAT,0,1184321
fldAp,0.06666666666666667,14,14,ATCAAGATCACGTACGTGTC,0,1094062
fldAp,0.06666666666666667,14,14,AGTTTTTGGAGATCAACGGG,0,1116631
fldAp,0.06666666666666667,14,14,AGTTCACGAGAGTCTGCGAC,0,1172847
fldAp,0.06666666666666667,14,14,AGTTACTATATACTTTGCAT,0,1148024
fldAp,0.06666666666666667,14,14,AGTCCTCAAAGTTCATGCTT,0,1134247
fldAp,0.06666666666666667,14,14,AGTCAGACTAACTTGAAAGG,0,1071040
fldAp,0.06666666666666667,14,14,AGTATATCTATCGTGGTATA,0,1069744
fldAp,0.06666666666666667,14,14,AGGTTCCGCTTTTAACGTAT,0,1136667
fldAp,0.06666666666666667,14,14,AGGTAGATGTGGTTCATATT,0,1138423
fldAp,0.06666666666666667,14,14,AGGGCCTACACGGGCCAACA,0,1142573
fldAp,0.06666666666666667,14,14,AGGGATCCTGTACGTCACAG,0,1105018
fldAp,0.06666666666666667,14,14,AGGGACTTGGGTTGTAATAA,0,1094489
fldAp,0.06666666666666667,14,14,AGGGAAGTAAGCACTCCCTG,0,1074523
fldAp,0.06666666666666667,14,14,AGGCCTCAGGAGCGAACTAC,0,1143534
fldAp,0.06666666666666667,14,14,AGGCAGTTCCAAAAGGCGGA,0,1079825
fldAp,0.06666666666666667,14,14,AGGAGTCCGTACGGACGATT,0,1089898
fldAp,0.06666666666666667,14,14,AGGACTTGTCGTTCAACAGA,0,1090063
fldAp,0.06666666666666667,14,14,AGGACAGGCAGCCGAGGCGG,0,1092639
fldAp,0.06666666666666667,14,14,AGCTGCGGAAAAAGTAACAT,0,1115182
fldAp,0.06666666666666667,14,14,AGCTGATTGAGCTACATCTC,0,1080591
fldAp,0.06666666666666667,14,14,AGCTCTGCGAACGTAGCTCA,0,1068680
fldAp,0.06666666666666667,14,14,AGCGTGAAAAGCGCCTTGAG,0,1071964
fldAp,0.06666666666666667,14,14,AGCGTCTGAAACCATTTAAA,0,1098761
fldAp,0.06666666666666667,14,14,AGCGCTCATGCGTGGTGCGG,0,1115054
fldAp,0.06666666666666667,14,14,AGCGCCGTATGGCTAGGCAT,0,1078669
fldAp,0.06666666666666667,14,14,AGCGCCGCAGACGGGCTAGA,0,1114345
fldAp,0.06666666666666667,14,14,AGCGATGAATCCTAACGCAT,0,1110948
fldAp,0.06666666666666667,14,14,AGCCCGTCGCGCGTACAGGA,0,1133819
fldAp,0.06666666666666667,14,14,AGCCATCAGTTAACCCGTTC,0,1064678
fldAp,0.06666666666666667,14,14,AGATTCGGCAGTGAGGCAGG,0,1159047
fldAp,0.06666666666666667,14,14,AGAGTTAGAAGGTCTGGAGC,0,1122981
fldAp,0.06666666666666667,14,14,AGAGTGACCGCACCATACAG,0,1068832
fldAp,0.06666666666666667,14,14,AGAGCGCTATTGCTTTGCAG,0,1166784
fldAp,0.06666666666666667,14,14,AGAGAATGCAAAGGCCAAAT,0,1182292
fldAp,0.06666666666666667,14,14,AGACCCTAAATTGGCTCAAC,0,1115897
fldAp,0.06666666666666667,14,14,AGACATACTTCAGACAGCAG,0,1078382
fldAp,0.06666666666666667,14,14,AGAAGCGTCCAGTATCTGGT,0,1125116
fldAp,0.06666666666666667,14,14,AGAAGCACTGGGTCCTCGTG,0,1121844
fldAp,0.06666666666666667,14,14,AGAAACCAGTGCTTTAAGGA,0,1093582
fldAp,0.06666666666666667,14,14,ACTTTGTCTGTTATGAGGTG,0,1183580
fldAp,0.06666666666666667,14,14,ACTGTCCGGCCATTTGTGCT,0,1084170
fldAp,0.06666666666666667,14,14,ACTCTGCAGGGGCTCAACGG,0,1073101
fldAp,0.06666666666666667,14,14,ACTCTCCCTATCAAATCGTA,0,1065469
fldAp,0.06666666666666667,14,14,ACTCCGGCGTCCAATCCCTA,0,1068144
fldAp,0.06666666666666667,14,14,ACTCAGAAGCGGTACCGTTA,0,1076531
fldAp,0.06666666666666667,14,14,ACTAGAGATGCAACTCACGA,0,1096259
fldAp,0.06666666666666667,14,14,ACTAAAGGTTATTCGAAGGC,0,1162564
fldAp,0.06666666666666667,14,14,ACGTTGCTCCAGTCTTCACA,0,1111118
fldAp,0.06666666666666667,14,14,ACGTGTTCAAGATCTAAAAA,0,1094867
fldAp,0.06666666666666667,14,14,ACGGTTTTATTCGGATTTTT,0,1152377
fldAp,0.06666666666666667,14,14,ACGGCCCCCTGCGAACCTGA,0,1142903
fldAp,0.06666666666666667,14,14,ACGCGCGTAGAAATATGCCT,0,1090544
fldAp,0.06666666666666667,14,14,ACGCCGCGAAGCGCACCTCT,0,1143305
fldAp,0.06666666666666667,14,14,ACGCAGTAGCGCGAAGGCAT,0,1118255
fldAp,0.06666666666666667,14,14,ACGATTGCACACGAACATTG,0,1132814
fldAp,0.06666666666666667,14,14,ACCTATACAAAGGTTATCCT,0,1086319
fldAp,0.06666666666666667,14,14,ACCCTCCCTGTTTATGTACT,0,1150396
fldAp,0.06666666666666667,14,14,ACCCGGCGCTAGGAACCTAG,0,1063873
fldAp,0.06666666666666667,14,14,ACCCATCGGGAAACATCAGT,0,1140198
fldAp,0.06666666666666667,14,14,ACATTCGAGTTGTATTGAGC,0,1158042
fldAp,0.06666666666666667,14,14,ACATTCCAGGTGGCTTACGT,0,1078198
fldAp,0.06666666666666667,14,14,ACATGCAACATGGGGCGTTG,0,1128834
fldAp,0.06666666666666667,14,14,ACAGTTATGTTAGTGCTCGG,0,1157935
fldAp,0.06666666666666667,14,14,ACACTAGGGGGTTTCTGTAC,0,1080083
fldAp,0.06666666666666667,14,14,ACACATGCGCTCTCAGGGCA,0,1112693
fldAp,0.06666666666666667,14,14,ACAATTGGGTCGTGGAAGTG,0,1125480
fldAp,0.06666666666666667,14,14,ACAATGTTACCTTTGACCTG,0,1179072
fldAp,0.06666666666666667,14,14,ACAATGTCCGACCTAGTAAC,0,1144097
fldAp,0.06666666666666667,14,14,AATTGCGGCGCGTCTCGCTG,0,1145074
fldAp,0.06666666666666667,14,14,AATTACCCGTTCAAAATGAT,0,1107875
fldAp,0.06666666666666667,14,14,AATGGTTGATGGGCTACAAC,0,1073999
fldAp,0.06666666666666667,14,14,AATGGCTCCTATAAACCCTA,0,1099418
fldAp,0.06666666666666667,14,14,AATGCACACCGGCGTAGTAG,0,1085135
fldAp,0.06666666666666667,14,14,AATATTCCTGCTAGCATCTG,0,1128270
fldAp,0.06666666666666667,14,14,AAGTTAAATAGGGACACACA,0,1159726
fldAp,0.06666666666666667,14,14,AAGTGACAGGGGTAGGATTC,0,1118053
fldAp,0.06666666666666667,14,14,AAGGTGTAAGCGGAGACTCA,0,1146726
fldAp,0.06666666666666667,14,14,AAGGTGGCCAGCGTATTCCA,0,1072510
fldAp,0.06666666666666667,14,14,AAGGTAATCTGCATCGAAAG,0,1175058
fldAp,0.06666666666666667,14,14,AAGCTGACTTCGTCCCATCT,0,1163442
fldAp,0.06666666666666667,14,14,AAGCCATGAATAGGGGATTC,0,1091240
fldAp,0.06666666666666667,14,14,AAGACTCTGCGACGAGTATT,0,1088794
fldAp,0.06666666666666667,14,14,AAGACGGCCCATGTCAACAT,0,1165923
fldAp,0.06666666666666667,14,14,AAGAATAAGGGGAGTACCTC,0,1165466
fldAp,0.06666666666666667,14,14,AACTGGAGGCTGTGTACGCT,0,1132713
fldAp,0.06666666666666667,14,14,AACCGCATCTCGGTAACTCA,0,1172169
fldAp,0.06666666666666667,14,14,AACCGAACGGGTTAGTGTTG,0,1092115
fldAp,0.06666666666666667,14,14,AACCCAATTTAGTAAAGAGA,0,1160082
fldAp,0.06666666666666667,14,14,AACATATGTAGTAGACGCTA,0,1123632
fldAp,0.06666666666666667,14,14,AAATTTCCTAAAAGATCATT,0,1113953
fldAp,0.06666666666666667,14,14,AAATCGAGGCTCAGAGCAAT,0,1089608
fldAp,0.06666666666666667,14,14,AAATCCCCCCCCAGTGACCA,0,1063163
fldAp,0.06666666666666667,14,14,AAAGTGGATAAGTTAAGACC,0,1117604
fldAp,0.06666666666666667,14,14,AAAGATTTGTGTGCCCGAGT,0,1078278
fldAp,0.06666666666666667,14,14,AAACAGACGCCTCCTTGGCA,0,1151277
fldAp,0.06666666666666667,14,14,AAAACGTTTAGATTGCGAAA,0,1067712
fldAp,0.06666666666666667,14,14,AAAAATTCGAAACCACGGAA,0,1154982
fldAp,0.07142857142857142,13,13,TTTTATTTGACGATGCCTAT,0,1175158
fldAp,0.07142857142857142,13,13,TTTGTGTTCTACTAAGCGAC,0,1172651
fldAp,0.07142857142857142,13,13,TTTGTCACCCTGACAAAACT,0,1173309
fldAp,0.07142857142857142,13,13,TTTGTAGAGATTTTTTTTGG,0,1126382
fldAp,0.07142857142857142,13,13,TTTGAATCTTGGCATGGCGC,0,1181822
fldAp,0.07142857142857142,13,13,TTTCTGAACGCCTCTGTGAC,0,1181848
fldAp,0.07142857142857142,13,13,TTTCTCGAGACTTCAGTTGG,0,1108976
fldAp,0.07142857142857142,13,13,TTTCGATGCCGTATCTCTCG,0,1116248
fldAp,0.07142857142857142,13,13,TTTCCGGTTACCGAATTTTC,0,1118511
fldAp,0.07142857142857142,13,13,TTTAGGGTATATGCGCAGTC,0,1068580
fldAp,0.07142857142857142,13,13,TTTACTGGCACTGAGAACGT,0,1104881
fldAp,0.07142857142857142,13,13,TTGGGGATTGTCGAAAAAGC,0,1073674
fldAp,0.07142857142857142,13,13,TTGGACTAGGCATCATTAAC,0,1170312
fldAp,0.07142857142857142,13,13,TTGGAATTGGCGCAGGCAGT,0,1076627
fldAp,0.07142857142857142,13,13,TTGGAAACCGCTCTAGTACG,0,1138131
fldAp,0.07142857142857142,13,13,TTGCTCTGCATCAATACCAG,0,1066563
fldAp,0.07142857142857142,13,13,TTGCGGAGGGGCGCCGTCAG,0,1154740
fldAp,0.07142857142857142,13,13,TTGCCGGACTCGTTAATCAG,0,1180424
fldAp,0.07142857142857142,13,13,TTGCCATCGTGGATCTGCGC,0,1086526
fldAp,0.07142857142857142,13,13,TTGCAAGCGAGTTAGCGACT,0,1113700
fldAp,0.07142857142857142,13,13,TTGAGGGCAGGCCCAAATCT,0,1066101
fldAp,0.07142857142857142,13,13,TTGACTAAACTTTCATTGGT,0,1063755
fldAp,0.07142857142857142,13,13,TTCTGCAGCGGGACACCCAG,0,1157286
fldAp,0.07142857142857142,13,13,TTCTCCATTTTTTAAGCCTA,0,1157470
fldAp,0.07142857142857142,13,13,TTCGGTTGGCCTGAGTGTTT,0,1186019
fldAp,0.07142857142857142,13,13,TTCGCTACCGACTCCCTGAA,0,1146487
fldAp,0.07142857142857142,13,13,TTCGAGAATAATAGTGGTCG,0,1090976
fldAp,0.07142857142857142,13,13,TTCCGTCGAATAGCATAACG,0,1089564
fldAp,0.07142857142857142,13,13,TTCCGTCAAATGTGGTCCCG,0,1174153
fldAp,0.07142857142857142,13,13,TTCCCAGCCTACCGGACAAA,0,1165856
fldAp,0.07142857142857142,13,13,TTCCCACGGGTTCAGGTACC,0,1126400
fldAp,0.07142857142857142,13,13,TTCATAGAGCTAATCGACCG,0,1107883
fldAp,0.07142857142857142,13,13,TTCAGGTACCCGAGGATTGC,0,1124326
fldAp,0.07142857142857142,13,13,TTCACATCCGGACTTCGGGT,0,1158882
fldAp,0.07142857142857142,13,13,TTAGTTTCTCAACTTGCTTT,0,1080886
fldAp,0.07142857142857142,13,13,TTACTCCTGCGAGAACCCTT,0,1108861
fldAp,0.07142857142857142,13,13,TTACGTAGCTCGAACAGGTC,0,1088872
fldAp,0.07142857142857142,13,13,TTACCATAAGGAGTGAGGGA,0,1123466
fldAp,0.07142857142857142,13,13,TTAATCTCATAAGAGGCAGT,0,1101015
fldAp,0.07142857142857142,13,13,TTAACTGCGTACAAATCTGG,0,1097201
fldAp,0.07142857142857142,13,13,TTAAAATTTCATAACTATAA,0,1168886
fldAp,0.07142857142857142,13,13,TTAAAAGATGGTCTATAATA,0,1106801
fldAp,0.07142857142857142,13,13,TGTTTTCGTCCCCATAGGCA,0,1101729
fldAp,0.07142857142857142,13,13,TGTTACTAGCAACCGGGGGA,0,1122254
fldAp,0.07142857142857142,13,13,TGTGCGAACGCATATTAATA,0,1123689
fldAp,0.07142857142857142,13,13,TGTGAGGCGATCGGCTGGGA,0,1174934
fldAp,0.07142857142857142,13,13,TGTCTGGCAGGATTGAGGCA,0,1098399
fldAp,0.07142857142857142,13,13,TGTATCATTACAACTCTAGC,0,1119851
fldAp,0.07142857142857142,13,13,TGGTTTTAGTCGCCAATACT,0,1069682
fldAp,0.07142857142857142,13,13,TGGGTTCAATGGAAGAGGCA,0,1107139
fldAp,0.07142857142857142,13,13,TGGGCGACAACAAGATGCCA,0,1138410
fldAp,0.07142857142857142,13,13,TGGGCAGATCTGGCTTTTCG,0,1146388
fldAp,0.07142857142857142,13,13,TGGGAGGAAGCGCCGGCGAA,0,1152374
fldAp,0.07142857142857142,13,13,TGGCTGCCACCAATTCGAGC,0,1184148
fldAp,0.07142857142857142,13,13,TGGCAATAGTCGGGTCTACA,0,1144286
fldAp,0.07142857142857142,13,13,TGGATATTCCTGTATACGTC,0,1106713
fldAp,0.07142857142857142,13,13,TGGATACATAGATTGGGGGA,0,1161602
fldAp,0.07142857142857142,13,13,TGCTGAGAAGTCGGAGGCAG,0,1134949
fldAp,0.07142857142857142,13,13,TGCTGACAGCATACCCCGGA,0,1102340
fldAp,0.07142857142857142,13,13,TGCGGAACATTAGACGTATA,0,1155157
fldAp,0.07142857142857142,13,13,TGCGATGTTGCACTTGTAGC,0,1078537
fldAp,0.07142857142857142,13,13,TGCAGTTGAAGACTACCTGA,0,1160395
fldAp,0.07142857142857142,13,13,TGATCACTTCTTATATTAGA,0,1165932
fldAp,0.07142857142857142,13,13,TGAGCATAACTGCCTCATTG,0,1160983
fldAp,0.07142857142857142,13,13,TGACTCGGCGATTTAGCTTG,0,1117023
fldAp,0.07142857142857142,13,13,TCTGCGAGGTGGAGTCCCCA,0,1098589
fldAp,0.07142857142857142,13,13,TCTGACAAGCGACTACAAGT,0,1155023
fldAp,0.07142857142857142,13,13,TCTCTTAGTTCTCCGAAGTG,0,1144473
fldAp,0.07142857142857142,13,13,TCTCCTAAAACTAAGCTGAT,0,1091619
fldAp,0.07142857142857142,13,13,TCTATCACATCTTAAGCTCG,0,1175693
fldAp,0.07142857142857142,13,13,TCTAGTTTTCCACCTTGAGC,0,1154627
fldAp,0.07142857142857142,13,13,TCGTTTAGGGCATCGCTCGT,0,1130062
fldAp,0.07142857142857142,13,13,TCGTTAGTGCTGTGTGTTTA,0,1128381
fldAp,0.07142857142857142,13,13,TCGTTAGGGGCCTCGACCGT,0,1174226
fldAp,0.07142857142857142,13,13,TCGTGTAGAAAGGATGTTCA,0,1134480
fldAp,0.07142857142857142,13,13,TCGTCATCAGGGAAAATATG,0,1129430
fldAp,0.07142857142857142,13,13,TCGGTAAAAGAACCGTGTTA,0,1165369
fldAp,0.07142857142857142,13,13,TCGGCATTACACCGTGATTG,0,1163586
fldAp,0.07142857142857142,13,13,TCGACTGCGCACCAGGTTCA,0,1123469
fldAp,0.07142857142857142,13,13,TCCGGTACAAAGCGTCGGCC,0,1111189
fldAp,0.07142857142857142,13,13,TCCCACGCATCGCTATCTAG,0,1090112
fldAp,0.07142857142857142,13,13,TCCATAGCTCAGCAAGTTTA,0,1110005
fldAp,0.07142857142857142,13,13,TCCACAGAGACCCGGCTCGT,0,1125180
fldAp,0.07142857142857142,13,13,TCATGTCGCGTGTATGAACT,0,1097542
fldAp,0.07142857142857142,13,13,TCATGCCTACTCATGTCAAG,0,1089017
fldAp,0.07142857142857142,13,13,TCATCGGCTAAGTTAATTTG,0,1072191
fldAp,0.07142857142857142,13,13,TCAGGAGGCACGTCGGACGC,0,1088996
fldAp,0.07142857142857142,13,13,TCAGCTGATGTGACTTCATA,0,1134926
fldAp,0.07142857142857142,13,13,TCACGGGATTGGTATCATAT,0,1070862
fldAp,0.07142857142857142,13,13,TCACGGCTCGGTAGGAAGGG,0,1095408
fldAp,0.07142857142857142,13,13,TCACATATAAGCTTAAGGTT,0,1166153
fldAp,0.07142857142857142,13,13,TCAATCGAGTGACGCGGTCA,0,1082126
fldAp,0.07142857142857142,13,13,TATTTTTGTAAACTGGTGTA,0,1124480
fldAp,0.07142857142857142,13,13,TATTGACTTCGACAATCCGG,0,1148547
fldAp,0.07142857142857142,13,13,TATTACCCGTAGGGGATTGC,0,1185524
fldAp,0.07142857142857142,13,13,TATGTGAGTTGAGTCGGAGA,0,1161103
fldAp,0.07142857142857142,13,13,TATGAGCTACCATGTCAGTT,0,1142547
fldAp,0.07142857142857142,13,13,TATCTTCGGCTTGGCTCAAT,0,1104371
fldAp,0.07142857142857142,13,13,TATCTAGAGTATTGCTCTTA,0,1090996
fldAp,0.07142857142857142,13,13,TATCGGGACGTGGGGAAGAA,0,1104873
fldAp,0.07142857142857142,13,13,TATCCGAGTAAATCCATCGA,0,1166454
fldAp,0.07142857142857142,13,13,TATAGAGCGATAAGAATCGT,0,1102275
fldAp,0.07142857142857142,13,13,TAGGTGGCAATGACACCACA,0,1087126
fldAp,0.07142857142857142,13,13,TAGGGAACTTTTATGCGTCG,0,1096255
fldAp,0.07142857142857142,13,13,TAGGATTTCCCCAGCCGGAA,0,1080430
fldAp,0.07142857142857142,13,13,TAGCAGTGGACCGTCGCAGG,0,1174043
fldAp,0.07142857142857142,13,13,TACGCGTCTTTCGAAAGGGT,0,1159803
fldAp,0.07142857142857142,13,13,TACCAACCAACGTAATATGA,0,1107769
fldAp,0.07142857142857142,13,13,TACACTTGCCGGTTTATAAA,0,1139831
fldAp,0.07142857142857142,13,13,TAAGTTCAACAACCAGGGCC,0,1171261
fldAp,0.07142857142857142,13,13,TAAGGACCGAACCCCGACAA,0,1105657
fldAp,0.07142857142857142,13,13,TAACTTAATAGTCACAAAGG,0,1071220
fldAp,0.07142857142857142,13,13,TAACTGCTTTAAGTCTATTC,0,1149021
fldAp,0.07142857142857142,13,13,TAACGGGACTTTATAGAGAA,0,1124736
fldAp,0.07142857142857142,13,13,TAACCGCGTGCTCCCTGCAG,0,1145497
fldAp,0.07142857142857142,13,13,TAACCGACTTGCGTGCTCAT,0,1063056
fldAp,0.07142857142857142,13,13,TAACAGGTCCTTTTGCACTC,0,1081029
fldAp,0.07142857142857142,13,13,TAAAGTAGTATCATAGAGAT,0,1097044
fldAp,0.07142857142857142,13,13,TAAAGGGTTGACATAGACAG,0,1168170
fldAp,0.07142857142857142,13,13,TAAACACTGCAACGCCTATC,0,1172864
fldAp,0.07142857142857142,13,13,GTTTGATCTTGGTGCGTTGC,0,1165863
fldAp,0.07142857142857142,13,13,GTTTCGCTTGGTCGAATTAA,0,1147132
fldAp,0.07142857142857142,13,13,GTTGCGGTCCGTCAGGGGCG,0,1140980
fldAp,0.07142857142857142,13,13,GTTGACCTCATTGGTTCTTC,0,1127874
fldAp,0.07142857142857142,13,13,GTTATAGGAGTTAATACGCG,0,1112082
fldAp,0.07142857142857142,13,13,GTTATACGGGGAACAATTAG,0,1153901
fldAp,0.07142857142857142,13,13,GTGTCCAGCTTGCCAGATCT,0,1086109
fldAp,0.07142857142857142,13,13,GTGGTACGTTAAAATCTATA,0,1150392
fldAp,0.07142857142857142,13,13,GTGCTAATATGCCTCGACAG,0,1177291
fldAp,0.07142857142857142,13,13,GTGCGGAACACCTGAGCCCA,0,1096182
fldAp,0.07142857142857142,13,13,GTGCCGAGTGACACTATATC,0,1087441
fldAp,0.07142857142857142,13,13,GTGCCAGTTGACAGAAATTT,0,1145535
fldAp,0.07142857142857142,13,13,GTGACATTCACTCCAGAGGG,0,1105256
fldAp,0.07142857142857142,13,13,GTCTTGTGCCATTATGCTCT,0,1110467
fldAp,0.07142857142857142,13,13,GTCTTATCAGGTCCGAGCCA,0,1069897
fldAp,0.07142857142857142,13,13,GTCTATTGAACATGGTTCTG,0,1098330
fldAp,0.07142857142857142,13,13,GTCGTCCTCTACCCTCGTGG,0,1099479
fldAp,0.07142857142857142,13,13,GTCGCGAAGTAAATCCGGCT,0,1180102
fldAp,0.07142857142857142,13,13,GTCCTCTGGTTGCCGGATGA,0,1167855
fldAp,0.07142857142857142,13,13,GTCCTCACGCCATGTCTTAA,0,1115240
fldAp,0.07142857142857142,13,13,GTCCCTGCCATACGTTACGC,0,1126401
fldAp,0.07142857142857142,13,13,GTCCCAAGGTTCTCACCAAA,0,1130968
fldAp,0.07142857142857142,13,13,GTCAGAGTTTTGGTATGAGA,0,1083424
fldAp,0.07142857142857142,13,13,GTATCGTGTGCCCTGCCGCT,0,1175690
fldAp,0.07142857142857142,13,13,GTATAGTCATAAGGATATGT,0,1065932
fldAp,0.07142857142857142,13,13,GTATAGCGTTATGAAGCCCA,0,1155029
fldAp,0.07142857142857142,13,13,GTAGTGAAATTATCTTCTAA,0,1165795
fldAp,0.07142857142857142,13,13,GTACCACGGCACGGGGGATA,0,1118273
fldAp,0.07142857142857142,13,13,GTACATCCTTGCGTAGTCAG,0,1089815
fldAp,0.07142857142857142,13,13,GTAAGAAAGCGGCATAAATA,0,1146118
fldAp,0.07142857142857142,13,13,GGTTCTCGCACAGATGGAAG,0,1171106
fldAp,0.07142857142857142,13,13,GGTTCGAGATGCGGTTTTAT,0,1074242
fldAp,0.07142857142857142,13,13,GGTGTCTGACGACATGCCTA,0,1142468
fldAp,0.07142857142857142,13,13,GGTGATCCATTGATATTTCG,0,1166251
fldAp,0.07142857142857142,13,13,GGTGAGTTCAGCTGCAACGA,0,1156961
fldAp,0.07142857142857142,13,13,GGTCCTTCATGCTACTGCGC,0,1077468
fldAp,0.07142857142857142,13,13,GGTCCTGTATCAGTGGTGAT,0,1143446
fldAp,0.07142857142857142,13,13,GGTCCGGAAACAATGAGACT,0,1166985
fldAp,0.07142857142857142,13,13,GGTATGACTTGAAATATGTT,0,1126454
fldAp,0.07142857142857142,13,13,GGTAGGCCCCATGTGGTTGA,0,1117461
fldAp,0.07142857142857142,13,13,GGTACGGCCGGATTAAAGTA,0,1070412
fldAp,0.07142857142857142,13,13,GGGTTTAGAAACGTACTGGA,0,1088514
fldAp,0.07142857142857142,13,13,GGGTTGTCCCGGAAAACGGT,0,1092698
fldAp,0.07142857142857142,13,13,GGGTTAGGCTTGCGGCAAAT,0,1137340
fldAp,0.07142857142857142,13,13,GGGTAGGGGGCGAAGACGAA,0,1063374
fldAp,0.07142857142857142,13,13,GGGGGTCCTACAATGCGAGG,0,1153539
fldAp,0.07142857142857142,13,13,GGGGGGCCGCAGAGCTTCTT,0,1118766
fldAp,0.07142857142857142,13,13,GGGGACAGTAGCAGGTTGGA,0,1154425
fldAp,0.07142857142857142,13,13,GGGCTAGGTCATACTAGCTG,0,1147243
fldAp,0.07142857142857142,13,13,GGGCAAAGGCTGAAGATCGT,0,1105579
fldAp,0.07142857142857142,13,13,GGCTGTGCGATATAAAGTGA,0,1155353
fldAp,0.07142857142857142,13,13,GGCTCGGGATGGAGTAGTGA,0,1171491
fldAp,0.07142857142857142,13,13,GGCTCACGGTTCCATCGCAT,0,1122986
fldAp,0.07142857142857142,13,13,GGCTCAATTCAACACTGTAC,0,1163570
fldAp,0.07142857142857142,13,13,GGCGGGTTGTTGGTACTAAG,0,1145974
fldAp,0.07142857142857142,13,13,GGCGCGCGTGGCGGCAGCCT,0,1074646
fldAp,0.07142857142857142,13,13,GGCCTTTTTAAGTAGTTGAT,0,1080293
fldAp,0.07142857142857142,13,13,GGCCTTTCCAAGGATTCGCC,0,1111651
fldAp,0.07142857142857142,13,13,GGCCTCGTCAGGGAGGACGG,0,1096160
fldAp,0.07142857142857142,13,13,GGCCCATATCCACTTTCCAA,0,1162121
fldAp,0.07142857142857142,13,13,GGCCAGTTGTAAGCGCTTAT,0,1078485
fldAp,0.07142857142857142,13,13,GGCACCAAAGATCCGCCCAC,0,1112349
fldAp,0.07142857142857142,13,13,GGCAAGCAGTGGAGAGGGTC,0,1084872
fldAp,0.07142857142857142,13,13,GGATGCTGAGTTGGTGGAGA,0,1090847
fldAp,0.07142857142857142,13,13,GGATGATTCTTCATATTTTT,0,1120004
fldAp,0.07142857142857142,13,13,GGATATACGCTCCTTTGTAA,0,1096215
fldAp,0.07142857142857142,13,13,GGAGTGGTTACTCTTAGTGT,0,1151871
fldAp,0.07142857142857142,13,13,GGAGTAGTCAGCCTTCTACA,0,1114690
fldAp,0.07142857142857142,13,13,GGACGGCAGCAATAGAGTAA,0,1162943
fldAp,0.07142857142857142,13,13,GGACAGGACGTGAGTTGGTA,0,1072030
fldAp,0.07142857142857142,13,13,GGAATATAGAGTCTACCTGG,0,1170397
fldAp,0.07142857142857142,13,13,GGAAGGATCCCCGGCATTGA,0,1131450
fldAp,0.07142857142857142,13,13,GGAACAATAGGACCCCTGAT,0,1153076
fldAp,0.07142857142857142,13,13,GGAAAAAGTCTGGTTCCTGA,0,1118718
fldAp,0.07142857142857142,13,13,GCTGCTTGTCCCCGTGTATT,0,1133765
fldAp,0.07142857142857142,13,13,GCTGACACGCATCAGGGCTT,0,1167513
fldAp,0.07142857142857142,13,13,GCTCGACAGCCTTCTATTGC,0,1120939
fldAp,0.07142857142857142,13,13,GCTCGAACTGACCCCTCCAC,0,1065073
fldAp,0.07142857142857142,13,13,GCTCAGCCTAGAAACCGCTC,0,1186975
fldAp,0.07142857142857142,13,13,GCTCAAGGGGCAGCTGGGGA,0,1063932
fldAp,0.07142857142857142,13,13,GCGTCTTGGACCAATGCATT,0,1094179
fldAp,0.07142857142857142,13,13,GCGTCTAGCTCTCAGGATAC,0,1117738
fldAp,0.07142857142857142,13,13,GCGTCGTCTACCAAAACAGA,0,1172314
fldAp,0.07142857142857142,13,13,GCGTCCTCGAAGCACGCGGG,0,1131557
fldAp,0.07142857142857142,13,13,GCGTCCACTCAATCATAAGG,0,1123717
fldAp,0.07142857142857142,13,13,GCGGGACTTCAAGAGTTTAC,0,1080802
fldAp,0.07142857142857142,13,13,GCGGATATCGCTACGGAAGA,0,1121461
fldAp,0.07142857142857142,13,13,GCGCTTCAACTTCGGGAGAT,0,1098715
fldAp,0.07142857142857142,13,13,GCGCGGACGGGCCGCACCTG,0,1132025
fldAp,0.07142857142857142,13,13,GCGCGCGGCTGCATTTGTTA,0,1071523
fldAp,0.07142857142857142,13,13,GCGCATTGAGGCGTTCGGAG,0,1165684
fldAp,0.07142857142857142,13,13,GCGAGCACGAGTATTAACTA,0,1093957
fldAp,0.07142857142857142,13,13,GCGACTGAGGACTCGGGGGG,0,1175460
fldAp,0.07142857142857142,13,13,GCGACGCCCCGAGCGTGGGA,0,1067733
fldAp,0.07142857142857142,13,13,GCCTGGCCCTGGTATGGTCA,0,1140020
fldAp,0.07142857142857142,13,13,GCCTCGTTGCTGTATATGCG,0,1136254
fldAp,0.07142857142857142,13,13,GCCTCATGGCAAGACTTTTT,0,1093867
fldAp,0.07142857142857142,13,13,GCCGTACGGTGCACTAGAAG,0,1107435
fldAp,0.07142857142857142,13,13,GCCGAATTAATGACGTAGCT,0,1105733
fldAp,0.07142857142857142,13,13,GCCCTCGATGGGACTGGCTA,0,1132262
fldAp,0.07142857142857142,13,13,GCCCCGAGGTTAGTCCTCTA,0,1094159
fldAp,0.07142857142857142,13,13,GCCAGCCTCTTTCCCGAACA,0,1104394
fldAp,0.07142857142857142,13,13,GCCAATTAAAGTTAACGGGA,0,1143201
fldAp,0.07142857142857142,13,13,GCATTTCTGAGGCGTCTCCT,0,1089570
fldAp,0.07142857142857142,13,13,GCATTGCGCATGCCCGCGGG,0,1185000
fldAp,0.07142857142857142,13,13,GCACTGTCATCACCCGGAAG,0,1139000
fldAp,0.07142857142857142,13,13,GCACCAATAAGTGAACTATA,0,1147246
fldAp,0.07142857142857142,13,13,GCACATAGTGGCTGTAATAT,0,1123958
fldAp,0.07142857142857142,13,13,GCACATAGCTAACTGAGTTA,0,1108238
fldAp,0.07142857142857142,13,13,GCACAGCTCGCCGGGCTATA,0,1081936
fldAp,0.07142857142857142,13,13,GCAACCCCCGTAAGGTGAAA,0,1165168
fldAp,0.07142857142857142,13,13,GATTTGTCCATTCAGTTCCG,0,1094578
fldAp,0.07142857142857142,13,13,GATTCCTATGTCAGGAAAGC,0,1136840
fldAp,0.07142857142857142,13,13,GATTAAAGCCAAGCGGCAAC,0,1143281
fldAp,0.07142857142857142,13,13,GATGTGGATCTATAGAGTAA,0,1079996
fldAp,0.07142857142857142,13,13,GATGGCTATTTACTATGTAT,0,1141122
fldAp,0.07142857142857142,13,13,GATCTACCTCTTGTTGGGCT,0,1180113
fldAp,0.07142857142857142,13,13,GAGTTGCTACGCCGCCCAAA,0,1112860
fldAp,0.07142857142857142,13,13,GAGGTTCAGTGACTGATATA,0,1069773
fldAp,0.07142857142857142,13,13,GAGGACACATGGTTAGGAGT,0,1065271
fldAp,0.07142857142857142,13,13,GAGCCTCCGCCCGTTCAATC,0,1081582
fldAp,0.07142857142857142,13,13,GAGATAGTCGGACTGCAACG,0,1146392
fldAp,0.07142857142857142,13,13,GAGACTGATCGAGTGAAGTT,0,1138836
fldAp,0.07142857142857142,13,13,GAGACCAACGTTGCCTATAC,0,1071156
fldAp,0.07142857142857142,13,13,GACGTAATCTGGGTCGCACT,0,1144237
fldAp,0.07142857142857142,13,13,GACGAGGAAATGTTCTTAAA,0,1150403
fldAp,0.07142857142857142,13,13,GACATTTTGTAGCCTTGCAT,0,1156862
fldAp,0.07142857142857142,13,13,GAAGGTGCGGGGCAACATCG,0,1150082
fldAp,0.07142857142857142,13,13,GAAGGAGAGAGGTACCCCGT,0,1155972
fldAp,0.07142857142857142,13,13,GAAGATGTGGTCATTTGAAG,0,1128021
fldAp,0.07142857142857142,13,13,GAACACATATCCATTATGGG,0,1088327
fldAp,0.07142857142857142,13,13,GAAATCGGCTAATAGGGGCG,0,1110672
fldAp,0.07142857142857142,13,13,CTTTTTAGCGGGAACTTGAG,0,1158551
fldAp,0.07142857142857142,13,13,CTTTCTGGGGCACATTTACA,0,1104880
fldAp,0.07142857142857142,13,13,CTTTATGTGGCCGGCCTCTT,0,1155506
fldAp,0.07142857142857142,13,13,CTTGTACCGAAAATAGAAGA,0,1174877
fldAp,0.07142857142857142,13,13,CTTGCGCAGCAGTGAATAGG,0,1175357
fldAp,0.07142857142857142,13,13,CTTGCAGGACTCACGCCATC,0,1131213
fldAp,0.07142857142857142,13,13,CTTCCCTATACTCTATTCGG,0,1180927
fldAp,0.07142857142857142,13,13,CTGGGCTGCAATCGCAACAG,0,1079307
fldAp,0.07142857142857142,13,13,CTGCTAACGTGCGCTGGTTT,0,1169147
fldAp,0.07142857142857142,13,13,CTGCGGCAATGCGAGATTTT,0,1181286
fldAp,0.07142857142857142,13,13,CTGCACGCATTATTTAATTA,0,1089943
fldAp,0.07142857142857142,13,13,CTGATTCTTGGGAGGTGTGG,0,1129097
fldAp,0.07142857142857142,13,13,CTGATATCCTAATCCAATTG,0,1075068
fldAp,0.07142857142857142,13,13,CTGACTCGAGGTCGCGGACT,0,1130205
fldAp,0.07142857142857142,13,13,CTGAAGTCTCGAACAGTCCT,0,1064610
fldAp,0.07142857142857142,13,13,CTCCCGGCCACACCAAAGCT,0,1080779
fldAp,0.07142857142857142,13,13,CTCATACGCCACTGACTGTG,0,1109533
fldAp,0.07142857142857142,13,13,CTCAAACCACCCTAAGGGCG,0,1140016
fldAp,0.07142857142857142,13,13,CTATCAGCGTCTAGGGTACA,0,1149639
fldAp,0.07142857142857142,13,13,CTATAATTTGGGCGGCGTCC,0,1135579
fldAp,0.07142857142857142,13,13,CTAGAGCCCAATCTTCCTCA,0,1106831
fldAp,0.07142857142857142,13,13,CTACCCAGCCTGCGTGATGA,0,1173939
fldAp,0.07142857142857142,13,13,CTACCAATATGGCCTAGCGG,0,1098574
fldAp,0.07142857142857142,13,13,CTAAACTAAAATTGCGTTGC,0,1085298
fldAp,0.07142857142857142,13,13,CTAAAATGTATGGTCTACGT,0,1166284
fldAp,0.07142857142857142,13,13,CGTTGTCCCTGTTCGAGGCA,0,1144099
fldAp,0.07142857142857142,13,13,CGTTCATAAGGGCTTAAGGA,0,1121004
fldAp,0.07142857142857142,13,13,CGTGTTAGTTTTACTACCCA,0,1075007
fldAp,0.07142857142857142,13,13,CGTGATATCTATCCCTAGGC,0,1152527
fldAp,0.07142857142857142,13,13,CGTCGCTCTTTAGCCTTCGA,0,1071743
fldAp,0.07142857142857142,13,13,CGTAATCAGTCATCCTGGGA,0,1186210
fldAp,0.07142857142857142,13,13,CGGTTTTGTCTCGATTCAAA,0,1102976
fldAp,0.07142857142857142,13,13,CGGTGGTTGCCGCGTTAGAC,0,1099723
fldAp,0.07142857142857142,13,13,CGGTAGATTTACTATGATAA,0,1074223
fldAp,0.07142857142857142,13,13,CGGTAGACTCCTAAATTTAC,0,1084279
fldAp,0.07142857142857142,13,13,CGGTAGAAAGGATCCACCAT,0,1158083
fldAp,0.07142857142857142,13,13,CGGGTATCGCTCCGACCTAG,0,1172486
fldAp,0.07142857142857142,13,13,CGGGTACCTAGGAGTAAGAC,0,1160047
fldAp,0.07142857142857142,13,13,CGGGGGCGTGGTAATAATTG,0,1133189
fldAp,0.07142857142857142,13,13,CGGGGAGGTGCGGCTTCAAC,0,1144319
fldAp,0.07142857142857142,13,13,CGGGCGACCTTTCGAAAACA,0,1167517
fldAp,0.07142857142857142,13,13,CGGCAGTCGGCCAACGCTGT,0,1096278
fldAp,0.07142857142857142,13,13,CGGCACGCATTTCGGGTGAC,0,1074453
fldAp,0.07142857142857142,13,13,CGGATCTACGACGTCAGGCC,0,1072627
fldAp,0.07142857142857142,13,13,CGGACGAACTAGGCGTAGAC,0,1096716
fldAp,0.07142857142857142,13,13,CGGAAATCTAGCCGGGTGCA,0,1099849
fldAp,0.07142857142857142,13,13,CGCTTCAGCAAAACAGTGAA,0,1148490
fldAp,0.07142857142857142,13,13,CGCGGGGGGCTGCCTTCCAT,0,1065109
fldAp,0.07142857142857142,13,13,CGCCAGCTGTATTGCGGATC,0,1109800
fldAp,0.07142857142857142,13,13,CGCATTGTTTATCCCAAGAA,0,1118892
fldAp,0.07142857142857142,13,13,CGCAAGTAAGCGCCGCTACT,0,1126621
fldAp,0.07142857142857142,13,13,CGATTAATGCTTTCTTTATC,0,1158245
fldAp,0.07142857142857142,13,13,CGATGATATACTGTTTCAAG,0,1098203
fldAp,0.07142857142857142,13,13,CGATCGCCAGGGATGGCTCA,0,1176337
fldAp,0.07142857142857142,13,13,CGAGTATTTTGCGCCTCGAC,0,1157839
fldAp,0.07142857142857142,13,13,CGAGCAACCGTGGTTAATAT,0,1153016
fldAp,0.07142857142857142,13,13,CGAAAGGTGAACAATTATTA,0,1123635
fldAp,0.07142857142857142,13,13,CGAAACAGAGGCTCACGTTG,0,1116099
fldAp,0.07142857142857142,13,13,CCTTTTGTTCGGGACCTTGT,0,1164887
fldAp,0.07142857142857142,13,13,CCTTGACGTATTATCAGAAC,0,1129240
fldAp,0.07142857142857142,13,13,CCTTCGCGTTGGTAGGTTTC,0,1086645
fldAp,0.07142857142857142,13,13,CCTGGGCCTCATGTTATTTT,0,1089565
fldAp,0.07142857142857142,13,13,CCTCGTGAGAGCAAGTCCCC,0,1148700
fldAp,0.07142857142857142,13,13,CCTCCGTTGGTCCTGCGTGG,0,1088400
fldAp,0.07142857142857142,13,13,CCTAGTCATCCATCTAGTGT,0,1138615
fldAp,0.07142857142857142,13,13,CCTACGGTTTGCGCTGACGG,0,1095524
fldAp,0.07142857142857142,13,13,CCTAAAATTCGGCGATGGTG,0,1122135
fldAp,0.07142857142857142,13,13,CCGTGATAGTAGCATCTACT,0,1089134
fldAp,0.07142857142857142,13,13,CCGTGAGCGTGGGCCTATAT,0,1109787
fldAp,0.07142857142857142,13,13,CCGTATAATCAGAAACAATT,0,1157698
fldAp,0.07142857142857142,13,13,CCGCGGTTTACGGATATAAG,0,1090589
fldAp,0.07142857142857142,13,13,CCGCATAGAGGCGGGTCAAC,0,1140255
fldAp,0.07142857142857142,13,13,CCGATCACAGTACGCAAAAC,0,1085011
fldAp,0.07142857142857142,13,13,CCCTTTGGCGCGTATCATTT,0,1163614
fldAp,0.07142857142857142,13,13,CCCTTTACAATACTGGTATA,0,1065221
fldAp,0.07142857142857142,13,13,CCCTGTGACTAACGAGAGTA,0,1150832
fldAp,0.07142857142857142,13,13,CCCTGTCGTGATAGGGTGCT,0,1120327
fldAp,0.07142857142857142,13,13,CCCTGATGCGCCCAGTCGAG,0,1066981
fldAp,0.07142857142857142,13,13,CCCTCGTCCCCACGTATGTC,0,1128028
fldAp,0.07142857142857142,13,13,CCCTCACTGTATGCGCCGCA,0,1116368
fldAp,0.07142857142857142,13,13,CCCGGGCACCCGAGCCTTGA,0,1127092
fldAp,0.07142857142857142,13,13,CCCGAGAGGGCAGTGTACAA,0,1069324
fldAp,0.07142857142857142,13,13,CCCCCGTGATTAGCCCCTGA,0,1105308
fldAp,0.07142857142857142,13,13,CCCAGTAGCTGGGGAGTTGC,0,1146992
fldAp,0.07142857142857142,13,13,CCCACACGTCCCTAAAATAG,0,1125972
fldAp,0.07142857142857142,13,13,CCATTCCTTACAGACTAAAC,0,1131452
fldAp,0.07142857142857142,13,13,CCATGCATTTCTATCACTGA,0,1125993
fldAp,0.07142857142857142,13,13,CCATATTATAACCAGCGCTG,0,1143375
fldAp,0.07142857142857142,13,13,CCACTGACAGGTGACACTAT,0,1086172
fldAp,0.07142857142857142,13,13,CCACCAGTCTATAACGGCTA,0,1085922
fldAp,0.07142857142857142,13,13,CCAACTATTATAGCCCCAAA,0,1129359
fldAp,0.07142857142857142,13,13,CATTTTTCGGCATGAAACTA,0,1063758
fldAp,0.07142857142857142,13,13,CATTTTCTTGCCAGGGGTCG,0,1120850
fldAp,0.07142857142857142,13,13,CATGTTTTCGTTCCAGCGGA,0,1108863
fldAp,0.07142857142857142,13,13,CATGGCTGATGGGTATAACG,0,1086538
fldAp,0.07142857142857142,13,13,CATGCCCACCCCTCGATCTC,0,1069025
fldAp,0.07142857142857142,13,13,CATGCAGCACCGTCAGGTGT,0,1145549
fldAp,0.07142857142857142,13,13,CATCTGGCCCGATGTGTAGA,0,1140461
fldAp,0.07142857142857142,13,13,CATAGCCGGTCGTGGTTCTA,0,1081046
fldAp,0.07142857142857142,13,13,CATAATGGTAGTGTCACACA,0,1146857
fldAp,0.07142857142857142,13,13,CAGTTCGTTTTTGAGTTAGT,0,1167561
fldAp,0.07142857142857142,13,13,CAGGTGAGAAAAAGGAGGTT,0,1094127
fldAp,0.07142857142857142,13,13,CAGGGCGGACATCTCTGGAA,0,1162450
fldAp,0.07142857142857142,13,13,CAGGCGTCGTTATACAGAAC,0,1148561
fldAp,0.07142857142857142,13,13,CAGGCCAGCGTACCTTCTTC,0,1111222
fldAp,0.07142857142857142,13,13,CAGGACGATTACGTCCAAGA,0,1169363
fldAp,0.07142857142857142,13,13,CAGGAAACATCATCTGAGTT,0,1182156
fldAp,0.07142857142857142,13,13,CAGCTGATAAAGTGGTGCAA,0,1085416
fldAp,0.07142857142857142,13,13,CAGCTCCGATTTCGTATGGT,0,1099476
fldAp,0.07142857142857142,13,13,CAGCCGGCGAACGCCCGTTT,0,1072966
fldAp,0.07142857142857142,13,13,CACTTGGCATGGTGCGACCA,0,1132440
fldAp,0.07142857142857142,13,13,CACTCCTGGGATACAGGGTA,0,1156743
fldAp,0.07142857142857142,13,13,CACTATCCGAGCAGTGTCCG,0,1099559
fldAp,0.07142857142857142,13,13,CACGTCGGAGATATTGTCCA,0,1157713
fldAp,0.07142857142857142,13,13,CACGATGGGATCAATCCCGA,0,1127122
fldAp,0.07142857142857142,13,13,CACCGCCCATTTCGGGACAT,0,1101118
fldAp,0.07142857142857142,13,13,CACCCGAGGTACGTGGCGAA,0,1120721
fldAp,0.07142857142857142,13,13,CACCCGAGGGCATGTGTCAG,0,1161019
fldAp,0.07142857142857142,13,13,CACATGGCCCTGACATCAGA,0,1070075
fldAp,0.07142857142857142,13,13,CACAGGAGTTTTCTGGCATA,0,1156356
fldAp,0.07142857142857142,13,13,CACACTTATATGACCTAAAT,0,1128350
fldAp,0.07142857142857142,13,13,CAAGTTGGTCGCAGGGATCA,0,1180117
fldAp,0.07142857142857142,13,13,CAAGGATCTACACAAGTTCG,0,1127844
fldAp,0.07142857142857142,13,13,CAACTTGCCCCACATAGTTA,0,1077032
fldAp,0.07142857142857142,13,13,CAACGTGCGGTTGGTACCGT,0,1124648
fldAp,0.07142857142857142,13,13,CAACGGCCCAGGATAATGTT,0,1099618
fldAp,0.07142857142857142,13,13,CAACCGTCTAGCGGGTCGTA,0,1067494
fldAp,0.07142857142857142,13,13,CAACAGCCAGAGTTATGTCG,0,1102977
fldAp,0.07142857142857142,13,13,CAACAGAGAAGTTACATATA,0,1081065
fldAp,0.07142857142857142,13,13,CAAAGGCCTGTTACAAGGCG,0,1118260
fldAp,0.07142857142857142,13,13,ATTTGACACTCTCTTTACTC,0,1158038
fldAp,0.07142857142857142,13,13,ATTTCGTCACTCTATCGAGA,0,1103233
fldAp,0.07142857142857142,13,13,ATTTCGTACAGAGACGCTGC,0,1140775
fldAp,0.07142857142857142,13,13,ATTACTGGTTCCACAAGGCA,0,1135638
fldAp,0.07142857142857142,13,13,ATTACGTACACCGGCTCATA,0,1123291
fldAp,0.07142857142857142,13,13,ATGTTTCCTCTGCGGGTTAT,0,1113889
fldAp,0.07142857142857142,13,13,ATGTGAACTTAATTCGACAA,0,1175921
fldAp,0.07142857142857142,13,13,ATGTCGAAATAGTAAGGGTA,0,1137332
fldAp,0.07142857142857142,13,13,ATGTCCGAGGGGAAAGTTCC,0,1133852
fldAp,0.07142857142857142,13,13,ATGTATCCGGATGTTAAAAT,0,1120847
fldAp,0.07142857142857142,13,13,ATGCTGTCGTGCCCCGTGAA,0,1092017
fldAp,0.07142857142857142,13,13,ATGCTACGGACGGGTATCGG,0,1146241
fldAp,0.07142857142857142,13,13,ATGCGAGAGAGCGCGCATCA,0,1135218
fldAp,0.07142857142857142,13,13,ATGCCCATGGGTAACTATAA,0,1114478
fldAp,0.07142857142857142,13,13,ATGCAGGTATTCAAGCAGCT,0,1085876
fldAp,0.07142857142857142,13,13,ATGATGTGAGAACCCGTCTA,0,1073261
fldAp,0.07142857142857142,13,13,ATGATATGTGAACGCATGTT,0,1077526
fldAp,0.07142857142857142,13,13,ATGATAGACTTCATCCGGAC,0,1069017
fldAp,0.07142857142857142,13,13,ATCTGTACATCGTTGCATAC,0,1152658
fldAp,0.07142857142857142,13,13,ATCTACGGGTTTTGCTGGTG,0,1080681
fldAp,0.07142857142857142,13,13,ATCGTTAGTTACGTTGCCTG,0,1171460
fldAp,0.07142857142857142,13,13,ATCGGCACGACACCAGATGC,0,1105412
fldAp,0.07142857142857142,13,13,ATCGATCGCTCAAAGGCTCG,0,1130343
fldAp,0.07142857142857142,13,13,ATCCCTGACTTGGTTTTCGG,0,1104066
fldAp,0.07142857142857142,13,13,ATAGTCTATAAATCATATGG,0,1182111
fldAp,0.07142857142857142,13,13,ATAGTCCAGGTTACAGAGGC,0,1118245
fldAp,0.07142857142857142,13,13,ATAGCTACTGTGTTTACGCC,0,1109826
fldAp,0.07142857142857142,13,13,ATACGACACGTTCGATAAGG,0,1107394
fldAp,0.07142857142857142,13,13,ATACACGCCAATAACATTTG,0,1117519
fldAp,0.07142857142857142,13,13,ATAAGGGATCAGCTACTGGC,0,1177288
fldAp,0.07142857142857142,13,13,ATAAGCAGATTGAGTCAGCA,0,1101770
fldAp,0.07142857142857142,13,13,AGTTGTATCGGCGAGTATGA,0,1148896
fldAp,0.07142857142857142,13,13,AGTTGGACGACACAGATCAA,0,1182923
fldAp,0.07142857142857142,13,13,AGTGTTTATTTCCTTGCACC,0,1158257
fldAp,0.07142857142857142,13,13,AGTGTCTACAGAGGTGATGT,0,1115175
fldAp,0.07142857142857142,13,13,AGTCTTTGATGGTATCTGCA,0,1113572
fldAp,0.07142857142857142,13,13,AGTCAGTAGATAATTATAGG,0,1121001
fldAp,0.07142857142857142,13,13,AGTATTGGCAAAGGTTGTGC,0,1139339
fldAp,0.07142857142857142,13,13,AGTATTCTGGATCCTATGGC,0,1125964
fldAp,0.07142857142857142,13,13,AGGTTGGACCCGTCAGAGTT,0,1152752
fldAp,0.07142857142857142,13,13,AGGTTGAAGGCCAGATCGGG,0,1127536
fldAp,0.07142857142857142,13,13,AGGTGTCGCTGAGCGTTTGC,0,1082398
fldAp,0.07142857142857142,13,13,AGGGTTTACATCTAGCCTTG,0,1104483
fldAp,0.07142857142857142,13,13,AGGGTATCATAACCGAGGGA,0,1143738
fldAp,0.07142857142857142,13,13,AGGGGGCCTCGAGGGTAGAA,0,1178183
fldAp,0.07142857142857142,13,13,AGGGGATGCCCATTGCCTTA,0,1182767
fldAp,0.07142857142857142,13,13,AGGGCTGGACACGGAAGTTT,0,1141101
fldAp,0.07142857142857142,13,13,AGGGCATGTTCACTGGCCAC,0,1161837
fldAp,0.07142857142857142,13,13,AGGCTTCATGTGCAACGGGT,0,1064175
fldAp,0.07142857142857142,13,13,AGGCGGTACTCAGCCAGTGG,0,1144766
fldAp,0.07142857142857142,13,13,AGGCAAACCCTGAACTTTGT,0,1166990
fldAp,0.07142857142857142,13,13,AGGAGACAACTAGACTCAGT,0,1180086
fldAp,0.07142857142857142,13,13,AGGAAAGGACCCTTCTGCAA,0,1142966
fldAp,0.07142857142857142,13,13,AGCGGCGTGCTAACCGGCTG,0,1092023
fldAp,0.07142857142857142,13,13,AGCGCCCCCGAAGGCTACGT,0,1178539
fldAp,0.07142857142857142,13,13,AGCCTTCAGTAAAGATTCGC,0,1170581
fldAp,0.07142857142857142,13,13,AGCCTTACTGTTGTCAACAT,0,1130651
fldAp,0.07142857142857142,13,13,AGCCTCATCAACTGTAATGC,0,1137145
fldAp,0.07142857142857142,13,13,AGCCGAGCACCCAATCCCGC,0,1163577
fldAp,0.07142857142857142,13,13,AGCCACCAATCGACCACTTT,0,1134244
fldAp,0.07142857142857142,13,13,AGCACCTCGCTAGTGGCATA,0,1116691
fldAp,0.07142857142857142,13,13,AGATATATGGCTCCATGCAT,0,1136898
fldAp,0.07142857142857142,13,13,AGAGAAGTCCTAGTCCCAGT,0,1153896
fldAp,0.07142857142857142,13,13,AGACCCGGTGGGATGGTGTA,0,1084961
fldAp,0.07142857142857142,13,13,AGACCAGGCGAGGTCACTAC,0,1063386
fldAp,0.07142857142857142,13,13,AGACCAAACTTCGCATCGCC,0,1081030
fldAp,0.07142857142857142,13,13,AGACAGTCAACCCCTAGAGT,0,1136664
fldAp,0.07142857142857142,13,13,AGAATTGGTAAGCGATGAGC,0,1091166
fldAp,0.07142857142857142,13,13,ACTTGCAGACCAGCATTGGC,0,1075603
fldAp,0.07142857142857142,13,13,ACTTCACCTCCAATGATCCT,0,1162226
fldAp,0.07142857142857142,13,13,ACTGTCAGCGGTGTACAGCG,0,1178809
fldAp,0.07142857142857142,13,13,ACTGTCACACTCGCCTAATC,0,1086638
fldAp,0.07142857142857142,13,13,ACTGGGTACGGTACGCGGTT,0,1168768
fldAp,0.07142857142857142,13,13,ACTGGCCAACGATGCGCTAT,0,1116844
fldAp,0.07142857142857142,13,13,ACTCTTTTGGCTTGTGATTC,0,1101731
fldAp,0.07142857142857142,13,13,ACGTTCTGGCGGTACCCGCG,0,1115022
fldAp,0.07142857142857142,13,13,ACGTTCCTCATCCGTCCGCA,0,1125787
fldAp,0.07142857142857142,13,13,ACGTGCGCTGTTTGAATGCA,0,1065653
fldAp,0.07142857142857142,13,13,ACGTCCTCTGGGCAGGTGTA,0,1155922
fldAp,0.07142857142857142,13,13,ACGTACAGCGCGTATCTATC,0,1104715
fldAp,0.07142857142857142,13,13,ACGCTATGGTGGTTCCCTTC,0,1161175
fldAp,0.07142857142857142,13,13,ACGCTAGGAGTTGTATGCGT,0,1121635
fldAp,0.07142857142857142,13,13,ACGCGACTCGCAACAGGCTC,0,1104181
fldAp,0.07142857142857142,13,13,ACGAATATCACCCGCATAAC,0,1182591
fldAp,0.07142857142857142,13,13,ACCCTCAGGGGAAAGCGACC,0,1142743
fldAp,0.07142857142857142,13,13,ACCCCGCAAGGGGATACGGG,0,1135418
fldAp,0.07142857142857142,13,13,ACCAGTCTAATTAGCGGATA,0,1138323
fldAp,0.07142857142857142,13,13,ACCAAGGAGATTTCGAAAGT,0,1069970
fldAp,0.07142857142857142,13,13,ACATTCTGGGCGTACCGTCC,0,1164893
fldAp,0.07142857142857142,13,13,ACAGTGTGTCGTTCTGTACA,0,1075876
fldAp,0.07142857142857142,13,13,ACAGTCAGGATCTGCCCGAT,0,1078153
fldAp,0.07142857142857142,13,13,ACAGAAACCAGTTGTTGAAG,0,1169374
fldAp,0.07142857142857142,13,13,ACACTCTGCACGTTAGGTCA,0,1140470
fldAp,0.07142857142857142,13,13,ACACTCTCTCCAGAGTCGAG,0,1145894
fldAp,0.07142857142857142,13,13,ACACAAATTAACCTGGCCCA,0,1166738
fldAp,0.07142857142857142,13,13,ACAACCGAATCAGCCGTGGT,0,1150039
fldAp,0.07142857142857142,13,13,ACAACCCAATTTAGCAGAGG,0,1103874
fldAp,0.07142857142857142,13,13,AATTAGGGCGTAATCGCTTA,0,1091237
fldAp,0.07142857142857142,13,13,AATTAATTGCTTGAGCCGTC,0,1095911
fldAp,0.07142857142857142,13,13,AATGGCATCCTTCCGGGTAT,0,1074730
fldAp,0.07142857142857142,13,13,AATGGAGGCTATACCCGGAA,0,1158903
fldAp,0.07142857142857142,13,13,AATCGGATTCATAAGGATTT,0,1169049
fldAp,0.07142857142857142,13,13,AATATCGTGTGTATAATACT,0,1141985
fldAp,0.07142857142857142,13,13,AATAACTCATCCTCACCTAG,0,1158098
fldAp,0.07142857142857142,13,13,AATAAACACTAAGCCCAAGA,0,1130313
fldAp,0.07142857142857142,13,13,AATAAAAACGCTTATGCAGT,0,1101641
fldAp,0.07142857142857142,13,13,AAGTCTGATCGGAAGGAGAC,0,1097266
fldAp,0.07142857142857142,13,13,AAGTCACGAATTGGGGTAAA,0,1174070
fldAp,0.07142857142857142,13,13,AAGGTCGAGGCAGAGGCATA,0,1119309
fldAp,0.07142857142857142,13,13,AAGGGTCACAAGCATTCCCA,0,1152588
fldAp,0.07142857142857142,13,13,AAGGCTGTGGGGATGTCGAT,0,1108274
fldAp,0.07142857142857142,13,13,AAGGACCGATCACAAGGCCT,0,1174923
fldAp,0.07142857142857142,13,13,AAGCGACGGAGGAAAGCAGA,0,1102672
fldAp,0.07142857142857142,13,13,AAGCCGTGTTTGTGCAAATT,0,1082780
fldAp,0.07142857142857142,13,13,AAGCATATAACAATGGAGTT,0,1134832
fldAp,0.07142857142857142,13,13,AAGACAAAAAACGAAAGACT,0,1116252
fldAp,0.07142857142857142,13,13,AACTCGACTCCGGTGGATAT,0,1116779
fldAp,0.07142857142857142,13,13,AACTAGGCGTGTATCTAGAG,0,1178290
fldAp,0.07142857142857142,13,13,AACGTGCTGCACACTGACCA,0,1156863
fldAp,0.07142857142857142,13,13,AACGCCAAGCTCACCCGCTA,0,1169413
fldAp,0.07142857142857142,13,13,AACGCAAGCACTATAGGCCA,0,1089109
fldAp,0.07142857142857142,13,13,AACCTTCCAGGATATCGTTG,0,1119813
fldAp,0.07142857142857142,13,13,AACAGAACGTGGGTCGCCTA,0,1096708
fldAp,0.07142857142857142,13,13,AACACCATTCCGGAGCCGCG,0,1140474
fldAp,0.07142857142857142,13,13,AAATTACGGTTGTGAGTGTT,0,1155571
fldAp,0.07142857142857142,13,13,AAATGGGGGCTTGCGTCCCA,0,1070091
fldAp,0.07142857142857142,13,13,AAATCGGATCTGGATGTTGG,0,1129254
fldAp,0.07142857142857142,13,13,AAATCGCCTGCCGGTACGCT,0,1149463
fldAp,0.07142857142857142,13,13,AAATCGATAATGGGGTGAAG,0,1136985
fldAp,0.07142857142857142,13,13,AAAGTAGAGACCTCTCGGTT,0,1063598
fldAp,0.07142857142857142,13,13,AAAGTAAATCCATACAACGG,0,1119079
fldAp,0.07142857142857142,13,13,AAACGTCGTTTATCGGCCGT,0,1067781
fldAp,0.07142857142857142,13,13,AAACGTCCAGGGTACCCGCA,0,1141359
fldAp,0.07142857142857142,13,13,AAAATGCAGATAATGAGGTC,0,1142080
fldAp,0.07142857142857142,13,13,AAAACCTCATTGGGTCCGTG,0,1082204
fldAp,0.07142857142857142,13,13,AAAAAAGGTATTTTTAACGC,0,1153510
fldAp,0.07692307692307693,12,12,TTTTGGGTCGAGCCAGCAGT,0,1170954
fldAp,0.07692307692307693,12,12,TTTTCCGCGAGCCGAACCTG,0,1136778
fldAp,0.07692307692307693,12,12,TTTTAGGACCGGCCGCGATT,0,1069198
fldAp,0.07692307692307693,12,12,TTTGGTTGAAAATCTATGAA,0,1174886
fldAp,0.07692307692307693,12,12,TTTGCTCGGGGTTGAGGTTC,0,1176857
fldAp,0.07692307692307693,12,12,TTTGATATTTGCAGCTCTCG,0,1102687
fldAp,0.07692307692307693,12,12,TTTCGCGCCAGTACAATTAA,0,1074583
fldAp,0.07692307692307693,12,12,TTTATTCTGGATAGTCCATG,0,1081259
fldAp,0.07692307692307693,12,12,TTTATGGCAACTCAAGCCAC,0,1183735
fldAp,0.07692307692307693,12,12,TTGTTGTAAGGGAATGTAGC,0,1138916
fldAp,0.07692307692307693,12,12,TTGTGGACCTTGAATGTACG,0,1136158
fldAp,0.07692307692307693,12,12,TTGTCGCCCCAGCCCCGATC,0,1071298
fldAp,0.07692307692307693,12,12,TTGTCATACAGTACTGTACT,0,1127180
fldAp,0.07692307692307693,12,12,TTGTCACACGTGGTATTGCG,0,1176434
fldAp,0.07692307692307693,12,12,TTGTATAATCACTCGGTATA,0,1108988
fldAp,0.07692307692307693,12,12,TTGTAAGAGTATCTCCTGTT,0,1183260
fldAp,0.07692307692307693,12,12,TTGGACAGGGCTACAAACGA,0,1082114
fldAp,0.07692307692307693,12,12,TTGCCGAAGCCGTGCACCTC,0,1105379
fldAp,0.07692307692307693,12,12,TTGCCCGTTGAGGATCGGGT,0,1081220
fldAp,0.07692307692307693,12,12,TTGATGTGTGTTCGCAGTGC,0,1163664
fldAp,0.07692307692307693,12,12,TTGAGGGGCTCCTGACCGAG,0,1138733
fldAp,0.07692307692307693,12,12,TTCTTGCAAGGAGATAATTA,0,1081928
fldAp,0.07692307692307693,12,12,TTCTAACATAAGATGTCGGA,0,1102089
fldAp,0.07692307692307693,12,12,TTCGTTTAACATATCCCATC,0,1139168
fldAp,0.07692307692307693,12,12,TTCGTTAAGCTGTTATTGTT,0,1124414
fldAp,0.07692307692307693,12,12,TTCGGGATTGAATGGCTCTT,0,1082118
fldAp,0.07692307692307693,12,12,TTCCGTCTACTTGGACTAAA,0,1129924
fldAp,0.07692307692307693,12,12,TTCCAATAGGTTATGAGTAT,0,1173907
fldAp,0.07692307692307693,12,12,TTCAAGCCTGGGTGAACGGT,0,1121632
fldAp,0.07692307692307693,12,12,TTCAACGGCTGACCAACATA,0,1150036
fldAp,0.07692307692307693,12,12,TTAGTTACATCGCCCCGGTA,0,1094595
fldAp,0.07692307692307693,12,12,TTAGTGTGTTCAGGTACTAG,0,1132261
fldAp,0.07692307692307693,12,12,TTAGTAATCCGCGGCAATAG,0,1176672
fldAp,0.07692307692307693,12,12,TTAGGACGCGGGACGCCACG,0,1065239
fldAp,0.07692307692307693,12,12,TTAGAAGTGAACCCCCGACC,0,1076448
fldAp,0.07692307692307693,12,12,TTAAGTTCAATGATTAGCTC,0,1144932
fldAp,0.07692307692307693,12,12,TGTTTTATAGTCAACGCAAT,0,1149697
fldAp,0.07692307692307693,12,12,TGTTTGCTACAAAACAGATG,0,1078174
fldAp,0.07692307692307693,12,12,TGTTTGCCCAAACGGTCGCT,0,1085373
fldAp,0.07692307692307693,12,12,TGTTTCTTAACGATCGTTTA,0,1099337
fldAp,0.07692307692307693,12,12,TGTTTATTGGTTCATCGTTT,0,1115905
fldAp,0.07692307692307693,12,12,TGTTGGTACAGCATTAGCTT,0,1160003
fldAp,0.07692307692307693,12,12,TGTTGAAGGTTCAGTTTTGA,0,1111655
fldAp,0.07692307692307693,12,12,TGTTCGTAAGATGTACAACT,0,1083521
fldAp,0.07692307692307693,12,12,TGTTCGAGACCCTGCTAGAG,0,1157226
fldAp,0.07692307692307693,12,12,TGTTAAGTGGATGTGACTCT,0,1135123
fldAp,0.07692307692307693,12,12,TGTGTTAGATGATTCGAGGG,0,1098196
fldAp,0.07692307692307693,12,12,TGTGCGCTATCACCCTGTGT,0,1083017
fldAp,0.07692307692307693,12,12,TGTGCCGTGGCCGCTTGCCC,0,1066680
fldAp,0.07692307692307693,12,12,TGTCTAGCGCGATAGCGAGC,0,1142757
fldAp,0.07692307692307693,12,12,TGTCCACGTGACACGAGGGG,0,1091541
fldAp,0.07692307692307693,12,12,TGGTGTTATAATGATATGGC,0,1135586
fldAp,0.07692307692307693,12,12,TGGTGGGTGTAAACCATCAT,0,1099924
fldAp,0.07692307692307693,12,12,TGGGCGATACGGATCCGTGT,0,1132406
fldAp,0.07692307692307693,12,12,TGGGCGACTGGGCGCACGCT,0,1070046
fldAp,0.07692307692307693,12,12,TGGGCCTGTGAACTAAGATA,0,1116174
fldAp,0.07692307692307693,12,12,TGGGATACATTTTGGGCACG,0,1069788
fldAp,0.07692307692307693,12,12,TGGGACCCTTGGACTGGTGG,0,1182105
fldAp,0.07692307692307693,12,12,TGGCCTAGGCCTATCGCGCT,0,1176228
fldAp,0.07692307692307693,12,12,TGGCACTCATTTTGCTCATG,0,1162933
fldAp,0.07692307692307693,12,12,TGGCAAAAGCATTGCCAAGA,0,1124064
fldAp,0.07692307692307693,12,12,TGGATAGACAATAGTATTTA,0,1127869
fldAp,0.07692307692307693,12,12,TGGAGTCCCCCTAAGTTCGT,0,1184540
fldAp,0.07692307692307693,12,12,TGGAGCATGGCATTAGGCAA,0,1083771
fldAp,0.07692307692307693,12,12,TGGACGCGCATTAACCGATG,0,1075676
fldAp,0.07692307692307693,12,12,TGCTGTACCGGGCGGGTCAT,0,1066308
fldAp,0.07692307692307693,12,12,TGCTGCCGTTATATGCTCAC,0,1186771
fldAp,0.07692307692307693,12,12,TGCTCTCGGCGTGGGGCGCT,0,1135285
fldAp,0.07692307692307693,12,12,TGCTCAACATCCGATTCGCG,0,1165405
fldAp,0.07692307692307693,12,12,TGCGTGCGGGGCTAGGATAC,0,1092059
fldAp,0.07692307692307693,12,12,TGCGAATTCCCTGGTATCCG,0,1090110
fldAp,0.07692307692307693,12,12,TGATTAGTACGTTGAAAATG,0,1182398
fldAp,0.07692307692307693,12,12,TGAGTCAAATCTGGAAGGCG,0,1119819
fldAp,0.07692307692307693,12,12,TGAGGCCAACTTACGTGTTT,0,1156814
fldAp,0.07692307692307693,12,12,TGAGAGTGCCAGATCGACTT,0,1157606
fldAp,0.07692307692307693,12,12,TGACCTTGGCGTAACCCGTG,0,1109382
fldAp,0.07692307692307693,12,12,TGACCCCACCGTTTGATTAG,0,1118228
fldAp,0.07692307692307693,12,12,TGACATATAGATCAGTATTA,0,1173387
fldAp,0.07692307692307693,12,12,TGACAGCTTTAAATAGGGCA,0,1144241
fldAp,0.07692307692307693,12,12,TGAACGGCACATTGGGGATG,0,1108994
fldAp,0.07692307692307693,12,12,TGAACGGACAAAAAACGAGA,0,1117548
fldAp,0.07692307692307693,12,12,TCTGTGACTTGTTCACAATT,0,1174448
fldAp,0.07692307692307693,12,12,TCTGACCACCCCGATGTGAA,0,1107207
fldAp,0.07692307692307693,12,12,TCTCTACCTATCAATGAAAA,0,1114699
fldAp,0.07692307692307693,12,12,TCTAGAGCGGCTGCCTCTGT,0,1116808
fldAp,0.07692307692307693,12,12,TCGTTAATGAAACTGCAGCA,0,1136123
fldAp,0.07692307692307693,12,12,TCGGGCATGTAGGTTAATAA,0,1103341
fldAp,0.07692307692307693,12,12,TCGGCATCCCTTATTTTAAG,0,1114597
fldAp,0.07692307692307693,12,12,TCGGATACCCAGTATAAGAC,0,1148083
fldAp,0.07692307692307693,12,12,TCGCAATGCTTTGCAGCTAA,0,1093208
fldAp,0.07692307692307693,12,12,TCCTTGAATCTCGGTCTACA,0,1068968
fldAp,0.07692307692307693,12,12,TCCTTCTCTCACGGTAGGGT,0,1184502
fldAp,0.07692307692307693,12,12,TCCTCTTGTGAGGTAATTAT,0,1172093
fldAp,0.07692307692307693,12,12,TCCGCACTACCGACCCCCAT,0,1154231
fldAp,0.07692307692307693,12,12,TCCGACTTTTTGTTGTAGAG,0,1161350
fldAp,0.07692307692307693,12,12,TCCATGCTTGGCAAGTGAGC,0,1107891
fldAp,0.07692307692307693,12,12,TCCACAAGCCACGGTGTGGT,0,1072330
fldAp,0.07692307692307693,12,12,TCAGTGAGACGGGTTATGAT,0,1116304
fldAp,0.07692307692307693,12,12,TCAGCGGTAGCGGCATGAAA,0,1063815
fldAp,0.07692307692307693,12,12,TCAGAGCCCAACCGGTAGCT,0,1117905
fldAp,0.07692307692307693,12,12,TCAACATCGGGGCGCGCAAG,0,1150124
fldAp,0.07692307692307693,12,12,TCAAATTACCCTAGACTAAA,0,1150267
fldAp,0.07692307692307693,12,12,TCAAATTAACGGCACGCACG,0,1123837
fldAp,0.07692307692307693,12,12,TCAAACTGCATTTGGGACTA,0,1063564
fldAp,0.07692307692307693,12,12,TATTCGCGGCGGGGTAGGCA,0,1134579
fldAp,0.07692307692307693,12,12,TATTCAGCCGAGGAGCCTGG,0,1139371
fldAp,0.07692307692307693,12,12,TATTACTATGAAGATGGAAT,0,1155619
fldAp,0.07692307692307693,12,12,TATGTGTCATCGCAAATATA,0,1069883
fldAp,0.07692307692307693,12,12,TATGTGTCAGTCCAAGACAT,0,1153894
fldAp,0.07692307692307693,12,12,TATGCGTATAGCGTAAGTCT,0,1071553
fldAp,0.07692307692307693,12,12,TATGATAACGAGCAACGTAT,0,1078998
fldAp,0.07692307692307693,12,12,TATCGAGTTGCTTTATGCGA,0,1179604
fldAp,0.07692307692307693,12,12,TATCCTTCCGTCATCTAGTA,0,1171286
fldAp,0.07692307692307693,12,12,TATATGGAAGGGTTGTGGAA,0,1159032
fldAp,0.07692307692307693,12,12,TATAGGGCTACCCCACACAC,0,1096220
fldAp,0.07692307692307693,12,12,TATACTCTGTTGACCATCGG,0,1117756
fldAp,0.07692307692307693,12,12,TATAAACCCAAATGATTGTG,0,1068172
fldAp,0.07692307692307693,12,12,TATAAAAGCAAAGCGCGTTC,0,1141442
fldAp,0.07692307692307693,12,12,TAGGTGTGTGTGCGCGGTCC,0,1155728
fldAp,0.07692307692307693,12,12,TAGGCGACAAGCAGTATGAA,0,1088943
fldAp,0.07692307692307693,12,12,TAGGCCCCGGCTACCGCGTC,0,1103236
fldAp,0.07692307692307693,12,12,TAGGCATATACGATCTAAGG,0,1146477
fldAp,0.07692307692307693,12,12,TAGCGAGAGGTTGTTTATGG,0,1068159
fldAp,0.07692307692307693,12,12,TAGCCTAGTACTGCGGTCTC,0,1141995
fldAp,0.07692307692307693,12,12,TAGCAAGCCCCTGCCCCAAA,0,1115645
fldAp,0.07692307692307693,12,12,TAGATGGGGGGCAAGGACAT,0,1122615
fldAp,0.07692307692307693,12,12,TAGAGCGATAAACGTAAATG,0,1145892
fldAp,0.07692307692307693,12,12,TAGAGCATTAGCATGACCTG,0,1162061
fldAp,0.07692307692307693,12,12,TACTGTCCTAGAGACGCTCT,0,1099099
fldAp,0.07692307692307693,12,12,TACTGCCATAGGGGGGTTTT,0,1127517
fldAp,0.07692307692307693,12,12,TACTGCCACGAGTTAAAAAC,0,1108968
fldAp,0.07692307692307693,12,12,TACGTGAGGCAAGAGGAGCG,0,1148450
fldAp,0.07692307692307693,12,12,TACGTCGCCTAGATAGTCCT,0,1098163
fldAp,0.07692307692307693,12,12,TACGAGCCCCTTCACAACGG,0,1075835
fldAp,0.07692307692307693,12,12,TACGACGAGATCAACAACCC,0,1082950
fldAp,0.07692307692307693,12,12,TACCGGGCCACGGTCGTTCG,0,1063399
fldAp,0.07692307692307693,12,12,TACAGCCATTATACTAGGAG,0,1075362
fldAp,0.07692307692307693,12,12,TAAGCGGGCATTCTTGCCGG,0,1150736
fldAp,0.07692307692307693,12,12,GTTTTAGCCCTGTCCGCCTA,0,1108417
fldAp,0.07692307692307693,12,12,GTTTGCCATGTATTGAGTGT,0,1107500
fldAp,0.07692307692307693,12,12,GTTTCTGGCATGTGACCAAT,0,1100025
fldAp,0.07692307692307693,12,12,GTTTCACGAGCTCAATGGCT,0,1147793
fldAp,0.07692307692307693,12,12,GTTTACTAGGCTAGGTGGAA,0,1144513
fldAp,0.07692307692307693,12,12,GTTGGGGTTGTGGTCTCGAA,0,1172875
fldAp,0.07692307692307693,12,12,GTTGGCTTAAAATCAGCTTT,0,1088986
fldAp,0.07692307692307693,12,12,GTTGCCGTGGTCATTATCAT,0,1143916
fldAp,0.07692307692307693,12,12,GTTGCCGGCAGAAAGACACA,0,1067990
fldAp,0.07692307692307693,12,12,GTTGAATATGGCTTGGTCAA,0,1146498
fldAp,0.07692307692307693,12,12,GTTCGGCAAACGTGGCTTGA,0,1082600
fldAp,0.07692307692307693,12,12,GTTAAGGGAGCCTCCGCAGA,0,1116849
fldAp,0.07692307692307693,12,12,GTTAAGAACGTCACGTATCG,0,1147196
fldAp,0.07692307692307693,12,12,GTTAACTTGAATACAAGAGT,0,1071296
fldAp,0.07692307692307693,12,12,GTGTATGGATGCGCTCATCC,0,1176609
fldAp,0.07692307692307693,12,12,GTGTAACGGCCCGGTTGAGT,0,1125400
fldAp,0.07692307692307693,12,12,GTGGTTGTCTTTCTCCAATG,0,1163283
fldAp,0.07692307692307693,12,12,GTGGCCCTTACTTGGAAGAG,0,1178413
fldAp,0.07692307692307693,12,12,GTGCTTTTCTTGCGGTTGCC,0,1111576
fldAp,0.07692307692307693,12,12,GTGACGGGAGAACTGTAGAA,0,1133128
fldAp,0.07692307692307693,12,12,GTCTGTTTTGACCGAGCGAC,0,1141429
fldAp,0.07692307692307693,12,12,GTCGGATTATCAGCGGCGGG,0,1080971
fldAp,0.07692307692307693,12,12,GTCCGTTGGGTCGTTTTACC,0,1137730
fldAp,0.07692307692307693,12,12,GTCCGGTGCGTCAGAGAGTT,0,1081623
fldAp,0.07692307692307693,12,12,GTCCGAAAGCAGCCCAATGA,0,1114390
fldAp,0.07692307692307693,12,12,GTCCAGAATGTCTAGAGTTG,0,1163676
fldAp,0.07692307692307693,12,12,GTCAGATCTAGACTAAATAC,0,1181749
fldAp,0.07692307692307693,12,12,GTCAGACGCAACTCCAAAGC,0,1164259
fldAp,0.07692307692307693,12,12,GTCACGAAGTCAGGCACACT,0,1096920
fldAp,0.07692307692307693,12,12,GTCAACCCGACTACCAAACA,0,1150544
fldAp,0.07692307692307693,12,12,GTATGTAGACAACTAGGGTA,0,1074709
fldAp,0.07692307692307693,12,12,GTATCGGAATCCGCGCACGA,0,1067979
fldAp,0.07692307692307693,12,12,GTAGGATATGCTAAACGGCC,0,1150366
fldAp,0.07692307692307693,12,12,GTACATCGAACTCGTACACA,0,1135406
fldAp,0.07692307692307693,12,12,GTAAGTGCACGAGGACTTGT,0,1122839
fldAp,0.07692307692307693,12,12,GTAAGCCCGTCGTACCGGCT,0,1140396
fldAp,0.07692307692307693,12,12,GGTTTCGCAAAAACAGTACT,0,1083133
fldAp,0.07692307692307693,12,12,GGTGTGGGGTTGCACGGCGT,0,1162401
fldAp,0.07692307692307693,12,12,GGTGCACACCAGTCTCTGGT,0,1176503
fldAp,0.07692307692307693,12,12,GGTCTCACAAGTGTAAGGTC,0,1089811
fldAp,0.07692307692307693,12,12,GGTCTACTCTGGTTCTCGGT,0,1115473
fldAp,0.07692307692307693,12,12,GGTATTTTCCCCCAACTTAC,0,1153541
fldAp,0.07692307692307693,12,12,GGGTTGCACCGATAAATCAA,0,1095558
fldAp,0.07692307692307693,12,12,GGGTGTCGCGATTGATCGGT,0,1077832
fldAp,0.07692307692307693,12,12,GGGTCAGGCGATGTGGTGCC,0,1087704
fldAp,0.07692307692307693,12,12,GGGGGGTCTAAGGGGAGCGC,0,1126807
fldAp,0.07692307692307693,12,12,GGGGCGCGCTCCTGTGCGGA,0,1164795
fldAp,0.07692307692307693,12,12,GGGCGAGATGTCTCCGCGCT,0,1137778
fldAp,0.07692307692307693,12,12,GGGCCTCAAGACTTCCTTCA,0,1105729
fldAp,0.07692307692307693,12,12,GGGAGCGGCGACTTACACAA,0,1138527
fldAp,0.07692307692307693,12,12,GGGAGAAAACCCGTGATGGT,0,1064960
fldAp,0.07692307692307693,12,12,GGGACGGTTGTTCGAGGATT,0,1100953
fldAp,0.07692307692307693,12,12,GGCTTGTGCAAAACGTAGGG,0,1128026
fldAp,0.07692307692307693,12,12,GGCTATGTTGACTGATCAGT,0,1074021
fldAp,0.07692307692307693,12,12,GGCGTAGAGCACGAGCGGGG,0,1109199
fldAp,0.07692307692307693,12,12,GGCGGTAATATCGTACTCAG,0,1173531
fldAp,0.07692307692307693,12,12,GGCGCTTCAGGCTCCGGTAT,0,1167803
fldAp,0.07692307692307693,12,12,GGCGCAATGTGCTTGAGGTC,0,1178077
fldAp,0.07692307692307693,12,12,GGCCGGAGGGCGAGTTTCCA,0,1135414
fldAp,0.07692307692307693,12,12,GGCCGCGACCATGGCAAGCG,0,1153414
fldAp,0.07692307692307693,12,12,GGCCCGTACTGGTCTCAGTT,0,1122348
fldAp,0.07692307692307693,12,12,GGCATCCCGGATGAAGTAAA,0,1127401
fldAp,0.07692307692307693,12,12,GGCAGTGGAAAAGGTAGAAC,0,1078144
fldAp,0.07692307692307693,12,12,GGCAGTCCTCATACAGTTTG,0,1121527
fldAp,0.07692307692307693,12,12,GGCAGTAAGTTGCGACATGT,0,1184999
fldAp,0.07692307692307693,12,12,GGCACCTCTACACGACCAGA,0,1140465
fldAp,0.07692307692307693,12,12,GGCACCGTTCTCGGGTTAAT,0,1088608
fldAp,0.07692307692307693,12,12,GGATTCTTTTTCCTAGCTAG,0,1117926
fldAp,0.07692307692307693,12,12,GGACTTTGTAGATACTGACA,0,1092026
fldAp,0.07692307692307693,12,12,GGAATTTGTCCACGTCTTGG,0,1073895
fldAp,0.07692307692307693,12,12,GGAAGTTTGATCATCGCTTT,0,1084092
fldAp,0.07692307692307693,12,12,GGAAAGAAACTGCTGAAAGA,0,1137952
fldAp,0.07692307692307693,12,12,GGAAAAAGCGCTCTATTCGT,0,1153226
fldAp,0.07692307692307693,12,12,GCTTTTGTGTAGGCTCGTGT,0,1167793
fldAp,0.07692307692307693,12,12,GCTTGGCGCTGGTAGGTTGT,0,1127171
fldAp,0.07692307692307693,12,12,GCTTCCCTTTCTAGAACATT,0,1178460
fldAp,0.07692307692307693,12,12,GCTGGCTATTTATGTCAGTT,0,1181057
fldAp,0.07692307692307693,12,12,GCTGGCCGATTGAGTCCCTT,0,1153957
fldAp,0.07692307692307693,12,12,GCTGGCAGGCATACATTTCA,0,1141268
fldAp,0.07692307692307693,12,12,GCTCGCCAAGCACTCGCTCT,0,1088242
fldAp,0.07692307692307693,12,12,GCTCATCTCGCGGATCTCTT,0,1080990
fldAp,0.07692307692307693,12,12,GCGTTCGCAATGCAACAGAA,0,1133332
fldAp,0.07692307692307693,12,12,GCGTGTCACGAAGTGGTTTG,0,1176253
fldAp,0.07692307692307693,12,12,GCGTCGAGCGGTTCATGATC,0,1181772
fldAp,0.07692307692307693,12,12,GCGGGTTTGGTGCAGCGCGG,0,1077367
fldAp,0.07692307692307693,12,12,GCGCTTTGGCATCCTATTGA,0,1102488
fldAp,0.07692307692307693,12,12,GCGCTATATTCGGGCTGACC,0,1075040
fldAp,0.07692307692307693,12,12,GCGCGCCTGCACTTTGAGAG,0,1074854
fldAp,0.07692307692307693,12,12,GCGCCGTGGTTATCCATTCT,0,1129252
fldAp,0.07692307692307693,12,12,GCGCAATTTCGATGACGATC,0,1077743
fldAp,0.07692307692307693,12,12,GCGATCACAGCCCTTTGATA,0,1130639
fldAp,0.07692307692307693,12,12,GCGAAGTAGCTAGCACGAAT,0,1070749
fldAp,0.07692307692307693,12,12,GCGAACATGCACGGACTTTA,0,1104154
fldAp,0.07692307692307693,12,12,GCCTCAACATGAGGCAAAAA,0,1126375
fldAp,0.07692307692307693,12,12,GCCTAACCAATACCGACCGG,0,1103506
fldAp,0.07692307692307693,12,12,GCCCGTGGATAGGCGTGGGG,0,1118450
fldAp,0.07692307692307693,12,12,GCCCGATTCAGCTTACATAC,0,1160620
fldAp,0.07692307692307693,12,12,GCCCCGGTTTAGCGTGGTTA,0,1075623
fldAp,0.07692307692307693,12,12,GCCCCCAAATTTGTCGAGTG,0,1121601
fldAp,0.07692307692307693,12,12,GCCATAGCGACCCTCACTGT,0,1120460
fldAp,0.07692307692307693,12,12,GCCAGTCGTAATTCCGATGA,0,1071158
fldAp,0.07692307692307693,12,12,GCCAACAACTACTATAAGAT,0,1144537
fldAp,0.07692307692307693,12,12,GCATCGCAAAAGAGTTTATA,0,1136572
fldAp,0.07692307692307693,12,12,GCATAACGGTAAGATGGGAT,0,1178228
fldAp,0.07692307692307693,12,12,GCATAAATTCAAGCTCGGGG,0,1156660
fldAp,0.07692307692307693,12,12,GCAGTATCAGGCGGCTTCAT,0,1107109
fldAp,0.07692307692307693,12,12,GCAGGACTAGAGCGCGGTTT,0,1131256
fldAp,0.07692307692307693,12,12,GCACCGACCCGTAAACCTTG,0,1099261
fldAp,0.07692307692307693,12,12,GCACAGTCGCGGGCCAGAAA,0,1130917
fldAp,0.07692307692307693,12,12,GCAAGTACCCTGAGGCGCGG,0,1116555
fldAp,0.07692307692307693,12,12,GCAAGGCACTCCGCAGGTTT,0,1144557
fldAp,0.07692307692307693,12,12,GCAAGCTGAAAATACAATGC,0,1172027
fldAp,0.07692307692307693,12,12,GCAAGACACAACCAACGGCC,0,1145752
fldAp,0.07692307692307693,12,12,GCAACTTGCGCTATTTTCTA,0,1073184
fldAp,0.07692307692307693,12,12,GCAACAGCTTCTCGACACGC,0,1135214
fldAp,0.07692307692307693,12,12,GCAAAGCGCGATCCGGGTTG,0,1167450
fldAp,0.07692307692307693,12,12,GATTTTGCTATGTCTTACGT,0,1182835
fldAp,0.07692307692307693,12,12,GATTTTATTCTGGCGCAGGT,0,1079882
fldAp,0.07692307692307693,12,12,GATTTTAAGCAGGGAATGAG,0,1172818
fldAp,0.07692307692307693,12,12,GATTTAAGTGCGGTGAAGGA,0,1127163
fldAp,0.07692307692307693,12,12,GATTGGTGCTAGCCAGAACT,0,1115994
fldAp,0.07692307692307693,12,12,GATTGGTCCCGGAAGCTTTT,0,1092663
fldAp,0.07692307692307693,12,12,GATTCCGAAGGTAGTCTCTT,0,1101724
fldAp,0.07692307692307693,12,12,GATTAGGACACCTGACAGAG,0,1086003
fldAp,0.07692307692307693,12,12,GATCTTCTCGTCGTCGGTAC,0,1165725
fldAp,0.07692307692307693,12,12,GATCAGGTCTTATTAGCGTT,0,1085586
fldAp,0.07692307692307693,12,12,GATAGACCCTAACCAGTTCA,0,1110602
fldAp,0.07692307692307693,12,12,GATACGCAATGGCCTGAGAC,0,1129233
fldAp,0.07692307692307693,12,12,GATAAGATATGTCCTCTTCC,0,1162488
fldAp,0.07692307692307693,12,12,GAGTGGCATTAACTACAGGT,0,1123112
fldAp,0.07692307692307693,12,12,GAGTCGGGCCGTTCCAGGCA,0,1100707
fldAp,0.07692307692307693,12,12,GAGTCGGAATAAAGAGCGCT,0,1095469
fldAp,0.07692307692307693,12,12,GAGTCAACTCGTGCGCCCCT,0,1124930
fldAp,0.07692307692307693,12,12,GAGTACGAGCGTGTAACATA,0,1172804
fldAp,0.07692307692307693,12,12,GAGGGAGTAAATTGTTTGGT,0,1123406
fldAp,0.07692307692307693,12,12,GAGCGCTATGGCTCAGCTTG,0,1131111
fldAp,0.07692307692307693,12,12,GAGCCACCCTAGCACGTCCT,0,1069321
fldAp,0.07692307692307693,12,12,GAGCATCGTTGCAGCAGATG,0,1083258
fldAp,0.07692307692307693,12,12,GACTTAGGAGGCGCGGAACT,0,1141377
fldAp,0.07692307692307693,12,12,GACTGGCTGATCTCCGGTGG,0,1166457
fldAp,0.07692307692307693,12,12,GACGTTCATTGCGTTCTAGC,0,1096809
fldAp,0.07692307692307693,12,12,GACGTCTAACCGGTAAGGGT,0,1169044
fldAp,0.07692307692307693,12,12,GACCGACTGTGCGAAAGTTC,0,1115137
fldAp,0.07692307692307693,12,12,GACCCGGTAAATTATGCTGT,0,1075334
fldAp,0.07692307692307693,12,12,GACCCGCGCATAACATCGGA,0,1068143
fldAp,0.07692307692307693,12,12,GACCCGCCATGGCATGCAGA,0,1069071
fldAp,0.07692307692307693,12,12,GACAATGTGGCCTATTGGTA,0,1100829
fldAp,0.07692307692307693,12,12,GAATTTTAACCGGTCTCTTG,0,1119601
fldAp,0.07692307692307693,12,12,GAATTGTAGGTTTGCCCGGC,0,1127223
fldAp,0.07692307692307693,12,12,GAATTAAATACTGGATTGTC,0,1097400
fldAp,0.07692307692307693,12,12,GAAGCACGGCGCATAGTCAG,0,1123833
fldAp,0.07692307692307693,12,12,GAACGGTAGTATTCATGACT,0,1153964
fldAp,0.07692307692307693,12,12,GAACCGAGGCAGCGACCATA,0,1156460
fldAp,0.07692307692307693,12,12,GAAAGGCCACGCCCTAATAG,0,1086936
fldAp,0.07692307692307693,12,12,GAAAAAGCATAAATGCTCAT,0,1157718
fldAp,0.07692307692307693,12,12,CTTTTGGCACGGAACTAGCA,0,1123303
fldAp,0.07692307692307693,12,12,CTTGTAGCGCGGTCCAAGCT,0,1097005
fldAp,0.07692307692307693,12,12,CTTGCTATCCATTTATACTA,0,1148982
fldAp,0.07692307692307693,12,12,CTTGCACCCACCGTACGCCT,0,1128819
fldAp,0.07692307692307693,12,12,CTTCGTGCTCTGGAAACATG,0,1120328
fldAp,0.07692307692307693,12,12,CTTCCGGATAGAATTTACCC,0,1127865
fldAp,0.07692307692307693,12,12,CTTCAGTTTCACCACTCAAG,0,1153809
fldAp,0.07692307692307693,12,12,CTTCACGTATACATAGGAAT,0,1129742
fldAp,0.07692307692307693,12,12,CTTACCTCGCGAACTGAAAT,0,1159889
fldAp,0.07692307692307693,12,12,CTGTTTGGCGCTACAGGTGA,0,1186513
fldAp,0.07692307692307693,12,12,CTGTCCAGATTTCGTCAATA,0,1148170
fldAp,0.07692307692307693,12,12,CTGGGTGGCATCAACTGCTC,0,1135777
fldAp,0.07692307692307693,12,12,CTGGCAGGCGAAAACCTGTA,0,1070427
fldAp,0.07692307692307693,12,12,CTGCTTGACTCCGATGCGAA,0,1130427
fldAp,0.07692307692307693,12,12,CTGCAAGGAGCGTCCAAAGG,0,1184612
fldAp,0.07692307692307693,12,12,CTGAGTGACTGATGGATATT,0,1160757
fldAp,0.07692307692307693,12,12,CTGAGGTTCGAACGGGACGA,0,1093515
fldAp,0.07692307692307693,12,12,CTGACGCGATAAGGCAGCGC,0,1186273
fldAp,0.07692307692307693,12,12,CTCTTGTAGCTATAACTGGG,0,1140018
fldAp,0.07692307692307693,12,12,CTCTTCACCAACGGAAGGAG,0,1068242
fldAp,0.07692307692307693,12,12,CTCTGGTTTGCTTATTTACT,0,1163175
fldAp,0.07692307692307693,12,12,CTCTGGCCGCAGGAGCGAAG,0,1069358
fldAp,0.07692307692307693,12,12,CTCTAAATCAAGTCTCAACT,0,1068737
fldAp,0.07692307692307693,12,12,CTCGTCCATCTATACACTGA,0,1151624
fldAp,0.07692307692307693,12,12,CTCGCGGGTCGTAATAGGAC,0,1098006
fldAp,0.07692307692307693,12,12,CTCATTCGATTAGATTCACC,0,1173498
fldAp,0.07692307692307693,12,12,CTATGATGCCTCAGACGAAA,0,1092371
fldAp,0.07692307692307693,12,12,CTATGAAGAGCCCAACAGAT,0,1079037
fldAp,0.07692307692307693,12,12,CTATCTTAAACAGTATCGCT,0,1081667
fldAp,0.07692307692307693,12,12,CTATAATACTGCCGGTGGGA,0,1075666
fldAp,0.07692307692307693,12,12,CTAGGGTTCAATACTGACTT,0,1147769
fldAp,0.07692307692307693,12,12,CTAGGGCGAGATATCAGCGC,0,1121302
fldAp,0.07692307692307693,12,12,CTACGTAAAGGCGAACGTCA,0,1157871
fldAp,0.07692307692307693,12,12,CTAATTAGTTTGTGCAATCG,0,1089950
fldAp,0.07692307692307693,12,12,CTAATATACAATCTCTGAGG,0,1079319
fldAp,0.07692307692307693,12,12,CGTTTGCACTGTTTCGTAGC,0,1114855
fldAp,0.07692307692307693,12,12,CGTTTCTTTTAATAATTGTG,0,1178901
fldAp,0.07692307692307693,12,12,CGTGTATACAACAAGAGTAT,0,1120615
fldAp,0.07692307692307693,12,12,CGTGGTTACACTCGGTACAG,0,1087043
fldAp,0.07692307692307693,12,12,CGTGCCATCAAAATGAACCC,0,1164240
fldAp,0.07692307692307693,12,12,CGTGAAGCCAGGACCGCAGT,0,1082049
fldAp,0.07692307692307693,12,12,CGTGAACTTAACAACGGACA,0,1077957
fldAp,0.07692307692307693,12,12,CGTATAGGGGCCCCCTGGGA,0,1085413
fldAp,0.07692307692307693,12,12,CGTAGGGGAAAGCTGCGAGT,0,1129629
fldAp,0.07692307692307693,12,12,CGGTTAGTTGGTTTGCAGAA,0,1175179
fldAp,0.07692307692307693,12,12,CGGTGATGTCGCTGCAGCTT,0,1168299
fldAp,0.07692307692307693,12,12,CGGTCCCCAAAAGTGAGTTT,0,1111267
fldAp,0.07692307692307693,12,12,CGGTACCCCTTGAGGGATGT,0,1084641
fldAp,0.07692307692307693,12,12,CGGGTTGACGCGCCCCATGC,0,1135529
fldAp,0.07692307692307693,12,12,CGGCGACGTTTGGACAAAAG,0,1155703
fldAp,0.07692307692307693,12,12,CGGCCTTAGGCTATCGGGGG,0,1113790
fldAp,0.07692307692307693,12,12,CGGATAATATAAAGCGGCTT,0,1085580
fldAp,0.07692307692307693,12,12,CGGACTACGAATTGTCCTAT,0,1105486
fldAp,0.07692307692307693,12,12,CGGACCCTACTATCTGCGGG,0,1067765
fldAp,0.07692307692307693,12,12,CGGACACCTAGACCGGCGCG,0,1174382
fldAp,0.07692307692307693,12,12,CGGAAAAATGGTTGACCGCG,0,1134594
fldAp,0.07692307692307693,12,12,CGCTCAAAAGAGGCCGGGTG,0,1134903
fldAp,0.07692307692307693,12,12,CGCGTGGGTACGCATATACC,0,1140307
fldAp,0.07692307692307693,12,12,CGCGGCCCTGGGCTCTCATA,0,1080193
fldAp,0.07692307692307693,12,12,CGCGCGGGCACTGCTATCCA,0,1121140
fldAp,0.07692307692307693,12,12,CGCCGTCATTGTCGGACTCG,0,1177235
fldAp,0.07692307692307693,12,12,CGCATATGCCGGGCTATGAG,0,1155594
fldAp,0.07692307692307693,12,12,CGCACCTAAGAGGACTTCCT,0,1170113
fldAp,0.07692307692307693,12,12,CGCACATTACGAAATTCTTA,0,1139952
fldAp,0.07692307692307693,12,12,CGAGGCGCAGCGCAGGCATC,0,1130315
fldAp,0.07692307692307693,12,12,CGAGAATACCATCCATGGAG,0,1146671
fldAp,0.07692307692307693,12,12,CGACTGTGCATGATTAGATG,0,1149613
fldAp,0.07692307692307693,12,12,CGACATCAGTTTTTATATCG,0,1131292
fldAp,0.07692307692307693,12,12,CGAATAGGGGATCGCGTTAT,0,1162541
fldAp,0.07692307692307693,12,12,CCTTCGGGACAAGTGACGAT,0,1173627
fldAp,0.07692307692307693,12,12,CCTTAATAGAAAACTACTCA,0,1123554
fldAp,0.07692307692307693,12,12,CCTGTCCACGGGGCGACACC,0,1185132
fldAp,0.07692307692307693,12,12,CCTGGGAGTCATTTAAATGG,0,1136473
fldAp,0.07692307692307693,12,12,CCTCGTACTTGTGCCTGCTT,0,1139036
fldAp,0.07692307692307693,12,12,CCTCAGCGTGTGACGCATTC,0,1141748
fldAp,0.07692307692307693,12,12,CCTCACCCTGTGCGACGGAG,0,1161657
fldAp,0.07692307692307693,12,12,CCTCAATCGGACCTAAGCTC,0,1184991
fldAp,0.07692307692307693,12,12,CCTATTGAGGGCATGAATCG,0,1147430
fldAp,0.07692307692307693,12,12,CCTAACGAGTAAAGCTTTGT,0,1125108
fldAp,0.07692307692307693,12,12,CCGGGATATTTTGGCGAGAG,0,1174447
fldAp,0.07692307692307693,12,12,CCGGCATGGTTCCGATCGGT,0,1144938
fldAp,0.07692307692307693,12,12,CCGCGGTTCGGGCAACCCTT,0,1148614
fldAp,0.07692307692307693,12,12,CCGATGGATTTCATTCAAAG,0,1162484
fldAp,0.07692307692307693,12,12,CCGATCCTAAGTAGTTCTCT,0,1133074
fldAp,0.07692307692307693,12,12,CCGAGCTTGGAATTACGATG,0,1103394
fldAp,0.07692307692307693,12,12,CCGACCTATCGAGTTCGTAT,0,1120688
fldAp,0.07692307692307693,12,12,CCGAATGGGGTAAAGACGAC,0,1090524
fldAp,0.07692307692307693,12,12,CCCTTGCGTGAGCTTTATGA,0,1106208
fldAp,0.07692307692307693,12,12,CCCTACATGCGAATAGGGTA,0,1086768
fldAp,0.07692307692307693,12,12,CCCGTTGAACGTTGGAACAG,0,1136012
fldAp,0.07692307692307693,12,12,CCCGCGTTCTTTGGACTATA,0,1107838
fldAp,0.07692307692307693,12,12,CCCGCCGGTCGTCACTACAG,0,1073656
fldAp,0.07692307692307693,12,12,CCCCACACCAAGGCACGTCA,0,1107425
fldAp,0.07692307692307693,12,12,CCCCAACAGGCACTCAAAGC,0,1138731
fldAp,0.07692307692307693,12,12,CCATTTATATAACCGTCGTT,0,1145732
fldAp,0.07692307692307693,12,12,CCATTCTAAAAGGTACTCGC,0,1162313
fldAp,0.07692307692307693,12,12,CCAGGCCATACCAGGAGCAA,0,1161099
fldAp,0.07692307692307693,12,12,CCAGCCACACATTGGTTGTT,0,1082295
fldAp,0.07692307692307693,12,12,CCAGAAACGTAGTGTTCATA,0,1118254
fldAp,0.07692307692307693,12,12,CCACTGAGATCATTCCGCCA,0,1120135
fldAp,0.07692307692307693,12,12,CCACCCGGAGCAGTTTCTGA,0,1090579
fldAp,0.07692307692307693,12,12,CCACATATACATCTACAGCG,0,1102402
fldAp,0.07692307692307693,12,12,CCAATAATCAGTGCTAAGGT,0,1180698
fldAp,0.07692307692307693,12,12,CATTTGTCCTCACGTACGAG,0,1105166
fldAp,0.07692307692307693,12,12,CATTTATGGCCCAATGCACA,0,1076191
fldAp,0.07692307692307693,12,12,CATTTATCCTTGCGACGGTA,0,1078881
fldAp,0.07692307692307693,12,12,CATTGTTTGTTAGACCAACT,0,1123160
fldAp,0.07692307692307693,12,12,CATTGTTCTGGTTGTAGGTT,0,1069926
fldAp,0.07692307692307693,12,12,CATTGATACCTGAAAGCACA,0,1104414
fldAp,0.07692307692307693,12,12,CATGGGGGTTCTGTTAAGTA,0,1063365
fldAp,0.07692307692307693,12,12,CATGGACGCCGCGTACGTTT,0,1122041
fldAp,0.07692307692307693,12,12,CATGACTCCCTAGGTACTTG,0,1120495
fldAp,0.07692307692307693,12,12,CATCTTCTGTTTAGGGGCAT,0,1098841
fldAp,0.07692307692307693,12,12,CATATTGTGTCGATGACCAG,0,1123307
fldAp,0.07692307692307693,12,12,CATATTCGCTCGACGACTGC,0,1134222
fldAp,0.07692307692307693,12,12,CATATATCACATCTCTGTGG,0,1068270
fldAp,0.07692307692307693,12,12,CAGTTTCCGTCCTTCTGTCG,0,1072680
fldAp,0.07692307692307693,12,12,CAGTTTCCGGAGGATTTAAG,0,1093625
fldAp,0.07692307692307693,12,12,CAGTTCTCACGAGACCAAGA,0,1186962
fldAp,0.07692307692307693,12,12,CAGTCAATGCCCCGCACTAA,0,1159602
fldAp,0.07692307692307693,12,12,CAGGTGGCCTCTACTACGAC,0,1151550
fldAp,0.07692307692307693,12,12,CAGGGTATACCCGTCAGATA,0,1173901
fldAp,0.07692307692307693,12,12,CAGCACACGCATGTCTCTCT,0,1170385
fldAp,0.07692307692307693,12,12,CAGATGAGTTTGATGACTAA,0,1121072
fldAp,0.07692307692307693,12,12,CAGAACGCTGACGCTGGGGC,0,1078543
fldAp,0.07692307692307693,12,12,CACTGCTCGACGTTGCCCTA,0,1070748
fldAp,0.07692307692307693,12,12,CACGTCAGGCTCACTCAGAA,0,1165115
fldAp,0.07692307692307693,12,12,CACGTAAGATATGACATACC,0,1070788
fldAp,0.07692307692307693,12,12,CACGGCGCCTGAGCTTCAGA,0,1116784
fldAp,0.07692307692307693,12,12,CACGCGACTGGATGCAACGC,0,1096845
fldAp,0.07692307692307693,12,12,CACCTCGACCTCGACTGTTG,0,1146966
fldAp,0.07692307692307693,12,12,CACCGATGGTGGTGAAGTAC,0,1128635
fldAp,0.07692307692307693,12,12,CACCATCTTCCTCGTTGATA,0,1099047
fldAp,0.07692307692307693,12,12,CACCACAACATTAGATGTGG,0,1169819
fldAp,0.07692307692307693,12,12,CACACGCCTGGGCCGCCTGT,0,1165397
fldAp,0.07692307692307693,12,12,CAATGTGCTACAAGTTAATG,0,1183240
fldAp,0.07692307692307693,12,12,CAATGTCTGGTCTAACTAAA,0,1140064
fldAp,0.07692307692307693,12,12,CAATCGGCATTCAACTGGAG,0,1178316
fldAp,0.07692307692307693,12,12,CAATCCAAACGTAACTGAAC,0,1109263
fldAp,0.07692307692307693,12,12,CAAGGGATGTGCGCGGCGTC,0,1120099
fldAp,0.07692307692307693,12,12,CAAGCATCCTCAGTAGTAAG,0,1101373
fldAp,0.07692307692307693,12,12,CAAGATGTGTCATCCATCAG,0,1115058
fldAp,0.07692307692307693,12,12,CAACGCGTGTCGATCGCGAG,0,1132123
fldAp,0.07692307692307693,12,12,CAACGAGCCTTAAGCAGGAC,0,1084397
fldAp,0.07692307692307693,12,12,CAACATGAGATAAAAGGAGC,0,1140069
fldAp,0.07692307692307693,12,12,CAACACCGTATTAAATCGTC,0,1130720
fldAp,0.07692307692307693,12,12,ATTTGTGGGGCTCACATAAT,0,1086875
fldAp,0.07692307692307693,12,12,ATTTCTTGGTTCTATTTTAG,0,1167253
fldAp,0.07692307692307693,12,12,ATTTCTCGCAAGCATTCTAA,0,1081604
fldAp,0.07692307692307693,12,12,ATTGTCTATTCGTCTTTTCT,0,1150215
fldAp,0.07692307692307693,12,12,ATTGGTGTCATACCGCACAC,0,1160401
fldAp,0.07692307692307693,12,12,ATTGGAACCCTCCGTAGGCA,0,1131842
fldAp,0.07692307692307693,12,12,ATTGATCGGGAGTTATCTCT,0,1104464
fldAp,0.07692307692307693,12,12,ATTGAATGATATTTCGCCGG,0,1131663
fldAp,0.07692307692307693,12,12,ATTCGAGCCGTATCCCATTC,0,1177252
fldAp,0.07692307692307693,12,12,ATTAGTACCGAGTCAGCACT,0,1174912
fldAp,0.07692307692307693,12,12,ATGGTGTACCATATCGGGTC,0,1094852
fldAp,0.07692307692307693,12,12,ATGGGGTAACGGGGTATTTC,0,1153168
fldAp,0.07692307692307693,12,12,ATGCTTTGTGAGACTGCCTC,0,1105484
fldAp,0.07692307692307693,12,12,ATGCCGCGGTCCGAGGCTGT,0,1118414
fldAp,0.07692307692307693,12,12,ATGATCCAACGGGGTGTGTG,0,1116187
fldAp,0.07692307692307693,12,12,ATGAGGCACGGGCAGGGGGG,0,1080423
fldAp,0.07692307692307693,12,12,ATCTTAAGGGGCAAGTTAAT,0,1150356
fldAp,0.07692307692307693,12,12,ATCTGCTAGTCATCATGCAA,0,1089038
fldAp,0.07692307692307693,12,12,ATCGGTTGGCATAGTTGGCA,0,1132257
fldAp,0.07692307692307693,12,12,ATCGGGTTCCATGGGAATAG,0,1152519
fldAp,0.07692307692307693,12,12,ATCATTCCCGTATCATGTGA,0,1094823
fldAp,0.07692307692307693,12,12,ATCAGGGCCTGAGTTAGCTG,0,1112720
fldAp,0.07692307692307693,12,12,ATCACCGTACGTGTCGGGGC,0,1132307
fldAp,0.07692307692307693,12,12,ATCACAACACAGACGGCTCT,0,1126113
fldAp,0.07692307692307693,12,12,ATCAAGCTACGTTATGATCG,0,1118893
fldAp,0.07692307692307693,12,12,ATATGGTCTGCTCCAGCAGG,0,1127809
fldAp,0.07692307692307693,12,12,ATATGCATAGCAATTTGGCC,0,1079010
fldAp,0.07692307692307693,12,12,ATATCTCCGATAGAGCATAT,0,1135223
fldAp,0.07692307692307693,12,12,ATAGGGAATGGGCCTTAAGT,0,1109413
fldAp,0.07692307692307693,12,12,ATAGGATAATACAGTCGTTG,0,1166891
fldAp,0.07692307692307693,12,12,ATAGATGCTCACAAGTTAAG,0,1069882
fldAp,0.07692307692307693,12,12,ATACTTTAAAAGAAAACAGC,0,1180566
fldAp,0.07692307692307693,12,12,ATACGGTCGCATCTCGCTAA,0,1071053
fldAp,0.07692307692307693,12,12,ATAATAAACTCAAGAGGCGA,0,1163171
fldAp,0.07692307692307693,12,12,ATAACTCAACGACCCGGCTT,0,1086074
fldAp,0.07692307692307693,12,12,AGTTTAGGAGCCAAAAGGTT,0,1090029
fldAp,0.07692307692307693,12,12,AGTTGGGTTCGACGGGTTGA,0,1122531
fldAp,0.07692307692307693,12,12,AGTTCGTCAAAACCGTACGC,0,1168148
fldAp,0.07692307692307693,12,12,AGTTCAATGTTTTACGATCA,0,1079426
fldAp,0.07692307692307693,12,12,AGTTAGGAGAGGAGTAACGA,0,1072596
fldAp,0.07692307692307693,12,12,AGTGGCAGCGGGAGGTCAGG,0,1080178
fldAp,0.07692307692307693,12,12,AGTGAAGCCAACGATCTGAT,0,1163854
fldAp,0.07692307692307693,12,12,AGTATAGCCGGCTGGCCTGT,0,1099826
fldAp,0.07692307692307693,12,12,AGTAAGGGACCCAGGTCCTT,0,1111732
fldAp,0.07692307692307693,12,12,AGGTCGCCAGCTATTAGAGT,0,1165697
fldAp,0.07692307692307693,12,12,AGGGTGAGCATAACCTATGG,0,1089702
fldAp,0.07692307692307693,12,12,AGGGCCATCACATTGTGTCT,0,1117465
fldAp,0.07692307692307693,12,12,AGGCTTGGAGGCATTAATTG,0,1096752
fldAp,0.07692307692307693,12,12,AGGCGTGTCCCCAAATACCA,0,1157294
fldAp,0.07692307692307693,12,12,AGGCCTTTAGGGGTATGCTG,0,1150910
fldAp,0.07692307692307693,12,12,AGGCAGCGGATTTCATACGT,0,1117010
fldAp,0.07692307692307693,12,12,AGGACGAATCCAGAGCTGTA,0,1098305
fldAp,0.07692307692307693,12,12,AGCTGAAGAACCTGCCGAAG,0,1080081
fldAp,0.07692307692307693,12,12,AGCGCTTTGCCGGAATGTGC,0,1158552
fldAp,0.07692307692307693,12,12,AGCGCCCGATGAAATCTTCC,0,1166731
fldAp,0.07692307692307693,12,12,AGCGACAATGCACAAACTGT,0,1154358
fldAp,0.07692307692307693,12,12,AGCGAATAGGGCGGTAGGTT,0,1104430
fldAp,0.07692307692307693,12,12,AGCCGATTAATGAAAAAGCA,0,1088600
fldAp,0.07692307692307693,12,12,AGCCCACCAGAGTTGGAATA,0,1131056
fldAp,0.07692307692307693,12,12,AGCCATCCGCTTGGGGTATA,0,1102099
fldAp,0.07692307692307693,12,12,AGCATTCAAAGTGCGTGGTT,0,1079024
fldAp,0.07692307692307693,12,12,AGATTTAATCTGGGGCCGAT,0,1075892
fldAp,0.07692307692307693,12,12,AGATTCCTCTCACAGTCGTG,0,1179726
fldAp,0.07692307692307693,12,12,AGATGGTATAACATTTGACA,0,1120848
fldAp,0.07692307692307693,12,12,AGATGCCAGCTTCAGAAATG,0,1119465
fldAp,0.07692307692307693,12,12,AGATCTGGGTGCGTGCGAGG,0,1095909
fldAp,0.07692307692307693,12,12,AGATCAGGGAGCAATGCAGT,0,1164530
fldAp,0.07692307692307693,12,12,AGAGCTGGACTATACATTGA,0,1130206
fldAp,0.07692307692307693,12,12,AGACGAAATTCGCTTAGCCC,0,1066837
fldAp,0.07692307692307693,12,12,AGACATGTGTCAGACACTTG,0,1125808
fldAp,0.07692307692307693,12,12,AGACATATCTGCTGGGGACC,0,1154502
fldAp,0.07692307692307693,12,12,ACTGTGGCGCGGGAGCTCTC,0,1133547
fldAp,0.07692307692307693,12,12,ACTGGCGGGACCAGGGCCGT,0,1159621
fldAp,0.07692307692307693,12,12,ACTGCATGTCCTACCCCGCT,0,1091623
fldAp,0.07692307692307693,12,12,ACTATAAACTACACGCGACC,0,1107546
fldAp,0.07692307692307693,12,12,ACTAAATGAGAGCACATTTC,0,1179804
fldAp,0.07692307692307693,12,12,ACGTTTAACAACGCCAATAC,0,1088586
fldAp,0.07692307692307693,12,12,ACGTTCGCACATCCTTAGCT,0,1117864
fldAp,0.07692307692307693,12,12,ACGGTTTGCAATTAGGGTAC,0,1184078
fldAp,0.07692307692307693,12,12,ACGGAACTGGCTGGGAAGTA,0,1139224
fldAp,0.07692307692307693,12,12,ACGCGATTTGGGCAAGTAGG,0,1160575
fldAp,0.07692307692307693,12,12,ACGCATAGTACGCCAACGGT,0,1079202
fldAp,0.07692307692307693,12,12,ACGCACGGAGGTAACACCCT,0,1086262
fldAp,0.07692307692307693,12,12,ACCTTCGTGTAGTTATCGCG,0,1134822
fldAp,0.07692307692307693,12,12,ACCTGTCCCAGGACGCGTAA,0,1122555
fldAp,0.07692307692307693,12,12,ACCTCTGGGCGATCCCGTAT,0,1180040
fldAp,0.07692307692307693,12,12,ACCGTGCCCTCTTAGGACCT,0,1122505
fldAp,0.07692307692307693,12,12,ACCGTGATTTAGAATGCATG,0,1118883
fldAp,0.07692307692307693,12,12,ACCGTGACTTTATTTTCGAC,0,1093299
fldAp,0.07692307692307693,12,12,ACCGACACGCGGTATGTTGC,0,1136013
fldAp,0.07692307692307693,12,12,ACCCTTAATGATTAATCCGG,0,1102684
fldAp,0.07692307692307693,12,12,ACCCTGAGGTGATAGTCCAA,0,1087485
fldAp,0.07692307692307693,12,12,ACCCGGAGCCTGTATTGCTC,0,1121855
fldAp,0.07692307692307693,12,12,ACCCGCCGTGTGGTGGAAGT,0,1113888
fldAp,0.07692307692307693,12,12,ACCCAACGGTACTATTAGTA,0,1134320
fldAp,0.07692307692307693,12,12,ACCACGTAATGGGAGGCGAA,0,1087428
fldAp,0.07692307692307693,12,12,ACCAACTTGATACCCTTTTG,0,1159645
fldAp,0.07692307692307693,12,12,ACATGCGCGACACCCAAGGT,0,1077461
fldAp,0.07692307692307693,12,12,ACATCAGGAAGTCTAGCAAG,0,1126418
fldAp,0.07692307692307693,12,12,ACAGTAGTTAGAACGTGGGA,0,1067202
fldAp,0.07692307692307693,12,12,ACAGTAAATTTATCCGTGCG,0,1145522
fldAp,0.07692307692307693,12,12,ACAGCGACCCGGACACTATG,0,1177301
fldAp,0.07692307692307693,12,12,ACACTAACGGGAAATTACGG,0,1099485
fldAp,0.07692307692307693,12,12,ACACGTATGCCTAGTGTCTG,0,1181735
fldAp,0.07692307692307693,12,12,ACACCCCAGCCCAACTCCCC,0,1104226
fldAp,0.07692307692307693,12,12,ACAATCGGTTGGGCTCGCAG,0,1102537
fldAp,0.07692307692307693,12,12,AATTCCGACGGCGACACGAG,0,1064157
fldAp,0.07692307692307693,12,12,AATTCAATCTGCATGATGCA,0,1151685
fldAp,0.07692307692307693,12,12,AATGTTGGACTCCTGGGCGT,0,1097157
fldAp,0.07692307692307693,12,12,AATGGTGCCGGGGGCTTAAG,0,1087597
fldAp,0.07692307692307693,12,12,AATGATGGGGTGCATTGGTA,0,1102518
fldAp,0.07692307692307693,12,12,AATGACATAAGCGCCTGGGA,0,1107619
fldAp,0.07692307692307693,12,12,AATCCGGTTCAAGACGCGCA,0,1107877
fldAp,0.07692307692307693,12,12,AATAGGCAGGAGGAAGACGA,0,1104449
fldAp,0.07692307692307693,12,12,AATACTTTGCCGCACCGAGT,0,1121926
fldAp,0.07692307692307693,12,12,AATACTTGTGACCTCATCGT,0,1123650
fldAp,0.07692307692307693,12,12,AATACAGTAGTCACGTTAAA,0,1120683
fldAp,0.07692307692307693,12,12,AAGTTTGGGAGAGCCCTGCC,0,1143191
fldAp,0.07692307692307693,12,12,AAGTTCGAATTCCAACGCGC,0,1142126
fldAp,0.07692307692307693,12,12,AAGTTATTCCTACTCAATAC,0,1156126
fldAp,0.07692307692307693,12,12,AAGTGTGGTCGGTATCATAA,0,1167573
fldAp,0.07692307692307693,12,12,AAGTGGTGCCTAAGGGCGGC,0,1125166
fldAp,0.07692307692307693,12,12,AAGTCGAAGGATACCCATGG,0,1100654
fldAp,0.07692307692307693,12,12,AAGGCTTTAGGCTTAGAATA,0,1129848
fldAp,0.07692307692307693,12,12,AAGGCTCCACGGGGTACGAC,0,1178173
fldAp,0.07692307692307693,12,12,AAGGAAGGCGGAAATAGTCA,0,1106864
fldAp,0.07692307692307693,12,12,AAGCCGAAGGATTCGTACTC,0,1136837
fldAp,0.07692307692307693,12,12,AAGCCATCCGCCGCATCGGA,0,1171975
fldAp,0.07692307692307693,12,12,AACTACTAACGTAGACCCGG,0,1108263
fldAp,0.07692307692307693,12,12,AACGGTTCAGTGATGCTCAT,0,1125342
fldAp,0.07692307692307693,12,12,AACCGTCGGTTGATTCGAAA,0,1120222
fldAp,0.07692307692307693,12,12,AACATTCAGTGCGTTCAAAG,0,1133729
fldAp,0.07692307692307693,12,12,AACATCGTTAAAGGAGCTAA,0,1150565
fldAp,0.07692307692307693,12,12,AACATATGCCTTGGTACTTT,0,1185395
fldAp,0.07692307692307693,12,12,AACAGTTGTTCAAATAGAGT,0,1090905
fldAp,0.07692307692307693,12,12,AACAACCTGCCGATTCGCCT,0,1110929
fldAp,0.07692307692307693,12,12,AACAAAATAGAGGGCCTCAA,0,1119884
fldAp,0.07692307692307693,12,12,AAATGTCTAAGTTTGAAGTT,0,1091921
fldAp,0.07692307692307693,12,12,AAATCGGGGGACGCTTCTGA,0,1142675
fldAp,0.07692307692307693,12,12,AAATATGCCAGAGTTTGACA,0,1183123
fldAp,0.07692307692307693,12,12,AAATATAGAGCTAATGAGGG,0,1118516
fldAp,0.07692307692307693,12,12,AAAGTTGCCCGGGGGTCACT,0,1176091
fldAp,0.07692307692307693,12,12,AAAGTACAGATGTGGACAAC,0,1068938
fldAp,0.07692307692307693,12,12,AAAGGCGCGTCTGTGGCTAC,0,1067783
fldAp,0.07692307692307693,12,12,AAAGCACATATAAACGGGAA,0,1167534
fldAp,0.07692307692307693,12,12,AAAGATCAGTGGGGTGATAC,0,1124100
fldAp,0.07692307692307693,12,12,AAACTTTATGTCTGTTCTAG,0,1152466
fldAp,0.07692307692307693,12,12,AAAATTTTCATCTAGTCAGG,0,1163740
fldAp,0.07692307692307693,12,12,AAAAGTTGCCAATTGAAACG,0,1138816
fldAp,0.08333333333333333,11,11,TTTTTTGAAATCTTCCCATA,0,1073520
fldAp,0.08333333333333333,11,11,TTTTTCACTAATGATTATAC,0,1111153
fldAp,0.08333333333333333,11,11,TTTTCCTGGTAGCTCGTCCC,0,1177232
fldAp,0.08333333333333333,11,11,TTTTCCAATTTTAGCGAATT,0,1088077
fldAp,0.08333333333333333,11,11,TTTTACCTGGCAAGTAGGGA,0,1094375
fldAp,0.08333333333333333,11,11,TTTGTGATGTGGCCATGCGC,0,1160568
fldAp,0.08333333333333333,11,11,TTTGAGTTCCTCTGGGGCTT,0,1079796
fldAp,0.08333333333333333,11,11,TTTGAGTCGGAAACGCTCCT,0,1096192
fldAp,0.08333333333333333,11,11,TTTGACAATGATTCTGCGAC,0,1123183
fldAp,0.08333333333333333,11,11,TTTCGCAATGAAGCACAGAA,0,1106586
fldAp,0.08333333333333333,11,11,TTTCCTTAAACTTTGCAACG,0,1180090
fldAp,0.08333333333333333,11,11,TTTCCTATAACGTCAAACGT,0,1173234
fldAp,0.08333333333333333,11,11,TTTCCCGTGGTGAGCATATT,0,1167918
fldAp,0.08333333333333333,11,11,TTTAGCCGTGTGGAATGTAA,0,1096709
fldAp,0.08333333333333333,11,11,TTTACAGTGTTAGGCCAGAG,0,1174662
fldAp,0.08333333333333333,11,11,TTTAAGCATTTCCCTTTTGC,0,1155049
fldAp,0.08333333333333333,11,11,TTGTTTCCCCTCTGGACGCA,0,1124035
fldAp,0.08333333333333333,11,11,TTGTGGTAGATACGGCACTA,0,1097770
fldAp,0.08333333333333333,11,11,TTGTCTCGAATAGTGAGGAT,0,1150644
fldAp,0.08333333333333333,11,11,TTGTCGAAGCAAATGACCGA,0,1142058
fldAp,0.08333333333333333,11,11,TTGTAGTAGCCCCCAGTTGT,0,1110677
fldAp,0.08333333333333333,11,11,TTGTAAAGCATGGTGTGCAG,0,1174144
fldAp,0.08333333333333333,11,11,TTGGCTGAAACCGCCATGTT,0,1150159
fldAp,0.08333333333333333,11,11,TTGGAGTGTTTGCTACTGTT,0,1155453
fldAp,0.08333333333333333,11,11,TTGCGTCTTTTTATGGTGTA,0,1086391
fldAp,0.08333333333333333,11,11,TTGCACAAAGCCGCTCCTGC,0,1170317
fldAp,0.08333333333333333,11,11,TTGATAGATTCTGGGGACGT,0,1128895
fldAp,0.08333333333333333,11,11,TTGAGCGGGGCATCTGCCTC,0,1178011
fldAp,0.08333333333333333,11,11,TTGAGCACGGTTGTGCAAAA,0,1143539
fldAp,0.08333333333333333,11,11,TTGACCCAAGTCGCCGCGAA,0,1069293
fldAp,0.08333333333333333,11,11,TTCTGGCGTGCATAAAGATG,0,1167777
fldAp,0.08333333333333333,11,11,TTCTGCTGGATCTTGAAACT,0,1109802
fldAp,0.08333333333333333,11,11,TTCTCGTCATCAGCCACCGA,0,1107847
fldAp,0.08333333333333333,11,11,TTCTCCGTCAACCTAGACTA,0,1064934
fldAp,0.08333333333333333,11,11,TTCTCAGGGTATAGGTCCGG,0,1133490
fldAp,0.08333333333333333,11,11,TTCGTGGTGGCCTATACGAG,0,1158534
fldAp,0.08333333333333333,11,11,TTCGATTTCCTATCGGTGGT,0,1106419
fldAp,0.08333333333333333,11,11,TTCGAGATCGGAGACCTTGA,0,1106320
fldAp,0.08333333333333333,11,11,TTCGACACGTAAGAGGTGCA,0,1108469
fldAp,0.08333333333333333,11,11,TTCGAACAAGGTTCTTCGCA,0,1080587
fldAp,0.08333333333333333,11,11,TTCCGCAGTGGCTTACGCCA,0,1143684
fldAp,0.08333333333333333,11,11,TTCCCGTGCATTAGGCCATA,0,1157704
fldAp,0.08333333333333333,11,11,TTCCAGACGGCATCATGACA,0,1106206
fldAp,0.08333333333333333,11,11,TTCATTTCCCGTCTCTGTTA,0,1063086
fldAp,0.08333333333333333,11,11,TTCAGTGAAAAGAGGGATAC,0,1136177
fldAp,0.08333333333333333,11,11,TTCACAGTAGACCAATCGAT,0,1144189
fldAp,0.08333333333333333,11,11,TTCACAATGTTATCTCGCTT,0,1165773
fldAp,0.08333333333333333,11,11,TTCACAAGTTAGCAGTGTCG,0,1125567
fldAp,0.08333333333333333,11,11,TTATTCTTATGAACGGTATA,0,1104876
fldAp,0.08333333333333333,11,11,TTATGACACAGCATGGCAGA,0,1157527
fldAp,0.08333333333333333,11,11,TTATGAAGGCATTAACGAGC,0,1109407
fldAp,0.08333333333333333,11,11,TTAAGGTGGCGATGGTCTGA,0,1112038
fldAp,0.08333333333333333,11,11,TTAACTCCACAGTCCTCGGA,0,1106066
fldAp,0.08333333333333333,11,11,TTAAAGCTCTCTACAGTGTT,0,1095767
fldAp,0.08333333333333333,11,11,TGTTTACTCCGGAACACCTA,0,1133287
fldAp,0.08333333333333333,11,11,TGTTCGAGATAGGTAATTTA,0,1065799
fldAp,0.08333333333333333,11,11,TGTTCGACTAAAGATTATTT,0,1070931
fldAp,0.08333333333333333,11,11,TGTGCCACGTAAGCCGGTGA,0,1171665
fldAp,0.08333333333333333,11,11,TGTGAGAACAACCTGAAACC,0,1063361
fldAp,0.08333333333333333,11,11,TGTCTCCAATCACTTGAAGT,0,1163513
fldAp,0.08333333333333333,11,11,TGTAAACAAATCCCCACAGG,0,1167452
fldAp,0.08333333333333333,11,11,TGGTGAGATGGGGATCAAAA,0,1165371
fldAp,0.08333333333333333,11,11,TGGTAAGGCATCGAAGAATT,0,1139575
fldAp,0.08333333333333333,11,11,TGGGGTGATACTCCGAACGT,0,1129613
fldAp,0.08333333333333333,11,11,TGGGAGCAATAATCTAGGCA,0,1071677
fldAp,0.08333333333333333,11,11,TGGCACCAGGTAGGCTGTTT,0,1152695
fldAp,0.08333333333333333,11,11,TGGATGGGATAGGCCGCTCT,0,1164700
fldAp,0.08333333333333333,11,11,TGGATCCGTCGGAGGCACGA,0,1081710
fldAp,0.08333333333333333,11,11,TGGAATTTGTACTCGACAAA,0,1090045
fldAp,0.08333333333333333,11,11,TGGAAGGGAGGGTATGATCA,0,1123457
fldAp,0.08333333333333333,11,11,TGCGTTTTATCGTGGCCCAC,0,1156425
fldAp,0.08333333333333333,11,11,TGCGATAGTTGTTGTGCGTC,0,1144329
fldAp,0.08333333333333333,11,11,TGCGAGCGCCCCGGACCACT,0,1072608
fldAp,0.08333333333333333,11,11,TGCCTTATATTGTTTATTTA,0,1149871
fldAp,0.08333333333333333,11,11,TGCAGGGAGTAGAGGACGTA,0,1171490
fldAp,0.08333333333333333,11,11,TGCAGCTTATGAAAACGCCT,0,1127507
fldAp,0.08333333333333333,11,11,TGATTGTCAGACTTTGAAGG,0,1108172
fldAp,0.08333333333333333,11,11,TGATTCTTCACGTAGGCGCC,0,1076954
fldAp,0.08333333333333333,11,11,TGATGCCCAATCCGTCATTA,0,1173456
fldAp,0.08333333333333333,11,11,TGATGACACGGTGGAGGTTG,0,1163082
fldAp,0.08333333333333333,11,11,TGACTAGGCCGTCGAGACAT,0,1134237
fldAp,0.08333333333333333,11,11,TCTTTATGATTAGCGCCAAG,0,1119747
fldAp,0.08333333333333333,11,11,TCTTTAGATTAGCGCTTGTG,0,1086862
fldAp,0.08333333333333333,11,11,TCTTGGCGGTCGGCGTTATG,0,1158987
fldAp,0.08333333333333333,11,11,TCTTCGGAAGCAAAAGTAGG,0,1146227
fldAp,0.08333333333333333,11,11,TCTTCGCTCGCTCGCGGGAC,0,1137062
fldAp,0.08333333333333333,11,11,TCTGTACTTATCTAAGCTGG,0,1132775
fldAp,0.08333333333333333,11,11,TCTCTGCGTTAAGCGCGTGG,0,1070602
fldAp,0.08333333333333333,11,11,TCTCGGTATGACAAACTCCA,0,1137663
fldAp,0.08333333333333333,11,11,TCTCCGGCGTTAAGGTTACC,0,1107322
fldAp,0.08333333333333333,11,11,TCTCCGGAAGGTGATTAATC,0,1179653
fldAp,0.08333333333333333,11,11,TCTCCATGCGGAAAATCCAG,0,1152761
fldAp,0.08333333333333333,11,11,TCTATAGGCGCCGGTTACAT,0,1184183
fldAp,0.08333333333333333,11,11,TCTACTGCAAAGGCGGACAA,0,1170455
fldAp,0.08333333333333333,11,11,TCGTTCTTGGCTAGTATCCA,0,1129334
fldAp,0.08333333333333333,11,11,TCGTGATGGGGGTCTTCGGG,0,1072978
fldAp,0.08333333333333333,11,11,TCGTATTTGGGGTCGGCGTG,0,1092749
fldAp,0.08333333333333333,11,11,TCGGTTTAATCGTCCACACA,0,1095869
fldAp,0.08333333333333333,11,11,TCGGTCACATGGAGGACCAC,0,1151566
fldAp,0.08333333333333333,11,11,TCGGTATATGTCGTACTATG,0,1063240
fldAp,0.08333333333333333,11,11,TCGGGCCACCTTGTAAATCA,0,1111058
fldAp,0.08333333333333333,11,11,TCGGCGACCGTAGATATCCT,0,1182733
fldAp,0.08333333333333333,11,11,TCGCTTTACCATCTTGCACA,0,1136964
fldAp,0.08333333333333333,11,11,TCGCCACCGCTGGGTCTGGG,0,1154178
fldAp,0.08333333333333333,11,11,TCGCAAGCGACTTCTCGTGA,0,1096625
fldAp,0.08333333333333333,11,11,TCGATAATCCGATCCGTTTA,0,1085937
fldAp,0.08333333333333333,11,11,TCCGTATATAAGCTTAGGGT,0,1179159
fldAp,0.08333333333333333,11,11,TCCGGCGATCCGGTTTAGCC,0,1181243
fldAp,0.08333333333333333,11,11,TCCGGATGTCGGTTCGTCGG,0,1066140
fldAp,0.08333333333333333,11,11,TCCGCTTTGACCAATGGACA,0,1093764
fldAp,0.08333333333333333,11,11,TCCCTCTAGCATAGTTACTT,0,1067032
fldAp,0.08333333333333333,11,11,TCCCTACCAGTAGTCGGCGT,0,1182141
fldAp,0.08333333333333333,11,11,TCCCACACGTCTTTTGTGTA,0,1087556
fldAp,0.08333333333333333,11,11,TCATTCAACTAAGACGCTAT,0,1139882
fldAp,0.08333333333333333,11,11,TCATAGATGTCCCTCCAGGA,0,1073544
fldAp,0.08333333333333333,11,11,TCATACGATGCACAATATTA,0,1138925
fldAp,0.08333333333333333,11,11,TCAGGTGTTCTAGGTTGGAA,0,1176126
fldAp,0.08333333333333333,11,11,TCAGACTCGGGGAGGAAATT,0,1125612
fldAp,0.08333333333333333,11,11,TCACTAGGATTCCCGGGAAA,0,1165167
fldAp,0.08333333333333333,11,11,TCACTAAGCAACGGTAATTT,0,1177452
fldAp,0.08333333333333333,11,11,TCACGCGGTGAACACGGGAT,0,1155705
fldAp,0.08333333333333333,11,11,TCACCGGTGTGCCAACTGTT,0,1176771
fldAp,0.08333333333333333,11,11,TCAATTAGGAGGTTTGAATA,0,1186865
fldAp,0.08333333333333333,11,11,TATTTTCAGTTGTTCATTGT,0,1142824
fldAp,0.08333333333333333,11,11,TATTGCGTGAGGCGCTAATA,0,1063331
fldAp,0.08333333333333333,11,11,TATTCGGGTCTTATCCCAGG,0,1153149
fldAp,0.08333333333333333,11,11,TATGGGCAAGAAAGCTTTGT,0,1174723
fldAp,0.08333333333333333,11,11,TATATGTACGTATATGGACT,0,1177724
fldAp,0.08333333333333333,11,11,TATATCGACCTTCTGTGCGA,0,1181578
fldAp,0.08333333333333333,11,11,TATATCAAAATGACCAAAGC,0,1100379
fldAp,0.08333333333333333,11,11,TAGTCCCCTATACTCAGAGG,0,1157106
fldAp,0.08333333333333333,11,11,TAGTATGGGGGGTGACATAG,0,1093619
fldAp,0.08333333333333333,11,11,TAGGGGCGGCGAAGGTTTGT,0,1145983
fldAp,0.08333333333333333,11,11,TAGGGATTTAAGCTCGAGCA,0,1084749
fldAp,0.08333333333333333,11,11,TAGGGAGACGTACGGCCACT,0,1161338
fldAp,0.08333333333333333,11,11,TAGGCCTCCTGATCGAAGCA,0,1130220
fldAp,0.08333333333333333,11,11,TAGGCCCACCGCGGTCCGCG,0,1106934
fldAp,0.08333333333333333,11,11,TAGGCAGCCCATCGTACCTC,0,1083435
fldAp,0.08333333333333333,11,11,TAGCTACAGAGTCACTTAGA,0,1078232
fldAp,0.08333333333333333,11,11,TAGCGCAGTCCGCGTCAGCG,0,1142820
fldAp,0.08333333333333333,11,11,TAGCACCATTAAGTGTGCAT,0,1088408
fldAp,0.08333333333333333,11,11,TAGAGCTCGTTTAAGTCCCT,0,1104208
fldAp,0.08333333333333333,11,11,TACTTTCGCACCGGAGTCAG,0,1110938
fldAp,0.08333333333333333,11,11,TACGTTCATCGAACCACTTC,0,1104758
fldAp,0.08333333333333333,11,11,TACGTCTGATACGCGGTCAT,0,1159138
fldAp,0.08333333333333333,11,11,TACGGGTACGCTTTAGGATC,0,1067723
fldAp,0.08333333333333333,11,11,TACGCGCGCCTGCCCCTTAA,0,1158527
fldAp,0.08333333333333333,11,11,TACCGTAGCCCCGCACTAAG,0,1071056
fldAp,0.08333333333333333,11,11,TACCCTCAGGCACGGCTAAT,0,1149303
fldAp,0.08333333333333333,11,11,TACATATTGCATGACAATTG,0,1164038
fldAp,0.08333333333333333,11,11,TACACCGGTATCTTGCATGT,0,1125869
fldAp,0.08333333333333333,11,11,TAATTTCGATACTTCTTCGG,0,1115359
fldAp,0.08333333333333333,11,11,TAATGCTCTAGTCAGTGCTC,0,1110055
fldAp,0.08333333333333333,11,11,TAACCCATGTGAGCGAGAAT,0,1124532
fldAp,0.08333333333333333,11,11,TAAACTGACCGGGCATACGG,0,1083652
fldAp,0.08333333333333333,11,11,TAAACGGATGAAGTTGGTCC,0,1083360
fldAp,0.08333333333333333,11,11,GTTTTGAAAAAAGCTAGGAG,0,1147933
fldAp,0.08333333333333333,11,11,GTTTATCGGCGGCCCAGGTG,0,1089803
fldAp,0.08333333333333333,11,11,GTTCGTACATCTGGATGTAC,0,1083247
fldAp,0.08333333333333333,11,11,GTTATCATGAATCCTGACAA,0,1093216
fldAp,0.08333333333333333,11,11,GTTAGAATACGCCTCAGACC,0,1147776
fldAp,0.08333333333333333,11,11,GTTAAGCCCGCAACTTAAAC,0,1065652
fldAp,0.08333333333333333,11,11,GTGTGTTTCCAAAATGTTTA,0,1121297
fldAp,0.08333333333333333,11,11,GTGTGTTCGATCGGGTAAAA,0,1139056
fldAp,0.08333333333333333,11,11,GTGGCGACTCTACGAAATAT,0,1148578
fldAp,0.08333333333333333,11,11,GTGCTTTGAACGCTAAGCCA,0,1108974
fldAp,0.08333333333333333,11,11,GTGCTCTGTACAGCAGTATT,0,1165046
fldAp,0.08333333333333333,11,11,GTGCGGCCCAGAGTCACTGG,0,1136291
fldAp,0.08333333333333333,11,11,GTGCCAAGTTCCTAAGTGGG,0,1161872
fldAp,0.08333333333333333,11,11,GTGCAAGGCAGGGCGGGGCG,0,1072028
fldAp,0.08333333333333333,11,11,GTGAGTCAGCTTCGAGGCGC,0,1164554
fldAp,0.08333333333333333,11,11,GTGACGCGTAAGGAGTAAGT,0,1106213
fldAp,0.08333333333333333,11,11,GTCTACTTCTGTTTTTCCGT,0,1145840
fldAp,0.08333333333333333,11,11,GTCTACACTAGGCAGCATAA,0,1126389
fldAp,0.08333333333333333,11,11,GTCGGAGTATCTGAGTCATT,0,1185016
fldAp,0.08333333333333333,11,11,GTCCTAAAACTACTTAAGTA,0,1090522
fldAp,0.08333333333333333,11,11,GTCCGGTGCCGTCGCCCCAA,0,1128746
fldAp,0.08333333333333333,11,11,GTCCGCGAGTAGCACAATAG,0,1114101
fldAp,0.08333333333333333,11,11,GTCCCGCATGCTGTAGATCT,0,1162791
fldAp,0.08333333333333333,11,11,GTCAGGTGTTTGGCGGGGAT,0,1104682
fldAp,0.08333333333333333,11,11,GTCACGCCCGCTAAGGCAGC,0,1099161
fldAp,0.08333333333333333,11,11,GTCACCAATCCGTATCGGTT,0,1081834
fldAp,0.08333333333333333,11,11,GTCACATCCTTTCGTTCCGT,0,1133724
fldAp,0.08333333333333333,11,11,GTATCTGTTGCCAATGTAAT,0,1136579
fldAp,0.08333333333333333,11,11,GTACTCAATGCGTCTTTGGA,0,1086242
fldAp,0.08333333333333333,11,11,GTACTAGAGTCGGGCCGCGC,0,1180140
fldAp,0.08333333333333333,11,11,GTACGAAGCCGCTCGGCTAC,0,1135085
fldAp,0.08333333333333333,11,11,GTACATAAATTTGATGCAAG,0,1122718
fldAp,0.08333333333333333,11,11,GTACACTTGATCGGCCATAG,0,1134466
fldAp,0.08333333333333333,11,11,GTAAGAAGTAAGCTATCCCT,0,1172798
fldAp,0.08333333333333333,11,11,GTAACTGCTTCTCTATGCGT,0,1167155
fldAp,0.08333333333333333,11,11,GGTTGCGATTTGCACGGCTG,0,1092210
fldAp,0.08333333333333333,11,11,GGTTGCCGCCCCTCCATTAT,0,1118743
fldAp,0.08333333333333333,11,11,GGTTGCCCCGTGGCTTTGGC,0,1093142
fldAp,0.08333333333333333,11,11,GGTTGAGGTCCTACCATGCA,0,1085838
fldAp,0.08333333333333333,11,11,GGTTCGGTGGGCCTTTCGAT,0,1122969
fldAp,0.08333333333333333,11,11,GGTTCCGTCAGGCTGAATAA,0,1112796
fldAp,0.08333333333333333,11,11,GGTTATGTAGAAGAGCCATT,0,1084036
fldAp,0.08333333333333333,11,11,GGTTACGAGACGATTGGCTA,0,1110686
fldAp,0.08333333333333333,11,11,GGTTAATGTTTGTCGCGTGT,0,1161104
fldAp,0.08333333333333333,11,11,GGTGTATCTTGATTGGCATA,0,1143119
fldAp,0.08333333333333333,11,11,GGTGGTCAGGAGTCCACATC,0,1123157
fldAp,0.08333333333333333,11,11,GGTGCTGCTCCCTTTTCCCG,0,1068444
fldAp,0.08333333333333333,11,11,GGTGATTGCCTGATGGCGAG,0,1179745
fldAp,0.08333333333333333,11,11,GGTCGTACAATCGGTGAAGT,0,1065446
fldAp,0.08333333333333333,11,11,GGTCGAACACTGTTAGGTTT,0,1150153
fldAp,0.08333333333333333,11,11,GGTATATCGCGTCAATAATG,0,1136587
fldAp,0.08333333333333333,11,11,GGTAGTGTAAACAGAATCAC,0,1100578
fldAp,0.08333333333333333,11,11,GGTAGGGGTGTACTCAGCCT,0,1147412
fldAp,0.08333333333333333,11,11,GGTAGAGAAGTACAGATCCA,0,1155450
fldAp,0.08333333333333333,11,11,GGTACAACGGATGACTATTG,0,1083480
fldAp,0.08333333333333333,11,11,GGGTTTACCGTCAATGTTAG,0,1098567
fldAp,0.08333333333333333,11,11,GGGTTCCAGAAGTCCTGCAG,0,1134030
fldAp,0.08333333333333333,11,11,GGGTGTAGTTGATACCCCGT,0,1163058
fldAp,0.08333333333333333,11,11,GGGTCAATTACTGTTGTGTC,0,1161282
fldAp,0.08333333333333333,11,11,GGGGTCCGACAGCCGATTGA,0,1079716
fldAp,0.08333333333333333,11,11,GGGGGATGACTTGCGGTATT,0,1130730
fldAp,0.08333333333333333,11,11,GGGGAATTCCATCAAGCTTT,0,1122724
fldAp,0.08333333333333333,11,11,GGGCGCTCTGTAAGTACCAG,0,1141001
fldAp,0.08333333333333333,11,11,GGGCGAGGGTTCTTCTAAGG,0,1162981
fldAp,0.08333333333333333,11,11,GGGCCGTTCCTCCTAATAGT,0,1122498
fldAp,0.08333333333333333,11,11,GGGCAATCGTTTGAAACTCT,0,1142068
fldAp,0.08333333333333333,11,11,GGGAGAGCGTTTATGACAGA,0,1123513
fldAp,0.08333333333333333,11,11,GGGAGACCTACCGGTCAAAT,0,1147105
fldAp,0.08333333333333333,11,11,GGGAACACACCGAATTATAA,0,1155352
fldAp,0.08333333333333333,11,11,GGCTGTCCGCTCGGGAACAC,0,1139481
fldAp,0.08333333333333333,11,11,GGCTGCCCATTTAGCGTTGT,0,1166926
fldAp,0.08333333333333333,11,11,GGCTCCATCACCGCCAGTAC,0,1172574
fldAp,0.08333333333333333,11,11,GGCTACAACAAAAGAAGCGA,0,1112583
fldAp,0.08333333333333333,11,11,GGCGTTCGCCATTTCGATTT,0,1129418
fldAp,0.08333333333333333,11,11,GGCGCACACTAAGCTTTTCT,0,1068233
fldAp,0.08333333333333333,11,11,GGCCGCCTTTGCATGGACAG,0,1135762
fldAp,0.08333333333333333,11,11,GGCAATATGAGGTAACGTGA,0,1103822
fldAp,0.08333333333333333,11,11,GGCAACCCTCCGCGCAATGT,0,1180610
fldAp,0.08333333333333333,11,11,GGATATTCTGTGGAGGCGAA,0,1113677
fldAp,0.08333333333333333,11,11,GGATATTCGTATAAGGAGAC,0,1156915
fldAp,0.08333333333333333,11,11,GGACTTTGAACTAGCGACAT,0,1147536
fldAp,0.08333333333333333,11,11,GGACTATGAAATAACTATTG,0,1183953
fldAp,0.08333333333333333,11,11,GGACAACGCGGAGAGGTTGT,0,1103259
fldAp,0.08333333333333333,11,11,GGAATTTGCAGGGGCCTAAA,0,1171271
fldAp,0.08333333333333333,11,11,GGAAGTGGGACATCCATGTT,0,1108856
fldAp,0.08333333333333333,11,11,GGAAGGCCAGGGTGTTCCTT,0,1142174
fldAp,0.08333333333333333,11,11,GGAAGAGTCACAACAGTATC,0,1127436
fldAp,0.08333333333333333,11,11,GGAACTGAGCATGCGGCCCC,0,1171625
fldAp,0.08333333333333333,11,11,GGAAACCAATTTTTTTATAT,0,1099571
fldAp,0.08333333333333333,11,11,GGAAACAGTTTTGCGAGAAA,0,1069374
fldAp,0.08333333333333333,11,11,GCTTGACGGATGACGGGAAT,0,1137732
fldAp,0.08333333333333333,11,11,GCTTCGCAGTGGCGTTTCCG,0,1181218
fldAp,0.08333333333333333,11,11,GCTTCCGTCATGCCCTCCAA,0,1127221
fldAp,0.08333333333333333,11,11,GCTTCCACTGGTATGTAGCT,0,1080005
fldAp,0.08333333333333333,11,11,GCTTACTCATACTGCTCGAG,0,1169365
fldAp,0.08333333333333333,11,11,GCTTAAGCCCTACCCTGCAG,0,1126735
fldAp,0.08333333333333333,11,11,GCTGTGAAGAGCTAGGATTT,0,1089291
fldAp,0.08333333333333333,11,11,GCTCGGGTCATTAAGTTAGA,0,1149545
fldAp,0.08333333333333333,11,11,GCTCCGATGGAAAAACATAT,0,1171192
fldAp,0.08333333333333333,11,11,GCTCACGTATAGAATGTCAG,0,1077498
fldAp,0.08333333333333333,11,11,GCTAGTGTTGTGCTCACGGG,0,1112817
fldAp,0.08333333333333333,11,11,GCGTTTCAGGTGGAGTAGCT,0,1153001
fldAp,0.08333333333333333,11,11,GCGTTCACACAACTCACAGA,0,1179639
fldAp,0.08333333333333333,11,11,GCGTCGAGCGATGAGGTGAT,0,1068165
fldAp,0.08333333333333333,11,11,GCGTAAAATTCACAACGATC,0,1165057
fldAp,0.08333333333333333,11,11,GCGGGAAGAATCCCGGGTTC,0,1148698
fldAp,0.08333333333333333,11,11,GCGGACTGACGATGTGTGCA,0,1088382
fldAp,0.08333333333333333,11,11,GCGGAAATAAATTTCACGTT,0,1150559
fldAp,0.08333333333333333,11,11,GCGCTACACGCTCGAATGTT,0,1159143
fldAp,0.08333333333333333,11,11,GCGCCGCATGTGGCTCTCAT,0,1135776
fldAp,0.08333333333333333,11,11,GCGCACAGCCCAGGATTGGA,0,1119046
fldAp,0.08333333333333333,11,11,GCGATTCAATGGCATATTAT,0,1092767
fldAp,0.08333333333333333,11,11,GCGAGCGGTGTCTGACCACC,0,1134648
fldAp,0.08333333333333333,11,11,GCGACGGTCCCTTTCCGGAA,0,1144763
fldAp,0.08333333333333333,11,11,GCGAAGGAGTTTTCGCGTCC,0,1169027
fldAp,0.08333333333333333,11,11,GCCTGTAGGGTCAACCCACA,0,1075905
fldAp,0.08333333333333333,11,11,GCCTGAACACAGTCTCCGAT,0,1171638
fldAp,0.08333333333333333,11,11,GCCGCGTTCTCAGTTAGAAT,0,1140496
fldAp,0.08333333333333333,11,11,GCCCGCGGAGGACCTTATGA,0,1098137
fldAp,0.08333333333333333,11,11,GCCCCATCATAATAGCTATA,0,1085612
fldAp,0.08333333333333333,11,11,GCCCACCTTTCCGTTGCACG,0,1099850
fldAp,0.08333333333333333,11,11,GCCACTTCGAGGAGCCGCGT,0,1101876
fldAp,0.08333333333333333,11,11,GCCACGGTACATCTATACTA,0,1084033
fldAp,0.08333333333333333,11,11,GCCACACGGTTCCGCTGTAC,0,1080413
fldAp,0.08333333333333333,11,11,GCATTGGATTACCGTAACAT,0,1175387
fldAp,0.08333333333333333,11,11,GCATGGCTAAGACCTTCGAA,0,1178928
fldAp,0.08333333333333333,11,11,GCATGAGCGTAAACAATAAT,0,1141234
fldAp,0.08333333333333333,11,11,GCATCTCTACGGATTGGTTG,0,1173846
fldAp,0.08333333333333333,11,11,GCATCACTGCTCATTGCCGA,0,1098719
fldAp,0.08333333333333333,11,11,GCATACCCAGGGTTGGTAAA,0,1117229
fldAp,0.08333333333333333,11,11,GCAGCCGAACGCTTTCCCAC,0,1116427
fldAp,0.08333333333333333,11,11,GCAGAGCTTGGTCATAGGTT,0,1175466
fldAp,0.08333333333333333,11,11,GCACTGCTGCCGCATAATAC,0,1106281
fldAp,0.08333333333333333,11,11,GCACTAGAACACCTCCGCGA,0,1165556
fldAp,0.08333333333333333,11,11,GCACCTGACTGTCAACCTTA,0,1071478
fldAp,0.08333333333333333,11,11,GCAATTGCCTGTTACGATGC,0,1068756
fldAp,0.08333333333333333,11,11,GCAATTCCGTCCTTTGATGG,0,1149202
fldAp,0.08333333333333333,11,11,GATTGCTCCCACGGGGTGAT,0,1184310
fldAp,0.08333333333333333,11,11,GATTCTTTGTTAATAGCGTA,0,1112306
fldAp,0.08333333333333333,11,11,GATGTGGTCTTAATCGAAAT,0,1080416
fldAp,0.08333333333333333,11,11,GATGTCATATCATGAATACT,0,1089259
fldAp,0.08333333333333333,11,11,GATGAAACCCGGCGGTTTTT,0,1101684
fldAp,0.08333333333333333,11,11,GATATGGAGCCGTCCTCGCT,0,1169462
fldAp,0.08333333333333333,11,11,GATAGGTTTCAATAATCCAG,0,1176429
fldAp,0.08333333333333333,11,11,GATAGCTGAGTTGTGGATAT,0,1168303
fldAp,0.08333333333333333,11,11,GATACCGAGCATCCGTTAGA,0,1093149
fldAp,0.08333333333333333,11,11,GAGTTATGTCCCGCCGAGAA,0,1105082
fldAp,0.08333333333333333,11,11,GAGTGTTTGTTAACCGGGAT,0,1164112
fldAp,0.08333333333333333,11,11,GAGGCGTCCTTCGGTGAGCA,0,1114308
fldAp,0.08333333333333333,11,11,GAGGCCTGGAAACTAAAATC,0,1139570
fldAp,0.08333333333333333,11,11,GAGCGGTGTCCGGTTCGTTA,0,1076027
fldAp,0.08333333333333333,11,11,GAGCGACACATTCACATCGA,0,1146322
fldAp,0.08333333333333333,11,11,GAGCCTATTTGGCTATGCAT,0,1159832
fldAp,0.08333333333333333,11,11,GAGCCTATACAGAGTGGTTT,0,1077877
fldAp,0.08333333333333333,11,11,GAGCCGCTGGGTGACGGTGA,0,1181742
fldAp,0.08333333333333333,11,11,GAGCACACATATCGACGGTC,0,1162160
fldAp,0.08333333333333333,11,11,GAGATCTCGAGGACCATAAT,0,1150860
fldAp,0.08333333333333333,11,11,GAGATACTGAGTAATATGAA,0,1095747
fldAp,0.08333333333333333,11,11,GAGAGCGTTTTTATTCTGTT,0,1137798
fldAp,0.08333333333333333,11,11,GACTTGTCTTCGTCAGGCGC,0,1120130
fldAp,0.08333333333333333,11,11,GACTCCCGCCTCGTTGCTTC,0,1093878
fldAp,0.08333333333333333,11,11,GACTCCATGCCCAGCAACGG,0,1113890
fldAp,0.08333333333333333,11,11,GACTACCTTGGTACCAAAAC,0,1081746
fldAp,0.08333333333333333,11,11,GACGGTACGGGGGAATTCTG,0,1150661
fldAp,0.08333333333333333,11,11,GACGGGCCTTCGTAACCTTA,0,1138987
fldAp,0.08333333333333333,11,11,GACGCTTTCGAGGGCAACCC,0,1069385
fldAp,0.08333333333333333,11,11,GACCACGTTAGATAGGGGGG,0,1181582
fldAp,0.08333333333333333,11,11,GACCAACTAGGCACTTGTTT,0,1145876
fldAp,0.08333333333333333,11,11,GACATCCGTGATCTTGATAT,0,1153707
fldAp,0.08333333333333333,11,11,GACATAAACGCACCTTGGTC,0,1082074
fldAp,0.08333333333333333,11,11,GACAATGGGAAATCCCACGC,0,1168250
fldAp,0.08333333333333333,11,11,GAATGGAGCCTTCTGGATGT,0,1127066
fldAp,0.08333333333333333,11,11,GAATAAACACTTTGTATCCA,0,1083173
fldAp,0.08333333333333333,11,11,GAAGGGTTGTTGGATTTGCT,0,1122976
fldAp,0.08333333333333333,11,11,GAACTCGGATTGTCCCGCCC,0,1124111
fldAp,0.08333333333333333,11,11,GAACGATTGTCGGTAAACCT,0,1183589
fldAp,0.08333333333333333,11,11,GAAATGGATTTCAGCATCAT,0,1087527
fldAp,0.08333333333333333,11,11,CTTTTGAGGTTATGTAAGTC,0,1141367
fldAp,0.08333333333333333,11,11,CTTTCTAAGCTTCATACAGC,0,1140041
fldAp,0.08333333333333333,11,11,CTTTATGCCCCTAGCACGCA,0,1085513
fldAp,0.08333333333333333,11,11,CTTGGGAGGCTCCGGATTTT,0,1157525
fldAp,0.08333333333333333,11,11,CTTGCTCTACGGAAATAAGA,0,1108575
fldAp,0.08333333333333333,11,11,CTTGCTCGACGTTAACACGC,0,1144551
fldAp,0.08333333333333333,11,11,CTTGCCACCGAACGTAACTG,0,1184474
fldAp,0.08333333333333333,11,11,CTTCTTGTCGTCCAGACCAG,0,1181517
fldAp,0.08333333333333333,11,11,CTTCTGCGACGGCAAGCGTC,0,1108665
fldAp,0.08333333333333333,11,11,CTTAGAACCAGATTCATTGG,0,1088304
fldAp,0.08333333333333333,11,11,CTGTTTATTAGATACAGACT,0,1119090
fldAp,0.08333333333333333,11,11,CTGTGGGGGCTTAGAAGACT,0,1095834
fldAp,0.08333333333333333,11,11,CTGTATGATGAGCAATGGCC,0,1174709
fldAp,0.08333333333333333,11,11,CTGTACTCTGTGTTAGACTG,0,1111132
fldAp,0.08333333333333333,11,11,CTGGGACTCTCGAATCTACC,0,1170859
fldAp,0.08333333333333333,11,11,CTGGCGGGTGAGGGTGCCTC,0,1113791
fldAp,0.08333333333333333,11,11,CTGCGGTCATGGCGGGCGGT,0,1109371
fldAp,0.08333333333333333,11,11,CTGCCAGTCACGGGGGGTAT,0,1128740
fldAp,0.08333333333333333,11,11,CTGAGGGTCGAGGTCAATTT,0,1080744
fldAp,0.08333333333333333,11,11,CTCTTTCAAGCATGGGTGAA,0,1130763
fldAp,0.08333333333333333,11,11,CTCTTCACGCAGGCTCCATG,0,1148176
fldAp,0.08333333333333333,11,11,CTCTGATGACCTAATCTGGT,0,1065642
fldAp,0.08333333333333333,11,11,CTCTCGTAATGTCAAAATCC,0,1068759
fldAp,0.08333333333333333,11,11,CTCTCGGTGGCAATTATCAG,0,1133129
fldAp,0.08333333333333333,11,11,CTCTCACGTAACCCGCTTTC,0,1092972
fldAp,0.08333333333333333,11,11,CTCTCACACCGCGGGATAGC,0,1163882
fldAp,0.08333333333333333,11,11,CTCTACTGCTGTAATTAAAT,0,1142087
fldAp,0.08333333333333333,11,11,CTCGTATCTCACATTCGCCA,0,1152779
fldAp,0.08333333333333333,11,11,CTCCAATCCTTGCACGTGGA,0,1083960
fldAp,0.08333333333333333,11,11,CTCAAGGTTAGATCATGAGC,0,1082493
fldAp,0.08333333333333333,11,11,CTCAAACTTCTCTGTCCTGA,0,1090633
fldAp,0.08333333333333333,11,11,CTATCGAATCATTCCAACGC,0,1126061
fldAp,0.08333333333333333,11,11,CTATATTCATTCCGGTTAAC,0,1125341
fldAp,0.08333333333333333,11,11,CTAGTATTTGTAGTTGCCGC,0,1137718
fldAp,0.08333333333333333,11,11,CTAGGCCTCGGGGACCAAGA,0,1177938
fldAp,0.08333333333333333,11,11,CTACTGAAAATAGGTTGCGC,0,1117371
fldAp,0.08333333333333333,11,11,CTACAACCATCTTGTCCGTC,0,1088099
fldAp,0.08333333333333333,11,11,CTAATCTAGTCACGGACAAC,0,1131874
fldAp,0.08333333333333333,11,11,CTAACGCATACGGGGCAGCG,0,1063311
fldAp,0.08333333333333333,11,11,CTAAATGGTCTAGAAACGGG,0,1069104
fldAp,0.08333333333333333,11,11,CGTTAGTCGGCCGGGACCCT,0,1169035
fldAp,0.08333333333333333,11,11,CGTTAGTAGGCGTTTTGATC,0,1119311
fldAp,0.08333333333333333,11,11,CGTTAATATCCGGTGGACGT,0,1092688
fldAp,0.08333333333333333,11,11,CGTTAAGAGAACAACCTCTT,0,1140264
fldAp,0.08333333333333333,11,11,CGTGACCGGCTAGCTACCCG,0,1085884
fldAp,0.08333333333333333,11,11,CGTGACAGCCCCACTTAGGG,0,1080530
fldAp,0.08333333333333333,11,11,CGTCGAAAGTGTTGTTTCAA,0,1171456
fldAp,0.08333333333333333,11,11,CGTATACTTGAGGAAGTAGA,0,1139381
fldAp,0.08333333333333333,11,11,CGTATACCGATTGTTAAAGG,0,1087170
fldAp,0.08333333333333333,11,11,CGTAGCACTCCCTTCCAGTT,0,1106033
fldAp,0.08333333333333333,11,11,CGTAGAAGATCAGTGCAGTT,0,1094453
fldAp,0.08333333333333333,11,11,CGTAATTCTACAACAGCCTT,0,1107810
fldAp,0.08333333333333333,11,11,CGGTGTAATCAACTTGTGAG,0,1101080
fldAp,0.08333333333333333,11,11,CGGTCTTGGTGGGGTAGCAA,0,1074651
fldAp,0.08333333333333333,11,11,CGGTCGAAAGGTCAGCTTAT,0,1080093
fldAp,0.08333333333333333,11,11,CGGTCAGAAGAGGAATCAAC,0,1100323
fldAp,0.08333333333333333,11,11,CGGTACATAGAGGGCGGATA,0,1158318
fldAp,0.08333333333333333,11,11,CGGGGTGGGCGAGCCGAAGT,0,1178836
fldAp,0.08333333333333333,11,11,CGGGCGGTCCATCTGCAATA,0,1107547
fldAp,0.08333333333333333,11,11,CGGCTGGGACCCCTGGTTCT,0,1153077
fldAp,0.08333333333333333,11,11,CGGCCTCGTAGGAAGACCGT,0,1182337
fldAp,0.08333333333333333,11,11,CGGCCCCGATCGAGTATCAT,0,1129036
fldAp,0.08333333333333333,11,11,CGGCACAGAAAGCTTGCGAC,0,1166214
fldAp,0.08333333333333333,11,11,CGGATCCAGGCTCAGATACA,0,1111786
fldAp,0.08333333333333333,11,11,CGCTTGCGAGAATCGCACAA,0,1155224
fldAp,0.08333333333333333,11,11,CGCTGGGGACGATCGACTCT,0,1162152
fldAp,0.08333333333333333,11,11,CGCTGCGATACTATCGTTGT,0,1184403
fldAp,0.08333333333333333,11,11,CGCTATTGAGCTAGCGGACA,0,1096445
fldAp,0.08333333333333333,11,11,CGCGTCGCCCTTTGCACAAT,0,1079838
fldAp,0.08333333333333333,11,11,CGCGGTTCGTCCATTTGCTT,0,1144783
fldAp,0.08333333333333333,11,11,CGCGGGGAAAAGTAACAGCA,0,1134510
fldAp,0.08333333333333333,11,11,CGCGGGAAATCTACGGCCGT,0,1143372
fldAp,0.08333333333333333,11,11,CGCCGTCACCAAACTGGTCT,0,1185520
fldAp,0.08333333333333333,11,11,CGCCCTCTTGCGCATAAGGG,0,1088234
fldAp,0.08333333333333333,11,11,CGCCCAGGTAAGCATAGTGT,0,1104735
fldAp,0.08333333333333333,11,11,CGCATAACGCTTCATGAAGG,0,1102803
fldAp,0.08333333333333333,11,11,CGAGTGGTCGCTTCTTGGTT,0,1148937
fldAp,0.08333333333333333,11,11,CGAGGCCTACTCGTCGAACC,0,1094038
fldAp,0.08333333333333333,11,11,CGAGCTGCAGCTATGAAGCA,0,1093404
fldAp,0.08333333333333333,11,11,CGAGACTAAATTCGGCCTAT,0,1100592
fldAp,0.08333333333333333,11,11,CGAGAAGAACGGCCTGTTAC,0,1160572
fldAp,0.08333333333333333,11,11,CGACGGTTAGATGTTCCCGT,0,1118677
fldAp,0.08333333333333333,11,11,CGACGCCAGGTAATGTGAAT,0,1100614
fldAp,0.08333333333333333,11,11,CGACCACCGCCGACGGATAT,0,1127143
fldAp,0.08333333333333333,11,11,CGAAGCCGGTGTCTACATCA,0,1090862
fldAp,0.08333333333333333,11,11,CGAACCTCTACGCCTTTGGA,0,1164860
fldAp,0.08333333333333333,11,11,CCTTGCTGGTGAAACCTGGA,0,1113543
fldAp,0.08333333333333333,11,11,CCTTGAAGGGTAAATTACGT,0,1164412
fldAp,0.08333333333333333,11,11,CCTGTCACGCCGTAATTTAG,0,1091489
fldAp,0.08333333333333333,11,11,CCTGGCGGGGCCATTCCATG,0,1106041
fldAp,0.08333333333333333,11,11,CCTCTCATGATTCAGCGCGC,0,1150342
fldAp,0.08333333333333333,11,11,CCTCTATGACCGGTTCCGTC,0,1092969
fldAp,0.08333333333333333,11,11,CCTCATTAATCGCTGCTACA,0,1150067
fldAp,0.08333333333333333,11,11,CCTCACATGGTCATACTTTA,0,1159142
fldAp,0.08333333333333333,11,11,CCTAAGCGTGCGGTTGAGTA,0,1120162
fldAp,0.08333333333333333,11,11,CCTAAACTGTTCTGTGGTAT,0,1174665
fldAp,0.08333333333333333,11,11,CCGTTGGGCTACGATTCTTA,0,1166102
fldAp,0.08333333333333333,11,11,CCGGTACCGTTGGGTTCCGC,0,1115285
fldAp,0.08333333333333333,11,11,CCGGGATTTCCATAGCGAAT,0,1137235
fldAp,0.08333333333333333,11,11,CCGGACCACTGAGATCGCCT,0,1116686
fldAp,0.08333333333333333,11,11,CCGCTCGTAATCATCCAGGA,0,1153326
fldAp,0.08333333333333333,11,11,CCGCGAAGGCTCTGACATGC,0,1120046
fldAp,0.08333333333333333,11,11,CCGCCTCTAGTTCCTTATTT,0,1153091
fldAp,0.08333333333333333,11,11,CCGCCCGGTACCCAGAATTT,0,1137150
fldAp,0.08333333333333333,11,11,CCGACTAGGCGCCCGGGACT,0,1144115
fldAp,0.08333333333333333,11,11,CCCGTAGTGCGGATTTAATA,0,1144863
fldAp,0.08333333333333333,11,11,CCCGGCGGTCAGAAAGTCAT,0,1105305
fldAp,0.08333333333333333,11,11,CCCGGCCCGGACGGAGTGTC,0,1145195
fldAp,0.08333333333333333,11,11,CCCGCTATTCCAAAAACCTA,0,1116428
fldAp,0.08333333333333333,11,11,CCCGCCGGGCATGTTTATCA,0,1151120
fldAp,0.08333333333333333,11,11,CCCGACGTTACACTGGAGAG,0,1141613
fldAp,0.08333333333333333,11,11,CCCATGTTTGCATTTTGCCT,0,1115264
fldAp,0.08333333333333333,11,11,CCCACCTTAGTCCGGATATG,0,1145345
fldAp,0.08333333333333333,11,11,CCCACCCGGCAAAAGTGGGG,0,1170091
fldAp,0.08333333333333333,11,11,CCATTTGGAAACGACGTTAA,0,1167715
fldAp,0.08333333333333333,11,11,CCAGTTCGGGTTGTGGGCAT,0,1136101
fldAp,0.08333333333333333,11,11,CCAGCCTTCATCGTTGTCAC,0,1176499
fldAp,0.08333333333333333,11,11,CCAGACTTCCCTGCCTGAGG,0,1143267
fldAp,0.08333333333333333,11,11,CCACTAGACCTATCCACCTA,0,1183450
fldAp,0.08333333333333333,11,11,CCAAAGCCTCCTGGCTAAAA,0,1078147
fldAp,0.08333333333333333,11,11,CCAAACGCGGAAGGATATTA,0,1127176
fldAp,0.08333333333333333,11,11,CATTTCAAATGTCTATCTTT,0,1094135
fldAp,0.08333333333333333,11,11,CATTTATAACTGAGGTCTCG,0,1071564
fldAp,0.08333333333333333,11,11,CATGTGCTATGGGTGGGGTA,0,1107221
fldAp,0.08333333333333333,11,11,CATGCTTGTAAGTGTTGAGT,0,1075267
fldAp,0.08333333333333333,11,11,CATGAGATTCGGATGGGGGA,0,1073266
fldAp,0.08333333333333333,11,11,CATCTTCTTGGGCATATTAC,0,1116435
fldAp,0.08333333333333333,11,11,CATCACGCCCGTACGACTTT,0,1082499
fldAp,0.08333333333333333,11,11,CATAGATCCGCGCAAACACA,0,1097264
fldAp,0.08333333333333333,11,11,CATACATATTCTGAAATGTG,0,1168497
fldAp,0.08333333333333333,11,11,CATAAACAAATAGGAGGCGA,0,1135205
fldAp,0.08333333333333333,11,11,CAGTTTGTCTTTTGGCGAGT,0,1167512
fldAp,0.08333333333333333,11,11,CAGTTCTCCGGTCCCGTTAA,0,1088493
fldAp,0.08333333333333333,11,11,CAGTACAATAGGCCTCGCCA,0,1154858
fldAp,0.08333333333333333,11,11,CAGGTCCACCCCCTTTACAA,0,1177236
fldAp,0.08333333333333333,11,11,CAGGAACGGCGAAGAATTTG,0,1142870
fldAp,0.08333333333333333,11,11,CAGCTACGGATACACTCAAC,0,1114952
fldAp,0.08333333333333333,11,11,CAGCCGTGGACATCCTACTC,0,1108021
fldAp,0.08333333333333333,11,11,CAGCCGCGTATGCCAGCACG,0,1068460
fldAp,0.08333333333333333,11,11,CAGCCGACGACCATGTTTCC,0,1148406
fldAp,0.08333333333333333,11,11,CAGCACATGGTCTGCCTAGG,0,1063780
fldAp,0.08333333333333333,11,11,CAGAGGATTACTCAAAGCTT,0,1133259
fldAp,0.08333333333333333,11,11,CAGACGAGGTTGCATATCTC,0,1124586
fldAp,0.08333333333333333,11,11,CACTTGTTTGGATTTATCGT,0,1170992
fldAp,0.08333333333333333,11,11,CACTAGCGTGGTCTTACCGA,0,1155814
fldAp,0.08333333333333333,11,11,CACGGGGTAGGCACTGTTAG,0,1166149
fldAp,0.08333333333333333,11,11,CACGGGGCGCGAGCTGGCTT,0,1076987
fldAp,0.08333333333333333,11,11,CACGATAGCCGGACGCCCCG,0,1077255
fldAp,0.08333333333333333,11,11,CACCTTGTACCCGGAGATTT,0,1154520
fldAp,0.08333333333333333,11,11,CACCTCACGTAGGCGAAGAC,0,1108221
fldAp,0.08333333333333333,11,11,CACCTAGGTGGCTAACGATG,0,1184797
fldAp,0.08333333333333333,11,11,CACCGTACTACTGCGCATAT,0,1100152
fldAp,0.08333333333333333,11,11,CACCGCTTAAGTGGGGATGA,0,1170569
fldAp,0.08333333333333333,11,11,CACCCCTCACTATCCTCCGG,0,1174879
fldAp,0.08333333333333333,11,11,CACAGTTATCGGGACTCAAG,0,1140186
fldAp,0.08333333333333333,11,11,CACACCAGGCTGCGTTGGAG,0,1121541
fldAp,0.08333333333333333,11,11,CACAAATGACATCTCGAGGC,0,1142482
fldAp,0.08333333333333333,11,11,CAATTCCATGCCCTCTAACA,0,1138673
fldAp,0.08333333333333333,11,11,CAAGTTGTATTTCATCTGGA,0,1160853
fldAp,0.08333333333333333,11,11,CAAGGGAATAAATAGTCAGG,0,1183709
fldAp,0.08333333333333333,11,11,CAAGGATGCTGGATCGTACA,0,1079624
fldAp,0.08333333333333333,11,11,CAAGCTTTTAAACGGCAGCT,0,1164960
fldAp,0.08333333333333333,11,11,CAAGAATTCGGGGGCAGGGT,0,1167053
fldAp,0.08333333333333333,11,11,CAACCAGACGCCGACAACCC,0,1128821
fldAp,0.08333333333333333,11,11,CAACAATTCAGCATAGTGTA,0,1143859
fldAp,0.08333333333333333,11,11,CAAATTTCAAATCGAACGTC,0,1072153
fldAp,0.08333333333333333,11,11,ATTTTTGGAGGGGCAAACAT,0,1178386
fldAp,0.08333333333333333,11,11,ATTTTAAGCCAGGGAGACTT,0,1128100
fldAp,0.08333333333333333,11,11,ATTTCCACGCCGAGAGATCT,0,1117637
fldAp,0.08333333333333333,11,11,ATTTATAATTACCAGAACAT,0,1183685
fldAp,0.08333333333333333,11,11,ATTTAACTCCAGGTACGATT,0,1163665
fldAp,0.08333333333333333,11,11,ATTGTAGTAAGTGTCACTAC,0,1091970
fldAp,0.08333333333333333,11,11,ATTGGGTGAGAGACAACCAA,0,1105891
fldAp,0.08333333333333333,11,11,ATTGGGGGAGCGAATGAGAC,0,1124483
fldAp,0.08333333333333333,11,11,ATTGGACTTCGCATTACCAA,0,1179838
fldAp,0.08333333333333333,11,11,ATTGCTCTACAAGGGACGAA,0,1137206
fldAp,0.08333333333333333,11,11,ATTCTTAAGCGACTCTGTGA,0,1173866
fldAp,0.08333333333333333,11,11,ATTCGTCTGTTGCGACCGCT,0,1077309
fldAp,0.08333333333333333,11,11,ATTCCTACTGATCTGTGGAC,0,1127019
fldAp,0.08333333333333333,11,11,ATTCACAACGCGATATCGCA,0,1112307
fldAp,0.08333333333333333,11,11,ATTATAGGATAGGGTATTTA,0,1138617
fldAp,0.08333333333333333,11,11,ATGTCCCAAGCGTGGAGTAT,0,1176646
fldAp,0.08333333333333333,11,11,ATGTAATGAGGAACGATGCT,0,1170316
fldAp,0.08333333333333333,11,11,ATGGCGGCTAGTCGCGCCTA,0,1115822
fldAp,0.08333333333333333,11,11,ATGGCACGTATCCGTGCGCA,0,1112808
fldAp,0.08333333333333333,11,11,ATGCTCTCCTTACGGGTAGT,0,1130519
fldAp,0.08333333333333333,11,11,ATGCGACCCCTAATATTAAT,0,1117530
fldAp,0.08333333333333333,11,11,ATGCGACATCGTATTACTTC,0,1141010
fldAp,0.08333333333333333,11,11,ATGCCGGTCGAATTGCTCAC,0,1128944
fldAp,0.08333333333333333,11,11,ATGCAGGACAATTATATTGT,0,1172003
fldAp,0.08333333333333333,11,11,ATGATGGCAGAAACCACGCA,0,1063480
fldAp,0.08333333333333333,11,11,ATGAATACTATGAACAAACC,0,1153268
fldAp,0.08333333333333333,11,11,ATGAACTGGCTGTTAACGAT,0,1094410
fldAp,0.08333333333333333,11,11,ATCTTACCAATGTCGTGCGC,0,1098828
fldAp,0.08333333333333333,11,11,ATCTCTGCGCCGCCCTCAGT,0,1153794
fldAp,0.08333333333333333,11,11,ATCTAGCTGTTGACCGGCGC,0,1071877
fldAp,0.08333333333333333,11,11,ATCGGCCTGCCGGGCTTGTG,0,1091248
fldAp,0.08333333333333333,11,11,ATCGAGATTAGTTCTCACGG,0,1149782
fldAp,0.08333333333333333,11,11,ATCGAACCCTTTTACGAGCA,0,1089007
fldAp,0.08333333333333333,11,11,ATCCGACAGGGGATCTGCAT,0,1154347
fldAp,0.08333333333333333,11,11,ATCCCCTTACTCAGTCTTAG,0,1116440
fldAp,0.08333333333333333,11,11,ATCCCCCCCACGGTCAGAGC,0,1174987
fldAp,0.08333333333333333,11,11,ATCCCAAACAAGGCAATTTG,0,1166329
fldAp,0.08333333333333333,11,11,ATCATAACCTTATGATGGAG,0,1070706
fldAp,0.08333333333333333,11,11,ATCACCGAGTGCTCGTTAGC,0,1144188
fldAp,0.08333333333333333,11,11,ATATGCGCGTGACCAATTAG,0,1104184
fldAp,0.08333333333333333,11,11,ATAGTTGCTTTTACAAAGGT,0,1119582
fldAp,0.08333333333333333,11,11,ATAGTGTGCGTGTTTTGGTG,0,1121458
fldAp,0.08333333333333333,11,11,ATAGTGGGCGTCTGCTGTAT,0,1149529
fldAp,0.08333333333333333,11,11,ATACGTGCACGAGCCGTAGA,0,1112353
fldAp,0.08333333333333333,11,11,ATAACGCCCGGTAGTGTTCT,0,1070674
fldAp,0.08333333333333333,11,11,ATAACAGGGATGGATAATTT,0,1085764
fldAp,0.08333333333333333,11,11,ATAAAACTGCCCCGCGGAGG,0,1091160
fldAp,0.08333333333333333,11,11,AGTTTTGGAACATACGGAAT,0,1155807
fldAp,0.08333333333333333,11,11,AGTTTCTAAAAACGGATGGT,0,1139342
fldAp,0.08333333333333333,11,11,AGTTTCGGTCAGGGTCCAAC,0,1062996
fldAp,0.08333333333333333,11,11,AGTTCAGTTCCCCGGAGCAT,0,1172797
fldAp,0.08333333333333333,11,11,AGTTCAATTTCGCGGTAGTC,0,1180736
fldAp,0.08333333333333333,11,11,AGTCCCGAGTGACCCGAAAA,0,1076907
fldAp,0.08333333333333333,11,11,AGTCAACCACCCCGTCTATC,0,1125998
fldAp,0.08333333333333333,11,11,AGTAGTAAGGATTGACAAGT,0,1107439
fldAp,0.08333333333333333,11,11,AGGTATATTATCCTTACGTA,0,1113148
fldAp,0.08333333333333333,11,11,AGGGTAAAGCTCTGGCCTAA,0,1123390
fldAp,0.08333333333333333,11,11,AGGGGCAGATGGAACAGGCA,0,1180854
fldAp,0.08333333333333333,11,11,AGGGAGCCAAAATTGATAAG,0,1105184
fldAp,0.08333333333333333,11,11,AGGCTTGAGAAGCATAGTAC,0,1177554
fldAp,0.08333333333333333,11,11,AGGCTTCGTTTTCATTTTTT,0,1146834
fldAp,0.08333333333333333,11,11,AGGCTGAGTTACAACAGGGA,0,1136959
fldAp,0.08333333333333333,11,11,AGGCTAAGGGCGGATAAGCG,0,1144650
fldAp,0.08333333333333333,11,11,AGGCGAACGTAATCTTAGCA,0,1140964
fldAp,0.08333333333333333,11,11,AGGCATGAGACTGGTTAGCT,0,1177080
fldAp,0.08333333333333333,11,11,AGGCACGGGTTAGGTAGCCA,0,1180431
fldAp,0.08333333333333333,11,11,AGGATTCCATGATGGGGTCG,0,1100926
fldAp,0.08333333333333333,11,11,AGGATCCTGATATCTAGGCA,0,1110705
fldAp,0.08333333333333333,11,11,AGGAGACCGGGGCGGCTCTG,0,1119474
fldAp,0.08333333333333333,11,11,AGGAACAACAGTTCACGGCT,0,1161604
fldAp,0.08333333333333333,11,11,AGCTATCGACATGTACTAAT,0,1173127
fldAp,0.08333333333333333,11,11,AGCGTATCATAAATACCTAA,0,1173629
fldAp,0.08333333333333333,11,11,AGCGTAGGAATTTGGTATTT,0,1088929
fldAp,0.08333333333333333,11,11,AGCGGTAACTGTTTCTCAAT,0,1182689
fldAp,0.08333333333333333,11,11,AGCGCCGACACCGTATTTTA,0,1107542
fldAp,0.08333333333333333,11,11,AGCGAGGCGATCAGTTATCA,0,1127481
fldAp,0.08333333333333333,11,11,AGCGAGATTCGAGGCTTCTT,0,1083141
fldAp,0.08333333333333333,11,11,AGCGACACGTCGGGTTCAAA,0,1109517
fldAp,0.08333333333333333,11,11,AGCCTTTATGGAGAACGGTT,0,1101146
fldAp,0.08333333333333333,11,11,AGCCGATTTGACTATGGATA,0,1172645
fldAp,0.08333333333333333,11,11,AGCCATCAGGATACCATACA,0,1116775
fldAp,0.08333333333333333,11,11,AGATTAACTTGTAAAGCAGT,0,1082175
fldAp,0.08333333333333333,11,11,AGATGCCTTGAGCCAGGATG,0,1074383
fldAp,0.08333333333333333,11,11,AGATCCGTAAAAGTCATTCT,0,1076516
fldAp,0.08333333333333333,11,11,AGAGAGACAGCGAGGTTGGT,0,1088816
fldAp,0.08333333333333333,11,11,AGAGACCGGGACTTCTTCGA,0,1113463
fldAp,0.08333333333333333,11,11,AGACTGCGTTGCTTGGTCGC,0,1175567
fldAp,0.08333333333333333,11,11,ACTTTCGATTCGCCCGGTTT,0,1092300
fldAp,0.08333333333333333,11,11,ACTTCTCTCGCGGGGGGTGT,0,1099090
fldAp,0.08333333333333333,11,11,ACTTAAAGGCGACAATCAAT,0,1152964
fldAp,0.08333333333333333,11,11,ACTAGCGTTGTGTATAGATT,0,1176250
fldAp,0.08333333333333333,11,11,ACTAGCGGAGGCATGGTCCA,0,1085153
fldAp,0.08333333333333333,11,11,ACGGTTCAGTGTTCCCTATT,0,1152199
fldAp,0.08333333333333333,11,11,ACGGTACCCGCACGTTATGA,0,1063292
fldAp,0.08333333333333333,11,11,ACGGGAGACCGCTCCATGGT,0,1083032
fldAp,0.08333333333333333,11,11,ACGGATCCCTTGCGCCTATC,0,1167976
fldAp,0.08333333333333333,11,11,ACGCTCCATACCGGAACGTA,0,1076072
fldAp,0.08333333333333333,11,11,ACGCCCCAGGGTCCGGTATT,0,1131511
fldAp,0.08333333333333333,11,11,ACGAGGTGAAAATTAGAACA,0,1133339
fldAp,0.08333333333333333,11,11,ACGAGCAGCCAGCGCACCTG,0,1128111
fldAp,0.08333333333333333,11,11,ACGAGCAAGTAACCTCTTCC,0,1138744
fldAp,0.08333333333333333,11,11,ACGAAGGGATATGAGACGTT,0,1173578
fldAp,0.08333333333333333,11,11,ACCTGGGCCACAGCTATAGA,0,1121342
fldAp,0.08333333333333333,11,11,ACCTGACGATCCACTCAATA,0,1073191
fldAp,0.08333333333333333,11,11,ACCGCGGAGATAGCAACGTA,0,1156010
fldAp,0.08333333333333333,11,11,ACCGAGGATGGTGTTAATAT,0,1132409
fldAp,0.08333333333333333,11,11,ACCCCTCTTTATTTTGAAAG,0,1153928
fldAp,0.08333333333333333,11,11,ACCCCTAGACTGGAAGGATG,0,1097594
fldAp,0.08333333333333333,11,11,ACCATCACGTTTTAGTCATC,0,1153012
fldAp,0.08333333333333333,11,11,ACCAGCAGTGTTGCAGGGTC,0,1108770
fldAp,0.08333333333333333,11,11,ACCACGTGAGTGGAGTTCAA,0,1186169
fldAp,0.08333333333333333,11,11,ACCAAGAGTCTGGATACACA,0,1075410
fldAp,0.08333333333333333,11,11,ACATGACGAGGGCACGTCGC,0,1086019
fldAp,0.08333333333333333,11,11,ACATAGCGTTCTTGATGCGC,0,1144933
fldAp,0.08333333333333333,11,11,ACAGTAGAATGGATTCCAAT,0,1120363
fldAp,0.08333333333333333,11,11,ACAGATGCGCTCTAACATCT,0,1086247
fldAp,0.08333333333333333,11,11,ACACCCGCGCAACCAGGTCT,0,1120182
fldAp,0.08333333333333333,11,11,ACACCATGTTCCTGTCAGTA,0,1066901
fldAp,0.08333333333333333,11,11,ACACATAAGCCGGAGCAGCA,0,1083410
fldAp,0.08333333333333333,11,11,ACAATTATGGCAAGCCCTCT,0,1104761
fldAp,0.08333333333333333,11,11,ACAAGGTGCATATCGGGATG,0,1159851
fldAp,0.08333333333333333,11,11,ACAAGACATCGTTCGTTTAA,0,1175669
fldAp,0.08333333333333333,11,11,ACAACCGGTTATTTGCAGGT,0,1129063
fldAp,0.08333333333333333,11,11,AATTTCCTGAACTGGCCTCA,0,1104683
fldAp,0.08333333333333333,11,11,AATTCCCAGGGTCCAAGTGA,0,1150865
fldAp,0.08333333333333333,11,11,AATGTGTCGCCAGTCCTGGA,0,1075640
fldAp,0.08333333333333333,11,11,AATGGGCGTGAATTATCATG,0,1176559
fldAp,0.08333333333333333,11,11,AATGAAATCCGACGGGATCT,0,1075151
fldAp,0.08333333333333333,11,11,AATCGTTTGAGTTATTTCGT,0,1150870
fldAp,0.08333333333333333,11,11,AATCGAACTGGCACAGGCTG,0,1138877
fldAp,0.08333333333333333,11,11,AATCATAAGATACAAGGTAC,0,1175956
fldAp,0.08333333333333333,11,11,AATATCTTCACAAAGCTGAG,0,1077017
fldAp,0.08333333333333333,11,11,AATAGGTATAGGCGTGTCGG,0,1092391
fldAp,0.08333333333333333,11,11,AATAGGAACACGAGTCATCC,0,1100393
fldAp,0.08333333333333333,11,11,AATACTGACAGGCTAAACGC,0,1121604
fldAp,0.08333333333333333,11,11,AAGTTCCAAATGGGGAATGT,0,1080863
fldAp,0.08333333333333333,11,11,AAGTGGGTTCATGTCCGATG,0,1070033
fldAp,0.08333333333333333,11,11,AAGTCGGCAGCGGTTGTGTT,0,1111074
fldAp,0.08333333333333333,11,11,AAGTCAATCCTGCACCCCTA,0,1154235
fldAp,0.08333333333333333,11,11,AAGGTGTTAGGCAACAAAGT,0,1120962
fldAp,0.08333333333333333,11,11,AAGGTCAGCAGCATCAATGT,0,1184273
fldAp,0.08333333333333333,11,11,AAGGGAGCCCTAGCTATTCT,0,1168074
fldAp,0.08333333333333333,11,11,AAGGCGTTGGTGGTCAGCCG,0,1142882
fldAp,0.08333333333333333,11,11,AAGGCGCAAATCCGAGGTGA,0,1077762
fldAp,0.08333333333333333,11,11,AAGGCCGCATCTGAGCGACC,0,1122835
fldAp,0.08333333333333333,11,11,AAGCTGCCATCCATCCGGAT,0,1076149
fldAp,0.08333333333333333,11,11,AAGCAGAAGTCGTATTCTTG,0,1070786
fldAp,0.08333333333333333,11,11,AAGAAGTATTTAAAAGGCTT,0,1152216
fldAp,0.08333333333333333,11,11,AAGAACGAACGCGCGTGTAC,0,1116577
fldAp,0.08333333333333333,11,11,AACTTATTGATCCTGTCTAG,0,1107549
fldAp,0.08333333333333333,11,11,AACTCCACACGTCGAACGCT,0,1121840
fldAp,0.08333333333333333,11,11,AACTACCGCCACGGTTTGAG,0,1119912
fldAp,0.08333333333333333,11,11,AACTAATAGCACAGGATTTA,0,1172342
fldAp,0.08333333333333333,11,11,AACGTGACCTTAACCTAAAA,0,1082172
fldAp,0.08333333333333333,11,11,AACCAATCTGTTCTCTAGCG,0,1181895
fldAp,0.08333333333333333,11,11,AACCAAGCTTTTAGCTAGCT,0,1088591
fldAp,0.08333333333333333,11,11,AACATCAGGAAATAAGCATG,0,1171263
fldAp,0.08333333333333333,11,11,AACATACTCCCAACATTACT,0,1136495
fldAp,0.08333333333333333,11,11,AACAGGTTGGGAAATCCGAG,0,1142997
fldAp,0.08333333333333333,11,11,AACAGCTATTCTATGAAGCA,0,1155204
fldAp,0.08333333333333333,11,11,AAATACGCGTGCCTAAAGAT,0,1098814
fldAp,0.08333333333333333,11,11,AAATAAACGGAATCTTGTTC,0,1075023
fldAp,0.08333333333333333,11,11,AAACTGTTACGAGGACGTAT,0,1066783
fldAp,0.08333333333333333,11,11,AAACGGGTTGTGTTACTAGC,0,1093371
fldAp,0.08333333333333333,11,11,AAACCTCCAAAACTTCAAAC,0,1176183
fldAp,0.08333333333333333,11,11,AAACCGTGGTAGCGTACGGT,0,1154349
fldAp,0.08333333333333333,11,11,AAACCCCTTGACTGTGTGGC,0,1117558
fldAp,0.08333333333333333,11,11,AAACAGGGCGCAAACATGAA,0,1134148
fldAp,0.08333333333333333,11,11,AAAATGTCGGAACCCATCAG,0,1116402
fldAp,0.08333333333333333,11,11,AAAACTGACACTTTCATCGA,0,1132006
fldAp,0.09090909090909091,10,10,TTTTGTGAAACGATATTTGT,0,1140545
fldAp,0.09090909090909091,10,10,TTTTCATCTTTTGGAGATAA,0,1168821
fldAp,0.09090909090909091,10,10,TTTTCAGAGTTTCTAAAGTC,0,1161477
fldAp,0.09090909090909091,10,10,TTTTATCATCGGCAGCTGAA,0,1150241
fldAp,0.09090909090909091,10,10,TTTTAGCGCTACTCTATATG,0,1178990
fldAp,0.09090909090909091,10,10,TTTTAGACTTTAGACACCGG,0,1066203
fldAp,0.09090909090909091,10,10,TTTTACTCCTCCATCATTTT,0,1132839
fldAp,0.09090909090909091,10,10,TTTGTAAAGATTTAGGCATG,0,1161561
fldAp,0.09090909090909091,10,10,TTTGGGTAGTAGATTTTACT,0,1093477
fldAp,0.09090909090909091,10,10,TTTGGAGTACAGTAGTAGGT,0,1135345
fldAp,0.09090909090909091,10,10,TTTGCGGCCGGCGTACAAAC,0,1083252
fldAp,0.09090909090909091,10,10,TTTCTGTCTGGGGCGCTCGA,0,1151382
fldAp,0.09090909090909091,10,10,TTTCTGACTCATACGCCAAT,0,1156374
fldAp,0.09090909090909091,10,10,TTTCAGATTCGGTTCCGTAG,0,1082154
fldAp,0.09090909090909091,10,10,TTTCAAACCAGATATTTGAA,0,1149956
fldAp,0.09090909090909091,10,10,TTTATCTTCTAGATAGTCTC,0,1131192
fldAp,0.09090909090909091,10,10,TTTAGACGCCCAACGGAGGA,0,1072252
fldAp,0.09090909090909091,10,10,TTTAGAATTCAAAAAACTTT,0,1074683
fldAp,0.09090909090909091,10,10,TTTACGAGTGTATTCGAGGT,0,1138825
fldAp,0.09090909090909091,10,10,TTGTTCGCGCCGCGACTTGC,0,1076245
fldAp,0.09090909090909091,10,10,TTGTGGGTGATGTCTCGAAG,0,1163445
fldAp,0.09090909090909091,10,10,TTGTGGCTGCAATTCTCCAT,0,1083612
fldAp,0.09090909090909091,10,10,TTGTGCAAGTCTGAGGGTAT,0,1136688
fldAp,0.09090909090909091,10,10,TTGGTGGCCTATCTGTGCTT,0,1141150
fldAp,0.09090909090909091,10,10,TTGGCGCCTAGTAAATCGAA,0,1119876
fldAp,0.09090909090909091,10,10,TTGGATAAGAGGACCCCCAT,0,1105180
fldAp,0.09090909090909091,10,10,TTGCGACTTCCAAGTGAACA,0,1136764
fldAp,0.09090909090909091,10,10,TTGCATGAGATGACATAACT,0,1088515
fldAp,0.09090909090909091,10,10,TTGATTTCGCGTCGAGTCGG,0,1093516
fldAp,0.09090909090909091,10,10,TTGAGTTTTGTTCGTAGTAT,0,1080016
fldAp,0.09090909090909091,10,10,TTCGTGTAGAGACATTCAAC,0,1081926
fldAp,0.09090909090909091,10,10,TTCGTAAGACAAAGTATATA,0,1088502
fldAp,0.09090909090909091,10,10,TTCGCGCCGGACATACAATA,0,1118889
fldAp,0.09090909090909091,10,10,TTCCTTTTTTAACAGTTCAT,0,1183587
fldAp,0.09090909090909091,10,10,TTCCTTCAGCTATGCGGAAC,0,1105882
fldAp,0.09090909090909091,10,10,TTCCGGCCCCCGGGAAGCAA,0,1072980
fldAp,0.09090909090909091,10,10,TTCCGCTTGAGGCTTATTAT,0,1136851
fldAp,0.09090909090909091,10,10,TTCCCTGTAGGATAGACTAA,0,1083963
fldAp,0.09090909090909091,10,10,TTCACAAAGAAGTTTCGGTC,0,1167516
fldAp,0.09090909090909091,10,10,TTATGGCTGAAGATCCTCAG,0,1169938
fldAp,0.09090909090909091,10,10,TTATCTTGGCAAAATCGCTT,0,1121534
fldAp,0.09090909090909091,10,10,TTATCCTATCCGGTGCCCAT,0,1125465
fldAp,0.09090909090909091,10,10,TTATACGCTGTCTAAGAGTG,0,1167802
fldAp,0.09090909090909091,10,10,TTAGTTCGTCCCGGACCATC,0,1064845
fldAp,0.09090909090909091,10,10,TTAGTTCGATTGCAGTTGAT,0,1182643
fldAp,0.09090909090909091,10,10,TTAGTAGCTTATTGCCGTTT,0,1144395
fldAp,0.09090909090909091,10,10,TTAGCGCATCGCGCGATCCA,0,1071530
fldAp,0.09090909090909091,10,10,TTAGAGTCGCTACGAGACAG,0,1107228
fldAp,0.09090909090909091,10,10,TTACTTCGAACAGCAGGGTC,0,1159059
fldAp,0.09090909090909091,10,10,TTACTCTTAGTCCGGTGTAC,0,1148180
fldAp,0.09090909090909091,10,10,TTACCGCGAAGATGGAATAT,0,1149346
fldAp,0.09090909090909091,10,10,TTACATTGCAGTGGCAAGCA,0,1185984
fldAp,0.09090909090909091,10,10,TGTGTTGGGATGGTTATTTA,0,1142649
fldAp,0.09090909090909091,10,10,TGTGTCACCAGGCGCAGCAG,0,1102543
fldAp,0.09090909090909091,10,10,TGTGAGGGGAATCGATCGGA,0,1090992
fldAp,0.09090909090909091,10,10,TGTGACCGCCTTAATTCCTG,0,1167665
fldAp,0.09090909090909091,10,10,TGTCGGAGACAGGCATGTTC,0,1169808
fldAp,0.09090909090909091,10,10,TGTATTTATTATCCAATTAA,0,1120642
fldAp,0.09090909090909091,10,10,TGTATTGAGTGGTCACCAGT,0,1156360
fldAp,0.09090909090909091,10,10,TGTAGTTCAAGCCGTTCACA,0,1167444
fldAp,0.09090909090909091,10,10,TGTAGGTTGCGTGTCATGTA,0,1084759
fldAp,0.09090909090909091,10,10,TGTACATCCGACGAAAGAAT,0,1150156
fldAp,0.09090909090909091,10,10,TGGTTTTTGTCATCCGGTTG,0,1102111
fldAp,0.09090909090909091,10,10,TGGTTGTATAGTCGGAATGC,0,1145514
fldAp,0.09090909090909091,10,10,TGGTTCTCCGAATTGCTTCA,0,1137782
fldAp,0.09090909090909091,10,10,TGGTTAGCGGGGGCCATTCG,0,1170143
fldAp,0.09090909090909091,10,10,TGGTGTCTTATACGTAGATG,0,1148481
fldAp,0.09090909090909091,10,10,TGGGTTCAGAATGATTTTTT,0,1111866
fldAp,0.09090909090909091,10,10,TGGGAGTGGGGCTGGGTCGG,0,1178981
fldAp,0.09090909090909091,10,10,TGGCTGGTCTCGGATGTCCT,0,1185964
fldAp,0.09090909090909091,10,10,TGGCCGAACTGTAGACAAGA,0,1100419
fldAp,0.09090909090909091,10,10,TGGCAGGTAATAACAGATCT,0,1150775
fldAp,0.09090909090909091,10,10,TGGAGGGGCGCTTGTATATA,0,1180760
fldAp,0.09090909090909091,10,10,TGGAGCGTGATGTCTAGAAC,0,1148400
fldAp,0.09090909090909091,10,10,TGGACTCTTATGTAAGTGTT,0,1104820
fldAp,0.09090909090909091,10,10,TGCTGCGTGAAAGTTTTAAG,0,1086233
fldAp,0.09090909090909091,10,10,TGCTGCGTCTGATGGATACC,0,1092996
fldAp,0.09090909090909091,10,10,TGCGTGTAGCCTGAAACGAA,0,1072883
fldAp,0.09090909090909091,10,10,TGCGAGCCCCTATGTCCTTC,0,1087518
fldAp,0.09090909090909091,10,10,TGCCGGTTGTAACAGAGGTC,0,1183257
fldAp,0.09090909090909091,10,10,TGCCCTGACGTGCTGAAGCT,0,1072194
fldAp,0.09090909090909091,10,10,TGCATGCACGCGTCGTTGTG,0,1085713
fldAp,0.09090909090909091,10,10,TGCAGGCGCATGCTCACTCA,0,1133756
fldAp,0.09090909090909091,10,10,TGCACTGTTCATAGCTTGCC,0,1064537
fldAp,0.09090909090909091,10,10,TGCAAATACGGTGTAACTGA,0,1071872
fldAp,0.09090909090909091,10,10,TGATGATGCTCCCTCGTTTA,0,1085254
fldAp,0.09090909090909091,10,10,TGATCTGCGCTTACCTTAGG,0,1124504
fldAp,0.09090909090909091,10,10,TGATCTGCGCCCTTGGTCGT,0,1161441
fldAp,0.09090909090909091,10,10,TGATCTCTTGATGACGTAAA,0,1084671
fldAp,0.09090909090909091,10,10,TGATAATCTGTAACTGCGGA,0,1139455
fldAp,0.09090909090909091,10,10,TGAGTTTTGGGGTTCAGGGA,0,1071041
fldAp,0.09090909090909091,10,10,TGAGTGCATTCCCACCCAGA,0,1122587
fldAp,0.09090909090909091,10,10,TGAGTAATTTGACCCGGCGA,0,1121389
fldAp,0.09090909090909091,10,10,TGAGGGCTATTACCTGTGAG,0,1087538
fldAp,0.09090909090909091,10,10,TGAGGAAACGTATGCTGTTA,0,1064568
fldAp,0.09090909090909091,10,10,TGAGCGTCTAAGACACAGCG,0,1151008
fldAp,0.09090909090909091,10,10,TGAGACTGACGGTTGTCAGG,0,1137879
fldAp,0.09090909090909091,10,10,TGACCCCCAGTACTTACGCG,0,1185033
fldAp,0.09090909090909091,10,10,TGACATTGAAATGGCGTCAC,0,1142430
fldAp,0.09090909090909091,10,10,TGACAGAGTAACCTCTGACA,0,1083946
fldAp,0.09090909090909091,10,10,TGAATAGGATTTGGAACAAC,0,1098673
fldAp,0.09090909090909091,10,10,TGAAGTGGGGTCTGGAGCCC,0,1105401
fldAp,0.09090909090909091,10,10,TGAAATACGGGAGTAGGAAA,0,1118826
fldAp,0.09090909090909091,10,10,TCTTCGATTGTCAACGTAAC,0,1175257
fldAp,0.09090909090909091,10,10,TCTTCAGCTCGTCAACCGGC,0,1185297
fldAp,0.09090909090909091,10,10,TCTGGGCGCAGGAGCTTCGG,0,1168968
fldAp,0.09090909090909091,10,10,TCTGCTTTTGCACAAAATAA,0,1098736
fldAp,0.09090909090909091,10,10,TCTCGCGCGAGTCCAGCTGC,0,1081128
fldAp,0.09090909090909091,10,10,TCTATTGGTGGAAGCGGAGT,0,1170955
fldAp,0.09090909090909091,10,10,TCTATTAAGTATAGCTGCCG,0,1069379
fldAp,0.09090909090909091,10,10,TCTATCAGATTGCACAGCAA,0,1114306
fldAp,0.09090909090909091,10,10,TCTAGCAGCAGTAAGGCCCC,0,1184553
fldAp,0.09090909090909091,10,10,TCTACTATCAACGGCACGTG,0,1146730
fldAp,0.09090909090909091,10,10,TCTAAAGCCAATATGCTAAG,0,1169329
fldAp,0.09090909090909091,10,10,TCGTTTGCCTCTTCAGCGTA,0,1092651
fldAp,0.09090909090909091,10,10,TCGTGCGTTACTAAATAACG,0,1126377
fldAp,0.09090909090909091,10,10,TCGTGAGGTATGGAACGATA,0,1129318
fldAp,0.09090909090909091,10,10,TCGTCCATTCCCTTCAAGAC,0,1100811
fldAp,0.09090909090909091,10,10,TCGTCAGATGCGCTGTATCT,0,1141609
fldAp,0.09090909090909091,10,10,TCGTATCATCCACTGGGCGC,0,1119696
fldAp,0.09090909090909091,10,10,TCGGATGAGCTCCGTCTCCT,0,1064941
fldAp,0.09090909090909091,10,10,TCGCTGGATACATAGGACGT,0,1177535
fldAp,0.09090909090909091,10,10,TCGCGTCGTGAAATCTATAA,0,1137237
fldAp,0.09090909090909091,10,10,TCGCCGTTCCCTAGGTGGGA,0,1097919
fldAp,0.09090909090909091,10,10,TCGCACACCGTTATTGAATC,0,1145365
fldAp,0.09090909090909091,10,10,TCGATAGGCGAGCTGTAACA,0,1101017
fldAp,0.09090909090909091,10,10,TCCTGTCGTCCCAGAGGGAT,0,1178915
fldAp,0.09090909090909091,10,10,TCCTGACATTGTGGGCCTCT,0,1123646
fldAp,0.09090909090909091,10,10,TCCGCAACAGGAAAAGTTGG,0,1145626
fldAp,0.09090909090909091,10,10,TCCGAGTAGTACTGCTCACC,0,1168255
fldAp,0.09090909090909091,10,10,TCCGAACCCTACGAGGTGCT,0,1070843
fldAp,0.09090909090909091,10,10,TCCCTTGGCACTCGCAGTAT,0,1183577
fldAp,0.09090909090909091,10,10,TCCCTAGGTGCGCGTTGTAA,0,1069413
fldAp,0.09090909090909091,10,10,TCCCGTTGGGTTGTAGGTAT,0,1074944
fldAp,0.09090909090909091,10,10,TCCCATTTTCATTCAAAACT,0,1123550
fldAp,0.09090909090909091,10,10,TCCAGGTTCCTGGGAAGCAT,0,1138442
fldAp,0.09090909090909091,10,10,TCCAAGTGTGTTTATACGCG,0,1114924
fldAp,0.09090909090909091,10,10,TCCAAACGTGGCTTGTCCGT,0,1142918
fldAp,0.09090909090909091,10,10,TCATTGAGAAAAAGTTAGAA,0,1175546
fldAp,0.09090909090909091,10,10,TCATCGCAGCAGAGCTCGCA,0,1134223
fldAp,0.09090909090909091,10,10,TCATCAAGTGTAGCGTTCAG,0,1147140
fldAp,0.09090909090909091,10,10,TCATATAGGACCCGTCATAT,0,1085124
fldAp,0.09090909090909091,10,10,TCATACCTTTTCGCTGACAA,0,1109553
fldAp,0.09090909090909091,10,10,TCATACAACTGGATAGGCGC,0,1121531
fldAp,0.09090909090909091,10,10,TCAGCATAGGCCTTCGACTG,0,1141706
fldAp,0.09090909090909091,10,10,TCAGATATTCGTCGCCGCAG,0,1078785
fldAp,0.09090909090909091,10,10,TCAGATAAGGCGTGATATTT,0,1183762
fldAp,0.09090909090909091,10,10,TCACCGCCCGTTTGAGCTTC,0,1137540
fldAp,0.09090909090909091,10,10,TCACCCCGGACGGTATACGA,0,1091021
fldAp,0.09090909090909091,10,10,TCACCATTCAGGGGTAAGTT,0,1148640
fldAp,0.09090909090909091,10,10,TCAATTGGACGGCGCTATTG,0,1159966
fldAp,0.09090909090909091,10,10,TCAATGGGACCATGCCCAAA,0,1064136
fldAp,0.09090909090909091,10,10,TCAATAGCGATGGAGTTACG,0,1114671
fldAp,0.09090909090909091,10,10,TCAAGCATTCTTGAAGTAGG,0,1141730
fldAp,0.09090909090909091,10,10,TCAACACCCAGGGGGTCCAG,0,1102160
fldAp,0.09090909090909091,10,10,TATTTTTCGGTAACGGAATC,0,1133556
fldAp,0.09090909090909091,10,10,TATTTTGCCCTCACTCGTGA,0,1123552
fldAp,0.09090909090909091,10,10,TATTTATTCAGCTAGGTCAC,0,1122893
fldAp,0.09090909090909091,10,10,TATTTACCCTAAAGAGGGGG,0,1160104
fldAp,0.09090909090909091,10,10,TATTCATTTTCTAGCCTCAC,0,1069992
fldAp,0.09090909090909091,10,10,TATGCTTTCTCGCGAACGCC,0,1097418
fldAp,0.09090909090909091,10,10,TATCTTCGTTAACTTCTAAG,0,1115376
fldAp,0.09090909090909091,10,10,TATCTTCGCCATGGCGATAC,0,1157521
fldAp,0.09090909090909091,10,10,TATCCGGTCCCAGTGCGAGC,0,1100974
fldAp,0.09090909090909091,10,10,TATCCCCATTGTGTACGCGG,0,1161363
fldAp,0.09090909090909091,10,10,TATATCCATCGGCAGTGACC,0,1085117
fldAp,0.09090909090909091,10,10,TATATAACAAAGGAACCCTA,0,1098927
fldAp,0.09090909090909091,10,10,TAGCTTCTTTAGCCTTAACT,0,1096317
fldAp,0.09090909090909091,10,10,TAGCGTACAGCTATGCCGAG,0,1173016
fldAp,0.09090909090909091,10,10,TAGCCTCCTCACGAATCGGT,0,1099163
fldAp,0.09090909090909091,10,10,TAGCCTACGCTGTTGTTGTT,0,1147084
fldAp,0.09090909090909091,10,10,TAGCCACCAACGTGGACACC,0,1169146
fldAp,0.09090909090909091,10,10,TAGCACGCTAGGTCTTGGCG,0,1079377
fldAp,0.09090909090909091,10,10,TAGATTCGGTAGGTATACCC,0,1166208
fldAp,0.09090909090909091,10,10,TAGATAGTCGCATCTAGGAA,0,1117163
fldAp,0.09090909090909091,10,10,TAGACACCAGCACACGACTA,0,1077966
fldAp,0.09090909090909091,10,10,TAGAAACACCTATATCGTAG,0,1125572
fldAp,0.09090909090909091,10,10,TACTTAAGGTATTGTACGGT,0,1140584
fldAp,0.09090909090909091,10,10,TACTGTCGATATGAGTATGT,0,1169342
fldAp,0.09090909090909091,10,10,TACTGGTACACGTATCTCTA,0,1144201
fldAp,0.09090909090909091,10,10,TACTCGATCGCGGGTAACTT,0,1183738
fldAp,0.09090909090909091,10,10,TACTCATCGTAGTATTTCTG,0,1122858
fldAp,0.09090909090909091,10,10,TACTATCCCTTTCTAGTCTA,0,1166857
fldAp,0.09090909090909091,10,10,TACTAACGCACGGACGAATA,0,1091443
fldAp,0.09090909090909091,10,10,TACTAACCCTGCGGCAAGGT,0,1097246
fldAp,0.09090909090909091,10,10,TACGGATAGTTTATTTGAGA,0,1159986
fldAp,0.09090909090909091,10,10,TACGCACAAAAGCGAGGATC,0,1123854
fldAp,0.09090909090909091,10,10,TACCTAGTCGCTAGACCTGA,0,1157534
fldAp,0.09090909090909091,10,10,TACCTAATTCGAGTTGTAAG,0,1115172
fldAp,0.09090909090909091,10,10,TACCGATAGAAATAGGCATG,0,1172454
fldAp,0.09090909090909091,10,10,TACCAATCGGGTTGAGGGGC,0,1102426
fldAp,0.09090909090909091,10,10,TACATTATACCGATCTCGCT,0,1142648
fldAp,0.09090909090909091,10,10,TACAGATTCAATTGCAGGAT,0,1175701
fldAp,0.09090909090909091,10,10,TACACACCTGAATATGCCTA,0,1084452
fldAp,0.09090909090909091,10,10,TAATTAGGCAGGTCTCAGAA,0,1175736
fldAp,0.09090909090909091,10,10,TAATGGGCGAATTAATCATC,0,1132861
fldAp,0.09090909090909091,10,10,TAAGTGAAAAACGAGCGGAA,0,1129992
fldAp,0.09090909090909091,10,10,TAAGATACTCACTCTCATCC,0,1070492
fldAp,0.09090909090909091,10,10,TAACAGGTACGTGTTTCATC,0,1091883
fldAp,0.09090909090909091,10,10,TAACAAATGCAGCACTTGTA,0,1130554
fldAp,0.09090909090909091,10,10,TAAACGCCAACACTTGCGGC,0,1159788
fldAp,0.09090909090909091,10,10,GTTTGTACATACCAAAGAGA,0,1082800
fldAp,0.09090909090909091,10,10,GTTTGGACTCTAGGTACGAA,0,1118842
fldAp,0.09090909090909091,10,10,GTTTCTTAGTAGCCTCGTAC,0,1144509
fldAp,0.09090909090909091,10,10,GTTTCTCGCCTAGGGAGCAG,0,1095850
fldAp,0.09090909090909091,10,10,GTTTCCATGGGAGACAAAGT,0,1181593
fldAp,0.09090909090909091,10,10,GTTGTCGATGGCGCATCGCC,0,1159969
fldAp,0.09090909090909091,10,10,GTTGTATAGAGCTGCCGGAG,0,1179656
fldAp,0.09090909090909091,10,10,GTTGGTACACATATCATTGA,0,1064475
fldAp,0.09090909090909091,10,10,GTTGGAAGTTACGCAGAGGC,0,1098039
fldAp,0.09090909090909091,10,10,GTTGCCGGAGACTCCCCGAC,0,1110105
fldAp,0.09090909090909091,10,10,GTTGCATCCGACGGACGGCA,0,1091286
fldAp,0.09090909090909091,10,10,GTTGAAGATCCGCTCCGTGA,0,1091747
fldAp,0.09090909090909091,10,10,GTTCTGCCCCATGTTCGGCC,0,1163516
fldAp,0.09090909090909091,10,10,GTTCGCAGGTATAGCGGCCC,0,1149374
fldAp,0.09090909090909091,10,10,GTGCTTCAACGGAGACAGAC,0,1123730
fldAp,0.09090909090909091,10,10,GTGCGCTTCGGGGTATACTA,0,1068074
fldAp,0.09090909090909091,10,10,GTGCGATGTTCCCTCCCACA,0,1090675
fldAp,0.09090909090909091,10,10,GTGCCCTGTTTTAGCTTTGA,0,1183462
fldAp,0.09090909090909091,10,10,GTGATTCTAGTCTGCATCCT,0,1151451
fldAp,0.09090909090909091,10,10,GTCTTGGGGAGAGGCGCCCA,0,1099186
fldAp,0.09090909090909091,10,10,GTCTCGCTGCCGACGTCAGA,0,1141404
fldAp,0.09090909090909091,10,10,GTCTCCTTCAATCCGGGACT,0,1079298
fldAp,0.09090909090909091,10,10,GTCGTCCCAGCGGGACACGT,0,1159781
fldAp,0.09090909090909091,10,10,GTCGGTTATTTTCCCGCATG,0,1145831
fldAp,0.09090909090909091,10,10,GTCGGTATGGCTGAACCGAC,0,1096867
fldAp,0.09090909090909091,10,10,GTCGGTAAGGGACTCTGTTC,0,1067769
fldAp,0.09090909090909091,10,10,GTCGGACCTCGACGCTGGCC,0,1091228
fldAp,0.09090909090909091,10,10,GTCGATAGGCAACCCCACAT,0,1151786
fldAp,0.09090909090909091,10,10,GTCGAGGGCTTGTAGATCTA,0,1089000
fldAp,0.09090909090909091,10,10,GTCCTTGCTGCATCAGCCCC,0,1093632
fldAp,0.09090909090909091,10,10,GTCATTCCGAACGGTTATAT,0,1120861
fldAp,0.09090909090909091,10,10,GTCAGGTCTCGCCAGCTGGG,0,1135048
fldAp,0.09090909090909091,10,10,GTCAGAATCTGGGATCCCGT,0,1117522
fldAp,0.09090909090909091,10,10,GTCACTCAGTGCCTCAAATT,0,1092047
fldAp,0.09090909090909091,10,10,GTATTAGTGCATGGCCCCGG,0,1124663
fldAp,0.09090909090909091,10,10,GTATGGCGTCAGTTTTCACA,0,1084095
fldAp,0.09090909090909091,10,10,GTAGTCCTCCTTCCGCTTAT,0,1092980
fldAp,0.09090909090909091,10,10,GTAGGGCTGTCACTAAAAGT,0,1092644
fldAp,0.09090909090909091,10,10,GTAGCACAGACGTACCGCTT,0,1070550
fldAp,0.09090909090909091,10,10,GTAGAAATACTTCTTCGGAA,0,1160672
fldAp,0.09090909090909091,10,10,GTACTAGCTAGATTCGAGGT,0,1132397
fldAp,0.09090909090909091,10,10,GTACGGAAAATTTGGAGCAA,0,1107187
fldAp,0.09090909090909091,10,10,GTACGCGAAAATCTTGTTCC,0,1120993
fldAp,0.09090909090909091,10,10,GTACGCCCACTCGGCCTTGA,0,1127248
fldAp,0.09090909090909091,10,10,GTACCTTGTACTATGTGTTA,0,1069211
fldAp,0.09090909090909091,10,10,GTACATGCCGACATTCAATA,0,1155107
fldAp,0.09090909090909091,10,10,GTACACCATGCAGCTGAAGA,0,1175013
fldAp,0.09090909090909091,10,10,GTAATAGCCGTATATCAAAT,0,1128267
fldAp,0.09090909090909091,10,10,GTAATACAGTATCTTCATTG,0,1077119
fldAp,0.09090909090909091,10,10,GTAACTACTAGCAAACTGAC,0,1111976
fldAp,0.09090909090909091,10,10,GTAAATCAGTTAGGGCGCGC,0,1089938
fldAp,0.09090909090909091,10,10,GGTTTTACATAAAGCTAAGT,0,1166202
fldAp,0.09090909090909091,10,10,GGTTTGTGCCAGCCTCAAGT,0,1124130
fldAp,0.09090909090909091,10,10,GGTTTATCAAGGGCGACCGC,0,1077410
fldAp,0.09090909090909091,10,10,GGTTGTCAAAAGGATGCTCC,0,1147590
fldAp,0.09090909090909091,10,10,GGTTGGATTTCTCTCTTACA,0,1087589
fldAp,0.09090909090909091,10,10,GGTTCCGTTAACTGGGATAT,0,1171911
fldAp,0.09090909090909091,10,10,GGTGTTAAAGACGTGAATTG,0,1119453
fldAp,0.09090909090909091,10,10,GGTGGTACACCAGGATTCTG,0,1114584
fldAp,0.09090909090909091,10,10,GGTGGATGATCACTGAGTTA,0,1109014
fldAp,0.09090909090909091,10,10,GGTGACGAGAGCGTTTACAT,0,1136930
fldAp,0.09090909090909091,10,10,GGTCTCTCGTTTATGTATGC,0,1165048
fldAp,0.09090909090909091,10,10,GGTCCTTCCGAGTAATTCGC,0,1086610
fldAp,0.09090909090909091,10,10,GGTCCACATCAATTGACCGA,0,1147787
fldAp,0.09090909090909091,10,10,GGTATTGTCAAGCCACGAGT,0,1182850
fldAp,0.09090909090909091,10,10,GGGTTACAGCATATTGATGG,0,1129736
fldAp,0.09090909090909091,10,10,GGGTCCAACTACTCAACCAT,0,1178313
fldAp,0.09090909090909091,10,10,GGGGTCGGTGCGCCCGCTCA,0,1108828
fldAp,0.09090909090909091,10,10,GGGGTCAGTCGGCTAACGCG,0,1078404
fldAp,0.09090909090909091,10,10,GGGGCTCTGCATACGTGGGT,0,1153417
fldAp,0.09090909090909091,10,10,GGGGCACATAGCCAGTAAAG,0,1072884
fldAp,0.09090909090909091,10,10,GGGGATAGGTTGGCCCATGG,0,1080817
fldAp,0.09090909090909091,10,10,GGGCTATCTACGAAAATGCA,0,1102781
fldAp,0.09090909090909091,10,10,GGGCCCTGTCTTCCCTAATA,0,1166482
fldAp,0.09090909090909091,10,10,GGGCCAGCGAGCGCGCGATC,0,1120711
fldAp,0.09090909090909091,10,10,GGGCATCCGTCCGACTAAGT,0,1103041
fldAp,0.09090909090909091,10,10,GGGCACCCAACTCCTATCCA,0,1113092
fldAp,0.09090909090909091,10,10,GGGACGAATTCCCATAATAT,0,1075473
fldAp,0.09090909090909091,10,10,GGCGTTGACGTCAATAGGGC,0,1108829
fldAp,0.09090909090909091,10,10,GGCGTAAGCTTTGCTGGTTT,0,1120388
fldAp,0.09090909090909091,10,10,GGCGGTCATCTGTGTATCCT,0,1079990
fldAp,0.09090909090909091,10,10,GGCGGGTGGCTAAGGCTGAT,0,1181952
fldAp,0.09090909090909091,10,10,GGCGAGAGCGCGGCTGGCAA,0,1075420
fldAp,0.09090909090909091,10,10,GGCCTAGAACAAAGGTGCAG,0,1107580
fldAp,0.09090909090909091,10,10,GGCCGCATGCATAATGCGTC,0,1145278
fldAp,0.09090909090909091,10,10,GGCCAGATCCACAGTGTCGC,0,1134303
fldAp,0.09090909090909091,10,10,GGCACTGTAATCATTAGTGG,0,1122508
fldAp,0.09090909090909091,10,10,GGCAAGTCGTTACGGAAAGA,0,1132242
fldAp,0.09090909090909091,10,10,GGATGTTAGGTGATTTGTAA,0,1137460
fldAp,0.09090909090909091,10,10,GGATGTGACAATGGATAATA,0,1080596
fldAp,0.09090909090909091,10,10,GGATGTGAATGAATGCCGCA,0,1100026
fldAp,0.09090909090909091,10,10,GGATGGTTTACACACAGCAG,0,1129364
fldAp,0.09090909090909091,10,10,GGATCAAGTTTATGCCGAAC,0,1182372
fldAp,0.09090909090909091,10,10,GGATACGGTCAGTCTAAATT,0,1178590
fldAp,0.09090909090909091,10,10,GGAGGTACCGCGCACTGGGT,0,1186723
fldAp,0.09090909090909091,10,10,GGAGGGCGCGCACCGCGAAT,0,1135167
fldAp,0.09090909090909091,10,10,GGACGGTGGGATTAAGTGTG,0,1148741
fldAp,0.09090909090909091,10,10,GGACGGGGCGCTCAAGTGTG,0,1075351
fldAp,0.09090909090909091,10,10,GGACGACCGCCCTTACCCCG,0,1158415
fldAp,0.09090909090909091,10,10,GGAAGTATAAGGGTCCCGAT,0,1087486
fldAp,0.09090909090909091,10,10,GGAAGGATCGCCTCCCCAGA,0,1125695
fldAp,0.09090909090909091,10,10,GGAACTTGCCTGTTTGTAAG,0,1118849
fldAp,0.09090909090909091,10,10,GGAAACGTTAGGACCCTCAG,0,1092658
fldAp,0.09090909090909091,10,10,GGAAACAGTGTGCGAGCTTA,0,1142261
fldAp,0.09090909090909091,10,10,GCTGGGCGGCCAGTCCCTTG,0,1084831
fldAp,0.09090909090909091,10,10,GCTGACAATCTCCACGGGTA,0,1131361
fldAp,0.09090909090909091,10,10,GCTCGGCGTTAGAGGCCTTC,0,1156787
fldAp,0.09090909090909091,10,10,GCTCGCTTAAGGACTGTCCC,0,1163789
fldAp,0.09090909090909091,10,10,GCTCGACCAAGAAGTCCTGC,0,1103142
fldAp,0.09090909090909091,10,10,GCTCCTTCTCGTGACCGGTA,0,1133588
fldAp,0.09090909090909091,10,10,GCTCCAGGGCTTGATCGTCT,0,1067834
fldAp,0.09090909090909091,10,10,GCTCAACCTCCGCGCATCAA,0,1114142
fldAp,0.09090909090909091,10,10,GCTATCATCTTTATCTCTGG,0,1111543
fldAp,0.09090909090909091,10,10,GCTATCAAAAGCACACTGAC,0,1103723
fldAp,0.09090909090909091,10,10,GCTAGTCGCTCGAGGTTAAA,0,1078837
fldAp,0.09090909090909091,10,10,GCTACGATTAAGAGAGGCGA,0,1162932
fldAp,0.09090909090909091,10,10,GCGTTGGCGTATCCCTTCAC,0,1096110
fldAp,0.09090909090909091,10,10,GCGTTCCGTCTGCGCGCCGG,0,1180807
fldAp,0.09090909090909091,10,10,GCGTTCAAACAGGTGGGACT,0,1084183
fldAp,0.09090909090909091,10,10,GCGTGTCCCAGTGGAACGCC,0,1117490
fldAp,0.09090909090909091,10,10,GCGTATAATTGTCGGGTGGA,0,1121585
fldAp,0.09090909090909091,10,10,GCGTACGAGCATATGGCCCT,0,1169416
fldAp,0.09090909090909091,10,10,GCGGGGAGGTACATGTCTCA,0,1175525
fldAp,0.09090909090909091,10,10,GCGGGACAAGGTCTAAACCT,0,1183842
fldAp,0.09090909090909091,10,10,GCGGAGTAAATCTCTGTTTT,0,1090332
fldAp,0.09090909090909091,10,10,GCGCGCCCTATCTATTTGTG,0,1119056
fldAp,0.09090909090909091,10,10,GCGCACAGACAGCGGCAGCC,0,1090331
fldAp,0.09090909090909091,10,10,GCGCAAGTTGGCAGCTCGAA,0,1068138
fldAp,0.09090909090909091,10,10,GCGACTACTTTATTGGCGGA,0,1064606
fldAp,0.09090909090909091,10,10,GCCTGCGGCACACAAGCGGG,0,1146539
fldAp,0.09090909090909091,10,10,GCCTAGGCAGCCTGGCGAAA,0,1119944
fldAp,0.09090909090909091,10,10,GCCCGATGAAGGATAATATG,0,1082768
fldAp,0.09090909090909091,10,10,GCCCCCGCAGAAAGAGTAAG,0,1119724
fldAp,0.09090909090909091,10,10,GCCATGGGCGGGGGACTCAA,0,1113842
fldAp,0.09090909090909091,10,10,GCCATCCGGTTGCTTCTAGG,0,1088631
fldAp,0.09090909090909091,10,10,GCCAGGACTGGGGTAATCGA,0,1063050
fldAp,0.09090909090909091,10,10,GCCACGGTCGAAGTTCAGGC,0,1077745
fldAp,0.09090909090909091,10,10,GCCACGGATACGTCTAGACA,0,1116954
fldAp,0.09090909090909091,10,10,GCCACCAGTTCAGGCGCACC,0,1164206
fldAp,0.09090909090909091,10,10,GCATTATGATATGAGTGACG,0,1077417
fldAp,0.09090909090909091,10,10,GCATGGCGGAGTACCCAGGT,0,1148803
fldAp,0.09090909090909091,10,10,GCATCGTTCCCTTGCCAAAT,0,1104200
fldAp,0.09090909090909091,10,10,GCATATAGTGGCAAGGTAGA,0,1166728
fldAp,0.09090909090909091,10,10,GCAGAGGCAAGAGCAGGCAT,0,1171899
fldAp,0.09090909090909091,10,10,GCAATCACCTGGTTTGGAAA,0,1068752
fldAp,0.09090909090909091,10,10,GCAAGGACACCACGGCATTG,0,1156964
fldAp,0.09090909090909091,10,10,GCAACCCAACGTCAGTTATT,0,1084830
fldAp,0.09090909090909091,10,10,GATTTAACGGACCCGTGGAC,0,1104763
fldAp,0.09090909090909091,10,10,GATTGATTTTACATGGTGGA,0,1091558
fldAp,0.09090909090909091,10,10,GATTATTATATTCTTTCTAA,0,1152474
fldAp,0.09090909090909091,10,10,GATTATGCCAGTAACCCGAA,0,1105261
fldAp,0.09090909090909091,10,10,GATGGGATCCTATGAGTTAA,0,1092649
fldAp,0.09090909090909091,10,10,GATGGCCACTGCTATCCAGG,0,1102200
fldAp,0.09090909090909091,10,10,GATGATTGACTATTGCGGCT,0,1085285
fldAp,0.09090909090909091,10,10,GATGAATCCTATGGCTGATA,0,1156358
fldAp,0.09090909090909091,10,10,GATCGAAGTATGGAATCACG,0,1090268
fldAp,0.09090909090909091,10,10,GATACAAGGAACTTCGAGAA,0,1185369
fldAp,0.09090909090909091,10,10,GAGTTTTCTTTAGTGTGTAA,0,1164837
fldAp,0.09090909090909091,10,10,GAGTGGGCGGTATCACCGCT,0,1132395
fldAp,0.09090909090909091,10,10,GAGGTTGGAGGCGTTCAGTC,0,1175607
fldAp,0.09090909090909091,10,10,GAGGTTCTTAACGCGCCCAG,0,1165012
fldAp,0.09090909090909091,10,10,GAGGTTATGTCGAGTGTGGC,0,1130259
fldAp,0.09090909090909091,10,10,GAGGGCGCAAGGTCAAGTGA,0,1091352
fldAp,0.09090909090909091,10,10,GAGGCCGGTTAAGCGTTACT,0,1098921
fldAp,0.09090909090909091,10,10,GAGGCAGAGTATAGGTCTAA,0,1114106
fldAp,0.09090909090909091,10,10,GAGGATTCCCCCTCATTCAA,0,1065110
fldAp,0.09090909090909091,10,10,GAGGAAACGTGGGGAATGGT,0,1079854
fldAp,0.09090909090909091,10,10,GAGCTTCCCCGCCCGTGATT,0,1127274
fldAp,0.09090909090909091,10,10,GAGCTGAGGCTTTCCATTAG,0,1138342
fldAp,0.09090909090909091,10,10,GAGCTATATATCCGTTCTCG,0,1139042
fldAp,0.09090909090909091,10,10,GAGCCGGGGTGCGATCTCTC,0,1085516
fldAp,0.09090909090909091,10,10,GAGCACTGGATGAATGTGTT,0,1071157
fldAp,0.09090909090909091,10,10,GAGATACCCCAACTACAATT,0,1140967
fldAp,0.09090909090909091,10,10,GAGAGCGCGGCTACGACCTA,0,1185818
fldAp,0.09090909090909091,10,10,GAGACTGCGCCCGGGCTCGT,0,1150214
fldAp,0.09090909090909091,10,10,GAGACATTATAAAATAAAAT,0,1112983
fldAp,0.09090909090909091,10,10,GACTTTAACGATGTACTCAC,0,1098123
fldAp,0.09090909090909091,10,10,GACTGGGCTCTCGAATGCGT,0,1146809
fldAp,0.09090909090909091,10,10,GACTAGGGACAGTTGACCAA,0,1155069
fldAp,0.09090909090909091,10,10,GACGGTCCACCTTAGGGTCC,0,1111442
fldAp,0.09090909090909091,10,10,GACGCTAGCCGGCGTCGTAG,0,1186188
fldAp,0.09090909090909091,10,10,GACCTTCAGTTGGATTCTAT,0,1150168
fldAp,0.09090909090909091,10,10,GACCTCGATTTATCTGGTGC,0,1146930
fldAp,0.09090909090909091,10,10,GACCGGTGCGGCACAGTATG,0,1105211
fldAp,0.09090909090909091,10,10,GACCCTAAAGGATCTCTCTG,0,1177643
fldAp,0.09090909090909091,10,10,GACAAACCCCAGGAGTCGCC,0,1080790
fldAp,0.09090909090909091,10,10,GAATTTAGTCTGTCATGACC,0,1108997
fldAp,0.09090909090909091,10,10,GAATGTGGAGTGAGATTTGT,0,1169734
fldAp,0.09090909090909091,10,10,GAACTTGTAGAAAAATTGGT,0,1098952
fldAp,0.09090909090909091,10,10,GAAATTATCGTGAAGTATGG,0,1177917
fldAp,0.09090909090909091,10,10,GAAAGTAGTACGATGCAGCT,0,1138750
fldAp,0.09090909090909091,10,10,GAAAATGCTTTCCTGCACAC,0,1099980
fldAp,0.09090909090909091,10,10,GAAAACCAGATGCGCAGGGG,0,1092094
fldAp,0.09090909090909091,10,10,GAAAACAGCGCTAAGAAGTA,0,1170135
fldAp,0.09090909090909091,10,10,CTTTGCAATAGTATCGGCAG,0,1085635
fldAp,0.09090909090909091,10,10,CTTGTCCGTACCGCCTCACT,0,1118415
fldAp,0.09090909090909091,10,10,CTTGGCACCTTACTCTAGTG,0,1154996
fldAp,0.09090909090909091,10,10,CTTGCGCTTTCGACGAGGGA,0,1132229
fldAp,0.09090909090909091,10,10,CTTGCGCGTACTCTCGGGTT,0,1149167
fldAp,0.09090909090909091,10,10,CTTGCCAGTTCTCAAATGGG,0,1093617
fldAp,0.09090909090909091,10,10,CTTGCCAATTCAGAATCAGC,0,1125816
fldAp,0.09090909090909091,10,10,CTTGAAACAACTTCAGTATA,0,1116795
fldAp,0.09090909090909091,10,10,CTTCTAGAGTGAACTAAATG,0,1180865
fldAp,0.09090909090909091,10,10,CTTCGACGAACAATGTCAGG,0,1090749
fldAp,0.09090909090909091,10,10,CTTCCTATATCCAAGGTCTG,0,1175888
fldAp,0.09090909090909091,10,10,CTTCCGGTTTTGACCATTTA,0,1118536
fldAp,0.09090909090909091,10,10,CTTCCCTAGGCCAGCGCTAA,0,1123527
fldAp,0.09090909090909091,10,10,CTTAGATTCTAGGGCGGCAT,0,1073677
fldAp,0.09090909090909091,10,10,CTTAACCGAGTGTAAATTAG,0,1115362
fldAp,0.09090909090909091,10,10,CTGTGGGTGGTTAATGAAAT,0,1155152
fldAp,0.09090909090909091,10,10,CTGTGCCAGGATAAGCCATT,0,1102176
fldAp,0.09090909090909091,10,10,CTGTCGCGGCTTTAAGCCGT,0,1159250
fldAp,0.09090909090909091,10,10,CTGTCATGTCACCGGTCACT,0,1166166
fldAp,0.09090909090909091,10,10,CTGGGTGGTGGCGGCGCCCA,0,1107008
fldAp,0.09090909090909091,10,10,CTGGATTACATCGGCTCAAT,0,1163742
fldAp,0.09090909090909091,10,10,CTGCTGCTCCCCATCCAAGA,0,1144098
fldAp,0.09090909090909091,10,10,CTGCTGCTCATTAGTCTGGA,0,1078366
fldAp,0.09090909090909091,10,10,CTGCTCCAGTTTGCTGGGTT,0,1091433
fldAp,0.09090909090909091,10,10,CTGCCACTTGGATGTCAGCG,0,1143912
fldAp,0.09090909090909091,10,10,CTGCACGTCTATTCATGCCA,0,1092908
fldAp,0.09090909090909091,10,10,CTGAGATAGGCCAGTCCGTA,0,1179459
fldAp,0.09090909090909091,10,10,CTCGGCGATGTCCCATGCGT,0,1117766
fldAp,0.09090909090909091,10,10,CTCGCCTTTGGATGGTCAAG,0,1182732
fldAp,0.09090909090909091,10,10,CTCCACAGCACTGCAAGCAT,0,1170908
fldAp,0.09090909090909091,10,10,CTCATGACGCATCTGATTGT,0,1093620
fldAp,0.09090909090909091,10,10,CTCAAGCCACAACTAAACTC,0,1162887
fldAp,0.09090909090909091,10,10,CTCAACCCGCCAATCCCCGG,0,1164455
fldAp,0.09090909090909091,10,10,CTATTTAGTGTTACAACGGT,0,1123312
fldAp,0.09090909090909091,10,10,CTATTGATTTCGGTGCAGGT,0,1176370
fldAp,0.09090909090909091,10,10,CTATTCTGGCTGCGCCTAAG,0,1115563
fldAp,0.09090909090909091,10,10,CTATGTGTTTTGAACGTAAA,0,1087835
fldAp,0.09090909090909091,10,10,CTATAGTAGTCTCCAAGACT,0,1102088
fldAp,0.09090909090909091,10,10,CTACTTGAAGGTGGTGAGCT,0,1151171
fldAp,0.09090909090909091,10,10,CTACGACAGACAAAAACTCT,0,1140507
fldAp,0.09090909090909091,10,10,CTACATTGGTATCCCGTCGG,0,1159398
fldAp,0.09090909090909091,10,10,CTACAATGGCTGCTAGTATT,0,1120633
fldAp,0.09090909090909091,10,10,CTAATGTTAGCTAGAAGAAT,0,1145394
fldAp,0.09090909090909091,10,10,CTAACGCCGCCGGTGGCCTC,0,1149547
fldAp,0.09090909090909091,10,10,CTAAACGGAGGCGAGTTAGT,0,1165585
fldAp,0.09090909090909091,10,10,CTAAAACTCTAAGCTTATCA,0,1165312
fldAp,0.09090909090909091,10,10,CGTTTCTACACGCTGCCACG,0,1163621
fldAp,0.09090909090909091,10,10,CGTTTAATCAGCGTAAAGTA,0,1143282
fldAp,0.09090909090909091,10,10,CGTTATGGTGTACCGTATGT,0,1124174
fldAp,0.09090909090909091,10,10,CGTTATGATAGATACTTGAC,0,1178837
fldAp,0.09090909090909091,10,10,CGTTAACTAATAGATGGAGT,0,1110067
fldAp,0.09090909090909091,10,10,CGTGGGCTTGAAATCCCTGA,0,1162953
fldAp,0.09090909090909091,10,10,CGTGCCTCGTTACGTTAGGC,0,1063586
fldAp,0.09090909090909091,10,10,CGTGAAAACCTAAGTGATGG,0,1130422
fldAp,0.09090909090909091,10,10,CGTCTGGGTCTCTCCTCTGA,0,1170051
fldAp,0.09090909090909091,10,10,CGTCGTCTGGGTACGTCGAT,0,1133686
fldAp,0.09090909090909091,10,10,CGTCGGTGCCGCATTGGATA,0,1100173
fldAp,0.09090909090909091,10,10,CGTCGGACGTGTTCAAAAAG,0,1163109
fldAp,0.09090909090909091,10,10,CGTCAAGTCCGAGAATCCGA,0,1170398
fldAp,0.09090909090909091,10,10,CGTATAGGGGCAGGTCAGAT,0,1129729
fldAp,0.09090909090909091,10,10,CGTAATTGACCAAAAGACGT,0,1117036
fldAp,0.09090909090909091,10,10,CGGTTCGGGAAAAATTCTCC,0,1122275
fldAp,0.09090909090909091,10,10,CGGTGAACCCGGTTCGACAC,0,1151262
fldAp,0.09090909090909091,10,10,CGGTATCTTATTAGTGCAGG,0,1147785
fldAp,0.09090909090909091,10,10,CGGTACGGTAAGGGGAGAAT,0,1161626
fldAp,0.09090909090909091,10,10,CGGTACATTCACGTATCGGG,0,1138089
fldAp,0.09090909090909091,10,10,CGGGTTGAGTTGAGCCGCGC,0,1109570
fldAp,0.09090909090909091,10,10,CGGGTGTTACTCTAGGGTTT,0,1144342
fldAp,0.09090909090909091,10,10,CGGGTAGTAATATCGCTGAA,0,1143014
fldAp,0.09090909090909091,10,10,CGGGGCACCTAGGTTGTATG,0,1117269
fldAp,0.09090909090909091,10,10,CGGGCACAGCGCCTCTACAG,0,1163282
fldAp,0.09090909090909091,10,10,CGGCCGTACAATGAGCCGCG,0,1112079
fldAp,0.09090909090909091,10,10,CGGCCATGAATTCGTAGCTA,0,1118207
fldAp,0.09090909090909091,10,10,CGGCACCGTCCGGCTCTTTG,0,1150796
fldAp,0.09090909090909091,10,10,CGGCAAAATGGATAGTATGA,0,1103593
fldAp,0.09090909090909091,10,10,CGGACGACTAGACTCGCTTC,0,1132238
fldAp,0.09090909090909091,10,10,CGCTGGAAACAACCCGTGGG,0,1158896
fldAp,0.09090909090909091,10,10,CGCTCGCCCATTCCTCAACA,0,1159065
fldAp,0.09090909090909091,10,10,CGCGGGCGGACTTTATGTTT,0,1173773
fldAp,0.09090909090909091,10,10,CGCGATGGGCGTTGCGCCAC,0,1141176
fldAp,0.09090909090909091,10,10,CGCGAGAGGAACGGTTTATC,0,1082046
fldAp,0.09090909090909091,10,10,CGCCTGCGGTATATAGCTCC,0,1071589
fldAp,0.09090909090909091,10,10,CGCCGGCTAGTTTAGGTGTT,0,1136360
fldAp,0.09090909090909091,10,10,CGCCAGATGTCGTTACGCGA,0,1128264
fldAp,0.09090909090909091,10,10,CGCAGGTATGAATCCAGAGC,0,1138049
fldAp,0.09090909090909091,10,10,CGCAGCGACTAGGGATGATC,0,1164847
fldAp,0.09090909090909091,10,10,CGCAGAGGCGCTACCTGCAG,0,1118682
fldAp,0.09090909090909091,10,10,CGCAGAGATGAATATTTTGT,0,1120609
fldAp,0.09090909090909091,10,10,CGCACGCCCGGTCCAAACCC,0,1172082
fldAp,0.09090909090909091,10,10,CGCACACCAACAATCCTCGG,0,1118164
fldAp,0.09090909090909091,10,10,CGATTTAAGCCATGGCTCCT,0,1068770
fldAp,0.09090909090909091,10,10,CGATTGAAACAAGTCACATG,0,1063414
fldAp,0.09090909090909091,10,10,CGATTAGTAGCTGCATTTCA,0,1147107
fldAp,0.09090909090909091,10,10,CGATGCAATTACTGGAGGGT,0,1077329
fldAp,0.09090909090909091,10,10,CGATCCACGGGGTATACTTT,0,1157562
fldAp,0.09090909090909091,10,10,CGATAAGCTGCTGATTCCAT,0,1080677
fldAp,0.09090909090909091,10,10,CGAGGGTACAGCGACGGCAA,0,1090028
fldAp,0.09090909090909091,10,10,CGAGGAATATCACCAATACT,0,1123090
fldAp,0.09090909090909091,10,10,CGACTTCGGCCTTAAGTAAT,0,1131788
fldAp,0.09090909090909091,10,10,CGACTGGACTTGCCGACCGC,0,1090233
fldAp,0.09090909090909091,10,10,CGACCTATGAGCTTGACACG,0,1116016
fldAp,0.09090909090909091,10,10,CGACCATCAGGGCTCCGGGA,0,1075871
fldAp,0.09090909090909091,10,10,CGAACCTGGTCATCAAATGC,0,1116455
fldAp,0.09090909090909091,10,10,CCTTTGCAACCTCGGGTTAT,0,1170940
fldAp,0.09090909090909091,10,10,CCTTGCAGCTAACATCCCTG,0,1146270
fldAp,0.09090909090909091,10,10,CCTTGAGGGCTGACAAGGAA,0,1174706
fldAp,0.09090909090909091,10,10,CCTGCCTTCGCGACACTTGC,0,1126829
fldAp,0.09090909090909091,10,10,CCTGACATGGCGTAATCACA,0,1103543
fldAp,0.09090909090909091,10,10,CCTGACACTCCGCATTCCAC,0,1114017
fldAp,0.09090909090909091,10,10,CCTCTATCTTTCAGGACAAT,0,1079023
fldAp,0.09090909090909091,10,10,CCTCGGGCGGGATAAATTCT,0,1064080
fldAp,0.09090909090909091,10,10,CCTCCGGCAGCGGGTAGTAT,0,1073917
fldAp,0.09090909090909091,10,10,CCTCCACGGCTCGTAAAACA,0,1157955
fldAp,0.09090909090909091,10,10,CCTACCAACATGCTGAGACA,0,1116183
fldAp,0.09090909090909091,10,10,CCGTTAACCTCGCTAATCGC,0,1168151
fldAp,0.09090909090909091,10,10,CCGTGGGCACCCACAGCTAT,0,1084589
fldAp,0.09090909090909091,10,10,CCGTCCCGCTACCCACAGCT,0,1141064
fldAp,0.09090909090909091,10,10,CCGGTCATGATCGGTTTTGT,0,1163279
fldAp,0.09090909090909091,10,10,CCGGGATCGGCGCCGCGGTG,0,1155278
fldAp,0.09090909090909091,10,10,CCGGAATACCGCTTCTGCGA,0,1176607
fldAp,0.09090909090909091,10,10,CCGCCGGAACTGCTGGCAGC,0,1167971
fldAp,0.09090909090909091,10,10,CCGCAGGTGCTACACATATG,0,1134500
fldAp,0.09090909090909091,10,10,CCGCAAATGGTGTAATTAGG,0,1181227
fldAp,0.09090909090909091,10,10,CCGATCTCCATCATACATGA,0,1130922
fldAp,0.09090909090909091,10,10,CCGACCCTCGGGAACGATGA,0,1182587
fldAp,0.09090909090909091,10,10,CCCTTGTGACGGGTGGTCAT,0,1136707
fldAp,0.09090909090909091,10,10,CCCTTCTGTTTTAGGCAATG,0,1122509
fldAp,0.09090909090909091,10,10,CCCGGTGTGCAATGAGGGAA,0,1160799
fldAp,0.09090909090909091,10,10,CCCGGTCTAAGGGACTGCAA,0,1081231
fldAp,0.09090909090909091,10,10,CCCCTTTTTTGCTTGAAATT,0,1073757
fldAp,0.09090909090909091,10,10,CCCCTGCTCCCTGCCGGCAA,0,1071241
fldAp,0.09090909090909091,10,10,CCCCTAATCGACTTGCAACA,0,1158978
fldAp,0.09090909090909091,10,10,CCCCGCTGAGAACATTCTGG,0,1083736
fldAp,0.09090909090909091,10,10,CCCCAAGGAATGTGTTCATA,0,1142543
fldAp,0.09090909090909091,10,10,CCCAGTCAATTGAAGTCTTC,0,1104889
fldAp,0.09090909090909091,10,10,CCCACTTGCCCCTAAGTAGA,0,1175692
fldAp,0.09090909090909091,10,10,CCATTTGCTAAAGCCTCTAC,0,1123665
fldAp,0.09090909090909091,10,10,CCATCCGTTATTGGCTGTGT,0,1150459
fldAp,0.09090909090909091,10,10,CCATAAGGATCTCACCCGTG,0,1159422
fldAp,0.09090909090909091,10,10,CCAGTTCTGCACAAGCGGGA,0,1107474
fldAp,0.09090909090909091,10,10,CCAGGGCATACATCGACAAG,0,1126643
fldAp,0.09090909090909091,10,10,CCAGGATACATGTGCGGCGT,0,1071070
fldAp,0.09090909090909091,10,10,CCAGGAGAAAGCCGACTCGA,0,1074121
fldAp,0.09090909090909091,10,10,CCAGCTCTCATCGGATCTTA,0,1099254
fldAp,0.09090909090909091,10,10,CCAGACTGTCAGGTCTCTTT,0,1069886
fldAp,0.09090909090909091,10,10,CCACTATTGGAGGATTGGAT,0,1092044
fldAp,0.09090909090909091,10,10,CCACTATTATGAACTCTGTA,0,1077155
fldAp,0.09090909090909091,10,10,CCACCCTAGACGGACTAACT,0,1167127
fldAp,0.09090909090909091,10,10,CCACCCCGCCCGCGCTGTCG,0,1115303
fldAp,0.09090909090909091,10,10,CCACAACGCAACTCGACCTA,0,1079302
fldAp,0.09090909090909091,10,10,CCAATATTGGTGGGGGTAGT,0,1170100
fldAp,0.09090909090909091,10,10,CATTGTCTTAGTGAGAGCCT,0,1097245
fldAp,0.09090909090909091,10,10,CATTGGATCGTTTTAAACTA,0,1185261
fldAp,0.09090909090909091,10,10,CATTGCGGTGAATCTTTAGG,0,1113288
fldAp,0.09090909090909091,10,10,CATTCGAAGGTGACCGTGCC,0,1113073
fldAp,0.09090909090909091,10,10,CATTAGCGGGAAGGTGTGCA,0,1153612
fldAp,0.09090909090909091,10,10,CATGGCACGTCGAACCCTTT,0,1089327
fldAp,0.09090909090909091,10,10,CATCTATGTAACATAAGTGC,0,1114726
fldAp,0.09090909090909091,10,10,CATCCCTATGAATTCGGTAT,0,1103268
fldAp,0.09090909090909091,10,10,CATCAGAGCACCACACAGAA,0,1103839
fldAp,0.09090909090909091,10,10,CATAGCGAACAAAATGTATC,0,1104073
fldAp,0.09090909090909091,10,10,CATAAGGGACAAAAGCTAAT,0,1140469
fldAp,0.09090909090909091,10,10,CATAACTCGCCTTTCTCAAT,0,1127667
fldAp,0.09090909090909091,10,10,CAGTGGAAGCCCTTGCAATT,0,1178362
fldAp,0.09090909090909091,10,10,CAGTCGTCTACGGAAAGAGC,0,1159567
fldAp,0.09090909090909091,10,10,CAGGTTGTTTCAGCCTACAT,0,1093835
fldAp,0.09090909090909091,10,10,CAGGTTACCTTGACAAACTA,0,1176558
fldAp,0.09090909090909091,10,10,CAGGTCTATGATATGATGCG,0,1154753
fldAp,0.09090909090909091,10,10,CAGGGTGCCTTTGGGAGATT,0,1088605
fldAp,0.09090909090909091,10,10,CAGGGCGGACATGGCACTAT,0,1163015
fldAp,0.09090909090909091,10,10,CAGGCTGCGCGCGGGTATAT,0,1121868
fldAp,0.09090909090909091,10,10,CAGGATATGCGTAGGTACTT,0,1094229
fldAp,0.09090909090909091,10,10,CAGCTCACTCTCAGTCTCAG,0,1138991
fldAp,0.09090909090909091,10,10,CAGCGCCCGCATGGGTGTGG,0,1154508
fldAp,0.09090909090909091,10,10,CAGCCGCGCGGTACGGGTGG,0,1168847
fldAp,0.09090909090909091,10,10,CAGCCATTTCTGAATGAGGT,0,1123644
fldAp,0.09090909090909091,10,10,CAGCATTCAAAATAGCAGCT,0,1067388
fldAp,0.09090909090909091,10,10,CAGCATGCGGCAGGGTACCC,0,1126823
fldAp,0.09090909090909091,10,10,CAGCAGTCGGCAATGGTTCG,0,1103875
fldAp,0.09090909090909091,10,10,CAGCAGCTGCATCGAGTCAA,0,1149917
fldAp,0.09090909090909091,10,10,CAGCAGATGCGCCGATTTCC,0,1108580
fldAp,0.09090909090909091,10,10,CAGAGGGCCTGGCGCCGTTC,0,1170093
fldAp,0.09090909090909091,10,10,CAGAGCGCCACGAGCACTAT,0,1173069
fldAp,0.09090909090909091,10,10,CAGAGAACTTCCCGTCCCCC,0,1169601
fldAp,0.09090909090909091,10,10,CAGACGGAACCGTGATGTAT,0,1082287
fldAp,0.09090909090909091,10,10,CAGAAGTCCAGGGGGGTACT,0,1185645
fldAp,0.09090909090909091,10,10,CACTGGTAGTTCGAATCATG,0,1140193
fldAp,0.09090909090909091,10,10,CACTGGGGCGTCTTGCCGCT,0,1140471
fldAp,0.09090909090909091,10,10,CACTGCGGTAGCTGTTAAAA,0,1139041
fldAp,0.09090909090909091,10,10,CACTACAAATGGCGGGCTTA,0,1146460
fldAp,0.09090909090909091,10,10,CACGCTTTCTGCTCTGGGTA,0,1173076
fldAp,0.09090909090909091,10,10,CACGCCGCCTGACGGCAGGC,0,1121850
fldAp,0.09090909090909091,10,10,CACGCCGACGAGGGCGCAAC,0,1063869
fldAp,0.09090909090909091,10,10,CACCCGGCAGCAAGGGGCTT,0,1106787
fldAp,0.09090909090909091,10,10,CACCCGAACGACGAGCATCA,0,1145095
fldAp,0.09090909090909091,10,10,CACATAGCACTGGAGTCCGC,0,1109639
fldAp,0.09090909090909091,10,10,CACAAAGACGGGGAAACGCC,0,1176255
fldAp,0.09090909090909091,10,10,CAATTAGCCATCGATTTTAG,0,1079696
fldAp,0.09090909090909091,10,10,CAAGTTAGCCTCTCTTTGAC,0,1150545
fldAp,0.09090909090909091,10,10,CAAGGACTAACTTGAATAGT,0,1094091
fldAp,0.09090909090909091,10,10,CAAGACTATCGCATCTGAAT,0,1153089
fldAp,0.09090909090909091,10,10,CAAGACACGCAGACAGCCTA,0,1136308
fldAp,0.09090909090909091,10,10,CAACCTTGACGTTGGAAGTG,0,1098587
fldAp,0.09090909090909091,10,10,CAACCTACTCTTACCGTCTA,0,1180613
fldAp,0.09090909090909091,10,10,CAACAGGGTATCCTTGAGGG,0,1063366
fldAp,0.09090909090909091,10,10,CAAACCCAATATAATACAAT,0,1140267
fldAp,0.09090909090909091,10,10,CAAAACTGTGGACGAGTAAT,0,1160950
fldAp,0.09090909090909091,10,10,ATTTATGTTTACTACGTAAT,0,1064027
fldAp,0.09090909090909091,10,10,ATTTAGCAAGGCGCACTGAT,0,1150281
fldAp,0.09090909090909091,10,10,ATTTAACCTTTATTTCAATA,0,1132654
fldAp,0.09090909090909091,10,10,ATTCTCGTTTGCAAGTTTTC,0,1091987
fldAp,0.09090909090909091,10,10,ATTCACATGCTCTGCGAGTA,0,1124649
fldAp,0.09090909090909091,10,10,ATTCAAGTAGTCGCGTTCCT,0,1141617
fldAp,0.09090909090909091,10,10,ATTCAAGAAGGTAACGTGTC,0,1104340
fldAp,0.09090909090909091,10,10,ATTATTATTCGGCAGCGCGG,0,1157731
fldAp,0.09090909090909091,10,10,ATTAGTTTTAACGGATAATA,0,1159555
fldAp,0.09090909090909091,10,10,ATTAGTGCGGTCGCGTAAGC,0,1080512
fldAp,0.09090909090909091,10,10,ATTACGCGAGGGCGCGTGAG,0,1068661
fldAp,0.09090909090909091,10,10,ATTACAGATGTGCTTGTATC,0,1132741
fldAp,0.09090909090909091,10,10,ATGTTCGGGCTATCTTAATT,0,1163677
fldAp,0.09090909090909091,10,10,ATGTTACCTGGTCTACGTGG,0,1104243
fldAp,0.09090909090909091,10,10,ATGTGGCAACCACCGCCGAG,0,1174729
fldAp,0.09090909090909091,10,10,ATGTCCGGTCATCCACGCAG,0,1110375
fldAp,0.09090909090909091,10,10,ATGTCACGGGCACGCACTAT,0,1177539
fldAp,0.09090909090909091,10,10,ATGGGTTCGTAAATGAACTA,0,1087273
fldAp,0.09090909090909091,10,10,ATGGGTCAGTCTGTGTTGGC,0,1064155
fldAp,0.09090909090909091,10,10,ATGGGCGCTTAACAACAAAG,0,1105163
fldAp,0.09090909090909091,10,10,ATGGATTACGAGGTAGTTGT,0,1174678
fldAp,0.09090909090909091,10,10,ATGGACCAAGGCCGAGGAGT,0,1161658
fldAp,0.09090909090909091,10,10,ATGCGGTAAAATCATAAGCC,0,1133825
fldAp,0.09090909090909091,10,10,ATGCGGGCGATGCACAATGG,0,1081035
fldAp,0.09090909090909091,10,10,ATGCGGATCAAAAATGTCTG,0,1102218
fldAp,0.09090909090909091,10,10,ATGCCCCGCAGGAGATTACA,0,1135960
fldAp,0.09090909090909091,10,10,ATGATCTTGTGATCCTTGCC,0,1129832
fldAp,0.09090909090909091,10,10,ATGATCAGCTGGAGGGTCAA,0,1157367
fldAp,0.09090909090909091,10,10,ATGAACAATACAACCAGGCT,0,1180097
fldAp,0.09090909090909091,10,10,ATCTTATTAGGGCCAGTGAA,0,1098540
fldAp,0.09090909090909091,10,10,ATCTCGCTAGGCGGGAAAGT,0,1120964
fldAp,0.09090909090909091,10,10,ATCGGGCTCCCTGGTAGGAG,0,1124481
fldAp,0.09090909090909091,10,10,ATCGGCGACCAGAGTTAGAT,0,1184863
fldAp,0.09090909090909091,10,10,ATCGCAACGCAACGGCTACC,0,1087517
fldAp,0.09090909090909091,10,10,ATCGACGAAGAGCATAGCTA,0,1104617
fldAp,0.09090909090909091,10,10,ATCCTTCCTCGGAACGTTAC,0,1134307
fldAp,0.09090909090909091,10,10,ATCCGCTAGGCTGGAGAATA,0,1090324
fldAp,0.09090909090909091,10,10,ATCCGATTCAGGTCCCACGG,0,1077824
fldAp,0.09090909090909091,10,10,ATCCGAAGGCGCTAAGCTGA,0,1135425
fldAp,0.09090909090909091,10,10,ATCCAAATCCACGTGCTCGT,0,1112503
fldAp,0.09090909090909091,10,10,ATCATTCAAATGCGCGAAGC,0,1098312
fldAp,0.09090909090909091,10,10,ATCACTGTAACCCGCTGGGA,0,1087398
fldAp,0.09090909090909091,10,10,ATCAAGCAGCACGTAGGTCA,0,1165662
fldAp,0.09090909090909091,10,10,ATATTGAGACGAGAGCCAGA,0,1134835
fldAp,0.09090909090909091,10,10,ATATCGGCAGTCTTTCCTGT,0,1101576
fldAp,0.09090909090909091,10,10,ATATATTGGGTGGACGTTTA,0,1168619
fldAp,0.09090909090909091,10,10,ATATATTACGCTCACGTTTG,0,1081941
fldAp,0.09090909090909091,10,10,ATAGGATCTATCCCACACCT,0,1121305
fldAp,0.09090909090909091,10,10,ATACTTCCACGGCAAACTAG,0,1072517
fldAp,0.09090909090909091,10,10,ATACGGGAACAATCCCACAT,0,1067836
fldAp,0.09090909090909091,10,10,ATACGCAGGTGCCTCTAAAT,0,1099138
fldAp,0.09090909090909091,10,10,ATACGAATGGCGAGACGTGG,0,1173477
fldAp,0.09090909090909091,10,10,ATACAGAACAGAAACTTCCT,0,1076509
fldAp,0.09090909090909091,10,10,ATACAATTTGAGGAATGTCA,0,1183668
fldAp,0.09090909090909091,10,10,ATACAAAAGCAGAAGGTTAT,0,1136673
fldAp,0.09090909090909091,10,10,ATAATGTCACATTAAACTTG,0,1095368
fldAp,0.09090909090909091,10,10,ATAACTGCCGTGTCAGGGGA,0,1156651
fldAp,0.09090909090909091,10,10,ATAACATCTTCGCCGGGGGA,0,1156767
fldAp,0.09090909090909091,10,10,AGTTTCACACAAGTTACCTC,0,1134418
fldAp,0.09090909090909091,10,10,AGTTGGGAAGTGGGAGTCAT,0,1173006
fldAp,0.09090909090909091,10,10,AGTTGCTTAGATGAACACTA,0,1137047
fldAp,0.09090909090909091,10,10,AGTTCTATAGGGGCCAGTGC,0,1171472
fldAp,0.09090909090909091,10,10,AGTTAATGAAAGCTATCTTC,0,1128415
fldAp,0.09090909090909091,10,10,AGTGGTCAACAAAGCGAAGG,0,1076327
fldAp,0.09090909090909091,10,10,AGTCTGCTGGTTCCTTCATA,0,1084039
fldAp,0.09090909090909091,10,10,AGTCGTTACTAAGACCGGCG,0,1173941
fldAp,0.09090909090909091,10,10,AGTCGAATGGAGTCTCTGGA,0,1122303
fldAp,0.09090909090909091,10,10,AGTCAGTTCAGAGCAAGTGT,0,1144782
fldAp,0.09090909090909091,10,10,AGTATTGGAACAACGTGTGA,0,1086977
fldAp,0.09090909090909091,10,10,AGTAGTCTCCCTACCAACGT,0,1131456
fldAp,0.09090909090909091,10,10,AGTACGAACTGTGGGAACAG,0,1182133
fldAp,0.09090909090909091,10,10,AGGTTTGAGTATATGTGGTA,0,1070607
fldAp,0.09090909090909091,10,10,AGGTGAGTTACCGTCCTCCG,0,1178605
fldAp,0.09090909090909091,10,10,AGGTCCATGTCTAGTTTTCA,0,1101767
fldAp,0.09090909090909091,10,10,AGGGGTGAGTTCGGACCAAG,0,1072101
fldAp,0.09090909090909091,10,10,AGGGGATATGCGATTTGAAC,0,1090025
fldAp,0.09090909090909091,10,10,AGGGCCCCGGTTAGCGCTGC,0,1112244
fldAp,0.09090909090909091,10,10,AGGATTCTCGTGGCAACCGG,0,1066980
fldAp,0.09090909090909091,10,10,AGGATGTGTCGATGTGGGTG,0,1086396
fldAp,0.09090909090909091,10,10,AGGAACGTCTACCCAGAATA,0,1153954
fldAp,0.09090909090909091,10,10,AGGAACCCCCCAACAAGAGT,0,1177977
fldAp,0.09090909090909091,10,10,AGCTCCTGGTGCGATCTTCC,0,1087629
fldAp,0.09090909090909091,10,10,AGCCCAGTCTGGGTCGCCCA,0,1140092
fldAp,0.09090909090909091,10,10,AGCCCAGGGGTATGCTAGGC,0,1101317
fldAp,0.09090909090909091,10,10,AGCATTAAAGGAATCTTTGT,0,1067737
fldAp,0.09090909090909091,10,10,AGCATCGGATACCCCGAGCC,0,1115610
fldAp,0.09090909090909091,10,10,AGCATCCTCCGCATCGCCAA,0,1128061
fldAp,0.09090909090909091,10,10,AGCATCAGAGCGCATTACAA,0,1084631
fldAp,0.09090909090909091,10,10,AGCATATCGCATTGGTTTTA,0,1066942
fldAp,0.09090909090909091,10,10,AGCACGGGGGCACATTCAGT,0,1074768
fldAp,0.09090909090909091,10,10,AGATTAAAATTCTTAGGGCG,0,1149384
fldAp,0.09090909090909091,10,10,AGATGGCATAAGGCATCGTA,0,1167712
fldAp,0.09090909090909091,10,10,AGATACTTCGCACATAAAAG,0,1152844
fldAp,0.09090909090909091,10,10,AGAGAAAGCTTTCGAGAACG,0,1065479
fldAp,0.09090909090909091,10,10,AGACTATCGACCTTTACTCC,0,1117446
fldAp,0.09090909090909091,10,10,AGACTACAGCGTCCCACTGG,0,1095896
fldAp,0.09090909090909091,10,10,AGACGGTTAACGCTACCGGA,0,1118552
fldAp,0.09090909090909091,10,10,AGACCCGGAGCGGGCCTGAT,0,1079912
fldAp,0.09090909090909091,10,10,AGACACGGATATCGATCACC,0,1154238
fldAp,0.09090909090909091,10,10,AGAATGCGCTCGATGAACGA,0,1110521
fldAp,0.09090909090909091,10,10,AGAATCCCTTAGTTTGATAT,0,1129325
fldAp,0.09090909090909091,10,10,AGAAGTTCAAGAAGCATAGC,0,1090218
fldAp,0.09090909090909091,10,10,AGAAATCGACGTCAAACGTC,0,1063830
fldAp,0.09090909090909091,10,10,ACTTTTTTGGTATTGAGAAC,0,1131947
fldAp,0.09090909090909091,10,10,ACTTTCGGGCATTCAAAATT,0,1174163
fldAp,0.09090909090909091,10,10,ACTTGTGTCGAGAAATTATT,0,1138593
fldAp,0.09090909090909091,10,10,ACTTAACCAGGGCTCATAAA,0,1171479
fldAp,0.09090909090909091,10,10,ACTGTTACCTCAAGGCTTGA,0,1159578
fldAp,0.09090909090909091,10,10,ACTGCCGTTTGAGCATCGGT,0,1183454
fldAp,0.09090909090909091,10,10,ACTGACTTCGTGTGTAAAGA,0,1166353
fldAp,0.09090909090909091,10,10,ACTGAAACTCTGGGGTTAAG,0,1182464
fldAp,0.09090909090909091,10,10,ACTCGCGGACTGCCGGATCT,0,1185147
fldAp,0.09090909090909091,10,10,ACTCAGAGTGAGTGTAATCT,0,1118054
fldAp,0.09090909090909091,10,10,ACTCACCAAGGCTGTAGCGT,0,1137666
fldAp,0.09090909090909091,10,10,ACTATTGGCATACACCCCTA,0,1179280
fldAp,0.09090909090909091,10,10,ACTACTCAGTGGAATGCGGA,0,1102418
fldAp,0.09090909090909091,10,10,ACTACATATTCTCTCAGTAC,0,1092722
fldAp,0.09090909090909091,10,10,ACTAAAGTCGGCGTTCGCAA,0,1184119
fldAp,0.09090909090909091,10,10,ACGTTTATTATCATACATAG,0,1063376
fldAp,0.09090909090909091,10,10,ACGTTGAAGAACATTCTATG,0,1150087
fldAp,0.09090909090909091,10,10,ACGTTCACCTATACGTTACT,0,1104752
fldAp,0.09090909090909091,10,10,ACGTGGTTCCGTTCACAGCA,0,1175871
fldAp,0.09090909090909091,10,10,ACGTACGGTTCAAGTTAGTA,0,1159890
fldAp,0.09090909090909091,10,10,ACGGGCCGTAGGTCGGCGAC,0,1103293
fldAp,0.09090909090909091,10,10,ACGGCTGTAAAATAGTTTGA,0,1153333
fldAp,0.09090909090909091,10,10,ACGGAGCTATGCTATCGGGA,0,1186887
fldAp,0.09090909090909091,10,10,ACGCGATACTGCAACGTTGA,0,1180767
fldAp,0.09090909090909091,10,10,ACGATAATATAACGTTTCAC,0,1133486
fldAp,0.09090909090909091,10,10,ACCTACATGTGATATTGGGG,0,1073761
fldAp,0.09090909090909091,10,10,ACCGGAACGAGTGCGCGCTA,0,1184318
fldAp,0.09090909090909091,10,10,ACCGCCACTATATAAACTGT,0,1086915
fldAp,0.09090909090909091,10,10,ACCCTCACGCCTTACGTACG,0,1081038
fldAp,0.09090909090909091,10,10,ACCCGTATGCCCTCATTGGA,0,1118241
fldAp,0.09090909090909091,10,10,ACCCCAACACTTACCGCCTC,0,1147414
fldAp,0.09090909090909091,10,10,ACCCACGTGCACATAACCTG,0,1093586
fldAp,0.09090909090909091,10,10,ACCAGCGGTCCGGTACCCGC,0,1088871
fldAp,0.09090909090909091,10,10,ACCACATAGACCCTGTTTAT,0,1101802
fldAp,0.09090909090909091,10,10,ACATCGGGGAACTGTGCCGC,0,1127410
fldAp,0.09090909090909091,10,10,ACATATGGATCATTCCGAAA,0,1063384
fldAp,0.09090909090909091,10,10,ACATACAACCTCATGGCGTT,0,1148636
fldAp,0.09090909090909091,10,10,ACATAAGGGCGCGCTCTAGG,0,1091385
fldAp,0.09090909090909091,10,10,ACAGCGGGCAAGCTGGATAA,0,1152294
fldAp,0.09090909090909091,10,10,ACAGCGAGCCCCGGCGTTCC,0,1114184
fldAp,0.09090909090909091,10,10,ACAGAAGTACCGAATAGACG,0,1155346
fldAp,0.09090909090909091,10,10,ACACTGGTTTGGAAATATAT,0,1114622
fldAp,0.09090909090909091,10,10,ACACTACACCCCGACACGCC,0,1163761
fldAp,0.09090909090909091,10,10,ACACCGGGGACAGGATGGGT,0,1151272
fldAp,0.09090909090909091,10,10,ACACATGTCGGTCCTGCAGA,0,1078185
fldAp,0.09090909090909091,10,10,ACACACACAGCATCCCTTCG,0,1147966
fldAp,0.09090909090909091,10,10,ACACAAGACTTCAAAATACC,0,1114674
fldAp,0.09090909090909091,10,10,ACAACCGAGCGTTCGCGTCT,0,1136905
fldAp,0.09090909090909091,10,10,ACAACAGATTTATAATACCA,0,1144627
fldAp,0.09090909090909091,10,10,AATTTGATTCCGTGGAAGTG,0,1104150
fldAp,0.09090909090909091,10,10,AATTGGGTTAAACAGATCTA,0,1116260
fldAp,0.09090909090909091,10,10,AATTGGGACAGCACGGTGAC,0,1151796
fldAp,0.09090909090909091,10,10,AATTGCCCCGAAGGGACAGT,0,1091351
fldAp,0.09090909090909091,10,10,AATTCCTAGACTTCATACTA,0,1119325
fldAp,0.09090909090909091,10,10,AATTACCCGACTGGTGCTAC,0,1072856
fldAp,0.09090909090909091,10,10,AATGTAAGCTCGCACGAATG,0,1099383
fldAp,0.09090909090909091,10,10,AATGGGGGAGATCTGAACAC,0,1180746
fldAp,0.09090909090909091,10,10,AATGGAAAAGAGCCTCAATG,0,1123472
fldAp,0.09090909090909091,10,10,AATGAGTTATTCGAAGAAAT,0,1149115
fldAp,0.09090909090909091,10,10,AATGAGCCAGCCGTTCACCC,0,1104143
fldAp,0.09090909090909091,10,10,AATCGTCACCTTGCAATCAT,0,1175288
fldAp,0.09090909090909091,10,10,AATCGGAGCGATTCTTGCAG,0,1099009
fldAp,0.09090909090909091,10,10,AATCCCAGTGGCACCTATCT,0,1169176
fldAp,0.09090909090909091,10,10,AATATGAAGCTGTGTCTTGT,0,1110531
fldAp,0.09090909090909091,10,10,AATACAGTACGCGGCTAAAA,0,1126659
fldAp,0.09090909090909091,10,10,AATAAGTCCTTTCCCGCCGG,0,1067468
fldAp,0.09090909090909091,10,10,AAGTGACTGTCTAGGGCATA,0,1094514
fldAp,0.09090909090909091,10,10,AAGTCTTTTCGGAAGCACAC,0,1092573
fldAp,0.09090909090909091,10,10,AAGTCGAGCGCTCACATGCA,0,1173702
fldAp,0.09090909090909091,10,10,AAGTCCAGTCGTCAGGCCGA,0,1064404
fldAp,0.09090909090909091,10,10,AAGTCAAAGACCAGAAATGC,0,1068087
fldAp,0.09090909090909091,10,10,AAGTACTATATTCTCGGCAT,0,1176016
fldAp,0.09090909090909091,10,10,AAGTAACAAGTAGACCACGA,0,1113812
fldAp,0.09090909090909091,10,10,AAGGTGATACGTTCCGGGTA,0,1078772
fldAp,0.09090909090909091,10,10,AAGGGGCTCTTGCATAATTG,0,1092760
fldAp,0.09090909090909091,10,10,AAGCGATATCTTAATACCTT,0,1173374
fldAp,0.09090909090909091,10,10,AAGCCGAGTGTCACAACCCA,0,1155729
fldAp,0.09090909090909091,10,10,AAGAGCGCGACTTGGGTATT,0,1174023
fldAp,0.09090909090909091,10,10,AACTAAACTTTTAACCTGCG,0,1115284
fldAp,0.09090909090909091,10,10,AACGTAGACGAATACCCCAT,0,1151896
fldAp,0.09090909090909091,10,10,AACGCATGCTTTTCAGAGTA,0,1134570
fldAp,0.09090909090909091,10,10,AACGATAGTTGACGGCTAAT,0,1066441
fldAp,0.09090909090909091,10,10,AACGACGACTAGGTCCAAGA,0,1170956
fldAp,0.09090909090909091,10,10,AACGAACGTCCTGAACAGAC,0,1088551
fldAp,0.09090909090909091,10,10,AACCTGGTATAGTACATAGG,0,1165688
fldAp,0.09090909090909091,10,10,AACCTCCCATTACTCTGGGA,0,1152616
fldAp,0.09090909090909091,10,10,AACCGGGGGTAGAATTCATT,0,1186734
fldAp,0.09090909090909091,10,10,AACATCCGTCGTCAACAAAA,0,1097164
fldAp,0.09090909090909091,10,10,AACATCCCAACATCTAACTG,0,1089295
fldAp,0.09090909090909091,10,10,AAATTCAGCAAACAGGCGAC,0,1176012
fldAp,0.09090909090909091,10,10,AAATGAGAGCCCATTGCGGG,0,1085581
fldAp,0.09090909090909091,10,10,AAATATATATCGTTCCGCGG,0,1177510
fldAp,0.09090909090909091,10,10,AAATAGCTGTAATGTGCTGC,0,1107765
fldAp,0.09090909090909091,10,10,AAAGGTCGCTTGTTCGCCTT,0,1135382
fldAp,0.09090909090909091,10,10,AAAGGGTAACGCCTTCCACT,0,1176880
fldAp,0.09090909090909091,10,10,AAAGCCGTTATATCGGTTGA,0,1174882
fldAp,0.09090909090909091,10,10,AAAGATAGCCTCTAGAGAAG,0,1146674
fldAp,0.09090909090909091,10,10,AAACGGTTATCGCTTGTTAC,0,1075459
fldAp,0.09090909090909091,10,10,AAACCCCGAAAGTGCACATC,0,1107206
fldAp,0.09090909090909091,10,10,AAAATCTTGACCGGGCATTC,0,1139244
fldAp,0.09090909090909091,10,10,AAAATCGGCGCTGGGGGTCT,0,1155931
fldAp,0.09090909090909091,10,10,AAAAGAAGTAAGATTTCCAG,0,1156383
fldAp,0.09090909090909091,10,10,AAAAAACGCTTCTGATCTCA,0,1106383
fldAp,0.1,9,9,TTTTTCAACAGGACCCGATT,0,1139884
fldAp,0.1,9,9,TTTTTAGTTTTCGGTTTTCG,0,1081312
fldAp,0.1,9,9,TTTTGCTCCGGGGCTTGGGT,0,1178525
fldAp,0.1,9,9,TTTTCGATGGGAGTACGGGT,0,1153163
fldAp,0.1,9,9,TTTGGAACTTCGGAGCTCGT,0,1145884
fldAp,0.1,9,9,TTTGCCAAGAATGGCCGGTC,0,1161263
fldAp,0.1,9,9,TTTCTTGCCACAGGAAATAG,0,1128601
fldAp,0.1,9,9,TTTCTATCCGTACGTAGAAT,0,1097160
fldAp,0.1,9,9,TTTCGAGTACTCATCCCCAT,0,1129117
fldAp,0.1,9,9,TTTCACGTGTCAATTATCAT,0,1105325
fldAp,0.1,9,9,TTTATAGGACTTTTCACCAA,0,1139145
fldAp,0.1,9,9,TTTAGTAGAGGGTTTGCCCG,0,1107096
fldAp,0.1,9,9,TTTAGAATCCAATGGCGCGA,0,1129511
fldAp,0.1,9,9,TTTACTGCACGATGTGAGGA,0,1154942
fldAp,0.1,9,9,TTGTTCCTTCACGTCGAACA,0,1067584
fldAp,0.1,9,9,TTGTCTCGGCCTCAATATGG,0,1157199
fldAp,0.1,9,9,TTGTCGCGCAAGAAAAACCC,0,1104067
fldAp,0.1,9,9,TTGTCATGATGTCCGATGTG,0,1124528
fldAp,0.1,9,9,TTGGGTATATCATTGGTGGG,0,1130188
fldAp,0.1,9,9,TTGGATTGAGTCGCCGATAT,0,1159132
fldAp,0.1,9,9,TTGCTGCTGCTAGGGGTCGG,0,1108420
fldAp,0.1,9,9,TTGCGCCCCTTCACCTAACA,0,1100233
fldAp,0.1,9,9,TTGCGCATGGCTACAGGGCG,0,1109393
fldAp,0.1,9,9,TTGCCTTATTCTGGCTCTCT,0,1070237
fldAp,0.1,9,9,TTGCAAGTCGTAACTGATGC,0,1181078
fldAp,0.1,9,9,TTGATCCCCACCAACAGGGC,0,1066988
fldAp,0.1,9,9,TTGATACGTCTCTTCTCGGG,0,1173162
fldAp,0.1,9,9,TTGAGGGCTAATCAAGGCTT,0,1125701
fldAp,0.1,9,9,TTCTTTCATTCCCTAAATTG,0,1103088
fldAp,0.1,9,9,TTCTGGGCCGCTAGTGCGTA,0,1172569
fldAp,0.1,9,9,TTCTGACGCACACTTTGGGT,0,1112579
fldAp,0.1,9,9,TTCTCACACTTGAGCGTAGC,0,1143927
fldAp,0.1,9,9,TTCGGAATGCCATTATCAAT,0,1129442
fldAp,0.1,9,9,TTCGCGTCGTGGTTATAGAG,0,1094870
fldAp,0.1,9,9,TTCGATGAACCCAGGTGGAG,0,1142395
fldAp,0.1,9,9,TTCCTAGTCACGTTTGGTTC,0,1117613
fldAp,0.1,9,9,TTCATCCCATCCGTGTATAC,0,1105030
fldAp,0.1,9,9,TTCATCAGTGGAGCCATAGG,0,1147693
fldAp,0.1,9,9,TTCACGTGTTCAAGAGGAAC,0,1088924
fldAp,0.1,9,9,TTCACGTCCGACATAGGGTC,0,1140138
fldAp,0.1,9,9,TTATGCTGGTATGACTAACT,0,1154041
fldAp,0.1,9,9,TTATGAGGTCACGGGCATTG,0,1150359
fldAp,0.1,9,9,TTATCGCAGAGTAGGGGTTT,0,1138815
fldAp,0.1,9,9,TTATCAGCAAAAAGACGCTG,0,1176985
fldAp,0.1,9,9,TTAGCGTACGATTACTCCAC,0,1125680
fldAp,0.1,9,9,TTACTTATGGTTTTATCTAT,0,1155957
fldAp,0.1,9,9,TTACCTGCTGCCGTTTGGCA,0,1154196
fldAp,0.1,9,9,TTACCTCGTTTTATATGATC,0,1104593
fldAp,0.1,9,9,TTAATTGGGCTCGTGCAGAG,0,1125880
fldAp,0.1,9,9,TTAAAAGGTAGCTCAGTTCA,0,1080323
fldAp,0.1,9,9,TGTTTCAATTTCTTAAAACA,0,1130914
fldAp,0.1,9,9,TGTTTACCACGGGCCCGGGG,0,1082492
fldAp,0.1,9,9,TGTTCGGCTGACCGTAGACT,0,1099308
fldAp,0.1,9,9,TGTTATTGGTAATCGTATTC,0,1095791
fldAp,0.1,9,9,TGTGAGGGGTACTGGTGCCA,0,1149580
fldAp,0.1,9,9,TGTATATGTAAGCTTATTTT,0,1126758
fldAp,0.1,9,9,TGTAGTCAAAAATAATGGAT,0,1181967
fldAp,0.1,9,9,TGTAGAAAATGAGCGTGATT,0,1065272
fldAp,0.1,9,9,TGTACTTTCTCTGTATTAAA,0,1089805
fldAp,0.1,9,9,TGGTTGACTCCTGGGGAGCT,0,1069715
fldAp,0.1,9,9,TGGTGAGAGCTTCTCCAAGG,0,1173642
fldAp,0.1,9,9,TGGTCTCAAGGTACGGGCAG,0,1122292
fldAp,0.1,9,9,TGGTCACCATGAGGCGGCCC,0,1174161
fldAp,0.1,9,9,TGGTCACATCCTCAGCTCGA,0,1092342
fldAp,0.1,9,9,TGGTCAAGTATGGACGGCCT,0,1179940
fldAp,0.1,9,9,TGGGTTGATCGGCCAATTCG,0,1180611
fldAp,0.1,9,9,TGGGTGCCGCCGAAATGGTT,0,1080986
fldAp,0.1,9,9,TGGGTCGTCTTAATATGGGA,0,1065090
fldAp,0.1,9,9,TGGGGTATTGTTTTGAGCTC,0,1178366
fldAp,0.1,9,9,TGGGCTTACCAGTTAGCAAT,0,1080546
fldAp,0.1,9,9,TGGGATAATCGTGACAGCGC,0,1063591
fldAp,0.1,9,9,TGGGAGTTTCAACCGCGATC,0,1164835
fldAp,0.1,9,9,TGGCTCCGTGTTCGGCTGCG,0,1125202
fldAp,0.1,9,9,TGGCTAGAATCTCAAGACGT,0,1116676
fldAp,0.1,9,9,TGGCGCATGCATCAAGGTAG,0,1065045
fldAp,0.1,9,9,TGGCCCGAAAGGACCAGATC,0,1081562
fldAp,0.1,9,9,TGGACCGTCTCAGCGAGCAA,0,1148730
fldAp,0.1,9,9,TGGACACCATTAGCGGACCT,0,1082922
fldAp,0.1,9,9,TGGAAGGGGGGGTTTCTTGG,0,1073312
fldAp,0.1,9,9,TGCTTAATGTCAAAGAGCCA,0,1178015
fldAp,0.1,9,9,TGCTGGGTAGCTTTGGTTGT,0,1101756
fldAp,0.1,9,9,TGCTCGACTTGTAGCGCGCT,0,1091678
fldAp,0.1,9,9,TGCTCAAAGTTCACGACGTG,0,1089219
fldAp,0.1,9,9,TGCTACAAATAGAGGAGGCT,0,1068235
fldAp,0.1,9,9,TGCGTTGTTATTCTTATCGT,0,1143779
fldAp,0.1,9,9,TGCGTTCATAGTACTAAGTC,0,1072879
fldAp,0.1,9,9,TGCGGCCACTCTACACAATT,0,1121463
fldAp,0.1,9,9,TGCGCTTCGGGATCGGAGAA,0,1103254
fldAp,0.1,9,9,TGCGCACCGTTAGTCGCAAG,0,1070313
fldAp,0.1,9,9,TGCCGGAAGATTGAAGCGTA,0,1089709
fldAp,0.1,9,9,TGCCGAATTACCGTGGAAAC,0,1178031
fldAp,0.1,9,9,TGCCAGCCAAAGTATGAATG,0,1161961
fldAp,0.1,9,9,TGCCAACGGGGTGATGTTCT,0,1137313
fldAp,0.1,9,9,TGCAGCATAATCACTTGCAG,0,1145188
fldAp,0.1,9,9,TGCAGATGGGTATGCGCGTT,0,1179756
fldAp,0.1,9,9,TGCACTAGGTAGCGTAAGCG,0,1171524
fldAp,0.1,9,9,TGCAAACGCATGCTCTGCCA,0,1175454
fldAp,0.1,9,9,TGATCAGATCTTAGGCAGCA,0,1074961
fldAp,0.1,9,9,TGAGTTATAACGTCCCTTCA,0,1083634
fldAp,0.1,9,9,TGAGCTGCGCTGTTGAGGTG,0,1144271
fldAp,0.1,9,9,TGAGCCTACCATCAGGAGGT,0,1183869
fldAp,0.1,9,9,TGAGCACAATGTTTGTGCTA,0,1104678
fldAp,0.1,9,9,TGAGATAAGTTGTAAGGTGT,0,1087503
fldAp,0.1,9,9,TGAGAATCTAAGTTCCGACG,0,1067772
fldAp,0.1,9,9,TGACTCAAGTTGCGTCGATA,0,1094063
fldAp,0.1,9,9,TGACGCGAGCGATCATATCG,0,1117442
fldAp,0.1,9,9,TGACCACACACACTTGTTAG,0,1091434
fldAp,0.1,9,9,TGACAAAGGTCGCAAGTATA,0,1085775
fldAp,0.1,9,9,TGAATTCTCAAAGGGTGTCG,0,1121244
fldAp,0.1,9,9,TGAAGTAAGCCAGTCGTGGG,0,1130746
fldAp,0.1,9,9,TGAAAGTTGGGCATCGAAAA,0,1116816
fldAp,0.1,9,9,TGAAAGCCCGCTTCTCCTGG,0,1080710
fldAp,0.1,9,9,TGAAACGACAGTCGCGTCAA,0,1084908
fldAp,0.1,9,9,TGAAACCTACATCACTGGCA,0,1132900
fldAp,0.1,9,9,TGAAAACCATCGTTACCGCG,0,1065869
fldAp,0.1,9,9,TCTTTCAACAGGAATCGCCC,0,1119930
fldAp,0.1,9,9,TCTTGTCGTGATCGGTCTCA,0,1099376
fldAp,0.1,9,9,TCTTCATAAGCTGAACGTGG,0,1157651
fldAp,0.1,9,9,TCTTATTGACCGAATCGGCA,0,1175033
fldAp,0.1,9,9,TCTTACATGATAACATGACT,0,1125907
fldAp,0.1,9,9,TCTGTGCTGTTTTGTCCTAA,0,1136798
fldAp,0.1,9,9,TCTCGTAGATCCACATTCGT,0,1158487
fldAp,0.1,9,9,TCTCAGTTTTTGAATCAAAT,0,1126102
fldAp,0.1,9,9,TCTATTGGCATTCTCGCTAA,0,1109582
fldAp,0.1,9,9,TCTAATTATTAGAGGCTTAT,0,1068301
fldAp,0.1,9,9,TCTAAAGGTTAAATAATTAC,0,1152598
fldAp,0.1,9,9,TCGTTTGACAATGGATAGTT,0,1115670
fldAp,0.1,9,9,TCGTTTCATGAGTGGTTAGA,0,1067169
fldAp,0.1,9,9,TCGTTCATTTACACTCAGGG,0,1151060
fldAp,0.1,9,9,TCGTCTCTACCAGAGTACTT,0,1172801
fldAp,0.1,9,9,TCGTCGGCCGCATAGCGAAA,0,1122614
fldAp,0.1,9,9,TCGTAGTTCACAATGTGTCG,0,1167597
fldAp,0.1,9,9,TCGGGCGAATCGTCTGAGGA,0,1122929
fldAp,0.1,9,9,TCGGGAATTCAAGCACGTGA,0,1140814
fldAp,0.1,9,9,TCGGAATTCGGCCACCCATA,0,1106776
fldAp,0.1,9,9,TCGCGAAACTAACCTAAGTG,0,1158040
fldAp,0.1,9,9,TCGCCGCAGTATCCAGAACT,0,1142377
fldAp,0.1,9,9,TCGCAGCACTTACGGTCTAC,0,1161292
fldAp,0.1,9,9,TCGCACCCTTGCATGTTCGG,0,1067433
fldAp,0.1,9,9,TCGATGATCAAGTTCATCGT,0,1099292
fldAp,0.1,9,9,TCGAGTTTGGAGTTGGATGA,0,1129911
fldAp,0.1,9,9,TCGAATATTGATTAATACTA,0,1075419
fldAp,0.1,9,9,TCGAAGCTCGCCCCGCCCCG,0,1167050
fldAp,0.1,9,9,TCGAAACTTGTTGTATATTC,0,1182608
fldAp,0.1,9,9,TCCTGCTGTATAGCGTATTC,0,1121591
fldAp,0.1,9,9,TCCTGCCTCATTTGTTCGGT,0,1110835
fldAp,0.1,9,9,TCCTATCGTGTTCCCTACGG,0,1123941
fldAp,0.1,9,9,TCCTATCATAAGCATGGCTC,0,1185672
fldAp,0.1,9,9,TCCGCACCAAATGTGAGCGA,0,1183534
fldAp,0.1,9,9,TCCCTGCGCTAGCGTCTGAA,0,1104966
fldAp,0.1,9,9,TCCCGTCAAAGTTCAGCTTG,0,1133691
fldAp,0.1,9,9,TCCCGGGCTTCCGGTCTTCT,0,1119455
fldAp,0.1,9,9,TCCCCGGGGGGCTTATGCGA,0,1077185
fldAp,0.1,9,9,TCCCCGAACAAATAACGCAA,0,1096479
fldAp,0.1,9,9,TCCCAGTTTAGGGTTCAGGC,0,1126225
fldAp,0.1,9,9,TCCATTAGTCCAAGAATAGT,0,1111523
fldAp,0.1,9,9,TCCATCGGCCATAGTATGAA,0,1172301
fldAp,0.1,9,9,TCCAACTTCCCTTGTAAAGG,0,1089009
fldAp,0.1,9,9,TCATCGAATCTATGACTCGA,0,1116110
fldAp,0.1,9,9,TCAGTACGCACTTTGTACAC,0,1098570
fldAp,0.1,9,9,TCAGGTAGCTTAAACATAGG,0,1078054
fldAp,0.1,9,9,TCAGGCGACACATGTTAGAC,0,1120400
fldAp,0.1,9,9,TCAGCAAACACAGAAGGATA,0,1163004
fldAp,0.1,9,9,TCAGAGGGCAAGGACGCCAC,0,1181670
fldAp,0.1,9,9,TCAGACGAGGGCGAATTGTA,0,1168335
fldAp,0.1,9,9,TCACTGGCTAGTGCGACAGA,0,1160934
fldAp,0.1,9,9,TCACGCGACTCAATCCTAGG,0,1122584
fldAp,0.1,9,9,TCACGCCCGTTACACCAAGG,0,1074797
fldAp,0.1,9,9,TCACGACGAGACCTTCGGGG,0,1130190
fldAp,0.1,9,9,TCACCTGAAGCGCTTATCCA,0,1130849
fldAp,0.1,9,9,TCACCGCCAGACCCGGGATT,0,1138436
fldAp,0.1,9,9,TCACCCATAGGATCTGCCTT,0,1092240
fldAp,0.1,9,9,TCACAGGCACGGCTAGCCCG,0,1153171
fldAp,0.1,9,9,TCACAGCGCAACACCGCATC,0,1096825
fldAp,0.1,9,9,TCAACTTAGATCGACTGTGG,0,1168849
fldAp,0.1,9,9,TATTTTAGGGAATGCGTCAA,0,1067282
fldAp,0.1,9,9,TATTGGTTTAAAGAAGGGGT,0,1144369
fldAp,0.1,9,9,TATTCGCCTACGCCGTGTCC,0,1098227
fldAp,0.1,9,9,TATTCACCACCGACACGGAC,0,1155045
fldAp,0.1,9,9,TATGGAGCTGGGTGATTAGG,0,1094934
fldAp,0.1,9,9,TATGGACTCAGGTCCCCCGT,0,1159266
fldAp,0.1,9,9,TATGGAACCCCCATAGCGAA,0,1146901
fldAp,0.1,9,9,TATGACCGTAATCGTATCTT,0,1113088
fldAp,0.1,9,9,TATCTTAGTATGTATCGGAC,0,1160863
fldAp,0.1,9,9,TATCAGACTGTATGGCTGTT,0,1154110
fldAp,0.1,9,9,TATATGGAACAGAGAGGTCT,0,1066678
fldAp,0.1,9,9,TATAGCTATGTTTTAGGGGG,0,1113205
fldAp,0.1,9,9,TATAAAGAGGATAACTGTAA,0,1074881
fldAp,0.1,9,9,TAGTCTAAACGGTCTGTTTT,0,1145215
fldAp,0.1,9,9,TAGGTGACGATTGTTCTTGT,0,1173780
fldAp,0.1,9,9,TAGGAAGAACGGCGCTCAAA,0,1071104
fldAp,0.1,9,9,TAGCTGGCATAACGAGTCTA,0,1183258
fldAp,0.1,9,9,TAGCTAAACGCGACTTATGT,0,1153237
fldAp,0.1,9,9,TAGCCGTCCTTTGCTCGCCC,0,1069035
fldAp,0.1,9,9,TAGCATGCAGGATGGTTCAC,0,1161866
fldAp,0.1,9,9,TAGAGTAAAGGCCGGACTAT,0,1099260
fldAp,0.1,9,9,TAGAGACGCAGTTTCACGGA,0,1148923
fldAp,0.1,9,9,TAGACGCAAATACTAAGGGA,0,1090845
fldAp,0.1,9,9,TAGACCGACTTTGCGCACAG,0,1117338
fldAp,0.1,9,9,TACTTAAATTACTTCCCAAG,0,1063058
fldAp,0.1,9,9,TACTATAGATATGTATTGGT,0,1168352
fldAp,0.1,9,9,TACGTTCATAAGCGGAGTTC,0,1182999
fldAp,0.1,9,9,TACGCCACTACATGCGCCGA,0,1091685
fldAp,0.1,9,9,TACGATTCGCGGGTGGGGCG,0,1148973
fldAp,0.1,9,9,TACCGTTACTTCATTGGCAT,0,1173483
fldAp,0.1,9,9,TACCAAGGTAATTTGTCGTG,0,1128998
fldAp,0.1,9,9,TACAGCCGAGGTGAAGAGGA,0,1133689
fldAp,0.1,9,9,TACACTCTTCCGAACGTCCC,0,1183506
fldAp,0.1,9,9,TACACAGGAGTGTCGTACCC,0,1099250
fldAp,0.1,9,9,TAATGGTCCATACAGCCAAT,0,1171548
fldAp,0.1,9,9,TAATGGCTGCTACCCATCGA,0,1163791
fldAp,0.1,9,9,TAATGCTGTAACGGAGTGCC,0,1123841
fldAp,0.1,9,9,TAATCTGAAATGCTATACTG,0,1110175
fldAp,0.1,9,9,TAAGTTCGCAGATCTTTAGT,0,1072347
fldAp,0.1,9,9,TAAGTAATCTTTCTTTGGAC,0,1085704
fldAp,0.1,9,9,TAACTAGGAGAAACGTGTAC,0,1180782
fldAp,0.1,9,9,TAACGCTAGGGATAATCGTA,0,1180527
fldAp,0.1,9,9,TAACAGCAGTTATAAAATGA,0,1075925
fldAp,0.1,9,9,TAACAAAAAGAATCCCAAAG,0,1158343
fldAp,0.1,9,9,TAAATTGATGTTAGCTGTCA,0,1081858
fldAp,0.1,9,9,TAAACTTACGCTCAAATAAG,0,1116287
fldAp,0.1,9,9,TAAAAATATATAAGAAGGGA,0,1125618
fldAp,0.1,9,9,TAAAAATACGTCCGATCCCA,0,1186231
fldAp,0.1,9,9,TAAAAAGAGTGTAATATGCA,0,1146694
fldAp,0.1,9,9,GTTTTCCGCAGGTTCCTTTA,0,1084201
fldAp,0.1,9,9,GTTTTCAGTAGATAGCACTA,0,1148847
fldAp,0.1,9,9,GTTTTAGACGCAGACCCTGT,0,1087528
fldAp,0.1,9,9,GTTTCAACCAGCTCTATCTG,0,1134091
fldAp,0.1,9,9,GTTGGGTTGACAAGGGCGGT,0,1107140
fldAp,0.1,9,9,GTTGGCACGTGGGGACTCAC,0,1147779
fldAp,0.1,9,9,GTTGATTACGGGGGATCGGC,0,1079745
fldAp,0.1,9,9,GTTGAGGGATTTCTAATATA,0,1085323
fldAp,0.1,9,9,GTTCTCATAGGCAATTAAGA,0,1114104
fldAp,0.1,9,9,GTTCCGGGTCCACTATATAT,0,1079538
fldAp,0.1,9,9,GTTCATTCTTACGGTTAAGC,0,1072024
fldAp,0.1,9,9,GTTATGAAGGACCCACTAAA,0,1158237
fldAp,0.1,9,9,GTTAGTGAGCTAGTATACAT,0,1144485
fldAp,0.1,9,9,GTTACTAAGGCCAACAGGCC,0,1071101
fldAp,0.1,9,9,GTTAATCCGGTAGGTCGAGG,0,1158752
fldAp,0.1,9,9,GTTAATACCGCTCGAGTATT,0,1183300
fldAp,0.1,9,9,GTGTTTGCTGGTGAGATTCG,0,1095707
fldAp,0.1,9,9,GTGTTTCAACGTGGCGCAGT,0,1110356
fldAp,0.1,9,9,GTGTCTGGTTCGGACAAGGG,0,1115790
fldAp,0.1,9,9,GTGTCGGATAACGCTAAGAT,0,1183810
fldAp,0.1,9,9,GTGTATCTAGCTTATATCCA,0,1143869
fldAp,0.1,9,9,GTGTAGTAACCTTCTGGACA,0,1068659
fldAp,0.1,9,9,GTGGTTTAGCTGCACCTCTA,0,1154779
fldAp,0.1,9,9,GTGGTGTGCCCACCGACAAG,0,1136983
fldAp,0.1,9,9,GTGGCAGACAATGCTAGAGA,0,1066954
fldAp,0.1,9,9,GTGGCACCAAGTCCAAGTCA,0,1111677
fldAp,0.1,9,9,GTGGAGGGTATCGCATGATA,0,1127609
fldAp,0.1,9,9,GTGGACACAGTGAATCTAAG,0,1163266
fldAp,0.1,9,9,GTGCTAGTGTTCCAATGTCA,0,1120404
fldAp,0.1,9,9,GTGCTAGGAGCATACGACTA,0,1085950
fldAp,0.1,9,9,GTGATGCGTACCGCATATTG,0,1081291
fldAp,0.1,9,9,GTGATCTCCGTCGTTGAATT,0,1149485
fldAp,0.1,9,9,GTGAGACTCGTGCATACATG,0,1170970
fldAp,0.1,9,9,GTGAATCGGTTCTATTCCAG,0,1179893
fldAp,0.1,9,9,GTCTTTGGGTCTGGCCGTAT,0,1115205
fldAp,0.1,9,9,GTCTCATGTTCGAAGTAATG,0,1105399
fldAp,0.1,9,9,GTCTCACGCGCGTACGGCGG,0,1146845
fldAp,0.1,9,9,GTCGGGTCGTGCAAGCTTCA,0,1148009
fldAp,0.1,9,9,GTCGCCTGTCCCGCAACTTC,0,1109403
fldAp,0.1,9,9,GTCGCCACAATAAGCTCCTC,0,1164820
fldAp,0.1,9,9,GTCGATGTTTCAAGTCGCTC,0,1143274
fldAp,0.1,9,9,GTCCCTGCCCTAAATTCTAA,0,1172628
fldAp,0.1,9,9,GTCCCGACGACGTACTCATA,0,1142195
fldAp,0.1,9,9,GTCCACACATGACGTTTCCT,0,1110841
fldAp,0.1,9,9,GTCCAATAGGAAAAGTGTCG,0,1175149
fldAp,0.1,9,9,GTCATTCAGGCATAGAATGT,0,1180111
fldAp,0.1,9,9,GTCAGTCTCAAACCCATAAG,0,1108664
fldAp,0.1,9,9,GTCAAACTGGCATTTTTCGG,0,1183172
fldAp,0.1,9,9,GTATTGGCCCCAGTGTGACC,0,1151007
fldAp,0.1,9,9,GTATGGCGGTACGGGGGACT,0,1136789
fldAp,0.1,9,9,GTATGGAGCGAAACCGACGA,0,1095573
fldAp,0.1,9,9,GTATCTCCTGGGAATCTGCT,0,1091162
fldAp,0.1,9,9,GTATATATAGCAGAAATAAA,0,1135840
fldAp,0.1,9,9,GTAGTTGGCACTAGATGGGT,0,1155285
fldAp,0.1,9,9,GTAGGCAGCACAAATAAATA,0,1065640
fldAp,0.1,9,9,GTACGGCGTGTCCTAAGTAT,0,1131570
fldAp,0.1,9,9,GTACGCTACACTGCCGCGGC,0,1163011
fldAp,0.1,9,9,GTACCGGGATGATCCATGTC,0,1086775
fldAp,0.1,9,9,GTACACAGAATTTTTGTAGG,0,1149393
fldAp,0.1,9,9,GTAATTATTTCGTAAGTTCG,0,1091537
fldAp,0.1,9,9,GTAATACCAGAACTCTGCGC,0,1070316
fldAp,0.1,9,9,GTAAGCAGCAGATCGGAATG,0,1162901
fldAp,0.1,9,9,GTAACCTTGGGCTAGTAACT,0,1186424
fldAp,0.1,9,9,GGTTTAGGCCTTCAATCAGT,0,1148728
fldAp,0.1,9,9,GGTTTACGGTGCATGAGGAT,0,1162567
fldAp,0.1,9,9,GGTTATATGGGTCCGAGAAC,0,1125284
fldAp,0.1,9,9,GGTTATACATCAGCCTACAG,0,1088577
fldAp,0.1,9,9,GGTGTTTTTAAACCTATTGA,0,1073021
fldAp,0.1,9,9,GGTGACTGAGAAATGCATCT,0,1142858
fldAp,0.1,9,9,GGTCTGTGGGTCAGCGTGAT,0,1135538
fldAp,0.1,9,9,GGTCGCTGCAGGAAGACTAT,0,1131949
fldAp,0.1,9,9,GGTCCTCCTATCCTGGAGAT,0,1117876
fldAp,0.1,9,9,GGTCACGTCAATGACTAGAT,0,1158186
fldAp,0.1,9,9,GGTATCTGGGGCATTGTGTA,0,1108864
fldAp,0.1,9,9,GGTATAAGTAGCTACCCTTA,0,1143668
fldAp,0.1,9,9,GGTACTGGGCGATACTACCG,0,1119478
fldAp,0.1,9,9,GGTAATTAGCATATGTGCAT,0,1150050
fldAp,0.1,9,9,GGTAATCGCATCAGGTAAGG,0,1172558
fldAp,0.1,9,9,GGGTTTTACGTTCGGGCTTA,0,1142568
fldAp,0.1,9,9,GGGTTGATAAGGCTTGTGTT,0,1103596
fldAp,0.1,9,9,GGGTTCGTAGCTTGTATACT,0,1180768
fldAp,0.1,9,9,GGGTGGCGCGGTCCCATGAT,0,1152917
fldAp,0.1,9,9,GGGTGCCTCCCGATGAGTCC,0,1137995
fldAp,0.1,9,9,GGGTCGATTCTGACAACAGT,0,1074755
fldAp,0.1,9,9,GGGTCATCATCAGAGCTCAT,0,1156370
fldAp,0.1,9,9,GGGGTGCAGCGGAATGTGGG,0,1134340
fldAp,0.1,9,9,GGGGGGAGCAAGGTATTTCT,0,1126866
fldAp,0.1,9,9,GGGGCTTCATGGCCCCGTTA,0,1132872
fldAp,0.1,9,9,GGGGCTCGCTGTTCCAAATG,0,1090078
fldAp,0.1,9,9,GGGCTGTTCAGACACCAGAT,0,1169024
fldAp,0.1,9,9,GGGCTCCCACACGTATTGAA,0,1131814
fldAp,0.1,9,9,GGGCGTTTAAAAAAAGGCGA,0,1137203
fldAp,0.1,9,9,GGGCATAAAGTCATGCAAAT,0,1080976
fldAp,0.1,9,9,GGGCACTTCCATCGTAATCC,0,1094587
fldAp,0.1,9,9,GGGCAAACAATGAGTCGATA,0,1153360
fldAp,0.1,9,9,GGGATGAACCTGGGACTTGC,0,1183855
fldAp,0.1,9,9,GGGATGAAAGGGCCTTGGGA,0,1155566
fldAp,0.1,9,9,GGGAGTTCTCAGGGCAGCGG,0,1081213
fldAp,0.1,9,9,GGGACCCTAGGCATCAAGCA,0,1176067
fldAp,0.1,9,9,GGCTGGGTGCTAGGGAGTTA,0,1174397
fldAp,0.1,9,9,GGCTGCGCTTTTGAGAAGCT,0,1117618
fldAp,0.1,9,9,GGCTAGGACGTGCATATAAT,0,1170850
fldAp,0.1,9,9,GGCGTCCCCACATTTGGGCT,0,1075982
fldAp,0.1,9,9,GGCGTATAGCTCAGGTATCA,0,1140776
fldAp,0.1,9,9,GGCGCATGAGGTGGTTACAT,0,1142796
fldAp,0.1,9,9,GGCGCACTCAATTAATGTAC,0,1117165
fldAp,0.1,9,9,GGCCTACTAGATGGGCGGCC,0,1130065
fldAp,0.1,9,9,GGCCCATCCGTTTGCGTGGT,0,1081668
fldAp,0.1,9,9,GGCACTTCGGAATCCTTGAG,0,1102706
fldAp,0.1,9,9,GGCAACACGATGTTCAGGAA,0,1118296
fldAp,0.1,9,9,GGATTTACCGCCTCGGACAG,0,1129997
fldAp,0.1,9,9,GGATTGCCTTTTAATCTGAG,0,1162103
fldAp,0.1,9,9,GGATTGAAGGAATTTTTTAT,0,1068456
fldAp,0.1,9,9,GGATCGAGATTGCCTACATG,0,1174794
fldAp,0.1,9,9,GGAGTGGGGTTGCGAGTTGG,0,1083080
fldAp,0.1,9,9,GGAGGGTTGATCTGCCACGA,0,1152236
fldAp,0.1,9,9,GGAGGGCCGAAACATCCGGA,0,1179022
fldAp,0.1,9,9,GGAGGGCACGTCATAAAAGT,0,1112275
fldAp,0.1,9,9,GGAGAACTCTATTGAGACAT,0,1102335
fldAp,0.1,9,9,GGACCACAGTTAAGGCGCCA,0,1084847
fldAp,0.1,9,9,GGAAGTGTTATCTCGTCTTG,0,1129667
fldAp,0.1,9,9,GGAACCATCGCTAAGGGAGC,0,1129249
fldAp,0.1,9,9,GGAAAGCTGGGTTTGCGCCG,0,1143271
fldAp,0.1,9,9,GGAAACATTCTATATAGTAA,0,1121207
fldAp,0.1,9,9,GCTTCTATGTTGGGCAATCT,0,1168829
fldAp,0.1,9,9,GCTGGTTGGAAGACATTGAT,0,1102544
fldAp,0.1,9,9,GCTGGGCGAAGGTAGTCCGA,0,1177215
fldAp,0.1,9,9,GCTCGAACATCCCATGGCAT,0,1114299
fldAp,0.1,9,9,GCTCCGGGCCTGGTTCGTGC,0,1185024
fldAp,0.1,9,9,GCTCCAGGAACAAGGTTTCC,0,1139558
fldAp,0.1,9,9,GCTCCACCTTTGAACTAACT,0,1146816
fldAp,0.1,9,9,GCTCATGAAGAGTAATCGAG,0,1082420
fldAp,0.1,9,9,GCTAGCCTACCATTCCACGC,0,1161046
fldAp,0.1,9,9,GCGTCTATAAAATTATTAAG,0,1134572
fldAp,0.1,9,9,GCGTACAAGGCGAGAAGCCA,0,1127566
fldAp,0.1,9,9,GCGGGCAGCGATCGGGTGTG,0,1130004
fldAp,0.1,9,9,GCGGATGGCGTCCTTCGGTT,0,1087833
fldAp,0.1,9,9,GCGGATGCGTAATGAAGCGA,0,1177859
fldAp,0.1,9,9,GCGGAGTGGCGTAGGAGTAT,0,1070640
fldAp,0.1,9,9,GCGCTTGAGAGGACCGGGTC,0,1113078
fldAp,0.1,9,9,GCGCTGATATTACTGGTGTC,0,1170516
fldAp,0.1,9,9,GCGCTCGACATTTAATCCCA,0,1130794
fldAp,0.1,9,9,GCGCCACGGACTGTTTAAAA,0,1166523
fldAp,0.1,9,9,GCGCAGCAGTTGTAGATAGC,0,1182102
fldAp,0.1,9,9,GCGCAAAGCTTAGGGCTGCT,0,1094596
fldAp,0.1,9,9,GCGATTACAGTTACAAAGTT,0,1064701
fldAp,0.1,9,9,GCGATACCATTGGGCTCAGG,0,1157597
fldAp,0.1,9,9,GCGACGCGGGACAGCTTAAA,0,1120607
fldAp,0.1,9,9,GCGAACAGATCGCCGAATAT,0,1071155
fldAp,0.1,9,9,GCGAACAATGACGTAGCCTT,0,1094504
fldAp,0.1,9,9,GCCTTATATGTCACAATGCA,0,1173488
fldAp,0.1,9,9,GCCTTAGCGAGATTCGGGTG,0,1163179
fldAp,0.1,9,9,GCCGTTCGACTTAGACACCG,0,1141857
fldAp,0.1,9,9,GCCGGCGTTGCCACAGGCGG,0,1105482
fldAp,0.1,9,9,GCCGACGCCTTCCTAGAGGT,0,1186156
fldAp,0.1,9,9,GCCGACCCGTCGTTATAGCC,0,1083214
fldAp,0.1,9,9,GCCCTATGGACTACCGGCGG,0,1086924
fldAp,0.1,9,9,GCCCGCAGCCGTGTATAAGG,0,1184134
fldAp,0.1,9,9,GCCCCTAGTACCCTTAAGTG,0,1172568
fldAp,0.1,9,9,GCCCATACGGTCCCCACAAC,0,1183611
fldAp,0.1,9,9,GCCATGATTGAGGATGATTG,0,1152620
fldAp,0.1,9,9,GCCATCTATGCACGCTATCT,0,1070772
fldAp,0.1,9,9,GCCAGTGAGTCGTGGAAGCG,0,1156669
fldAp,0.1,9,9,GCCAGTGAATACGCACTCGG,0,1184125
fldAp,0.1,9,9,GCCAGCGGCCAGGGGAGACC,0,1097024
fldAp,0.1,9,9,GCCACCTGTAGAGATGCCTA,0,1067691
fldAp,0.1,9,9,GCATCGCTCGGTTCTCTCTC,0,1097807
fldAp,0.1,9,9,GCATAAGCCTACAACGATCA,0,1086620
fldAp,0.1,9,9,GCAGGTGCTGGCGTGCTTAG,0,1085582
fldAp,0.1,9,9,GCAGGTGCCTCATTGACTTG,0,1184807
fldAp,0.1,9,9,GCAGAACTAACAAGCAGAGA,0,1114490
fldAp,0.1,9,9,GCACGCTGTAGCTCAATCCA,0,1185352
fldAp,0.1,9,9,GCACCGCAGTCCACTGTAAG,0,1146492
fldAp,0.1,9,9,GCAAGCCCTAACTACGCGTA,0,1101090
fldAp,0.1,9,9,GCAACGATCGACAGTATACT,0,1113806
fldAp,0.1,9,9,GCAACCCTTTTTCGGAACAA,0,1100385
fldAp,0.1,9,9,GCAACCCGTCCGTGGGCGGA,0,1065331
fldAp,0.1,9,9,GCAAACGCACTTCACGTCGT,0,1148119
fldAp,0.1,9,9,GATTTAGACGTTCAGATATA,0,1098765
fldAp,0.1,9,9,GATTGGCAGTATTACAGGAA,0,1136550
fldAp,0.1,9,9,GATTCGTTTCAGACCTTAAA,0,1083549
fldAp,0.1,9,9,GATTCCGCCATATGCAGTGA,0,1117854
fldAp,0.1,9,9,GATTATAATTCAATTCGTTC,0,1129171
fldAp,0.1,9,9,GATTAGGGGCAGGGAATGGT,0,1121724
fldAp,0.1,9,9,GATTACGTAAATGTTACGAC,0,1090606
fldAp,0.1,9,9,GATTAAACATTGCATGTGGG,0,1101456
fldAp,0.1,9,9,GATGTAAGGAAGCTTGGGCA,0,1129167
fldAp,0.1,9,9,GATGGGGAAGTGGTAACAGC,0,1117744
fldAp,0.1,9,9,GATGGGCAAGCGCGCAAAAC,0,1169533
fldAp,0.1,9,9,GATGGCAGGAGTGAACCGCG,0,1093017
fldAp,0.1,9,9,GATGGAGTAATTACTTCTAC,0,1174937
fldAp,0.1,9,9,GATGCAGCACTTTCCTGCAG,0,1150171
fldAp,0.1,9,9,GATGACTTACCCTGTCTCTT,0,1129529
fldAp,0.1,9,9,GATCTTCACAATGGTGACAA,0,1090880
fldAp,0.1,9,9,GATCGTAAAGTCTATCTTGT,0,1127240
fldAp,0.1,9,9,GATCAACACCAGAGATTGAA,0,1070095
fldAp,0.1,9,9,GATATTGAATTTGGATTAAC,0,1083448
fldAp,0.1,9,9,GATAAAACAGATCCTTATAG,0,1140760
fldAp,0.1,9,9,GAGTTCTCCGCGATGTTTCC,0,1114840
fldAp,0.1,9,9,GAGTTAGCAGTCCTTTACCA,0,1138227
fldAp,0.1,9,9,GAGTGAAGGAAAGGTTAGAA,0,1071911
fldAp,0.1,9,9,GAGTCGCGGTAGAGGTATAG,0,1092366
fldAp,0.1,9,9,GAGTCGCACGTGCGGGGATT,0,1172085
fldAp,0.1,9,9,GAGTAGCAACTAGCGTATGT,0,1098602
fldAp,0.1,9,9,GAGGTAACCGGAGACCGACT,0,1127053
fldAp,0.1,9,9,GAGGGTGCCTGGGGACACAA,0,1079205
fldAp,0.1,9,9,GAGGGTCTTCTTCTTGATTA,0,1100039
fldAp,0.1,9,9,GAGGGAATTAGGCCATGCAA,0,1117042
fldAp,0.1,9,9,GAGCGGTAATGTATATGCGG,0,1097989
fldAp,0.1,9,9,GAGATTCATATTGAAGCGAT,0,1107880
fldAp,0.1,9,9,GAGAGAATAGAATTTCGAGA,0,1158288
fldAp,0.1,9,9,GAGAATTTACGAAACTCGAT,0,1140556
fldAp,0.1,9,9,GAGAATCATTGATAATAGCG,0,1160852
fldAp,0.1,9,9,GACTTGTGCCTTCCAATGTG,0,1112045
fldAp,0.1,9,9,GACTCGCTCTAGCAGCTTCA,0,1157124
fldAp,0.1,9,9,GACTCCAGACGTGTTTACTA,0,1167436
fldAp,0.1,9,9,GACTATACGACGCACCTCTG,0,1181881
fldAp,0.1,9,9,GACGTCAACATTGCGGTAGC,0,1182589
fldAp,0.1,9,9,GACCAGGGGACCGGGTGCTG,0,1182519
fldAp,0.1,9,9,GACCACCAGAGCAAGGAGCA,0,1136822
fldAp,0.1,9,9,GACAGTTTTTAGTATTCCAG,0,1178775
fldAp,0.1,9,9,GACAGGCCAGAGTCGGCTTT,0,1083242
fldAp,0.1,9,9,GACACTGAGTGCCCATGTTT,0,1183317
fldAp,0.1,9,9,GACAAAGTACAAAAGGGTAG,0,1148155
fldAp,0.1,9,9,GACAAAGCGGTGGTACAGGA,0,1125706
fldAp,0.1,9,9,GACAAAACGAATCGGATGAT,0,1114119
fldAp,0.1,9,9,GAATTTTTTGAGAGAGGAGA,0,1129499
fldAp,0.1,9,9,GAATTAGAACAAATGACTAT,0,1134432
fldAp,0.1,9,9,GAATCGGGAATAGGAGCCAG,0,1146305
fldAp,0.1,9,9,GAAGTTATCGAAAGAAAGCA,0,1154624
fldAp,0.1,9,9,GAAGTGCAACATTAGGGAGT,0,1081425
fldAp,0.1,9,9,GAAGCGCGTCTGGGGGTTGT,0,1164873
fldAp,0.1,9,9,GAAGAAACACACTAAAGGGG,0,1145697
fldAp,0.1,9,9,GAACTTTTCAATTGGTCGGG,0,1153515
fldAp,0.1,9,9,GAACTTTCGCAGCCCAAAAA,0,1069217
fldAp,0.1,9,9,GAACGGACATACGCGCGCGA,0,1081055
fldAp,0.1,9,9,GAACCCGTTAAGGCAATTGG,0,1170737
fldAp,0.1,9,9,GAAACTTCATAAGAGATAGA,0,1097677
fldAp,0.1,9,9,CTTTTTTGGCCTTCTTGTTC,0,1174306
fldAp,0.1,9,9,CTTTTTCGCACTGTGATCAA,0,1119889
fldAp,0.1,9,9,CTTTTGTTGCGCCGGTACCC,0,1120312
fldAp,0.1,9,9,CTTTCTGGGTGGATGGTCCT,0,1116249
fldAp,0.1,9,9,CTTTCGGTACCTGTATGAAC,0,1085810
fldAp,0.1,9,9,CTTTAGAGTATGGAAGTCAA,0,1085106
fldAp,0.1,9,9,CTTTACCCCCTTGTAAAGTA,0,1104958
fldAp,0.1,9,9,CTTTACCAATAGTCTGCGCC,0,1177050
fldAp,0.1,9,9,CTTGGGGCTTCACTGCCTTC,0,1068058
fldAp,0.1,9,9,CTTGCATGTGGAGATAAGTA,0,1104489
fldAp,0.1,9,9,CTTGCAGCAAATCGGACGTC,0,1069977
fldAp,0.1,9,9,CTTCGTACGGACGGGGCGGA,0,1085776
fldAp,0.1,9,9,CTTCGGAGAGCGCTTTATTT,0,1122704
fldAp,0.1,9,9,CTTCACGTTTCATTTAGGGA,0,1090658
fldAp,0.1,9,9,CTTCACCGATAGACGGTAGA,0,1178354
fldAp,0.1,9,9,CTTATGAATCCATAGCAGGC,0,1152303
fldAp,0.1,9,9,CTTAGTGCTATTCTAGAGGC,0,1067481
fldAp,0.1,9,9,CTGTTGAGTGGTGACAAGCT,0,1109737
fldAp,0.1,9,9,CTGTTACTTCGTCGTGGATA,0,1171334
fldAp,0.1,9,9,CTGTGTCGAACTCTTAGGGC,0,1144697
fldAp,0.1,9,9,CTGTCGATGGATGGTCATTA,0,1113631
fldAp,0.1,9,9,CTGTCCTTTATTTGTTGCTT,0,1097627
fldAp,0.1,9,9,CTGTACTCCGTCTCAAGCCG,0,1177371
fldAp,0.1,9,9,CTGTAATGTTTGCACCTTTC,0,1099087
fldAp,0.1,9,9,CTGGGTGTCGTTTCAGGGGT,0,1068957
fldAp,0.1,9,9,CTGGGTGAACTGTCGAGTAA,0,1078084
fldAp,0.1,9,9,CTGGCTGGATAGGTGGGATT,0,1120622
fldAp,0.1,9,9,CTGGCCCGCTTTCTCATACA,0,1129876
fldAp,0.1,9,9,CTGCTCGGAAACAGTGCGAG,0,1110925
fldAp,0.1,9,9,CTGCGGATAGACCCTGCCAT,0,1120731
fldAp,0.1,9,9,CTGCCTGTGATAACTTGACG,0,1121767
fldAp,0.1,9,9,CTGCCGATCCACATGACATT,0,1121245
fldAp,0.1,9,9,CTGCATACAGGTGTGGGACA,0,1114691
fldAp,0.1,9,9,CTGATAGGACTTACTTATCC,0,1072992
fldAp,0.1,9,9,CTGAGTACGAAATACTGGGG,0,1166230
fldAp,0.1,9,9,CTCTTAGGATTACATCATCA,0,1177550
fldAp,0.1,9,9,CTCTGGCTTGCCCGGGGTAG,0,1124251
fldAp,0.1,9,9,CTCTGCCTATAACCACTGTT,0,1069303
fldAp,0.1,9,9,CTCGTGTCTTGGGATTACTA,0,1172225
fldAp,0.1,9,9,CTCGGCGCCGGTGTAAATTT,0,1101375
fldAp,0.1,9,9,CTCGCTTCACCTGCATGGAA,0,1083265
fldAp,0.1,9,9,CTCGCGGCGTCCTGGATATT,0,1064607
fldAp,0.1,9,9,CTCGATTCACTTAGGCCTTT,0,1159584
fldAp,0.1,9,9,CTCCTGAGGCCTTCGCGAAC,0,1074878
fldAp,0.1,9,9,CTCCTCCGATGCTGATTGAT,0,1114837
fldAp,0.1,9,9,CTCCATTGCGTAAGTGCTGT,0,1134664
fldAp,0.1,9,9,CTCCAGGCTCGGAAGCTGGG,0,1089937
fldAp,0.1,9,9,CTCATGCTTGCCGGTGACGA,0,1121594
fldAp,0.1,9,9,CTCATGATAGGATCCATGTC,0,1100043
fldAp,0.1,9,9,CTCAGCAGAGTCTGAACCCG,0,1167690
fldAp,0.1,9,9,CTCACACGCACTACGGCGGC,0,1160711
fldAp,0.1,9,9,CTCAAGAATTAGATCATTGT,0,1099727
fldAp,0.1,9,9,CTCAAACCGATCCCCCATGG,0,1065130
fldAp,0.1,9,9,CTATGAGACCAGTAGCTCAC,0,1157073
fldAp,0.1,9,9,CTAGTCCATGTTCTCGGAAC,0,1183579
fldAp,0.1,9,9,CTAGCATTGTCGGTGCCCTA,0,1177788
fldAp,0.1,9,9,CTAGAGGATGACGAAAACTT,0,1149926
fldAp,0.1,9,9,CTACGATACTCGTCTCTAAG,0,1166881
fldAp,0.1,9,9,CTACAGGGGGATCTTATCTA,0,1118434
fldAp,0.1,9,9,CTAATAAGCTCAGAATAAAG,0,1160810
fldAp,0.1,9,9,CTAAGGGATGCCCGGTCCTT,0,1101563
fldAp,0.1,9,9,CTAAGATTTTTGTTCGGTGT,0,1080051
fldAp,0.1,9,9,CTAAGACGCTGGCGACGCTT,0,1092704
fldAp,0.1,9,9,CTAAAGGGAGGCGAGTGAGA,0,1093422
fldAp,0.1,9,9,CGTTAAAAGCCTTCCGACCG,0,1144124
fldAp,0.1,9,9,CGTGTATGAAATATCCCTTA,0,1098127
fldAp,0.1,9,9,CGTGGGGTACTCTTGCGATA,0,1146223
fldAp,0.1,9,9,CGTGAGGTCACTTAGGTGAT,0,1066171
fldAp,0.1,9,9,CGTCTTTGAGCACTTATGGT,0,1076147
fldAp,0.1,9,9,CGTCGTTGACATTACATATG,0,1121513
fldAp,0.1,9,9,CGTCCAGTCTCCTGATAATA,0,1123636
fldAp,0.1,9,9,CGTCACGATAGGCTCCTGCC,0,1162081
fldAp,0.1,9,9,CGTATGTAAAAGCCTAATGC,0,1176516
fldAp,0.1,9,9,CGTAGGGACCTACAGGTTCC,0,1172353
fldAp,0.1,9,9,CGTAGACGGCCTCGCGGGAG,0,1077668
fldAp,0.1,9,9,CGTAACGGGCGTGTAGGTCA,0,1135313
fldAp,0.1,9,9,CGGTTGCCAGCCTGTAATGG,0,1171114
fldAp,0.1,9,9,CGGTTCCTGATTCCCCGTCT,0,1102625
fldAp,0.1,9,9,CGGTGAGCATGTAGAGTGGG,0,1079567
fldAp,0.1,9,9,CGGTCCAGTTCCCCGGGTCT,0,1112767
fldAp,0.1,9,9,CGGGTGCTGACTAGAAACGA,0,1095300
fldAp,0.1,9,9,CGGGGGTCGTTATTATCTTA,0,1161905
fldAp,0.1,9,9,CGGGGGGTTGACCAGCTGAC,0,1180178
fldAp,0.1,9,9,CGGGGGCACTCAATTGGGGG,0,1097065
fldAp,0.1,9,9,CGGGGACAAATATCACAGGG,0,1137129
fldAp,0.1,9,9,CGGGCTAACTTCGAATAAGT,0,1066875
fldAp,0.1,9,9,CGGGCATGCAGAGTATCTCA,0,1128429
fldAp,0.1,9,9,CGGGAACTATTTATTGTTGC,0,1161373
fldAp,0.1,9,9,CGGCTAGGCGGGCTGAGGTA,0,1183456
fldAp,0.1,9,9,CGGCGTGACTGGTGTGATCC,0,1077360
fldAp,0.1,9,9,CGGCCCAGGCGACCATACTC,0,1135794
fldAp,0.1,9,9,CGGACCGCCAGATCACTGTG,0,1162115
fldAp,0.1,9,9,CGGAATGAATGCGATGTTAT,0,1166476
fldAp,0.1,9,9,CGCTTAGGTGGGCCGTGCGG,0,1079824
fldAp,0.1,9,9,CGCTGCAGATACGTAAGTGT,0,1083463
fldAp,0.1,9,9,CGCTCTATCGTTTATGCAAA,0,1068348
fldAp,0.1,9,9,CGCTAGTTAGCATCTCGAAG,0,1065330
fldAp,0.1,9,9,CGCTAGTTAGACGGCGACGA,0,1096322
fldAp,0.1,9,9,CGCTAAGTGTATGTTCTTAC,0,1106699
fldAp,0.1,9,9,CGCTAAAGAAACTGCCATAA,0,1112564
fldAp,0.1,9,9,CGCGGCTCCCGGACTCAGAT,0,1124252
fldAp,0.1,9,9,CGCGCTCCTCACACTCGGGA,0,1099536
fldAp,0.1,9,9,CGCGCGTAAGGATTTCGTTC,0,1073510
fldAp,0.1,9,9,CGCGACGCAAATTAGCCGAG,0,1072240
fldAp,0.1,9,9,CGCGAATTCTGGGGCCTAGC,0,1128812
fldAp,0.1,9,9,CGCGAAACTAACTTCCGGTA,0,1111619
fldAp,0.1,9,9,CGCCTTGGTGGGCAACCCGG,0,1111504
fldAp,0.1,9,9,CGCCTCCTCTCGGGAAGAAG,0,1128529
fldAp,0.1,9,9,CGCCGGCTTAGAAGAGACCT,0,1132165
fldAp,0.1,9,9,CGCCACGGAAGATCCGTGAG,0,1075989
fldAp,0.1,9,9,CGCATAGACGCCGCGATTCA,0,1120947
fldAp,0.1,9,9,CGCACGTGGTGACCCCAACT,0,1103510
fldAp,0.1,9,9,CGCAAGGTGTATATGACTCG,0,1070096
fldAp,0.1,9,9,CGATGCGCGATATTGGATCT,0,1141002
fldAp,0.1,9,9,CGAGTTTACTCAGCGACTTG,0,1130744
fldAp,0.1,9,9,CGAGGGAAATCGGGGTTCTT,0,1101401
fldAp,0.1,9,9,CGAGCTATGGTTTAATAGGC,0,1072826
fldAp,0.1,9,9,CGAGCCTTTGAGTTATAAAC,0,1102329
fldAp,0.1,9,9,CGACGCACATGGTTTCCGGA,0,1109955
fldAp,0.1,9,9,CGACCAGAAGACAGATGTAC,0,1090129
fldAp,0.1,9,9,CGAATTACTTACCTTACATA,0,1181143
fldAp,0.1,9,9,CGAAGCTCGTAGGTTGGATG,0,1108422
fldAp,0.1,9,9,CGAACTCGTGCTGTCCGAAT,0,1170304
fldAp,0.1,9,9,CGAAATGAGGACTATCAGAT,0,1084101
fldAp,0.1,9,9,CGAAAACTATCAAGCACGGT,0,1066381
fldAp,0.1,9,9,CCTTGGATTGGAGGACCGAC,0,1135947
fldAp,0.1,9,9,CCTTCCGGCTGGAGGCCATT,0,1177180
fldAp,0.1,9,9,CCTGTTCGTCTTTGAGGTCT,0,1140127
fldAp,0.1,9,9,CCTGCCAGAAGGCGCAGCTG,0,1089022
fldAp,0.1,9,9,CCTCGGCTGACGTGCTGATA,0,1119399
fldAp,0.1,9,9,CCTCGCCCACGTAACTACTG,0,1176002
fldAp,0.1,9,9,CCTCCCGGACTGTTCCCTGC,0,1063684
fldAp,0.1,9,9,CCTCATTGGGTAAATGTAAA,0,1138676
fldAp,0.1,9,9,CCTCATGTCAGTGACAATTG,0,1161787
fldAp,0.1,9,9,CCTATGTGTGGTAACGTTAC,0,1090981
fldAp,0.1,9,9,CCTATCAGGAACGATCACGT,0,1133117
fldAp,0.1,9,9,CCTATCACTCAACGGCGAGC,0,1167729
fldAp,0.1,9,9,CCTAGGCCATTTTTCTATCA,0,1122538
fldAp,0.1,9,9,CCTAGAGATTCGGCCAGGAG,0,1146894
fldAp,0.1,9,9,CCTACCACTATAACTCAGAA,0,1174437
fldAp,0.1,9,9,CCTACAGGAAGCAGCACGAA,0,1088817
fldAp,0.1,9,9,CCTAAGGGAAACGGTGGAGT,0,1136970
fldAp,0.1,9,9,CCGTTATTGAAAGCTGGGAG,0,1160567
fldAp,0.1,9,9,CCGTGGCCCAGCCGTCATGA,0,1129351
fldAp,0.1,9,9,CCGTGCGCGCAAATCGACAT,0,1093561
fldAp,0.1,9,9,CCGTGATACCGAGCACAGCG,0,1142207
fldAp,0.1,9,9,CCGTCAGCGTAACTGCCTAA,0,1134908
fldAp,0.1,9,9,CCGTATACGCAGCGCAATAA,0,1170099
fldAp,0.1,9,9,CCGGTTGCAGCCCCCCAGGT,0,1116017
fldAp,0.1,9,9,CCGGGTACCGGGACACGGAT,0,1086723
fldAp,0.1,9,9,CCGGCGAGACCATTGTTCAG,0,1095384
fldAp,0.1,9,9,CCGGAGACTCGTGATTGGCA,0,1107558
fldAp,0.1,9,9,CCGCTTCGCGTCCATACTGC,0,1117895
fldAp,0.1,9,9,CCGCTGACGAACCTCCCACG,0,1115353
fldAp,0.1,9,9,CCGCACAAGCCATTAGCTCT,0,1128844
fldAp,0.1,9,9,CCGCAAATCTTGGATCGTTC,0,1096557
fldAp,0.1,9,9,CCGATATCCCGAAAACATAT,0,1079883
fldAp,0.1,9,9,CCGATAAGACACTGGAGGGA,0,1162044
fldAp,0.1,9,9,CCGAGGTTAAATCCTCGCCG,0,1097996
fldAp,0.1,9,9,CCGAAAATGGCCTGAATCTT,0,1123222
fldAp,0.1,9,9,CCCTGGGATTGGCATTGTTT,0,1081463
fldAp,0.1,9,9,CCCGTGGTTCAGAGGGCCGG,0,1152797
fldAp,0.1,9,9,CCCGGGTACCTTGAGGAGGT,0,1129435
fldAp,0.1,9,9,CCCGGCGCTCGCCCTGTACA,0,1076151
fldAp,0.1,9,9,CCCGCCCGAAGTACTCAACA,0,1080086
fldAp,0.1,9,9,CCCGCAGTTGTTAACTTGAT,0,1091117
fldAp,0.1,9,9,CCCCGTCAGGCTACAAGCAT,0,1135387
fldAp,0.1,9,9,CCCCCAAGGCCACTTTACTT,0,1073897
fldAp,0.1,9,9,CCCAGGCGCAACGCGGCCTA,0,1101399
fldAp,0.1,9,9,CCCACTATTCCCCTCGACAG,0,1072831
fldAp,0.1,9,9,CCCAAAATTCTTTGCATTCG,0,1140771
fldAp,0.1,9,9,CCATTGGCTCGCGTAGGATT,0,1115562
fldAp,0.1,9,9,CCATCCACGGGTGTGACCTT,0,1166161
fldAp,0.1,9,9,CCAGTTCATGATTTTAGTAA,0,1106862
fldAp,0.1,9,9,CCAGTGGGCGGGTCCGCAGT,0,1178368
fldAp,0.1,9,9,CCAGGTAGAAGCTGTTTGTG,0,1174300
fldAp,0.1,9,9,CCAGGTACGATTTTTTGCGC,0,1153087
fldAp,0.1,9,9,CCAGGGCCGTCTCGATCATT,0,1108336
fldAp,0.1,9,9,CCAGGGAATAGGATCACGCT,0,1137297
fldAp,0.1,9,9,CCAGGCAAAAGAAGCGGGTT,0,1077870
fldAp,0.1,9,9,CCAGATACGAGGTCTTATGA,0,1081549
fldAp,0.1,9,9,CCACTCCGCCAGGACCTCTA,0,1092646
fldAp,0.1,9,9,CCACGCGCGCATGTACATAG,0,1103025
fldAp,0.1,9,9,CCACCTCTCAGCGCAATGCT,0,1083302
fldAp,0.1,9,9,CCACCCAATTAACTAAAAAG,0,1180779
fldAp,0.1,9,9,CCAATGTAATCCGAGGGAGC,0,1177537
fldAp,0.1,9,9,CCAATCAATGCCGACCAAGT,0,1094973
fldAp,0.1,9,9,CCAAACGTTACTGATTCACT,0,1102000
fldAp,0.1,9,9,CCAAAACACACAATTTGGGG,0,1063735
fldAp,0.1,9,9,CATTTTTTACTGCCTTTGAG,0,1130088
fldAp,0.1,9,9,CATTGCGTATCGTAGATTAC,0,1102648
fldAp,0.1,9,9,CATGGTTCCCGTGCGGCACA,0,1087879
fldAp,0.1,9,9,CATGCCAGTGCCATTATGAT,0,1140968
fldAp,0.1,9,9,CATGCATGAGGCGTAATGAC,0,1100927
fldAp,0.1,9,9,CATGATCGTCTACGGATGAG,0,1131388
fldAp,0.1,9,9,CATCTGAACTTCAGTTATCC,0,1086432
fldAp,0.1,9,9,CATCGAGCGCCGATCAGGAA,0,1127129
fldAp,0.1,9,9,CATCCTCTATGGGATTGCCC,0,1177645
fldAp,0.1,9,9,CATCCCGAGTCAGGCCAGCT,0,1084388
fldAp,0.1,9,9,CATCCAAAGGGAACCTGCAC,0,1091656
fldAp,0.1,9,9,CATATGTTCGCGGAGCGCTT,0,1157370
fldAp,0.1,9,9,CATAGTACTGGGGCGAATTT,0,1125491
fldAp,0.1,9,9,CATAGGGGCATTGAATATTA,0,1138202
fldAp,0.1,9,9,CATAGACGGAAAGAGAAGGT,0,1075144
fldAp,0.1,9,9,CAGTTTTCGCGTACGAGTGA,0,1154471
fldAp,0.1,9,9,CAGTTGATGAATCGCAGGCT,0,1175008
fldAp,0.1,9,9,CAGTTAGGTAAGATTTTATG,0,1140197
fldAp,0.1,9,9,CAGTATCTTGTTAGTTATAA,0,1154823
fldAp,0.1,9,9,CAGGTGTTTATGGTAGTGGG,0,1093836
fldAp,0.1,9,9,CAGGTCATGTGCTTGGCCCG,0,1102410
fldAp,0.1,9,9,CAGGTCACGCAAAACACTCC,0,1155602
fldAp,0.1,9,9,CAGGAGCGGTTGCCGGTACA,0,1122585
fldAp,0.1,9,9,CAGCCGTATCCCCGCAAGCT,0,1091544
fldAp,0.1,9,9,CAGATCACTTCAAACCAATT,0,1168794
fldAp,0.1,9,9,CAGAGGCCCGGATGTGCAGG,0,1180000
fldAp,0.1,9,9,CAGAGCACCTATACGGTGTT,0,1079802
fldAp,0.1,9,9,CAGACTTAGCGCTAGGTTTT,0,1085633
fldAp,0.1,9,9,CAGAACGGAGTCACCTGCCA,0,1168341
fldAp,0.1,9,9,CACTGCGTTTGGCTCATAGT,0,1164194
fldAp,0.1,9,9,CACTAGATTCGGTTCCGCCC,0,1076910
fldAp,0.1,9,9,CACGGTTGAACGTGCTTGGC,0,1114297
fldAp,0.1,9,9,CACGGTCCGCGCGGACAGGA,0,1091001
fldAp,0.1,9,9,CACGGATTGCCGACCGAGTG,0,1097645
fldAp,0.1,9,9,CACGGAGGTGCTTGTTAGCG,0,1179574
fldAp,0.1,9,9,CACGCTGCAAGTGCCATGAC,0,1103708
fldAp,0.1,9,9,CACGACCAGTGTTTCAGTAT,0,1095516
fldAp,0.1,9,9,CACCTCCTCCCTCGAAGCGA,0,1115761
fldAp,0.1,9,9,CACCCAATGTGCTGTCTCAA,0,1159163
fldAp,0.1,9,9,CACCAACCTGCCTAGACAAG,0,1067726
fldAp,0.1,9,9,CACATTGTTTATGCAGTCCT,0,1135001
fldAp,0.1,9,9,CACATGTTTCCTCCCTAGCA,0,1182653
fldAp,0.1,9,9,CACATGGGACGCGGTGTTCT,0,1119436
fldAp,0.1,9,9,CACACTCTGCATATGACTTT,0,1181591
fldAp,0.1,9,9,CACAAGGTGTCGAATGGTCG,0,1097483
fldAp,0.1,9,9,CACAAGCAAATCGTTTCCGG,0,1167413
fldAp,0.1,9,9,CAATTCGATACCCCAGGATA,0,1139902
fldAp,0.1,9,9,CAATGTCCAAGTCACGACAG,0,1174236
fldAp,0.1,9,9,CAATCCAACCGATAATTATA,0,1162555
fldAp,0.1,9,9,CAATAATCCTCGGAAAGGAT,0,1158427
fldAp,0.1,9,9,CAATAACGCCAAGGAGCCGA,0,1146493
fldAp,0.1,9,9,CAAGTCCATCTCCACCCGCA,0,1079906
fldAp,0.1,9,9,CAAGGTATGTTGTTAGTGTC,0,1065127
fldAp,0.1,9,9,CAAGGATTTGCTGAGTCTTT,0,1175922
fldAp,0.1,9,9,CAAGGACGGCCCGCAACTGG,0,1161783
fldAp,0.1,9,9,CAAGACGGGGGGCAAGCCAA,0,1090220
fldAp,0.1,9,9,CAAGACCTGCGGCGCACCCT,0,1105985
fldAp,0.1,9,9,CAACTACGTAACGGTAAAAT,0,1179670
fldAp,0.1,9,9,CAACGGCACACTGATTTCGT,0,1063367
fldAp,0.1,9,9,CAAAGTGGAGGAGGGTTAAA,0,1179236
fldAp,0.1,9,9,CAAAGATCCGGCCGCATAAA,0,1064855
fldAp,0.1,9,9,CAAACCACAGGCAGGGGCAG,0,1123495
fldAp,0.1,9,9,CAAAAGGGCCAAAAGTGGCT,0,1133427
fldAp,0.1,9,9,ATTTTCAGTGGGTATAGTGT,0,1077967
fldAp,0.1,9,9,ATTTCTAGGTAGGTTAGTGC,0,1126858
fldAp,0.1,9,9,ATTTCCTGTTATTAAGTAGG,0,1092015
fldAp,0.1,9,9,ATTTAAGCACTTCATATGTG,0,1140254
fldAp,0.1,9,9,ATTGGAGTGAAGTAAAGCAT,0,1075011
fldAp,0.1,9,9,ATTGGAGCCTGCCGGTCGGG,0,1096757
fldAp,0.1,9,9,ATTGAGCCGCCAGCCTCGCT,0,1132161
fldAp,0.1,9,9,ATTCTTGTGGAGTTTCCCCA,0,1086270
fldAp,0.1,9,9,ATTCTTGGCAGGCGAGGCCG,0,1118104
fldAp,0.1,9,9,ATTCGTCCCCATGCCCATGG,0,1135070
fldAp,0.1,9,9,ATTCGTAGTCTGGTATTTTC,0,1074539
fldAp,0.1,9,9,ATTCGCATTTGAGGTGAAAT,0,1086252
fldAp,0.1,9,9,ATTCCTGCCCGACGAGTGTG,0,1153324
fldAp,0.1,9,9,ATTCAGGGGGCAAGGCAATA,0,1143675
fldAp,0.1,9,9,ATTCAATGTTCCATAATACA,0,1116288
fldAp,0.1,9,9,ATTCAACGTGACGATAAAGG,0,1136024
fldAp,0.1,9,9,ATGTTGTCAGTACGAGGTAG,0,1075038
fldAp,0.1,9,9,ATGTTAGCGTAGCCTCTATA,0,1159399
fldAp,0.1,9,9,ATGTGCATATACAACGGACC,0,1100250
fldAp,0.1,9,9,ATGTGACCTTTCTGCGGTAT,0,1108569
fldAp,0.1,9,9,ATGTCATCAGATCCCGATTA,0,1123596
fldAp,0.1,9,9,ATGTCACTATTTGGAGAGCC,0,1173884
fldAp,0.1,9,9,ATGTAACTGCTCCATCGAGT,0,1107438
fldAp,0.1,9,9,ATGGTGGTATTGCGTCAACG,0,1113549
fldAp,0.1,9,9,ATGGCTCAGAATGTTTAGCA,0,1093159
fldAp,0.1,9,9,ATGGCGCTTGAGCAGCATTC,0,1066858
fldAp,0.1,9,9,ATGGCGATCCACTCTGTTAG,0,1165956
fldAp,0.1,9,9,ATGGACGTAACGTGCAGGCC,0,1172805
fldAp,0.1,9,9,ATGCTAACTCAGACCAGGTA,0,1103606
fldAp,0.1,9,9,ATGCGCTAGCGATTGCTCGA,0,1164695
fldAp,0.1,9,9,ATGAGGGTTTTCATCGACCC,0,1096551
fldAp,0.1,9,9,ATGAGAGCGCACCGATTGTC,0,1158610
fldAp,0.1,9,9,ATCTTGGTGTTCTGACAGTC,0,1140673
fldAp,0.1,9,9,ATCGTAATTGAATATCGTGC,0,1152302
fldAp,0.1,9,9,ATCGGCTCCACAGTGGCGAT,0,1138709
fldAp,0.1,9,9,ATCGCCATGGTGAGTACACG,0,1173757
fldAp,0.1,9,9,ATCGATCCACAGTTGGCATG,0,1141440
fldAp,0.1,9,9,ATCCGGACTATAGGGCAAGT,0,1089636
fldAp,0.1,9,9,ATCCCCTCGACGCAGTCACG,0,1112285
fldAp,0.1,9,9,ATCCAGAGAGTTGGGCCGAT,0,1088495
fldAp,0.1,9,9,ATCACACATCTAAACGTAAT,0,1077083
fldAp,0.1,9,9,ATCAAATCCGGGAGAACTCA,0,1131961
fldAp,0.1,9,9,ATATTCGTTTGCCACCCATA,0,1156398
fldAp,0.1,9,9,ATATTAATATCGTGAGAGAT,0,1100072
fldAp,0.1,9,9,ATATGTGGAGACTTTTTCGC,0,1136479
fldAp,0.1,9,9,ATAGATGGCGCAACTCCTTA,0,1180850
fldAp,0.1,9,9,ATAGACCAAGCGCCTAGTAT,0,1137852
fldAp,0.1,9,9,ATACTGATTCCAGCTTTGCT,0,1183054
fldAp,0.1,9,9,ATACGGGAACAGAGACACTT,0,1124364
fldAp,0.1,9,9,ATACGATGTAAGGCCAAGCA,0,1151916
fldAp,0.1,9,9,ATACCATTTATCCCACCAGA,0,1131305
fldAp,0.1,9,9,ATACAGTATGTTCAATACCA,0,1093760
fldAp,0.1,9,9,ATACAGTAGGGGGGCGTTCT,0,1071724
fldAp,0.1,9,9,ATAATGGACCGTCGCGCATT,0,1125949
fldAp,0.1,9,9,ATAATGCCTATTTCGTCAGC,0,1136267
fldAp,0.1,9,9,ATAAGCCCGCACCGGCTTCC,0,1075094
fldAp,0.1,9,9,AGTTGCCGCTCACCTTTTAC,0,1164356
fldAp,0.1,9,9,AGTGTTGGAACACACTATGA,0,1121298
fldAp,0.1,9,9,AGTGTTCCAGCGGGTCAAGT,0,1150655
fldAp,0.1,9,9,AGTGTAAAACGATCTCCTAT,0,1152130
fldAp,0.1,9,9,AGTGCCCGTGCACTGGCAGG,0,1091035
fldAp,0.1,9,9,AGTGCATTGGAGAGTCAGCC,0,1175405
fldAp,0.1,9,9,AGTCTCTAATTTGAACACGT,0,1104823
fldAp,0.1,9,9,AGTCGTATCGGGCGAAACTG,0,1141066
fldAp,0.1,9,9,AGTCGGGTGTCGTGAGCACA,0,1095252
fldAp,0.1,9,9,AGTCGGCCGATCGAAGCACG,0,1104707
fldAp,0.1,9,9,AGTCGCGTCGCTAAGATTTA,0,1087111
fldAp,0.1,9,9,AGTCAATAGGAGCGGGCTCC,0,1076830
fldAp,0.1,9,9,AGTATCGCAGCTATGACCGT,0,1131787
fldAp,0.1,9,9,AGTAGTGCCGCGAGCTGACA,0,1116293
fldAp,0.1,9,9,AGTAGTCGTATGAGTACCAT,0,1135135
fldAp,0.1,9,9,AGTAGCGTTGGACTATGGCA,0,1083968
fldAp,0.1,9,9,AGTACAGACCTCAAGTAGCT,0,1099058
fldAp,0.1,9,9,AGTAAGGCAATAACATGGAA,0,1114137
fldAp,0.1,9,9,AGGTTTCCCCAAAAGGGGGC,0,1103656
fldAp,0.1,9,9,AGGTTTAAGCCGCACAGAAA,0,1182347
fldAp,0.1,9,9,AGGTTGCATCCACAAATATT,0,1115513
fldAp,0.1,9,9,AGGTTGAAATTAACTATCGT,0,1084000
fldAp,0.1,9,9,AGGTTCGCTCCCAGACTTAT,0,1088413
fldAp,0.1,9,9,AGGTTATTGTAATGAGCCTT,0,1083545
fldAp,0.1,9,9,AGGTTAGTGTTTGGTCCCGC,0,1151806
fldAp,0.1,9,9,AGGTGTTGGGGTGACCGTCA,0,1096872
fldAp,0.1,9,9,AGGTGAATATATGACACGGT,0,1176511
fldAp,0.1,9,9,AGGTCAGTCACGCTTAATAG,0,1113809
fldAp,0.1,9,9,AGGGTGAGATTGGTGTAATA,0,1099579
fldAp,0.1,9,9,AGGGGCTCATCCTTCGCAAA,0,1064262
fldAp,0.1,9,9,AGGGCAATCTACCCCTTCTA,0,1148220
fldAp,0.1,9,9,AGGCTTGCGTATGTCTAAAG,0,1165140
fldAp,0.1,9,9,AGGCTGTTCAGAAAGGACTA,0,1097155
fldAp,0.1,9,9,AGGCTGCCGACTCCTGATAA,0,1118628
fldAp,0.1,9,9,AGGCGATGCGCCCCCAGTTC,0,1098176
fldAp,0.1,9,9,AGGCGAGCGAGAGTAAACGC,0,1148707
fldAp,0.1,9,9,AGGCCATGGTCTCGTGCACT,0,1100367
fldAp,0.1,9,9,AGGAGTCAAGTTTAACCGAG,0,1110636
fldAp,0.1,9,9,AGGAAGACCTTTTGCTATTC,0,1167104
fldAp,0.1,9,9,AGCTTTAACGTCTTATCAAG,0,1131390
fldAp,0.1,9,9,AGCTTGCGGATTGGACCGAA,0,1150647
fldAp,0.1,9,9,AGCGGTTCCGAGCGAAATTA,0,1115517
fldAp,0.1,9,9,AGCGCTGTACCAGCAACAAA,0,1124495
fldAp,0.1,9,9,AGCGATGGTCCGGCGGACCC,0,1116005
fldAp,0.1,9,9,AGCGAGTGGAGCAAGGTCAT,0,1177630
fldAp,0.1,9,9,AGCGAGAAATGAAGTTGCGG,0,1149749
fldAp,0.1,9,9,AGCCTGGTCCATTGTTCTGG,0,1145200
fldAp,0.1,9,9,AGCATTTCAAAGCTGGTCGC,0,1089217
fldAp,0.1,9,9,AGCAGGTTCGGGCTTGGTAC,0,1180276
fldAp,0.1,9,9,AGCAGAGCATCCCTCGCAGG,0,1122852
fldAp,0.1,9,9,AGCACTTGCAGAAACTGGTC,0,1171675
fldAp,0.1,9,9,AGCAATCCACACGGGATGAA,0,1146591
fldAp,0.1,9,9,AGATTTCGTACAGGCGTTGA,0,1077201
fldAp,0.1,9,9,AGATTCCGGTTACCAAATCG,0,1122609
fldAp,0.1,9,9,AGATGTACCAGCCACACCAC,0,1071816
fldAp,0.1,9,9,AGATGTAACAAAGCGTTAGC,0,1116411
fldAp,0.1,9,9,AGATCATCAGCATAGGGTAG,0,1075297
fldAp,0.1,9,9,AGAGTGGTCATTAATACCGA,0,1152121
fldAp,0.1,9,9,AGAGTCCCTTTAGGCGAATA,0,1182873
fldAp,0.1,9,9,AGAGTACGAGCGAGGGCATA,0,1132621
fldAp,0.1,9,9,AGAGGCTGCGAGGCGGGTAT,0,1103672
fldAp,0.1,9,9,AGAGGAGCACGAACGCGCCT,0,1152163
fldAp,0.1,9,9,AGAGGAATCACCCTCGGTCG,0,1185287
fldAp,0.1,9,9,AGAGAGCCGGGTGTTATAGC,0,1168595
fldAp,0.1,9,9,AGACTTCTGCGGTACCGCCT,0,1115728
fldAp,0.1,9,9,AGACATCAGAATTCTGTAAA,0,1088380
fldAp,0.1,9,9,AGACAAGCCGGGTTCCCTGT,0,1110393
fldAp,0.1,9,9,AGAATTACTTGGATCAGGAA,0,1074860
fldAp,0.1,9,9,AGAATCGTACGGGCTTACGC,0,1148455
fldAp,0.1,9,9,AGAAGCGTGTATGAGGGGAA,0,1099295
fldAp,0.1,9,9,AGAAACGCATGGGCATGGAT,0,1171803
fldAp,0.1,9,9,ACTTTGTGTCATTGCTCCGG,0,1084736
fldAp,0.1,9,9,ACTTGTCACGAGACTAGGTT,0,1077833
fldAp,0.1,9,9,ACTTGGTGTCACGTGTCTGC,0,1136381
fldAp,0.1,9,9,ACTTGAATGGATGGGGCAGA,0,1084531
fldAp,0.1,9,9,ACTTACGATGTTTGTCCATA,0,1174146
fldAp,0.1,9,9,ACTGTGAACGGTGGAGGTAA,0,1085041
fldAp,0.1,9,9,ACTGGTTCGGCGCGTTCGCT,0,1168814
fldAp,0.1,9,9,ACTGGCGCCGTTGGCATTCT,0,1065880
fldAp,0.1,9,9,ACTGCGTGGGGTGCATCGGC,0,1121241
fldAp,0.1,9,9,ACTGCATCGGACCAGGATTT,0,1093518
fldAp,0.1,9,9,ACTCTCTGGGGGCAATCGTG,0,1161275
fldAp,0.1,9,9,ACTCGTTCATGCGCTTACAA,0,1106458
fldAp,0.1,9,9,ACTCGTGTCCCTACTGGAGT,0,1081235
fldAp,0.1,9,9,ACTCCTTGGTGGGCACCGGT,0,1179127
fldAp,0.1,9,9,ACTCCTGAATATGTACGGAA,0,1186521
fldAp,0.1,9,9,ACTCCTAATGGCGGCCATTG,0,1175388
fldAp,0.1,9,9,ACTATCGCCCTTATTATAGG,0,1151650
fldAp,0.1,9,9,ACTACTGCAGCCTGAACAAA,0,1079390
fldAp,0.1,9,9,ACTACACGCGTGGACCCCTT,0,1142914
fldAp,0.1,9,9,ACTAAATCCTACAGGGTAGT,0,1153421
fldAp,0.1,9,9,ACGTTTCAGTATGCTTAAGA,0,1183856
fldAp,0.1,9,9,ACGTGCAATATACGGGTAAT,0,1148623
fldAp,0.1,9,9,ACGGGCTATATGGGACCCGG,0,1177856
fldAp,0.1,9,9,ACGGGAGTCTGCGTTCTTAT,0,1068772
fldAp,0.1,9,9,ACGGATAAGAACTGTGCTAC,0,1123982
fldAp,0.1,9,9,ACGGAAGTACGAGTACTTCA,0,1131441
fldAp,0.1,9,9,ACGGAAACGCCGGCCTTTAA,0,1087850
fldAp,0.1,9,9,ACGCTTCACACCTAAGGATT,0,1101995
fldAp,0.1,9,9,ACGCTCAGAGGTAGCTTAGT,0,1107342
fldAp,0.1,9,9,ACGCGCAAAAATATACTGAC,0,1068945
fldAp,0.1,9,9,ACGAGTCGCCACGGACCGTG,0,1103024
fldAp,0.1,9,9,ACGAGAGTCCTCGCATGACT,0,1072670
fldAp,0.1,9,9,ACGAGAAGCACTCGTTAGAC,0,1152615
fldAp,0.1,9,9,ACGACTGAGGGCGGCGCGTC,0,1118158
fldAp,0.1,9,9,ACGAATCGAGCACAGTCGGT,0,1148473
fldAp,0.1,9,9,ACGAATAGCTTATGGTCGAG,0,1158825
fldAp,0.1,9,9,ACCTGTTGAGACGCATGCGT,0,1183875
fldAp,0.1,9,9,ACCTATGCTTGGTCTACGGC,0,1130844
fldAp,0.1,9,9,ACCGTCCTGAGGGGAAATGT,0,1077264
fldAp,0.1,9,9,ACCGGTACTAGGACTTCTTC,0,1096903
fldAp,0.1,9,9,ACCGCGACACATACCAAGTA,0,1116038
fldAp,0.1,9,9,ACCCGTCAATCTAGCACGTC,0,1147031
fldAp,0.1,9,9,ACCCCGAGCGAAGACACTGC,0,1134358
fldAp,0.1,9,9,ACCCAGGGGTAGCCTGACAT,0,1169164
fldAp,0.1,9,9,ACCACGAACGAGCGTCTAAC,0,1109718
fldAp,0.1,9,9,ACCAAGGCCTTCGGTCCCGG,0,1112104
fldAp,0.1,9,9,ACATTTACTGGCGTGACACG,0,1152624
fldAp,0.1,9,9,ACATTCTTGTTCGGCTTTCA,0,1176479
fldAp,0.1,9,9,ACATTACTTCATACGTTTGC,0,1077055
fldAp,0.1,9,9,ACATGTACCTTTGGGCCAAT,0,1148306
fldAp,0.1,9,9,ACATCAACAGGTAGGGGAGT,0,1170683
fldAp,0.1,9,9,ACAGTGATCCGAGTATGCTG,0,1113671
fldAp,0.1,9,9,ACAGGTAGGACGAAGTGAAT,0,1162381
fldAp,0.1,9,9,ACAGGCTTGCAGACACCACG,0,1121596
fldAp,0.1,9,9,ACAGCGTCGGCACAAGGTGG,0,1116279
fldAp,0.1,9,9,ACAGCAAGAACATGGGAAGG,0,1070328
fldAp,0.1,9,9,ACACTCAGTGCAAAGAACTA,0,1142158
fldAp,0.1,9,9,ACACAGCCAGATGTCGAAGA,0,1089390
fldAp,0.1,9,9,ACACAAGGAGGGTCATGGGA,0,1139461
fldAp,0.1,9,9,ACAATGTTGACGTTATACAC,0,1093520
fldAp,0.1,9,9,ACAAGTGACGAGGAAGAAGA,0,1175390
fldAp,0.1,9,9,ACAAGGAAAATTTCTCCGCG,0,1169459
fldAp,0.1,9,9,ACAAGCGAGTCGCTTTGGAG,0,1131113
fldAp,0.1,9,9,ACAACGGGGGGAGAGAGCTT,0,1072558
fldAp,0.1,9,9,ACAAATCTCAGAACGGATAC,0,1171822
fldAp,0.1,9,9,ACAAAGCACGCAGATGTAGC,0,1133823
fldAp,0.1,9,9,ACAAAGAGACAGCCCGCTTT,0,1122064
fldAp,0.1,9,9,AATTGGAATCTCCCTCGATC,0,1095161
fldAp,0.1,9,9,AATTGGAAATTAGCAAAATA,0,1171442
fldAp,0.1,9,9,AATTCTCAATTCAGAGGTCT,0,1102357
fldAp,0.1,9,9,AATTAAGTCGGCGGATTGGT,0,1164438
fldAp,0.1,9,9,AATTAAAATTAGGTGTGCTC,0,1084614
fldAp,0.1,9,9,AATGTGCGCTGCTCGCGGGT,0,1157215
fldAp,0.1,9,9,AATGGTGCCATCAGCGTGAT,0,1135440
fldAp,0.1,9,9,AATGGCTTGGGAGGTGACAC,0,1109716
fldAp,0.1,9,9,AATGCTATTTTCGCGACAGA,0,1159150
fldAp,0.1,9,9,AATCCTATAAACCGCGGTAT,0,1173867
fldAp,0.1,9,9,AATCCCGGCTAGCCCCTTAG,0,1153532
fldAp,0.1,9,9,AATCATTATACGATAGGAAA,0,1078249
fldAp,0.1,9,9,AATATTTGATGACGCGTCTT,0,1094145
fldAp,0.1,9,9,AATAGGGGTTATCATCAGTG,0,1151554
fldAp,0.1,9,9,AATACAACGGGCTTGACAAT,0,1149505
fldAp,0.1,9,9,AATAACATACTGACGAGCGT,0,1154799
fldAp,0.1,9,9,AATAAACAACAATCGGTCAC,0,1147213
fldAp,0.1,9,9,AAGTTGGGCAACGCTCATAT,0,1068830
fldAp,0.1,9,9,AAGTGAGCCCTGCGGGACGC,0,1125315
fldAp,0.1,9,9,AAGTCGCGGGTCGTTAGGGT,0,1178810
fldAp,0.1,9,9,AAGGTGCTAGGCTGGACTCT,0,1155351
fldAp,0.1,9,9,AAGGTGCAAGGCTTGCGAGT,0,1084991
fldAp,0.1,9,9,AAGGTGATCCCATCATCAGA,0,1071947
fldAp,0.1,9,9,AAGGGACATAGAAAATCGGC,0,1083061
fldAp,0.1,9,9,AAGGCCAAATTAATTCGAAG,0,1066849
fldAp,0.1,9,9,AAGCTGGACGATGCAAGAAC,0,1151752
fldAp,0.1,9,9,AAGCGGTTGGTCAGCTTGAA,0,1068065
fldAp,0.1,9,9,AAGCGGACTTCGGCATAACC,0,1149343
fldAp,0.1,9,9,AAGCGACTCTCGCATGGCCG,0,1130942
fldAp,0.1,9,9,AAGCCCGCGAGCAAAAGAGT,0,1154245
fldAp,0.1,9,9,AAGCCCAAGGGCTCATCAAG,0,1140690
fldAp,0.1,9,9,AAGCATTAGACCCCTATCGT,0,1162443
fldAp,0.1,9,9,AAGATGCACCGCCCCAATGC,0,1166888
fldAp,0.1,9,9,AAGATCCCAACTTAATTCGG,0,1091545
fldAp,0.1,9,9,AAGATAGCGAGCGAGATTGT,0,1173905
fldAp,0.1,9,9,AAGATAAGGGACATACGCCG,0,1113796
fldAp,0.1,9,9,AAGAGGGAATTACCTCTGTA,0,1125472
fldAp,0.1,9,9,AAGAAATCGAAAGTTGGGCT,0,1081460
fldAp,0.1,9,9,AACTTCGACTCGCCTAATTG,0,1145748
fldAp,0.1,9,9,AACTCGTTACTTCTACTCGT,0,1075873
fldAp,0.1,9,9,AACTAATAAGCAGCGAAGCA,0,1073104
fldAp,0.1,9,9,AACGTGTTGGCGGTCCCCGG,0,1172396
fldAp,0.1,9,9,AACGGGCACATCTTCAGCAT,0,1159492
fldAp,0.1,9,9,AACGCGGCAATGAAAGTTTT,0,1080604
fldAp,0.1,9,9,AACGCGCCTTGGGTAGACAG,0,1116864
fldAp,0.1,9,9,AACGAAGATCGACACTAGGA,0,1070888
fldAp,0.1,9,9,AACCCTTTTTAACATGATGA,0,1148826
fldAp,0.1,9,9,AACCACCTCATACGGAGAAC,0,1161051
fldAp,0.1,9,9,AACAGCCTACTATTGGGCCG,0,1100954
fldAp,0.1,9,9,AACACCAGCCTACCGAAAGT,0,1164083
fldAp,0.1,9,9,AACACAAAAATTTACCGTGC,0,1103340
fldAp,0.1,9,9,AAATGGGCTCACCTCAATGA,0,1175714
fldAp,0.1,9,9,AAATATTTATACATGCCTCC,0,1133104
fldAp,0.1,9,9,AAATAGAGTAAACACGCGGC,0,1123318
fldAp,0.1,9,9,AAAGTTAAGCGACCCCTCAA,0,1154796
fldAp,0.1,9,9,AAAGCGGATCTGACGCGCGG,0,1156060
fldAp,0.1,9,9,AAAGAGTCTCCGAAGCAGCG,0,1065247
fldAp,0.1,9,9,AAAGAAATAGTGTTATGCGC,0,1151686
fldAp,0.1,9,9,AAACAGCGACAGCGGAAAAG,0,1079074
fldAp,0.1,9,9,AAAAGCGCCACGCGAGAGAA,0,1126743
fldAp,0.1,9,9,AAAAGACTAACCAGACTGAT,0,1164953
fldAp,0.1,9,9,AAAACTACTGTAGTTCCCTT,0,1084102
fldAp,0.1,9,9,AAAACGCTTCCTTGCGACAC,0,1091665
fldAp,0.1,9,9,AAAACAGGATTAGGATACCA,0,1114045
fldAp,0.1,9,9,AAAAATCCAGTTAGTCAACA,0,1069923
fldAp,0.1111111111111111,8,8,TTTTGTCGTGTATGGGGGGA,0,1118695
fldAp,0.1111111111111111,8,8,TTTTCGTGGCAGTGAGGTAT,0,1105561
fldAp,0.1111111111111111,8,8,TTTTATGTGCAATGACAATG,0,1170013
fldAp,0.1111111111111111,8,8,TTTTAGTGGAGGGCATCCCC,0,1144867
fldAp,0.1111111111111111,8,8,TTTTAACGACATTACAAGGG,0,1115261
fldAp,0.1111111111111111,8,8,TTTGGGGCGTTTAGTACATT,0,1181686
fldAp,0.1111111111111111,8,8,TTTGCCGACCTTAACTCTAA,0,1139591
fldAp,0.1111111111111111,8,8,TTTGACGGCGCATATCTCTT,0,1152321
fldAp,0.1111111111111111,8,8,TTTCTGTGCACGCAACAATT,0,1070504
fldAp,0.1111111111111111,8,8,TTTCTGTCTGTCATAATGGA,0,1176889
fldAp,0.1111111111111111,8,8,TTTCTATGGCACGCGCGCCT,0,1169866
fldAp,0.1111111111111111,8,8,TTTCGGTTCTGTAGGGTAAA,0,1140002
fldAp,0.1111111111111111,8,8,TTTCGCACGCGTAAGAGATA,0,1181219
fldAp,0.1111111111111111,8,8,TTTCCTAAACTTTTCAGTCG,0,1178038
fldAp,0.1111111111111111,8,8,TTTCCCGAAGGCCCCTAAAG,0,1133271
fldAp,0.1111111111111111,8,8,TTTATGACAGCCAGAGACGC,0,1106669
fldAp,0.1111111111111111,8,8,TTTATCGGAATAACCAGTCA,0,1106876
fldAp,0.1111111111111111,8,8,TTTATCGCATGACAGTAAAT,0,1122377
fldAp,0.1111111111111111,8,8,TTTATAGAGGGATACTGCGA,0,1116843
fldAp,0.1111111111111111,8,8,TTTACCTAATAAATTAATAA,0,1185625
fldAp,0.1111111111111111,8,8,TTTAAATCCAATGAATACAG,0,1072873
fldAp,0.1111111111111111,8,8,TTGTTGAATCCAGGTACTTT,0,1084627
fldAp,0.1111111111111111,8,8,TTGTAAAGTAATCACATATG,0,1164544
fldAp,0.1111111111111111,8,8,TTGGTTTGTACGTACAAGAA,0,1119971
fldAp,0.1111111111111111,8,8,TTGGTGGCTACCCACAACCA,0,1176176
fldAp,0.1111111111111111,8,8,TTGGTCGCACCGGGCACGCC,0,1182315
fldAp,0.1111111111111111,8,8,TTGGTCATCGAGTAACAAGA,0,1078220
fldAp,0.1111111111111111,8,8,TTGGGGCCTGGACACTCAGT,0,1099270
fldAp,0.1111111111111111,8,8,TTGGCGGGCGTAGATGAACC,0,1168852
fldAp,0.1111111111111111,8,8,TTGGCCTGCGACTCCACGTA,0,1150049
fldAp,0.1111111111111111,8,8,TTGCGCCAGTAGACACCATA,0,1156796
fldAp,0.1111111111111111,8,8,TTGCGACCGAGAGGGGTCAG,0,1100500
fldAp,0.1111111111111111,8,8,TTGCCTTTCCTAAAGCGTCA,0,1139600
fldAp,0.1111111111111111,8,8,TTGCCGGCCTGCGCACACGA,0,1123463
fldAp,0.1111111111111111,8,8,TTGCCCCTATTTGTCTGTAG,0,1159973
fldAp,0.1111111111111111,8,8,TTGCCAGCTAGCTAATCTTA,0,1171445
fldAp,0.1111111111111111,8,8,TTGCAAATAAATGATCGAAC,0,1070414
fldAp,0.1111111111111111,8,8,TTGATCTGTTTTCTAGCTAG,0,1131019
fldAp,0.1111111111111111,8,8,TTGATAGGGGAGGCGGCGCA,0,1113503
fldAp,0.1111111111111111,8,8,TTGATAGCCACGAAACAGAA,0,1133069
fldAp,0.1111111111111111,8,8,TTGAGTAAGTCCTCTGAAGG,0,1185101
fldAp,0.1111111111111111,8,8,TTGAACATAAGATTTCAGTA,0,1100503
fldAp,0.1111111111111111,8,8,TTCTTCGTTCGGCTCCGTTC,0,1114056
fldAp,0.1111111111111111,8,8,TTCTCTCTGATAGCACGAGA,0,1143867
fldAp,0.1111111111111111,8,8,TTCGGTAACCTTCGCTGGAC,0,1147579
fldAp,0.1111111111111111,8,8,TTCGGAATTGGCGTGCCGAA,0,1159127
fldAp,0.1111111111111111,8,8,TTCGCAGTTTCCTGCTTGCT,0,1158062
fldAp,0.1111111111111111,8,8,TTCGATCGTCTTCGTTTGCA,0,1178260
fldAp,0.1111111111111111,8,8,TTCCATGGTTCATTTGCCCT,0,1129258
fldAp,0.1111111111111111,8,8,TTCAGTCGCTACCGAGGAGT,0,1174663
fldAp,0.1111111111111111,8,8,TTCACTTATACCCGTTATTC,0,1108731
fldAp,0.1111111111111111,8,8,TTCACACTTCAGAGGAATTT,0,1068793
fldAp,0.1111111111111111,8,8,TTCAAGATACGTTCTTCACG,0,1162544
fldAp,0.1111111111111111,8,8,TTATTGTAAAATGTTGATAA,0,1117032
fldAp,0.1111111111111111,8,8,TTATTCGGGGTGGTAAACCT,0,1126404
fldAp,0.1111111111111111,8,8,TTATGGCTCTACTCTTTGTG,0,1118908
fldAp,0.1111111111111111,8,8,TTATCTCCCAACGAGCCATA,0,1066095
fldAp,0.1111111111111111,8,8,TTATCTAGGGCAGTCGATAC,0,1156027
fldAp,0.1111111111111111,8,8,TTAGTGGCCCCGCGTCTATC,0,1163589
fldAp,0.1111111111111111,8,8,TTAGGGTTACCGGGTGTAAC,0,1095900
fldAp,0.1111111111111111,8,8,TTAGACTCCGTTAGCTCAAG,0,1182309
fldAp,0.1111111111111111,8,8,TTAGACCAGTTAGCGGGTGC,0,1099943
fldAp,0.1111111111111111,8,8,TTACTTCAATGGATAAGAAT,0,1086945
fldAp,0.1111111111111111,8,8,TTACTAATGCTCGAACAAGT,0,1108621
fldAp,0.1111111111111111,8,8,TTACGATTAAAGGACCGTCG,0,1072203
fldAp,0.1111111111111111,8,8,TTACATTATGCAGTGCTAGA,0,1143484
fldAp,0.1111111111111111,8,8,TTAAGCACGACTTTTTTGCT,0,1166458
fldAp,0.1111111111111111,8,8,TTAAGATTCGGTTGGTAATA,0,1129464
fldAp,0.1111111111111111,8,8,TGTTCACTACTACTTCTGTC,0,1129977
fldAp,0.1111111111111111,8,8,TGTTATTCGGAGGATTTTTC,0,1093788
fldAp,0.1111111111111111,8,8,TGTTACGAAGTTCTCAATGT,0,1068791
fldAp,0.1111111111111111,8,8,TGTGGTCAACAACAGACTAT,0,1100897
fldAp,0.1111111111111111,8,8,TGTGGGCAGACCGATTGGTA,0,1108341
fldAp,0.1111111111111111,8,8,TGTGCGTACGAATCATGAAG,0,1095947
fldAp,0.1111111111111111,8,8,TGTGAAAATTAGAACCGGAT,0,1101979
fldAp,0.1111111111111111,8,8,TGTCTGACACTCGCGCCCCT,0,1074731
fldAp,0.1111111111111111,8,8,TGTCTAAAAACTTCCGATTG,0,1117711
fldAp,0.1111111111111111,8,8,TGTCGTTTCCCTCCTGTAGT,0,1179538
fldAp,0.1111111111111111,8,8,TGTCGAAACGGGACCATTTT,0,1176336
fldAp,0.1111111111111111,8,8,TGTATGGCGAATTCTTTCCA,0,1139568
fldAp,0.1111111111111111,8,8,TGTAGGTGTACCCACCGTGT,0,1157453
fldAp,0.1111111111111111,8,8,TGTACTCACTGGTGCAAAGT,0,1110696
fldAp,0.1111111111111111,8,8,TGTAATCCAGAAACCCTTAC,0,1100557
fldAp,0.1111111111111111,8,8,TGGTTATTATCTAAGACAGA,0,1134326
fldAp,0.1111111111111111,8,8,TGGTCTCGGCGTCATGGAAT,0,1089214
fldAp,0.1111111111111111,8,8,TGGGTCCCACAGGATAGAGT,0,1095833
fldAp,0.1111111111111111,8,8,TGGGGTTCCTTTTAACAAGT,0,1152655
fldAp,0.1111111111111111,8,8,TGGGGTCAGTAATCATTAAA,0,1137230
fldAp,0.1111111111111111,8,8,TGGGGGCACGAATCAGGTAA,0,1139477
fldAp,0.1111111111111111,8,8,TGGGGATCGGTGCTTGGTCA,0,1122264
fldAp,0.1111111111111111,8,8,TGGGACGCCTTATCTCTTAT,0,1117021
fldAp,0.1111111111111111,8,8,TGGCTGTGTTCTGTGGCAGA,0,1098809
fldAp,0.1111111111111111,8,8,TGGCTGGGGAAGCGGCGCCC,0,1144970
fldAp,0.1111111111111111,8,8,TGGCTACTGTGAGATCGAAT,0,1122857
fldAp,0.1111111111111111,8,8,TGGCCAATGGTGAAACGGAA,0,1122786
fldAp,0.1111111111111111,8,8,TGGCACAAATGGATATTCGA,0,1123681
fldAp,0.1111111111111111,8,8,TGGATGAACTCTGCGGCGCG,0,1151478
fldAp,0.1111111111111111,8,8,TGGAGATCGCCGATCTTTGC,0,1157368
fldAp,0.1111111111111111,8,8,TGGACAGAGCCAGAGATCGT,0,1088200
fldAp,0.1111111111111111,8,8,TGGAATCCGTTAAATCAGGG,0,1150167
fldAp,0.1111111111111111,8,8,TGCTTCAACATTAGGTTTGT,0,1110592
fldAp,0.1111111111111111,8,8,TGCTGTTTGGTCCCTTGATG,0,1178486
fldAp,0.1111111111111111,8,8,TGCTCTCTCACACCATATTA,0,1172791
fldAp,0.1111111111111111,8,8,TGCTCGATAGTAACCAATTC,0,1115189
fldAp,0.1111111111111111,8,8,TGCGTTCCGGGACAACTTGC,0,1128017
fldAp,0.1111111111111111,8,8,TGCGTGAGAATACGGAGCGT,0,1164533
fldAp,0.1111111111111111,8,8,TGCGTCTGAACATAACATCC,0,1108991
fldAp,0.1111111111111111,8,8,TGCGGCCCTCTGCTGCATGC,0,1181380
fldAp,0.1111111111111111,8,8,TGCGGACCTGATTAATTACG,0,1178907
fldAp,0.1111111111111111,8,8,TGCGCGGGGTTAGGCCGAGG,0,1112123
fldAp,0.1111111111111111,8,8,TGCGAAGGACGTTCGTACCT,0,1092212
fldAp,0.1111111111111111,8,8,TGCCTGACACTACAAATGTA,0,1101777
fldAp,0.1111111111111111,8,8,TGCCTGAAAGGTAGGGGAGT,0,1147881
fldAp,0.1111111111111111,8,8,TGCCGGGGTCGTTGGAGGGG,0,1078869
fldAp,0.1111111111111111,8,8,TGCCGGGACCCTCAGTGTAG,0,1085417
fldAp,0.1111111111111111,8,8,TGCCACGCTTCTCATAGACT,0,1172989
fldAp,0.1111111111111111,8,8,TGCATCACGCGTCAGGCGCA,0,1147413
fldAp,0.1111111111111111,8,8,TGCATACTATGTTAGATGAA,0,1092092
fldAp,0.1111111111111111,8,8,TGCAGTCGGTAGTAAGTAAA,0,1066552
fldAp,0.1111111111111111,8,8,TGCAGACTAAAGGCCCGCGG,0,1163288
fldAp,0.1111111111111111,8,8,TGCACTCTCTAGCACATAAA,0,1148580
fldAp,0.1111111111111111,8,8,TGCACTAGGGATTCCGTCGG,0,1161543
fldAp,0.1111111111111111,8,8,TGATGGACAGATAACTAATG,0,1153733
fldAp,0.1111111111111111,8,8,TGATCTTCCCACGTAGGGTT,0,1175858
fldAp,0.1111111111111111,8,8,TGATATACAGCACTTTTCCC,0,1139229
fldAp,0.1111111111111111,8,8,TGATACATTCCTGCTACCCG,0,1182624
fldAp,0.1111111111111111,8,8,TGAGTAGAGAATTGGGGTTA,0,1149952
fldAp,0.1111111111111111,8,8,TGAGGAGTTCTTAAGCTCAC,0,1102491
fldAp,0.1111111111111111,8,8,TGACGGCGCTATCCGTCGCA,0,1096446
fldAp,0.1111111111111111,8,8,TGACCCATTCCGGGTGCCGG,0,1176621
fldAp,0.1111111111111111,8,8,TGACAGACCACTGTCCGTGA,0,1081095
fldAp,0.1111111111111111,8,8,TGACACAAATGCGAATACCC,0,1106591
fldAp,0.1111111111111111,8,8,TGAAGTCGTCGGCCTCCAAA,0,1135145
fldAp,0.1111111111111111,8,8,TGAAGGGATGTTTGTGTTGA,0,1157252
fldAp,0.1111111111111111,8,8,TGAACTCTTCACCATGGAGT,0,1123092
fldAp,0.1111111111111111,8,8,TCTTTGGAAAAGACATACGC,0,1072238
fldAp,0.1111111111111111,8,8,TCTTGGGTGGGCTATATCAA,0,1112425
fldAp,0.1111111111111111,8,8,TCTTGAGGAGCACATCAGGG,0,1072872
fldAp,0.1111111111111111,8,8,TCTTCTTCCACTACCCCAAA,0,1069478
fldAp,0.1111111111111111,8,8,TCTGTTCGCATAGGGAGAAG,0,1184475
fldAp,0.1111111111111111,8,8,TCTGTCGTCGTGATCTCAGT,0,1165071
fldAp,0.1111111111111111,8,8,TCTGTCCCTTGTTCTTCCCG,0,1184848
fldAp,0.1111111111111111,8,8,TCTGGTAGGGATTCCGTCGA,0,1098459
fldAp,0.1111111111111111,8,8,TCTCTAAGCGAGTATTTTGA,0,1069528
fldAp,0.1111111111111111,8,8,TCTCGGTTTATTCTCGCCAT,0,1173247
fldAp,0.1111111111111111,8,8,TCTCGCGTATAGCAACTTAC,0,1131865
fldAp,0.1111111111111111,8,8,TCTCGCGGCGCCCTAGTATG,0,1148567
fldAp,0.1111111111111111,8,8,TCTCGCCGAAAATCAGGCCT,0,1130423
fldAp,0.1111111111111111,8,8,TCTCAGTGTATTTAGATTTG,0,1072298
fldAp,0.1111111111111111,8,8,TCTCACACGAGGCCATTCTA,0,1164954
fldAp,0.1111111111111111,8,8,TCTATTTGATTACTTTGTCT,0,1128937
fldAp,0.1111111111111111,8,8,TCTATTCATCCCCAGGAGGA,0,1094299
fldAp,0.1111111111111111,8,8,TCTATAACCATTGAGGGCTT,0,1148721
fldAp,0.1111111111111111,8,8,TCTAGATGAGTTGGGAAGCA,0,1115461
fldAp,0.1111111111111111,8,8,TCTAGATAGTCTTAATACGA,0,1184171
fldAp,0.1111111111111111,8,8,TCTACCTCTTGAAAAGCAGA,0,1123408
fldAp,0.1111111111111111,8,8,TCTAAAGGTTGGGCTAGTAA,0,1140403
fldAp,0.1111111111111111,8,8,TCGTTTTTTCGTGAGCATAC,0,1112403
fldAp,0.1111111111111111,8,8,TCGTTTAGGTAGGTGTGGAA,0,1122223
fldAp,0.1111111111111111,8,8,TCGTTTAGAGGCCGCTCGTC,0,1111788
fldAp,0.1111111111111111,8,8,TCGTGCGAACAAGGTCACGA,0,1126683
fldAp,0.1111111111111111,8,8,TCGTCACCGTGCAATTATAT,0,1064318
fldAp,0.1111111111111111,8,8,TCGTATGGTGCGCCGGTACG,0,1112925
fldAp,0.1111111111111111,8,8,TCGTAGCGTGGAATATCATT,0,1063749
fldAp,0.1111111111111111,8,8,TCGGTAATCGTCTAAAGTTC,0,1118503
fldAp,0.1111111111111111,8,8,TCGGGCGCGTGCCATCTTGC,0,1071115
fldAp,0.1111111111111111,8,8,TCGGCAGTAGAAGCCAAGGT,0,1136236
fldAp,0.1111111111111111,8,8,TCGGATTCAATTTGTAGGTC,0,1120401
fldAp,0.1111111111111111,8,8,TCGGAGCTGGCGGCGTTTCT,0,1156782
fldAp,0.1111111111111111,8,8,TCGGACTGTAGGGACTACGG,0,1111642
fldAp,0.1111111111111111,8,8,TCGGACGCTAACTGCGTAAA,0,1152433
fldAp,0.1111111111111111,8,8,TCGCTTAGACTCCCGAGTTG,0,1128771
fldAp,0.1111111111111111,8,8,TCGCTATGCCATTTACATTA,0,1148094
fldAp,0.1111111111111111,8,8,TCGCGTTGAGGGGTTCAGTA,0,1149640
fldAp,0.1111111111111111,8,8,TCGCGAACCGGGAAATTTAT,0,1185605
fldAp,0.1111111111111111,8,8,TCGCCTATGCCCGCCCAAGT,0,1169414
fldAp,0.1111111111111111,8,8,TCGCCAGCGTGTGTAGCGTT,0,1153141
fldAp,0.1111111111111111,8,8,TCGCACCCTCGTGAGCGCTA,0,1118902
fldAp,0.1111111111111111,8,8,TCGCAATGGAACGTTCCAAT,0,1152668
fldAp,0.1111111111111111,8,8,TCCTTCGACTATCTATGACA,0,1168439
fldAp,0.1111111111111111,8,8,TCCTTAGCACATCTAGGGGT,0,1118837
fldAp,0.1111111111111111,8,8,TCCTACTCGCTAACCATCCA,0,1078326
fldAp,0.1111111111111111,8,8,TCCGGGATTGGACTTACTGT,0,1133208
fldAp,0.1111111111111111,8,8,TCCGCTGGAGCCAAGTATTT,0,1119352
fldAp,0.1111111111111111,8,8,TCCGCGATCTACCCTGAGCA,0,1166802
fldAp,0.1111111111111111,8,8,TCCGCGAAAGTGCACTACAA,0,1161560
fldAp,0.1111111111111111,8,8,TCCCTATTCAAATTTGAGAA,0,1082519
fldAp,0.1111111111111111,8,8,TCCCGCACTCCGTAAGCGAA,0,1176841
fldAp,0.1111111111111111,8,8,TCCCATGGACTAGGGTCCCC,0,1140272
fldAp,0.1111111111111111,8,8,TCCCACCAGGTCACAGACCA,0,1126453
fldAp,0.1111111111111111,8,8,TCCCAAACCGGGTATGTTGG,0,1083221
fldAp,0.1111111111111111,8,8,TCCAAGCAAGTATAATTTGC,0,1179909
fldAp,0.1111111111111111,8,8,TCCAAATTCGACGAGCCGAC,0,1161065
fldAp,0.1111111111111111,8,8,TCATGGACCGAAATGGAACA,0,1168134
fldAp,0.1111111111111111,8,8,TCATGCTTCTTTACTTGTTT,0,1174445
fldAp,0.1111111111111111,8,8,TCATGAGCGGCATATGGCAT,0,1106324
fldAp,0.1111111111111111,8,8,TCATCGTTAATAGCAACATT,0,1126934
fldAp,0.1111111111111111,8,8,TCATCGGTCGTGGGCTCTAT,0,1091380
fldAp,0.1111111111111111,8,8,TCATAAATTTTCTTAGCGCA,0,1174524
fldAp,0.1111111111111111,8,8,TCAGGCGGGACGCCATTGCA,0,1149876
fldAp,0.1111111111111111,8,8,TCAGCAGGTTGCACCGTCGC,0,1078866
fldAp,0.1111111111111111,8,8,TCAGATCGTGGACCTGCCGT,0,1105084
fldAp,0.1111111111111111,8,8,TCAGACGGATGTGCGCAAGT,0,1112483
fldAp,0.1111111111111111,8,8,TCAGAAACCAGGCACCTCTT,0,1128297
fldAp,0.1111111111111111,8,8,TCACGGCATCCCGACCGAGA,0,1134783
fldAp,0.1111111111111111,8,8,TCACCCATGTCGTGCATGTC,0,1140421
fldAp,0.1111111111111111,8,8,TCACCCAGTGCCTGATGACC,0,1132016
fldAp,0.1111111111111111,8,8,TCACAGGTCTTGGGGTTTAC,0,1114292
fldAp,0.1111111111111111,8,8,TCACACGAGGGTTGGTTGGT,0,1092881
fldAp,0.1111111111111111,8,8,TCAATGCAGCCGGCCTTAAC,0,1138843
fldAp,0.1111111111111111,8,8,TCAAGGTATCTCGTTAGATG,0,1072512
fldAp,0.1111111111111111,8,8,TATTTTTTCCAACCGTATGA,0,1183296
fldAp,0.1111111111111111,8,8,TATTTCGATGTTTTAAGCTT,0,1109817
fldAp,0.1111111111111111,8,8,TATTGTAGCGGGCGGGTTTA,0,1177214
fldAp,0.1111111111111111,8,8,TATGGGTTCCGTTAACGTCT,0,1074869
fldAp,0.1111111111111111,8,8,TATGGCTAAGGGATCCAATT,0,1087365
fldAp,0.1111111111111111,8,8,TATGCTCCACATAGCTTACA,0,1091427
fldAp,0.1111111111111111,8,8,TATGAACTCGGTCTATGGTT,0,1075830
fldAp,0.1111111111111111,8,8,TATCTGGTCATAACGACCGA,0,1066492
fldAp,0.1111111111111111,8,8,TATCGGGACAGCTAGGTTGA,0,1156946
fldAp,0.1111111111111111,8,8,TATCGGCCAGGAGTTGGTTT,0,1184528
fldAp,0.1111111111111111,8,8,TATCGCATTACTTACCACCT,0,1177503
fldAp,0.1111111111111111,8,8,TATATGAGAAAGACTTCAAC,0,1149771
fldAp,0.1111111111111111,8,8,TAGTGCTTACCATTCAATTT,0,1169849
fldAp,0.1111111111111111,8,8,TAGTGACCTGTCAAGTTTAA,0,1079108
fldAp,0.1111111111111111,8,8,TAGTCGTACGCACCCGAATG,0,1075031
fldAp,0.1111111111111111,8,8,TAGTAGAATCAGTAATTGGC,0,1066562
fldAp,0.1111111111111111,8,8,TAGGTAGGAGTTCGGTGTCT,0,1081376
fldAp,0.1111111111111111,8,8,TAGGTAATGCACTATTGTAG,0,1113801
fldAp,0.1111111111111111,8,8,TAGGGTCCGTCCGGCTCTGG,0,1087760
fldAp,0.1111111111111111,8,8,TAGGGGGGCACCATGCAGGA,0,1147452
fldAp,0.1111111111111111,8,8,TAGGGCATGGCGGCCGAAAT,0,1172199
fldAp,0.1111111111111111,8,8,TAGGCTTTCAGTGCGATTTC,0,1071766
fldAp,0.1111111111111111,8,8,TAGGCGCCAAAGTTGTTTTG,0,1114422
fldAp,0.1111111111111111,8,8,TAGGCATGTCTTTAGTCAGT,0,1173888
fldAp,0.1111111111111111,8,8,TAGGCAAATTTTGGCCTACT,0,1083766
fldAp,0.1111111111111111,8,8,TAGCGGGAACTAATTAGGAT,0,1108854
fldAp,0.1111111111111111,8,8,TAGCGCGTAATGGAGGAAAA,0,1140353
fldAp,0.1111111111111111,8,8,TAGCAGTTAATACCTGGCTA,0,1168431
fldAp,0.1111111111111111,8,8,TAGCAAGATCTCGTAGTGAC,0,1128620
fldAp,0.1111111111111111,8,8,TAGCAAGAAGGGTCTCATGT,0,1142322
fldAp,0.1111111111111111,8,8,TAGATCCGCAGTAGGTATCA,0,1098375
fldAp,0.1111111111111111,8,8,TAGACTTATAGGGCACTACT,0,1173550
fldAp,0.1111111111111111,8,8,TAGAAGGACCACGGCTTCAG,0,1102713
fldAp,0.1111111111111111,8,8,TAGAACCTTTCGCATAGTGT,0,1100597
fldAp,0.1111111111111111,8,8,TAGAAAGCTACAACAAACGG,0,1073932
fldAp,0.1111111111111111,8,8,TACTGTTAACCCGGGGCAGG,0,1106210
fldAp,0.1111111111111111,8,8,TACTGCACGAAGGCTATATC,0,1087035
fldAp,0.1111111111111111,8,8,TACTAGCGCGCTGGCCTACC,0,1150363
fldAp,0.1111111111111111,8,8,TACGTTCGGTATGAACCCGC,0,1146326
fldAp,0.1111111111111111,8,8,TACGGTCATTTTTCTGCTCA,0,1065310
fldAp,0.1111111111111111,8,8,TACGGCGGCCCAAGATGTCC,0,1158177
fldAp,0.1111111111111111,8,8,TACGCGTGGGTAATTTTAAT,0,1144741
fldAp,0.1111111111111111,8,8,TACGCGTGCAAGCCCAATTC,0,1113810
fldAp,0.1111111111111111,8,8,TACGAAGAGCAGACATCAGA,0,1135491
fldAp,0.1111111111111111,8,8,TACAGATCTAACCCCCGCAT,0,1161389
fldAp,0.1111111111111111,8,8,TAATTTCCAAACAGTCACAA,0,1153550
fldAp,0.1111111111111111,8,8,TAATCGTCATAGTAAATGGA,0,1111846
fldAp,0.1111111111111111,8,8,TAATCGCAGTTCGCAAAATC,0,1157760
fldAp,0.1111111111111111,8,8,TAATCCTGACGCAGCAAGAA,0,1107468
fldAp,0.1111111111111111,8,8,TAAGTGTAACGCGTCGCAAC,0,1079431
fldAp,0.1111111111111111,8,8,TAAGGGCCGTCGGTCAATTG,0,1165569
fldAp,0.1111111111111111,8,8,TAAGAAACTTCTACTCGCGG,0,1126657
fldAp,0.1111111111111111,8,8,TAACTGTCCGCCAAGGAAAG,0,1088950
fldAp,0.1111111111111111,8,8,TAACTCGGCAGATACCGGTA,0,1120662
fldAp,0.1111111111111111,8,8,TAACGGCGCTATGACTACAA,0,1079939
fldAp,0.1111111111111111,8,8,TAACAGAGGGGCCGGCGTTC,0,1160581
fldAp,0.1111111111111111,8,8,TAACACTCGCCCTCTCCTGC,0,1167524
fldAp,0.1111111111111111,8,8,TAAAGTTTGTCCAGCATTGG,0,1093652
fldAp,0.1111111111111111,8,8,TAAAGTGGTGCGAAGTGCAT,0,1085596
fldAp,0.1111111111111111,8,8,TAAACGTCGTCCTGCTGCCA,0,1136982
fldAp,0.1111111111111111,8,8,TAAACGTATCCACATGGAGC,0,1099136
fldAp,0.1111111111111111,8,8,TAAACGCCTTGTGCACCAGG,0,1163385
fldAp,0.1111111111111111,8,8,TAAACGCCATCCCACCAAGC,0,1131672
fldAp,0.1111111111111111,8,8,TAAACCCTCTAATAAGCCCA,0,1114327
fldAp,0.1111111111111111,8,8,GTTTTGTGCAGCTCAGTCTG,0,1084907
fldAp,0.1111111111111111,8,8,GTTTTAGTGGCTGGGTTTAC,0,1092057
fldAp,0.1111111111111111,8,8,GTTTCAGACTAAAACATCGG,0,1071448
fldAp,0.1111111111111111,8,8,GTTGTAAGACTGTGCAGAGA,0,1132626
fldAp,0.1111111111111111,8,8,GTTGCATAACGTATGGATGT,0,1131770
fldAp,0.1111111111111111,8,8,GTTGAGCAACATCTGCGCGG,0,1127877
fldAp,0.1111111111111111,8,8,GTTCTTGTACCTACTGCGGA,0,1101681
fldAp,0.1111111111111111,8,8,GTTCCGCTCCAGGCTTGGAG,0,1159882
fldAp,0.1111111111111111,8,8,GTTCCCGGTGACGCCTAGGT,0,1168063
fldAp,0.1111111111111111,8,8,GTTCAGGTCCCTCCAGGTTT,0,1063329
fldAp,0.1111111111111111,8,8,GTTCAAGTAGTACTACTGAA,0,1156012
fldAp,0.1111111111111111,8,8,GTTATCCTGTACAGGGGGGT,0,1120346
fldAp,0.1111111111111111,8,8,GTTAGTCTGCGAGATAAGGT,0,1086772
fldAp,0.1111111111111111,8,8,GTTAGGGACTTGGCAGTGTA,0,1172594
fldAp,0.1111111111111111,8,8,GTTAGATAAAGACCAGAAAA,0,1176531
fldAp,0.1111111111111111,8,8,GTTAACAGCGCGAATCAATA,0,1146344
fldAp,0.1111111111111111,8,8,GTGTTTGATAAGTATAGCAG,0,1079880
fldAp,0.1111111111111111,8,8,GTGTTGCGGAACGGGACGTG,0,1147911
fldAp,0.1111111111111111,8,8,GTGTTCACCCAGGCTCATAG,0,1064726
fldAp,0.1111111111111111,8,8,GTGTGTTTATTACTTTGAAA,0,1098763
fldAp,0.1111111111111111,8,8,GTGTCTGGCGAGGTTTATAG,0,1066740
fldAp,0.1111111111111111,8,8,GTGTCTGACCGCTTAGGCAA,0,1134017
fldAp,0.1111111111111111,8,8,GTGTCCGATTGGTGTGCTTT,0,1164801
fldAp,0.1111111111111111,8,8,GTGTAAGGACGCACCGGTGT,0,1067359
fldAp,0.1111111111111111,8,8,GTGGACACACACACAAACGG,0,1104402
fldAp,0.1111111111111111,8,8,GTGCTAGCAATTGGGTACTC,0,1085137
fldAp,0.1111111111111111,8,8,GTGCGAACCCGTGTTTAGAG,0,1164697
fldAp,0.1111111111111111,8,8,GTGCATACTAAACATTAACT,0,1078514
fldAp,0.1111111111111111,8,8,GTGCACTACCGGAGAATAGA,0,1162222
fldAp,0.1111111111111111,8,8,GTGCAATGAAGGTCGGCTCA,0,1127825
fldAp,0.1111111111111111,8,8,GTGATTACCTGTCATACGAT,0,1109704
fldAp,0.1111111111111111,8,8,GTGATCCACCACGAGTTCTT,0,1071047
fldAp,0.1111111111111111,8,8,GTGAGTAAGGCATCATTTGA,0,1080400
fldAp,0.1111111111111111,8,8,GTGAGAGAGACCCAGTTGGT,0,1079845
fldAp,0.1111111111111111,8,8,GTGACGTCGCGGCGCCGAAT,0,1159976
fldAp,0.1111111111111111,8,8,GTGACATATAACACTTCGCA,0,1119306
fldAp,0.1111111111111111,8,8,GTGAAGCAGACTATATTGGA,0,1121232
fldAp,0.1111111111111111,8,8,GTCTTTTGTGTACTTCATAA,0,1132623
fldAp,0.1111111111111111,8,8,GTCGTTTCAAGTAATCTCGG,0,1084710
fldAp,0.1111111111111111,8,8,GTCGTTCCTTCGTTTCTGAT,0,1182025
fldAp,0.1111111111111111,8,8,GTCGTTATGCTCGGGAATGT,0,1081929
fldAp,0.1111111111111111,8,8,GTCGTCCTAGGATCAAAGGT,0,1156650
fldAp,0.1111111111111111,8,8,GTCGGGTAGGTCAGAAGTGA,0,1078201
fldAp,0.1111111111111111,8,8,GTCGGACGTACTCGTAAGCA,0,1179617
fldAp,0.1111111111111111,8,8,GTCCTTTCCTCACAAAATTA,0,1162880
fldAp,0.1111111111111111,8,8,GTCCTGACCGACAGAGCCAA,0,1114693
fldAp,0.1111111111111111,8,8,GTCCGGACATTACTGGGGAC,0,1121493
fldAp,0.1111111111111111,8,8,GTCCCGTGTGTGATTGATTG,0,1141255
fldAp,0.1111111111111111,8,8,GTCCCCCATACGTCGTCAGC,0,1182596
fldAp,0.1111111111111111,8,8,GTCCACTGCATATTGGACGG,0,1119715
fldAp,0.1111111111111111,8,8,GTCAGGAAGCTCGTCGCGGT,0,1138519
fldAp,0.1111111111111111,8,8,GTCAGAGATCTTTGGTATCT,0,1147343
fldAp,0.1111111111111111,8,8,GTCACCAGTAGAAATGCGAG,0,1174512
fldAp,0.1111111111111111,8,8,GTCAACCTCTGTATGAGCTT,0,1071407
fldAp,0.1111111111111111,8,8,GTATCTGTAAAATGCGCGGA,0,1164848
fldAp,0.1111111111111111,8,8,GTAGTTTGTGAAATCATTAA,0,1125570
fldAp,0.1111111111111111,8,8,GTAGTGGGGGAGCGCGTAAG,0,1166365
fldAp,0.1111111111111111,8,8,GTAGTCTTGATGGTGAGGAA,0,1142419
fldAp,0.1111111111111111,8,8,GTAGTCGGTCCTACTCAGAC,0,1095512
fldAp,0.1111111111111111,8,8,GTAGGAATGTACGCCAGGTG,0,1105942
fldAp,0.1111111111111111,8,8,GTAGAGTGGTGGATTCGAGA,0,1111409
fldAp,0.1111111111111111,8,8,GTACTTACCTGTTTAAATAT,0,1123475
fldAp,0.1111111111111111,8,8,GTACTGCAGCCTCGCTTGCA,0,1116417
fldAp,0.1111111111111111,8,8,GTACTAGGCGCATATTCGCA,0,1069981
fldAp,0.1111111111111111,8,8,GTACTAAGAAAACAGGGAGT,0,1168920
fldAp,0.1111111111111111,8,8,GTACCGAACACGTTCATCTG,0,1165567
fldAp,0.1111111111111111,8,8,GTACAGTGAGCGGAGCATCG,0,1138841
fldAp,0.1111111111111111,8,8,GTACACATTCGTACGATGAG,0,1165068
fldAp,0.1111111111111111,8,8,GTACAAATTGGGTTTCAACA,0,1115722
fldAp,0.1111111111111111,8,8,GTAAGATCAGTTCCCTTGCC,0,1097529
fldAp,0.1111111111111111,8,8,GTAAATGCGGCCTCATTCGT,0,1110472
fldAp,0.1111111111111111,8,8,GTAAATCACATTCAAGCAAT,0,1180728
fldAp,0.1111111111111111,8,8,GTAAAGGGGAATGACATTGA,0,1075441
fldAp,0.1111111111111111,8,8,GGTTTAGGAGCACTTGTTTA,0,1086946
fldAp,0.1111111111111111,8,8,GGTTTACCCCGGGATGCTAC,0,1102972
fldAp,0.1111111111111111,8,8,GGTTGGCGGAGTGAGCTCTA,0,1179812
fldAp,0.1111111111111111,8,8,GGTTGCCAAAGGGCACCTTC,0,1152974
fldAp,0.1111111111111111,8,8,GGTTAATCAAACGTGTTGAC,0,1100074
fldAp,0.1111111111111111,8,8,GGTTAAGCATGCAAGTAGTC,0,1134134
fldAp,0.1111111111111111,8,8,GGTGTCGGGATGGCTACGAC,0,1072415
fldAp,0.1111111111111111,8,8,GGTGTCATTTCGGAGAATAC,0,1143192
fldAp,0.1111111111111111,8,8,GGTGTATTGAGGTGTTGGAG,0,1073813
fldAp,0.1111111111111111,8,8,GGTGTACACGTGGTAGCGCA,0,1086292
fldAp,0.1111111111111111,8,8,GGTGGTTGCGTAGATCGTAT,0,1115299
fldAp,0.1111111111111111,8,8,GGTGGTGTTAGATCGGCCGA,0,1173763
fldAp,0.1111111111111111,8,8,GGTGGACTTGCCACCGACGT,0,1156436
fldAp,0.1111111111111111,8,8,GGTGCTGTGCCGGATTACTA,0,1176737
fldAp,0.1111111111111111,8,8,GGTGCGCGTAGGGTAGGCAT,0,1116032
fldAp,0.1111111111111111,8,8,GGTGATATGCGGCCTATCCT,0,1133628
fldAp,0.1111111111111111,8,8,GGTGAGGTAGTAAAATGGAA,0,1163535
fldAp,0.1111111111111111,8,8,GGTGACTGTGGCCGCTAACA,0,1066999
fldAp,0.1111111111111111,8,8,GGTCGTTGGGGCGTTCTTTT,0,1085143
fldAp,0.1111111111111111,8,8,GGTCGGTAGGGCCGACAGGA,0,1162141
fldAp,0.1111111111111111,8,8,GGTCGGCCCGAAATGGAATC,0,1125544
fldAp,0.1111111111111111,8,8,GGTCAGGCTTCCAGTACTTC,0,1101870
fldAp,0.1111111111111111,8,8,GGTCACGAGCCGGCTATAGC,0,1185588
fldAp,0.1111111111111111,8,8,GGTACGTACCTGGAAGACCA,0,1123684
fldAp,0.1111111111111111,8,8,GGTACGACCAAGTTATCTAT,0,1143318
fldAp,0.1111111111111111,8,8,GGGTTCCTTCACCTTTAGAG,0,1156752
fldAp,0.1111111111111111,8,8,GGGTTAGCACTAATGTGGCA,0,1083988
fldAp,0.1111111111111111,8,8,GGGTTAAGCGATTCAGGTGA,0,1084628
fldAp,0.1111111111111111,8,8,GGGTGGTTCAAGTTCCTCAT,0,1120852
fldAp,0.1111111111111111,8,8,GGGTCACGATCGACACACTT,0,1147326
fldAp,0.1111111111111111,8,8,GGGGTCGTTCTTGTGGATGG,0,1094174
fldAp,0.1111111111111111,8,8,GGGGGTGACCCAACCAACGA,0,1067858
fldAp,0.1111111111111111,8,8,GGGGCGCACGGGGAATCACC,0,1162646
fldAp,0.1111111111111111,8,8,GGGGAGCTAAACCACAGGTA,0,1090573
fldAp,0.1111111111111111,8,8,GGGCGAGATAACGAGTCCCC,0,1105994
fldAp,0.1111111111111111,8,8,GGGCATTGGTCGGATGAAGT,0,1117270
fldAp,0.1111111111111111,8,8,GGGCAGCAATATCCCAACAA,0,1177697
fldAp,0.1111111111111111,8,8,GGGCACTCGGCACAGAGCTT,0,1131777
fldAp,0.1111111111111111,8,8,GGGATTGGTAGACTCTTCAA,0,1170925
fldAp,0.1111111111111111,8,8,GGGAGTGGCTGTTTGTATTT,0,1159109
fldAp,0.1111111111111111,8,8,GGGAGCGTCCAGAAATCCAC,0,1136963
fldAp,0.1111111111111111,8,8,GGGACTTTAAAGACCGCTCG,0,1141067
fldAp,0.1111111111111111,8,8,GGGAACCCTGAGGGTGTTGA,0,1144231
fldAp,0.1111111111111111,8,8,GGCTCGGATCGCTGGGCCTC,0,1173370
fldAp,0.1111111111111111,8,8,GGCTCCTGCGGGCACAAGTG,0,1178416
fldAp,0.1111111111111111,8,8,GGCTACTGTTTTGCGGCTTC,0,1107772
fldAp,0.1111111111111111,8,8,GGCTACACGGTCCAGTTTGT,0,1084747
fldAp,0.1111111111111111,8,8,GGCGGGGCACGAAAGTCAAA,0,1090877
fldAp,0.1111111111111111,8,8,GGCGGACTTACATACTTAAA,0,1100077
fldAp,0.1111111111111111,8,8,GGCGCAAATTGAGACGGTAG,0,1167755
fldAp,0.1111111111111111,8,8,GGCCTTCCCTGCATCTCTTG,0,1136447
fldAp,0.1111111111111111,8,8,GGCCTCCTAACTTTTGAACG,0,1093709
fldAp,0.1111111111111111,8,8,GGCCTCAGTCATTTCTGGGT,0,1079146
fldAp,0.1111111111111111,8,8,GGCCTAGGTTTAATAAATAG,0,1081666
fldAp,0.1111111111111111,8,8,GGCCGTCTGTGGACATTAGT,0,1149768
fldAp,0.1111111111111111,8,8,GGCCGTCTAGAGTGCGCCGG,0,1121597
fldAp,0.1111111111111111,8,8,GGCCCTAGAACAAGGCAACC,0,1158174
fldAp,0.1111111111111111,8,8,GGCCATACACCAGCCTAGTG,0,1173628
fldAp,0.1111111111111111,8,8,GGCAGGGAAACTGGGATCCC,0,1135132
fldAp,0.1111111111111111,8,8,GGCACATTCCCGGGCTGTGC,0,1139705
fldAp,0.1111111111111111,8,8,GGATTATGGCACAGCAGTGT,0,1162745
fldAp,0.1111111111111111,8,8,GGATGGAACTCGTCCTTAGC,0,1110825
fldAp,0.1111111111111111,8,8,GGATCGCAACTATTTAACCT,0,1080660
fldAp,0.1111111111111111,8,8,GGATCACCAGAGCGTGTTTA,0,1101651
fldAp,0.1111111111111111,8,8,GGATATATGTAAGTCTTCGA,0,1131919
fldAp,0.1111111111111111,8,8,GGAGGTTGTGGCATATCAAG,0,1103335
fldAp,0.1111111111111111,8,8,GGAGGATACGGGGTGGTGTA,0,1088729
fldAp,0.1111111111111111,8,8,GGAGCAGTGGGCTCACCGTG,0,1169531
fldAp,0.1111111111111111,8,8,GGACTGCTCGGTACCCAAGC,0,1076821
fldAp,0.1111111111111111,8,8,GGACGCTTGTGTACAGCCAA,0,1077448
fldAp,0.1111111111111111,8,8,GGACGATCAAGTCTCGCCTG,0,1142733
fldAp,0.1111111111111111,8,8,GGACATGAATTTGACGTATA,0,1182125
fldAp,0.1111111111111111,8,8,GGACAACTCCTGACTAAAGT,0,1091842
fldAp,0.1111111111111111,8,8,GGAAGCCGTTATGGGTGGTG,0,1159267
fldAp,0.1111111111111111,8,8,GCTTCTTGATATACCTCGCT,0,1150759
fldAp,0.1111111111111111,8,8,GCTTCGGCGATCCAACTGTC,0,1076990
fldAp,0.1111111111111111,8,8,GCTTCGATCAGGTTGTATGG,0,1117591
fldAp,0.1111111111111111,8,8,GCTTACGGGCCGTGTGCAAT,0,1106423
fldAp,0.1111111111111111,8,8,GCTGTCGTTCCGAGCTCAAT,0,1127204
fldAp,0.1111111111111111,8,8,GCTGAAAGTCCTTGAACACC,0,1174200
fldAp,0.1111111111111111,8,8,GCTCTGTAAGCCTTTAAGGC,0,1077257
fldAp,0.1111111111111111,8,8,GCTCTGGGTTAGTGTTGTAG,0,1097052
fldAp,0.1111111111111111,8,8,GCTCTAGGAAAGCTTACCCG,0,1075861
fldAp,0.1111111111111111,8,8,GCTCGGAGCATGGTGACAGG,0,1093785
fldAp,0.1111111111111111,8,8,GCTCCTTGGCTGCTTCACGA,0,1143376
fldAp,0.1111111111111111,8,8,GCTCCGGCCTTCCACCCACC,0,1150365
fldAp,0.1111111111111111,8,8,GCTCCCACGCCGCGGCAATT,0,1093413
fldAp,0.1111111111111111,8,8,GCTATTACACTGTTCGCCGG,0,1080105
fldAp,0.1111111111111111,8,8,GCTATGGTCTAGGGTTTAAG,0,1154075
fldAp,0.1111111111111111,8,8,GCTAGGGGTATTTTCCGCCA,0,1090893
fldAp,0.1111111111111111,8,8,GCTAGCGGTTCGACCCTTCA,0,1149392
fldAp,0.1111111111111111,8,8,GCTACGGGCGTAGTTGAGCA,0,1143393
fldAp,0.1111111111111111,8,8,GCTACCATCTGCAATCGTGC,0,1091268
fldAp,0.1111111111111111,8,8,GCTAAGTTGTTGGCAGCAGA,0,1125561
fldAp,0.1111111111111111,8,8,GCGTTTGTGTGATTGGATAG,0,1181245
fldAp,0.1111111111111111,8,8,GCGTTTGGCATATGAGTGGA,0,1105858
fldAp,0.1111111111111111,8,8,GCGTTTAGTTGGTGAAATCA,0,1152003
fldAp,0.1111111111111111,8,8,GCGTTGCTGAGAAGCCCCTT,0,1175379
fldAp,0.1111111111111111,8,8,GCGTTCGGTAGGGGGCGGGT,0,1167823
fldAp,0.1111111111111111,8,8,GCGGTGCTGGCATTGACTAT,0,1170457
fldAp,0.1111111111111111,8,8,GCGGGTTTTGGGTCATTCTA,0,1161738
fldAp,0.1111111111111111,8,8,GCGGGCCTCACTGTTTTCGC,0,1117692
fldAp,0.1111111111111111,8,8,GCGGAGTAGAATGAGGGCGC,0,1111271
fldAp,0.1111111111111111,8,8,GCGGAAATAAGGATCATGGG,0,1165130
fldAp,0.1111111111111111,8,8,GCGCGTGCATTTTAATGGGA,0,1173803
fldAp,0.1111111111111111,8,8,GCGCCCATCTTATCACTGTA,0,1173423
fldAp,0.1111111111111111,8,8,GCGCCAACAGTGTGTAGCTG,0,1130245
fldAp,0.1111111111111111,8,8,GCGATGAGTACCACGTACTT,0,1165470
fldAp,0.1111111111111111,8,8,GCGAGTGTGGCAATGTAAAG,0,1078730
fldAp,0.1111111111111111,8,8,GCGAGGATATGACGATAATC,0,1159795
fldAp,0.1111111111111111,8,8,GCGAACGGACACGGACCCAG,0,1150239
fldAp,0.1111111111111111,8,8,GCCTTTTGAGTTCATTGCCA,0,1185824
fldAp,0.1111111111111111,8,8,GCCTTGTTAAGTACATGCAA,0,1130911
fldAp,0.1111111111111111,8,8,GCCTTACCTACCCAGCTTTA,0,1065963
fldAp,0.1111111111111111,8,8,GCCTGCCCAACTTTGCCATT,0,1181252
fldAp,0.1111111111111111,8,8,GCCTGACGCGGAAGAAAGGA,0,1155797
fldAp,0.1111111111111111,8,8,GCCTCCCAGCCCAGGTCATT,0,1104730
fldAp,0.1111111111111111,8,8,GCCTAGCTTCCATACCGATC,0,1098059
fldAp,0.1111111111111111,8,8,GCCTAAGGTGGGTGACGCAA,0,1186415
fldAp,0.1111111111111111,8,8,GCCGTGGTGCGGAGATGGGG,0,1130905
fldAp,0.1111111111111111,8,8,GCCGTGGAGTAGCCGGTTAT,0,1099382
fldAp,0.1111111111111111,8,8,GCCGTCCTTTTAACGGACTG,0,1165491
fldAp,0.1111111111111111,8,8,GCCGCGATCGTCTATTCTGG,0,1110670
fldAp,0.1111111111111111,8,8,GCCGCAGTGCACCGTGGCTA,0,1105885
fldAp,0.1111111111111111,8,8,GCCGATGCATGTCCCCACGT,0,1138173
fldAp,0.1111111111111111,8,8,GCCGAAAACTAACGACAGCA,0,1099866
fldAp,0.1111111111111111,8,8,GCCCTACAGGTACGACAGTG,0,1078291
fldAp,0.1111111111111111,8,8,GCCCGTCTGATGAACCTGCA,0,1181893
fldAp,0.1111111111111111,8,8,GCCCCGAGGAGGCTACCCTC,0,1165201
fldAp,0.1111111111111111,8,8,GCCCCCTGGGGCTAGTTGTT,0,1113271
fldAp,0.1111111111111111,8,8,GCCATTTTTCTTGGATCCTG,0,1131248
fldAp,0.1111111111111111,8,8,GCCATGGCGAATACTAGCTT,0,1153803
fldAp,0.1111111111111111,8,8,GCCATGATGGAAATTAGTTT,0,1128724
fldAp,0.1111111111111111,8,8,GCCAGGCAGCCTAGCGAATC,0,1078473
fldAp,0.1111111111111111,8,8,GCCACGTGGGAATTCCATGC,0,1149535
fldAp,0.1111111111111111,8,8,GCCAAGTGGGGCCGCCATTA,0,1144856
fldAp,0.1111111111111111,8,8,GCATCGTGATCTCCGACAAT,0,1143560
fldAp,0.1111111111111111,8,8,GCATCCTGTTCCGTGCCATA,0,1168276
fldAp,0.1111111111111111,8,8,GCATATGGGACTTGCTGGCG,0,1159553
fldAp,0.1111111111111111,8,8,GCATAGTTGGGCCGGTACAC,0,1098922
fldAp,0.1111111111111111,8,8,GCAGTCTTCAAACGTAGTCA,0,1104874
fldAp,0.1111111111111111,8,8,GCAGGGAAATATAAGGCGCA,0,1119721
fldAp,0.1111111111111111,8,8,GCAGGCTAGCCGCTACTATA,0,1077141
fldAp,0.1111111111111111,8,8,GCAGGCCCGACAAATTCAGA,0,1185684
fldAp,0.1111111111111111,8,8,GCAGCGAGATAAGAGTTCAA,0,1125473
fldAp,0.1111111111111111,8,8,GCAGATTTGCTCTTAAATAC,0,1151922
fldAp,0.1111111111111111,8,8,GCAGATGGCTCTTTACGACT,0,1160088
fldAp,0.1111111111111111,8,8,GCAGAACTATAACATGTACA,0,1064041
fldAp,0.1111111111111111,8,8,GCACTAGCAACAAACGTGAG,0,1174902
fldAp,0.1111111111111111,8,8,GCACGATAATCCTGGGCATA,0,1165310
fldAp,0.1111111111111111,8,8,GCACAAGCTCTCCTCGCAAG,0,1096048
fldAp,0.1111111111111111,8,8,GCAATGGGGGGGGTAACGTT,0,1148978
fldAp,0.1111111111111111,8,8,GATTGGAACGGGCGGGACAA,0,1158047
fldAp,0.1111111111111111,8,8,GATTGACGGGCGACTGATAC,0,1173720
fldAp,0.1111111111111111,8,8,GATTCTTCCACGGCTGTTCA,0,1146811
fldAp,0.1111111111111111,8,8,GATTACCCCATGAATTGGCC,0,1140225
fldAp,0.1111111111111111,8,8,GATTAAGGGTCGTATCAGCA,0,1105461
fldAp,0.1111111111111111,8,8,GATGGGGCTAAGGTACTACT,0,1133943
fldAp,0.1111111111111111,8,8,GATGCTCGCGAGCGCTTATA,0,1165695
fldAp,0.1111111111111111,8,8,GATGCAGAGTATCATTTCCC,0,1064094
fldAp,0.1111111111111111,8,8,GATGACTCTCCCTCGTTGGC,0,1091128
fldAp,0.1111111111111111,8,8,GATGAAAAGGACTGCCGATG,0,1185463
fldAp,0.1111111111111111,8,8,GATCGGGAGAGGTGCGACTA,0,1156552
fldAp,0.1111111111111111,8,8,GATCGCTCTAACCGTTGATG,0,1068997
fldAp,0.1111111111111111,8,8,GATCCTCTAAGACGGTGCTA,0,1116915
fldAp,0.1111111111111111,8,8,GATCCTATGTTGACTGGTTA,0,1164849
fldAp,0.1111111111111111,8,8,GATCCATACATAAACACGCG,0,1085185
fldAp,0.1111111111111111,8,8,GATCATCCCGCCTCATGTCT,0,1118948
fldAp,0.1111111111111111,8,8,GATATTGTGAGTCGGGAAAC,0,1079623
fldAp,0.1111111111111111,8,8,GATAGATGGCAAATAGCTAG,0,1112199
fldAp,0.1111111111111111,8,8,GATAATATGTATTTCACACG,0,1172583
fldAp,0.1111111111111111,8,8,GAGTGTGTGAGCCACGTTGC,0,1141688
fldAp,0.1111111111111111,8,8,GAGTCTTAGTATACGCTAAT,0,1126119
fldAp,0.1111111111111111,8,8,GAGTCCTATAGTTGTAGGAC,0,1151904
fldAp,0.1111111111111111,8,8,GAGTCCACTACTCTCGTGTA,0,1083964
fldAp,0.1111111111111111,8,8,GAGTAACCTGTCGCACCCCC,0,1069030
fldAp,0.1111111111111111,8,8,GAGGTGTGCCTGTCGTGGAT,0,1128618
fldAp,0.1111111111111111,8,8,GAGGTCGAACTGATACTTCT,0,1181748
fldAp,0.1111111111111111,8,8,GAGGGAACTCAGACCTTCAT,0,1089910
fldAp,0.1111111111111111,8,8,GAGGCCTCCCCAGTACTCGT,0,1089639
fldAp,0.1111111111111111,8,8,GAGGACCGTCAACTAAGCTC,0,1179023
fldAp,0.1111111111111111,8,8,GAGGAAGACATTTCGCCCAT,0,1074498
fldAp,0.1111111111111111,8,8,GAGGAAAACTGGGGTAATTA,0,1113561
fldAp,0.1111111111111111,8,8,GAGCTCTTGTAATGGTGGAG,0,1181778
fldAp,0.1111111111111111,8,8,GAGCGCTATCAATCAAAAGA,0,1165061
fldAp,0.1111111111111111,8,8,GAGATGCGATCACAGGTATC,0,1164179
fldAp,0.1111111111111111,8,8,GAGATCAGTCGTGAAAAGAG,0,1081533
fldAp,0.1111111111111111,8,8,GAGAGTGAATACAGTCTTGA,0,1089111
fldAp,0.1111111111111111,8,8,GAGAGTAATCCTCAGACTTT,0,1118775
fldAp,0.1111111111111111,8,8,GAGAGCACCTTGAAGGCGGG,0,1105172
fldAp,0.1111111111111111,8,8,GAGAAAAAGCGGCCTGCCAT,0,1094844
fldAp,0.1111111111111111,8,8,GACTTAATCTCGCGTCTGCT,0,1170458
fldAp,0.1111111111111111,8,8,GACTTAAGCATGCGGTGGAG,0,1100841
fldAp,0.1111111111111111,8,8,GACTGGTATTCACAGCTCAT,0,1153250
fldAp,0.1111111111111111,8,8,GACTGGCTCTCTCCGGCTAG,0,1145306
fldAp,0.1111111111111111,8,8,GACTCATGACCCGACACGTC,0,1182400
fldAp,0.1111111111111111,8,8,GACTAGGTCGGCTGAACAGT,0,1074570
fldAp,0.1111111111111111,8,8,GACGTCAACTTTAAGTGAAG,0,1071038
fldAp,0.1111111111111111,8,8,GACGTAGAGGCACCTTCATT,0,1152619
fldAp,0.1111111111111111,8,8,GACGCTCATCTCAACTCCAG,0,1158146
fldAp,0.1111111111111111,8,8,GACCGTTCTATGAGTAACCA,0,1177350
fldAp,0.1111111111111111,8,8,GACCGGGCTACATAAGCCCT,0,1170645
fldAp,0.1111111111111111,8,8,GACCGCAGATCCTAGGTTGA,0,1081248
fldAp,0.1111111111111111,8,8,GACCGATTTTCGTATAGTTT,0,1096787
fldAp,0.1111111111111111,8,8,GACCACCTTAGCAACAGAAT,0,1107098
fldAp,0.1111111111111111,8,8,GACATCCCATGTTTGGCCGC,0,1067112
fldAp,0.1111111111111111,8,8,GACAGTATCTGATCACGACT,0,1086999
fldAp,0.1111111111111111,8,8,GACAGGAGCTACTTGATATA,0,1173010
fldAp,0.1111111111111111,8,8,GACAGCTCAATAGGACTATA,0,1152137
fldAp,0.1111111111111111,8,8,GACACGGATCCAGCGGATAT,0,1153905
fldAp,0.1111111111111111,8,8,GAATGTATAACTATGTGCGT,0,1071760
fldAp,0.1111111111111111,8,8,GAATAGAGAGCATGAGAGAA,0,1074213
fldAp,0.1111111111111111,8,8,GAAGGCTTCATCGCGATTCT,0,1112005
fldAp,0.1111111111111111,8,8,GAAGAGAAATGGCCCCGCAG,0,1121749
fldAp,0.1111111111111111,8,8,GAAATGGTCGTGTTACGTTC,0,1144343
fldAp,0.1111111111111111,8,8,GAAATACAGGAGTTCTTTCA,0,1085907
fldAp,0.1111111111111111,8,8,GAAACGTTTCGTGGTGTAGA,0,1095777
fldAp,0.1111111111111111,8,8,GAAACGTGTGACGTATCGCC,0,1178910
fldAp,0.1111111111111111,8,8,CTTTTCGGTGGCAGGGTCCG,0,1145771
fldAp,0.1111111111111111,8,8,CTTTGTGCTAGCTGATCTGA,0,1125834
fldAp,0.1111111111111111,8,8,CTTTGGTCATCTGTGAACGG,0,1081632
fldAp,0.1111111111111111,8,8,CTTTCCGTCCTAATGACGAA,0,1170250
fldAp,0.1111111111111111,8,8,CTTTCACGGCCACACTATAT,0,1171813
fldAp,0.1111111111111111,8,8,CTTTATCAGGCCCACAAAAA,0,1103171
fldAp,0.1111111111111111,8,8,CTTTAGGGCTCACTGGCCGG,0,1155561
fldAp,0.1111111111111111,8,8,CTTGCCGACCCACTATTCGG,0,1123229
fldAp,0.1111111111111111,8,8,CTTGCAAGCCCATCGATAGT,0,1144549
fldAp,0.1111111111111111,8,8,CTTCTGCCGGAGAATATGCA,0,1084317
fldAp,0.1111111111111111,8,8,CTTCGGCTTATCACCTTGGT,0,1111715
fldAp,0.1111111111111111,8,8,CTTCGGAACTGCGAGCCTCA,0,1113136
fldAp,0.1111111111111111,8,8,CTTCGATTCACGATCATTTA,0,1180721
fldAp,0.1111111111111111,8,8,CTTCGAGGCCACAAGCGGGT,0,1131509
fldAp,0.1111111111111111,8,8,CTTCCTGTATGGCGATGTAT,0,1088556
fldAp,0.1111111111111111,8,8,CTTCCGACTCGGAGGGATGC,0,1089106
fldAp,0.1111111111111111,8,8,CTTATGCTAAGTTGGGTGTC,0,1088126
fldAp,0.1111111111111111,8,8,CTTAACTCCTGTTTCCGGCT,0,1166003
fldAp,0.1111111111111111,8,8,CTTAACGGTAGTATTGGCTT,0,1075110
fldAp,0.1111111111111111,8,8,CTTAAAGGGCGTGGACCGGG,0,1170227
fldAp,0.1111111111111111,8,8,CTGTTTCACATAAGTTCTAG,0,1099137
fldAp,0.1111111111111111,8,8,CTGTGGCTTTTGAAGTGGGG,0,1082771
fldAp,0.1111111111111111,8,8,CTGTATATCGTTCCCAAGGC,0,1145818
fldAp,0.1111111111111111,8,8,CTGTACGAGATCACATACTC,0,1122399
fldAp,0.1111111111111111,8,8,CTGGTTACACATGCCTTCCT,0,1105993
fldAp,0.1111111111111111,8,8,CTGGTACTATTATTTCTACA,0,1180756
fldAp,0.1111111111111111,8,8,CTGGCCGGGTAACCGCCACA,0,1153971
fldAp,0.1111111111111111,8,8,CTGGCAACAGCACCCTGTTT,0,1135740
fldAp,0.1111111111111111,8,8,CTGCTCTTATAAAGCGCTCA,0,1091637
fldAp,0.1111111111111111,8,8,CTGCCTACTTCCCGCACCCC,0,1087649
fldAp,0.1111111111111111,8,8,CTGATACCATATAATGGAGT,0,1104487
fldAp,0.1111111111111111,8,8,CTGAGTCGCATTCACGTAGG,0,1145210
fldAp,0.1111111111111111,8,8,CTGAATGCCACGTTATTACC,0,1160418
fldAp,0.1111111111111111,8,8,CTCTTAGCCCATTCGTATCT,0,1107100
fldAp,0.1111111111111111,8,8,CTCTGCGGCCGGCCCGGGGA,0,1129546
fldAp,0.1111111111111111,8,8,CTCTGCAGTGGGCGGTACAG,0,1186434
fldAp,0.1111111111111111,8,8,CTCTCCGGAACCACTCAGAG,0,1183124
fldAp,0.1111111111111111,8,8,CTCTACTGTATCGCTCCGTG,0,1136896
fldAp,0.1111111111111111,8,8,CTCTAATGCTCGTGCTAACT,0,1070841
fldAp,0.1111111111111111,8,8,CTCGTTCTTGTGGGGTCTGG,0,1172993
fldAp,0.1111111111111111,8,8,CTCGGGACAGCGACTTGCAT,0,1071806
fldAp,0.1111111111111111,8,8,CTCGCTGGCAGCCTAATTCA,0,1137407
fldAp,0.1111111111111111,8,8,CTCCGTATCGAGGGACTGCG,0,1152661
fldAp,0.1111111111111111,8,8,CTCCGGGTATCGTTTTAAGA,0,1126232
fldAp,0.1111111111111111,8,8,CTCCCAAAGCGTCCGCTAGC,0,1079757
fldAp,0.1111111111111111,8,8,CTCCAGTTATCTTATCTGAG,0,1096276
fldAp,0.1111111111111111,8,8,CTCCACCGGAAACTGGGTAT,0,1148158
fldAp,0.1111111111111111,8,8,CTCCAATGAGCCGTTCGACT,0,1086793
fldAp,0.1111111111111111,8,8,CTCATGGGGAAGTGACAGAA,0,1066819
fldAp,0.1111111111111111,8,8,CTCATACCTGGACATAAACG,0,1067504
fldAp,0.1111111111111111,8,8,CTCAGTTTGCGGCCGCAGCC,0,1074098
fldAp,0.1111111111111111,8,8,CTCACGTTTTCTGGGCTTCC,0,1169177
fldAp,0.1111111111111111,8,8,CTCACGGATTGCCCCGTGAA,0,1184269
fldAp,0.1111111111111111,8,8,CTATTTAAATGCAGATTCGG,0,1183533
fldAp,0.1111111111111111,8,8,CTATCGCCCAGTCATCGTCC,0,1129378
fldAp,0.1111111111111111,8,8,CTATACATATCGTTGCCCTT,0,1144496
fldAp,0.1111111111111111,8,8,CTAGTCATCGAGCTAAATCA,0,1133462
fldAp,0.1111111111111111,8,8,CTAGGGACATTGGGGTCTCA,0,1143370
fldAp,0.1111111111111111,8,8,CTAGGGAAGGTTCTACTATT,0,1134901
fldAp,0.1111111111111111,8,8,CTAGCTCATCGTAGTCTGTT,0,1183494
fldAp,0.1111111111111111,8,8,CTAGCCATCCAGGTAAACAT,0,1119895
fldAp,0.1111111111111111,8,8,CTAGATTTACACAGTCCTAT,0,1149078
fldAp,0.1111111111111111,8,8,CTACCCCCGCTAGCTGATGA,0,1168509
fldAp,0.1111111111111111,8,8,CTACACTGTGATTTAGGATT,0,1114191
fldAp,0.1111111111111111,8,8,CTAATGGCCTGTCCGCGAAT,0,1084634
fldAp,0.1111111111111111,8,8,CTAAGGGTTCAGCTAATCTA,0,1106076
fldAp,0.1111111111111111,8,8,CTAAGAGTGGTAGTTATTCA,0,1081075
fldAp,0.1111111111111111,8,8,CTAACCCTAGATATGAGCCA,0,1173230
fldAp,0.1111111111111111,8,8,CGTTTAGGGTGATGACCAGT,0,1176736
fldAp,0.1111111111111111,8,8,CGTTGTTGTCAAACCTCCTG,0,1143745
fldAp,0.1111111111111111,8,8,CGTTGGCTCATTCATCGGTG,0,1177375
fldAp,0.1111111111111111,8,8,CGTTACCCTGTGTTCGCTGC,0,1135011
fldAp,0.1111111111111111,8,8,CGTTAACCGCGGTTGAATGT,0,1130931
fldAp,0.1111111111111111,8,8,CGTGGTGACCGCAAACATCT,0,1135954
fldAp,0.1111111111111111,8,8,CGTGGAGAACTTCTCTGGTT,0,1107575
fldAp,0.1111111111111111,8,8,CGTGATACACCTTAGGCGGA,0,1129503
fldAp,0.1111111111111111,8,8,CGTGAGTTACCCCTTACTCA,0,1076166
fldAp,0.1111111111111111,8,8,CGTGAACCGGTGTCCCCAGC,0,1066627
fldAp,0.1111111111111111,8,8,CGTCTGCTGCAGGGACTTTT,0,1162542
fldAp,0.1111111111111111,8,8,CGTCTAGTTTGCCGACGCCA,0,1172901
fldAp,0.1111111111111111,8,8,CGTCGAAGTTCAGCTACCAG,0,1074871
fldAp,0.1111111111111111,8,8,CGTCAGTTCCAAAAGCACGC,0,1084848
fldAp,0.1111111111111111,8,8,CGTCACCGGGGAACCGGATT,0,1133170
fldAp,0.1111111111111111,8,8,CGTATTTAAATCTCTAGTTA,0,1135410
fldAp,0.1111111111111111,8,8,CGTATGGAATACGTGTAAGT,0,1152824
fldAp,0.1111111111111111,8,8,CGTATGCGGCCCTCATAGAT,0,1117219
fldAp,0.1111111111111111,8,8,CGTATCTTTAGCAGTCCATT,0,1126097
fldAp,0.1111111111111111,8,8,CGGTTCTCGGAAATACTCTC,0,1088511
fldAp,0.1111111111111111,8,8,CGGTTAGAAGAATGACGAAG,0,1170389
fldAp,0.1111111111111111,8,8,CGGTGCAAGCCGCCCTGTGT,0,1136407
fldAp,0.1111111111111111,8,8,CGGTCGGGCGGCTCCATCGT,0,1157517
fldAp,0.1111111111111111,8,8,CGGTCACTGATTGGTGCTGA,0,1186303
fldAp,0.1111111111111111,8,8,CGGTCAAGCATTCGTCTGTG,0,1127175
fldAp,0.1111111111111111,8,8,CGGGTAGAAGCGACTGTCTA,0,1132575
fldAp,0.1111111111111111,8,8,CGGGGGCGATAAGTCGAGTT,0,1172631
fldAp,0.1111111111111111,8,8,CGGGAGAGGGGTAACACCGG,0,1184343
fldAp,0.1111111111111111,8,8,CGGCTATGTAGTTACTCGAG,0,1077307
fldAp,0.1111111111111111,8,8,CGGCGAAGTCGGGTCCCATA,0,1091386
fldAp,0.1111111111111111,8,8,CGGCATCCGATTTGAACGCT,0,1163088
fldAp,0.1111111111111111,8,8,CGGACGGAGCGGTGCTTCGA,0,1106867
fldAp,0.1111111111111111,8,8,CGGAAAGGCATTCTTTCGCG,0,1082435
fldAp,0.1111111111111111,8,8,CGCTGGTTTTTTGGAGCGGA,0,1065966
fldAp,0.1111111111111111,8,8,CGCTCTGTGCCCCCGGTCAT,0,1140836
fldAp,0.1111111111111111,8,8,CGCTCATGGATAGGCAATTA,0,1078462
fldAp,0.1111111111111111,8,8,CGCTATGTGGATTGTACGAG,0,1180253
fldAp,0.1111111111111111,8,8,CGCTATGGGCACGGCGCATT,0,1082406
fldAp,0.1111111111111111,8,8,CGCGTATTGCATAGGCCGGG,0,1117397
fldAp,0.1111111111111111,8,8,CGCGCAGCAGCGTGTTGACA,0,1172191
fldAp,0.1111111111111111,8,8,CGCGACCTAAAAATGCAAGC,0,1137375
fldAp,0.1111111111111111,8,8,CGCCGTTTGTCTCCGCATAC,0,1080452
fldAp,0.1111111111111111,8,8,CGCCGGGCGTTGTCAGTCGG,0,1094932
fldAp,0.1111111111111111,8,8,CGCCGGCTAGGGAGAACAAC,0,1153213
fldAp,0.1111111111111111,8,8,CGCCAACACATGTGCCATGT,0,1173066
fldAp,0.1111111111111111,8,8,CGCATGGCACCAGTGGGTGT,0,1065154
fldAp,0.1111111111111111,8,8,CGCATCGTCAATATCAAAGC,0,1093077
fldAp,0.1111111111111111,8,8,CGCATCAGCCAGTTATGGTC,0,1152741
fldAp,0.1111111111111111,8,8,CGCAGGCCTTACCCAGGCTT,0,1117138
fldAp,0.1111111111111111,8,8,CGCAGCTCGCGTCCACTATA,0,1164359
fldAp,0.1111111111111111,8,8,CGCAGCGTCTGCCGCCGAGT,0,1130329
fldAp,0.1111111111111111,8,8,CGCAAGGTATCCTGATACAG,0,1092222
fldAp,0.1111111111111111,8,8,CGATTCCAGACCTTGCGAAG,0,1171439
fldAp,0.1111111111111111,8,8,CGATGTACTTCCACTGTGCT,0,1153489
fldAp,0.1111111111111111,8,8,CGATCTGGAGTGAAGGGGTG,0,1114134
fldAp,0.1111111111111111,8,8,CGATCATTCATGCCAGAAAA,0,1179889
fldAp,0.1111111111111111,8,8,CGATATAGGGGCGTTAAATC,0,1143265
fldAp,0.1111111111111111,8,8,CGATATAGATACCAGCTTAA,0,1115699
fldAp,0.1111111111111111,8,8,CGATAGGTGAGGTATCCATT,0,1128983
fldAp,0.1111111111111111,8,8,CGATACGGTTCGTGGCTCGT,0,1067030
fldAp,0.1111111111111111,8,8,CGAGCTAGCTAGCAACTTTC,0,1079251
fldAp,0.1111111111111111,8,8,CGAGCCTATTACCATGCTCG,0,1068148
fldAp,0.1111111111111111,8,8,CGAGCCGCGCTAGCGTTCCC,0,1073424
fldAp,0.1111111111111111,8,8,CGAGCCAACTTCGTACTATC,0,1123943
fldAp,0.1111111111111111,8,8,CGAGCAATCCACACCCAGAG,0,1120473
fldAp,0.1111111111111111,8,8,CGAGAGCGCTTAGGGTATGT,0,1067473
fldAp,0.1111111111111111,8,8,CGACTTTTACACACTTGGTC,0,1129851
fldAp,0.1111111111111111,8,8,CGACGTGTAATTGGATCACC,0,1135788
fldAp,0.1111111111111111,8,8,CGACGTGGTCCTCGGTGCTT,0,1143945
fldAp,0.1111111111111111,8,8,CGACGCCCGAGACGATATAT,0,1161997
fldAp,0.1111111111111111,8,8,CGACGATGGTTACGTGGTGT,0,1159820
fldAp,0.1111111111111111,8,8,CGACAGACTAGCACCAATTT,0,1135394
fldAp,0.1111111111111111,8,8,CGACACTCTCGAGACAGCTA,0,1179566
fldAp,0.1111111111111111,8,8,CGACACTCGCGTCCGTGGTT,0,1146051
fldAp,0.1111111111111111,8,8,CGAATGGGACGATTGACGGC,0,1172967
fldAp,0.1111111111111111,8,8,CGAAGCGGGAGACATAGTGC,0,1071670
fldAp,0.1111111111111111,8,8,CGAAACACCTCGCATTCTTA,0,1154066
fldAp,0.1111111111111111,8,8,CCTTTCCGCCATTCGGTCAT,0,1078907
fldAp,0.1111111111111111,8,8,CCTTGTCGGCCACCGGTGTA,0,1126903
fldAp,0.1111111111111111,8,8,CCTTGGTAAGTTTATGATAG,0,1148077
fldAp,0.1111111111111111,8,8,CCTTCGGGCGCCCACACATT,0,1069724
fldAp,0.1111111111111111,8,8,CCTTCCCTAGTTGTACAAAA,0,1154841
fldAp,0.1111111111111111,8,8,CCTTCCCCGGGCCGGTAACC,0,1102971
fldAp,0.1111111111111111,8,8,CCTGATACTTCATGAAAACA,0,1185853
fldAp,0.1111111111111111,8,8,CCTCTGGTTTATTCTGCCCA,0,1131680
fldAp,0.1111111111111111,8,8,CCTCCTTGTGAGAGATGAGC,0,1115401
fldAp,0.1111111111111111,8,8,CCTATTCCACAGGTCGCCAG,0,1127141
fldAp,0.1111111111111111,8,8,CCTATCAATTTTGTGCCTTT,0,1100755
fldAp,0.1111111111111111,8,8,CCTATATTGACATACGGATT,0,1079347
fldAp,0.1111111111111111,8,8,CCTATAGTACAGGTAACGGC,0,1069408
fldAp,0.1111111111111111,8,8,CCTATACAACAGCTATGAGG,0,1150693
fldAp,0.1111111111111111,8,8,CCTAGTCATAGGTTCTGGCG,0,1175519
fldAp,0.1111111111111111,8,8,CCGTTGTGAATGCCCAGACT,0,1182498
fldAp,0.1111111111111111,8,8,CCGTGTGCTCCAATTCGCGG,0,1167947
fldAp,0.1111111111111111,8,8,CCGTGGTTCACGCTCTTCGA,0,1142457
fldAp,0.1111111111111111,8,8,CCGTCGTTCAGGAGCGAGGT,0,1163209
fldAp,0.1111111111111111,8,8,CCGTCCACTTCGGGGCCGGC,0,1179237
fldAp,0.1111111111111111,8,8,CCGTAGACGCGCATGTTAGA,0,1097253
fldAp,0.1111111111111111,8,8,CCGGTCGCCACGCCGTGAAT,0,1081967
fldAp,0.1111111111111111,8,8,CCGGTATGTAAGGATACACA,0,1161552
fldAp,0.1111111111111111,8,8,CCGGTATCGGTGCACCTAGT,0,1093171
fldAp,0.1111111111111111,8,8,CCGGGGAAAGGATGTGCGTC,0,1068839
fldAp,0.1111111111111111,8,8,CCGGCTGCTCACGGGTGGAA,0,1085149
fldAp,0.1111111111111111,8,8,CCGGCTCACCTCAACTCGGA,0,1106209
fldAp,0.1111111111111111,8,8,CCGGCCCTCTAAACCTAGAA,0,1155935
fldAp,0.1111111111111111,8,8,CCGGATGTAAGGTTCTGAGG,0,1084713
fldAp,0.1111111111111111,8,8,CCGCGTTTCGTTTAACGTGA,0,1175691
fldAp,0.1111111111111111,8,8,CCGCGTCCGACAACTTGCGG,0,1093496
fldAp,0.1111111111111111,8,8,CCGCATACTTTCTCCGTAAC,0,1081680
fldAp,0.1111111111111111,8,8,CCGCATACTCGATCAAAGAT,0,1130356
fldAp,0.1111111111111111,8,8,CCGCATAACCCCGGGCAGTT,0,1149578
fldAp,0.1111111111111111,8,8,CCGCACCAAGTCACGCAGTA,0,1104692
fldAp,0.1111111111111111,8,8,CCGCAAGCATGAAAACAGCA,0,1085508
fldAp,0.1111111111111111,8,8,CCGATCTCCACACGAGGGAT,0,1180346
fldAp,0.1111111111111111,8,8,CCGATACGCCGGTTCCTTAG,0,1091610
fldAp,0.1111111111111111,8,8,CCGAACTTTGGAATAGTGAG,0,1119110
fldAp,0.1111111111111111,8,8,CCCTGTGCGTAACAGAGAAC,0,1160560
fldAp,0.1111111111111111,8,8,CCCTCACCTGTCGCAGTGTC,0,1183957
fldAp,0.1111111111111111,8,8,CCCTAACTTTAAGGCTGTGA,0,1151910
fldAp,0.1111111111111111,8,8,CCCGGGGGGTGCCCAGCTAG,0,1138659
fldAp,0.1111111111111111,8,8,CCCGCGGAACACCTGCGGAA,0,1074857
fldAp,0.1111111111111111,8,8,CCCGAGGCGTAGGGATACTT,0,1167879
fldAp,0.1111111111111111,8,8,CCCCTTACTATTAAGGTCAC,0,1117621
fldAp,0.1111111111111111,8,8,CCCCTGGTAAGGCAGTCGTC,0,1165673
fldAp,0.1111111111111111,8,8,CCCCGTCTTTCCGTGGACGT,0,1122281
fldAp,0.1111111111111111,8,8,CCCCGCTCCCGGTCGATATT,0,1123581
fldAp,0.1111111111111111,8,8,CCCCGCGCGATGCCACACAA,0,1181060
fldAp,0.1111111111111111,8,8,CCCATGTCTTGTGGGAGCAT,0,1170991
fldAp,0.1111111111111111,8,8,CCCATGGAAAATATTTGACG,0,1173955
fldAp,0.1111111111111111,8,8,CCCAGACACGGCTAAACTTT,0,1071238
fldAp,0.1111111111111111,8,8,CCCACCAATCTTTCATTCAC,0,1152965
fldAp,0.1111111111111111,8,8,CCCACAGACTGGTCCCGAGA,0,1131112
fldAp,0.1111111111111111,8,8,CCCAATGGGCTAGGCCCGCT,0,1130196
fldAp,0.1111111111111111,8,8,CCCAAACAGGTTAGTCGAGC,0,1184455
fldAp,0.1111111111111111,8,8,CCATGTAGTGTGGAGAACTG,0,1110517
fldAp,0.1111111111111111,8,8,CCATGGCGGAACATGGGCCA,0,1123480
fldAp,0.1111111111111111,8,8,CCATCTGTGACGGGGCAGGT,0,1144994
fldAp,0.1111111111111111,8,8,CCATACATACCGTGGACTGT,0,1125942
fldAp,0.1111111111111111,8,8,CCATAACCAGGGTCTTAGTG,0,1136570
fldAp,0.1111111111111111,8,8,CCAGGCGGCTTACATCAATA,0,1106795
fldAp,0.1111111111111111,8,8,CCAGCTGTTAACCACACACC,0,1071202
fldAp,0.1111111111111111,8,8,CCAGATGCTATGGGAACACT,0,1168284
fldAp,0.1111111111111111,8,8,CCACTTACTGACAACGACTA,0,1088597
fldAp,0.1111111111111111,8,8,CCACGACCGCGATCGCTATT,0,1087797
fldAp,0.1111111111111111,8,8,CCACCAGTGAAGTAAACTGG,0,1114749
fldAp,0.1111111111111111,8,8,CCACAACTACACTTGCTGGA,0,1145645
fldAp,0.1111111111111111,8,8,CCAATCGAATCGAACCGCGT,0,1180772
fldAp,0.1111111111111111,8,8,CCAATAAAGCATTGCCGTGA,0,1098081
fldAp,0.1111111111111111,8,8,CCAATAAAACCGATGGGAAA,0,1136829
fldAp,0.1111111111111111,8,8,CATTTCGTATGTGGATTGCA,0,1163191
fldAp,0.1111111111111111,8,8,CATTCCCCCTTGAATCATGG,0,1136903
fldAp,0.1111111111111111,8,8,CATTATGGCGCTCCGTAACT,0,1070429
fldAp,0.1111111111111111,8,8,CATTACTGGACACGCACACG,0,1071297
fldAp,0.1111111111111111,8,8,CATTACTATTCATCGTTAAT,0,1172537
fldAp,0.1111111111111111,8,8,CATGTGGCGCAACATTAGTC,0,1086692
fldAp,0.1111111111111111,8,8,CATGTATAATGAGGCGTCCG,0,1134748
fldAp,0.1111111111111111,8,8,CATGGTATTCGGGTAATACA,0,1065641
fldAp,0.1111111111111111,8,8,CATGCGTTCTGACTCCCAGT,0,1141554
fldAp,0.1111111111111111,8,8,CATGCCCGACAAGGCCATCC,0,1138995
fldAp,0.1111111111111111,8,8,CATGCAACGCAGGTTTAACT,0,1112794
fldAp,0.1111111111111111,8,8,CATGAGGGACATCAGAGTAT,0,1113500
fldAp,0.1111111111111111,8,8,CATGAGAAGCCAAGAAGTTG,0,1077647
fldAp,0.1111111111111111,8,8,CATGACCGACGCGGCCATAA,0,1171865
fldAp,0.1111111111111111,8,8,CATCTGTCGCTGGTGCGTTG,0,1185503
fldAp,0.1111111111111111,8,8,CATCTGGGGTGGCTGGAGGG,0,1106393
fldAp,0.1111111111111111,8,8,CATCTCACACCTCCAATGAA,0,1155064
fldAp,0.1111111111111111,8,8,CATCCGCTCCCTCCCGCCAG,0,1089583
fldAp,0.1111111111111111,8,8,CATCATAATGTCACGATCAC,0,1110849
fldAp,0.1111111111111111,8,8,CATCAGTGGGGAGATGGTTA,0,1102061
fldAp,0.1111111111111111,8,8,CATCAGGAGCCATATCACAC,0,1182360
fldAp,0.1111111111111111,8,8,CATCAAATGAGCAAAGCGGC,0,1144384
fldAp,0.1111111111111111,8,8,CATACGTCAGGGAAAGCTGC,0,1112697
fldAp,0.1111111111111111,8,8,CATACCAGGATGCAGCATCC,0,1161559
fldAp,0.1111111111111111,8,8,CAGTTGCGTGTTAAGTGATC,0,1161176
fldAp,0.1111111111111111,8,8,CAGTTCTTTTTGCCGACCCA,0,1108004
fldAp,0.1111111111111111,8,8,CAGTGGGCGTTGGAATTCAT,0,1168057
fldAp,0.1111111111111111,8,8,CAGTGCGGGCTTCTACTGTT,0,1069899
fldAp,0.1111111111111111,8,8,CAGTCCCGTCCTCATAGGGG,0,1074412
fldAp,0.1111111111111111,8,8,CAGGTCGGTCCCTGTTGTCT,0,1142935
fldAp,0.1111111111111111,8,8,CAGGGACACAATGGCGACCC,0,1108790
fldAp,0.1111111111111111,8,8,CAGGCTCGCAGGCTGGAATC,0,1097405
fldAp,0.1111111111111111,8,8,CAGGATGTAAAAGGAAGATT,0,1065224
fldAp,0.1111111111111111,8,8,CAGGAGCTCCGCAACACTGG,0,1090134
fldAp,0.1111111111111111,8,8,CAGCTTAGGGCACGACAATC,0,1121252
fldAp,0.1111111111111111,8,8,CAGCGGACGATTCGAGGCGA,0,1183665
fldAp,0.1111111111111111,8,8,CAGCGACAAGTGTTACGATA,0,1104412
fldAp,0.1111111111111111,8,8,CAGCAGGAGGCACGTAAAAA,0,1089062
fldAp,0.1111111111111111,8,8,CAGAGTAATTTGGCGTGCGA,0,1093693
fldAp,0.1111111111111111,8,8,CACTTCACCGCAAAACGAGC,0,1090024
fldAp,0.1111111111111111,8,8,CACTGGTTCGCCATCGAAGA,0,1145017
fldAp,0.1111111111111111,8,8,CACTCATCACGGGACCTGCA,0,1143193
fldAp,0.1111111111111111,8,8,CACTAGAGAGCTTCGACAGC,0,1106263
fldAp,0.1111111111111111,8,8,CACGTAGGCGGCGGCTTACG,0,1115649
fldAp,0.1111111111111111,8,8,CACGGTCCAGGCGAGAAAGT,0,1173589
fldAp,0.1111111111111111,8,8,CACGGCCATTAACGGACTGA,0,1134527
fldAp,0.1111111111111111,8,8,CACGGCACTTATTTGGGAGA,0,1168049
fldAp,0.1111111111111111,8,8,CACGCGGCTGGTGTTCTCGG,0,1119211
fldAp,0.1111111111111111,8,8,CACGAATGACATCATAAGTG,0,1114413
fldAp,0.1111111111111111,8,8,CACCTCCGTGAGTACAAGCT,0,1168220
fldAp,0.1111111111111111,8,8,CACCGCCCATCGACAGATCT,0,1137194
fldAp,0.1111111111111111,8,8,CACCGAATCCCAACTCCGGA,0,1150264
fldAp,0.1111111111111111,8,8,CACCCGGGGGTGCGATGCGT,0,1091341
fldAp,0.1111111111111111,8,8,CACATACCCCCGGTAGCAAG,0,1117726
fldAp,0.1111111111111111,8,8,CACAACGAGTGTTGCGATTA,0,1153746
fldAp,0.1111111111111111,8,8,CACAACAATAGAAGCGATCT,0,1081934
fldAp,0.1111111111111111,8,8,CAATTAGGGTCTGAACTACA,0,1156560
fldAp,0.1111111111111111,8,8,CAATGTTGGGAGGCTCATGC,0,1144672
fldAp,0.1111111111111111,8,8,CAATCCAATCCGGACTTGCT,0,1090062
fldAp,0.1111111111111111,8,8,CAATACTGGTGTTTACCGCT,0,1136759
fldAp,0.1111111111111111,8,8,CAATACTGCTCCGATAGGCA,0,1069613
fldAp,0.1111111111111111,8,8,CAATACCGGAAATAGTGCGA,0,1175953
fldAp,0.1111111111111111,8,8,CAATAAATTTAATGAAATCT,0,1148174
fldAp,0.1111111111111111,8,8,CAAGGGAAAGTCTTGGAAGG,0,1168948
fldAp,0.1111111111111111,8,8,CAAGGATCAACACTGAATTC,0,1071377
fldAp,0.1111111111111111,8,8,CAACTGCTTGTAAGTAACTC,0,1137755
fldAp,0.1111111111111111,8,8,CAACTGCGAGAACCGGCTTC,0,1173109
fldAp,0.1111111111111111,8,8,CAACTCGTTGGTATGTAACT,0,1138742
fldAp,0.1111111111111111,8,8,CAACGGTATCCATAAGCCAC,0,1085669
fldAp,0.1111111111111111,8,8,CAACGCAAGTTCACTCACGC,0,1122405
fldAp,0.1111111111111111,8,8,CAACAGAAGGCTAGGACGAA,0,1183608
fldAp,0.1111111111111111,8,8,CAAAGCCTTCAAGTTTCGGC,0,1106529
fldAp,0.1111111111111111,8,8,CAAACATCTATTGGTGATTG,0,1098064
fldAp,0.1111111111111111,8,8,ATTTTCCGGTGATCACAACG,0,1174741
fldAp,0.1111111111111111,8,8,ATTTAATATAGGAGCGTATT,0,1098293
fldAp,0.1111111111111111,8,8,ATTTAACGATAACTGGCTCA,0,1180765
fldAp,0.1111111111111111,8,8,ATTGTGTGACTATGTAGCCA,0,1182583
fldAp,0.1111111111111111,8,8,ATTGTACCGCCCTTTCTCCA,0,1136967
fldAp,0.1111111111111111,8,8,ATTGGGCGTCCGGACTTGCG,0,1178753
fldAp,0.1111111111111111,8,8,ATTGCGAATAATGCGGATTG,0,1096751
fldAp,0.1111111111111111,8,8,ATTGATGGTAGAGACTGTCT,0,1085770
fldAp,0.1111111111111111,8,8,ATTGAACAGTCACTTGGCCG,0,1172632
fldAp,0.1111111111111111,8,8,ATTCTGCCGTTGATCGTACA,0,1139459
fldAp,0.1111111111111111,8,8,ATTCGTACAGCGGCGGACCA,0,1074419
fldAp,0.1111111111111111,8,8,ATTCGGGGGCTTGACCTCGT,0,1077002
fldAp,0.1111111111111111,8,8,ATTCGCATGTCCACAAAGTA,0,1131967
fldAp,0.1111111111111111,8,8,ATTCGCAACCTACATCCAAT,0,1089434
fldAp,0.1111111111111111,8,8,ATTCCGTTGCCTAAAGGTGG,0,1162504
fldAp,0.1111111111111111,8,8,ATTCCGCCCCGAAAATAGTC,0,1122907
fldAp,0.1111111111111111,8,8,ATTCATCTCGGCGTTAGGCT,0,1150639
fldAp,0.1111111111111111,8,8,ATTCACTCACGGTACCGGCA,0,1138786
fldAp,0.1111111111111111,8,8,ATTCAAGTTGGATGAGTCTA,0,1158099
fldAp,0.1111111111111111,8,8,ATTCAAGGATAATTTAAGGG,0,1145526
fldAp,0.1111111111111111,8,8,ATTATGAGGGCCACGGGCAT,0,1179667
fldAp,0.1111111111111111,8,8,ATTATCCTTTCTTATTTAGT,0,1123462
fldAp,0.1111111111111111,8,8,ATTATAGGTATAGGGCACCC,0,1100460
fldAp,0.1111111111111111,8,8,ATTATAACCGAAAGACACAT,0,1074531
fldAp,0.1111111111111111,8,8,ATTAGTATAAAAAGGGCGTC,0,1085601
fldAp,0.1111111111111111,8,8,ATTACTTTCATGATACATAA,0,1175458
fldAp,0.1111111111111111,8,8,ATTAACCGCAACAAGGTCCA,0,1112144
fldAp,0.1111111111111111,8,8,ATTAAATGGCCTCCCACGTA,0,1157176
fldAp,0.1111111111111111,8,8,ATTAAAAATCATAAGAGCAA,0,1117152
fldAp,0.1111111111111111,8,8,ATGTTGGTCTGCTCCTCGAC,0,1098775
fldAp,0.1111111111111111,8,8,ATGTTCCATCTTGAAGAGCC,0,1104194
fldAp,0.1111111111111111,8,8,ATGTTAAACCAACCTCGGTT,0,1066417
fldAp,0.1111111111111111,8,8,ATGTAGGTTGTATGGTAAAT,0,1064636
fldAp,0.1111111111111111,8,8,ATGGTGGGAGCTGGTAAAAC,0,1117699
fldAp,0.1111111111111111,8,8,ATGGTCACTCTGGTCCCCCA,0,1115488
fldAp,0.1111111111111111,8,8,ATGGGTGCCAGCTGCTGAAC,0,1175398
fldAp,0.1111111111111111,8,8,ATGGGGCACATGATGAGATA,0,1177590
fldAp,0.1111111111111111,8,8,ATGGGAGGACCGCGACAAAT,0,1104636
fldAp,0.1111111111111111,8,8,ATGGATGCATCCTGATTCCA,0,1139415
fldAp,0.1111111111111111,8,8,ATGGAGCGCCCCACAAGGTC,0,1100320
fldAp,0.1111111111111111,8,8,ATGCTTTTCTTTCAGGGTTT,0,1090296
fldAp,0.1111111111111111,8,8,ATGCTCTGTCTGGTAAGTAT,0,1163864
fldAp,0.1111111111111111,8,8,ATGCTAAGGACCGGGTCCGT,0,1119859
fldAp,0.1111111111111111,8,8,ATGCCTTATCGCGCTTGTAG,0,1075201
fldAp,0.1111111111111111,8,8,ATGCCGAATTTAATAACAAG,0,1167048
fldAp,0.1111111111111111,8,8,ATGCACTCCACCTTGTCGAG,0,1137031
fldAp,0.1111111111111111,8,8,ATGCACGCGAAAGGTGATCT,0,1184595
fldAp,0.1111111111111111,8,8,ATGATTGGATGGCAGTTCTC,0,1141065
fldAp,0.1111111111111111,8,8,ATGATGGTATCACCAGTAAG,0,1100651
fldAp,0.1111111111111111,8,8,ATGAGGTAAACTTGGTCCGA,0,1097596
fldAp,0.1111111111111111,8,8,ATGACCATGTTCATTGCGTC,0,1158644
fldAp,0.1111111111111111,8,8,ATGAAGCTAGCGAGTTTCTC,0,1162539
fldAp,0.1111111111111111,8,8,ATGAAATTTTCTGGCCTATC,0,1148105
fldAp,0.1111111111111111,8,8,ATGAAATCCAGGTGCCAGGT,0,1118068
fldAp,0.1111111111111111,8,8,ATCTGCTCCGCCTGGGTAAG,0,1173400
fldAp,0.1111111111111111,8,8,ATCTGCTATGTGGGACAGTG,0,1157624
fldAp,0.1111111111111111,8,8,ATCTACGCGTCGGTTTAGAC,0,1109281
fldAp,0.1111111111111111,8,8,ATCTAAGTTGGTTGGTATTT,0,1120943
fldAp,0.1111111111111111,8,8,ATCGTTTTCGCAAGTTGGTA,0,1097305
fldAp,0.1111111111111111,8,8,ATCGGGAAGAATGCATTCTT,0,1150538
fldAp,0.1111111111111111,8,8,ATCGCTATTTACAAGGAAAT,0,1108291
fldAp,0.1111111111111111,8,8,ATCGCCATTTCATACTGTTA,0,1090258
fldAp,0.1111111111111111,8,8,ATCGACGTCAAACGTGCTCA,0,1174795
fldAp,0.1111111111111111,8,8,ATCGACAAGACAACCGGACA,0,1070829
fldAp,0.1111111111111111,8,8,ATCCGGCTATGGTTTGATGC,0,1122610
fldAp,0.1111111111111111,8,8,ATCCCGTCGGGGAACATCAC,0,1168082
fldAp,0.1111111111111111,8,8,ATCCACGTGGAGCGGTCGAC,0,1118746
fldAp,0.1111111111111111,8,8,ATCACCCATACATTGTATAA,0,1136584
fldAp,0.1111111111111111,8,8,ATCAATATCCCTAAGGGGCT,0,1141607
fldAp,0.1111111111111111,8,8,ATCAACTTGGGTGTTATGCG,0,1136594
fldAp,0.1111111111111111,8,8,ATATTTAAGCTGAGTTCTCT,0,1162280
fldAp,0.1111111111111111,8,8,ATATGCACGTACGTTTTGAA,0,1181957
fldAp,0.1111111111111111,8,8,ATATCACGTAAGACCAAAGG,0,1093565
fldAp,0.1111111111111111,8,8,ATATATGGCCCATGTCCTGA,0,1066551
fldAp,0.1111111111111111,8,8,ATATAGGATTAAGTATGTGT,0,1070937
fldAp,0.1111111111111111,8,8,ATAGTAATCAGCTAGCTGGT,0,1138946
fldAp,0.1111111111111111,8,8,ATAGGTCTTTTGAGAGGTGT,0,1105591
fldAp,0.1111111111111111,8,8,ATAGGATTGGAACGATAATG,0,1128977
fldAp,0.1111111111111111,8,8,ATAGCCGGTGAAGATACTTA,0,1074885
fldAp,0.1111111111111111,8,8,ATAGCAGGCGGATCTCCACT,0,1139950
fldAp,0.1111111111111111,8,8,ATAGACGTCTTGGAAAGAAG,0,1162763
fldAp,0.1111111111111111,8,8,ATACTGTATAGGCGGGCCGG,0,1123763
fldAp,0.1111111111111111,8,8,ATACGTGAGCGACGGAGGGT,0,1183961
fldAp,0.1111111111111111,8,8,ATACCCCTATAAGATATGAT,0,1112132
fldAp,0.1111111111111111,8,8,ATACATACTGCGAAGTGATT,0,1087479
fldAp,0.1111111111111111,8,8,ATACAGAGACTACCGAGACA,0,1118953
fldAp,0.1111111111111111,8,8,ATAATTAACGGGATCTGGGC,0,1121383
fldAp,0.1111111111111111,8,8,ATAAATGAGTTTAAAAGTGA,0,1072972
fldAp,0.1111111111111111,8,8,ATAAACGGAAGAACGCAAGC,0,1096984
fldAp,0.1111111111111111,8,8,ATAAACAGGATGGCGTCTGT,0,1069401
fldAp,0.1111111111111111,8,8,AGTTTTAAACTCCAGACTGT,0,1068475
fldAp,0.1111111111111111,8,8,AGTTCGCCCAGTCAGGAGGA,0,1180185
fldAp,0.1111111111111111,8,8,AGTTCAAGTGTGTCAGGGTT,0,1080490
fldAp,0.1111111111111111,8,8,AGTTATGCATTTTTCCGATG,0,1141152
fldAp,0.1111111111111111,8,8,AGTGTTAGAATTCACGTTTG,0,1102239
fldAp,0.1111111111111111,8,8,AGTGTCCACAGGTATTCTAG,0,1077223
fldAp,0.1111111111111111,8,8,AGTGGCCTCGGATATCTATC,0,1090717
fldAp,0.1111111111111111,8,8,AGTGGAGGATGAAAACGTAG,0,1181071
fldAp,0.1111111111111111,8,8,AGTGCCTAGAGATGTGTAAG,0,1180169
fldAp,0.1111111111111111,8,8,AGTGCACTGTATCGCTCTTA,0,1155978
fldAp,0.1111111111111111,8,8,AGTCTTATGCAGCGTTGCAG,0,1147927
fldAp,0.1111111111111111,8,8,AGTCCATCTGCGATTAGTCA,0,1074389
fldAp,0.1111111111111111,8,8,AGTAGTCCGCGCGTCCGGGT,0,1113510
fldAp,0.1111111111111111,8,8,AGTAGAATGCAAAATGGGCT,0,1104875
fldAp,0.1111111111111111,8,8,AGTAGAATATAACATCCGCC,0,1077276
fldAp,0.1111111111111111,8,8,AGGTGGGCTGCCCGTGATGT,0,1064213
fldAp,0.1111111111111111,8,8,AGGTGGCCCAACGCACATCG,0,1102060
fldAp,0.1111111111111111,8,8,AGGTGGAGGGTAGGTGTTCT,0,1164707
fldAp,0.1111111111111111,8,8,AGGTGACGTCTCATGGCCAT,0,1124691
fldAp,0.1111111111111111,8,8,AGGTCCACCGTGATCACGGC,0,1098739
fldAp,0.1111111111111111,8,8,AGGTATTTCATTGGCTGAGC,0,1105414
fldAp,0.1111111111111111,8,8,AGGTAGGGAAGTCCCAAGTA,0,1094322
fldAp,0.1111111111111111,8,8,AGGGTCTCCCTCTCCGCAGT,0,1121335
fldAp,0.1111111111111111,8,8,AGGGGGATGCACGAATGACA,0,1084382
fldAp,0.1111111111111111,8,8,AGGGCAGAGGACTTCGTTTG,0,1114136
fldAp,0.1111111111111111,8,8,AGGGATCATAGGCGTCTGGT,0,1145641
fldAp,0.1111111111111111,8,8,AGGCAATTCGCCCTCAAGCG,0,1067770
fldAp,0.1111111111111111,8,8,AGGATGAAAGGGCATATCAT,0,1171348
fldAp,0.1111111111111111,8,8,AGGAGAATACTTTTGATGCT,0,1119486
fldAp,0.1111111111111111,8,8,AGGACGGCGTGAATAGATCC,0,1067179
fldAp,0.1111111111111111,8,8,AGGACCTTGCAGGCCGCGGT,0,1140961
fldAp,0.1111111111111111,8,8,AGGACCGGCGTACAACGTAT,0,1081532
fldAp,0.1111111111111111,8,8,AGGAAAGCTCGCAAAGTCGT,0,1063153
fldAp,0.1111111111111111,8,8,AGCTTGGTTTCGTGGAGCAG,0,1096125
fldAp,0.1111111111111111,8,8,AGCTTGCAATGGGCACAACG,0,1175960
fldAp,0.1111111111111111,8,8,AGCTGCGGTCAACTTCCAGG,0,1181171
fldAp,0.1111111111111111,8,8,AGCTCTGTGGGTGTGATCCG,0,1073920
fldAp,0.1111111111111111,8,8,AGCTACTTAGGTACTTCCAG,0,1144590
fldAp,0.1111111111111111,8,8,AGCGTCCCCTTATCGTAGGT,0,1162680
fldAp,0.1111111111111111,8,8,AGCGCCTACGAAGCCTACCA,0,1133487
fldAp,0.1111111111111111,8,8,AGCGAGTTAATGACGGTGGA,0,1127568
fldAp,0.1111111111111111,8,8,AGCCTAGGGTACGTGCATAT,0,1073516
fldAp,0.1111111111111111,8,8,AGCCTACTACTACTTAGTCA,0,1077313
fldAp,0.1111111111111111,8,8,AGCCATGCCATTTGGTGCAT,0,1184417
fldAp,0.1111111111111111,8,8,AGCATTATGCTCACCGGAGG,0,1104411
fldAp,0.1111111111111111,8,8,AGCACTTACGATGGATACTG,0,1098413
fldAp,0.1111111111111111,8,8,AGCACGGATAGAAATCAACT,0,1131003
fldAp,0.1111111111111111,8,8,AGCACAATCAAGGGTGGTTG,0,1080984
fldAp,0.1111111111111111,8,8,AGATTTAGTTGCTAAGAGTT,0,1091966
fldAp,0.1111111111111111,8,8,AGATTGTCGCTGCGTGCGTA,0,1116247
fldAp,0.1111111111111111,8,8,AGATTGTCACTGTGAAAGAC,0,1135247
fldAp,0.1111111111111111,8,8,AGATTATCAAGCTTGGTCTA,0,1079924
fldAp,0.1111111111111111,8,8,AGATGGAATTATGCTCAAGT,0,1174728
fldAp,0.1111111111111111,8,8,AGATCGTCGTTGCGTTTTTA,0,1126394
fldAp,0.1111111111111111,8,8,AGATCGTCCCCCTGCGAGTT,0,1129931
fldAp,0.1111111111111111,8,8,AGATCATGGCGCTTCCATAG,0,1079404
fldAp,0.1111111111111111,8,8,AGATAGTCTAAGTGTATGCT,0,1099886
fldAp,0.1111111111111111,8,8,AGATAGCAGGGTATCGTCCT,0,1066960
fldAp,0.1111111111111111,8,8,AGATAAGGTGCAGCCAGTTC,0,1153557
fldAp,0.1111111111111111,8,8,AGAGCTGCCGCGCTCGTTGC,0,1068840
fldAp,0.1111111111111111,8,8,AGAGCGTTTTCCCTCTATCA,0,1102619
fldAp,0.1111111111111111,8,8,AGAGCATCCGTTATGGGCGA,0,1175345
fldAp,0.1111111111111111,8,8,AGAGAAAGAGGCGTAAGGTG,0,1156725
fldAp,0.1111111111111111,8,8,AGACTTATCCCGCTCCAGAC,0,1087591
fldAp,0.1111111111111111,8,8,AGACTGCTGCGATCGCGGAC,0,1186416
fldAp,0.1111111111111111,8,8,AGACGTACGGTGAAGGAATT,0,1082315
fldAp,0.1111111111111111,8,8,AGACGCAATCTCATGCAGAG,0,1171429
fldAp,0.1111111111111111,8,8,AGACAAATAACAGATTCGAG,0,1079355
fldAp,0.1111111111111111,8,8,AGAATACTGATACGCAAAGA,0,1099839
fldAp,0.1111111111111111,8,8,AGAATACTGAAACCTACCGT,0,1180023
fldAp,0.1111111111111111,8,8,AGAAGTTCCATCGGCTACAT,0,1141037
fldAp,0.1111111111111111,8,8,AGAAGCAAGTCCTCAGGTCC,0,1160960
fldAp,0.1111111111111111,8,8,AGAACCCGCTAGTAAAGGCA,0,1132761
fldAp,0.1111111111111111,8,8,AGAACACCCAATCACCGTAA,0,1122600
fldAp,0.1111111111111111,8,8,AGAAATGACAGCCCCCGGAC,0,1135020
fldAp,0.1111111111111111,8,8,AGAAACTTCCAGTGCGCGGT,0,1154232
fldAp,0.1111111111111111,8,8,ACTTTTGACCACCGGAACTT,0,1082078
fldAp,0.1111111111111111,8,8,ACTTTCTTGGTAGTCGATCA,0,1132323
fldAp,0.1111111111111111,8,8,ACTTGCTCCATAATACGTCA,0,1113884
fldAp,0.1111111111111111,8,8,ACTTCCAGGTGGATGTCGTG,0,1071864
fldAp,0.1111111111111111,8,8,ACTTACTATTGTTGGAGTGT,0,1167061
fldAp,0.1111111111111111,8,8,ACTGCCTGCTGTGCCCCGCC,0,1144229
fldAp,0.1111111111111111,8,8,ACTCTTAGTGCCCGACTAGG,0,1175169
fldAp,0.1111111111111111,8,8,ACTCTGGACTAGGACGGGCT,0,1094809
fldAp,0.1111111111111111,8,8,ACTCGGCATGTGAGTCAAGG,0,1139211
fldAp,0.1111111111111111,8,8,ACTAGATTCATAGCAAGTTC,0,1137549
fldAp,0.1111111111111111,8,8,ACTAGATGGCGGTGATGGCA,0,1141527
fldAp,0.1111111111111111,8,8,ACTAGAGATTGCCTTTCATC,0,1150762
fldAp,0.1111111111111111,8,8,ACGTGCAGCCTAAGGCAGAC,0,1115211
fldAp,0.1111111111111111,8,8,ACGTGACACCTGGTTAACGG,0,1177993
fldAp,0.1111111111111111,8,8,ACGGTTAATTTATGGACAAA,0,1067607
fldAp,0.1111111111111111,8,8,ACGGTCGTACACCGACAGCT,0,1066825
fldAp,0.1111111111111111,8,8,ACGGGTAGCATCCCAGTCAG,0,1070132
fldAp,0.1111111111111111,8,8,ACGGGTACAAGACTACGATA,0,1120778
fldAp,0.1111111111111111,8,8,ACGGGGCGAGCAAACAGGGT,0,1094360
fldAp,0.1111111111111111,8,8,ACGGAAGCATGAGCGTCGCC,0,1185457
fldAp,0.1111111111111111,8,8,ACGCTTGTTATGGAAACAAT,0,1098401
fldAp,0.1111111111111111,8,8,ACGCAGTCCCGGACAACTGT,0,1091876
fldAp,0.1111111111111111,8,8,ACGACCTAGTGAGTAATTAA,0,1125598
fldAp,0.1111111111111111,8,8,ACGACCATCGATAAATGGAC,0,1092743
fldAp,0.1111111111111111,8,8,ACGAATTGTCCGAGGGATAT,0,1170104
fldAp,0.1111111111111111,8,8,ACCTAGTGGTGACCGCACGG,0,1067684
fldAp,0.1111111111111111,8,8,ACCTAGAGATCCGCGCGAGG,0,1080663
fldAp,0.1111111111111111,8,8,ACCGTTTAACGTCCCTGTCG,0,1138032
fldAp,0.1111111111111111,8,8,ACCGTGTCCTATATAGAAGT,0,1090975
fldAp,0.1111111111111111,8,8,ACCGTCCCTGCGCATACGCA,0,1070597
fldAp,0.1111111111111111,8,8,ACCGGGTGGTACTCTTGTGA,0,1082527
fldAp,0.1111111111111111,8,8,ACCGGACAAGGCGGGTTTGA,0,1100496
fldAp,0.1111111111111111,8,8,ACCGCATGGTATTACAGTAT,0,1074359
fldAp,0.1111111111111111,8,8,ACCCTGGATGTCCCTACGAC,0,1084310
fldAp,0.1111111111111111,8,8,ACCCGCCAGGTTCGTCGGCC,0,1171368
fldAp,0.1111111111111111,8,8,ACCCACGACTAAACGTTTCG,0,1163823
fldAp,0.1111111111111111,8,8,ACCAGACGAGAGTTCAACGG,0,1115989
fldAp,0.1111111111111111,8,8,ACCACAGGAGAGGGCGGGAT,0,1185018
fldAp,0.1111111111111111,8,8,ACCACACTTAAAATAGGAGA,0,1134531
fldAp,0.1111111111111111,8,8,ACCAATAGCTTAGCCCATCG,0,1157741
fldAp,0.1111111111111111,8,8,ACATTCTGGGATATAATAAA,0,1111647
fldAp,0.1111111111111111,8,8,ACATTCAGTCCCGGGCCGCA,0,1175268
fldAp,0.1111111111111111,8,8,ACATTATAGAGGTTCTCAGG,0,1115287
fldAp,0.1111111111111111,8,8,ACATGCCCTCGGGCGTCAAC,0,1177062
fldAp,0.1111111111111111,8,8,ACATCCTATCCCCACTTTTC,0,1089048
fldAp,0.1111111111111111,8,8,ACATAGTCATTATTTAGCTT,0,1139458
fldAp,0.1111111111111111,8,8,ACATACACCTCAGGCCTGTG,0,1084058
fldAp,0.1111111111111111,8,8,ACAGTCCCGTGTGGTACCTG,0,1150734
fldAp,0.1111111111111111,8,8,ACAGTATTTTTGTCCATCTA,0,1064740
fldAp,0.1111111111111111,8,8,ACAGGGTAACAATTACGGGT,0,1110709
fldAp,0.1111111111111111,8,8,ACAGGGATCAGCTCTGTTGT,0,1134306
fldAp,0.1111111111111111,8,8,ACAGATCAGTTGTTCTTGGT,0,1165224
fldAp,0.1111111111111111,8,8,ACAGAGAACCCAGGAAAGAC,0,1174408
fldAp,0.1111111111111111,8,8,ACACCCAGCAGATAAATGGC,0,1100044
fldAp,0.1111111111111111,8,8,ACAATACCTCACGTCAAACT,0,1148495
fldAp,0.1111111111111111,8,8,ACAAGGGATTTATATGTCTC,0,1164939
fldAp,0.1111111111111111,8,8,AATTGCACCCAGGTAGTCAG,0,1072991
fldAp,0.1111111111111111,8,8,AATTCAGATATGGAAAAGCA,0,1179737
fldAp,0.1111111111111111,8,8,AATTACATGCCAGGGGCACC,0,1139559
fldAp,0.1111111111111111,8,8,AATGTACCCAACCCGTCTGA,0,1172988
fldAp,0.1111111111111111,8,8,AATGCTCTTTGCCAACGTAA,0,1103530
fldAp,0.1111111111111111,8,8,AATGCATAGTTGCGGTTCCC,0,1138429
fldAp,0.1111111111111111,8,8,AATGCAGTCTTGACGTTGAC,0,1131510
fldAp,0.1111111111111111,8,8,AATCGTTAGGAACCAGTGAG,0,1129447
fldAp,0.1111111111111111,8,8,AATCGTCCTACATGCGGGCA,0,1128772
fldAp,0.1111111111111111,8,8,AATCGCTGAATGATTCTGTA,0,1186685
fldAp,0.1111111111111111,8,8,AATCATGAAAGACACCGTAG,0,1180327
fldAp,0.1111111111111111,8,8,AATCAGTACCTGAGTTCGAG,0,1111479
fldAp,0.1111111111111111,8,8,AATCAGATAATCCGTCTATG,0,1077510
fldAp,0.1111111111111111,8,8,AATATACCACGAATCCATGG,0,1077465
fldAp,0.1111111111111111,8,8,AATAGTACAGACGCAGTATC,0,1099010
fldAp,0.1111111111111111,8,8,AATAGGGGCGCACTAACCAA,0,1109172
fldAp,0.1111111111111111,8,8,AATAGGCTATGCGAGCCCGT,0,1069686
fldAp,0.1111111111111111,8,8,AAGTTAGTTCAGTGCCAGTG,0,1169716
fldAp,0.1111111111111111,8,8,AAGTGTTCGTGATCGGGTGT,0,1087500
fldAp,0.1111111111111111,8,8,AAGTGTGGGCACCTATTCTA,0,1082392
fldAp,0.1111111111111111,8,8,AAGTCATAATTCGCCGTAGA,0,1152159
fldAp,0.1111111111111111,8,8,AAGTAGGCGCTAGTGACTAT,0,1159055
fldAp,0.1111111111111111,8,8,AAGTACTATACAGTCGGAAG,0,1087452
fldAp,0.1111111111111111,8,8,AAGGTGGGGGGGTTCTCCTT,0,1168937
fldAp,0.1111111111111111,8,8,AAGGGTCGATCGAGGTGACT,0,1131508
fldAp,0.1111111111111111,8,8,AAGGGCTTCGACTGGACAAG,0,1148081
fldAp,0.1111111111111111,8,8,AAGCTGGTCAAGGTTTTCTT,0,1101384
fldAp,0.1111111111111111,8,8,AAGCTATTCTGTTCGACGAA,0,1067008
fldAp,0.1111111111111111,8,8,AAGATAGCCATCCATAGTCA,0,1132979
fldAp,0.1111111111111111,8,8,AAGACCGCTGGCTCGCTCTA,0,1129656
fldAp,0.1111111111111111,8,8,AAGAATTGGCTAGAGCGATG,0,1144937
fldAp,0.1111111111111111,8,8,AAGAACGCGGTTTCATGTGA,0,1081718
fldAp,0.1111111111111111,8,8,AAGAAAGCCTCCTTAATGGT,0,1079489
fldAp,0.1111111111111111,8,8,AACTCGTGTACCAGCCAGTG,0,1131556
fldAp,0.1111111111111111,8,8,AACTCCGACCTGGGTCAAGA,0,1129101
fldAp,0.1111111111111111,8,8,AACTCAGTACGCCCTTTAGA,0,1114755
fldAp,0.1111111111111111,8,8,AACTATGGTCTAGACGGCCC,0,1071784
fldAp,0.1111111111111111,8,8,AACGTAGGAGCTTTTCATCA,0,1079457
fldAp,0.1111111111111111,8,8,AACGCGGTTAATTGTATCAT,0,1146755
fldAp,0.1111111111111111,8,8,AACGATCGTCCCCGTGTAAA,0,1068259
fldAp,0.1111111111111111,8,8,AACCTTAGTCCAAAGGATGT,0,1121714
fldAp,0.1111111111111111,8,8,AACCTTAACAGATGGCTGTG,0,1082200
fldAp,0.1111111111111111,8,8,AACCCATCCACACACAGTAG,0,1148868
fldAp,0.1111111111111111,8,8,AACCCAGAATAGGTTCATAT,0,1186272
fldAp,0.1111111111111111,8,8,AACCAACAATGAGTGTAAGA,0,1104192
fldAp,0.1111111111111111,8,8,AACATCCCGACTGGAATAAT,0,1071396
fldAp,0.1111111111111111,8,8,AACATAGTACGCGATATGGT,0,1072659
fldAp,0.1111111111111111,8,8,AAATTTCCCAATTAACAACG,0,1178547
fldAp,0.1111111111111111,8,8,AAATGTGGACCGGTGTATCC,0,1093705
fldAp,0.1111111111111111,8,8,AAATGGGTCAAACTGTCGGT,0,1107444
fldAp,0.1111111111111111,8,8,AAATGAGGCAGGCACCGGTA,0,1165699
fldAp,0.1111111111111111,8,8,AAATCGTTATTCCCCATCGC,0,1135217
fldAp,0.1111111111111111,8,8,AAATCCATGGATGGGCGAGC,0,1112803
fldAp,0.1111111111111111,8,8,AAAGGGTGTCAGAATTAGTC,0,1070400
fldAp,0.1111111111111111,8,8,AAAGCTGAACGATTCACTCA,0,1172107
fldAp,0.1111111111111111,8,8,AAAGCCCTAACGAAGGCCCA,0,1172182
fldAp,0.1111111111111111,8,8,AAACGCGGACAAATTTCGAG,0,1161684
fldAp,0.1111111111111111,8,8,AAACGCAAAATCGAGGTTTC,0,1177221
fldAp,0.1111111111111111,8,8,AAACCTTTGTCAGCGCAGAC,0,1073657
fldAp,0.1111111111111111,8,8,AAACAGTACAACTTGGCTGG,0,1119751
fldAp,0.1111111111111111,8,8,AAAATTCGGTGGCTGATTCG,0,1112207
fldAp,0.1111111111111111,8,8,AAAATGCTGTACTCTCAGAA,0,1071879
fldAp,0.1111111111111111,8,8,AAAAGTCCGAATGTGTGTAA,0,1140322
fldAp,0.1111111111111111,8,8,AAAAGCAAGCATGTGGGGTT,0,1121772
fldAp,0.1111111111111111,8,8,AAAAGACGGACGCAGCCTTC,0,1084191
fldAp,0.1111111111111111,8,8,AAAACGTGTGCTATCCCTTT,0,1158897
fldAp,0.125,7,7,TTTTTTTGAGGTTTTCATAT,0,1132807
fldAp,0.125,7,7,TTTTTTACTTGTAACGGATC,0,1095988
fldAp,0.125,7,7,TTTTTCCGTGTGCATTCCTG,0,1173328
fldAp,0.125,7,7,TTTTGCAAGCGACCGAGTTG,0,1137634
fldAp,0.125,7,7,TTTTCCTTAACCTCGGACAG,0,1103575
fldAp,0.125,7,7,TTTTAGCATACCTCCTAGCA,0,1185019
fldAp,0.125,7,7,TTTGTCTAACCAAAATCTTC,0,1186172
fldAp,0.125,7,7,TTTGGTCCACCAGATTACAT,0,1089737
fldAp,0.125,7,7,TTTGGAACGGTATTTTAATC,0,1095133
fldAp,0.125,7,7,TTTGCATTTGGTAGCCAGGT,0,1072833
fldAp,0.125,7,7,TTTCTTTCCGGTGTCACTGA,0,1077001
fldAp,0.125,7,7,TTTCTAGTAACCCACCCGTT,0,1178048
fldAp,0.125,7,7,TTTCGCTCTACAATCTATCT,0,1122814
fldAp,0.125,7,7,TTTCCTTCAAGTGAGATACG,0,1073531
fldAp,0.125,7,7,TTTCCTAGGATAGGGATGCA,0,1159128
fldAp,0.125,7,7,TTTCCTACATTAGCTCAGAT,0,1152650
fldAp,0.125,7,7,TTTAGCAGTGATTATAAAGA,0,1093431
fldAp,0.125,7,7,TTTACGTGCTCCTGGCTTGT,0,1082689
fldAp,0.125,7,7,TTGTTCCTTATGGTGACAAA,0,1129983
fldAp,0.125,7,7,TTGTGGACCGGACCCGGCAA,0,1069943
fldAp,0.125,7,7,TTGTCGGGTACATAAGTTCC,0,1116687
fldAp,0.125,7,7,TTGTCCGCATCAGATGCTAT,0,1102229
fldAp,0.125,7,7,TTGGTTGGGGCCTCGAATAC,0,1072578
fldAp,0.125,7,7,TTGGTAAACTTCAGTATGTT,0,1172576
fldAp,0.125,7,7,TTGGAGCATATTACAGCCCT,0,1081127
fldAp,0.125,7,7,TTGGACATGCCGTGGCCCCC,0,1106147
fldAp,0.125,7,7,TTGGAACCCCTGCGTGTGAG,0,1120136
fldAp,0.125,7,7,TTGGAAACTGTTCGTCTTAC,0,1077449
fldAp,0.125,7,7,TTGCGTGCCAATCATTCTTA,0,1167096
fldAp,0.125,7,7,TTGCCTGTCTACCCGCATGC,0,1131942
fldAp,0.125,7,7,TTGCAGTAGGGTGTACGCAG,0,1147349
fldAp,0.125,7,7,TTGATACCAAGGCACGGAGT,0,1097604
fldAp,0.125,7,7,TTGACCCAGTATTAAGAAGC,0,1090035
fldAp,0.125,7,7,TTGACATTCTTACTCACGAA,0,1071904
fldAp,0.125,7,7,TTCTTCGTAGTAATAGGAAA,0,1120275
fldAp,0.125,7,7,TTCTGCCTTCAGGAAGACGA,0,1129269
fldAp,0.125,7,7,TTCTCTCCGAAAGGATAGTG,0,1113583
fldAp,0.125,7,7,TTCTCGACAATATCACACAC,0,1154850
fldAp,0.125,7,7,TTCTACTACTGTGTAGGTCA,0,1162642
fldAp,0.125,7,7,TTCGTGTTTAGGAAGTGTTA,0,1085781
fldAp,0.125,7,7,TTCGTAGAGGGTGCTGCACT,0,1088725
fldAp,0.125,7,7,TTCGGTTTCTCAACCTGCAG,0,1098303
fldAp,0.125,7,7,TTCGGGAAGAGACGTGAGTA,0,1086850
fldAp,0.125,7,7,TTCGCTCAGAGAAGCGGGTT,0,1162047
fldAp,0.125,7,7,TTCGCAGAAAGAGTCGCAAG,0,1161446
fldAp,0.125,7,7,TTCGATAGGAACAAGAGCTA,0,1173874
fldAp,0.125,7,7,TTCCTGCTGGCACACAGTAT,0,1142577
fldAp,0.125,7,7,TTCCGGGCAGGCCTCAGCTC,0,1138758
fldAp,0.125,7,7,TTCCCAGTATAACGACTTAC,0,1151400
fldAp,0.125,7,7,TTCCATTCCGGCTGCTAACA,0,1184730
fldAp,0.125,7,7,TTCCATCATAGTTTTTAGGA,0,1087373
fldAp,0.125,7,7,TTCCAAGTGTGGCCTCGGAG,0,1085064
fldAp,0.125,7,7,TTCCAACCGTTAGGCCAGCT,0,1067214
fldAp,0.125,7,7,TTCATGTCATTAACTGATTG,0,1110876
fldAp,0.125,7,7,TTCATCCGGGCCACAGTGCG,0,1093067
fldAp,0.125,7,7,TTCACTGCCGCTATAACTAA,0,1110520
fldAp,0.125,7,7,TTCACGGATAATGCTCAGAG,0,1096679
fldAp,0.125,7,7,TTCACGCATGTGCTCTTAAG,0,1164563
fldAp,0.125,7,7,TTATGTTACGGACATATGGG,0,1080958
fldAp,0.125,7,7,TTATAGGCGGAAGGTTACCG,0,1180457
fldAp,0.125,7,7,TTAGTGCAGGTTGTTTCTGC,0,1071740
fldAp,0.125,7,7,TTAGGTCAGTGTCGTGGCCT,0,1121839
fldAp,0.125,7,7,TTAGGGGACCTCATTTAAAT,0,1119054
fldAp,0.125,7,7,TTAGGGATTACGTACCCCTG,0,1152220
fldAp,0.125,7,7,TTAGGCACTTGTTTTAGATC,0,1088090
fldAp,0.125,7,7,TTAGCTGCCCTCTTACAATT,0,1066294
fldAp,0.125,7,7,TTAGATATTGTTATTGTGTG,0,1116310
fldAp,0.125,7,7,TTAGACATTCCACTTTAGAT,0,1165401
fldAp,0.125,7,7,TTACGGACTTTGGACGCTAC,0,1095781
fldAp,0.125,7,7,TTACCCCAAGAATCTGTAGG,0,1146897
fldAp,0.125,7,7,TTAAGCACAGAAACGGGGCA,0,1076429
fldAp,0.125,7,7,TTAAGATATCCACGAATCTA,0,1120768
fldAp,0.125,7,7,TTAACGAATCACAGGGGGTG,0,1153216
fldAp,0.125,7,7,TTAACAACCCTCCGCCTCTG,0,1081043
fldAp,0.125,7,7,TTAAACCGCTCAAGCCTATC,0,1145887
fldAp,0.125,7,7,TGTTGTCTGTTCTTATTGGT,0,1123299
fldAp,0.125,7,7,TGTTGCGGACCTGGGAAGCC,0,1148938
fldAp,0.125,7,7,TGTTCGGGAATGTCTAAAGG,0,1069979
fldAp,0.125,7,7,TGTTATCTCGTGTCTCGGCT,0,1133519
fldAp,0.125,7,7,TGTTAGCGTAAGCGGCCGTT,0,1086788
fldAp,0.125,7,7,TGTTAGACTCCGGCACAATG,0,1067198
fldAp,0.125,7,7,TGTTAACCATACTTTTTCGA,0,1173316
fldAp,0.125,7,7,TGTGTAACGACATCGAGCTC,0,1141735
fldAp,0.125,7,7,TGTGATGTCGAGCTCAATCG,0,1118008
fldAp,0.125,7,7,TGTCGTTCGGGCGCTCTAGC,0,1162724
fldAp,0.125,7,7,TGTCAATCCACTCGGAGCAT,0,1163102
fldAp,0.125,7,7,TGTATGCCAGAAGCCTTAGC,0,1161370
fldAp,0.125,7,7,TGTATGATGAATAGCGGTCA,0,1156553
fldAp,0.125,7,7,TGTAGTTGCGTGAAGTCAGT,0,1148988
fldAp,0.125,7,7,TGTAGTCCCATTCAAGGGCA,0,1064570
fldAp,0.125,7,7,TGTACTGTTACGGTTAACAG,0,1166644
fldAp,0.125,7,7,TGTACGCGTGTCATCCGATA,0,1154638
fldAp,0.125,7,7,TGTAAGGTGATGATGATGAT,0,1172112
fldAp,0.125,7,7,TGTAAAACGGATGCGAGGAG,0,1093066
fldAp,0.125,7,7,TGGTTCCCCGAACCATCATC,0,1167828
fldAp,0.125,7,7,TGGTAGTCCACGTGACCTTT,0,1132404
fldAp,0.125,7,7,TGGGGTGGCGTGGATACGAC,0,1165418
fldAp,0.125,7,7,TGGGCATCGTGCTCGAAATG,0,1171731
fldAp,0.125,7,7,TGGGCAGCTAGGTGCCTAAA,0,1152381
fldAp,0.125,7,7,TGGCTCGGTTCAAGGATCGC,0,1083082
fldAp,0.125,7,7,TGGCTCGGACTACACACAGT,0,1130257
fldAp,0.125,7,7,TGGCGCGTAGCCGTATAACT,0,1131225
fldAp,0.125,7,7,TGGCAGGTAGTTTCAATTAT,0,1172010
fldAp,0.125,7,7,TGGCAAACTCTACTGCTTAT,0,1097234
fldAp,0.125,7,7,TGGATACAGAAAAGAGGAGT,0,1149484
fldAp,0.125,7,7,TGGAAGGATTCGGTATGCTG,0,1081310
fldAp,0.125,7,7,TGGAACGCTTAGGCTAGCAG,0,1155281
fldAp,0.125,7,7,TGGAAAGGACTTGGTTCTAA,0,1090977
fldAp,0.125,7,7,TGCTTGGGTACTCTAAACAT,0,1123659
fldAp,0.125,7,7,TGCTTCGCCATCAAACAACG,0,1175902
fldAp,0.125,7,7,TGCTGGTTGTAGAACATACA,0,1123162
fldAp,0.125,7,7,TGCTGGCTTGAGCGTTAAAT,0,1146677
fldAp,0.125,7,7,TGCTGCAGTGAATTGGTTAC,0,1167614
fldAp,0.125,7,7,TGCTAGAAATAGATCGTCTC,0,1134332
fldAp,0.125,7,7,TGCGTTAAACATGTCTGTGA,0,1130595
fldAp,0.125,7,7,TGCGTCTGTTACGTGTATTC,0,1152057
fldAp,0.125,7,7,TGCGTCCTCAGAGGCGGAAG,0,1151640
fldAp,0.125,7,7,TGCGTATTTGTCTTGCAACT,0,1127136
fldAp,0.125,7,7,TGCGGTGCTTTCAAACGCCA,0,1143592
fldAp,0.125,7,7,TGCGCGGAGACGTAACCCTA,0,1181912
fldAp,0.125,7,7,TGCGACGGAGTTTGTCAACC,0,1108531
fldAp,0.125,7,7,TGCCTTGCTCACGCGAAATC,0,1106664
fldAp,0.125,7,7,TGCCTGCTGGTATGTCTGCT,0,1126109
fldAp,0.125,7,7,TGCCTATGGAACATTACAAC,0,1157026
fldAp,0.125,7,7,TGCCGTCACCAACTGCTCCC,0,1156391
fldAp,0.125,7,7,TGCCCTTGTCGTTATATCTG,0,1177121
fldAp,0.125,7,7,TGCCCCGAAGTGAACGGCCA,0,1125671
fldAp,0.125,7,7,TGCCCACTGCGCCAAGTTTA,0,1097017
fldAp,0.125,7,7,TGCCATGCGAGACCGGATGT,0,1153086
fldAp,0.125,7,7,TGCCACTCGAGGTCTACGCG,0,1127575
fldAp,0.125,7,7,TGCCACACGGGCCTCAGAAC,0,1117288
fldAp,0.125,7,7,TGCATGTCTGACAGCAATTA,0,1163522
fldAp,0.125,7,7,TGCATCTATATCATCCGTGA,0,1128224
fldAp,0.125,7,7,TGCATCTAGCAAGCGTGGAA,0,1167085
fldAp,0.125,7,7,TGCAGTGCTGGCATGTGTTC,0,1065337
fldAp,0.125,7,7,TGCACTGTATTTTTCGGCAT,0,1185604
fldAp,0.125,7,7,TGATTTTATAAGGCATCGAC,0,1065582
fldAp,0.125,7,7,TGATTGGTGGCAACAGAGCA,0,1125214
fldAp,0.125,7,7,TGATTCCTTCCTGGGAAAGG,0,1108809
fldAp,0.125,7,7,TGATGAATCAGTTGCACCCT,0,1110261
fldAp,0.125,7,7,TGATCATTGCACCAGGAAGA,0,1099393
fldAp,0.125,7,7,TGAGTAGCCGCCCACTTGAT,0,1073551
fldAp,0.125,7,7,TGAGGCAACATGGATGGAAC,0,1093138
fldAp,0.125,7,7,TGAGAGTTCGGCAGTGGTCG,0,1136077
fldAp,0.125,7,7,TGACTTCGCTGAGCCTCGGG,0,1115107
fldAp,0.125,7,7,TGACCCTAACATTCTCTGAT,0,1174888
fldAp,0.125,7,7,TGAAGCGCTAGCTTGGAGGT,0,1105181
fldAp,0.125,7,7,TGAAGATGGTGGCCTGAAGG,0,1160778
fldAp,0.125,7,7,TGAACTCAACTCTGGCACCT,0,1143615
fldAp,0.125,7,7,TGAACAAATCCATTTTCAAT,0,1067539
fldAp,0.125,7,7,TGAAATGGCTACGGGGAGTC,0,1071906
fldAp,0.125,7,7,TCTTTTGCCGGACCCCGGGA,0,1126031
fldAp,0.125,7,7,TCTTTGGTGTACGATCACTA,0,1087192
fldAp,0.125,7,7,TCTTTGGCAAGTCAGGGACA,0,1090703
fldAp,0.125,7,7,TCTTTACTCATTCGGAAAAT,0,1135759
fldAp,0.125,7,7,TCTTGTTAAGTACCATGTCC,0,1082404
fldAp,0.125,7,7,TCTTGGGTTTTACGTCGCGG,0,1068331
fldAp,0.125,7,7,TCTTGGACAGTGCACCGAGT,0,1102506
fldAp,0.125,7,7,TCTTGAATACTGGTGACCCA,0,1064612
fldAp,0.125,7,7,TCTTGAATAAGCATTATCCA,0,1177959
fldAp,0.125,7,7,TCTTCTATTCGGCTTCATAG,0,1110339
fldAp,0.125,7,7,TCTTAGGCTTTGACCGGTGC,0,1111811
fldAp,0.125,7,7,TCTGTTGACCTGTACGCAGG,0,1181174
fldAp,0.125,7,7,TCTGTAACAATAAGTAAGAT,0,1071495
fldAp,0.125,7,7,TCTGCTCTCGACTCGAATGA,0,1096813
fldAp,0.125,7,7,TCTGCAGAAACCTTCTATCA,0,1088863
fldAp,0.125,7,7,TCTGATTCCATCTCAGATCG,0,1085757
fldAp,0.125,7,7,TCTGAGTGTTGGAGAAAGAG,0,1155280
fldAp,0.125,7,7,TCTGAATTTTTCATTAGTTC,0,1092549
fldAp,0.125,7,7,TCTCCCTCTACACGCACTCC,0,1099386
fldAp,0.125,7,7,TCTCATTCAATGGGCTAGAT,0,1142667
fldAp,0.125,7,7,TCTCATCGTGATCTGTCCGC,0,1100729
fldAp,0.125,7,7,TCTCAGTGCCAAGCTATTCT,0,1164640
fldAp,0.125,7,7,TCTCAAATTTACCCCGTATT,0,1155704
fldAp,0.125,7,7,TCTAGGGACACAAGCTGTGT,0,1076282
fldAp,0.125,7,7,TCTAGCGAGGCATTGTAATT,0,1166797
fldAp,0.125,7,7,TCTACGAAGGAAAGTGTGCA,0,1083536
fldAp,0.125,7,7,TCTACCCACTTTACGAGGAT,0,1104204
fldAp,0.125,7,7,TCTACCAACGTTGTGTACGG,0,1161710
fldAp,0.125,7,7,TCTAATGACACGGGTTTGTG,0,1158885
fldAp,0.125,7,7,TCTAAGGCACTTAATCCCAT,0,1173544
fldAp,0.125,7,7,TCTAACCTCATCGGAACAGG,0,1077806
fldAp,0.125,7,7,TCGTGTCGGGTGAAACGTAT,0,1120140
fldAp,0.125,7,7,TCGTCTAAAGGCAGTACATG,0,1120000
fldAp,0.125,7,7,TCGTCAGGGTCTCACACGAT,0,1133540
fldAp,0.125,7,7,TCGTACCTTATGATGACGAT,0,1164800
fldAp,0.125,7,7,TCGGTTCCGAGGAGGCGTTA,0,1132884
fldAp,0.125,7,7,TCGGTCGGTTATCGGCCCCA,0,1167252
fldAp,0.125,7,7,TCGGGTGGTTGTGACTCTCC,0,1137052
fldAp,0.125,7,7,TCGGGCTCGGGGGGATGGAT,0,1078565
fldAp,0.125,7,7,TCGGCCCGGTCGCGTGGGCA,0,1132088
fldAp,0.125,7,7,TCGGAGCTTGCTCAGCCTGG,0,1115900
fldAp,0.125,7,7,TCGGAATCTCTCGGGTTTCG,0,1181434
fldAp,0.125,7,7,TCGGAAGTTTAACGCGGTGA,0,1094292
fldAp,0.125,7,7,TCGCTTTGGTCCGACAAGCC,0,1153918
fldAp,0.125,7,7,TCGCTTTAAGGTGCGTCCTA,0,1140439
fldAp,0.125,7,7,TCGCTCTCTTAGGCGCATAA,0,1163023
fldAp,0.125,7,7,TCGCGTGTAAGGAGCATGAA,0,1091859
fldAp,0.125,7,7,TCGCGAGGGCCTTATCTGAG,0,1178196
fldAp,0.125,7,7,TCGCCTTGCATGTGATGGAA,0,1102443
fldAp,0.125,7,7,TCGCCCAAGACGGCCAATGT,0,1177139
fldAp,0.125,7,7,TCGCCAGGTGCGCTTATGAA,0,1159119
fldAp,0.125,7,7,TCGCCACTCCCGATCTAGGA,0,1101002
fldAp,0.125,7,7,TCGACGACGCATCCGGGCAG,0,1084192
fldAp,0.125,7,7,TCGACAGCACTCCCCAGTCT,0,1065680
fldAp,0.125,7,7,TCCTTTAGTCTGCAGATGGT,0,1171119
fldAp,0.125,7,7,TCCTGGATTGATCCTGTCAC,0,1095605
fldAp,0.125,7,7,TCCTGACTTTAGCAGATCAT,0,1085798
fldAp,0.125,7,7,TCCTGAAGATGCAGCCATTT,0,1068430
fldAp,0.125,7,7,TCCGGTCGGCCAGCTATCGG,0,1078156
fldAp,0.125,7,7,TCCGGGGAGATCGAACGTCC,0,1089307
fldAp,0.125,7,7,TCCGGGCTCCAGGTCAGTCC,0,1160029
fldAp,0.125,7,7,TCCGGCAAAATACAGGCTTG,0,1175552
fldAp,0.125,7,7,TCCGCTTCACTAAGCTCTGC,0,1139255
fldAp,0.125,7,7,TCCGCGATGAGCCAGAATCT,0,1063502
fldAp,0.125,7,7,TCCGCCGGGTGCAAGGGATA,0,1104986
fldAp,0.125,7,7,TCCGCAACCGGCTCACATTT,0,1076795
fldAp,0.125,7,7,TCCGAGCTGGCAGCTGAGTT,0,1171641
fldAp,0.125,7,7,TCCCTACTAAAAAGATAGAT,0,1070155
fldAp,0.125,7,7,TCCCGAGGTGTCGCCTATTA,0,1112114
fldAp,0.125,7,7,TCCATCGATGGGGCGTCATT,0,1094316
fldAp,0.125,7,7,TCCATAAATCTACAGAGTTT,0,1151623
fldAp,0.125,7,7,TCCAGGTAAACGCTTCTCCC,0,1072484
fldAp,0.125,7,7,TCCAAGCGGTACATTGCTGA,0,1151543
fldAp,0.125,7,7,TCATTGCAGCTCTATCAAAG,0,1082405
fldAp,0.125,7,7,TCATGTACTTTTCGTGTGTA,0,1130314
fldAp,0.125,7,7,TCATATCTATGTCAGTATGA,0,1158184
fldAp,0.125,7,7,TCATAATGGCACATAGCCAC,0,1160081
fldAp,0.125,7,7,TCAGTTCGCACGGGAATTGG,0,1099241
fldAp,0.125,7,7,TCAGTGGCCTGTTTCTAGTA,0,1147535
fldAp,0.125,7,7,TCAGAATCCCTCTAGTACCT,0,1072487
fldAp,0.125,7,7,TCACGGTAATATGATATCAA,0,1101042
fldAp,0.125,7,7,TCACGGATCAAAGCAAAGAT,0,1084651
fldAp,0.125,7,7,TCACGACTACGCCTTTGGGA,0,1122065
fldAp,0.125,7,7,TCACCATGAAGACAGCAAGT,0,1155296
fldAp,0.125,7,7,TCACATACGGGAACATCGTC,0,1157315
fldAp,0.125,7,7,TCAATCTTAACTTTTCCGCC,0,1166056
fldAp,0.125,7,7,TCAATCTGACATCAACGGCA,0,1148989
fldAp,0.125,7,7,TCAATATGCAGCCGATCTAC,0,1113431
fldAp,0.125,7,7,TATTTTAAATACCGGACTCT,0,1185268
fldAp,0.125,7,7,TATTTACAATAGGCGGGGCA,0,1152747
fldAp,0.125,7,7,TATTGGTGCCTGTCGCCTGC,0,1084344
fldAp,0.125,7,7,TATTATCTAATTTGTTGGGT,0,1119254
fldAp,0.125,7,7,TATTACGTTATTCGTCAATC,0,1129498
fldAp,0.125,7,7,TATGTCCATGCGATATTATG,0,1073183
fldAp,0.125,7,7,TATGTACGTGATGTCTCCCC,0,1081478
fldAp,0.125,7,7,TATGTACACAGTGACGACGA,0,1090161
fldAp,0.125,7,7,TATGGTCTGAATCGGAGAAA,0,1075790
fldAp,0.125,7,7,TATGGTAACAGTCGGTGTGA,0,1097471
fldAp,0.125,7,7,TATGGAGTGGTACTATCCCT,0,1118790
fldAp,0.125,7,7,TATGCATCCTCTGGAGAGTG,0,1176628
fldAp,0.125,7,7,TATCTGGTAGATTGTCACAA,0,1115106
fldAp,0.125,7,7,TATCGCAATCTGGTGGCCCA,0,1123875
fldAp,0.125,7,7,TATCCGTCTCCTGCTCTTGA,0,1089846
fldAp,0.125,7,7,TATCAATAAAGTCCGGGTTG,0,1089503
fldAp,0.125,7,7,TATATTGATGGGTGACCATT,0,1138341
fldAp,0.125,7,7,TATACTTAAGAACACCAGAG,0,1075095
fldAp,0.125,7,7,TATACGCGCGTCAATCGTAT,0,1174155
fldAp,0.125,7,7,TATACCCCAAAACAGTTGTA,0,1140261
fldAp,0.125,7,7,TAGTGGCTACGAGAAGGGAG,0,1178358
fldAp,0.125,7,7,TAGTGGACAGATCTTTAAAC,0,1143264
fldAp,0.125,7,7,TAGGTGAATATCTGCTAAAA,0,1104441
fldAp,0.125,7,7,TAGGGCCTAGGGGGACTTGT,0,1185986
fldAp,0.125,7,7,TAGGCCGAAGCTTTGACTCC,0,1154896
fldAp,0.125,7,7,TAGCTTTGTGCGGTATTAAA,0,1102323
fldAp,0.125,7,7,TAGATACGACTTTCTGCGCA,0,1079406
fldAp,0.125,7,7,TAGAGTCTACACCAAACAGC,0,1163467
fldAp,0.125,7,7,TAGAGGTAATGATTAGCATC,0,1069503
fldAp,0.125,7,7,TAGACTTGGTTCCCCTATTC,0,1129419
fldAp,0.125,7,7,TAGACATATATTCATCCGAA,0,1081152
fldAp,0.125,7,7,TACTTCATTGGACTAGACGA,0,1146733
fldAp,0.125,7,7,TACTCGGCCTTGCCAGGATC,0,1136785
fldAp,0.125,7,7,TACTCATTGGTTCCAGCAGG,0,1168436
fldAp,0.125,7,7,TACTATGTGAACCATGCACA,0,1159410
fldAp,0.125,7,7,TACTACGAGAAAGCGGATGA,0,1101455
fldAp,0.125,7,7,TACGTCCAGCGGCCCCGGTA,0,1183373
fldAp,0.125,7,7,TACGTAAATGATTTCAAGGG,0,1085247
fldAp,0.125,7,7,TACGGGTGATTACGACCCTC,0,1131843
fldAp,0.125,7,7,TACGGGCCTAAGACGATATC,0,1091356
fldAp,0.125,7,7,TACGCTTGATGGGGGACAAC,0,1079831
fldAp,0.125,7,7,TACCTTACGCAACAACAGCA,0,1085991
fldAp,0.125,7,7,TACCGGGCCTTTAAGTGTTG,0,1074065
fldAp,0.125,7,7,TACCGAGGACATGGAGGTGA,0,1095381
fldAp,0.125,7,7,TACCGAACAGCCTAATGCCA,0,1163096
fldAp,0.125,7,7,TACCATTGCCGGGCGGATCA,0,1107188
fldAp,0.125,7,7,TACAGTGATTGCGTGACCTA,0,1115204
fldAp,0.125,7,7,TACAGTCATAGGAGCGGTTA,0,1126263
fldAp,0.125,7,7,TACAGGTATGTGTGAGAGGA,0,1150473
fldAp,0.125,7,7,TACAGCCGTCTGCCTACCGT,0,1155141
fldAp,0.125,7,7,TAATGTCCTTGGTGTGGGTT,0,1106665
fldAp,0.125,7,7,TAATGTAGAATCTACCAGCC,0,1075978
fldAp,0.125,7,7,TAATGGGGGTTTGGCCGTGA,0,1170773
fldAp,0.125,7,7,TAATCAGATAGAAACAGTGT,0,1100492
fldAp,0.125,7,7,TAAGTTTGTTGAAGCAATTC,0,1182849
fldAp,0.125,7,7,TAAGTAAATAGAGCGGAGAC,0,1138581
fldAp,0.125,7,7,TAAGGGTCTCTGATTCCAAG,0,1157953
fldAp,0.125,7,7,TAAGGGTAGCAAAAAGATCA,0,1100371
fldAp,0.125,7,7,TAAGCGATCGACCAACAAAT,0,1155102
fldAp,0.125,7,7,TAAGACTTGTCTAGAGTCAA,0,1186564
fldAp,0.125,7,7,TAAGACCACCTTCTATAACA,0,1184536
fldAp,0.125,7,7,TAACGGTCACACCAACGAGC,0,1069212
fldAp,0.125,7,7,TAACCGCTGACGCAGTCGAT,0,1132424
fldAp,0.125,7,7,TAACCAATTTGAGGGTCTGC,0,1141829
fldAp,0.125,7,7,TAAATTTCTTTTAGTACAGT,0,1086057
fldAp,0.125,7,7,TAAATACACCGAGAGGATGG,0,1067207
fldAp,0.125,7,7,TAAAGAATGGAACGAGCGGC,0,1169403
fldAp,0.125,7,7,TAAACTTCGTCCAGCCGGGG,0,1065069
fldAp,0.125,7,7,TAAACGTTGGGTACCACAAT,0,1110591
fldAp,0.125,7,7,TAAACGGTCTTGGGAATAGT,0,1088718
fldAp,0.125,7,7,TAAAAATTGGAATTCGTTGC,0,1084061
fldAp,0.125,7,7,GTTTTCTGGTCCGCGTACTC,0,1126811
fldAp,0.125,7,7,GTTTGTTGAGTTGCTGACTT,0,1064854
fldAp,0.125,7,7,GTTTGCAGGGAACAAACCTG,0,1097077
fldAp,0.125,7,7,GTTTCTGACACAACGCTATG,0,1142132
fldAp,0.125,7,7,GTTTCCTGCTTTATCCGCTC,0,1185886
fldAp,0.125,7,7,GTTTAGTTCCTTCGTCGGAT,0,1063557
fldAp,0.125,7,7,GTTTACCAGCCTTACACGGC,0,1096397
fldAp,0.125,7,7,GTTGTCTTATCGCTCTTCAC,0,1088831
fldAp,0.125,7,7,GTTGTAGGGTACGTAACCAT,0,1149706
fldAp,0.125,7,7,GTTGGCGGACTCGGAACCTT,0,1133618
fldAp,0.125,7,7,GTTGCCTGGAAGAGACCAGT,0,1087166
fldAp,0.125,7,7,GTTGAGTGCGACCGCAACAA,0,1075258
fldAp,0.125,7,7,GTTGAAGGTTCTGTTCATAC,0,1123421
fldAp,0.125,7,7,GTTGAACTTCTTAACGGTAC,0,1105087
fldAp,0.125,7,7,GTTCGGAGGACCATGGACTA,0,1117757
fldAp,0.125,7,7,GTTCGGACAAGAACATAGCA,0,1135649
fldAp,0.125,7,7,GTTCGCGAGGAGATTCCAGA,0,1143548
fldAp,0.125,7,7,GTTCCTTGATCATATGCGTG,0,1147635
fldAp,0.125,7,7,GTTCCTCGGGTTGCTGCCTG,0,1086197
fldAp,0.125,7,7,GTTCCCGGTCAGACTACTCA,0,1101315
fldAp,0.125,7,7,GTTCCAGCCTATCGACGCCC,0,1145728
fldAp,0.125,7,7,GTTCATCATCTTCCCAGGGT,0,1075478
fldAp,0.125,7,7,GTTATTTTCTTTAGTTCGGC,0,1086845
fldAp,0.125,7,7,GTTATGCCCGTTTCGACAAG,0,1114839
fldAp,0.125,7,7,GTTATAGGTTTACAGGGAAT,0,1111480
fldAp,0.125,7,7,GTTAGTGTGTGGGAGGATAC,0,1116693
fldAp,0.125,7,7,GTTAGTAAGGCGTTGGTTAG,0,1141544
fldAp,0.125,7,7,GTTAACCATTGAAAAGGCGT,0,1154036
fldAp,0.125,7,7,GTGTTACCACCTTACATATA,0,1143450
fldAp,0.125,7,7,GTGTGGTGTAGTAATCATGT,0,1094144
fldAp,0.125,7,7,GTGTCCCTGACGGGTTCTAC,0,1137973
fldAp,0.125,7,7,GTGTATGCAGGCATAGGTAT,0,1063863
fldAp,0.125,7,7,GTGTATGCACACGTCTTGCC,0,1142471
fldAp,0.125,7,7,GTGTACATGCCGGGGAACGG,0,1162732
fldAp,0.125,7,7,GTGGTCGCAGGGTCTTTGGT,0,1076203
fldAp,0.125,7,7,GTGGGGTATTTACATGCACT,0,1101529
fldAp,0.125,7,7,GTGGCGACGTAGAGTAGACT,0,1085722
fldAp,0.125,7,7,GTGGCATGGAAGCTGTAAAA,0,1138509
fldAp,0.125,7,7,GTGCTGGTTCCAAAGGAGAG,0,1086547
fldAp,0.125,7,7,GTGCTCTCTTTCCTTCAGGA,0,1091602
fldAp,0.125,7,7,GTGCGGCGTGGATCCAGAAA,0,1124758
fldAp,0.125,7,7,GTGCGCTCATACATGCCCAT,0,1103689
fldAp,0.125,7,7,GTGCCCGTAGTCGGGGGTAT,0,1092586
fldAp,0.125,7,7,GTGCCCACCGGGGTAAGGAC,0,1179986
fldAp,0.125,7,7,GTGCAGGTGATACTCGCTAT,0,1158032
fldAp,0.125,7,7,GTGCAAACTTCGCGACGTCT,0,1144456
fldAp,0.125,7,7,GTGATAGAAGCTCTCGGCAA,0,1104170
fldAp,0.125,7,7,GTGATACTGACCGCATCTGC,0,1138885
fldAp,0.125,7,7,GTCTTCTGTACATTGCGGAG,0,1102166
fldAp,0.125,7,7,GTCTTCTGCTTCTGGAGCTT,0,1138600
fldAp,0.125,7,7,GTCTTATTACGGCACGGGCA,0,1155838
fldAp,0.125,7,7,GTCTGTCAGACTTCCGATAC,0,1112649
fldAp,0.125,7,7,GTCTCGGCGGTACTTTAAAG,0,1186965
fldAp,0.125,7,7,GTCTCCCAGCGAATCTACGG,0,1159757
fldAp,0.125,7,7,GTCGAGCGCATTACAATAGG,0,1148199
fldAp,0.125,7,7,GTCCTGGAGTACACGTGTGT,0,1107862
fldAp,0.125,7,7,GTCCGTACTGTCGTTACAGC,0,1138060
fldAp,0.125,7,7,GTCCCAACCGGAAGCGGGGT,0,1094128
fldAp,0.125,7,7,GTCCAATATCAGGAGGACAG,0,1118757
fldAp,0.125,7,7,GTCATTTGATCGAACATAGC,0,1142859
fldAp,0.125,7,7,GTCATGGTCCATGCGTGAAG,0,1136602
fldAp,0.125,7,7,GTCACCATTTTTAGTACAGA,0,1185144
fldAp,0.125,7,7,GTCACCACCCCATTTTGACG,0,1144519
fldAp,0.125,7,7,GTCACACTCCGGTTCATGGT,0,1151490
fldAp,0.125,7,7,GTCAACTGGGGTTGTATTGC,0,1149187
fldAp,0.125,7,7,GTATTCTGCTCTAGTGATCT,0,1107185
fldAp,0.125,7,7,GTATTACTCAATTTCACTCT,0,1085336
fldAp,0.125,7,7,GTATGCTGCGTGGGGAGCTT,0,1086611
fldAp,0.125,7,7,GTATGCTGCCGGCATCGCCC,0,1105350
fldAp,0.125,7,7,GTATGATTGGACTTCGTTAC,0,1083034
fldAp,0.125,7,7,GTATCGTCTAGCCGCGAAAT,0,1115472
fldAp,0.125,7,7,GTATCATAGGGCACAATTGG,0,1109966
fldAp,0.125,7,7,GTAGTCGGGATACTCACGGG,0,1098966
fldAp,0.125,7,7,GTAGGTTAAAGAATGCTATG,0,1082442
fldAp,0.125,7,7,GTAGGGGTCATGTTTCAGCA,0,1127930
fldAp,0.125,7,7,GTAGGCCAAGCAGTCCAGCA,0,1094367
fldAp,0.125,7,7,GTAGGAGGCGCTTTGACAAA,0,1137749
fldAp,0.125,7,7,GTACTTTTTCTAACATCGTT,0,1087358
fldAp,0.125,7,7,GTACTGAGCGCACAAATGGT,0,1138707
fldAp,0.125,7,7,GTACGTTTGCGGTGATAGGA,0,1120620
fldAp,0.125,7,7,GTACGGAGTTGGAAACTCTC,0,1130522
fldAp,0.125,7,7,GTACATATGTTAACATTTGT,0,1158847
fldAp,0.125,7,7,GTAACTTCAGGGAGGAAAAT,0,1112487
fldAp,0.125,7,7,GTAACACAGTTGCATCCATC,0,1145986
fldAp,0.125,7,7,GGTTTTGCGAGGAACTACAA,0,1139731
fldAp,0.125,7,7,GGTTTTCCCTTGTTTACGGG,0,1163040
fldAp,0.125,7,7,GGTTTGTATTACGTGGCACA,0,1083418
fldAp,0.125,7,7,GGTTCAAGTCAATGCAAAGC,0,1186292
fldAp,0.125,7,7,GGTGTTTGTGGTGGTTCTGA,0,1183872
fldAp,0.125,7,7,GGTGGTAAGAAAGTCTGCCC,0,1148437
fldAp,0.125,7,7,GGTGGGATGCGACTGTTCTC,0,1068992
fldAp,0.125,7,7,GGTGGCCCCCATTAGAGCGT,0,1174797
fldAp,0.125,7,7,GGTGGCCACCGATGCTCGTT,0,1117969
fldAp,0.125,7,7,GGTGCTTAAACCGGAGCTCT,0,1180928
fldAp,0.125,7,7,GGTCGGTAGTCGCTCACCAG,0,1075004
fldAp,0.125,7,7,GGTCGGCACAAATTCCCTTG,0,1164564
fldAp,0.125,7,7,GGTCGAACGCTATGCGCGGA,0,1133683
fldAp,0.125,7,7,GGTCCATTACTCGGCCGCGA,0,1072592
fldAp,0.125,7,7,GGTCCAGATCTGCAAGTTCA,0,1158671
fldAp,0.125,7,7,GGTCATCTTCTACCCGACTA,0,1161760
fldAp,0.125,7,7,GGTCAGTTCACGCATAGTTT,0,1113420
fldAp,0.125,7,7,GGTCACAGGAAGAAGCCAAT,0,1143115
fldAp,0.125,7,7,GGTAAACAAGGCTATAGGGA,0,1065993
fldAp,0.125,7,7,GGGTTCGTAAGAAAATTCAG,0,1083413
fldAp,0.125,7,7,GGGTGGCGGTGAATGCCTGA,0,1137583
fldAp,0.125,7,7,GGGTGGCCCCTCCTCCCTTG,0,1102764
fldAp,0.125,7,7,GGGTGGACAATCAGCAAAAC,0,1135793
fldAp,0.125,7,7,GGGTGCGTTGTCACGAACAC,0,1110358
fldAp,0.125,7,7,GGGTCGGTGATTCAAAAGGC,0,1111387
fldAp,0.125,7,7,GGGTATTCTTGCGCACCACA,0,1081183
fldAp,0.125,7,7,GGGGGGCGCGGCGAAACCCC,0,1148776
fldAp,0.125,7,7,GGGGGCCAAGGACACTCGAT,0,1094940
fldAp,0.125,7,7,GGGGATGTACCATAGGGAGA,0,1150887
fldAp,0.125,7,7,GGGGAGGCAGTTAAAATGCG,0,1100040
fldAp,0.125,7,7,GGGGACCGGGGTGGCTCTCC,0,1091724
fldAp,0.125,7,7,GGGGAACCGGACCGGTGGGC,0,1089414
fldAp,0.125,7,7,GGGCTTCAAATGGAAGGTAT,0,1099494
fldAp,0.125,7,7,GGGCTCACAGGTCCGGGCGG,0,1113605
fldAp,0.125,7,7,GGGCGCATCACTCCTGGTGA,0,1147788
fldAp,0.125,7,7,GGGCGACCACTCCCCGAAGC,0,1066377
fldAp,0.125,7,7,GGGCCTCTGAGAGACGCGCC,0,1176886
fldAp,0.125,7,7,GGGCATGGGTCGTTTATGCG,0,1064955
fldAp,0.125,7,7,GGGCAACCTGAAGACTTGAT,0,1077074
fldAp,0.125,7,7,GGGATACGCAATACCAGGGC,0,1150947
fldAp,0.125,7,7,GGGATAATAGCATGCGCCGC,0,1068037
fldAp,0.125,7,7,GGGACTTGTTCGAGTATCAC,0,1181652
fldAp,0.125,7,7,GGGACGGACTTGCACCTACA,0,1117624
fldAp,0.125,7,7,GGGACCGGAGCCTTAACATA,0,1165390
fldAp,0.125,7,7,GGCTTCAGAGCTACAAACAC,0,1185817
fldAp,0.125,7,7,GGCTGTATGTGGTAACTTAT,0,1077752
fldAp,0.125,7,7,GGCTATGCAGGGGAGATCAT,0,1184005
fldAp,0.125,7,7,GGCGGACGGCGGAGTTGCCG,0,1129114
fldAp,0.125,7,7,GGCGCTTCTGCAAGTACACG,0,1084784
fldAp,0.125,7,7,GGCGATTTTCTCGTTGCTTG,0,1096755
fldAp,0.125,7,7,GGCGATATGTGCGGTTAAAC,0,1143378
fldAp,0.125,7,7,GGCGAGTCGTCAAGCTGGTC,0,1167002
fldAp,0.125,7,7,GGCGAACTGCGACCGGGGAA,0,1138845
fldAp,0.125,7,7,GGCCTCCTCCCCAAGAGCAA,0,1158049
fldAp,0.125,7,7,GGCCGTGCCTAAGGGCGTAC,0,1090055
fldAp,0.125,7,7,GGCCGCGGCGTGCTCCACCT,0,1128410
fldAp,0.125,7,7,GGCCGCACTTATGCGATAGG,0,1082783
fldAp,0.125,7,7,GGCCGCAAATGGACGCGTGT,0,1138776
fldAp,0.125,7,7,GGCCCTTTGTACGTCGATAG,0,1093833
fldAp,0.125,7,7,GGCCCTGCATGACACGAATA,0,1119679
fldAp,0.125,7,7,GGCCCGGGTACGGGTACGAA,0,1149942
fldAp,0.125,7,7,GGCCAGCGCGACTAAGAATC,0,1081336
fldAp,0.125,7,7,GGCATGGTGTGGAGAATCGG,0,1138773
fldAp,0.125,7,7,GGCATAGAACATGGAGCCGG,0,1086495
fldAp,0.125,7,7,GGCAGGCGGCCTGTCAAGGG,0,1149469
fldAp,0.125,7,7,GGCACATGCGGGGTAGTCTC,0,1159892
fldAp,0.125,7,7,GGCAAGTGTGACAGCCATCC,0,1178537
fldAp,0.125,7,7,GGATTTCCGCCGTAAGTAGT,0,1158773
fldAp,0.125,7,7,GGATTACTCCGCTCCACAGA,0,1081765
fldAp,0.125,7,7,GGATTACGGCAAAAGTGGGT,0,1065044
fldAp,0.125,7,7,GGATGGAATACTCGTTTCAA,0,1136592
fldAp,0.125,7,7,GGAGTCAGGAAAGTACGGAA,0,1146882
fldAp,0.125,7,7,GGAGGGTCCGGGGAAGTCAT,0,1093771
fldAp,0.125,7,7,GGAGCGCTTGAAATACAAAA,0,1146399
fldAp,0.125,7,7,GGACTTGATCCCCTGAGGCT,0,1142728
fldAp,0.125,7,7,GGACGGCAGCTACATAGTGT,0,1185628
fldAp,0.125,7,7,GGACGCCTTCGTATTGATAT,0,1089594
fldAp,0.125,7,7,GGACGCCGGCCTAATGTAGA,0,1076067
fldAp,0.125,7,7,GGACCGGTGACAGGATCTGA,0,1150224
fldAp,0.125,7,7,GGACCGACGCTGAACAATCT,0,1164602
fldAp,0.125,7,7,GGACAATGGACTTAGGGATA,0,1064363
fldAp,0.125,7,7,GGAATGGAAATATGGAGTGA,0,1063053
fldAp,0.125,7,7,GGAATCCCAGACCACTCGTT,0,1177862
fldAp,0.125,7,7,GGAACTATCACGGGCCACAC,0,1164275
fldAp,0.125,7,7,GCTTTACCAGATAGGTATGC,0,1088651
fldAp,0.125,7,7,GCTTGTACTCGGACGTCTAG,0,1107901
fldAp,0.125,7,7,GCTTGCTCAGGGGCCTGTAA,0,1081162
fldAp,0.125,7,7,GCTTATGCCTGTGGCGTAGG,0,1157722
fldAp,0.125,7,7,GCTGGGACAAGGGGGCCACA,0,1126819
fldAp,0.125,7,7,GCTGGCCAGGCTCCCTGCTC,0,1142801
fldAp,0.125,7,7,GCTGCTGATATTTGTATTTG,0,1185117
fldAp,0.125,7,7,GCTGACTCGTGAGCCAGCTA,0,1133500
fldAp,0.125,7,7,GCTGACAGAAGATGAGTATA,0,1147357
fldAp,0.125,7,7,GCTGAATTTAAGGATAAATA,0,1097838
fldAp,0.125,7,7,GCTCTCTATCCGGCTTCTGA,0,1125592
fldAp,0.125,7,7,GCTCGAATGAACGTGCACAG,0,1150475
fldAp,0.125,7,7,GCTCCGGCAAATCATAGTAA,0,1077166
fldAp,0.125,7,7,GCTCCGAAGAATTTGGCCCG,0,1110269
fldAp,0.125,7,7,GCTCCCATGTTGGGTAACTT,0,1171367
fldAp,0.125,7,7,GCTCATGCGGACGAGTCCAC,0,1088404
fldAp,0.125,7,7,GCTCATAGTGTCAGCCCTCC,0,1173261
fldAp,0.125,7,7,GCTCACCGGCGAACCTCGGC,0,1123642
fldAp,0.125,7,7,GCTCAACGGAGATGGTTACA,0,1170909
fldAp,0.125,7,7,GCTACGGTTTCCGTTCGGTC,0,1177169
fldAp,0.125,7,7,GCTAATGCGCTGAAATATAC,0,1113548
fldAp,0.125,7,7,GCGTTTGCTCCAGAGCACGA,0,1161664
fldAp,0.125,7,7,GCGTTGCGTACAGGGCGTTT,0,1083092
fldAp,0.125,7,7,GCGTGCGGTCCTGACAAAGC,0,1170988
fldAp,0.125,7,7,GCGTGATTTGGCAGTCAAGT,0,1097046
fldAp,0.125,7,7,GCGTCTATACAATTTCCTTT,0,1182040
fldAp,0.125,7,7,GCGGGTTCAACCAACATAGT,0,1117159
fldAp,0.125,7,7,GCGGCTTAAACACAGTCACG,0,1105639
fldAp,0.125,7,7,GCGGACATCCACCTACAGTC,0,1085024
fldAp,0.125,7,7,GCGGAATGGATCCCCGTAGA,0,1072572
fldAp,0.125,7,7,GCGCGAATAGCCTTTTAGCT,0,1179287
fldAp,0.125,7,7,GCGCCGTTTAAGTGGGCGAC,0,1153222
fldAp,0.125,7,7,GCGCCGCACAGTACTTGTAT,0,1081557
fldAp,0.125,7,7,GCGATTCGAGAAATTGAGTG,0,1115960
fldAp,0.125,7,7,GCGATGGTGCACCTGTAAAG,0,1151750
fldAp,0.125,7,7,GCGATCCGGTATCTGGCGAT,0,1134336
fldAp,0.125,7,7,GCGAGTAGTTTTAAGGGATC,0,1074685
fldAp,0.125,7,7,GCGAGAAACGTTCTCACGTC,0,1128025
fldAp,0.125,7,7,GCGACTCCGGTCATTGCGTA,0,1135760
fldAp,0.125,7,7,GCGACCTAATCCGGACTACT,0,1128825
fldAp,0.125,7,7,GCGAATGTCCTTGTGGAAGT,0,1173218
fldAp,0.125,7,7,GCGAAACACGGAACTAACGG,0,1119680
fldAp,0.125,7,7,GCCTGGCTGTACCCTGAGTG,0,1074524
fldAp,0.125,7,7,GCCTGATACACGGTCCAATG,0,1108983
fldAp,0.125,7,7,GCCTCCGGGTATCATAGAAC,0,1149948
fldAp,0.125,7,7,GCCGTAGATCCTTCCACCTG,0,1172345
fldAp,0.125,7,7,GCCGGGTCTAGGGGGCCACG,0,1178076
fldAp,0.125,7,7,GCCCTAGCCTTACTAGGCTC,0,1094545
fldAp,0.125,7,7,GCCCTAATCCATTATGCCTC,0,1082949
fldAp,0.125,7,7,GCCCGTTGTCCTGGATTCTA,0,1115657
fldAp,0.125,7,7,GCCCGCGGAGTCCCAATTAC,0,1110430
fldAp,0.125,7,7,GCCCGAGTGTGTCGCGCGGA,0,1092835
fldAp,0.125,7,7,GCCATTGGATTTAAAGGCTG,0,1077335
fldAp,0.125,7,7,GCCAGTATAACTGGCGTGTA,0,1134047
fldAp,0.125,7,7,GCCACCAGTACGCCGCTTTG,0,1117970
fldAp,0.125,7,7,GCCAATTGCGAAAGTTTGAA,0,1063156
fldAp,0.125,7,7,GCCAAGTGTCGGGATTACTT,0,1120142
fldAp,0.125,7,7,GCATTGGGCCAGTCCTCGGG,0,1099081
fldAp,0.125,7,7,GCATGTGATCTTCGCAGCTT,0,1070590
fldAp,0.125,7,7,GCATAGTGAATTGCTCGAAA,0,1161994
fldAp,0.125,7,7,GCAGTTGTGTATCTAGCCGT,0,1121454
fldAp,0.125,7,7,GCAGTTAAGGCCGCACGGCT,0,1128190
fldAp,0.125,7,7,GCAGTCGGTGGGCGCTGCTC,0,1140318
fldAp,0.125,7,7,GCAGACTGCACAGTCGGACC,0,1181973
fldAp,0.125,7,7,GCACTTTGCAGAGTCTGGAG,0,1169997
fldAp,0.125,7,7,GCACTGAAAAATGAGTACTA,0,1173308
fldAp,0.125,7,7,GCACTACCTGATGTACGTAC,0,1181320
fldAp,0.125,7,7,GCACGGTTTGTTAGTACCTG,0,1159044
fldAp,0.125,7,7,GCACGACACTTGCTCTTAGT,0,1175093
fldAp,0.125,7,7,GCACGAATGCGGCAAACGGG,0,1170851
fldAp,0.125,7,7,GCACAAAGCATAACTACATG,0,1119407
fldAp,0.125,7,7,GCAAGTAGGGACATTCGCCA,0,1117638
fldAp,0.125,7,7,GCAAGACCTTTCGTGCGGGT,0,1115295
fldAp,0.125,7,7,GCAAATGCGATGGTTAATTG,0,1118763
fldAp,0.125,7,7,GCAAATCTACATTTTTTAAT,0,1142598
fldAp,0.125,7,7,GCAAACGACACAGGCTTCAT,0,1152045
fldAp,0.125,7,7,GCAAAACCACCCGGAGATTC,0,1077350
fldAp,0.125,7,7,GATTTGTAGAATCTGAACAA,0,1125798
fldAp,0.125,7,7,GATTGGAGGGTGAGGCAGTA,0,1067859
fldAp,0.125,7,7,GATTCTTGCAACGCTCGCCT,0,1133185
fldAp,0.125,7,7,GATTCCGTACGAAGGAGAAC,0,1133059
fldAp,0.125,7,7,GATTCAATGCGGAACCGGAG,0,1068648
fldAp,0.125,7,7,GATGTCTAATAGTCAGTACG,0,1116031
fldAp,0.125,7,7,GATGGGTCGCAGGCAGGGGA,0,1174172
fldAp,0.125,7,7,GATGGGGCGACGTCATGTTT,0,1155448
fldAp,0.125,7,7,GATGCTTCGGTTTATCAGGA,0,1095680
fldAp,0.125,7,7,GATGAATGCTACATTTGGGA,0,1064205
fldAp,0.125,7,7,GATCCGGGTCCGGATAATAA,0,1073836
fldAp,0.125,7,7,GATCCAGTGGCAGAGCTCAG,0,1168132
fldAp,0.125,7,7,GATATACGTCTATAAGTAAT,0,1168616
fldAp,0.125,7,7,GATAGGTATTTGAATCCAAC,0,1165129
fldAp,0.125,7,7,GATAGATAACAGTCCGTCTT,0,1145838
fldAp,0.125,7,7,GATACTTACAGGGAAGACAG,0,1065043
fldAp,0.125,7,7,GATACGGTGCCACCCTTTAA,0,1166496
fldAp,0.125,7,7,GAGTTGTCCGTAGGATTCTG,0,1077311
fldAp,0.125,7,7,GAGTGAATAAAGCGTTGTTA,0,1087257
fldAp,0.125,7,7,GAGTCGTTGGGGCAAAGGTC,0,1141252
fldAp,0.125,7,7,GAGTCCCCCCCTTCCACCTA,0,1176613
fldAp,0.125,7,7,GAGTATTCTAATAGAAGCTT,0,1078374
fldAp,0.125,7,7,GAGGTTGTATACAGAGTATA,0,1079407
fldAp,0.125,7,7,GAGGTAGGTTTGCGACAATA,0,1130745
fldAp,0.125,7,7,GAGGGTGCAATTCCACTAAA,0,1063448
fldAp,0.125,7,7,GAGGCTAAAGTATCTCTTTG,0,1131155
fldAp,0.125,7,7,GAGGAGTGGCACCTCCCGAA,0,1165562
fldAp,0.125,7,7,GAGGACAGGCTATATGGGGT,0,1085402
fldAp,0.125,7,7,GAGCTCTCATTAAATGGCCT,0,1101857
fldAp,0.125,7,7,GAGCGAGGTTCCCGTGCCGA,0,1123293
fldAp,0.125,7,7,GAGCCGGTAGGTACTGAAGT,0,1179988
fldAp,0.125,7,7,GAGCCCCGTCCCTATTGTGA,0,1103434
fldAp,0.125,7,7,GAGCAAGATCATCGAGAAAG,0,1064942
fldAp,0.125,7,7,GAGATAACATACTCACTAAT,0,1082957
fldAp,0.125,7,7,GAGAGTGTCAAAGCGGGCGT,0,1183593
fldAp,0.125,7,7,GAGAGGAGGAGGGATGAGCA,0,1072829
fldAp,0.125,7,7,GAGACTGCCTTGGTTATAGA,0,1111542
fldAp,0.125,7,7,GAGACTAGGCCCCCGTCAGG,0,1178020
fldAp,0.125,7,7,GAGACGATGGTTTAGGACGA,0,1081130
fldAp,0.125,7,7,GAGACCGGAAGTACCGTCAG,0,1112034
fldAp,0.125,7,7,GACTTGCTGGTGCACTCAGT,0,1168898
fldAp,0.125,7,7,GACTTGAAGAGCAGTATACA,0,1074100
fldAp,0.125,7,7,GACTAGGTTCCCCGTCTCGC,0,1154111
fldAp,0.125,7,7,GACGGTTATAACAGCAATAG,0,1127857
fldAp,0.125,7,7,GACGGGTGTCCCGGGTGCAT,0,1065760
fldAp,0.125,7,7,GACGGGTGAGCGATCCTAAT,0,1129512
fldAp,0.125,7,7,GACGGCAGGGACCGGTTTAA,0,1128116
fldAp,0.125,7,7,GACGGATCGTGATAAATACA,0,1181879
fldAp,0.125,7,7,GACGCTTTTTTACGGACGTT,0,1074002
fldAp,0.125,7,7,GACGCATGGGGTATTCCGGT,0,1095219
fldAp,0.125,7,7,GACCTGTATAATGCAGGGGT,0,1117286
fldAp,0.125,7,7,GACCTGGCATCAAACGTCGG,0,1168047
fldAp,0.125,7,7,GACCTGCCGGATCCAGTCTC,0,1069509
fldAp,0.125,7,7,GACCGTATGAACGACATGCC,0,1148232
fldAp,0.125,7,7,GACCGCCCTCTAGTTATTGT,0,1070436
fldAp,0.125,7,7,GACCGACGATGGAAACAGCA,0,1094464
fldAp,0.125,7,7,GACCCCAATGTCGAAGTGAT,0,1106214
fldAp,0.125,7,7,GACCATTATACTTATGTGCG,0,1101109
fldAp,0.125,7,7,GACACTCCTATGCGGTTGTA,0,1179066
fldAp,0.125,7,7,GACAAATACCTTCGGTGTTG,0,1120612
fldAp,0.125,7,7,GAATGAGAATTCACCTATTA,0,1179555
fldAp,0.125,7,7,GAATCTGTGAGTAGGAAAAC,0,1161606
fldAp,0.125,7,7,GAATCCGTATTTTTTGCAGT,0,1140699
fldAp,0.125,7,7,GAATAGTCTGCTGGTAAGAG,0,1184736
fldAp,0.125,7,7,GAATACGCGTATCTAATTCA,0,1088009
fldAp,0.125,7,7,GAAGTCAGGGGCCGCCCACT,0,1171211
fldAp,0.125,7,7,GAAGTATAGAACCCCGGTAT,0,1121983
fldAp,0.125,7,7,GAAGGACCTTGGACGCAGCC,0,1169596
fldAp,0.125,7,7,GAAGCGTTAACTTACCAATG,0,1067097
fldAp,0.125,7,7,GAAGAGGCGGCCACGAGAAA,0,1124775
fldAp,0.125,7,7,GAAGAATGTGGAAATTTCTA,0,1098575
fldAp,0.125,7,7,GAAGAAGTAGACGTTGATTG,0,1103284
fldAp,0.125,7,7,GAACTTGGCCTTTATGCACA,0,1122166
fldAp,0.125,7,7,GAACTGACTGTCTGCCGTTA,0,1147115
fldAp,0.125,7,7,GAACGTGCGTAGGCCCATCT,0,1094131
fldAp,0.125,7,7,GAACCAATCATAGTTGCCCC,0,1105389
fldAp,0.125,7,7,GAAATGAGCAAGCGATAGGA,0,1096031
fldAp,0.125,7,7,GAAATCGAGTTGGTGAAGAA,0,1130434
fldAp,0.125,7,7,GAAATCAGCGACGCGTCTCA,0,1090127
fldAp,0.125,7,7,GAAATAACGCTTGTGTAATA,0,1106711
fldAp,0.125,7,7,GAAACGGAGGCTGAATGTCT,0,1081455
fldAp,0.125,7,7,CTTTTCCAAGAGGTTCGTAG,0,1101392
fldAp,0.125,7,7,CTTTTAAATAATCGGTGGTA,0,1164278
fldAp,0.125,7,7,CTTTGCTCATAGCGCCGCGA,0,1153454
fldAp,0.125,7,7,CTTTGAAGCAGTGGATGACC,0,1147104
fldAp,0.125,7,7,CTTTCAAGGTCACGTGCTTA,0,1113635
fldAp,0.125,7,7,CTTTCAACACGCGGCATAGG,0,1176885
fldAp,0.125,7,7,CTTTACACGGACACGCTCCT,0,1085528
fldAp,0.125,7,7,CTTTAACGAGCGGTCAGCTT,0,1149348
fldAp,0.125,7,7,CTTGGGTAGCGACCAATCAG,0,1121642
fldAp,0.125,7,7,CTTGGGACTTGCATTCTTGT,0,1066448
fldAp,0.125,7,7,CTTGCTCATAGCCATTGGGA,0,1123505
fldAp,0.125,7,7,CTTCTTATGTAGGTTCAAGT,0,1165400
fldAp,0.125,7,7,CTTCGTGCCTTATCACGTCT,0,1133078
fldAp,0.125,7,7,CTTCGTATGGTTTCTGGTCA,0,1153362
fldAp,0.125,7,7,CTTCGGTCCCCCAATCCCGA,0,1148464
fldAp,0.125,7,7,CTTCGGGCACCCTAAGCAGG,0,1126729
fldAp,0.125,7,7,CTTCCAAGAAGACCTGGGTG,0,1088925
fldAp,0.125,7,7,CTTATCGGGGAATGGGTAGT,0,1065326
fldAp,0.125,7,7,CTTATAGAAGCGGCTGGTCT,0,1150578
fldAp,0.125,7,7,CTTAGCATCCCGTATAAACG,0,1148298
fldAp,0.125,7,7,CTGTTTGTTGGTCCTATATT,0,1149195
fldAp,0.125,7,7,CTGTTGCCGATTCTATATAG,0,1115379
fldAp,0.125,7,7,CTGTTAGGCGAATCTTGGGA,0,1075475
fldAp,0.125,7,7,CTGTGTTGTAAGCGTTCATC,0,1125196
fldAp,0.125,7,7,CTGTGTTAATCGTAGGGGGG,0,1145386
fldAp,0.125,7,7,CTGGGCCCTATTCGCACTGC,0,1138189
fldAp,0.125,7,7,CTGGCCCGTCCAGGATGAAG,0,1118246
fldAp,0.125,7,7,CTGGCCATCGGTATTTCATC,0,1110827
fldAp,0.125,7,7,CTGGCATTCGTACGTTATGT,0,1142725
fldAp,0.125,7,7,CTGGATCCTCCTAGGCATCA,0,1111910
fldAp,0.125,7,7,CTGGAAAGTAGTAGTAAAAA,0,1076903
fldAp,0.125,7,7,CTGCTTGTCAATCACCGACT,0,1155718
fldAp,0.125,7,7,CTGCTTGCTAAAGCGCAGTT,0,1117523
fldAp,0.125,7,7,CTGCTAGCTTCCGTTCTCAG,0,1092134
fldAp,0.125,7,7,CTGCGGTACCCCGAATCTTT,0,1069890
fldAp,0.125,7,7,CTGATCATGGCACTTCTCCT,0,1185255
fldAp,0.125,7,7,CTGATCATCGGCCCTGCTGG,0,1184503
fldAp,0.125,7,7,CTGACGAGGATCCTACACAC,0,1109866
fldAp,0.125,7,7,CTGAAACTCAGTGATAGTAA,0,1126996
fldAp,0.125,7,7,CTCTGGGGGGGTCCACTAAC,0,1081527
fldAp,0.125,7,7,CTCTGATCTAAGTTCAGATA,0,1178565
fldAp,0.125,7,7,CTCTCGCTATGTCGCGTCTT,0,1104510
fldAp,0.125,7,7,CTCTCACTGCTTAACGCACC,0,1106730
fldAp,0.125,7,7,CTCGTGGTAAGTGACATGGG,0,1141541
fldAp,0.125,7,7,CTCGATTGCCGCCGTGCCCA,0,1108442
fldAp,0.125,7,7,CTCGAGTGACAACCACAGCT,0,1183143
fldAp,0.125,7,7,CTCGAAGAGTCCTGACTTCA,0,1104182
fldAp,0.125,7,7,CTCCTGGCTTTGCGTGCACC,0,1077317
fldAp,0.125,7,7,CTCCATACTTGCCTGCGAAG,0,1169046
fldAp,0.125,7,7,CTCCACACTTCGCTTCTGAA,0,1151056
fldAp,0.125,7,7,CTCACGACATGAATGTGCGG,0,1116684
fldAp,0.125,7,7,CTCACCTCTTGTGCCCAACG,0,1180325
fldAp,0.125,7,7,CTCAAGACCATCACTATAGG,0,1111540
fldAp,0.125,7,7,CTCAAAGTTCTGCAAACTAC,0,1171290
fldAp,0.125,7,7,CTATTTGTTCCAGTGGACCT,0,1145648
fldAp,0.125,7,7,CTATTGGCATTCCCCGTGGA,0,1132205
fldAp,0.125,7,7,CTATTGGCAGCTATGATAGT,0,1077839
fldAp,0.125,7,7,CTATTCGACGAGCTGTACGA,0,1091621
fldAp,0.125,7,7,CTATGCAACAAAGCCCCTGA,0,1162487
fldAp,0.125,7,7,CTATGAGGGTAAATCTCGCC,0,1148968
fldAp,0.125,7,7,CTATAGTATACAACTTAGTA,0,1073998
fldAp,0.125,7,7,CTAGTTTGGTCTGCTGAGTA,0,1180691
fldAp,0.125,7,7,CTAGTTCCCAACTAGGCATA,0,1126634
fldAp,0.125,7,7,CTAGAGTCGCGTTGTCCTGT,0,1101277
fldAp,0.125,7,7,CTAGAGACTGCAGGTGAAGC,0,1075152
fldAp,0.125,7,7,CTAGAGAAGGTACGTACCTT,0,1073512
fldAp,0.125,7,7,CTAGAAATAACTGTGTCACC,0,1097054
fldAp,0.125,7,7,CTACGTCGTTAACAGCCGAC,0,1093962
fldAp,0.125,7,7,CTACGCTGGGGTTAGACGCG,0,1108225
fldAp,0.125,7,7,CTACAATTACTCGTTCGGAC,0,1087421
fldAp,0.125,7,7,CTAATAGGCTCTTGTTTTTA,0,1144935
fldAp,0.125,7,7,CTAAGAACGTCGAGAATTAT,0,1089256
fldAp,0.125,7,7,CTAACGTCCTCTGCGGAACA,0,1167783
fldAp,0.125,7,7,CTAACGACACCATGAACAGT,0,1137537
fldAp,0.125,7,7,CTAACAGGATCGACACGTGA,0,1137374
fldAp,0.125,7,7,CTAAAAGGCGGTGTACTTGA,0,1112482
fldAp,0.125,7,7,CGTTTAGGCTAAGGCGAACG,0,1088299
fldAp,0.125,7,7,CGTTGGTTGCGGTGCATTAG,0,1173890
fldAp,0.125,7,7,CGTTGGACCATAGATACTTA,0,1115375
fldAp,0.125,7,7,CGTTCTCTGGCGCACTTGAT,0,1103662
fldAp,0.125,7,7,CGTTCGAGCGCCTAACCAGG,0,1072857
fldAp,0.125,7,7,CGTTCATCGGCACCCACACA,0,1163859
fldAp,0.125,7,7,CGTTCAGTCAGTTTTTTGCG,0,1119883
fldAp,0.125,7,7,CGTTACTTCTTTTAGATAAT,0,1115030
fldAp,0.125,7,7,CGTTACATTTCAGAGCGGGA,0,1164094
fldAp,0.125,7,7,CGTGTCATGGGAAAGCTCTG,0,1081150
fldAp,0.125,7,7,CGTGTACTGCTAAATACGGT,0,1173136
fldAp,0.125,7,7,CGTGGGCTGCTCTTTATTAT,0,1131007
fldAp,0.125,7,7,CGTGCTCTAATTTGCTCTCG,0,1156009
fldAp,0.125,7,7,CGTGCTAGCATCCGACCGGA,0,1162216
fldAp,0.125,7,7,CGTGCCCTATATATGCATTT,0,1138105
fldAp,0.125,7,7,CGTGCATCTTAGCGGTAATA,0,1157335
fldAp,0.125,7,7,CGTCTGCTCTTCAGATGAAC,0,1167774
fldAp,0.125,7,7,CGTCTACCAAACTTCCTCGT,0,1112476
fldAp,0.125,7,7,CGTCGATATCCCAACGATGG,0,1176832
fldAp,0.125,7,7,CGTCCCCCTCCTCAAGACGC,0,1143961
fldAp,0.125,7,7,CGTCCAATAATTATAAGTAA,0,1171981
fldAp,0.125,7,7,CGTCCAAAACTCATCCACTA,0,1170230
fldAp,0.125,7,7,CGTCACGTTTTCCGGATTCC,0,1137305
fldAp,0.125,7,7,CGTCACCAGATGACGTACAG,0,1069386
fldAp,0.125,7,7,CGTCAAGGCGCGGCTATTCT,0,1177028
fldAp,0.125,7,7,CGTATGGCGCAATCACGTAT,0,1084658
fldAp,0.125,7,7,CGTAATTTAAACTTTAGCTA,0,1170513
fldAp,0.125,7,7,CGTAAAGCGTGCGTATTTTC,0,1065398
fldAp,0.125,7,7,CGGTTCTAGAATGTGTCCTG,0,1149291
fldAp,0.125,7,7,CGGTGCCGAGTCAAATTGAG,0,1097070
fldAp,0.125,7,7,CGGTCTGTATAGTGTAATCG,0,1157151
fldAp,0.125,7,7,CGGTCCCGGGTCTTAATAAA,0,1181538
fldAp,0.125,7,7,CGGGTTAAGAAATAGCTCGA,0,1160855
fldAp,0.125,7,7,CGGGTGGAGCAGTTATAAAA,0,1081405
fldAp,0.125,7,7,CGGGTCCCGGAAATAAAGCA,0,1111648
fldAp,0.125,7,7,CGGGTCAGTGCTAACGGGTC,0,1090780
fldAp,0.125,7,7,CGGGATAATGGACAACGCGA,0,1106199
fldAp,0.125,7,7,CGGGAGGCTGGGCTTCTGTT,0,1095214
fldAp,0.125,7,7,CGGGACCATGTACGGCTCTT,0,1167789
fldAp,0.125,7,7,CGGCTCGCTGTCACACCGGG,0,1186690
fldAp,0.125,7,7,CGGCTAAACAGGCTGTGAGG,0,1177810
fldAp,0.125,7,7,CGGCAACGGAGAAAGCGAGC,0,1115991
fldAp,0.125,7,7,CGGATGAGCTTCTAACTAAC,0,1111965
fldAp,0.125,7,7,CGGATCAACCGACGACGATA,0,1077648
fldAp,0.125,7,7,CGGATATGCTATATTTACCA,0,1118921
fldAp,0.125,7,7,CGGACGTGTGGGTAAGCCGT,0,1104771
fldAp,0.125,7,7,CGGACATTCAATCGCGCGAC,0,1113539
fldAp,0.125,7,7,CGGACACCAGTAAGGGCCAT,0,1150602
fldAp,0.125,7,7,CGGAATTCGTTCTAAACGGG,0,1086141
fldAp,0.125,7,7,CGGAACATGGCGACGGCTAC,0,1127030
fldAp,0.125,7,7,CGCTTTGGGGCGTGCAATAT,0,1165464
fldAp,0.125,7,7,CGCTTTCCCGAAAATTGTAT,0,1134043
fldAp,0.125,7,7,CGCTTGTTGGAGATCCAGAA,0,1179531
fldAp,0.125,7,7,CGCTTCCCAAATATGCTGTT,0,1065129
fldAp,0.125,7,7,CGCTTCACTTGGATAACAAT,0,1154495
fldAp,0.125,7,7,CGCTGGCACCGTCCCCGTTT,0,1140768
fldAp,0.125,7,7,CGCTGACTCCCGAGTCTATG,0,1099298
fldAp,0.125,7,7,CGCTCGTCGCCTAAGAGTCC,0,1116033
fldAp,0.125,7,7,CGCGTTGGCCGCAATTTGTC,0,1098826
fldAp,0.125,7,7,CGCGTTGCCGTACAGCGAAA,0,1076150
fldAp,0.125,7,7,CGCGTTCGTACATTGTTAGT,0,1114067
fldAp,0.125,7,7,CGCGCTGGCTGGTTAACATT,0,1089447
fldAp,0.125,7,7,CGCGCATCGTCCACCGTGTA,0,1144862
fldAp,0.125,7,7,CGCGAGATCTTCCGTAAATA,0,1101217
fldAp,0.125,7,7,CGCCTTTCTAAAGGCTGCCG,0,1072237
fldAp,0.125,7,7,CGCCTCTATACCTCTGTTGC,0,1153837
fldAp,0.125,7,7,CGCATTTCATTAGGTATTAT,0,1066151
fldAp,0.125,7,7,CGCATGTCATCCCGGGGCTT,0,1123336
fldAp,0.125,7,7,CGCATGGGCGCGATATCAGG,0,1089521
fldAp,0.125,7,7,CGCATGGATAACCGTACTGG,0,1151392
fldAp,0.125,7,7,CGCATAGGAACATCTGTATA,0,1100687
fldAp,0.125,7,7,CGCAGGAGGCAGGGTTGGAG,0,1097820
fldAp,0.125,7,7,CGCAGCAAGAACTGTCTCAT,0,1163395
fldAp,0.125,7,7,CGATTCAATCGCACGGAAAT,0,1142732
fldAp,0.125,7,7,CGATCGGTCTACACCCCGAA,0,1150407
fldAp,0.125,7,7,CGATCCGTTCTGCAATGGGT,0,1094415
fldAp,0.125,7,7,CGATCATCGTGGTGAAGCCC,0,1152115
fldAp,0.125,7,7,CGATATAAAAGGTGCACGGA,0,1134025
fldAp,0.125,7,7,CGATACCGATAGTAGAAGAT,0,1073725
fldAp,0.125,7,7,CGAGGAGGTACCGTAGCAAT,0,1066705
fldAp,0.125,7,7,CGAGCTGCTGATCTCTGGGT,0,1157028
fldAp,0.125,7,7,CGAGCCCATCGAGGGCTCAC,0,1112638
fldAp,0.125,7,7,CGAGCACATATGCATATGCA,0,1149188
fldAp,0.125,7,7,CGAGATAGGACGGGTTACTC,0,1140541
fldAp,0.125,7,7,CGAGAAGGCAGAAACACGAT,0,1109379
fldAp,0.125,7,7,CGACTTCGGTGTTGCCTAAT,0,1103342
fldAp,0.125,7,7,CGACTCGATCTCTCGCTCGG,0,1112567
fldAp,0.125,7,7,CGACGTATGGTGCGGCGCAA,0,1066881
fldAp,0.125,7,7,CGACGAAAAGGGACCACTAC,0,1159063
fldAp,0.125,7,7,CGACCGCGTATGCTTCTTAA,0,1092174
fldAp,0.125,7,7,CGAATTAACAGACATTCGAA,0,1163460
fldAp,0.125,7,7,CGAATACATACTATCGGACT,0,1137651
fldAp,0.125,7,7,CGAACAGCTCGACCAAAGTC,0,1185247
fldAp,0.125,7,7,CGAAATAACACCGACCGATA,0,1126822
fldAp,0.125,7,7,CGAAAGTGGCTCCATACAGA,0,1077625
fldAp,0.125,7,7,CCTTTTTCAGGAGATTCTTG,0,1143741
fldAp,0.125,7,7,CCTTGTCGTATACGTGCACG,0,1156781
fldAp,0.125,7,7,CCTTCCTCCTACGACCGTTA,0,1115929
fldAp,0.125,7,7,CCTTCCATCATTCGTACGAA,0,1162649
fldAp,0.125,7,7,CCTTAGTTGGGCATGAGACG,0,1177937
fldAp,0.125,7,7,CCTTACATTCAAGTACTGTA,0,1151894
fldAp,0.125,7,7,CCTGTCAACCCGCCCATACA,0,1091238
fldAp,0.125,7,7,CCTGTACTGTACGGGCTCCC,0,1171992
fldAp,0.125,7,7,CCTGCCAGAGTTGTTTATGC,0,1099177
fldAp,0.125,7,7,CCTCTCCTGACCTTACTTTC,0,1186160
fldAp,0.125,7,7,CCTCTAGTGCCCTTCGTTGC,0,1139724
fldAp,0.125,7,7,CCTCGTGTCACAAATACTTG,0,1132432
fldAp,0.125,7,7,CCTCCGGGGATTCACACCCC,0,1107837
fldAp,0.125,7,7,CCTCCGGAACAAGGGTTTGT,0,1152112
fldAp,0.125,7,7,CCTCCACTCAAATAAATCCT,0,1144722
fldAp,0.125,7,7,CCTATTCCCCTACTTGTCGG,0,1179387
fldAp,0.125,7,7,CCTATACTGCTGAGCGTTAT,0,1179359
fldAp,0.125,7,7,CCTAATATCATGGTCTTGTT,0,1141082
fldAp,0.125,7,7,CCTAACCCTCGCCCAGTCAA,0,1160051
fldAp,0.125,7,7,CCGTTCGATGAAGACGATGG,0,1175849
fldAp,0.125,7,7,CCGTGCTCCGTTGCGATGCT,0,1138309
fldAp,0.125,7,7,CCGTCGTAGAATTTTACGGG,0,1126636
fldAp,0.125,7,7,CCGTCGCTTCCATGTGGATA,0,1111338
fldAp,0.125,7,7,CCGGTGAGTGGGGCTAGCAA,0,1152268
fldAp,0.125,7,7,CCGGTCTTTCACGAGACAAA,0,1141631
fldAp,0.125,7,7,CCGGGTAGGTGGCCGCCCGA,0,1161100
fldAp,0.125,7,7,CCGGGGCGTTAGTTCTCCAA,0,1065428
fldAp,0.125,7,7,CCGGGGCCATTTCCGTGGGA,0,1102547
fldAp,0.125,7,7,CCGGCTCGAACTGTATTCGC,0,1076236
fldAp,0.125,7,7,CCGGATTGATCCGGATAGGG,0,1164767
fldAp,0.125,7,7,CCGGAGGTCTAGACTTAGTG,0,1153738
fldAp,0.125,7,7,CCGGAGGACATCCGTCTGGC,0,1186899
fldAp,0.125,7,7,CCGGACTTATAGTCCATCGT,0,1108883
fldAp,0.125,7,7,CCGCTGATATTGAAGTACGT,0,1119387
fldAp,0.125,7,7,CCGCTCGCAGTCTTAATTAG,0,1076638
fldAp,0.125,7,7,CCGCGCGCACTTCGCGAACC,0,1092928
fldAp,0.125,7,7,CCGCGCCGGAGAAAGTACTT,0,1183960
fldAp,0.125,7,7,CCGCGCCCGCAACACGGTAA,0,1063098
fldAp,0.125,7,7,CCGCACGTGCCGTTCGCGTA,0,1137472
fldAp,0.125,7,7,CCGCACATTGTACGGCGGAG,0,1090272
fldAp,0.125,7,7,CCGAGGATTGACCCTGGTAG,0,1174299
fldAp,0.125,7,7,CCGACTCTACATGTCGCTTA,0,1110679
fldAp,0.125,7,7,CCGACGTCCGATTGAACGCA,0,1134330
fldAp,0.125,7,7,CCGACGCCGGCGACGCTACG,0,1096393
fldAp,0.125,7,7,CCGAACGGTGCTTAGCTCTT,0,1182443
fldAp,0.125,7,7,CCCTTTAATGACCTCATGCT,0,1167152
fldAp,0.125,7,7,CCCTGTCCAGGGATTAAATC,0,1150064
fldAp,0.125,7,7,CCCTGGGTTAGCAAGAATCC,0,1102807
fldAp,0.125,7,7,CCCTGCAACTGGAAACAATT,0,1144793
fldAp,0.125,7,7,CCCGTGCATCCAGTAACCAG,0,1167628
fldAp,0.125,7,7,CCCGTCCCCATGAACCGTCC,0,1100239
fldAp,0.125,7,7,CCCGGTCTCTTTACTCACGA,0,1132132
fldAp,0.125,7,7,CCCGGGTTGCCAGGAATGAG,0,1071945
fldAp,0.125,7,7,CCCGATAAGGGAGGGTAACG,0,1148767
fldAp,0.125,7,7,CCCCTGCCGGAGTGCGCTGA,0,1170780
fldAp,0.125,7,7,CCCCTATGGTTTGAGTGATA,0,1163821
fldAp,0.125,7,7,CCCCGTTGAAGGAACCGAAA,0,1181058
fldAp,0.125,7,7,CCCATTTCGAAAAACCATCA,0,1185945
fldAp,0.125,7,7,CCCATACTGATAATTTGTGT,0,1141539
fldAp,0.125,7,7,CCCATACGTAGGGTCTTAGT,0,1081871
fldAp,0.125,7,7,CCCAAGTGCCCATGTAGCCA,0,1114764
fldAp,0.125,7,7,CCCAAGGTATGTCGCGTAAT,0,1085437
fldAp,0.125,7,7,CCCAAGGGCTCATACAGTTC,0,1072082
fldAp,0.125,7,7,CCATGGTAATACGGGAGGGC,0,1104492
fldAp,0.125,7,7,CCATGGAACTGATGTGCTGG,0,1075288
fldAp,0.125,7,7,CCATGAGAGCGCTTTAACAA,0,1169355
fldAp,0.125,7,7,CCATCACGCTTAGATACTGT,0,1159669
fldAp,0.125,7,7,CCATCACGCGGTCGGATCGT,0,1095246
fldAp,0.125,7,7,CCATATGAACGGTGGATCTT,0,1168139
fldAp,0.125,7,7,CCATACGGGACCGGACACTC,0,1113878
fldAp,0.125,7,7,CCATACGCCCCAGATTATAC,0,1096928
fldAp,0.125,7,7,CCAGGTGAATCGCGGGGGAC,0,1158467
fldAp,0.125,7,7,CCAGATTGACAAAATGAGGG,0,1129500
fldAp,0.125,7,7,CCAGAACCTACCGTGCATTC,0,1144463
fldAp,0.125,7,7,CCACTGGCGTGACGAAATTT,0,1175951
fldAp,0.125,7,7,CCACTCCGGACATGGACAGT,0,1170080
fldAp,0.125,7,7,CCACTAATCTACCATAGTCG,0,1094241
fldAp,0.125,7,7,CCACGGTAACGGTTGGGGTG,0,1120341
fldAp,0.125,7,7,CCAATTATCTAGGAGAAGCG,0,1112388
fldAp,0.125,7,7,CCAAGCACCATCATTAAGGT,0,1153680
fldAp,0.125,7,7,CCAAATGGTATAGCGGCTGA,0,1154136
fldAp,0.125,7,7,CCAAATAGCTTGGATGGGTT,0,1097241
fldAp,0.125,7,7,CATTTGCGCCTCCGTTGGGT,0,1136410
fldAp,0.125,7,7,CATGTTGGGAGCCGGGCTTA,0,1160875
fldAp,0.125,7,7,CATGTTCTTAGCTACCCGTG,0,1137167
fldAp,0.125,7,7,CATGTAAATCGCTGATCCGG,0,1170240
fldAp,0.125,7,7,CATGGGCCACTTAGGGGCCT,0,1156559
fldAp,0.125,7,7,CATGCTGCGGACGTGTGGTA,0,1096020
fldAp,0.125,7,7,CATGCGTTGGAGACAAGCGT,0,1064581
fldAp,0.125,7,7,CATGCGTGTTTAGTGGAGTT,0,1115815
fldAp,0.125,7,7,CATGAGACCCTTAGAAGTAG,0,1098712
fldAp,0.125,7,7,CATCGGATATAGTCCATAGT,0,1159480
fldAp,0.125,7,7,CATCGAATCAGATCGATCAG,0,1165132
fldAp,0.125,7,7,CATCCTAGCTGGACGGCACC,0,1179373
fldAp,0.125,7,7,CATCAGATATGGGTGGAGAA,0,1182857
fldAp,0.125,7,7,CATATGGCCGGAGACTGGTC,0,1145404
fldAp,0.125,7,7,CATACCGGCCCCCGCGCTCT,0,1170833
fldAp,0.125,7,7,CATACAATGGAATCAGGGTT,0,1106753
fldAp,0.125,7,7,CATAACCTCAAGGAGCGGGG,0,1128358
fldAp,0.125,7,7,CAGTTTGATCCAAATGCACA,0,1166274
fldAp,0.125,7,7,CAGTGGCGTGACTGGTGCAA,0,1098774
fldAp,0.125,7,7,CAGTCTTTCTTGCAATGCGG,0,1104755
fldAp,0.125,7,7,CAGTCTGTCCGGGACGCTCG,0,1182168
fldAp,0.125,7,7,CAGTCAATCTTGGCCTGACC,0,1068303
fldAp,0.125,7,7,CAGTAACCCGATTACTGCCA,0,1114806
fldAp,0.125,7,7,CAGTAAACTGCCACAACAGT,0,1106194
fldAp,0.125,7,7,CAGGTCGATGACCAGTATCT,0,1086436
fldAp,0.125,7,7,CAGGTATAACTTTGCAGGAT,0,1174449
fldAp,0.125,7,7,CAGGGTTCGTAGTCATCCTT,0,1088525
fldAp,0.125,7,7,CAGGGGCTGTGCTGCCATTG,0,1160336
fldAp,0.125,7,7,CAGGCGCTTCAGTGATCAGG,0,1067466
fldAp,0.125,7,7,CAGGAGTTATTCATCGGTAA,0,1091355
fldAp,0.125,7,7,CAGGAGGCTCCGAGGGATTA,0,1134774
fldAp,0.125,7,7,CAGGAGCTTCCATTCTATTC,0,1083058
fldAp,0.125,7,7,CAGCTCTCGGGTAAAGTCAC,0,1080148
fldAp,0.125,7,7,CAGCTAGGGGAATGGGCCAC,0,1126244
fldAp,0.125,7,7,CAGCCTAAGCGCTAAACGGT,0,1160602
fldAp,0.125,7,7,CAGCCCTCTGTAATTCGGTG,0,1107554
fldAp,0.125,7,7,CAGCCCCCACCATTTGGGTC,0,1105416
fldAp,0.125,7,7,CAGCAATTAAAAACAGGTCT,0,1157338
fldAp,0.125,7,7,CAGAGGCAACGAGTGTACCT,0,1151741
fldAp,0.125,7,7,CAGAGCGTTAACTGGAGGTT,0,1130369
fldAp,0.125,7,7,CAGAGACTGCAGAAAAGTCC,0,1181165
fldAp,0.125,7,7,CAGAAAAATGACTCATTCTT,0,1171661
fldAp,0.125,7,7,CACTTGCCACGGGATACGTC,0,1135209
fldAp,0.125,7,7,CACTTACATCAGGTAGAGAC,0,1063467
fldAp,0.125,7,7,CACTCCAGTGGGTTTGGGGA,0,1110035
fldAp,0.125,7,7,CACTCAGGTTTCGACCCGGC,0,1150073
fldAp,0.125,7,7,CACTATTTTACATAAGCGAA,0,1074721
fldAp,0.125,7,7,CACTAGGCACCTGTTACGGG,0,1078241
fldAp,0.125,7,7,CACTACTACTAAGAGGTTGG,0,1184718
fldAp,0.125,7,7,CACTACGGTCCGGCCATTGC,0,1179199
fldAp,0.125,7,7,CACGTGCGCAGACTGACGCG,0,1160146
fldAp,0.125,7,7,CACGTCCCGTGTCCAACAAC,0,1128823
fldAp,0.125,7,7,CACGTACACCTTGCCCGTGG,0,1076271
fldAp,0.125,7,7,CACCCAATAAGAGATGAACC,0,1176930
fldAp,0.125,7,7,CACCCAAACCGTGTACGGAA,0,1138470
fldAp,0.125,7,7,CACCAGTACAGAATTTAGCG,0,1171615
fldAp,0.125,7,7,CACAAGGATCCCAGTTATCT,0,1069096
fldAp,0.125,7,7,CACAAGCGCAGTAGTGGCCA,0,1143757
fldAp,0.125,7,7,CACAAGCATAATAAGCTCTG,0,1167804
fldAp,0.125,7,7,CAATTCCCACCCGCGAAGCA,0,1179572
fldAp,0.125,7,7,CAATTAGGAGTTGTGCTATA,0,1140095
fldAp,0.125,7,7,CAATGGTAGCAGGGACATAA,0,1084418
fldAp,0.125,7,7,CAATGACATCTCACGGAGGA,0,1181307
fldAp,0.125,7,7,CAATCCGTTAGTTTTCTCGT,0,1174883
fldAp,0.125,7,7,CAATACAAACAGACACACGG,0,1110211
fldAp,0.125,7,7,CAAGTTATGTTTTCCTTTGC,0,1133615
fldAp,0.125,7,7,CAAGTCGAGCACAAAAGTGA,0,1065383
fldAp,0.125,7,7,CAAGGGGTGTCAGTCGGTAT,0,1154067
fldAp,0.125,7,7,CAACGGGAACCGGCTACGGC,0,1163640
fldAp,0.125,7,7,CAACGCACTCCGTGGGTTTC,0,1114387
fldAp,0.125,7,7,CAACAACGGGTGTGATTATA,0,1164001
fldAp,0.125,7,7,CAAAGCCGGGTGTTTGGGGT,0,1091483
fldAp,0.125,7,7,CAAAGATAAAAACCGTATAC,0,1099757
fldAp,0.125,7,7,CAAAGACTACAGTTCTATTG,0,1078941
fldAp,0.125,7,7,CAAAGAAATTCTTGTGACGA,0,1123553
fldAp,0.125,7,7,CAAACTGGGCAATAAATCCC,0,1102571
fldAp,0.125,7,7,CAAACAAACACGCCGCTGGA,0,1106545
fldAp,0.125,7,7,CAAAACAAGGCGTTGTTCAG,0,1131774
fldAp,0.125,7,7,ATTTTGTAACCGGGTAAATA,0,1125128
fldAp,0.125,7,7,ATTTTGATCGCCCTTCTTAG,0,1118916
fldAp,0.125,7,7,ATTTTATCTATCGCCGTTAT,0,1108634
fldAp,0.125,7,7,ATTTGGCCTAGACACTGCCA,0,1136490
fldAp,0.125,7,7,ATTTGACTGTAAATTTCCGT,0,1119292
fldAp,0.125,7,7,ATTTGACCCTGTTGCCCAAT,0,1166890
fldAp,0.125,7,7,ATTTCCCCTTGCGCACTGAG,0,1177159
fldAp,0.125,7,7,ATTGTTTACTGTCAGGTTCA,0,1155580
fldAp,0.125,7,7,ATTGGGTTTGAAGGTGAGGT,0,1156558
fldAp,0.125,7,7,ATTGGGTCAAATAAGGAGCT,0,1076428
fldAp,0.125,7,7,ATTGCGGAGGTGGCCGCTGT,0,1084722
fldAp,0.125,7,7,ATTGACGAGTGAGTTAGTGA,0,1064470
fldAp,0.125,7,7,ATTGAAAGGCTTGTCGTGTC,0,1094622
fldAp,0.125,7,7,ATTCTCAACAATCACGGCTG,0,1087008
fldAp,0.125,7,7,ATTCTATAGTCACGGACCCT,0,1076341
fldAp,0.125,7,7,ATTCAGTCTACGTCGTATTA,0,1126878
fldAp,0.125,7,7,ATTCAGTCATAACCTTACAT,0,1132740
fldAp,0.125,7,7,ATTCAGGCCCATTTCATGAT,0,1179351
fldAp,0.125,7,7,ATTCAGCATGCTAAACAACT,0,1133068
fldAp,0.125,7,7,ATTATGTGAATCTATCTGAC,0,1153343
fldAp,0.125,7,7,ATTATCTTCAGTCCTCTGGT,0,1136241
fldAp,0.125,7,7,ATTATCCACCTCCTTAATGT,0,1114692
fldAp,0.125,7,7,ATTAGAGGTATCCCGTGCAT,0,1166075
fldAp,0.125,7,7,ATTAGACCGGAATAGGACCT,0,1099843
fldAp,0.125,7,7,ATTACTCTACGGCGTAACAA,0,1117062
fldAp,0.125,7,7,ATTACGCAGGGTGGTCATCG,0,1184746
fldAp,0.125,7,7,ATTAAGATAAGCTGGTTCGA,0,1098430
fldAp,0.125,7,7,ATGTTTTGCGCGGTTTTTTA,0,1103277
fldAp,0.125,7,7,ATGTTTCTTAAGCTATTGTA,0,1183597
fldAp,0.125,7,7,ATGTGGCAACCTGAATTCCC,0,1092725
fldAp,0.125,7,7,ATGTCCTTGGCCTAGGTTTA,0,1102685
fldAp,0.125,7,7,ATGTCCTTACAGCTCAGGTC,0,1159595
fldAp,0.125,7,7,ATGTCCTGGTCCCACGCCCT,0,1147041
fldAp,0.125,7,7,ATGTATCGAGTGCTCTGGTG,0,1177140
fldAp,0.125,7,7,ATGTATATGTGCAATGTCAA,0,1146309
fldAp,0.125,7,7,ATGTACAAGAGTGAGGCAAG,0,1163172
fldAp,0.125,7,7,ATGGTCGGTGTTCTTATAAG,0,1103733
fldAp,0.125,7,7,ATGGTAGCGTCCCGAAGATA,0,1171110
fldAp,0.125,7,7,ATGGGTGCAGACGCTTACAA,0,1086762
fldAp,0.125,7,7,ATGGGAGTCACCGGAGTGGG,0,1158376
fldAp,0.125,7,7,ATGGCTCCTTGTCGAGCACT,0,1068874
fldAp,0.125,7,7,ATGGCGCTCGCGGTTGAAGT,0,1119872
fldAp,0.125,7,7,ATGGCGCAGATTTCTTGCCG,0,1149282
fldAp,0.125,7,7,ATGGCCTACTCCTATGGCCG,0,1144184
fldAp,0.125,7,7,ATGGACAGGGAATTGAGACT,0,1070619
fldAp,0.125,7,7,ATGCTCCGCAATCATGATAA,0,1067391
fldAp,0.125,7,7,ATGCTAGCTAGACCAAATCG,0,1097553
fldAp,0.125,7,7,ATGCGTTAGAACTGCGGGAA,0,1145563
fldAp,0.125,7,7,ATGCGCAACTGTTTCAGCTT,0,1152300
fldAp,0.125,7,7,ATGCCATTGCGGTCTAAAGG,0,1134164
fldAp,0.125,7,7,ATGCCATGGGGCTAGAACAG,0,1148460
fldAp,0.125,7,7,ATGCACAAGGAGAATCCACA,0,1186790
fldAp,0.125,7,7,ATGCAAATTCGCTTTGTCAT,0,1172751
fldAp,0.125,7,7,ATGATGATCGAAGAGACGGC,0,1165019
fldAp,0.125,7,7,ATGAGTTTGCGACGTAAAAC,0,1095249
fldAp,0.125,7,7,ATGAGCGTCCAGGGTACTGT,0,1159409
fldAp,0.125,7,7,ATGAGCAAACTAAGTTGTAC,0,1184317
fldAp,0.125,7,7,ATGAGATGTTGGCCTTGAAC,0,1172128
fldAp,0.125,7,7,ATGAGAATTGGTTAGACGTC,0,1126156
fldAp,0.125,7,7,ATGACGTAAACTTAAGAATA,0,1169704
fldAp,0.125,7,7,ATGAAGTGGCCCCCTGACTA,0,1128043
fldAp,0.125,7,7,ATCTTTTTGTAAGAGGAGTA,0,1143873
fldAp,0.125,7,7,ATCTTGGGGGTTGGGGTGGT,0,1114748
fldAp,0.125,7,7,ATCTTAGCCAGTTGGTTCGG,0,1138385
fldAp,0.125,7,7,ATCTGCTAGCTGAAAAAAGA,0,1143906
fldAp,0.125,7,7,ATCTGCGGAAAGAGCGGCAT,0,1185467
fldAp,0.125,7,7,ATCTGCATGGTAATTAAATA,0,1157694
fldAp,0.125,7,7,ATCGCTGCGCAGACCTAGCT,0,1180936
fldAp,0.125,7,7,ATCGATGCTCAGGACGATGC,0,1109141
fldAp,0.125,7,7,ATCGAATACGTATAGCTGTC,0,1136027
fldAp,0.125,7,7,ATCCTCCAGGTCGTGGGAGT,0,1136630
fldAp,0.125,7,7,ATCCGTTATGGGTATGCTAC,0,1087959
fldAp,0.125,7,7,ATCCGGGTGTTGGTCCCTGG,0,1128272
fldAp,0.125,7,7,ATCCGGCCGCGATCTACGTC,0,1116130
fldAp,0.125,7,7,ATCCGGAGCAATCTTAAAAA,0,1147986
fldAp,0.125,7,7,ATCCGCCTCGAGATCGCAAT,0,1142260
fldAp,0.125,7,7,ATCCCGCTTTACATTGCATT,0,1090924
fldAp,0.125,7,7,ATCCCAAATCCCGTGTTAAG,0,1072046
fldAp,0.125,7,7,ATCCATTTCTGCTCGTGTTT,0,1112145
fldAp,0.125,7,7,ATCATGTTTAGGTTCTCAAG,0,1175920
fldAp,0.125,7,7,ATCATGGCGCACTGGCTCGA,0,1101885
fldAp,0.125,7,7,ATCAGGAGTAGGAGATGTAA,0,1114157
fldAp,0.125,7,7,ATCACGGCCCATGTGCCTAA,0,1069496
fldAp,0.125,7,7,ATCACCAAAACGCCTACTGG,0,1135393
fldAp,0.125,7,7,ATATTCGGGTAGATGTACTC,0,1121149
fldAp,0.125,7,7,ATATTAAACGACCCGGATAT,0,1162870
fldAp,0.125,7,7,ATATCGCATGCTCATGGTGG,0,1067978
fldAp,0.125,7,7,ATATAGTGCCGCGCACACGA,0,1168687
fldAp,0.125,7,7,ATAGGACGCTAAAAAAGATG,0,1075051
fldAp,0.125,7,7,ATAGCTGAACGCAATATGCG,0,1123496
fldAp,0.125,7,7,ATAGCCTTGACGCAAATCGT,0,1109481
fldAp,0.125,7,7,ATAGCCGGGCAAGATAGTCA,0,1089425
fldAp,0.125,7,7,ATAGATCTGGCTTAGACCAG,0,1164543
fldAp,0.125,7,7,ATAGATACGATCCCAATATG,0,1157193
fldAp,0.125,7,7,ATAGAGTTGTGACCCGTAGG,0,1158890
fldAp,0.125,7,7,ATAGACTGTAAATTCACTCG,0,1114781
fldAp,0.125,7,7,ATACTTCTGCAGGTCGCCCT,0,1104119
fldAp,0.125,7,7,ATACGTACGTGGCACGGCCA,0,1161179
fldAp,0.125,7,7,ATACGGTAAGGGCGGACAGT,0,1136912
fldAp,0.125,7,7,ATACGCTGTCGGACCGGTGC,0,1140513
fldAp,0.125,7,7,ATACGCAAGACTTACCCGTT,0,1153046
fldAp,0.125,7,7,ATACCCAGGTGAGAACAGAG,0,1105036
fldAp,0.125,7,7,ATACATAATCGTAGACGCTG,0,1095912
fldAp,0.125,7,7,ATACACCTCATTTGCATCGG,0,1139465
fldAp,0.125,7,7,ATAAGTGTAGGGTGTATAGT,0,1089787
fldAp,0.125,7,7,ATAAGAGGGGGATGCAGTGA,0,1115601
fldAp,0.125,7,7,ATAACTGTGTGTTTTCCATG,0,1142114
fldAp,0.125,7,7,AGTTTCGATTTTGGTTGTTA,0,1136973
fldAp,0.125,7,7,AGTTTAAATCTTGTTGATGG,0,1119052
fldAp,0.125,7,7,AGTTTAAATCTCAGGACTCC,0,1081658
fldAp,0.125,7,7,AGTTCCCCGAAGAAGGCCGT,0,1089303
fldAp,0.125,7,7,AGTGGGACCTCCAATTCATT,0,1155830
fldAp,0.125,7,7,AGTGCTAGCGACGGGACAAA,0,1117994
fldAp,0.125,7,7,AGTGCCATCATGGTGAGATT,0,1125674
fldAp,0.125,7,7,AGTGACCCCGGCGACCGTTT,0,1147621
fldAp,0.125,7,7,AGTCTCGTGGTACAGTGAAA,0,1101994
fldAp,0.125,7,7,AGTCGTCTCGTTTTCATGTA,0,1074493
fldAp,0.125,7,7,AGTCGTAGTAGGTCATCACC,0,1176062
fldAp,0.125,7,7,AGTCGTACTTACGAGTTCCG,0,1131537
fldAp,0.125,7,7,AGTCGGCCCACGTAGAACCG,0,1133047
fldAp,0.125,7,7,AGTCGAGCTCAACACCATCC,0,1143766
fldAp,0.125,7,7,AGTCACTGGATCTTGTCGTT,0,1153526
fldAp,0.125,7,7,AGTCACGCAGCTCTGTGAAC,0,1121484
fldAp,0.125,7,7,AGTCACAGGCAATAAACCAC,0,1110864
fldAp,0.125,7,7,AGTATAGCGCTTACAGCGAC,0,1087455
fldAp,0.125,7,7,AGTATACTGACTTAAGTCCC,0,1170519
fldAp,0.125,7,7,AGTAGCCTTCAGTGCTGTAA,0,1110713
fldAp,0.125,7,7,AGTAGCCTCACTTAAGGTAC,0,1117534
fldAp,0.125,7,7,AGTAGAAACGCTCACACCCT,0,1149786
fldAp,0.125,7,7,AGTAACCACGCCACCGATCT,0,1134619
fldAp,0.125,7,7,AGGTTAGGATAGGTATTTGG,0,1158633
fldAp,0.125,7,7,AGGTTAAAGTCGCGCGGCGT,0,1070756
fldAp,0.125,7,7,AGGTGTAACAGCGAGACCTT,0,1160430
fldAp,0.125,7,7,AGGTCGCGCATGGATACCTT,0,1075557
fldAp,0.125,7,7,AGGTCCGTCTCACGACGCTT,0,1182509
fldAp,0.125,7,7,AGGTCACGGCGGCCAACCGT,0,1177257
fldAp,0.125,7,7,AGGGTCTTCACCAAGCCCTA,0,1103928
fldAp,0.125,7,7,AGGGTATGCGTCGTGTGGTC,0,1159734
fldAp,0.125,7,7,AGGGTAGCAGTCCGCTGTTT,0,1134302
fldAp,0.125,7,7,AGGGGGCGTACGGGCATCAT,0,1119916
fldAp,0.125,7,7,AGGGGCTTGTATCTGGACAT,0,1150739
fldAp,0.125,7,7,AGGGCTTCCGTACGTGTCAT,0,1088489
fldAp,0.125,7,7,AGGGATGCCACTTCGTCGGT,0,1182158
fldAp,0.125,7,7,AGGGAGGTTCGATGCCCATA,0,1150506
fldAp,0.125,7,7,AGGGAATAGGTGCCGAGGGA,0,1099063
fldAp,0.125,7,7,AGGGAAAAACGCTAGCGGAG,0,1180526
fldAp,0.125,7,7,AGGCCTCTTCATTGCTAGTA,0,1152743
fldAp,0.125,7,7,AGGATATCCGAGTAATTACG,0,1126386
fldAp,0.125,7,7,AGGAGGGGGGTGGTCATTTC,0,1168673
fldAp,0.125,7,7,AGGAGCGCCGACGGGTCTGG,0,1070497
fldAp,0.125,7,7,AGGAATGACGCTTGGGATGT,0,1153898
fldAp,0.125,7,7,AGGAAGCTCCTAACCCGGAT,0,1157232
fldAp,0.125,7,7,AGGAACTGATGTTTAAGAAA,0,1162558
fldAp,0.125,7,7,AGCTCCGAACGCTTAACGAG,0,1134904
fldAp,0.125,7,7,AGCTCACTCCCTTCGTTTTT,0,1129248
fldAp,0.125,7,7,AGCTATCTTGTAAACGTCCG,0,1165901
fldAp,0.125,7,7,AGCTATAGACGTAGTGGTCG,0,1092864
fldAp,0.125,7,7,AGCGGGACCATCAAAACATG,0,1079394
fldAp,0.125,7,7,AGCGCGCCTAACGAGATGCT,0,1096103
fldAp,0.125,7,7,AGCGCATGCAGTTCCTTGTG,0,1184088
fldAp,0.125,7,7,AGCGACCCGAGAATGACTGT,0,1101523
fldAp,0.125,7,7,AGCGAAAGGTTTTCCTCAGG,0,1072669
fldAp,0.125,7,7,AGCCTCAAGAATAGCTGACT,0,1075206
fldAp,0.125,7,7,AGCCGTGCATACTGGGTCTA,0,1129602
fldAp,0.125,7,7,AGCCCGGCAAAATTGGTCGG,0,1169834
fldAp,0.125,7,7,AGCCACCAGCTTCCCTAAGC,0,1151396
fldAp,0.125,7,7,AGCATGCGGACTCGGATGGG,0,1142259
fldAp,0.125,7,7,AGCAGGTGGGTTCGCAGGCT,0,1184026
fldAp,0.125,7,7,AGCAGCATCATAGCGCCACG,0,1105819
fldAp,0.125,7,7,AGCACTTTGGTGAGTAACAG,0,1067528
fldAp,0.125,7,7,AGCACTTCACTACAGGATTT,0,1148660
fldAp,0.125,7,7,AGCACGATGGGGCGCACATT,0,1133393
fldAp,0.125,7,7,AGCACGAGCTGCCATCGCCT,0,1159988
fldAp,0.125,7,7,AGCACCATAGACTCGTCTCT,0,1086382
fldAp,0.125,7,7,AGATGGCCGTCTCGTTGCGT,0,1142659
fldAp,0.125,7,7,AGAGTGCTGAACCATTCCAC,0,1066770
fldAp,0.125,7,7,AGAGGTTGACTGGCTTATAT,0,1176635
fldAp,0.125,7,7,AGAGATCGCTTTGCTTAAAC,0,1090226
fldAp,0.125,7,7,AGAGAGACGTGACCGGAGTT,0,1076705
fldAp,0.125,7,7,AGAGAATCACGAGAGACTTA,0,1145275
fldAp,0.125,7,7,AGACGTTGAGGGCGCAGCAC,0,1186103
fldAp,0.125,7,7,AGACGCTCCCGTGAAATGCT,0,1127602
fldAp,0.125,7,7,AGACGATGATGGATTTAGGA,0,1090538
fldAp,0.125,7,7,AGACATGACTCGGGGCAGGG,0,1137055
fldAp,0.125,7,7,AGACACTCGACCCCATCGGC,0,1157647
fldAp,0.125,7,7,AGAATTCAGGCCGGTCCACA,0,1075417
fldAp,0.125,7,7,AGAATGCGCTCTAAGACTCA,0,1073685
fldAp,0.125,7,7,AGAAGTTGGAGGATTACGGT,0,1136412
fldAp,0.125,7,7,AGAAGTTCACGCGGGACACC,0,1122807
fldAp,0.125,7,7,AGAAGAGAAATTTGAGAACT,0,1151385
fldAp,0.125,7,7,AGAACTTGCGTTGGGAAGAG,0,1067890
fldAp,0.125,7,7,AGAACCGCCTGACAGGTACC,0,1171329
fldAp,0.125,7,7,AGAAAGCCGTACAAATACCT,0,1133421
fldAp,0.125,7,7,ACTTTTTCTGCAACTATGCA,0,1065038
fldAp,0.125,7,7,ACTTTGGAACTATGAGTTAC,0,1169918
fldAp,0.125,7,7,ACTTTGCACCGTTGACCGTT,0,1141950
fldAp,0.125,7,7,ACTTTACAGGCCGTGCAACA,0,1072503
fldAp,0.125,7,7,ACTTGGGGTTCGGACCGTAA,0,1149901
fldAp,0.125,7,7,ACTTGCGGCGTCCAGAGGGT,0,1135207
fldAp,0.125,7,7,ACTTCTGTGTCTGCGAGCCT,0,1143443
fldAp,0.125,7,7,ACTTAGTGGGCGCTGGGTGG,0,1156582
fldAp,0.125,7,7,ACTTACGGTCCACTATGTAA,0,1080869
fldAp,0.125,7,7,ACTTAAGCATTGGATGGATG,0,1069482
fldAp,0.125,7,7,ACTGTTATCGACTGCCTGAT,0,1124787
fldAp,0.125,7,7,ACTGTACAGTATATCTAACA,0,1072054
fldAp,0.125,7,7,ACTGGTCTGGCACTATCTGG,0,1109522
fldAp,0.125,7,7,ACTGGCTAGGGAAGATCCAG,0,1153834
fldAp,0.125,7,7,ACTGCCGCTTCCCACCGCGC,0,1101585
fldAp,0.125,7,7,ACTCTGCTTACGGAACTAGA,0,1084453
fldAp,0.125,7,7,ACTCGTACACTGGAAGACAA,0,1142647
fldAp,0.125,7,7,ACTCCCGTACACATGGAAAT,0,1166347
fldAp,0.125,7,7,ACTCCAAGGTCTGCGTCGGA,0,1065234
fldAp,0.125,7,7,ACTCATGTCCTTTCCTGCCA,0,1140285
fldAp,0.125,7,7,ACTCATCCGATCATATTACA,0,1079295
fldAp,0.125,7,7,ACTCACATTGTTCATAACTG,0,1080003
fldAp,0.125,7,7,ACTATGTTGTCTTAGCATCT,0,1086808
fldAp,0.125,7,7,ACTATCGTCATTGGTAGGTG,0,1076929
fldAp,0.125,7,7,ACTAGGACGGATTGGCAACA,0,1067010
fldAp,0.125,7,7,ACTAGATCTATGACCCCTAG,0,1080684
fldAp,0.125,7,7,ACTACGGATATCAGCGGTAC,0,1069099
fldAp,0.125,7,7,ACTAAACTTGAGGACGCTTT,0,1154768
fldAp,0.125,7,7,ACGTTAGCGAGCCAGAAATC,0,1089567
fldAp,0.125,7,7,ACGTTAAGCGCTTCTTGCCA,0,1122267
fldAp,0.125,7,7,ACGTGTCTACAGTAGGCCTC,0,1135955
fldAp,0.125,7,7,ACGTGTCCACAGACGACTAT,0,1115322
fldAp,0.125,7,7,ACGTACAAACACTGGAAGGG,0,1111294
fldAp,0.125,7,7,ACGTAACGCGGAACTGCCCG,0,1135211
fldAp,0.125,7,7,ACGGGTCTAGCGTTTTCAAT,0,1081539
fldAp,0.125,7,7,ACGGGCAAATTCCCGGTTTG,0,1130054
fldAp,0.125,7,7,ACGGCTTCCACTTAGCAATG,0,1150740
fldAp,0.125,7,7,ACGGCTGTTATGTCAATATG,0,1155458
fldAp,0.125,7,7,ACGGAGAGGCTCGGTTGACA,0,1073188
fldAp,0.125,7,7,ACGGACGGCCCCGACAGGGG,0,1119291
fldAp,0.125,7,7,ACGCTGTGTCAGCTAGATTG,0,1137302
fldAp,0.125,7,7,ACGCGTCCTGGCGCCCTATA,0,1158284
fldAp,0.125,7,7,ACGCGTAGATCGGTTGACTA,0,1157110
fldAp,0.125,7,7,ACGCGCTACCCGGGGAATTG,0,1153521
fldAp,0.125,7,7,ACGCCTCGGCGCTGGAACAA,0,1135525
fldAp,0.125,7,7,ACGCCAGGTGGTAAAGAGAA,0,1106969
fldAp,0.125,7,7,ACGCAAAGCACGCGGACTTC,0,1124340
fldAp,0.125,7,7,ACGAGGAACGAAGTGAATGT,0,1181756
fldAp,0.125,7,7,ACGAGCAAGTCACTGTTTGC,0,1106211
fldAp,0.125,7,7,ACGACGCGCCAGACAAGTAA,0,1145634
fldAp,0.125,7,7,ACGAAGAACCTCGGGGCGGA,0,1085163
fldAp,0.125,7,7,ACCTAAAGTTGGCCAGCGCC,0,1184447
fldAp,0.125,7,7,ACCGTTACTAATCGAGGGAG,0,1149265
fldAp,0.125,7,7,ACCGGGCGAGTCGGGGTTGT,0,1173110
fldAp,0.125,7,7,ACCCTGATATGCTGGTCTTT,0,1083199
fldAp,0.125,7,7,ACCCGATATGATGGTTTTAG,0,1131662
fldAp,0.125,7,7,ACCCCGCATAGAGCCTGTTC,0,1133131
fldAp,0.125,7,7,ACCCCCGCTCGTGTCCGCTC,0,1180766
fldAp,0.125,7,7,ACCCCCATTCCATTATGGCT,0,1125184
fldAp,0.125,7,7,ACCCATCACTACGGGAAGTG,0,1182110
fldAp,0.125,7,7,ACCCATAGTAAGTAGACGAT,0,1148323
fldAp,0.125,7,7,ACCATTACTTCGTCTTTGGC,0,1166088
fldAp,0.125,7,7,ACCATAGTTACCGCTACAGG,0,1180606
fldAp,0.125,7,7,ACCACATTATCTCTATTGGA,0,1121748
fldAp,0.125,7,7,ACATTTTAGCCTTAACACTT,0,1074852
fldAp,0.125,7,7,ACATTGGCAGCCAGCAGGAA,0,1159069
fldAp,0.125,7,7,ACATCGGTCAATCCTATGGA,0,1158256
fldAp,0.125,7,7,ACATCCCATGATTCTGAAAC,0,1079438
fldAp,0.125,7,7,ACAGTGCGCTCCTATGAGGG,0,1126217
fldAp,0.125,7,7,ACAGGTGGTCGGGTGGTTAT,0,1081788
fldAp,0.125,7,7,ACAGGCCAAGGCCAAGAAAG,0,1070113
fldAp,0.125,7,7,ACAGCCGATTGGCGTTGCAT,0,1167689
fldAp,0.125,7,7,ACAGCCAACAACTAAACCAC,0,1088095
fldAp,0.125,7,7,ACAGATTAGCCAAGGCGGGA,0,1164726
fldAp,0.125,7,7,ACACTTAAATAGGAACACTT,0,1128536
fldAp,0.125,7,7,ACACGACTTACGTATAAACG,0,1169333
fldAp,0.125,7,7,ACACATCCCAGCCAAAGGGC,0,1106684
fldAp,0.125,7,7,ACAATGAAACCAACCAAGTG,0,1107990
fldAp,0.125,7,7,ACAAGTATCTTGATAACCTT,0,1103729
fldAp,0.125,7,7,ACAAGGCAGGAGGTCTTTAC,0,1129965
fldAp,0.125,7,7,AATTTTATAGAATCAGCCAG,0,1129504
fldAp,0.125,7,7,AATTTGGTCAAGGCCAAGAT,0,1171647
fldAp,0.125,7,7,AATTTCGCGTGCGGCGCGGC,0,1084844
fldAp,0.125,7,7,AATTGTTCGAGGAACGCACA,0,1098020
fldAp,0.125,7,7,AATTGATTCGACCGTGCCTG,0,1132699
fldAp,0.125,7,7,AATTCGCCTACCTTGGAGTG,0,1113080
fldAp,0.125,7,7,AATTAAAATTCGTCACCTAC,0,1082066
fldAp,0.125,7,7,AATGGTGGATGTGTAGTTTA,0,1091718
fldAp,0.125,7,7,AATGATTAGTTATCATCCCG,0,1153708
fldAp,0.125,7,7,AATCTTCGGCTACTATCAGC,0,1158544
fldAp,0.125,7,7,AATCGCTGCGTATTTACATT,0,1152150
fldAp,0.125,7,7,AATCGAACCGCTTTAAGGTT,0,1071431
fldAp,0.125,7,7,AATCCTCTGCCAAAGACGTC,0,1173533
fldAp,0.125,7,7,AATCATAGAGACCCAAGTCA,0,1084045
fldAp,0.125,7,7,AATATAAGCTTTTATTACCC,0,1083691
fldAp,0.125,7,7,AATAGTCCAAACATGTCCTG,0,1150748
fldAp,0.125,7,7,AATAGAGGGATATTACGGGT,0,1167713
fldAp,0.125,7,7,AATACGTACCAGGTTTTAAT,0,1076227
fldAp,0.125,7,7,AATACGGTTTCAATCAATGA,0,1112496
fldAp,0.125,7,7,AATAACAACGGGGTGTCGGA,0,1168048
fldAp,0.125,7,7,AAGTTCGCATCTCTAGGAGG,0,1125310
fldAp,0.125,7,7,AAGTTAGGGATTTCTACGCA,0,1150873
fldAp,0.125,7,7,AAGTGGCTGCGGCCGAAGAC,0,1089348
fldAp,0.125,7,7,AAGTGCAAGAGGTTTGAGTG,0,1186746
fldAp,0.125,7,7,AAGTCGCTTAGCTACCTGGG,0,1138826
fldAp,0.125,7,7,AAGTATAAAGGTTTCGTTCT,0,1183299
fldAp,0.125,7,7,AAGTAGTGGGTGTCCCGGCT,0,1129098
fldAp,0.125,7,7,AAGTACCCGTATTTGTGACT,0,1089791
fldAp,0.125,7,7,AAGTAAGGTAGGATTGCCAG,0,1074487
fldAp,0.125,7,7,AAGGTGATGATTTAGAGGAC,0,1142968
fldAp,0.125,7,7,AAGGAAGTCCACGACTGCGA,0,1087203
fldAp,0.125,7,7,AAGCGTCGCCGTACGGGTAC,0,1148712
fldAp,0.125,7,7,AAGCGTCCCAGCGACCCTAT,0,1114661
fldAp,0.125,7,7,AAGCGAGTGTGGGAGATTTG,0,1157545
fldAp,0.125,7,7,AAGCATTATTGATCGTCAGT,0,1096407
fldAp,0.125,7,7,AAGCACAGCTAACCACCACG,0,1183806
fldAp,0.125,7,7,AAGATATCGCCATCCCGATT,0,1139893
fldAp,0.125,7,7,AAGAGTGAACTGCGGTTAGA,0,1079713
fldAp,0.125,7,7,AAGAGACAGATTCGATGAGC,0,1165041
fldAp,0.125,7,7,AAGACTTTCCTAGTCTCGGG,0,1092671
fldAp,0.125,7,7,AAGACATTAACGTGTTTGGA,0,1171052
fldAp,0.125,7,7,AACTTCCACCCTCTTCCTGT,0,1168672
fldAp,0.125,7,7,AACTCTAGCGGATAGGTTAG,0,1167604
fldAp,0.125,7,7,AACTCCACTACGATTTTACA,0,1123567
fldAp,0.125,7,7,AACTAGATTTTCTACTAAAT,0,1151695
fldAp,0.125,7,7,AACGTTTGGTGGGCCGCGGC,0,1104897
fldAp,0.125,7,7,AACGTGGGAAGACGTTTTCT,0,1176825
fldAp,0.125,7,7,AACGGCCAGTAGGTCCTAAA,0,1064705
fldAp,0.125,7,7,AACGCCCCAGCGGACACCGA,0,1168866
fldAp,0.125,7,7,AACGCCAGTAAATAGTGAGA,0,1165855
fldAp,0.125,7,7,AACGAGTAAGGTCAGGGTCC,0,1097321
fldAp,0.125,7,7,AACCGCGTGAAAATGGTGTT,0,1148032
fldAp,0.125,7,7,AACCCGGATCAACTCCCGTT,0,1071166
fldAp,0.125,7,7,AACCCGCCGTATGGTTTTCG,0,1095004
fldAp,0.125,7,7,AACCACTGGTTCAAGATTCG,0,1073818
fldAp,0.125,7,7,AAATTGAACTCTTTTGGCAT,0,1127184
fldAp,0.125,7,7,AAATGGACCTTCGTCCCGAG,0,1101230
fldAp,0.125,7,7,AAATCGGACGGGTGCGGGTC,0,1152773
fldAp,0.125,7,7,AAATCCCTAGTGTCTCGTCT,0,1129038
fldAp,0.125,7,7,AAAGGTGAGGTACAGGCAGC,0,1064686
fldAp,0.125,7,7,AAAGGGGAAGCGCTCTGGGT,0,1090260
fldAp,0.125,7,7,AAAGCTGATTTTACACGTCA,0,1083402
fldAp,0.125,7,7,AAAGCTAACCTAGAACCTTC,0,1110823
fldAp,0.125,7,7,AAAGCAAAGTAACTCTAATA,0,1072505
fldAp,0.125,7,7,AAAGAACCCTCAGGCGCTAT,0,1073434
fldAp,0.125,7,7,AAAGAAATGCAGTGGTTTCA,0,1089545
fldAp,0.125,7,7,AAACGAGGGTCAGGGCAAGA,0,1170914
fldAp,0.125,7,7,AAACAGGGCATCGGATGCCC,0,1123397
fldAp,0.125,7,7,AAACACTAATTGCAGGAACA,0,1087377
fldAp,0.125,7,7,AAACACGGGATAAGGGTCCT,0,1064064
fldAp,0.125,7,7,AAAAGGGCATTGCCCCCGAT,0,1110596
fldAp,0.125,7,7,AAAAGCTTCATTGTATCAGG,0,1138201
fldAp,0.125,7,7,AAAACGTGTCGGTTAGTATT,0,1158226
fldAp,0.125,7,7,AAAACCCAGCTAGAGTATTC,0,1086882
fldAp,0.125,7,7,AAAAATTATAATTATGTTCC,0,1116710
fldAp,0.125,7,7,AAAAAGGCTGTCGAACCGGA,0,1143535
fldAp,0.125,7,7,AAAAAAACATCTGCTGGCGC,0,1160006
fldAp,0.14285714285714285,6,6,TTTTTTGTAGGGTCAAGACT,0,1102814
fldAp,0.14285714285714285,6,6,TTTTGTTATCCGCGCTTTAG,0,1090598
fldAp,0.14285714285714285,6,6,TTTTGGGACGGCAAGTGTAA,0,1079997
fldAp,0.14285714285714285,6,6,TTTTCCTAGTTGCCCGATAG,0,1175246
fldAp,0.14285714285714285,6,6,TTTTCATTTTAGGCTGCAGG,0,1181120
fldAp,0.14285714285714285,6,6,TTTTATACAGCCCTAATATT,0,1096170
fldAp,0.14285714285714285,6,6,TTTTAACCATCGCCCCTATG,0,1108507
fldAp,0.14285714285714285,6,6,TTTGTCGTGGAAGCCGGGGA,0,1135599
fldAp,0.14285714285714285,6,6,TTTGGCGATTGGTGATTTCA,0,1161907
fldAp,0.14285714285714285,6,6,TTTGGACAACTATAACGGCT,0,1126629
fldAp,0.14285714285714285,6,6,TTTGCGATTGTGTAGCGCAA,0,1095576
fldAp,0.14285714285714285,6,6,TTTGCCGGCCTGTTATGGAA,0,1099151
fldAp,0.14285714285714285,6,6,TTTGCACAATAGATGTACGA,0,1155844
fldAp,0.14285714285714285,6,6,TTTGATATGATTGCCTGGAA,0,1120496
fldAp,0.14285714285714285,6,6,TTTGAGCATATACGGCCGGT,0,1071322
fldAp,0.14285714285714285,6,6,TTTGAGCACTTGATACCCTT,0,1082683
fldAp,0.14285714285714285,6,6,TTTGAGAGTTATGCATAGGC,0,1074855
fldAp,0.14285714285714285,6,6,TTTGAAAGGAATTGTCACAC,0,1135768
fldAp,0.14285714285714285,6,6,TTTCGCAACAAGAATCAAGT,0,1175995
fldAp,0.14285714285714285,6,6,TTTCGATATCTAGCCGCGCA,0,1065752
fldAp,0.14285714285714285,6,6,TTTCCTTGAATTAGGTTCAA,0,1102065
fldAp,0.14285714285714285,6,6,TTTCATCTCCCCACCACCAT,0,1140806
fldAp,0.14285714285714285,6,6,TTTATGATGTCCCAGAGTAG,0,1158463
fldAp,0.14285714285714285,6,6,TTTATCTGCCGGGGCATGAT,0,1068234
fldAp,0.14285714285714285,6,6,TTTATAAAGCCCGTATGACA,0,1183452
fldAp,0.14285714285714285,6,6,TTTAGTAAAGCCGTTGAGAA,0,1124258
fldAp,0.14285714285714285,6,6,TTGTTTTGGAAGAGTAGAAA,0,1149618
fldAp,0.14285714285714285,6,6,TTGTTTCACCCTGTGGCCGT,0,1095858
fldAp,0.14285714285714285,6,6,TTGTTGGCAGCGAACTTTTA,0,1114112
fldAp,0.14285714285714285,6,6,TTGTCGGGAGAATGCTGGAG,0,1070199
fldAp,0.14285714285714285,6,6,TTGTAGGCAGCTCCGTTGGC,0,1091605
fldAp,0.14285714285714285,6,6,TTGTAAAATTTGATTACTTT,0,1144339
fldAp,0.14285714285714285,6,6,TTGGTATTGAAAACAGCGGT,0,1083102
fldAp,0.14285714285714285,6,6,TTGGGGGAAGACTGCAGTCT,0,1176636
fldAp,0.14285714285714285,6,6,TTGGCGTAAACTGGGGAGGC,0,1158902
fldAp,0.14285714285714285,6,6,TTGGCGGAAGAACCCAGCTT,0,1117186
fldAp,0.14285714285714285,6,6,TTGCGTTCTTCGTATAACTG,0,1144340
fldAp,0.14285714285714285,6,6,TTGCCTCCTCGAGGGGCTTG,0,1157595
fldAp,0.14285714285714285,6,6,TTGCCCTCGACGGAAGGTTT,0,1124432
fldAp,0.14285714285714285,6,6,TTGAGTCTCGCGGGGCCTCA,0,1078368
fldAp,0.14285714285714285,6,6,TTGAGACTATTACTCGCAAA,0,1145462
fldAp,0.14285714285714285,6,6,TTGAAGCGGGCCATGGGCTA,0,1178738
fldAp,0.14285714285714285,6,6,TTGAACTGAAAGGCTACTTG,0,1185871
fldAp,0.14285714285714285,6,6,TTCTTTCGCCGCTTACCTGA,0,1126632
fldAp,0.14285714285714285,6,6,TTCTTGCATGGTTGCGAATC,0,1074166
fldAp,0.14285714285714285,6,6,TTCTTCCACTTAAGTAATAC,0,1071330
fldAp,0.14285714285714285,6,6,TTCTGGGCGATTAGGGTCGG,0,1132790
fldAp,0.14285714285714285,6,6,TTCTGACCTACGGAGATATT,0,1069295
fldAp,0.14285714285714285,6,6,TTCTGACCAGCCGGTAATGA,0,1116583
fldAp,0.14285714285714285,6,6,TTCTGACAGGTAATACATTC,0,1160783
fldAp,0.14285714285714285,6,6,TTCTCAAGACACAGTTAGGT,0,1064376
fldAp,0.14285714285714285,6,6,TTCTATAGGAGCGTGTTCGA,0,1140677
fldAp,0.14285714285714285,6,6,TTCTAGAAATCGCACTGGCG,0,1146448
fldAp,0.14285714285714285,6,6,TTCTAAGTCGGATGGAAAGT,0,1064308
fldAp,0.14285714285714285,6,6,TTCGGTTTCCGGACAGACAT,0,1143515
fldAp,0.14285714285714285,6,6,TTCGGTCTCGACGGAGGATA,0,1078340
fldAp,0.14285714285714285,6,6,TTCGGGCTATAGATCTCCGA,0,1146540
fldAp,0.14285714285714285,6,6,TTCGCGACTGTCTAGCCATT,0,1172799
fldAp,0.14285714285714285,6,6,TTCGCATACGGATTATAGGA,0,1133441
fldAp,0.14285714285714285,6,6,TTCGATAAGGCCAGAGACGC,0,1083211
fldAp,0.14285714285714285,6,6,TTCCTCCCAGCCGATGCGAC,0,1123003
fldAp,0.14285714285714285,6,6,TTCCGGACTTTACTAGCACT,0,1141165
fldAp,0.14285714285714285,6,6,TTCCGCGGCTGAATTGAATA,0,1075737
fldAp,0.14285714285714285,6,6,TTCCGAGGGTGTTGTTGCAG,0,1160182
fldAp,0.14285714285714285,6,6,TTCCCATGGGTAGATAATGT,0,1144392
fldAp,0.14285714285714285,6,6,TTCCAGGGTCAGGTTGACAC,0,1079409
fldAp,0.14285714285714285,6,6,TTCCAGGAGGATGAGCGGGG,0,1085522
fldAp,0.14285714285714285,6,6,TTCCAGCTAAGTCATGAGAT,0,1098874
fldAp,0.14285714285714285,6,6,TTCCAGAAACTTTGTGCAAT,0,1155153
fldAp,0.14285714285714285,6,6,TTCAGTAGAGGACACTTTTG,0,1130806
fldAp,0.14285714285714285,6,6,TTCACGACGCAAGGAACGGG,0,1100260
fldAp,0.14285714285714285,6,6,TTCACACCTTTGTTAGGTTT,0,1154619
fldAp,0.14285714285714285,6,6,TTCAATCGTATAAACTCAGT,0,1164021
fldAp,0.14285714285714285,6,6,TTCAATCAAAGATCCACAGG,0,1162385
fldAp,0.14285714285714285,6,6,TTCAACGGGTTTAGTGTGCC,0,1069485
fldAp,0.14285714285714285,6,6,TTATCGCGCCGTCCGATGGG,0,1126798
fldAp,0.14285714285714285,6,6,TTATACACGTTCAATATGCC,0,1066068
fldAp,0.14285714285714285,6,6,TTAGGTTCCCTTTTGTGATT,0,1067628
fldAp,0.14285714285714285,6,6,TTAGGTACCTATAGTTAGAG,0,1083690
fldAp,0.14285714285714285,6,6,TTAGGGTATCCGTTGAAAGA,0,1131137
fldAp,0.14285714285714285,6,6,TTAGCGAGATGAAAAGGAAA,0,1073666
fldAp,0.14285714285714285,6,6,TTAGCCCGCCGGGGAGAGCA,0,1082489
fldAp,0.14285714285714285,6,6,TTAGAAAGCCCCTAAGTAAC,0,1144512
fldAp,0.14285714285714285,6,6,TTACTGTTGTTGCAACCCGG,0,1103598
fldAp,0.14285714285714285,6,6,TTACTCTCTCGCGAAGGTTA,0,1112072
fldAp,0.14285714285714285,6,6,TTACTCTCGGGTAGCTTGGC,0,1165035
fldAp,0.14285714285714285,6,6,TTACGTGTTCCACATCTACC,0,1174444
fldAp,0.14285714285714285,6,6,TTACCATGTCAACAGAGGTG,0,1116421
fldAp,0.14285714285714285,6,6,TTACATGTGTAATGCCCAAC,0,1134834
fldAp,0.14285714285714285,6,6,TTACATACTGTCGTTTGCAT,0,1137722
fldAp,0.14285714285714285,6,6,TTACAAGGAGTTAGAATATA,0,1090998
fldAp,0.14285714285714285,6,6,TTAATTACCCAGGTGTGATT,0,1183108
fldAp,0.14285714285714285,6,6,TTAAGTTATCGGCCAGTGTG,0,1153909
fldAp,0.14285714285714285,6,6,TTAAGTCCTCTCAACGCGTC,0,1093908
fldAp,0.14285714285714285,6,6,TTAAGACATTAGCACCTGCC,0,1097334
fldAp,0.14285714285714285,6,6,TTAACCCTCCGGGACGAAAA,0,1125563
fldAp,0.14285714285714285,6,6,TTAAAACATAGTAGGTGCAA,0,1139183
fldAp,0.14285714285714285,6,6,TTAAAAAAGGATCGCTCTTT,0,1072970
fldAp,0.14285714285714285,6,6,TGTTGCGATTTGGTTGATAA,0,1136051
fldAp,0.14285714285714285,6,6,TGTTAGAGGAAGCGGGTGAC,0,1110194
fldAp,0.14285714285714285,6,6,TGTTACAAACGTTCGCGCTA,0,1125213
fldAp,0.14285714285714285,6,6,TGTGGTGGAGAATAAGCAGT,0,1184221
fldAp,0.14285714285714285,6,6,TGTGGGATTACCTGTTCGAT,0,1157830
fldAp,0.14285714285714285,6,6,TGTGGCATGCAAGCGTGGAC,0,1150606
fldAp,0.14285714285714285,6,6,TGTGCGCGGCTGGGGGGGAT,0,1100294
fldAp,0.14285714285714285,6,6,TGTGCCGAAACCACTAGAAA,0,1175023
fldAp,0.14285714285714285,6,6,TGTGAGGTACAAAACACATA,0,1091002
fldAp,0.14285714285714285,6,6,TGTGAGAGCTACCTCAAGGT,0,1133260
fldAp,0.14285714285714285,6,6,TGTGAAGGACCTTCAGGGTA,0,1103004
fldAp,0.14285714285714285,6,6,TGTCGTTAGGCCCTGACGGG,0,1092502
fldAp,0.14285714285714285,6,6,TGTCGCAATAGATCCGGGTC,0,1136612
fldAp,0.14285714285714285,6,6,TGTCAGGTTCAGGGAATTTC,0,1153165
fldAp,0.14285714285714285,6,6,TGTCACTTCGTGGGATTTCA,0,1097163
fldAp,0.14285714285714285,6,6,TGTCAACGTCCCTAGGCTTG,0,1116289
fldAp,0.14285714285714285,6,6,TGTATTAACCAGGCCCAGTT,0,1175681
fldAp,0.14285714285714285,6,6,TGTATCCAGTTGGCGCCTGA,0,1088088
fldAp,0.14285714285714285,6,6,TGTACTCTGCACTTGTAATT,0,1072423
fldAp,0.14285714285714285,6,6,TGTACCGCGAGTGGGCATAC,0,1121732
fldAp,0.14285714285714285,6,6,TGTACATGCGTCCGTTGTTC,0,1130714
fldAp,0.14285714285714285,6,6,TGTAAGTAGCTCGCTTATCA,0,1175739
fldAp,0.14285714285714285,6,6,TGTAAGCACCAAAGCCGGAT,0,1137757
fldAp,0.14285714285714285,6,6,TGTAAATGATAACAAGGGTA,0,1137944
fldAp,0.14285714285714285,6,6,TGGTTTTAGTCGTGATCATG,0,1076345
fldAp,0.14285714285714285,6,6,TGGTTACATCGGGATCCAGC,0,1166201
fldAp,0.14285714285714285,6,6,TGGTCAAGTATAACCAAGGC,0,1125929
fldAp,0.14285714285714285,6,6,TGGGTACGGAGCTTCATCCG,0,1175096
fldAp,0.14285714285714285,6,6,TGGGGGAGCTTACATCAGGT,0,1173452
fldAp,0.14285714285714285,6,6,TGGGGCAAGACCGAAGGATT,0,1104913
fldAp,0.14285714285714285,6,6,TGGGGCAAACCGGAGAAGAT,0,1139933
fldAp,0.14285714285714285,6,6,TGGGCTTCCGTTATACTGCC,0,1095918
fldAp,0.14285714285714285,6,6,TGGGCGATTAAAGCTGACCC,0,1085434
fldAp,0.14285714285714285,6,6,TGGGATTGACGTACTTGTTT,0,1159887
fldAp,0.14285714285714285,6,6,TGGCTGTTCAACAGTCCGGG,0,1089388
fldAp,0.14285714285714285,6,6,TGGCTCGTTGCGACGCACGA,0,1113001
fldAp,0.14285714285714285,6,6,TGGCCGCCAGGGCCATTCAA,0,1110041
fldAp,0.14285714285714285,6,6,TGGCACATGAACGCTCGTCC,0,1155013
fldAp,0.14285714285714285,6,6,TGGCAACTAGCGTCAGATAA,0,1092703
fldAp,0.14285714285714285,6,6,TGGATTTTGATTATTACGCT,0,1092127
fldAp,0.14285714285714285,6,6,TGGATATTGGGCTCTGCCTC,0,1147614
fldAp,0.14285714285714285,6,6,TGGAGCTGGCACCCTCGTAT,0,1155815
fldAp,0.14285714285714285,6,6,TGGAGAGCCCGCCCATAGGC,0,1102414
fldAp,0.14285714285714285,6,6,TGGAGACGGATGAGCTAGGT,0,1094688
fldAp,0.14285714285714285,6,6,TGGACTCCCGGCCAAGGATG,0,1099259
fldAp,0.14285714285714285,6,6,TGGACGACATAATTTTCTCA,0,1104625
fldAp,0.14285714285714285,6,6,TGGACAAAACCGACCCCGAC,0,1118923
fldAp,0.14285714285714285,6,6,TGCTTGCCTCTGTCTTGAGA,0,1167254
fldAp,0.14285714285714285,6,6,TGCTTATTTTGACAGGTACT,0,1163988
fldAp,0.14285714285714285,6,6,TGCTGCTGGTCAGTGTAATA,0,1092974
fldAp,0.14285714285714285,6,6,TGCTGCCTTCGTGGGTAGTC,0,1171485
fldAp,0.14285714285714285,6,6,TGCTGATAGGCTGCTTACTG,0,1133075
fldAp,0.14285714285714285,6,6,TGCTAGATTGCAGAATACCC,0,1173775
fldAp,0.14285714285714285,6,6,TGCGGGTATAAAAGGTCCGC,0,1171808
fldAp,0.14285714285714285,6,6,TGCGCTTGGGTGAAATTTTG,0,1126744
fldAp,0.14285714285714285,6,6,TGCCGGAAATTTTTGAAGTT,0,1149780
fldAp,0.14285714285714285,6,6,TGCCCGTATCATGTGGAGAA,0,1082009
fldAp,0.14285714285714285,6,6,TGCCCGGATAGGTCGTCCTT,0,1155161
fldAp,0.14285714285714285,6,6,TGCCCCGTCAGATTTCCTGT,0,1176124
fldAp,0.14285714285714285,6,6,TGCATTTAATAAGTAGGCAT,0,1135769
fldAp,0.14285714285714285,6,6,TGCATAGCCACCTGGGTTAG,0,1109834
fldAp,0.14285714285714285,6,6,TGATTAGGAATTAATCGATA,0,1124485
fldAp,0.14285714285714285,6,6,TGATGGGGTTGTGCGGAGTC,0,1152908
fldAp,0.14285714285714285,6,6,TGATCTGTGATTCCTGTATA,0,1092874
fldAp,0.14285714285714285,6,6,TGATACCTTGGCAGCGGCAT,0,1070389
fldAp,0.14285714285714285,6,6,TGAGTTACAAAGCTCCTGAA,0,1124129
fldAp,0.14285714285714285,6,6,TGAGGAAGTCCGTACGAGGA,0,1122174
fldAp,0.14285714285714285,6,6,TGAGCGCTACGCCAAGGCCA,0,1073508
fldAp,0.14285714285714285,6,6,TGAGAGTATCTTTTTACAAC,0,1181310
fldAp,0.14285714285714285,6,6,TGACTGTCGGGACACGGGGA,0,1139241
fldAp,0.14285714285714285,6,6,TGACTGAGACTCCCTAATTT,0,1157817
fldAp,0.14285714285714285,6,6,TGACTCTAAGACCACTTGGT,0,1095862
fldAp,0.14285714285714285,6,6,TGACCCCTTCGAGGCCAAAC,0,1067821
fldAp,0.14285714285714285,6,6,TGACACAGACTGGGTTATGA,0,1082874
fldAp,0.14285714285714285,6,6,TGAATTACGACGCGGAAGCA,0,1106796
fldAp,0.14285714285714285,6,6,TGAATGTTTAATGGTAGATA,0,1131768
fldAp,0.14285714285714285,6,6,TGAAGGATACTTAAGTCACC,0,1074442
fldAp,0.14285714285714285,6,6,TGAACAGCGCCAGATAGTCG,0,1156608
fldAp,0.14285714285714285,6,6,TGAAATGGGCGGCATCCGAT,0,1144127
fldAp,0.14285714285714285,6,6,TGAAATCTATGTCGAAATAT,0,1096040
fldAp,0.14285714285714285,6,6,TGAAAGCATGGGCGAGGGGT,0,1091741
fldAp,0.14285714285714285,6,6,TCTTGCCTAGTTCACTAAAA,0,1139712
fldAp,0.14285714285714285,6,6,TCTTATAGAAGAAACGTCAT,0,1158562
fldAp,0.14285714285714285,6,6,TCTTACTAGCCCTTTGAGCA,0,1174682
fldAp,0.14285714285714285,6,6,TCTTAACAAGGCATCACACA,0,1115046
fldAp,0.14285714285714285,6,6,TCTGTTGCATAATTGTTGGT,0,1180372
fldAp,0.14285714285714285,6,6,TCTGGTAGCCGCCCATGACA,0,1107018
fldAp,0.14285714285714285,6,6,TCTGGGTTCCTGCGCGGAGA,0,1099359
fldAp,0.14285714285714285,6,6,TCTGGGTCGGGCTGAGGAAA,0,1151508
fldAp,0.14285714285714285,6,6,TCTGGGAAATATTTCTGGTT,0,1172932
fldAp,0.14285714285714285,6,6,TCTGGAATTCACAACTAAGA,0,1103519
fldAp,0.14285714285714285,6,6,TCTGCGTAGTAACGCGTGGT,0,1162042
fldAp,0.14285714285714285,6,6,TCTGCATTGACTTAGTCATG,0,1179624
fldAp,0.14285714285714285,6,6,TCTGATTAGACCTTGATTCA,0,1185239
fldAp,0.14285714285714285,6,6,TCTGAGACCGCCAGTCTCGA,0,1156945
fldAp,0.14285714285714285,6,6,TCTGACAAAGAACTGGTGTG,0,1177449
fldAp,0.14285714285714285,6,6,TCTCTGGTGTGGCAGTGGTG,0,1077188
fldAp,0.14285714285714285,6,6,TCTCCTTCCTCTGTGCGCTT,0,1165574
fldAp,0.14285714285714285,6,6,TCTCCGGGACTCTCGTACAA,0,1182603
fldAp,0.14285714285714285,6,6,TCTCCGACTTCAGGTGCACG,0,1086929
fldAp,0.14285714285714285,6,6,TCTCCAGGAATTTCGGCATG,0,1087831
fldAp,0.14285714285714285,6,6,TCTCCAAGACTTGACGCATC,0,1106233
fldAp,0.14285714285714285,6,6,TCTCATCGCTAGTACGGAGG,0,1114831
fldAp,0.14285714285714285,6,6,TCTCACACTCCCACGCATTA,0,1160013
fldAp,0.14285714285714285,6,6,TCTCAATCCTGAAGTCAGGA,0,1163014
fldAp,0.14285714285714285,6,6,TCTCAATATTTAGCCTCGCT,0,1164333
fldAp,0.14285714285714285,6,6,TCTATCCGTTTTAGAGGTGG,0,1118238
fldAp,0.14285714285714285,6,6,TCTAGGCTCCGTTGGTGTAA,0,1120652
fldAp,0.14285714285714285,6,6,TCTACGATCTAATGTTTGGC,0,1101652
fldAp,0.14285714285714285,6,6,TCTAATCGTTCGGAAAGCCA,0,1082980
fldAp,0.14285714285714285,6,6,TCTAAATGGCGCGTGAAGAC,0,1103533
fldAp,0.14285714285714285,6,6,TCGTGTCACGTTAGTCTTTA,0,1095768
fldAp,0.14285714285714285,6,6,TCGTGGCGTCACGACATTGG,0,1162731
fldAp,0.14285714285714285,6,6,TCGTCTTGCCCGGACATTAC,0,1106388
fldAp,0.14285714285714285,6,6,TCGTCCTGGTCAGAGGGCGA,0,1161671
fldAp,0.14285714285714285,6,6,TCGTAGGCTGCGGACACGTT,0,1179833
fldAp,0.14285714285714285,6,6,TCGTAGAATTCTTCCTGTCC,0,1074687
fldAp,0.14285714285714285,6,6,TCGTACTACACCGAAGTGTC,0,1090863
fldAp,0.14285714285714285,6,6,TCGTAAGAGCTTATAACTTA,0,1185525
fldAp,0.14285714285714285,6,6,TCGGTGGCTACGTGGATCAG,0,1160477
fldAp,0.14285714285714285,6,6,TCGGTACTATATGCAGAGAG,0,1183670
fldAp,0.14285714285714285,6,6,TCGGGCTCATCAGTTAGAAA,0,1072261
fldAp,0.14285714285714285,6,6,TCGGGCACCAGTGGGTTTAA,0,1171835
fldAp,0.14285714285714285,6,6,TCGGGATAGTGAGTTACGTC,0,1154286
fldAp,0.14285714285714285,6,6,TCGCTTCAGGCCCAGTGATC,0,1148167
fldAp,0.14285714285714285,6,6,TCGCTGTGGCCGCGTCCGCA,0,1075429
fldAp,0.14285714285714285,6,6,TCGCTCCTATGCCGAAAGTC,0,1070419
fldAp,0.14285714285714285,6,6,TCGCGTAGGACCCCGTATCA,0,1071926
fldAp,0.14285714285714285,6,6,TCGCGGACCGCTTTTTCTGT,0,1094050
fldAp,0.14285714285714285,6,6,TCGCCTGTCGAGTCTATCCC,0,1081768
fldAp,0.14285714285714285,6,6,TCGATTCGTGCAGGGTTTGG,0,1141299
fldAp,0.14285714285714285,6,6,TCGAGGGCTAGGCACGCATC,0,1076615
fldAp,0.14285714285714285,6,6,TCGACTTTGAGTACGGGTAG,0,1172007
fldAp,0.14285714285714285,6,6,TCGACTCTCTGCCTCAAGAC,0,1153116
fldAp,0.14285714285714285,6,6,TCGAACGTATGACAAATGAA,0,1180775
fldAp,0.14285714285714285,6,6,TCCTTAAGTGTGAGGTCAAA,0,1115870
fldAp,0.14285714285714285,6,6,TCCTCCAGTTTAACGAGAGC,0,1120257
fldAp,0.14285714285714285,6,6,TCCTCATACTGCCGTGCGCC,0,1079788
fldAp,0.14285714285714285,6,6,TCCTCACCTTTTATGTTGTA,0,1109122
fldAp,0.14285714285714285,6,6,TCCTAGTCAGCGGCTCCTAC,0,1095582
fldAp,0.14285714285714285,6,6,TCCTACGGTAAAGCTCGGAG,0,1064020
fldAp,0.14285714285714285,6,6,TCCTAAGGGGGTCTATATTT,0,1090823
fldAp,0.14285714285714285,6,6,TCCGTTGACATAGTGGCTTT,0,1088460
fldAp,0.14285714285714285,6,6,TCCGGTTCCGTTAAGTCGTT,0,1157141
fldAp,0.14285714285714285,6,6,TCCGGTATACATAGTGAATC,0,1182446
fldAp,0.14285714285714285,6,6,TCCGAGTCCGTTTACTATGT,0,1158640
fldAp,0.14285714285714285,6,6,TCCCTTTTTTCTACGGGGAA,0,1126879
fldAp,0.14285714285714285,6,6,TCCCTCAGCGGTCTACAGTC,0,1114052
fldAp,0.14285714285714285,6,6,TCCCGACTGAGTTACATAAG,0,1121760
fldAp,0.14285714285714285,6,6,TCCCCTTGTTATGGCGCGCA,0,1140475
fldAp,0.14285714285714285,6,6,TCCCCGTATGCAGTCCCGGA,0,1113567
fldAp,0.14285714285714285,6,6,TCCCCGAGTCATTCGTCCCT,0,1066859
fldAp,0.14285714285714285,6,6,TCCCCGAGTATCCTAATCGA,0,1085431
fldAp,0.14285714285714285,6,6,TCCATGGAGTGTTGCCGGCG,0,1186536
fldAp,0.14285714285714285,6,6,TCCACCACTACCGGGGCTAT,0,1075045
fldAp,0.14285714285714285,6,6,TCCACAACTCTGATGATAAA,0,1157281
fldAp,0.14285714285714285,6,6,TCCAAGTCAGGCCCTGGGAC,0,1111389
fldAp,0.14285714285714285,6,6,TCATTTCTCCCTGCCAGCAT,0,1065939
fldAp,0.14285714285714285,6,6,TCATGGGTGGGACTTAGTTC,0,1127348
fldAp,0.14285714285714285,6,6,TCATGGGGTTCTAAAATGCC,0,1109793
fldAp,0.14285714285714285,6,6,TCATGGGCACTTGGTGTGCA,0,1145298
fldAp,0.14285714285714285,6,6,TCAGGGCAATCGGCCAATCG,0,1103043
fldAp,0.14285714285714285,6,6,TCAGGCGGGGGATACTCATC,0,1115561
fldAp,0.14285714285714285,6,6,TCAGCGTAATGTAATCTCGT,0,1165022
fldAp,0.14285714285714285,6,6,TCAGCCGGGCGCACTTACTA,0,1124073
fldAp,0.14285714285714285,6,6,TCACTTACTTACAGGCGCCT,0,1177218
fldAp,0.14285714285714285,6,6,TCACTGGTACCCTTGAGCGG,0,1073121
fldAp,0.14285714285714285,6,6,TCACGCTTTCGGGCTGTTTC,0,1091181
fldAp,0.14285714285714285,6,6,TCACCCGACATGTTTGGGTT,0,1091639
fldAp,0.14285714285714285,6,6,TCACCAGGGTTTTTGCCATG,0,1130520
fldAp,0.14285714285714285,6,6,TCACATGAGGCCGCTGTTTC,0,1113752
fldAp,0.14285714285714285,6,6,TCACAGTCACAGGGGTCTCT,0,1100214
fldAp,0.14285714285714285,6,6,TCAATTAAGTTCACTCGGGT,0,1157408
fldAp,0.14285714285714285,6,6,TCAAGAAAAACTATTATGTA,0,1176187
fldAp,0.14285714285714285,6,6,TCAAATTTGTCACTGATAAT,0,1063052
fldAp,0.14285714285714285,6,6,TATTCCCCCGGCAGAGAAAG,0,1165721
fldAp,0.14285714285714285,6,6,TATTCCAAAAACCGTCTGAG,0,1125183
fldAp,0.14285714285714285,6,6,TATGTTAAGTATGGGAAGAA,0,1110555
fldAp,0.14285714285714285,6,6,TATGTACTATAACGGAGTCA,0,1163470
fldAp,0.14285714285714285,6,6,TATGGGTGTAGGACAGTGTG,0,1182632
fldAp,0.14285714285714285,6,6,TATGGAGACACAATTATCTA,0,1119262
fldAp,0.14285714285714285,6,6,TATGCTTACAAGCTTACTAT,0,1135143
fldAp,0.14285714285714285,6,6,TATGCTCCCGAGTTGTAGAC,0,1160143
fldAp,0.14285714285714285,6,6,TATGATTTTCATCTAGCATA,0,1154427
fldAp,0.14285714285714285,6,6,TATGATCAGCGCCAATGTAC,0,1094204
fldAp,0.14285714285714285,6,6,TATCGTGATGTTCAGTTTGG,0,1159340
fldAp,0.14285714285714285,6,6,TATCGTCGAAATCGCCGGCA,0,1168955
fldAp,0.14285714285714285,6,6,TATCGCGCAAAGACCGCCAG,0,1164526
fldAp,0.14285714285714285,6,6,TATCGCCCTCATGATAGGCT,0,1138950
fldAp,0.14285714285714285,6,6,TATATCTCAAAAGGAGGCGA,0,1070604
fldAp,0.14285714285714285,6,6,TATATCCTGGTGTTTTTGGG,0,1180115
fldAp,0.14285714285714285,6,6,TATAGGGCTGGATTCCATAC,0,1154628
fldAp,0.14285714285714285,6,6,TATACAGGTCGCTGTGTGGT,0,1146304
fldAp,0.14285714285714285,6,6,TATAATTCGAGGACAAGAGG,0,1146034
fldAp,0.14285714285714285,6,6,TATAAACTCATCCAAATGAT,0,1072248
fldAp,0.14285714285714285,6,6,TAGGTTCGGAGACATCAGGG,0,1080150
fldAp,0.14285714285714285,6,6,TAGGGGATCAACCCACCGGC,0,1081458
fldAp,0.14285714285714285,6,6,TAGGCGACAAGTTAGTCCAT,0,1109375
fldAp,0.14285714285714285,6,6,TAGGCCTGATCAGCGTTAGA,0,1104628
fldAp,0.14285714285714285,6,6,TAGGCAACTCTCAAGAGTGG,0,1119670
fldAp,0.14285714285714285,6,6,TAGGAGTCCCGAGGATCACA,0,1158300
fldAp,0.14285714285714285,6,6,TAGGACCAAGATTCCTGCAG,0,1116592
fldAp,0.14285714285714285,6,6,TAGCTCAGGTCCCATGTTTC,0,1098717
fldAp,0.14285714285714285,6,6,TAGCGAGCTACGGCCATATA,0,1084391
fldAp,0.14285714285714285,6,6,TAGCCTGCCAAATAAAACGC,0,1154629
fldAp,0.14285714285714285,6,6,TAGCCATGTTATCGTCGCGT,0,1116856
fldAp,0.14285714285714285,6,6,TAGCAATATACGTTTCGAGT,0,1150761
fldAp,0.14285714285714285,6,6,TAGATTCTGTACGGAGAGAA,0,1104075
fldAp,0.14285714285714285,6,6,TAGATCAGGGTAGTTTCCTG,0,1155932
fldAp,0.14285714285714285,6,6,TAGACGGTTCAGGTCTTACT,0,1171900
fldAp,0.14285714285714285,6,6,TAGAACAGCTCTCCAGACTG,0,1111201
fldAp,0.14285714285714285,6,6,TACTTTAGGAGATGTCGTTA,0,1100147
fldAp,0.14285714285714285,6,6,TACTTCATTTGCGTCGGGTA,0,1137872
fldAp,0.14285714285714285,6,6,TACTGAGTGATCTTGATGCT,0,1154058
fldAp,0.14285714285714285,6,6,TACTATCCACGTCCCTAGCA,0,1112735
fldAp,0.14285714285714285,6,6,TACTACAATTCAGGCGCAAG,0,1089300
fldAp,0.14285714285714285,6,6,TACGTGAACTAAATTCCACC,0,1132888
fldAp,0.14285714285714285,6,6,TACGGGTATCTGCTACATAG,0,1151406
fldAp,0.14285714285714285,6,6,TACCTCCGAATCTGAGAAGC,0,1132899
fldAp,0.14285714285714285,6,6,TACCGGGACCAGGAATCCAA,0,1104511
fldAp,0.14285714285714285,6,6,TACCCTCCCTGTACTTCAAT,0,1159427
fldAp,0.14285714285714285,6,6,TACCCTACATAAAAAAACAT,0,1065162
fldAp,0.14285714285714285,6,6,TACCCCATAATTGTTTAACC,0,1081683
fldAp,0.14285714285714285,6,6,TACCAGTCGAATTGACGGTA,0,1064753
fldAp,0.14285714285714285,6,6,TACATGCTTGCTAGCAAGAT,0,1134324
fldAp,0.14285714285714285,6,6,TACATCCACATCGTGTCTCT,0,1131325
fldAp,0.14285714285714285,6,6,TACAGCACCCTGCACGGCCT,0,1071004
fldAp,0.14285714285714285,6,6,TACACGTGCAATCGGTGCGA,0,1137308
fldAp,0.14285714285714285,6,6,TACACCTGGCCTGTTTCAAG,0,1183746
fldAp,0.14285714285714285,6,6,TACAATGTTTACAGTGTTGC,0,1065468
fldAp,0.14285714285714285,6,6,TACAAGCATGACCCCGCCAA,0,1125468
fldAp,0.14285714285714285,6,6,TACAACCGGGTAGGGTACCA,0,1080852
fldAp,0.14285714285714285,6,6,TAATTTTCACTTGTTGATCA,0,1090044
fldAp,0.14285714285714285,6,6,TAATCTCCCCACGGTTCAAC,0,1158683
fldAp,0.14285714285714285,6,6,TAATCCTTTATAAGAAATTA,0,1155921
fldAp,0.14285714285714285,6,6,TAATCCCATGCGGGTGTGGT,0,1068027
fldAp,0.14285714285714285,6,6,TAATCATACAAAAATTAACA,0,1152618
fldAp,0.14285714285714285,6,6,TAATATTATCGGTTAATATC,0,1123855
fldAp,0.14285714285714285,6,6,TAAGGTCCAGTCAGCGTCTC,0,1175027
fldAp,0.14285714285714285,6,6,TAAGGTACTTGTGGCAGGCA,0,1120464
fldAp,0.14285714285714285,6,6,TAAGCTGCGTGGCACTAGCT,0,1104477
fldAp,0.14285714285714285,6,6,TAAGCGCTTGGAAAAACAAA,0,1094233
fldAp,0.14285714285714285,6,6,TAAGACAACTAAGGTTGAGC,0,1119066
fldAp,0.14285714285714285,6,6,TAAGAATTGTATAGTATTCC,0,1142108
fldAp,0.14285714285714285,6,6,TAACTTCATATTGGAACGGA,0,1071408
fldAp,0.14285714285714285,6,6,TAACCGTTAAGGTTTGTTGG,0,1163798
fldAp,0.14285714285714285,6,6,TAACCATGGATACAGCCTCA,0,1154751
fldAp,0.14285714285714285,6,6,TAAATTCGGGCACAATGTTG,0,1109020
fldAp,0.14285714285714285,6,6,TAAATCGCCGTTCGTCAGAA,0,1184799
fldAp,0.14285714285714285,6,6,TAAAGGGCCAGGTGGGGGAA,0,1135494
fldAp,0.14285714285714285,6,6,TAAACTTACGGGGTGAGAAA,0,1113100
fldAp,0.14285714285714285,6,6,TAAAATGACGCTTCCGACCT,0,1133496
fldAp,0.14285714285714285,6,6,TAAAATAGTTCAGTTAGCGT,0,1181946
fldAp,0.14285714285714285,6,6,TAAAAGGGTTGGGGCAGGAA,0,1082675
fldAp,0.14285714285714285,6,6,GTTTTTGGAGCCTAAGCGAC,0,1120398
fldAp,0.14285714285714285,6,6,GTTTTGAGTGCTGGATTCGC,0,1100016
fldAp,0.14285714285714285,6,6,GTTTTCCCGCATTCCTGTCC,0,1121759
fldAp,0.14285714285714285,6,6,GTTTGATGAATGGTGGACTG,0,1076172
fldAp,0.14285714285714285,6,6,GTTTAGCTCAGATTCGGTTC,0,1098576
fldAp,0.14285714285714285,6,6,GTTGGATTAGTGCGAGCGAT,0,1162398
fldAp,0.14285714285714285,6,6,GTTGGAGACACATCCACTGC,0,1121143
fldAp,0.14285714285714285,6,6,GTTGCCTCCTATGTAGCGTA,0,1148238
fldAp,0.14285714285714285,6,6,GTTGATAATTTGCAACATCT,0,1150232
fldAp,0.14285714285714285,6,6,GTTGAAGATTACTGCATGAT,0,1080529
fldAp,0.14285714285714285,6,6,GTTCTGGGACGAGGCGTAAG,0,1100403
fldAp,0.14285714285714285,6,6,GTTCGCTTCGAGACCTGGAT,0,1173296
fldAp,0.14285714285714285,6,6,GTTCGAATGGGACTTTTGTG,0,1096315
fldAp,0.14285714285714285,6,6,GTTCCTCCGCACTCGCGGTT,0,1168277
fldAp,0.14285714285714285,6,6,GTTCCGGCTCCCCGGGATTC,0,1115927
fldAp,0.14285714285714285,6,6,GTTCCGCCCACGCGCTGTCG,0,1136607
fldAp,0.14285714285714285,6,6,GTTCCATGTCAGGTTGGCTG,0,1118444
fldAp,0.14285714285714285,6,6,GTTCAGCCCCCAAGCGATTG,0,1173672
fldAp,0.14285714285714285,6,6,GTTCACAAGTTTTTAAGCAT,0,1123526
fldAp,0.14285714285714285,6,6,GTTCAAGATTATGCGTGTGG,0,1178017
fldAp,0.14285714285714285,6,6,GTTATTTAACTAACTATACT,0,1077305
fldAp,0.14285714285714285,6,6,GTTATGGGGCAGAGCGATAC,0,1181585
fldAp,0.14285714285714285,6,6,GTTATGCTGGGGTACCGTAA,0,1149273
fldAp,0.14285714285714285,6,6,GTTAGAACCGCCCTATGCCC,0,1175677
fldAp,0.14285714285714285,6,6,GTTACTTCACGGCCGTCTCA,0,1162584
fldAp,0.14285714285714285,6,6,GTTACTCCCGGTATTTAGGA,0,1085194
fldAp,0.14285714285714285,6,6,GTTACGGGTACCAGCCCAGT,0,1077010
fldAp,0.14285714285714285,6,6,GTTAATATGTGTCCCAGTTA,0,1097938
fldAp,0.14285714285714285,6,6,GTGTTTCCTGGCTCGGTAGA,0,1103089
fldAp,0.14285714285714285,6,6,GTGTGAAGAGCTTTGATGTT,0,1134327
fldAp,0.14285714285714285,6,6,GTGTCCGAAAGCTCATTTTT,0,1067117
fldAp,0.14285714285714285,6,6,GTGTATGTTGAGCTTGTTAT,0,1097272
fldAp,0.14285714285714285,6,6,GTGTATCAGTTCTCGTGATC,0,1114048
fldAp,0.14285714285714285,6,6,GTGGTCCCAAAAAGACGCGC,0,1073164
fldAp,0.14285714285714285,6,6,GTGGTAGTCCGCAAGCCAGC,0,1064316
fldAp,0.14285714285714285,6,6,GTGGGGACAACTGTCGGCCT,0,1090326
fldAp,0.14285714285714285,6,6,GTGGGCGGCGGGCGTGCCAT,0,1159999
fldAp,0.14285714285714285,6,6,GTGGCGGAATGAAGAGATAT,0,1072333
fldAp,0.14285714285714285,6,6,GTGGAATTCGTACGCCTTTC,0,1076110
fldAp,0.14285714285714285,6,6,GTGCTTTATTCGTGACCCAT,0,1100565
fldAp,0.14285714285714285,6,6,GTGCTTACTGAAAAATATGA,0,1080174
fldAp,0.14285714285714285,6,6,GTGCGTAAGCTTTATTCGAT,0,1068166
fldAp,0.14285714285714285,6,6,GTGCGATGCCTCGGACATTT,0,1105717
fldAp,0.14285714285714285,6,6,GTGCGAAAATCGCCGGGTGA,0,1110949
fldAp,0.14285714285714285,6,6,GTGCCGTTGTAGTATTGATC,0,1079735
fldAp,0.14285714285714285,6,6,GTGCCGGACTTGCGTGAAAT,0,1099737
fldAp,0.14285714285714285,6,6,GTGCATCACCAGGATCTAAC,0,1125681
fldAp,0.14285714285714285,6,6,GTGCAGTGTCTTCTAAAAAG,0,1127058
fldAp,0.14285714285714285,6,6,GTGCAAGAGAACCTGAGGAT,0,1119853
fldAp,0.14285714285714285,6,6,GTGATTTTGACAGTTGGCTC,0,1150157
fldAp,0.14285714285714285,6,6,GTGATATTGTTGTAAGATGA,0,1118924
fldAp,0.14285714285714285,6,6,GTGAGGACAATATAACATAA,0,1091734
fldAp,0.14285714285714285,6,6,GTGAGCGAGGTAGAGATAAT,0,1071805
fldAp,0.14285714285714285,6,6,GTGAGAAACGGCATGTCTAA,0,1165133
fldAp,0.14285714285714285,6,6,GTGAATTCTATCCTATAGGC,0,1071472
fldAp,0.14285714285714285,6,6,GTGAAGCGTATCGGAGCTGA,0,1095800
fldAp,0.14285714285714285,6,6,GTGAACCCTTCCACGACGAG,0,1151819
fldAp,0.14285714285714285,6,6,GTGAAATTGTATAGTAGGTT,0,1126081
fldAp,0.14285714285714285,6,6,GTCTGGGTCTGGCTGGGACA,0,1137207
fldAp,0.14285714285714285,6,6,GTCTGACTAGAACATTAGCA,0,1093257
fldAp,0.14285714285714285,6,6,GTCTCATTCATAATATGGGT,0,1087165
fldAp,0.14285714285714285,6,6,GTCTCAATGGGCCTTCGGCG,0,1171777
fldAp,0.14285714285714285,6,6,GTCTAACCCGTACACTGTTA,0,1179567
fldAp,0.14285714285714285,6,6,GTCGCCACACTAATTAGAGA,0,1100485
fldAp,0.14285714285714285,6,6,GTCGAGCCTCTCCTTGACAT,0,1121394
fldAp,0.14285714285714285,6,6,GTCGAGATAGATGCTATCAA,0,1070938
fldAp,0.14285714285714285,6,6,GTCCTGCCTGGGTTCCTCAA,0,1079007
fldAp,0.14285714285714285,6,6,GTCCTCTAAATCCACAGTAT,0,1183975
fldAp,0.14285714285714285,6,6,GTCCTCGTAGTGTTGCAACA,0,1104960
fldAp,0.14285714285714285,6,6,GTCCTCCACCGGATCTGGAA,0,1161784
fldAp,0.14285714285714285,6,6,GTCCGCTCATTTAAGATCAT,0,1108194
fldAp,0.14285714285714285,6,6,GTCCCTCTCTTAACCGAGGT,0,1128698
fldAp,0.14285714285714285,6,6,GTCATTATCCAGTAGCTCTG,0,1144181
fldAp,0.14285714285714285,6,6,GTCATCCCGGTGGCACTCTT,0,1136979
fldAp,0.14285714285714285,6,6,GTCAGGGGATCATGAGGATC,0,1160394
fldAp,0.14285714285714285,6,6,GTCACTAAACCCGAATCGGT,0,1182451
fldAp,0.14285714285714285,6,6,GTCACGATAGGTCCGTGCGT,0,1088914
fldAp,0.14285714285714285,6,6,GTCACATGGTGTATTTGCGT,0,1178277
fldAp,0.14285714285714285,6,6,GTCAACCATAGGTTGTGTAC,0,1184784
fldAp,0.14285714285714285,6,6,GTATTGGTGCGGATATATTA,0,1165150
fldAp,0.14285714285714285,6,6,GTATGGGGCGTCCCACCTCT,0,1151619
fldAp,0.14285714285714285,6,6,GTATAGCCGTTTGACACGAG,0,1073199
fldAp,0.14285714285714285,6,6,GTAGTGGTTAGGCACGAGGT,0,1168853
fldAp,0.14285714285714285,6,6,GTAGTGGGATTTCCGTTTTT,0,1079241
fldAp,0.14285714285714285,6,6,GTAGGGGCTGCGTGACGCTG,0,1165870
fldAp,0.14285714285714285,6,6,GTAGGAATCCCTCGCTTCCC,0,1153723
fldAp,0.14285714285714285,6,6,GTAGCTAACGTGTCAGAATA,0,1174173
fldAp,0.14285714285714285,6,6,GTAGCCCCTTCGACTTGACA,0,1152888
fldAp,0.14285714285714285,6,6,GTAGCAGGCTAGCCCTTGCA,0,1108637
fldAp,0.14285714285714285,6,6,GTACTTCAGCTTTAACGGCG,0,1132953
fldAp,0.14285714285714285,6,6,GTACTCGGCTGTATTCCCCG,0,1110473
fldAp,0.14285714285714285,6,6,GTACTACGGTGAAGGAGAGT,0,1109715
fldAp,0.14285714285714285,6,6,GTACGTATCGCTGGACTGTG,0,1125110
fldAp,0.14285714285714285,6,6,GTACGTAGAAGTGAGGGCCA,0,1146299
fldAp,0.14285714285714285,6,6,GTACGTACATTTGGGTGTCT,0,1124862
fldAp,0.14285714285714285,6,6,GTACCTATCCGATCTTTGTT,0,1091652
fldAp,0.14285714285714285,6,6,GTACAGCAAGCCTCGACAAA,0,1120511
fldAp,0.14285714285714285,6,6,GTACACTCAACGTGTAGTTC,0,1096015
fldAp,0.14285714285714285,6,6,GTACACTACGGAAAGCCTGG,0,1165873
fldAp,0.14285714285714285,6,6,GTAAGACGCGAGTTGGTGTG,0,1064292
fldAp,0.14285714285714285,6,6,GTAACCTAGGGGTTATGATT,0,1106504
fldAp,0.14285714285714285,6,6,GTAAAGTCATTGTGGTCGCA,0,1145789
fldAp,0.14285714285714285,6,6,GTAAACGCGAGCCGGTTAAG,0,1063957
fldAp,0.14285714285714285,6,6,GGTTTTTATAGTCATGATGG,0,1172756
fldAp,0.14285714285714285,6,6,GGTTTTGTGAGCGTAAATGC,0,1112859
fldAp,0.14285714285714285,6,6,GGTTTTGAATCGGCGGGTTA,0,1108091
fldAp,0.14285714285714285,6,6,GGTTGGGGGGGACGTCGAGG,0,1070244
fldAp,0.14285714285714285,6,6,GGTTGGGAAGCGCGCTCGTG,0,1133219
fldAp,0.14285714285714285,6,6,GGTTGGCACCATCCGTTGGT,0,1127473
fldAp,0.14285714285714285,6,6,GGTTCGTTATACCGACATTA,0,1073505
fldAp,0.14285714285714285,6,6,GGTTCGCTCCTAAAGAGGGC,0,1147238
fldAp,0.14285714285714285,6,6,GGTTCCCCGGCTTAGATACA,0,1086146
fldAp,0.14285714285714285,6,6,GGTTCATGGTCAAAAATGTT,0,1130736
fldAp,0.14285714285714285,6,6,GGTTATAGCTTATTATGGGA,0,1185982
fldAp,0.14285714285714285,6,6,GGTTATACGTATCCCGCTTG,0,1129560
fldAp,0.14285714285714285,6,6,GGTTAAAGAGATAGCGGGTA,0,1125173
fldAp,0.14285714285714285,6,6,GGTGTGTTCAAATGGCGTGT,0,1140311
fldAp,0.14285714285714285,6,6,GGTGGTCTGATGCGGCATCA,0,1083241
fldAp,0.14285714285714285,6,6,GGTGGGGACCCACAAGCGCC,0,1071221
fldAp,0.14285714285714285,6,6,GGTGAAGGCCGTTCGTACAT,0,1099861
fldAp,0.14285714285714285,6,6,GGTCTTCATAAGGTGCTTCT,0,1157730
fldAp,0.14285714285714285,6,6,GGTCTTATCGCTAGCGGAGA,0,1076298
fldAp,0.14285714285714285,6,6,GGTCTGTGATGTGGGTCGGT,0,1086260
fldAp,0.14285714285714285,6,6,GGTCTCGTCGGGGTAGCCTA,0,1132316
fldAp,0.14285714285714285,6,6,GGTCGTTATTAGTCACATAA,0,1183001
fldAp,0.14285714285714285,6,6,GGTCGCGTTTCGTAAGTAGA,0,1117962
fldAp,0.14285714285714285,6,6,GGTCAGCCTTCTACCTAGAA,0,1169412
fldAp,0.14285714285714285,6,6,GGTAGCGGATCCTGTATGTC,0,1135866
fldAp,0.14285714285714285,6,6,GGTACTCTAAAATTAAGCTT,0,1092104
fldAp,0.14285714285714285,6,6,GGTAAGAATCGAAATGAAGC,0,1074566
fldAp,0.14285714285714285,6,6,GGGTTGTACCCCGCAGAAGA,0,1143275
fldAp,0.14285714285714285,6,6,GGGTTGCGCAAGAGCCAATC,0,1095579
fldAp,0.14285714285714285,6,6,GGGTTCTTTGTGTCGATTCC,0,1081576
fldAp,0.14285714285714285,6,6,GGGTGGAAACCGATCTTAGA,0,1066219
fldAp,0.14285714285714285,6,6,GGGTCGCAGAAGGGCGCAGT,0,1118965
fldAp,0.14285714285714285,6,6,GGGTCATATAGGTTCTTTAT,0,1145219
fldAp,0.14285714285714285,6,6,GGGTACTCCGCGGTGGAGTA,0,1076194
fldAp,0.14285714285714285,6,6,GGGGTTGCTTCCTTGTGACA,0,1176450
fldAp,0.14285714285714285,6,6,GGGGTATGATAAGGGAATCT,0,1081702
fldAp,0.14285714285714285,6,6,GGGGGTTGCCGAAACTGTGT,0,1122283
fldAp,0.14285714285714285,6,6,GGGGGTGGTTATACAACGGT,0,1091790
fldAp,0.14285714285714285,6,6,GGGGGGTTTTTCGTGTAGGA,0,1165384
fldAp,0.14285714285714285,6,6,GGGGGAACATAAACCAGTGG,0,1108984
fldAp,0.14285714285714285,6,6,GGGGCATTAAATTTTAGACG,0,1067874
fldAp,0.14285714285714285,6,6,GGGGATACGTCAGCGTCTCC,0,1181327
fldAp,0.14285714285714285,6,6,GGGGAAGGCCGTTATGGATG,0,1144016
fldAp,0.14285714285714285,6,6,GGGCTTATAGAAGATGTTAT,0,1166617
fldAp,0.14285714285714285,6,6,GGGCTAAATTCGGGCATTTG,0,1133676
fldAp,0.14285714285714285,6,6,GGGCGTTGGGGAAGTCAGAC,0,1166740
fldAp,0.14285714285714285,6,6,GGGCGCTGGTGCAACCAGAG,0,1148615
fldAp,0.14285714285714285,6,6,GGGCGATGTGTAAAATCGGG,0,1073588
fldAp,0.14285714285714285,6,6,GGGCCATGGCATACCCGTTA,0,1084158
fldAp,0.14285714285714285,6,6,GGGCAGAGGGCTCCTGTGGA,0,1093170
fldAp,0.14285714285714285,6,6,GGGCAAGGTGGCGAGTGCCC,0,1078044
fldAp,0.14285714285714285,6,6,GGGATGTTTAGTGGGCCGCG,0,1070562
fldAp,0.14285714285714285,6,6,GGGATGCGTGCGGAACTTTT,0,1177300
fldAp,0.14285714285714285,6,6,GGGATCCCACGCCTATTGAT,0,1117238
fldAp,0.14285714285714285,6,6,GGGATATAGCCGGCCTTAGA,0,1092857
fldAp,0.14285714285714285,6,6,GGGATACACATTACATTCCT,0,1170770
fldAp,0.14285714285714285,6,6,GGGACTATAGCAGGCTCCTG,0,1184179
fldAp,0.14285714285714285,6,6,GGGACGGGTTCACACGTCCT,0,1106871
fldAp,0.14285714285714285,6,6,GGGAAAACAACCCGCACGCG,0,1118756
fldAp,0.14285714285714285,6,6,GGCTTCCTCTGCCTAGAGCG,0,1115759
fldAp,0.14285714285714285,6,6,GGCTGTCAGACCACGATTGC,0,1091460
fldAp,0.14285714285714285,6,6,GGCTGCATCTGCTCCTCAAT,0,1130577
fldAp,0.14285714285714285,6,6,GGCTCATTGAACAGATCGGT,0,1139278
fldAp,0.14285714285714285,6,6,GGCTATCAAGAGCTGGAAAC,0,1162873
fldAp,0.14285714285714285,6,6,GGCTAGGGGGGTGACGAAGA,0,1087410
fldAp,0.14285714285714285,6,6,GGCTAGAGGCCTGGACGTTG,0,1160683
fldAp,0.14285714285714285,6,6,GGCGGCTCCCTGGGTATAAT,0,1091849
fldAp,0.14285714285714285,6,6,GGCGCGTGGTACAGCTTTCT,0,1073756
fldAp,0.14285714285714285,6,6,GGCGAGTGTAAGTTTTCAGC,0,1155276
fldAp,0.14285714285714285,6,6,GGCGACGGAACTCTGTCTCG,0,1177484
fldAp,0.14285714285714285,6,6,GGCCTGAAGAGGCCAGCCGT,0,1144811
fldAp,0.14285714285714285,6,6,GGCCGCGATTAGTGACCGCA,0,1096116
fldAp,0.14285714285714285,6,6,GGCCGAGTGGGCTAAACCTA,0,1139573
fldAp,0.14285714285714285,6,6,GGCCATTAACTAGTGCACGT,0,1104978
fldAp,0.14285714285714285,6,6,GGCCACGGCGAAGTAGTGCG,0,1129600
fldAp,0.14285714285714285,6,6,GGCATTTCGTGAGGTTCTCA,0,1087885
fldAp,0.14285714285714285,6,6,GGCATTCGGCGTGCGCCATT,0,1097413
fldAp,0.14285714285714285,6,6,GGCATTAACAACAGAGTTGT,0,1178019
fldAp,0.14285714285714285,6,6,GGCAGCGTACTCTGGTTGGC,0,1093148
fldAp,0.14285714285714285,6,6,GGCAGCCTTCCGTACAACGG,0,1100377
fldAp,0.14285714285714285,6,6,GGCACCGGCGGGAAGTCCGT,0,1088410
fldAp,0.14285714285714285,6,6,GGCAATAAGCTAGTAATGAA,0,1069504
fldAp,0.14285714285714285,6,6,GGCAACGAAGTGTATTGGTT,0,1140632
fldAp,0.14285714285714285,6,6,GGATTTTTTGCGGTATCCGA,0,1094501
fldAp,0.14285714285714285,6,6,GGATTTGAGGGCATCCCCGT,0,1091251
fldAp,0.14285714285714285,6,6,GGATTCGGCAAGATTTATGT,0,1102463
fldAp,0.14285714285714285,6,6,GGATGGCTAGTAATGTCCGG,0,1100167
fldAp,0.14285714285714285,6,6,GGAGTACTTCCGTCGTTTGT,0,1080210
fldAp,0.14285714285714285,6,6,GGACTATTTCTTACCCAGCC,0,1131848
fldAp,0.14285714285714285,6,6,GGACCGAGCGATGCTGGTAA,0,1090848
fldAp,0.14285714285714285,6,6,GGACCACCAGATAAGGAACA,0,1177860
fldAp,0.14285714285714285,6,6,GGACCAAGGGCTATAGACCC,0,1089695
fldAp,0.14285714285714285,6,6,GGACATGGGTCAATGGGGAG,0,1103445
fldAp,0.14285714285714285,6,6,GGACAGGTATAGGGTATCCA,0,1064844
fldAp,0.14285714285714285,6,6,GGAATGGGTCTGTGCCCCAC,0,1121300
fldAp,0.14285714285714285,6,6,GGAATGCATATGTCATCCTT,0,1136091
fldAp,0.14285714285714285,6,6,GGAATGACCACGCATGATTA,0,1184478
fldAp,0.14285714285714285,6,6,GGAAGCTCTGTTATTCAAGC,0,1149646
fldAp,0.14285714285714285,6,6,GGAAATTGCACTTGCATTCC,0,1123719
fldAp,0.14285714285714285,6,6,GGAAAGCATTGAATCAGATA,0,1162963
fldAp,0.14285714285714285,6,6,GCTTTTGCGGCTTACATTGG,0,1171631
fldAp,0.14285714285714285,6,6,GCTTTTATGGGATCCGGGGT,0,1106788
fldAp,0.14285714285714285,6,6,GCTTTGATGTTTGGGGTTCC,0,1108593
fldAp,0.14285714285714285,6,6,GCTTTGATACGGAACTTATT,0,1177939
fldAp,0.14285714285714285,6,6,GCTTTCGGTTTATAGGGTTA,0,1095892
fldAp,0.14285714285714285,6,6,GCTTTCAAATGGGAAGATAG,0,1150593
fldAp,0.14285714285714285,6,6,GCTTGTTAGACGTTCCACCG,0,1108913
fldAp,0.14285714285714285,6,6,GCTTGAGTGGCATATCTGTG,0,1140061
fldAp,0.14285714285714285,6,6,GCTTCACCGGGGTGGCGTGA,0,1106430
fldAp,0.14285714285714285,6,6,GCTTAGTGAGAGTTCTGGTT,0,1091934
fldAp,0.14285714285714285,6,6,GCTTAGGTTGAACGGTATCA,0,1126721
fldAp,0.14285714285714285,6,6,GCTTAAGGTCTGTTCTTGTG,0,1080177
fldAp,0.14285714285714285,6,6,GCTGGTAGGATTGGCATGAG,0,1081459
fldAp,0.14285714285714285,6,6,GCTGGGGGTAGCACAGGGAT,0,1065769
fldAp,0.14285714285714285,6,6,GCTGGGACTTTATCCGCCTA,0,1130063
fldAp,0.14285714285714285,6,6,GCTGGCAGAAGTTGGATTCG,0,1124421
fldAp,0.14285714285714285,6,6,GCTGGACGGAGAGTTCACGC,0,1143704
fldAp,0.14285714285714285,6,6,GCTGATCCGTTGGGCGCCAA,0,1120018
fldAp,0.14285714285714285,6,6,GCTGAATTTTGTAGTGTGGA,0,1099721
fldAp,0.14285714285714285,6,6,GCTCTTTTGGAGCGGCTCCC,0,1140409
fldAp,0.14285714285714285,6,6,GCTCTTAAATTGTAGTTGGT,0,1109845
fldAp,0.14285714285714285,6,6,GCTCTAGTTATCGTTTCAAG,0,1113410
fldAp,0.14285714285714285,6,6,GCTCGTGCAGGCGTACGTCA,0,1078000
fldAp,0.14285714285714285,6,6,GCTCGAACCGTACCGGTGGA,0,1183249
fldAp,0.14285714285714285,6,6,GCTCCCCGGAGGTTAGGAGT,0,1096438
fldAp,0.14285714285714285,6,6,GCTAGGTGCAATTTGTTCGT,0,1120984
fldAp,0.14285714285714285,6,6,GCTAGGGGGATATAAAAAAC,0,1122197
fldAp,0.14285714285714285,6,6,GCTAGCATCTTGGTCGGTTG,0,1151397
fldAp,0.14285714285714285,6,6,GCTACTTCATGCTACAGCAG,0,1152234
fldAp,0.14285714285714285,6,6,GCTACGTGTGTTAGCAGCGC,0,1128193
fldAp,0.14285714285714285,6,6,GCTAATATGGTCTCTATCTC,0,1084706
fldAp,0.14285714285714285,6,6,GCTAAGGCTCACATTGGCTA,0,1186496
fldAp,0.14285714285714285,6,6,GCTAAGCCCTAGGAACTTCG,0,1107892
fldAp,0.14285714285714285,6,6,GCTAAATCAGTCTACATTGA,0,1070598
fldAp,0.14285714285714285,6,6,GCGTTAGCATCGTGCGCGGC,0,1113881
fldAp,0.14285714285714285,6,6,GCGTGAGCGGTAGTATCGAA,0,1184387
fldAp,0.14285714285714285,6,6,GCGTCTTGGCATGAGAAAAT,0,1087483
fldAp,0.14285714285714285,6,6,GCGTAGTTAAACGTTCCTGT,0,1165598
fldAp,0.14285714285714285,6,6,GCGTAAAACGCGGGTTAGTT,0,1153014
fldAp,0.14285714285714285,6,6,GCGGTTCTTGGCAGTGCTCA,0,1182752
fldAp,0.14285714285714285,6,6,GCGGTAATCACTGGAGACAA,0,1163978
fldAp,0.14285714285714285,6,6,GCGGTAAGTAGGTAAACAAC,0,1132494
fldAp,0.14285714285714285,6,6,GCGGCGCGAGCATCCAGGTC,0,1136541
fldAp,0.14285714285714285,6,6,GCGGAGTCTGGCCTCGGTCA,0,1174413
fldAp,0.14285714285714285,6,6,GCGGACTAAATTATTGCTGA,0,1098170
fldAp,0.14285714285714285,6,6,GCGCTTTGGGTCCGTAAAGG,0,1098246
fldAp,0.14285714285714285,6,6,GCGCTTTGCGAATTCGTGGA,0,1068356
fldAp,0.14285714285714285,6,6,GCGCTCGTTGGCGTGCAAAG,0,1102894
fldAp,0.14285714285714285,6,6,GCGCGTTAGCTGAGAAAGGG,0,1106144
fldAp,0.14285714285714285,6,6,GCGCGTCCCGTAGTGGTAAA,0,1111987
fldAp,0.14285714285714285,6,6,GCGCCTGGTAGGTTACCCTT,0,1082148
fldAp,0.14285714285714285,6,6,GCGCCTCCTAGATACTGTAC,0,1108582
fldAp,0.14285714285714285,6,6,GCGCCTCCGATCCCAAACAC,0,1167806
fldAp,0.14285714285714285,6,6,GCGCCGGGCGCCAACTCGGA,0,1184617
fldAp,0.14285714285714285,6,6,GCGCCACGAGTCTACGGAAA,0,1154721
fldAp,0.14285714285714285,6,6,GCGCCAAGCCCACAGAGGTC,0,1087017
fldAp,0.14285714285714285,6,6,GCGCACGGGGGCTTAGCTAC,0,1180410
fldAp,0.14285714285714285,6,6,GCGATCTGGGGGCCAGTCAC,0,1123845
fldAp,0.14285714285714285,6,6,GCGAGGTGAGTTTGATGATA,0,1101895
fldAp,0.14285714285714285,6,6,GCGAGGCTGTGCAGTGGAAG,0,1119468
fldAp,0.14285714285714285,6,6,GCGAGCCTGTTCCTTGCATG,0,1096210
fldAp,0.14285714285714285,6,6,GCGACTCGTAGGCATCGTTT,0,1096343
fldAp,0.14285714285714285,6,6,GCGACGTCCAAAAACTCGTG,0,1135402
fldAp,0.14285714285714285,6,6,GCGAATGAATGTTTTGTTAC,0,1099166
fldAp,0.14285714285714285,6,6,GCCTTGACATGGTCATTCGT,0,1177126
fldAp,0.14285714285714285,6,6,GCCTTAAAAGACTATCGCGA,0,1064203
fldAp,0.14285714285714285,6,6,GCCTCCCTGGATTCTGTCCA,0,1083014
fldAp,0.14285714285714285,6,6,GCCTATTTTAGAGGGACGAG,0,1177193
fldAp,0.14285714285714285,6,6,GCCGTGGCCATCCGCTACGG,0,1172893
fldAp,0.14285714285714285,6,6,GCCGTATAAATATGGAGTTG,0,1080789
fldAp,0.14285714285714285,6,6,GCCGCTCGATGCGAAGCATT,0,1101085
fldAp,0.14285714285714285,6,6,GCCGCGGGCGCACTCATTTC,0,1095387
fldAp,0.14285714285714285,6,6,GCCGCCGGCACGGCCAGCGA,0,1092370
fldAp,0.14285714285714285,6,6,GCCGATACTACTCAACGGAT,0,1091262
fldAp,0.14285714285714285,6,6,GCCGAGATCATGTCCATATT,0,1120692
fldAp,0.14285714285714285,6,6,GCCCTCCCGGAGGTGTTACC,0,1148300
fldAp,0.14285714285714285,6,6,GCCCTACGCAGGGAAGACTT,0,1112890
fldAp,0.14285714285714285,6,6,GCCCGTTCTGCAGTTGTGGC,0,1100949
fldAp,0.14285714285714285,6,6,GCCCGTCTAAATCGTACGGA,0,1174367
fldAp,0.14285714285714285,6,6,GCCCGAGCGGCGGCGAGCCT,0,1088689
fldAp,0.14285714285714285,6,6,GCCCCCACATGATGTTAGAA,0,1120072
fldAp,0.14285714285714285,6,6,GCCCATAGGTAGAACGTTGT,0,1078483
fldAp,0.14285714285714285,6,6,GCCATTCCCTATTAATTGGC,0,1097436
fldAp,0.14285714285714285,6,6,GCCATGCCGCGCAAGCGTTT,0,1146666
fldAp,0.14285714285714285,6,6,GCCAGTACTGTTCCGGGCGG,0,1108445
fldAp,0.14285714285714285,6,6,GCCAGGGAAAATGAAAGCTT,0,1162186
fldAp,0.14285714285714285,6,6,GCCACTAAGCCAGGTTCCAA,0,1074181
fldAp,0.14285714285714285,6,6,GCCACGAAATGACTCCGACC,0,1099343
fldAp,0.14285714285714285,6,6,GCCAATTAGATTTGTAGTCA,0,1150576
fldAp,0.14285714285714285,6,6,GCCAATCGCCCTCCTCATGA,0,1150051
fldAp,0.14285714285714285,6,6,GCCAAGTCCGTACTGTGCAA,0,1068564
fldAp,0.14285714285714285,6,6,GCATTGTCGGAGACACTAAA,0,1173094
fldAp,0.14285714285714285,6,6,GCATGTTTGAGATCACGCTC,0,1102173
fldAp,0.14285714285714285,6,6,GCATGGGATGATGTGTGCGA,0,1146044
fldAp,0.14285714285714285,6,6,GCATGGACCCAAGTGTAATG,0,1077180
fldAp,0.14285714285714285,6,6,GCATGCGCCAGCGTTAAGAT,0,1119626
fldAp,0.14285714285714285,6,6,GCATGCCCGAGCCTGTTTTG,0,1186754
fldAp,0.14285714285714285,6,6,GCATGACCACCGGGGTCTCA,0,1066846
fldAp,0.14285714285714285,6,6,GCATATCGTCCCATTCAAGA,0,1089026
fldAp,0.14285714285714285,6,6,GCATAAACGATAGCCAAATC,0,1114035
fldAp,0.14285714285714285,6,6,GCAGTCGAAACAGTTAACGA,0,1129554
fldAp,0.14285714285714285,6,6,GCAGTATGGAGTCGGCACAG,0,1175341
fldAp,0.14285714285714285,6,6,GCAGTACGCATCTTGTTGCA,0,1088994
fldAp,0.14285714285714285,6,6,GCAGGGTGATGATCGATTAC,0,1088590
fldAp,0.14285714285714285,6,6,GCAGATGGACGATGTTAAAT,0,1116910
fldAp,0.14285714285714285,6,6,GCAGAAAGCCATAGCACCGC,0,1118618
fldAp,0.14285714285714285,6,6,GCACTCAAGGAGTGCACCCA,0,1112042
fldAp,0.14285714285714285,6,6,GCACGTTGTGTGTAAGGAAG,0,1160133
fldAp,0.14285714285714285,6,6,GCACGTCTTATATGGAGGAA,0,1168565
fldAp,0.14285714285714285,6,6,GCACGATGCTGTCATTGGGA,0,1095205
fldAp,0.14285714285714285,6,6,GCACCTGAGACATATGGTAC,0,1154737
fldAp,0.14285714285714285,6,6,GCACCACTTGTGCTATTGTA,0,1172437
fldAp,0.14285714285714285,6,6,GCAATCAATGTTTAGGTACG,0,1176322
fldAp,0.14285714285714285,6,6,GCAACAGGCATCTCACCATA,0,1129196
fldAp,0.14285714285714285,6,6,GCAAAAGCACCAGCAAACGA,0,1177450
fldAp,0.14285714285714285,6,6,GATTTCATCGTAGTGTAATG,0,1125467
fldAp,0.14285714285714285,6,6,GATTGATGCGGCGATCAACT,0,1127071
fldAp,0.14285714285714285,6,6,GATTCTAAGCGCCGACTAAA,0,1168449
fldAp,0.14285714285714285,6,6,GATTCCTGCCGCGCGCATAG,0,1070928
fldAp,0.14285714285714285,6,6,GATTATGATATCAAGAGGAA,0,1079034
fldAp,0.14285714285714285,6,6,GATTATGACTCATGGTTTGA,0,1126894
fldAp,0.14285714285714285,6,6,GATGGGGCGTTTCAGTTTGT,0,1110690
fldAp,0.14285714285714285,6,6,GATGCTAACCTCATGATGGC,0,1141991
fldAp,0.14285714285714285,6,6,GATGAGTATTATAACTAAAA,0,1071161
fldAp,0.14285714285714285,6,6,GATGAGGATGGGGGAAGAGA,0,1069804
fldAp,0.14285714285714285,6,6,GATCTAGTCAGGGGGTGCGC,0,1175711
fldAp,0.14285714285714285,6,6,GATCGTAGGGACAGCGACGT,0,1175040
fldAp,0.14285714285714285,6,6,GATCGAACATTGTGTAAGTC,0,1115104
fldAp,0.14285714285714285,6,6,GATATTCGTGTTTTATTGTA,0,1085467
fldAp,0.14285714285714285,6,6,GATATGGACGGTTGGCGATC,0,1138835
fldAp,0.14285714285714285,6,6,GATATGCTGGCTCTCGCGGT,0,1113133
fldAp,0.14285714285714285,6,6,GATAGTGCGGATGGTCCTCT,0,1146635
fldAp,0.14285714285714285,6,6,GATAGAGCGGCCTGTCCTGG,0,1141054
fldAp,0.14285714285714285,6,6,GATACGCGAATATAAGGTGC,0,1158659
fldAp,0.14285714285714285,6,6,GATAATTCGATGTTGAACTG,0,1139551
fldAp,0.14285714285714285,6,6,GATAAGCCTGAGGAACGGCC,0,1093548
fldAp,0.14285714285714285,6,6,GATAACGTGCAGATTCACGT,0,1141953
fldAp,0.14285714285714285,6,6,GAGTTAAGTGCTGACCTCTA,0,1119866
fldAp,0.14285714285714285,6,6,GAGTGGCAAACGCCTCGATT,0,1180548
fldAp,0.14285714285714285,6,6,GAGGTGTGCACAGATTTCCT,0,1150645
fldAp,0.14285714285714285,6,6,GAGGGCTATCACATAATCCA,0,1132419
fldAp,0.14285714285714285,6,6,GAGGGCGCTACCGAGAGAAC,0,1112968
fldAp,0.14285714285714285,6,6,GAGGGATTTACTTGGGAACG,0,1173467
fldAp,0.14285714285714285,6,6,GAGGCTTTCTGTGTTGAGTA,0,1119787
fldAp,0.14285714285714285,6,6,GAGGCCCTTGACCCTATAAG,0,1139148
fldAp,0.14285714285714285,6,6,GAGGACTTCGAGATTGCGGT,0,1167052
fldAp,0.14285714285714285,6,6,GAGGAATGATATCTGGGTTC,0,1149264
fldAp,0.14285714285714285,6,6,GAGCTTACCTCCCAGGCATC,0,1073433
fldAp,0.14285714285714285,6,6,GAGCGGGAGACATAGCAAAT,0,1096055
fldAp,0.14285714285714285,6,6,GAGCGCGCATGGACGCATTG,0,1160347
fldAp,0.14285714285714285,6,6,GAGCGATCTGGGTAATAAGT,0,1111949
fldAp,0.14285714285714285,6,6,GAGCCCAGCTGGCTCCAAAC,0,1095367
fldAp,0.14285714285714285,6,6,GAGCACGGGGCTAGGCCTAT,0,1153645
fldAp,0.14285714285714285,6,6,GAGAGTTCTCGGGAGGCTAA,0,1142995
fldAp,0.14285714285714285,6,6,GAGAGGTGTTGGTAATAGAC,0,1147417
fldAp,0.14285714285714285,6,6,GAGAGCGGCTACAGTGCTCC,0,1127619
fldAp,0.14285714285714285,6,6,GAGAGCGCTCGGACGCTATG,0,1125069
fldAp,0.14285714285714285,6,6,GAGAGACGCTGGGGCAACCT,0,1134359
fldAp,0.14285714285714285,6,6,GAGACTATTATACTTCGGCC,0,1078145
fldAp,0.14285714285714285,6,6,GAGACAAGGGGTTTCTGAGC,0,1175935
fldAp,0.14285714285714285,6,6,GAGAATAAGCGGGGCTAATA,0,1150162
fldAp,0.14285714285714285,6,6,GACTTGTTTCCTGGATGCTA,0,1084617
fldAp,0.14285714285714285,6,6,GACTTACATTGCTTACTAGC,0,1071823
fldAp,0.14285714285714285,6,6,GACTTAATGATGCGAAACCG,0,1157950
fldAp,0.14285714285714285,6,6,GACTGAGCCACCGCGACAAT,0,1080997
fldAp,0.14285714285714285,6,6,GACTCCCCTGGTGAAATCTT,0,1111166
fldAp,0.14285714285714285,6,6,GACTACTTCGGGGGGAGCTA,0,1144720
fldAp,0.14285714285714285,6,6,GACGCGGGCAACGTCTCCCC,0,1097079
fldAp,0.14285714285714285,6,6,GACGCGAACCTGCCTTGAAG,0,1132321
fldAp,0.14285714285714285,6,6,GACGCCTCCCAGATTCGGCA,0,1082513
fldAp,0.14285714285714285,6,6,GACGCCCCGTCCGAATTGTT,0,1160658
fldAp,0.14285714285714285,6,6,GACCTGATGACGTAGGAGCG,0,1157767
fldAp,0.14285714285714285,6,6,GACCGCTAACGTCCCGTGGG,0,1074572
fldAp,0.14285714285714285,6,6,GACCCTCTTCATTCCTCAAT,0,1128351
fldAp,0.14285714285714285,6,6,GACCCCGAGGATAGGTAGCC,0,1112184
fldAp,0.14285714285714285,6,6,GACCAGTGTCTTACGTTTCA,0,1143461
fldAp,0.14285714285714285,6,6,GACCAGGGTCCGACCTCTGG,0,1163108
fldAp,0.14285714285714285,6,6,GACATGTTCAATGCGCGTAG,0,1167519
fldAp,0.14285714285714285,6,6,GACAGTGTAAGGGTTAGCTA,0,1138842
fldAp,0.14285714285714285,6,6,GACAGTGAAAATCAGCTTGC,0,1090654
fldAp,0.14285714285714285,6,6,GACACTCGGCACGAGAACGA,0,1148654
fldAp,0.14285714285714285,6,6,GACAATTTTGAACGTACGGC,0,1086537
fldAp,0.14285714285714285,6,6,GACAATGGTGGGTTGACAAT,0,1153506
fldAp,0.14285714285714285,6,6,GACAACAGCACACCTGCTGG,0,1077463
fldAp,0.14285714285714285,6,6,GACAAAAGTGTAACGGTCGT,0,1170460
fldAp,0.14285714285714285,6,6,GAATTGGTTTTTTTGTGTAA,0,1144149
fldAp,0.14285714285714285,6,6,GAATGGCGGCAGGGCGCTGC,0,1109368
fldAp,0.14285714285714285,6,6,GAATGCCTATAATTCTTGCC,0,1104956
fldAp,0.14285714285714285,6,6,GAATGAGGTTGAGGCCCGTT,0,1109273
fldAp,0.14285714285714285,6,6,GAATCAGCCGGTCTAACGTC,0,1142124
fldAp,0.14285714285714285,6,6,GAAGTTTGGGGAGGGCCTCA,0,1149160
fldAp,0.14285714285714285,6,6,GAAGTTGGGCGACGGCCATT,0,1115844
fldAp,0.14285714285714285,6,6,GAAGTGATAAATGCTTTTGC,0,1089524
fldAp,0.14285714285714285,6,6,GAAGTACAACCGCTATAGTT,0,1091534
fldAp,0.14285714285714285,6,6,GAAGCCTATGGCCCGCGCCA,0,1129108
fldAp,0.14285714285714285,6,6,GAAGCCGCTCTACGCTGTTA,0,1183542
fldAp,0.14285714285714285,6,6,GAAGAAGCAGGCTGTGTGGG,0,1085133
fldAp,0.14285714285714285,6,6,GAACCTGACAGGTGTGCGGA,0,1063236
fldAp,0.14285714285714285,6,6,GAACCAAATTAATCCGGTAG,0,1104796
fldAp,0.14285714285714285,6,6,GAACAGTTCCGGTGAAGAAC,0,1071109
fldAp,0.14285714285714285,6,6,GAACAGACGTTTATACATAT,0,1143909
fldAp,0.14285714285714285,6,6,GAACACCTCACCCTTCGGCT,0,1100067
fldAp,0.14285714285714285,6,6,GAAAGGAAGTCTCTTTTTCG,0,1085284
fldAp,0.14285714285714285,6,6,GAAAGAAGGCTTAGATACCT,0,1172977
fldAp,0.14285714285714285,6,6,GAAACCTCCCAGAGTGAACA,0,1128292
fldAp,0.14285714285714285,6,6,GAAACATAAGATCGTAACAA,0,1103538
fldAp,0.14285714285714285,6,6,GAAAATGGTATTAGGGGTAT,0,1180455
fldAp,0.14285714285714285,6,6,GAAAAGTTACGAGTGGCGTG,0,1078946
fldAp,0.14285714285714285,6,6,GAAAAACTCAGAGGGGACAG,0,1095625
fldAp,0.14285714285714285,6,6,CTTTTCACGTCGATCCCCGA,0,1137964
fldAp,0.14285714285714285,6,6,CTTTTACTATTGGATAACGA,0,1141772
fldAp,0.14285714285714285,6,6,CTTTGCGGTCTATATAAGCT,0,1174938
fldAp,0.14285714285714285,6,6,CTTTCTCATGAGTCCTAAAC,0,1128330
fldAp,0.14285714285714285,6,6,CTTTACTGCAGTCATCGTGG,0,1108751
fldAp,0.14285714285714285,6,6,CTTGTCCCACCCGCAGGGCT,0,1143672
fldAp,0.14285714285714285,6,6,CTTGGTCGTCGGCAATCCTT,0,1131372
fldAp,0.14285714285714285,6,6,CTTGGGCACGTCCTTTTAGT,0,1123654
fldAp,0.14285714285714285,6,6,CTTGGCATAGAGAAGCGAGG,0,1085376
fldAp,0.14285714285714285,6,6,CTTGGACTTAAAGGCTTTTC,0,1115751
fldAp,0.14285714285714285,6,6,CTTGCAGCAATTACGGAAGG,0,1167357
fldAp,0.14285714285714285,6,6,CTTGCACGATGCCCCGATGG,0,1092804
fldAp,0.14285714285714285,6,6,CTTGCAACTGCACTCCCCGC,0,1133957
fldAp,0.14285714285714285,6,6,CTTCTGGTGTTTTCAAACTG,0,1139028
fldAp,0.14285714285714285,6,6,CTTCTGGCAAAGGGTAAAGC,0,1104092
fldAp,0.14285714285714285,6,6,CTTCATAATTAAGTTTCCTA,0,1146491
fldAp,0.14285714285714285,6,6,CTTATTCAACAAACTACGGT,0,1152728
fldAp,0.14285714285714285,6,6,CTTATCATCGACGTACAATG,0,1142922
fldAp,0.14285714285714285,6,6,CTTATATGGATAACTACGTT,0,1154042
fldAp,0.14285714285714285,6,6,CTTAGCTAATTTTTTAATGT,0,1124117
fldAp,0.14285714285714285,6,6,CTTACGGGAAGGGACAGATG,0,1122639
fldAp,0.14285714285714285,6,6,CTTACCATTCGATCGTCCCG,0,1085512
fldAp,0.14285714285714285,6,6,CTTAACGCTTCGCAACGCAA,0,1178734
fldAp,0.14285714285714285,6,6,CTGTTTTTAATGTACGGTTC,0,1090828
fldAp,0.14285714285714285,6,6,CTGTTGTTGTATCTAAAACC,0,1143095
fldAp,0.14285714285714285,6,6,CTGTGTCCTGCCCTACTTAC,0,1158172
fldAp,0.14285714285714285,6,6,CTGTGGATTGAGACGGCGTT,0,1083298
fldAp,0.14285714285714285,6,6,CTGTCGTAACAGCGTGATCC,0,1077339
fldAp,0.14285714285714285,6,6,CTGTCCCAGTAATAACAGTA,0,1131109
fldAp,0.14285714285714285,6,6,CTGTCCATTTCAGCATAAAA,0,1119817
fldAp,0.14285714285714285,6,6,CTGTATGCACGTGTTGATCT,0,1099602
fldAp,0.14285714285714285,6,6,CTGTATCGCACGTGGATGAT,0,1184213
fldAp,0.14285714285714285,6,6,CTGTATAAATGTAAAGGACT,0,1090856
fldAp,0.14285714285714285,6,6,CTGTACGGTCTTGTGGGTGG,0,1163528
fldAp,0.14285714285714285,6,6,CTGGGGTGCACAACAGGTGC,0,1063435
fldAp,0.14285714285714285,6,6,CTGGGCTCGTAGACGCTCCT,0,1183531
fldAp,0.14285714285714285,6,6,CTGGCCCTGACCCGGGTTCA,0,1180039
fldAp,0.14285714285714285,6,6,CTGGATCCTGACCTTTAACC,0,1066987
fldAp,0.14285714285714285,6,6,CTGGACTCGCCGGCCCACAT,0,1143805
fldAp,0.14285714285714285,6,6,CTGGACATTATCTGGAGTGA,0,1149279
fldAp,0.14285714285714285,6,6,CTGCTCTTGCGGCGGAGGTC,0,1147895
fldAp,0.14285714285714285,6,6,CTGCGGGGTCTCACCTTCCG,0,1139055
fldAp,0.14285714285714285,6,6,CTGCCTTTCGTCCATAACGT,0,1087568
fldAp,0.14285714285714285,6,6,CTGCCCTTCACCAGAATGGA,0,1128903
fldAp,0.14285714285714285,6,6,CTGCCAGCAGCATGGTGCAA,0,1070193
fldAp,0.14285714285714285,6,6,CTGATACTTTAACTAATTAA,0,1116245
fldAp,0.14285714285714285,6,6,CTGAGTTGTGGCGTCCTGAA,0,1158962
fldAp,0.14285714285714285,6,6,CTGAGGGTTTCTAGCAGTCA,0,1101061
fldAp,0.14285714285714285,6,6,CTGAGGGGGCGGGTCTCTGA,0,1099152
fldAp,0.14285714285714285,6,6,CTGAGGCCTTCCTTCTGGTT,0,1121758
fldAp,0.14285714285714285,6,6,CTGACGGTACCGGCGAGGCG,0,1064928
fldAp,0.14285714285714285,6,6,CTGACCACTGCATGATTGTT,0,1162947
fldAp,0.14285714285714285,6,6,CTGAACAATCTGGAGACCCC,0,1170659
fldAp,0.14285714285714285,6,6,CTCTTTGTCAGCATATTCGT,0,1089944
fldAp,0.14285714285714285,6,6,CTCTTGCTGTAATAGAGGTA,0,1173112
fldAp,0.14285714285714285,6,6,CTCTTACATGGAGCAGGCGG,0,1149157
fldAp,0.14285714285714285,6,6,CTCTGTACGGTTATACTTGT,0,1159197
fldAp,0.14285714285714285,6,6,CTCTGGTATCCTAGGCCAAG,0,1102100
fldAp,0.14285714285714285,6,6,CTCTGGCTCCTGCGGCACTG,0,1085244
fldAp,0.14285714285714285,6,6,CTCTGGCACCGTGCTATCGT,0,1167193
fldAp,0.14285714285714285,6,6,CTCTCGTTACGGGGGCGATC,0,1119829
fldAp,0.14285714285714285,6,6,CTCTCGTGATGGAAAAGTTG,0,1114118
fldAp,0.14285714285714285,6,6,CTCTCGTCATGTCTAATGAT,0,1149401
fldAp,0.14285714285714285,6,6,CTCTCGCAGCCAGAAAGATG,0,1064703
fldAp,0.14285714285714285,6,6,CTCTATTTTCTATCACCTTA,0,1140079
fldAp,0.14285714285714285,6,6,CTCTATGATACCCCGCTTAC,0,1186405
fldAp,0.14285714285714285,6,6,CTCGGCGCCGACGGCCTGAA,0,1071797
fldAp,0.14285714285714285,6,6,CTCGGCCCCTCCGGTGTGTG,0,1147902
fldAp,0.14285714285714285,6,6,CTCGCGCGGTCGCAATGAAC,0,1093179
fldAp,0.14285714285714285,6,6,CTCGATTGCGATGGAAGCTT,0,1171361
fldAp,0.14285714285714285,6,6,CTCGACACACGCTAATGACA,0,1091917
fldAp,0.14285714285714285,6,6,CTCCGGGGATCTGTTCGCTA,0,1156511
fldAp,0.14285714285714285,6,6,CTCCGGCGTTAGGTTTATAT,0,1170937
fldAp,0.14285714285714285,6,6,CTCCGAAGGCAAATGTAGTG,0,1082047
fldAp,0.14285714285714285,6,6,CTCCCTAAGCATCGCGTAGA,0,1122920
fldAp,0.14285714285714285,6,6,CTCCACGCCTATAAGCGTAA,0,1165095
fldAp,0.14285714285714285,6,6,CTCAGTCCCATGTGACAAGG,0,1106793
fldAp,0.14285714285714285,6,6,CTCAGCGGTGTATGGGAGCG,0,1067779
fldAp,0.14285714285714285,6,6,CTCAGCGGCAGAAATATGAA,0,1186738
fldAp,0.14285714285714285,6,6,CTCAGCACCTGAGGTCGGCC,0,1117348
fldAp,0.14285714285714285,6,6,CTCACAAGTCTACAGCACCA,0,1119945
fldAp,0.14285714285714285,6,6,CTCAAGGCAAGAACGGATAT,0,1086832
fldAp,0.14285714285714285,6,6,CTATTGTAGGGGGCAGTATG,0,1149349
fldAp,0.14285714285714285,6,6,CTATCCTGGGAGATTTCATC,0,1104239
fldAp,0.14285714285714285,6,6,CTAGCGACAGTGGCGCAATA,0,1084795
fldAp,0.14285714285714285,6,6,CTAGACAAGCCTTCGGCGAA,0,1173078
fldAp,0.14285714285714285,6,6,CTACGTGTCGAGAGTTTTGA,0,1171680
fldAp,0.14285714285714285,6,6,CTACGTGGGATCGAAGTTTC,0,1153317
fldAp,0.14285714285714285,6,6,CTACGATAGCGGTCCAAACG,0,1099419
fldAp,0.14285714285714285,6,6,CTACATGAAACTTGAGTTTT,0,1092567
fldAp,0.14285714285714285,6,6,CTACATATAAACGCCTCAGG,0,1106804
fldAp,0.14285714285714285,6,6,CTACACTATAATACATGGAC,0,1105227
fldAp,0.14285714285714285,6,6,CTAATGTGATGCGTGTGCTC,0,1073278
fldAp,0.14285714285714285,6,6,CTAATGTAAGGACCCCTTTG,0,1178989
fldAp,0.14285714285714285,6,6,CTAAGGGAAAGGGTGGGCAA,0,1077459
fldAp,0.14285714285714285,6,6,CTAACAGAGGTACACCGTAA,0,1075801
fldAp,0.14285714285714285,6,6,CTAAATTCATGGTAGTACCT,0,1167935
fldAp,0.14285714285714285,6,6,CGTTTTAAGTCTTGTCCCCA,0,1127587
fldAp,0.14285714285714285,6,6,CGTTTGTGATTCTTGCATTC,0,1143321
fldAp,0.14285714285714285,6,6,CGTTTAAAGTGAACGTCAAG,0,1175663
fldAp,0.14285714285714285,6,6,CGTTGGGGGGAAGGTGCTCG,0,1099196
fldAp,0.14285714285714285,6,6,CGTTGCATCGGACCTCACTA,0,1098311
fldAp,0.14285714285714285,6,6,CGTTCGCAGGGGATGGTAAC,0,1182109
fldAp,0.14285714285714285,6,6,CGTTCATTCTTTTTCTACGC,0,1079222
fldAp,0.14285714285714285,6,6,CGTTAATAGAGGGGTTGAGT,0,1183759
fldAp,0.14285714285714285,6,6,CGTGTTGTTTGGTGGGACGT,0,1110524
fldAp,0.14285714285714285,6,6,CGTGTCGGGGAGAAATGACT,0,1108040
fldAp,0.14285714285714285,6,6,CGTGGTTCGGTTGGGGAGGC,0,1126240
fldAp,0.14285714285714285,6,6,CGTGCTTCCGAATTGTATTA,0,1116648
fldAp,0.14285714285714285,6,6,CGTGATTAACTGGAAAGCTG,0,1182348
fldAp,0.14285714285714285,6,6,CGTCTTGCCGGCGTCGTCCA,0,1119061
fldAp,0.14285714285714285,6,6,CGTCGAGAATCGGTGAGAAC,0,1117437
fldAp,0.14285714285714285,6,6,CGTCCGACCTCACGCGAGAG,0,1086619
fldAp,0.14285714285714285,6,6,CGTATCGAGCATTTTTACTC,0,1113167
fldAp,0.14285714285714285,6,6,CGTACGACTCCCATCCCACC,0,1083300
fldAp,0.14285714285714285,6,6,CGTAAGAGGTGCGAAAAGAA,0,1107203
fldAp,0.14285714285714285,6,6,CGGTTTGGCCATGGGGCGTT,0,1133698
fldAp,0.14285714285714285,6,6,CGGTTCATGTACTGCATTGT,0,1141605
fldAp,0.14285714285714285,6,6,CGGTTATTGATTCGCCCATA,0,1157725
fldAp,0.14285714285714285,6,6,CGGTGAAGAGCCTAGCCATA,0,1065216
fldAp,0.14285714285714285,6,6,CGGTCGGGTCTATGGACTAT,0,1132324
fldAp,0.14285714285714285,6,6,CGGTACAGGCCTGCCGATTA,0,1120851
fldAp,0.14285714285714285,6,6,CGGTAAGTATCTATTTCACT,0,1086073
fldAp,0.14285714285714285,6,6,CGGGTTAGTGCCCGCGCGAG,0,1136491
fldAp,0.14285714285714285,6,6,CGGGGTATGACATTCGGTGA,0,1082030
fldAp,0.14285714285714285,6,6,CGGGGCATCTTCTTAGAAAC,0,1133279
fldAp,0.14285714285714285,6,6,CGGGGCAAGAGTCGGGAGGT,0,1178438
fldAp,0.14285714285714285,6,6,CGGGCGGATGGCTCAGTATT,0,1124518
fldAp,0.14285714285714285,6,6,CGGGCAACTAGACCGGATTA,0,1171130
fldAp,0.14285714285714285,6,6,CGGCTTTACGGGTTTCAGGA,0,1170403
fldAp,0.14285714285714285,6,6,CGGCTTGACGAGGTTCTAAT,0,1106719
fldAp,0.14285714285714285,6,6,CGGCTCCTTCGCTTTTCTTT,0,1095642
fldAp,0.14285714285714285,6,6,CGGCGTTACGGGGTCAAGAT,0,1138822
fldAp,0.14285714285714285,6,6,CGGCGTCCTTGTACCAGTAG,0,1088320
fldAp,0.14285714285714285,6,6,CGGCCGACATCTTGGTCGTA,0,1178839
fldAp,0.14285714285714285,6,6,CGGCAAGTGCGTATCGGTTT,0,1168609
fldAp,0.14285714285714285,6,6,CGGACTGCCATTATCAGATC,0,1092474
fldAp,0.14285714285714285,6,6,CGGACTCATAGTTACAAGCT,0,1089563
fldAp,0.14285714285714285,6,6,CGGACGATACGACCGAAGAG,0,1133436
fldAp,0.14285714285714285,6,6,CGGACAGGGGATCACGATCG,0,1084863
fldAp,0.14285714285714285,6,6,CGCTTGATCCTGATTCTCAT,0,1180693
fldAp,0.14285714285714285,6,6,CGCTTCCTTGCCAGATAGCA,0,1101753
fldAp,0.14285714285714285,6,6,CGCTCGAGAGAATGGGACCA,0,1088313
fldAp,0.14285714285714285,6,6,CGCTATCAGCGAACCGCCTA,0,1156724
fldAp,0.14285714285714285,6,6,CGCTATAGACCATGCGCCCG,0,1145636
fldAp,0.14285714285714285,6,6,CGCGTGCACCCCTAGTGCAT,0,1081359
fldAp,0.14285714285714285,6,6,CGCGTCGGGCTTATTCAAGA,0,1175997
fldAp,0.14285714285714285,6,6,CGCGGGTTCTTAATTCGAGA,0,1112920
fldAp,0.14285714285714285,6,6,CGCGCAGCTCGAATTCAGAT,0,1123210
fldAp,0.14285714285714285,6,6,CGCGAAGGCTGACTCTGGAC,0,1177864
fldAp,0.14285714285714285,6,6,CGCCTAGTGTAAGCGTGAGA,0,1120685
fldAp,0.14285714285714285,6,6,CGCCTAGGGTTCCTTGTGGC,0,1179056
fldAp,0.14285714285714285,6,6,CGCCGTATATGTCTGCCTTT,0,1082858
fldAp,0.14285714285714285,6,6,CGCCCTTTCCGCCTTTTAAG,0,1089015
fldAp,0.14285714285714285,6,6,CGCCCCATCGAGCATTGCAG,0,1161959
fldAp,0.14285714285714285,6,6,CGCCCCAAGCCACTTCCCAT,0,1182919
fldAp,0.14285714285714285,6,6,CGCCCATGTCGCGAACGGGT,0,1143581
fldAp,0.14285714285714285,6,6,CGCATTGCCTACGCCGAGAT,0,1104171
fldAp,0.14285714285714285,6,6,CGCATGACGTTAGAGAACCG,0,1099155
fldAp,0.14285714285714285,6,6,CGCAGTGTATGGCCCGTGCA,0,1087925
fldAp,0.14285714285714285,6,6,CGCACCCGGCCGATACGGGA,0,1099879
fldAp,0.14285714285714285,6,6,CGCAAGTATACAATTTAAAT,0,1125151
fldAp,0.14285714285714285,6,6,CGCAACACCCCTGGGTCCAC,0,1132496
fldAp,0.14285714285714285,6,6,CGATTTTTTCATCCTTGGCG,0,1147467
fldAp,0.14285714285714285,6,6,CGATTGCAGGGGCTCACAGC,0,1119208
fldAp,0.14285714285714285,6,6,CGATGGAAGCATAAAAATGC,0,1084720
fldAp,0.14285714285714285,6,6,CGATGCCTTTCACTAAAGTT,0,1098936
fldAp,0.14285714285714285,6,6,CGATGCCCGGAAGGTAATGG,0,1093499
fldAp,0.14285714285714285,6,6,CGATATCGCGAAACAACTGA,0,1069817
fldAp,0.14285714285714285,6,6,CGATAGGGACAGGGTTGTCG,0,1184702
fldAp,0.14285714285714285,6,6,CGATACGTTGAGGTAAGAAG,0,1171310
fldAp,0.14285714285714285,6,6,CGATACCGTGACGACACAGC,0,1173388
fldAp,0.14285714285714285,6,6,CGAGTCTGCCGGGCGAGGGT,0,1065872
fldAp,0.14285714285714285,6,6,CGAGGGTATACGCTCCCCCA,0,1107863
fldAp,0.14285714285714285,6,6,CGAGGCATGCTAGGCTACAC,0,1160881
fldAp,0.14285714285714285,6,6,CGAGGCACCATCACCTCCGG,0,1169602
fldAp,0.14285714285714285,6,6,CGAGCTCTATGCAGTTTATA,0,1122202
fldAp,0.14285714285714285,6,6,CGAGATCGGCTACAGAAGGA,0,1135474
fldAp,0.14285714285714285,6,6,CGACTATTTCTCGCGTTAGA,0,1069572
fldAp,0.14285714285714285,6,6,CGACGGTCCAGGCACATATT,0,1169224
fldAp,0.14285714285714285,6,6,CGACCTCGCACGGGACCTAA,0,1179455
fldAp,0.14285714285714285,6,6,CGACCCTTTAGCCCTAGTCT,0,1081302
fldAp,0.14285714285714285,6,6,CGACCACCGCGTCGGCGCCG,0,1067321
fldAp,0.14285714285714285,6,6,CGACAAAACATATTGCGCCT,0,1152526
fldAp,0.14285714285714285,6,6,CGAATAGTGTATGTCGCATC,0,1163101
fldAp,0.14285714285714285,6,6,CGAAGACTGGCCGTTAGTCG,0,1176349
fldAp,0.14285714285714285,6,6,CGAACCTACCAGTTCACTCG,0,1069296
fldAp,0.14285714285714285,6,6,CGAACACGTTTGTCCAGGTT,0,1130733
fldAp,0.14285714285714285,6,6,CGAACAACAACCTGAATACT,0,1168867
fldAp,0.14285714285714285,6,6,CGAAAGAAGCCCTTTGGAGC,0,1186955
fldAp,0.14285714285714285,6,6,CGAAACTTGGTATCGTTTTA,0,1066984
fldAp,0.14285714285714285,6,6,CGAAAATAGCTCACTTGATG,0,1182028
fldAp,0.14285714285714285,6,6,CCTTTTGTACAGGGTGCAAA,0,1066703
fldAp,0.14285714285714285,6,6,CCTTGGGGCGCGCCGATGCT,0,1104193
fldAp,0.14285714285714285,6,6,CCTTCGAGTAGAGCGAAAAT,0,1151687
fldAp,0.14285714285714285,6,6,CCTTAAACTGACACACCCGA,0,1147195
fldAp,0.14285714285714285,6,6,CCTGTGTGCCGACAAAAGTT,0,1169440
fldAp,0.14285714285714285,6,6,CCTGTGGATCGCATTGGACG,0,1178827
fldAp,0.14285714285714285,6,6,CCTGTCTACGAGAAAGACGA,0,1161609
fldAp,0.14285714285714285,6,6,CCTGGAAGGGCCTAACCATT,0,1065157
fldAp,0.14285714285714285,6,6,CCTGCTGTGGAGTTAACTAA,0,1076158
fldAp,0.14285714285714285,6,6,CCTGCGCGGACGGTTTATAT,0,1154848
fldAp,0.14285714285714285,6,6,CCTGCATTGCGAGGTTCGAT,0,1071966
fldAp,0.14285714285714285,6,6,CCTGCACAAGTATCAGATGT,0,1090694
fldAp,0.14285714285714285,6,6,CCTGCAAGTGACCTCAGGTG,0,1149967
fldAp,0.14285714285714285,6,6,CCTGCAAACTTCGTGATAGG,0,1161341
fldAp,0.14285714285714285,6,6,CCTGAGCTGTCTGGAAACAT,0,1131841
fldAp,0.14285714285714285,6,6,CCTCTGGTACGCATCATCAC,0,1186237
fldAp,0.14285714285714285,6,6,CCTCTAAGCCAAACTGCCCG,0,1129440
fldAp,0.14285714285714285,6,6,CCTCTAAGACTGATCTATTC,0,1178819
fldAp,0.14285714285714285,6,6,CCTCGTTGCATTACGTCAAA,0,1111903
fldAp,0.14285714285714285,6,6,CCTCCATAGATTGCAATTCT,0,1175329
fldAp,0.14285714285714285,6,6,CCTATACATCTTACCACCGG,0,1066823
fldAp,0.14285714285714285,6,6,CCTAGTGTCGGAAGTTGGGA,0,1095142
fldAp,0.14285714285714285,6,6,CCTACTGCAGGCGCGTGGTA,0,1173724
fldAp,0.14285714285714285,6,6,CCTACTCTCTAGCCCGCACT,0,1171227
fldAp,0.14285714285714285,6,6,CCTACTAATATCATTAATAA,0,1071676
fldAp,0.14285714285714285,6,6,CCGTTCCCTATTGGTCTTGT,0,1144597
fldAp,0.14285714285714285,6,6,CCGTTCAGTACCAATGCGGG,0,1085303
fldAp,0.14285714285714285,6,6,CCGTGCTACGGGATAGCTGC,0,1151906
fldAp,0.14285714285714285,6,6,CCGTCTATATCCTAACTACA,0,1108065
fldAp,0.14285714285714285,6,6,CCGTACGCGTGTGGGTCCTA,0,1108518
fldAp,0.14285714285714285,6,6,CCGTACATTGTGGAAGGATG,0,1168980
fldAp,0.14285714285714285,6,6,CCGTAACAAACTATCAGATC,0,1122728
fldAp,0.14285714285714285,6,6,CCGTAAACTCCAAAGCGTGT,0,1186963
fldAp,0.14285714285714285,6,6,CCGGTTTAGGGAATCTCTGG,0,1153543
fldAp,0.14285714285714285,6,6,CCGGTTTAAAGCTGGGGCGT,0,1069832
fldAp,0.14285714285714285,6,6,CCGGTTGTCAAGCTACCGGA,0,1080266
fldAp,0.14285714285714285,6,6,CCGGTGAAATTGGCGGTATT,0,1087940
fldAp,0.14285714285714285,6,6,CCGGTCTAAAATTACAGCCA,0,1179362
fldAp,0.14285714285714285,6,6,CCGGTATGTATTAGAATTAA,0,1065214
fldAp,0.14285714285714285,6,6,CCGGTATGCAGATGAGGGAT,0,1069077
fldAp,0.14285714285714285,6,6,CCGGTATATTCAATTGATCC,0,1147253
fldAp,0.14285714285714285,6,6,CCGGCTTCGGCGCACTTTCA,0,1107583
fldAp,0.14285714285714285,6,6,CCGGCTGGGTGCGGTCTCAC,0,1083555
fldAp,0.14285714285714285,6,6,CCGGCTACCCACATGATTAA,0,1135743
fldAp,0.14285714285714285,6,6,CCGGATCTGTAGCCGGCACT,0,1163292
fldAp,0.14285714285714285,6,6,CCGCTTATTGGGGCCGTATA,0,1131283
fldAp,0.14285714285714285,6,6,CCGCTGACTAAGGAGACCGT,0,1171467
fldAp,0.14285714285714285,6,6,CCGCCCCGGTGGGATTTCTA,0,1153973
fldAp,0.14285714285714285,6,6,CCGCATGTTACAATTCTAGG,0,1148915
fldAp,0.14285714285714285,6,6,CCGCAATGGGAAACGGGCTA,0,1105501
fldAp,0.14285714285714285,6,6,CCGATTGACGGCTCGCCGAA,0,1113587
fldAp,0.14285714285714285,6,6,CCGAGGACCTCATCGCGTTA,0,1080319
fldAp,0.14285714285714285,6,6,CCGACTCCAGGGACACCAGA,0,1071919
fldAp,0.14285714285714285,6,6,CCGACCCTGGTCTCCCTCTC,0,1158543
fldAp,0.14285714285714285,6,6,CCGACACCATATTTTCACAC,0,1186902
fldAp,0.14285714285714285,6,6,CCGAAACCTACTGCTCGCAG,0,1124921
fldAp,0.14285714285714285,6,6,CCCTGGATTGGGGTAAGAGG,0,1072489
fldAp,0.14285714285714285,6,6,CCCTCTCATATATCACAGCG,0,1117191
fldAp,0.14285714285714285,6,6,CCCTATCCACTGTGTATCGG,0,1185854
fldAp,0.14285714285714285,6,6,CCCTAGGTCTAAGCCAGATT,0,1107193
fldAp,0.14285714285714285,6,6,CCCGTGTCTTACACAAGATC,0,1091670
fldAp,0.14285714285714285,6,6,CCCGTGTCTGTAAGATAGTT,0,1120543
fldAp,0.14285714285714285,6,6,CCCGTCTGAGAGGTGTTTGG,0,1119924
fldAp,0.14285714285714285,6,6,CCCGTCCCTGGTCTGACGTT,0,1177960
fldAp,0.14285714285714285,6,6,CCCGTACTAAGAGGACCAAT,0,1163576
fldAp,0.14285714285714285,6,6,CCCGGGAGGACCCCCTGTGT,0,1123805
fldAp,0.14285714285714285,6,6,CCCCCACCTGGCTCTCACAA,0,1098158
fldAp,0.14285714285714285,6,6,CCCATGGGGAGAGACACCCC,0,1093497
fldAp,0.14285714285714285,6,6,CCCATATAGGTCCCATTACG,0,1084059
fldAp,0.14285714285714285,6,6,CCCACGGGTACCCAACAGCG,0,1185290
fldAp,0.14285714285714285,6,6,CCCACGCTCATTTGATGCTC,0,1123863
fldAp,0.14285714285714285,6,6,CCCACGCCAGTATGGGCACA,0,1183127
fldAp,0.14285714285714285,6,6,CCCAACCCAAGAGCAAGTCC,0,1087433
fldAp,0.14285714285714285,6,6,CCATTTGGCAGGATGGCCCC,0,1117024
fldAp,0.14285714285714285,6,6,CCATTCATCCCGACACTGTT,0,1071246
fldAp,0.14285714285714285,6,6,CCATTAGATCCTAGTAATAG,0,1105631
fldAp,0.14285714285714285,6,6,CCATGACGCGATATTGATCT,0,1116580
fldAp,0.14285714285714285,6,6,CCATCTAGACTTAGCGACGC,0,1144562
fldAp,0.14285714285714285,6,6,CCATATGGCATATAGGACTC,0,1079887
fldAp,0.14285714285714285,6,6,CCATAGGTGGTCGGTGACAG,0,1145770
fldAp,0.14285714285714285,6,6,CCATAGCCGTTGGAACCATC,0,1081126
fldAp,0.14285714285714285,6,6,CCAGTCCGATCAGTAGTGCG,0,1085882
fldAp,0.14285714285714285,6,6,CCAGGGAATGTTGTCGAAGG,0,1140548
fldAp,0.14285714285714285,6,6,CCAGCCAGGTATAGGGCGGT,0,1113296
fldAp,0.14285714285714285,6,6,CCAGCAGTCAACACCCTTTA,0,1145635
fldAp,0.14285714285714285,6,6,CCAGCAATGATAACCGCTCC,0,1157523
fldAp,0.14285714285714285,6,6,CCAGACGTCGGCAGCTCGAA,0,1064188
fldAp,0.14285714285714285,6,6,CCAGAATGTGTCGCAGTCCA,0,1087085
fldAp,0.14285714285714285,6,6,CCACTCTGGTCCTGGGTTAA,0,1165502
fldAp,0.14285714285714285,6,6,CCACTCGAGCTGTGTTAAAC,0,1124602
fldAp,0.14285714285714285,6,6,CCACTATTTTGATATGTTGA,0,1097141
fldAp,0.14285714285714285,6,6,CCACGCCTTTCATGCCAAGG,0,1184233
fldAp,0.14285714285714285,6,6,CCACCTCAGATTGCTCAAAC,0,1111536
fldAp,0.14285714285714285,6,6,CCACCGATTGCCCTACGGAC,0,1115997
fldAp,0.14285714285714285,6,6,CCACATACTATAATTACGTA,0,1110086
fldAp,0.14285714285714285,6,6,CCACAGTCCTGAATATTGGA,0,1067626
fldAp,0.14285714285714285,6,6,CCACAGCTCAACTAAGGGCA,0,1097235
fldAp,0.14285714285714285,6,6,CCACACGAGATGTAATGGTA,0,1106418
fldAp,0.14285714285714285,6,6,CCACAATTATACCTGTCAAT,0,1094604
fldAp,0.14285714285714285,6,6,CCAATTCTTGCCGGACATTT,0,1120770
fldAp,0.14285714285714285,6,6,CCAATGGAACCTCGAGTCCA,0,1140846
fldAp,0.14285714285714285,6,6,CCAATCTCACGTACCTAACG,0,1067698
fldAp,0.14285714285714285,6,6,CCAAGTCTAGCAACATAATA,0,1157805
fldAp,0.14285714285714285,6,6,CCAACGCTTCTAGCCGATAT,0,1176020
fldAp,0.14285714285714285,6,6,CCAACCTAGCCGTGTGATGG,0,1106043
fldAp,0.14285714285714285,6,6,CCAACCCAACCAGAACTCCG,0,1149714
fldAp,0.14285714285714285,6,6,CCAAATCCACCGAAAGCCTG,0,1100887
fldAp,0.14285714285714285,6,6,CATTTTTCTCGCCGACAAGG,0,1090704
fldAp,0.14285714285714285,6,6,CATTTGGTAACCGGGGTTGT,0,1065248
fldAp,0.14285714285714285,6,6,CATTGGGTCGGGATGTCAGA,0,1141553
fldAp,0.14285714285714285,6,6,CATTGAGATATCGCTTAGTC,0,1094253
fldAp,0.14285714285714285,6,6,CATTGACTTCCGCCGAAAGC,0,1165791
fldAp,0.14285714285714285,6,6,CATTCACTTACAGATGGAAG,0,1147834
fldAp,0.14285714285714285,6,6,CATTACGTATTCGGTTATCT,0,1080318
fldAp,0.14285714285714285,6,6,CATGTTTGGTACAGACGCCC,0,1068853
fldAp,0.14285714285714285,6,6,CATGTTTGATTCAGCGGTTC,0,1084765
fldAp,0.14285714285714285,6,6,CATGTGCATATGTAGTGTCG,0,1179728
fldAp,0.14285714285714285,6,6,CATGTCTTCAAGGGTCCCCT,0,1079488
fldAp,0.14285714285714285,6,6,CATGTATTACACCTCGTGCC,0,1093888
fldAp,0.14285714285714285,6,6,CATGATCCCATTTAGTTACA,0,1086001
fldAp,0.14285714285714285,6,6,CATGAACTTGATATTTAATA,0,1157515
fldAp,0.14285714285714285,6,6,CATCTGTGTAACTGGTCAAT,0,1130933
fldAp,0.14285714285714285,6,6,CATCTGGTTTCAGCATTATA,0,1143070
fldAp,0.14285714285714285,6,6,CATCTGATCATTAAAATCCC,0,1166026
fldAp,0.14285714285714285,6,6,CATCGATCCAAATGGAGTAT,0,1161301
fldAp,0.14285714285714285,6,6,CATCCTGTCAGTAGATAAAA,0,1123381
fldAp,0.14285714285714285,6,6,CATCCCTAGGCGCGGTTTCC,0,1155093
fldAp,0.14285714285714285,6,6,CATCCAGGTTCGGTCCATGG,0,1115393
fldAp,0.14285714285714285,6,6,CATCATAGTCATACGTTAGG,0,1076183
fldAp,0.14285714285714285,6,6,CATCAGTTGGATGTGATTCT,0,1083064
fldAp,0.14285714285714285,6,6,CATCAGCGCTAACGGCAGGG,0,1120286
fldAp,0.14285714285714285,6,6,CATCACAATGCTGGCAGCCT,0,1073133
fldAp,0.14285714285714285,6,6,CATAGGTTTGGTCATTGGGC,0,1166970
fldAp,0.14285714285714285,6,6,CATACTCGCGTGGGATTAGC,0,1078874
fldAp,0.14285714285714285,6,6,CAGTTGCACTTTTAGATTGA,0,1171066
fldAp,0.14285714285714285,6,6,CAGTGTGGAAACGAAGCTCC,0,1069710
fldAp,0.14285714285714285,6,6,CAGTGGCAGTACGACTCTGG,0,1168069
fldAp,0.14285714285714285,6,6,CAGTCTTTTATTTCGGTCGG,0,1098548
fldAp,0.14285714285714285,6,6,CAGTCCGCTTAAAGACGACA,0,1129926
fldAp,0.14285714285714285,6,6,CAGTCCAAATAAGCCTGGAC,0,1110945
fldAp,0.14285714285714285,6,6,CAGTAATCACGTATAATCGC,0,1095771
fldAp,0.14285714285714285,6,6,CAGGTTGCATCGACGTGGCA,0,1170621
fldAp,0.14285714285714285,6,6,CAGGGGTCTTCACTTGGTTG,0,1121654
fldAp,0.14285714285714285,6,6,CAGGGGGTGCTGTGGAGACC,0,1076069
fldAp,0.14285714285714285,6,6,CAGGGGCTCGCCAGACAATA,0,1160257
fldAp,0.14285714285714285,6,6,CAGGGGCATGTCTCAGAGAA,0,1175389
fldAp,0.14285714285714285,6,6,CAGGGACAAAGTAACGCAGC,0,1155312
fldAp,0.14285714285714285,6,6,CAGGCAGGTGTATAGGCTTA,0,1166684
fldAp,0.14285714285714285,6,6,CAGGCAACGGAGAGTCGATC,0,1158460
fldAp,0.14285714285714285,6,6,CAGGAGATTCAATTAGCATA,0,1097791
fldAp,0.14285714285714285,6,6,CAGGAGAAGCATCTATCCTA,0,1084004
fldAp,0.14285714285714285,6,6,CAGCGGAACAGGGGGGTAAG,0,1162066
fldAp,0.14285714285714285,6,6,CAGCGCCGTCTTCGCGTGAT,0,1130432
fldAp,0.14285714285714285,6,6,CAGCCGGTGGACCCCCAGCC,0,1108757
fldAp,0.14285714285714285,6,6,CAGCCCCGAGACGCGTCATC,0,1141149
fldAp,0.14285714285714285,6,6,CAGCCATGGCTTCTGCACCG,0,1120342
fldAp,0.14285714285714285,6,6,CAGATCACGCTGTAAACAAA,0,1130612
fldAp,0.14285714285714285,6,6,CAGAGATCGCCTATGACGTT,0,1185764
fldAp,0.14285714285714285,6,6,CAGAACTATGACTATATTGG,0,1107386
fldAp,0.14285714285714285,6,6,CAGAACGACTCAACCTGCAG,0,1171359
fldAp,0.14285714285714285,6,6,CAGAAATTGACTGACCGTGA,0,1065046
fldAp,0.14285714285714285,6,6,CAGAAACGAGCCTGACGGTT,0,1152621
fldAp,0.14285714285714285,6,6,CACTTGATCTCACTGACTAC,0,1065124
fldAp,0.14285714285714285,6,6,CACTTCTCGAGCCCAGAGTA,0,1180430
fldAp,0.14285714285714285,6,6,CACTGTCGTTTGAGGACTAA,0,1138879
fldAp,0.14285714285714285,6,6,CACTGGGGCGTCTGACCGTC,0,1108057
fldAp,0.14285714285714285,6,6,CACTCAGTCCTATCCTAAGT,0,1070964
fldAp,0.14285714285714285,6,6,CACTATATTCACAGGTAATC,0,1157030
fldAp,0.14285714285714285,6,6,CACTAACGCGAGAATAGTAG,0,1133230
fldAp,0.14285714285714285,6,6,CACGTTCCCAGGGAACTGGA,0,1174476
fldAp,0.14285714285714285,6,6,CACGTGTTTTCGGGTACTTG,0,1107134
fldAp,0.14285714285714285,6,6,CACGGATTAGCAGCTCGCAG,0,1153442
fldAp,0.14285714285714285,6,6,CACGAGGTGCCTGCCATGAA,0,1064587
fldAp,0.14285714285714285,6,6,CACGACCCGCACATTCTGGC,0,1097463
fldAp,0.14285714285714285,6,6,CACGACAAAACTCACATCTT,0,1143362
fldAp,0.14285714285714285,6,6,CACGAATAGTTAGTTTTTTG,0,1144502
fldAp,0.14285714285714285,6,6,CACCTTGCCGAAGTGTTGAC,0,1081761
fldAp,0.14285714285714285,6,6,CACCTCGTGAGCTCCTCACA,0,1070227
fldAp,0.14285714285714285,6,6,CACCGGTGTGTTTCTCCCCA,0,1179896
fldAp,0.14285714285714285,6,6,CACCGCCCCAAGTCGTTAAG,0,1117709
fldAp,0.14285714285714285,6,6,CACCGAAATGATTAGCAACG,0,1106790
fldAp,0.14285714285714285,6,6,CACCCGTCTTAAATGAAAGT,0,1164684
fldAp,0.14285714285714285,6,6,CACCCGGGGACTTAAACTAT,0,1083222
fldAp,0.14285714285714285,6,6,CACAGACTTTAGTTCTTCTC,0,1132885
fldAp,0.14285714285714285,6,6,CACACAGCGACGAAACGGCG,0,1168927
fldAp,0.14285714285714285,6,6,CACACACCCTGCAGCCCTTT,0,1125979
fldAp,0.14285714285714285,6,6,CAATCTTCGATGTGACGGGG,0,1162485
fldAp,0.14285714285714285,6,6,CAATCTAACACGTCGGGTAT,0,1168926
fldAp,0.14285714285714285,6,6,CAAGTGAGTTACTGCACGGC,0,1119053
fldAp,0.14285714285714285,6,6,CAAGTATGGATATCTATGAT,0,1073196
fldAp,0.14285714285714285,6,6,CAAGGGATTCCGGGCGAGGT,0,1177313
fldAp,0.14285714285714285,6,6,CAAGGGAAGAGCTGTCGTCC,0,1158526
fldAp,0.14285714285714285,6,6,CAAGGCCAAACCGCTGCTAC,0,1079178
fldAp,0.14285714285714285,6,6,CAAGCGGAAGCGCACACGGA,0,1069380
fldAp,0.14285714285714285,6,6,CAAGAGTGAAATGGAGGCGC,0,1112641
fldAp,0.14285714285714285,6,6,CAAGAGCTCCGAGCGATGAG,0,1129360
fldAp,0.14285714285714285,6,6,CAAGACCAGACATTAATCTT,0,1076654
fldAp,0.14285714285714285,6,6,CAAGAATAAGGAGCAGTATG,0,1132880
fldAp,0.14285714285714285,6,6,CAACGTTTTCATAGGGCAGC,0,1094420
fldAp,0.14285714285714285,6,6,CAACGGCTACAGTGCAGAGG,0,1140756
fldAp,0.14285714285714285,6,6,CAACCGCTCTGAGCTGGAGT,0,1095794
fldAp,0.14285714285714285,6,6,CAACCGAACACATCTGACTG,0,1145429
fldAp,0.14285714285714285,6,6,CAACCCTCGTGAGACGGTTT,0,1117116
fldAp,0.14285714285714285,6,6,CAAAGCCCGGGTTCCGCCGT,0,1135598
fldAp,0.14285714285714285,6,6,CAAAGCACAGTAATTCTGCT,0,1158647
fldAp,0.14285714285714285,6,6,CAAACTGTCTAGTCTTGGTA,0,1170319
fldAp,0.14285714285714285,6,6,CAAAACAGCCACCACTCACT,0,1074140
fldAp,0.14285714285714285,6,6,ATTTGTACTTTCGCAATTAG,0,1080125
fldAp,0.14285714285714285,6,6,ATTTGGGCCGGCCAGTCAAA,0,1106515
fldAp,0.14285714285714285,6,6,ATTTGCTAGACGAAAGGTCT,0,1116626
fldAp,0.14285714285714285,6,6,ATTTCGTCTTCTCATCGAGC,0,1139405
fldAp,0.14285714285714285,6,6,ATTTCCTATAGCACTCACAC,0,1166962
fldAp,0.14285714285714285,6,6,ATTTCAAGTGTAAATTCTGA,0,1179201
fldAp,0.14285714285714285,6,6,ATTTAGTTGCCAGGACATGA,0,1067818
fldAp,0.14285714285714285,6,6,ATTTAAGTCAGGACTCACGT,0,1181737
fldAp,0.14285714285714285,6,6,ATTTAACATACACATGTTGA,0,1066464
fldAp,0.14285714285714285,6,6,ATTGTTCACGTGTGGTTGGT,0,1167095
fldAp,0.14285714285714285,6,6,ATTGGGAGGTCACCAATGGA,0,1170244
fldAp,0.14285714285714285,6,6,ATTGGCTTTACATCCGCATT,0,1161405
fldAp,0.14285714285714285,6,6,ATTGGCTAAAGCAGAGTAGT,0,1172489
fldAp,0.14285714285714285,6,6,ATTGGAATCGAATTTGGCGT,0,1102349
fldAp,0.14285714285714285,6,6,ATTGCGCGATAGATAAAGGG,0,1090432
fldAp,0.14285714285714285,6,6,ATTGCCCTGCAACCCGTCTG,0,1070212
fldAp,0.14285714285714285,6,6,ATTGCAGGAAACACCAAGGA,0,1137205
fldAp,0.14285714285714285,6,6,ATTCTGGAGCTGGGTCGCTA,0,1115434
fldAp,0.14285714285714285,6,6,ATTCTAAACGTGTTATATGA,0,1122729
fldAp,0.14285714285714285,6,6,ATTCGCACGGGAACGGTGTG,0,1185468
fldAp,0.14285714285714285,6,6,ATTCCTGCTTTACGTATTAA,0,1167758
fldAp,0.14285714285714285,6,6,ATTCCTATTCATGAGTGGAT,0,1085310
fldAp,0.14285714285714285,6,6,ATTCCAGGGAGTTTTGTGGC,0,1099753
fldAp,0.14285714285714285,6,6,ATTCAGTACGGGGGCATTCA,0,1065765
fldAp,0.14285714285714285,6,6,ATTCAGGTTTCCAATTAGTA,0,1135104
fldAp,0.14285714285714285,6,6,ATTATGTGGGCAAAGGTGGT,0,1179162
fldAp,0.14285714285714285,6,6,ATTAGCGGGAGCAGGCCGAA,0,1161686
fldAp,0.14285714285714285,6,6,ATTAGCATGGTGGGCACCGA,0,1078937
fldAp,0.14285714285714285,6,6,ATTAATTTGCTGGAAACGCG,0,1180839
fldAp,0.14285714285714285,6,6,ATGTTTACTCAGTAAATGAG,0,1184367
fldAp,0.14285714285714285,6,6,ATGTTGGATGGGCCGTCCTA,0,1070062
fldAp,0.14285714285714285,6,6,ATGTTGCACAATGGTAGTTT,0,1127392
fldAp,0.14285714285714285,6,6,ATGTTCGTTTACCGCGCTTA,0,1172644
fldAp,0.14285714285714285,6,6,ATGTTCCTATGTTCGTTGTG,0,1125469
fldAp,0.14285714285714285,6,6,ATGTTAGGGTCTGCAGCGGA,0,1150362
fldAp,0.14285714285714285,6,6,ATGTGAGTGAGGGGTTGCTG,0,1104829
fldAp,0.14285714285714285,6,6,ATGTCTTGCGCTCGGACACA,0,1103884
fldAp,0.14285714285714285,6,6,ATGGGTTACGGCGCTAGCGA,0,1077915
fldAp,0.14285714285714285,6,6,ATGGGCGTAAAGTTCGGGTA,0,1157670
fldAp,0.14285714285714285,6,6,ATGGCTCGTAAATAAGTTGG,0,1072949
fldAp,0.14285714285714285,6,6,ATGGCCTTTGTGCCCTGCAG,0,1093959
fldAp,0.14285714285714285,6,6,ATGGCAGATTGCTGCATTCC,0,1084995
fldAp,0.14285714285714285,6,6,ATGGCAAGGCTTGGCCCAAG,0,1116793
fldAp,0.14285714285714285,6,6,ATGGACACGAGTCAACAGGA,0,1170949
fldAp,0.14285714285714285,6,6,ATGCTTTTCTGTCAACCGTA,0,1065718
fldAp,0.14285714285714285,6,6,ATGCTGGATACCAAATACGG,0,1088000
fldAp,0.14285714285714285,6,6,ATGCTAAGATCCTCTGGTAC,0,1157346
fldAp,0.14285714285714285,6,6,ATGCGTCAAAGCTTCGACGA,0,1099940
fldAp,0.14285714285714285,6,6,ATGCGAGGGGGTGTATCCAA,0,1129115
fldAp,0.14285714285714285,6,6,ATGCATCGAGTAACAGGATA,0,1134245
fldAp,0.14285714285714285,6,6,ATGATGCTAGGCTTTAAGCT,0,1097806
fldAp,0.14285714285714285,6,6,ATGATGCACATAAAGTTAGG,0,1101000
fldAp,0.14285714285714285,6,6,ATGACTGCGTGGTCAAGCCC,0,1105902
fldAp,0.14285714285714285,6,6,ATGACTCAGAGGAACAATAA,0,1136173
fldAp,0.14285714285714285,6,6,ATGACAACCACACGATAAAG,0,1104251
fldAp,0.14285714285714285,6,6,ATGAATCAGCGCCCAATGGG,0,1115835
fldAp,0.14285714285714285,6,6,ATGAACGTCTAATGGGGCGG,0,1166073
fldAp,0.14285714285714285,6,6,ATGAACAATTGCCGGTGTCG,0,1092775
fldAp,0.14285714285714285,6,6,ATGAAAAGGACTCGCTAAGC,0,1132723
fldAp,0.14285714285714285,6,6,ATCTTGAAACGCGGAGGAGA,0,1102424
fldAp,0.14285714285714285,6,6,ATCTGGTGTTCCTTATGGTG,0,1181055
fldAp,0.14285714285714285,6,6,ATCTGAAAGCACATGCTCTA,0,1075624
fldAp,0.14285714285714285,6,6,ATCTCCATTGGTCACACGGC,0,1169952
fldAp,0.14285714285714285,6,6,ATCTACAGGAACAACCCTCA,0,1129257
fldAp,0.14285714285714285,6,6,ATCGCTCTGACGGAAGCGAG,0,1153592
fldAp,0.14285714285714285,6,6,ATCGCTCGTAATCCTTGGCC,0,1110959
fldAp,0.14285714285714285,6,6,ATCGCGATCTCGACCTTTCT,0,1071744
fldAp,0.14285714285714285,6,6,ATCGATCGCTGAACACGCAA,0,1136309
fldAp,0.14285714285714285,6,6,ATCGAGGGTCGTAACGGTCA,0,1106644
fldAp,0.14285714285714285,6,6,ATCCTGGCCTCCCTAGGTGT,0,1166271
fldAp,0.14285714285714285,6,6,ATCCTCCGAACCTAATGGGT,0,1098019
fldAp,0.14285714285714285,6,6,ATCCTAGTTCGGGCGGTGCA,0,1090132
fldAp,0.14285714285714285,6,6,ATCCGTCGTTCGTTGGAAAG,0,1115351
fldAp,0.14285714285714285,6,6,ATCCGGGTCGAGAACGCTAC,0,1116339
fldAp,0.14285714285714285,6,6,ATCCCTCGATGCGTCCAAAC,0,1133521
fldAp,0.14285714285714285,6,6,ATCCCCCCACGATTCAGCGA,0,1083113
fldAp,0.14285714285714285,6,6,ATCCATTAGTGAGGCGGAAA,0,1085789
fldAp,0.14285714285714285,6,6,ATCCAGCTTTATATATTCGG,0,1103518
fldAp,0.14285714285714285,6,6,ATCCAAACCGCCCTCGTACG,0,1118955
fldAp,0.14285714285714285,6,6,ATCAGGATATGGTGAAACTA,0,1085715
fldAp,0.14285714285714285,6,6,ATCACACCCATCCACCTATG,0,1174451
fldAp,0.14285714285714285,6,6,ATCAATGTATCGGAGGGAGA,0,1081774
fldAp,0.14285714285714285,6,6,ATATTGAGTGGGTGTCAGCG,0,1163565
fldAp,0.14285714285714285,6,6,ATATGTTCAAGTGAGGAACG,0,1175934
fldAp,0.14285714285714285,6,6,ATATGTGACGTCATTCTACT,0,1120678
fldAp,0.14285714285714285,6,6,ATATAGCCTCAACAAGCGCC,0,1092278
fldAp,0.14285714285714285,6,6,ATAGTGTCGGGAAGAACGTG,0,1101976
fldAp,0.14285714285714285,6,6,ATAGTCTACGGGAGGCTAAT,0,1078290
fldAp,0.14285714285714285,6,6,ATAGTATGGCGAATTCGAAT,0,1122694
fldAp,0.14285714285714285,6,6,ATAGGCTTGGTGATCTACAT,0,1090308
fldAp,0.14285714285714285,6,6,ATAGCGAGATTATATAGGGT,0,1136758
fldAp,0.14285714285714285,6,6,ATAGATTAGAGATCGTCTAC,0,1105682
fldAp,0.14285714285714285,6,6,ATAGAGACACGTAATATGGA,0,1093087
fldAp,0.14285714285714285,6,6,ATACTTCAACATAAGAGGAA,0,1083251
fldAp,0.14285714285714285,6,6,ATACGTTAAGGTAGTCATTT,0,1155621
fldAp,0.14285714285714285,6,6,ATACGAGATCTGTCGAAAAC,0,1165233
fldAp,0.14285714285714285,6,6,ATACAGGATGAGGGCTAGAC,0,1136430
fldAp,0.14285714285714285,6,6,ATACACACGGCTGCACATTG,0,1138261
fldAp,0.14285714285714285,6,6,ATACAAGACCAAGCGCGCAT,0,1185927
fldAp,0.14285714285714285,6,6,ATAACGGTAAGTTATGACTC,0,1089599
fldAp,0.14285714285714285,6,6,ATAAAGGTAAATAGCAATAG,0,1121766
fldAp,0.14285714285714285,6,6,AGTTTGGGCGGGGTGAGACA,0,1154047
fldAp,0.14285714285714285,6,6,AGTTTGGGAAGTACTCTTTC,0,1118191
fldAp,0.14285714285714285,6,6,AGTTGTTCCAGGGACCTGAA,0,1119591
fldAp,0.14285714285714285,6,6,AGTTGACTTCTGTCAGTAGT,0,1081487
fldAp,0.14285714285714285,6,6,AGTTGACGAAAACCAAGAGT,0,1078535
fldAp,0.14285714285714285,6,6,AGTTCTGGTACGAGTTCGCG,0,1143286
fldAp,0.14285714285714285,6,6,AGTTCATTTCGTGAAGTATT,0,1100056
fldAp,0.14285714285714285,6,6,AGTTCAAACTGACGAGCGTA,0,1113914
fldAp,0.14285714285714285,6,6,AGTTATTGCTTCCGTACCCA,0,1099823
fldAp,0.14285714285714285,6,6,AGTTAGGTGGGCACGTATTA,0,1104637
fldAp,0.14285714285714285,6,6,AGTTAGAACATCCGTGCTCC,0,1084153
fldAp,0.14285714285714285,6,6,AGTGTGCTTTGAAAATCTGT,0,1075590
fldAp,0.14285714285714285,6,6,AGTGTGAGGCCTTTTTTGAT,0,1067096
fldAp,0.14285714285714285,6,6,AGTGGTTGACGGGATCGAGG,0,1101663
fldAp,0.14285714285714285,6,6,AGTGGGATCAGAGAAGAATA,0,1065350
fldAp,0.14285714285714285,6,6,AGTCTGGTTTAGCAGATTTA,0,1178229
fldAp,0.14285714285714285,6,6,AGTCCCGGGGCCCCAGCTGA,0,1163877
fldAp,0.14285714285714285,6,6,AGTCCAGCGGGAGAAGCTCA,0,1171804
fldAp,0.14285714285714285,6,6,AGTCATATTGGACGATCGTA,0,1147525
fldAp,0.14285714285714285,6,6,AGTCACTTCAAAGTCGCCCT,0,1169105
fldAp,0.14285714285714285,6,6,AGTATTATTGGCTACTGCTA,0,1149285
fldAp,0.14285714285714285,6,6,AGTATGAGTACTTCGTAATA,0,1134077
fldAp,0.14285714285714285,6,6,AGTAGGGAGCAGATGGAGTA,0,1081216
fldAp,0.14285714285714285,6,6,AGTAGGCGCAATGGGGCGGT,0,1153006
fldAp,0.14285714285714285,6,6,AGTAGCGCGGGCTAACTGGG,0,1154852
fldAp,0.14285714285714285,6,6,AGTACCGTACTCAGATAGTA,0,1077108
fldAp,0.14285714285714285,6,6,AGGTTTCACGCAAAACTGTA,0,1122662
fldAp,0.14285714285714285,6,6,AGGTTGTAACGGGTCACGTT,0,1107770
fldAp,0.14285714285714285,6,6,AGGTTCTATTCGATCCGCTA,0,1148286
fldAp,0.14285714285714285,6,6,AGGTTAGCGTGTAATGGCTT,0,1108814
fldAp,0.14285714285714285,6,6,AGGTGGTTTACAGGGCTGGT,0,1180813
fldAp,0.14285714285714285,6,6,AGGTGGCTGTGCACGGACGA,0,1080058
fldAp,0.14285714285714285,6,6,AGGTGCAGGCTGACGCAACG,0,1184498
fldAp,0.14285714285714285,6,6,AGGTGAGGCGCAGGCTAAAA,0,1121890
fldAp,0.14285714285714285,6,6,AGGTGAGACCCTCGATGCAC,0,1168512
fldAp,0.14285714285714285,6,6,AGGTGACCACGTCCGTCCGA,0,1182595
fldAp,0.14285714285714285,6,6,AGGTCTGTGATAGTAGCTCT,0,1111669
fldAp,0.14285714285714285,6,6,AGGTCTGGTTTCAATGTTGT,0,1128968
fldAp,0.14285714285714285,6,6,AGGTCTATCGATCAACGAGG,0,1091609
fldAp,0.14285714285714285,6,6,AGGTCGTCTTGTTGCTTTTA,0,1155726
fldAp,0.14285714285714285,6,6,AGGGTGGATAATCTCGTGAT,0,1150649
fldAp,0.14285714285714285,6,6,AGGGTCATAAAGTACTAGAG,0,1084190
fldAp,0.14285714285714285,6,6,AGGGGCCTACGATGCGCTCT,0,1085350
fldAp,0.14285714285714285,6,6,AGGGGAATGCCAGCCAACTA,0,1167274
fldAp,0.14285714285714285,6,6,AGGGCATTGTTCGCAAAGCG,0,1075145
fldAp,0.14285714285714285,6,6,AGGGATGGTTACTAATAGTG,0,1084715
fldAp,0.14285714285714285,6,6,AGGGATCTGACAGTGAGACA,0,1101875
fldAp,0.14285714285714285,6,6,AGGGATAATATCCCGACTAG,0,1126626
fldAp,0.14285714285714285,6,6,AGGCTGCAAAGTTCAGTCTA,0,1086060
fldAp,0.14285714285714285,6,6,AGGCTCAATGAACACCTACC,0,1087593
fldAp,0.14285714285714285,6,6,AGGCGGCCTCCGGAGACGCA,0,1086549
fldAp,0.14285714285714285,6,6,AGGCGGAATGGAGGCGAGCG,0,1153737
fldAp,0.14285714285714285,6,6,AGGCGCTCGTCACGGGGACA,0,1080551
fldAp,0.14285714285714285,6,6,AGGCCGTAAGCAGTTGGCGA,0,1082297
fldAp,0.14285714285714285,6,6,AGGCCGCGGTAGGAAATAAT,0,1152640
fldAp,0.14285714285714285,6,6,AGGCCAGTCACATATGCCGG,0,1102617
fldAp,0.14285714285714285,6,6,AGGCAATAATTTTTGCGAGG,0,1096169
fldAp,0.14285714285714285,6,6,AGGCAAGAACTAGCGAACTA,0,1152892
fldAp,0.14285714285714285,6,6,AGGATTTGCCGGAATTCGAC,0,1182314
fldAp,0.14285714285714285,6,6,AGGATGCTTCAACCCGTGGC,0,1117629
fldAp,0.14285714285714285,6,6,AGGATCTGGCACAGGACGTT,0,1135243
fldAp,0.14285714285714285,6,6,AGGAGAGAATTGGGGTGTTA,0,1093210
fldAp,0.14285714285714285,6,6,AGGAATTCGTCTCACGGCTA,0,1183188
fldAp,0.14285714285714285,6,6,AGCTTTTACTCGTGAAAGAG,0,1168044
fldAp,0.14285714285714285,6,6,AGCTTGAACAGACATTCCCG,0,1166197
fldAp,0.14285714285714285,6,6,AGCTTATGAAGGGCATGCCC,0,1083187
fldAp,0.14285714285714285,6,6,AGCTGGGTTTGCACGACGAA,0,1170425
fldAp,0.14285714285714285,6,6,AGCTGGAATAGCTTAGGACG,0,1136815
fldAp,0.14285714285714285,6,6,AGCTCTCGTCGCCCGACTCA,0,1075249
fldAp,0.14285714285714285,6,6,AGCTCAGCAAGGACTTGCCT,0,1182045
fldAp,0.14285714285714285,6,6,AGCTATGTCCACTGCCTTTA,0,1066828
fldAp,0.14285714285714285,6,6,AGCGGGACTCGAGCCGGGCT,0,1160900
fldAp,0.14285714285714285,6,6,AGCGACCGACGTTTCTCGTC,0,1083419
fldAp,0.14285714285714285,6,6,AGCCTGTGGAGGGCGCTCGT,0,1133307
fldAp,0.14285714285714285,6,6,AGCCGTAACATTCTCTGCGA,0,1095916
fldAp,0.14285714285714285,6,6,AGCCGCCTGGAAGGGTATGG,0,1105727
fldAp,0.14285714285714285,6,6,AGCCATTTCAATAATCCAAT,0,1165162
fldAp,0.14285714285714285,6,6,AGCCATGGAAGGGCCATGCC,0,1092518
fldAp,0.14285714285714285,6,6,AGCCATATATGTAGTGTTAC,0,1169996
fldAp,0.14285714285714285,6,6,AGCCAGTCAATCGGTGACAT,0,1143476
fldAp,0.14285714285714285,6,6,AGCCACCGAGCGTCCAGAAA,0,1181066
fldAp,0.14285714285714285,6,6,AGCACTTCATGGCGCCAGTT,0,1129925
fldAp,0.14285714285714285,6,6,AGCACTGCGAGGGACAACAT,0,1093441
fldAp,0.14285714285714285,6,6,AGCACGATAGAGGCCGAGTC,0,1091929
fldAp,0.14285714285714285,6,6,AGCACATCCAGGGAGCGCGC,0,1077446
fldAp,0.14285714285714285,6,6,AGATTCCTATTAAAGTATGC,0,1095167
fldAp,0.14285714285714285,6,6,AGATGCATCGCGGGGACAGC,0,1101524
fldAp,0.14285714285714285,6,6,AGATGCAACGTGCGCTTAGT,0,1068003
fldAp,0.14285714285714285,6,6,AGATATTGTAGGGCTACTAA,0,1151684
fldAp,0.14285714285714285,6,6,AGATACGAGTTACAATCCCC,0,1082440
fldAp,0.14285714285714285,6,6,AGATAAGTTTTCCTAAGACA,0,1125006
fldAp,0.14285714285714285,6,6,AGAGGGAGCGTAATAATCCC,0,1168680
fldAp,0.14285714285714285,6,6,AGAGATGCTTTGCCCTACAT,0,1130074
fldAp,0.14285714285714285,6,6,AGACTTGTCCGGGTTCGCCA,0,1168420
fldAp,0.14285714285714285,6,6,AGACTAGGGCAATTACTACA,0,1159072
fldAp,0.14285714285714285,6,6,AGACTACAGGATTTACTAGG,0,1150567
fldAp,0.14285714285714285,6,6,AGACGAACGATTCGTCAACA,0,1171831
fldAp,0.14285714285714285,6,6,AGACCAGAGGTCATGCGAAA,0,1149306
fldAp,0.14285714285714285,6,6,AGACAGGCTTTATTTACAAA,0,1147372
fldAp,0.14285714285714285,6,6,AGACAGCCCAAGTCACGGAT,0,1134657
fldAp,0.14285714285714285,6,6,AGAATGCGGGATACGACGAG,0,1117160
fldAp,0.14285714285714285,6,6,AGAATCTGCGCGGATCGATT,0,1122791
fldAp,0.14285714285714285,6,6,AGAATCGTGCTCGGTGCATT,0,1116295
fldAp,0.14285714285714285,6,6,AGAATCATGTTTGATTGCGA,0,1114531
fldAp,0.14285714285714285,6,6,AGAACGCGACGCTATCCTAT,0,1091182
fldAp,0.14285714285714285,6,6,AGAAATCGGTGTTGTTCGCA,0,1111413
fldAp,0.14285714285714285,6,6,AGAAAGTCTTGTGTTGACGG,0,1092909
fldAp,0.14285714285714285,6,6,AGAAAGGATACCGAGGAGGG,0,1106442
fldAp,0.14285714285714285,6,6,ACTTTGGTCATCTGCATTCA,0,1071541
fldAp,0.14285714285714285,6,6,ACTTTGAGGCCACGATGAGT,0,1116271
fldAp,0.14285714285714285,6,6,ACTTGGACGAGTCGCCTTTT,0,1101748
fldAp,0.14285714285714285,6,6,ACTTGCAATGCAGACTTTAT,0,1182795
fldAp,0.14285714285714285,6,6,ACTTCGTGAGCTGGCACGCA,0,1086557
fldAp,0.14285714285714285,6,6,ACTTCCGAGAGTTACACCAG,0,1106219
fldAp,0.14285714285714285,6,6,ACTTCAATCACGATCTACAT,0,1176478
fldAp,0.14285714285714285,6,6,ACTGTGCCATCCGATGGGTC,0,1147972
fldAp,0.14285714285714285,6,6,ACTGTCGTGTTCGTAATCTG,0,1140792
fldAp,0.14285714285714285,6,6,ACTGTCGTCGGCTTGACGGG,0,1063310
fldAp,0.14285714285714285,6,6,ACTGGTTCGCTGTATTCAGG,0,1159201
fldAp,0.14285714285714285,6,6,ACTGGACCGTGCAAAACATC,0,1064430
fldAp,0.14285714285714285,6,6,ACTGCCAGCGCGAACCCTGA,0,1089387
fldAp,0.14285714285714285,6,6,ACTGATGCCCCGTGAGGTAA,0,1181740
fldAp,0.14285714285714285,6,6,ACTGAGAAAGGCAGATGCGA,0,1150466
fldAp,0.14285714285714285,6,6,ACTCTCAGCGACCTCGGGCA,0,1090430
fldAp,0.14285714285714285,6,6,ACTCGGGTCTTGGTAGTCGC,0,1147030
fldAp,0.14285714285714285,6,6,ACTCCCCTCTAGCACCCTGC,0,1072026
fldAp,0.14285714285714285,6,6,ACTATTAGTACGAGAAAGTG,0,1094037
fldAp,0.14285714285714285,6,6,ACTAGGGGAAGAATATCAAA,0,1118165
fldAp,0.14285714285714285,6,6,ACTAGGAGCATAGGCACTTT,0,1122818
fldAp,0.14285714285714285,6,6,ACTAGCCAGTGCATGCCGGA,0,1126423
fldAp,0.14285714285714285,6,6,ACTACAAAACGTGGGAACGG,0,1091801
fldAp,0.14285714285714285,6,6,ACTAACACGGATTATCTGCC,0,1079405
fldAp,0.14285714285714285,6,6,ACGTTTCCATATCGAAGACT,0,1121960
fldAp,0.14285714285714285,6,6,ACGTTCCTACTACTACATTC,0,1143270
fldAp,0.14285714285714285,6,6,ACGTTACTCACCAGATGTCA,0,1161615
fldAp,0.14285714285714285,6,6,ACGTGGCACGATTCCCCCAA,0,1146042
fldAp,0.14285714285714285,6,6,ACGTGCATCTGGCATAATTC,0,1123950
fldAp,0.14285714285714285,6,6,ACGTCGGCACGGGGGGTCAA,0,1094838
fldAp,0.14285714285714285,6,6,ACGTAGTATTCCAACTGTGA,0,1122040
fldAp,0.14285714285714285,6,6,ACGTAGGGTCACTTCTGGAC,0,1073609
fldAp,0.14285714285714285,6,6,ACGGTGTTGGTGGTAAGAGT,0,1073823
fldAp,0.14285714285714285,6,6,ACGGTGCGATGGGTACCCCC,0,1142799
fldAp,0.14285714285714285,6,6,ACGGTCAACGAGCTTCGAGT,0,1069513
fldAp,0.14285714285714285,6,6,ACGGGTTAAGCCTTGTAACC,0,1071057
fldAp,0.14285714285714285,6,6,ACGGGATGACCAAAATTTTT,0,1136249
fldAp,0.14285714285714285,6,6,ACGGGATATTGACTCCAGGG,0,1156401
fldAp,0.14285714285714285,6,6,ACGGCGGCATCGGAGGTCAG,0,1081394
fldAp,0.14285714285714285,6,6,ACGGCAAGGGCGGATTTCTG,0,1108249
fldAp,0.14285714285714285,6,6,ACGGCAACGTCATTAGATTT,0,1166586
fldAp,0.14285714285714285,6,6,ACGGAGCGCCCGCGCGATGC,0,1104185
fldAp,0.14285714285714285,6,6,ACGGAATACGTTACAAGAAA,0,1085733
fldAp,0.14285714285714285,6,6,ACGCGTCGTTATGGTGGTAA,0,1182744
fldAp,0.14285714285714285,6,6,ACGCGGGTCCGAATAGCTAA,0,1165571
fldAp,0.14285714285714285,6,6,ACGCGGACCTGGAGGCACCG,0,1113318
fldAp,0.14285714285714285,6,6,ACGCGCTTAAGTACGATTAC,0,1141222
fldAp,0.14285714285714285,6,6,ACGCGCGGGCACCAAATGAT,0,1111257
fldAp,0.14285714285714285,6,6,ACGCCCCCAATCCAGAACCG,0,1128137
fldAp,0.14285714285714285,6,6,ACGCAGTGGAGAGAATCTCT,0,1076961
fldAp,0.14285714285714285,6,6,ACGCACGTCCCGAACAGCGT,0,1099082
fldAp,0.14285714285714285,6,6,ACGCACCCGCGTCAGAGTAC,0,1154214
fldAp,0.14285714285714285,6,6,ACGCAAGCGCCCATATGGAA,0,1099401
fldAp,0.14285714285714285,6,6,ACGATGGCGGGCGCGCGCAA,0,1068041
fldAp,0.14285714285714285,6,6,ACGACGAAACGGTACCTTTG,0,1064403
fldAp,0.14285714285714285,6,6,ACGACATCAAAAAGCCGTTG,0,1148475
fldAp,0.14285714285714285,6,6,ACCTGGGGTTCGAAGGGTCA,0,1099978
fldAp,0.14285714285714285,6,6,ACCTGGCTCTAGAGCAGGCA,0,1129475
fldAp,0.14285714285714285,6,6,ACCTGGCATGTTATGAAACT,0,1113633
fldAp,0.14285714285714285,6,6,ACCTCAGGTTTATCAACTAT,0,1172501
fldAp,0.14285714285714285,6,6,ACCGGGATAAATTACGAGTT,0,1113433
fldAp,0.14285714285714285,6,6,ACCGCTGATACCCATCACAC,0,1107878
fldAp,0.14285714285714285,6,6,ACCGCAGGTTTCGGGGCGAA,0,1111411
fldAp,0.14285714285714285,6,6,ACCGAGGCGCCACATTCGGG,0,1141365
fldAp,0.14285714285714285,6,6,ACCGAGGCACCAAGCCGCAG,0,1177845
fldAp,0.14285714285714285,6,6,ACCCTGGCGACCGCTCTTTG,0,1129593
fldAp,0.14285714285714285,6,6,ACCCGTGCCCTCGAACTCCC,0,1108489
fldAp,0.14285714285714285,6,6,ACCCGCTCCACCTCAGAGTC,0,1087614
fldAp,0.14285714285714285,6,6,ACCCGCGATAGGTACATATG,0,1098718
fldAp,0.14285714285714285,6,6,ACCCGCCCATAGCATCAAAA,0,1162410
fldAp,0.14285714285714285,6,6,ACCCCTTTGGTCAAATGCGT,0,1140040
fldAp,0.14285714285714285,6,6,ACCCCTTAATTTCAACACTA,0,1161481
fldAp,0.14285714285714285,6,6,ACCCCGCATCAACGCTTCTA,0,1170680
fldAp,0.14285714285714285,6,6,ACCCACGGTGATTTGATCTG,0,1087304
fldAp,0.14285714285714285,6,6,ACCATGCGAGGCCCAGTCGT,0,1135582
fldAp,0.14285714285714285,6,6,ACCACTCGGCTCAATATTCG,0,1068297
fldAp,0.14285714285714285,6,6,ACCACCCCCCACCACCGACG,0,1125679
fldAp,0.14285714285714285,6,6,ACATTAGCGATCCAACAAGT,0,1166910
fldAp,0.14285714285714285,6,6,ACATTAAGAGGTCAACGCTC,0,1185747
fldAp,0.14285714285714285,6,6,ACATGTCTCGATGTACTAGA,0,1091776
fldAp,0.14285714285714285,6,6,ACATGGTCTACGGCGGACCT,0,1122055
fldAp,0.14285714285714285,6,6,ACATGGCGGACGCGGCGTAT,0,1186684
fldAp,0.14285714285714285,6,6,ACATGCGTTGGATTCCCATC,0,1126204
fldAp,0.14285714285714285,6,6,ACATCTGTTCCCCAATTGTA,0,1144602
fldAp,0.14285714285714285,6,6,ACATACGCCGGGTGGCATCC,0,1065134
fldAp,0.14285714285714285,6,6,ACAGTCTACGCATGCTAGAA,0,1158818
fldAp,0.14285714285714285,6,6,ACAGTACCCGATTCCGTGGG,0,1111779
fldAp,0.14285714285714285,6,6,ACAGGCAGCGTGTTTAGGCC,0,1144852
fldAp,0.14285714285714285,6,6,ACAGGCACCAGCCATGTGGT,0,1116489
fldAp,0.14285714285714285,6,6,ACAGCGTATCATACGAGCGA,0,1124757
fldAp,0.14285714285714285,6,6,ACAGCCGCAAAGCGTCGGAG,0,1089925
fldAp,0.14285714285714285,6,6,ACAGCCCATGATAGGCGCCG,0,1140468
fldAp,0.14285714285714285,6,6,ACAGCCATGCCCGTGTAAAC,0,1087836
fldAp,0.14285714285714285,6,6,ACAGATGTATCCTAATCACA,0,1148370
fldAp,0.14285714285714285,6,6,ACAGATACTTGATCTAGGCG,0,1176991
fldAp,0.14285714285714285,6,6,ACAGAGTCCCGCGATGCTAG,0,1072839
fldAp,0.14285714285714285,6,6,ACAGAGACTGGTTCATTAGT,0,1074290
fldAp,0.14285714285714285,6,6,ACACGGATGCCGTGCAGGTT,0,1076905
fldAp,0.14285714285714285,6,6,ACACGCTCCGGTCTGGCCAG,0,1066233
fldAp,0.14285714285714285,6,6,ACACGATTCTGGCGAAACAC,0,1153221
fldAp,0.14285714285714285,6,6,ACACCGCAAACGTGAGGCTC,0,1140990
fldAp,0.14285714285714285,6,6,ACACCCAGATGTATTGGCCC,0,1114023
fldAp,0.14285714285714285,6,6,ACACATAGATGTTCAGCGGC,0,1169715
fldAp,0.14285714285714285,6,6,ACACATACACCAAGCCGTGT,0,1172820
fldAp,0.14285714285714285,6,6,ACAAGTTGTGCAAACACAAA,0,1183297
fldAp,0.14285714285714285,6,6,ACAAGGTCCAGCACTCTCGT,0,1171834
fldAp,0.14285714285714285,6,6,ACAAGGCATGGCAGGACAAA,0,1147116
fldAp,0.14285714285714285,6,6,AATTTATCGAGTCTTGCATT,0,1095451
fldAp,0.14285714285714285,6,6,AATTGGTCCAGTAGAAACGG,0,1092604
fldAp,0.14285714285714285,6,6,AATTCGGGGTGGATTAACGC,0,1150878
fldAp,0.14285714285714285,6,6,AATTACGCGTTTGATTGGCT,0,1133949
fldAp,0.14285714285714285,6,6,AATGTCCGTGCCAGTCAGCA,0,1066277
fldAp,0.14285714285714285,6,6,AATGCTCGACTAAGAAGTAA,0,1102070
fldAp,0.14285714285714285,6,6,AATGCAGAGGAGGAGATGGA,0,1091184
fldAp,0.14285714285714285,6,6,AATGACCTTGAACATCGTGC,0,1132138
fldAp,0.14285714285714285,6,6,AATGAATAGCCACGGTTCGT,0,1112203
fldAp,0.14285714285714285,6,6,AATCTCCCCGTCCAGCGTAA,0,1157979
fldAp,0.14285714285714285,6,6,AATCGTTTGGGCTGCGCCAC,0,1112783
fldAp,0.14285714285714285,6,6,AATCGATAGGCTTTAACCTC,0,1085424
fldAp,0.14285714285714285,6,6,AATCCTTATCTGGGTTGCTT,0,1163971
fldAp,0.14285714285714285,6,6,AATCACCTGTATGCATTTGA,0,1117006
fldAp,0.14285714285714285,6,6,AATATTACAGGGAGCCGTCC,0,1086014
fldAp,0.14285714285714285,6,6,AATATGGCTGTTAGATCATA,0,1134743
fldAp,0.14285714285714285,6,6,AATATCATTATGTACGGTCT,0,1072407
fldAp,0.14285714285714285,6,6,AATAGGGATAGTAATAGGTC,0,1127191
fldAp,0.14285714285714285,6,6,AATACGATCTCCATTAGTCA,0,1165998
fldAp,0.14285714285714285,6,6,AAGTGTCCAGATCGCTAGGA,0,1132640
fldAp,0.14285714285714285,6,6,AAGTGTCACAAATTTTTCTA,0,1070575
fldAp,0.14285714285714285,6,6,AAGTGCAGATTAACATACTA,0,1171380
fldAp,0.14285714285714285,6,6,AAGTCTCCGCGGACCCCCAT,0,1177390
fldAp,0.14285714285714285,6,6,AAGTCTCCAGGCTCGTCCGT,0,1118195
fldAp,0.14285714285714285,6,6,AAGTCTATGTTAATATGTAT,0,1145254
fldAp,0.14285714285714285,6,6,AAGTCGTGCCGTAGACTGGT,0,1103346
fldAp,0.14285714285714285,6,6,AAGTAGGATTCTCTCCTGAT,0,1080441
fldAp,0.14285714285714285,6,6,AAGTACCACGGATGCATGAC,0,1110526
fldAp,0.14285714285714285,6,6,AAGTAACCGTCGTCACACGT,0,1069697
fldAp,0.14285714285714285,6,6,AAGGTCAGGCTTAGTATGTA,0,1153027
fldAp,0.14285714285714285,6,6,AAGGTAGCGGCTCAATTATG,0,1101033
fldAp,0.14285714285714285,6,6,AAGGGCGCCATTTGCTGGCA,0,1178903
fldAp,0.14285714285714285,6,6,AAGGATCATTTCGACACGGT,0,1156248
fldAp,0.14285714285714285,6,6,AAGGATAAAGTGCTACCCCC,0,1116570
fldAp,0.14285714285714285,6,6,AAGGAGTCGGTATGTACATT,0,1159557
fldAp,0.14285714285714285,6,6,AAGCTAACCCACGGCCTGTT,0,1145812
fldAp,0.14285714285714285,6,6,AAGCGCAACGTGTCTAGACG,0,1176438
fldAp,0.14285714285714285,6,6,AAGCGAATCTTTGACAATGG,0,1158342
fldAp,0.14285714285714285,6,6,AAGCCGATTGGGAACCAAAG,0,1108413
fldAp,0.14285714285714285,6,6,AAGCCCCGTTAAAGCGGTTT,0,1113970
fldAp,0.14285714285714285,6,6,AAGCATACGGGGGGGGAATG,0,1101740
fldAp,0.14285714285714285,6,6,AAGCAGAAAATGCAAAAGCA,0,1129711
fldAp,0.14285714285714285,6,6,AAGATTGTCTGCAGAACGGG,0,1112613
fldAp,0.14285714285714285,6,6,AAGATTCTGTTTCGGTTCTA,0,1161762
fldAp,0.14285714285714285,6,6,AAGAGCGTACCTTAAATAGA,0,1140696
fldAp,0.14285714285714285,6,6,AAGACGTTGAACCGAATGGC,0,1096141
fldAp,0.14285714285714285,6,6,AAGACAACGCGGTTCACCAG,0,1127578
fldAp,0.14285714285714285,6,6,AAGAAATTAGGGATCATTCC,0,1146822
fldAp,0.14285714285714285,6,6,AACTTTCCGGCCCATCGTCG,0,1107989
fldAp,0.14285714285714285,6,6,AACTTCCCCACGTGGGTCAC,0,1093636
fldAp,0.14285714285714285,6,6,AACTGTAGGTCACCAGCGAG,0,1070399
fldAp,0.14285714285714285,6,6,AACTGAGATCATCGTGACAG,0,1121329
fldAp,0.14285714285714285,6,6,AACTCCGGGTACTGACCTGG,0,1151576
fldAp,0.14285714285714285,6,6,AACTCAAAGGTGGGCACGGG,0,1098597
fldAp,0.14285714285714285,6,6,AACTAAAAGCGGCCAGATCC,0,1109933
fldAp,0.14285714285714285,6,6,AACGTTTTTGCCCTGCTAAT,0,1150183
fldAp,0.14285714285714285,6,6,AACGGGGAGGCATGGGTAAT,0,1174874
fldAp,0.14285714285714285,6,6,AACGGGCATTTATGCGAACG,0,1104363
fldAp,0.14285714285714285,6,6,AACGGATCGCTTCCTACTCT,0,1129682
fldAp,0.14285714285714285,6,6,AACGGAATCCCGTGCCCACT,0,1072411
fldAp,0.14285714285714285,6,6,AACGAGAAATCAACCCAGAG,0,1128436
fldAp,0.14285714285714285,6,6,AACCTCGCACCTAGCCCATG,0,1156042
fldAp,0.14285714285714285,6,6,AACCCACACGGGCCGCCTCT,0,1152867
fldAp,0.14285714285714285,6,6,AACCATTTGCAGTCCAGATT,0,1116759
fldAp,0.14285714285714285,6,6,AACATCGGCGCGCCATCTGC,0,1124491
fldAp,0.14285714285714285,6,6,AACATACTCAAGTCTGAACT,0,1102282
fldAp,0.14285714285714285,6,6,AACAGTTTATGTTTTCTATC,0,1121545
fldAp,0.14285714285714285,6,6,AACAGCCTCAATTGTTCAGT,0,1121250
fldAp,0.14285714285714285,6,6,AACACTTATAACTATTCGCT,0,1183491
fldAp,0.14285714285714285,6,6,AACACCAGCAAGTTTAGGTG,0,1161340
fldAp,0.14285714285714285,6,6,AACAAAAGGTACACACATCC,0,1129333
fldAp,0.14285714285714285,6,6,AAATTCGATAATCATCTGCG,0,1137068
fldAp,0.14285714285714285,6,6,AAATTCCTAATGGGAACCCG,0,1181988
fldAp,0.14285714285714285,6,6,AAATGACAGACGCTCGCTCG,0,1153351
fldAp,0.14285714285714285,6,6,AAATCGAAATATCTAGACGC,0,1068188
fldAp,0.14285714285714285,6,6,AAATCATGATTTAGAAGTTT,0,1121479
fldAp,0.14285714285714285,6,6,AAATCAATCGGCAGTCTGAC,0,1069505
fldAp,0.14285714285714285,6,6,AAATCAACGTGGAGTAGGTG,0,1070626
fldAp,0.14285714285714285,6,6,AAATAGGACAAAATTAATCT,0,1092227
fldAp,0.14285714285714285,6,6,AAATAGCTAAGAAGCGGCTC,0,1064480
fldAp,0.14285714285714285,6,6,AAAGTGCATCAATACGACAC,0,1110951
fldAp,0.14285714285714285,6,6,AAAGGTATTAGTATCCAAAG,0,1104415
fldAp,0.14285714285714285,6,6,AAAGGCACATACTGCGGCTA,0,1140277
fldAp,0.14285714285714285,6,6,AAAGGATAAACTTTTTCATT,0,1106935
fldAp,0.14285714285714285,6,6,AAAGCGGGAGACAGCACTCA,0,1064374
fldAp,0.14285714285714285,6,6,AAAGCGGCTTCGAGTATAAA,0,1063162
fldAp,0.14285714285714285,6,6,AAACTTTATCACCTATCTTG,0,1131943
fldAp,0.14285714285714285,6,6,AAACTCCTGTACGAATTCAC,0,1151663
fldAp,0.14285714285714285,6,6,AAACGAGATCGTCTAAACTC,0,1152846
fldAp,0.14285714285714285,6,6,AAACCACGGCAGCGCGTTTA,0,1086116
fldAp,0.14285714285714285,6,6,AAACCACCTCGACCTCCAGC,0,1181739
fldAp,0.14285714285714285,6,6,AAAATGAGAGCTTAGCTTCT,0,1170585
fldAp,0.14285714285714285,6,6,AAAATATGTACACGGGGGAC,0,1120273
fldAp,0.14285714285714285,6,6,AAAAGATAGACCTTACGACT,0,1129852
fldAp,0.14285714285714285,6,6,AAAACTGCCTGTTAGACGCT,0,1164851
fldAp,0.14285714285714285,6,6,AAAACCGTGTTGGCTGATGT,0,1143197
fldAp,0.14285714285714285,6,6,AAAAATCCGGTACGCCATGT,0,1138115
fldAp,0.16666666666666666,5,5,TTTTTCTACCAACGTGCACT,0,1144857
fldAp,0.16666666666666666,5,5,TTTTGTGACATGCACGCGCC,0,1114510
fldAp,0.16666666666666666,5,5,TTTTGCTTACAGCCGGTATC,0,1101440
fldAp,0.16666666666666666,5,5,TTTTCGCCAAATGAGCTCGT,0,1107590
fldAp,0.16666666666666666,5,5,TTTTAAAAAAGAAATAGGTT,0,1066870
fldAp,0.16666666666666666,5,5,TTTGGTTAAGCATCGAGGAC,0,1069020
fldAp,0.16666666666666666,5,5,TTTGGCCAGTAACCAAAACT,0,1118700
fldAp,0.16666666666666666,5,5,TTTGGCACACCGCCACATGG,0,1128360
fldAp,0.16666666666666666,5,5,TTTGCCCTATTCTGCTCCAT,0,1174469
fldAp,0.16666666666666666,5,5,TTTGCAACGGGCGCCAGAGT,0,1092095
fldAp,0.16666666666666666,5,5,TTTGATTATTTTGATTCTGT,0,1082799
fldAp,0.16666666666666666,5,5,TTTGAGGTCTAAAGCCGGAT,0,1064949
fldAp,0.16666666666666666,5,5,TTTGACGGCTGCGTCACCAA,0,1137401
fldAp,0.16666666666666666,5,5,TTTGACACTTTGGCCCCGCG,0,1152649
fldAp,0.16666666666666666,5,5,TTTCTTTCTCTTATCTCGTA,0,1080306
fldAp,0.16666666666666666,5,5,TTTCTGGGGAGATTACGCCG,0,1170169
fldAp,0.16666666666666666,5,5,TTTCTAAACCCCCCTGGGTC,0,1128697
fldAp,0.16666666666666666,5,5,TTTCGTGCACTAACTAAAAG,0,1157194
fldAp,0.16666666666666666,5,5,TTTCGGACATAGGCGGTCTA,0,1088913
fldAp,0.16666666666666666,5,5,TTTCGCTCGTCCCTAATTGG,0,1169498
fldAp,0.16666666666666666,5,5,TTTCGCGACAAGGTTGTTAT,0,1149301
fldAp,0.16666666666666666,5,5,TTTCAGTAGATTGAGATTAT,0,1161993
fldAp,0.16666666666666666,5,5,TTTAGAGGCAGCGCTTTCGT,0,1103837
fldAp,0.16666666666666666,5,5,TTTACTGGTTTCCTCACACG,0,1136605
fldAp,0.16666666666666666,5,5,TTTACGTGTACTGCCACTCC,0,1094532
fldAp,0.16666666666666666,5,5,TTTAAGCTAGCAGGGATCGT,0,1153488
fldAp,0.16666666666666666,5,5,TTTAACTCTAGTAATCAGCA,0,1107273
fldAp,0.16666666666666666,5,5,TTGTTTCGGGGGGGTAGCTC,0,1117142
fldAp,0.16666666666666666,5,5,TTGTTGCTGCGGGGGCTACA,0,1114037
fldAp,0.16666666666666666,5,5,TTGTTCAACTCACTTTCATC,0,1081298
fldAp,0.16666666666666666,5,5,TTGTGTTATCTGGCGGAAGT,0,1097936
fldAp,0.16666666666666666,5,5,TTGTGGCAACCCTTTGGCAG,0,1088802
fldAp,0.16666666666666666,5,5,TTGTAGTAGGTAGCAGAGTT,0,1159699
fldAp,0.16666666666666666,5,5,TTGTACGGCTTTGTATTGCG,0,1140023
fldAp,0.16666666666666666,5,5,TTGTACATAAAAACGACGAC,0,1088893
fldAp,0.16666666666666666,5,5,TTGTAAGACGTGATAAATGA,0,1063926
fldAp,0.16666666666666666,5,5,TTGGTATCGGTAACGGGTCG,0,1101560
fldAp,0.16666666666666666,5,5,TTGGTAGCGCCACCCTAGTA,0,1120977
fldAp,0.16666666666666666,5,5,TTGGGCGGGTAGATGAGTAG,0,1122726
fldAp,0.16666666666666666,5,5,TTGGGAACGGGATGCGTAGA,0,1111566
fldAp,0.16666666666666666,5,5,TTGGCCGGACAGTACAGGTC,0,1186227
fldAp,0.16666666666666666,5,5,TTGGCACATCCAAGCCCCTG,0,1085444
fldAp,0.16666666666666666,5,5,TTGGACGTGCGACGGTGCGG,0,1094574
fldAp,0.16666666666666666,5,5,TTGGACGGGATGGGGGAGTG,0,1066632
fldAp,0.16666666666666666,5,5,TTGGACATCGGCTGCGTTCA,0,1066766
fldAp,0.16666666666666666,5,5,TTGGAACCCCCCCGTGTACC,0,1078497
fldAp,0.16666666666666666,5,5,TTGCGGCTTGCCCACCACGC,0,1117049
fldAp,0.16666666666666666,5,5,TTGCGGCACATCGAGCGATG,0,1081323
fldAp,0.16666666666666666,5,5,TTGCGCACGAAGAGACCTCT,0,1121825
fldAp,0.16666666666666666,5,5,TTGCCTGACGTTATTTGGGG,0,1170698
fldAp,0.16666666666666666,5,5,TTGCCGTCAAGTCTCGTCTA,0,1142291
fldAp,0.16666666666666666,5,5,TTGCCCGTCGTTGTTGGACT,0,1143977
fldAp,0.16666666666666666,5,5,TTGCCCAGGAAGTTTCGAAC,0,1148364
fldAp,0.16666666666666666,5,5,TTGCAGCATGGATACGATTA,0,1167556
fldAp,0.16666666666666666,5,5,TTGCAGATGTTAAGGCAACC,0,1132328
fldAp,0.16666666666666666,5,5,TTGCACGAACTGAGCATTGA,0,1116887
fldAp,0.16666666666666666,5,5,TTGCAACAATAATCGGGACT,0,1145836
fldAp,0.16666666666666666,5,5,TTGATCAGTGTCTCTTTCGC,0,1170587
fldAp,0.16666666666666666,5,5,TTGAGTCTAAGCTCAAAGAG,0,1175002
fldAp,0.16666666666666666,5,5,TTGAGCACCAAATAACGGTG,0,1133780
fldAp,0.16666666666666666,5,5,TTGACTTCTCCGGCTGAGCC,0,1167859
fldAp,0.16666666666666666,5,5,TTGACTCTCGCCTCACAAAT,0,1169623
fldAp,0.16666666666666666,5,5,TTGAATACGAAACCCGCAAC,0,1147666
fldAp,0.16666666666666666,5,5,TTGAACCTGTCATTCAAGGC,0,1172732
fldAp,0.16666666666666666,5,5,TTCTGGAATTGAACCTCTCG,0,1113415
fldAp,0.16666666666666666,5,5,TTCTGAGGTCACCTCGCCGG,0,1158278
fldAp,0.16666666666666666,5,5,TTCTCTGAAACGGTACCAGA,0,1139242
fldAp,0.16666666666666666,5,5,TTCTCCTGGATCGGCCAATA,0,1179458
fldAp,0.16666666666666666,5,5,TTCTCAGCTCCTATGGCTGA,0,1154722
fldAp,0.16666666666666666,5,5,TTCTCAGCGATCTATTTCAT,0,1113024
fldAp,0.16666666666666666,5,5,TTCTCAATGGCGCAACTCAC,0,1159394
fldAp,0.16666666666666666,5,5,TTCTAGATAGGTCTCCGGGT,0,1107905
fldAp,0.16666666666666666,5,5,TTCTAAAAAATGAGTAGCGT,0,1158751
fldAp,0.16666666666666666,5,5,TTCGTTATTGATCGGTTTTG,0,1121845
fldAp,0.16666666666666666,5,5,TTCGTGCGGCGAGAGTTCTT,0,1175062
fldAp,0.16666666666666666,5,5,TTCGTCACCCGGACATACCT,0,1093977
fldAp,0.16666666666666666,5,5,TTCGGCATGGTATGTAAGAG,0,1063372
fldAp,0.16666666666666666,5,5,TTCGCTCATTTTCCAAATGC,0,1101532
fldAp,0.16666666666666666,5,5,TTCGCGGTCGTTCTGTTGTA,0,1095583
fldAp,0.16666666666666666,5,5,TTCGATACTTATTTGGACGC,0,1163769
fldAp,0.16666666666666666,5,5,TTCGACGTTCAAGGCCCTCT,0,1111905
fldAp,0.16666666666666666,5,5,TTCGAATCGCTCTCCAGGGA,0,1171635
fldAp,0.16666666666666666,5,5,TTCGAAAAGGTAATCTACTG,0,1138642
fldAp,0.16666666666666666,5,5,TTCCTTCGTTTTCATGCTGC,0,1067713
fldAp,0.16666666666666666,5,5,TTCCTGTAATAAGTGTACTT,0,1142534
fldAp,0.16666666666666666,5,5,TTCCTCGCGAACACACTTGG,0,1170682
fldAp,0.16666666666666666,5,5,TTCCGAGTTTACTCAACCCA,0,1186964
fldAp,0.16666666666666666,5,5,TTCCGAGTCTGTACCGCGCT,0,1174807
fldAp,0.16666666666666666,5,5,TTCCCTTGTGCGAACGCACT,0,1141145
fldAp,0.16666666666666666,5,5,TTCCCATAACTAAGGTTAAG,0,1132173
fldAp,0.16666666666666666,5,5,TTCCCAGGATGGTGACCATA,0,1182001
fldAp,0.16666666666666666,5,5,TTCATCTCACTGCAAAGAAC,0,1107122
fldAp,0.16666666666666666,5,5,TTCATCATGTCTCATGTGGA,0,1155596
fldAp,0.16666666666666666,5,5,TTCAGAGAGCGTTACAGTCG,0,1147461
fldAp,0.16666666666666666,5,5,TTCAATTTAGGTACCTTCGA,0,1083119
fldAp,0.16666666666666666,5,5,TTCAAGGCCGGCGAAACGTG,0,1155399
fldAp,0.16666666666666666,5,5,TTCAAGCTACACTGGGCGTT,0,1121835
fldAp,0.16666666666666666,5,5,TTCAAGACTTGACTTCTAAA,0,1076506
fldAp,0.16666666666666666,5,5,TTCAAACTTAGGCTGGGCCT,0,1064848
fldAp,0.16666666666666666,5,5,TTATTCAGAGTCTTTATCGT,0,1146896
fldAp,0.16666666666666666,5,5,TTATGGCTCACAGTTAGCTT,0,1080339
fldAp,0.16666666666666666,5,5,TTATGGACATTACTTAATCC,0,1161419
fldAp,0.16666666666666666,5,5,TTATGACTAATTAAACCTAG,0,1153152
fldAp,0.16666666666666666,5,5,TTATCTCTTACCGCGGATGT,0,1093152
fldAp,0.16666666666666666,5,5,TTATATGTAAAGGGTTAGTA,0,1069314
fldAp,0.16666666666666666,5,5,TTATATAGCAGTTTTCAAAT,0,1150729
fldAp,0.16666666666666666,5,5,TTATAAGTGCTAAAGCGAAG,0,1176266
fldAp,0.16666666666666666,5,5,TTAGTTCTCGTACGCGGTCT,0,1182735
fldAp,0.16666666666666666,5,5,TTAGGTGAGTTCGGTGTAGC,0,1166729
fldAp,0.16666666666666666,5,5,TTAGGGGGTGTGTCAGGCAA,0,1156758
fldAp,0.16666666666666666,5,5,TTAGGCGCGTCAGGACATAG,0,1095515
fldAp,0.16666666666666666,5,5,TTAGGAATATAGGGAGCATC,0,1150005
fldAp,0.16666666666666666,5,5,TTAGGAAGTAAGTCCAAGTA,0,1158974
fldAp,0.16666666666666666,5,5,TTAGGAAGAGAACACGCATC,0,1154978
fldAp,0.16666666666666666,5,5,TTAGCTTTATACGGGAGGGT,0,1175021
fldAp,0.16666666666666666,5,5,TTAGCTCCGTGGGGGTAAGT,0,1103285
fldAp,0.16666666666666666,5,5,TTAGCTATAGCTCGCAAATC,0,1069892
fldAp,0.16666666666666666,5,5,TTAGCCTTTTGCCTGGCTCC,0,1182503
fldAp,0.16666666666666666,5,5,TTAGCACTACACATTACGCT,0,1167160
fldAp,0.16666666666666666,5,5,TTAGATTAGAGAACCTCCGA,0,1093071
fldAp,0.16666666666666666,5,5,TTAGACTTTCTAGGTAAACA,0,1081409
fldAp,0.16666666666666666,5,5,TTAGACAGTCGTCCAGCGCC,0,1095147
fldAp,0.16666666666666666,5,5,TTACTTGTACTTCTACACAT,0,1093211
fldAp,0.16666666666666666,5,5,TTACTTGCATCACATTCAAC,0,1096118
fldAp,0.16666666666666666,5,5,TTACGCGTAGAGAAAGACAA,0,1099216
fldAp,0.16666666666666666,5,5,TTACCTTCGCGGGGCGTATC,0,1093546
fldAp,0.16666666666666666,5,5,TTACCCCGCACCGTCCTGTG,0,1140618
fldAp,0.16666666666666666,5,5,TTACCAGGTTCTCACTGACA,0,1108153
fldAp,0.16666666666666666,5,5,TTACAAGACCCCTTCGGTCC,0,1131125
fldAp,0.16666666666666666,5,5,TTACAAAAGCAAAAAACTGG,0,1093532
fldAp,0.16666666666666666,5,5,TTAATGCGACATACCTCATG,0,1160645
fldAp,0.16666666666666666,5,5,TTAAGGCAATGATAAAAGTA,0,1065889
fldAp,0.16666666666666666,5,5,TTAACGTCCACGTATGGCTT,0,1080807
fldAp,0.16666666666666666,5,5,TTAACGACGAGATAGTCCAC,0,1139997
fldAp,0.16666666666666666,5,5,TTAAATACAAATTCCGCAAA,0,1081210
fldAp,0.16666666666666666,5,5,TTAAACTTGTATTCCAACGT,0,1129066
fldAp,0.16666666666666666,5,5,TTAAACGATGGTGTAGTCAA,0,1158080
fldAp,0.16666666666666666,5,5,TGTTTTGCACAAAGCGACGT,0,1124650
fldAp,0.16666666666666666,5,5,TGTTTCATGATTCTAACGGA,0,1183262
fldAp,0.16666666666666666,5,5,TGTTGGTTACTAGATACATA,0,1115830
fldAp,0.16666666666666666,5,5,TGTTGGTCTGTGTGGATGCC,0,1170602
fldAp,0.16666666666666666,5,5,TGTTGAAGGGACATCGCCTC,0,1140970
fldAp,0.16666666666666666,5,5,TGTTCAGTTAATTCTCTGCG,0,1155509
fldAp,0.16666666666666666,5,5,TGTTATACGGCACGGCCCTC,0,1125123
fldAp,0.16666666666666666,5,5,TGTTAGCACTGGGTAGAGCC,0,1106439
fldAp,0.16666666666666666,5,5,TGTTACTCTTGAAGCCCGGG,0,1122151
fldAp,0.16666666666666666,5,5,TGTTAAAGTACCCAGCGTCA,0,1068691
fldAp,0.16666666666666666,5,5,TGTGTCTAACTACTTCTGGC,0,1181601
fldAp,0.16666666666666666,5,5,TGTGTAGGGCAGCAGGCAGC,0,1175688
fldAp,0.16666666666666666,5,5,TGTGGCCATTTATCTGACCG,0,1127173
fldAp,0.16666666666666666,5,5,TGTGCCATAGAAAGGGCATG,0,1172766
fldAp,0.16666666666666666,5,5,TGTGATTGCAAAACGCATCA,0,1106417
fldAp,0.16666666666666666,5,5,TGTGACATAGTACCAGCACC,0,1086765
fldAp,0.16666666666666666,5,5,TGTCTATGCCTTAGCGGGGA,0,1120406
fldAp,0.16666666666666666,5,5,TGTCGTATCGGAGTCCTAGA,0,1110235
fldAp,0.16666666666666666,5,5,TGTCGGTCTATATCGGATGT,0,1156157
fldAp,0.16666666666666666,5,5,TGTCGCCAGGCGAATGTATT,0,1133830
fldAp,0.16666666666666666,5,5,TGTCCGGTCGTTATACATGT,0,1127021
fldAp,0.16666666666666666,5,5,TGTCAGTTCACCTAACTTGT,0,1183395
fldAp,0.16666666666666666,5,5,TGTCAACACTGGGGTTAGGA,0,1065930
fldAp,0.16666666666666666,5,5,TGTATTATGCGAGCGATTTA,0,1078365
fldAp,0.16666666666666666,5,5,TGTATAGGTGTGATAAATAT,0,1078572
fldAp,0.16666666666666666,5,5,TGTATACGGATCCGGAGCAT,0,1071916
fldAp,0.16666666666666666,5,5,TGTACGGGCATATTTTTTTG,0,1151443
fldAp,0.16666666666666666,5,5,TGTAAATATTTCCTTTTTAC,0,1096934
fldAp,0.16666666666666666,5,5,TGTAAAGCCCATAGTGTTTA,0,1165992
fldAp,0.16666666666666666,5,5,TGGTTCACGTTTGGCGAACA,0,1186566
fldAp,0.16666666666666666,5,5,TGGTAGACATTCGGGCATCA,0,1088748
fldAp,0.16666666666666666,5,5,TGGTAATCCATGGCATAAGG,0,1150398
fldAp,0.16666666666666666,5,5,TGGGTAGCTGGGGCGTTTAC,0,1071091
fldAp,0.16666666666666666,5,5,TGGCCTTAGTATTTCAGGAT,0,1130280
fldAp,0.16666666666666666,5,5,TGGCCGTATTAGCAGAGGGA,0,1106466
fldAp,0.16666666666666666,5,5,TGGCCCCTATGAGCCTGCAA,0,1173936
fldAp,0.16666666666666666,5,5,TGGCCAACCAAAGTTATTAT,0,1151653
fldAp,0.16666666666666666,5,5,TGGCATGTAAGTAGTACGCG,0,1155226
fldAp,0.16666666666666666,5,5,TGGCATAACCCCATGGGGTT,0,1181894
fldAp,0.16666666666666666,5,5,TGGATTGTGTCTATTGATCA,0,1165465
fldAp,0.16666666666666666,5,5,TGGATTGACTGTGCTAAGAT,0,1129733
fldAp,0.16666666666666666,5,5,TGGATGCTATAGATGCTGCA,0,1093473
fldAp,0.16666666666666666,5,5,TGGATACTACTTGTTTATAG,0,1158947
fldAp,0.16666666666666666,5,5,TGGATACGATATCCTGCAGA,0,1095058
fldAp,0.16666666666666666,5,5,TGGAGAGCCACGGTTAGACC,0,1104088
fldAp,0.16666666666666666,5,5,TGGAGACTGGTAAGGATACA,0,1171817
fldAp,0.16666666666666666,5,5,TGGACGATTCGTGAAGGTTA,0,1140801
fldAp,0.16666666666666666,5,5,TGGACGACATCACGTATGAT,0,1167588
fldAp,0.16666666666666666,5,5,TGGAATGATTGCGGTGCTCA,0,1164265
fldAp,0.16666666666666666,5,5,TGGAAGACGCTACTCTCGTG,0,1144785
fldAp,0.16666666666666666,5,5,TGCTTTAAATACTATGGGGT,0,1081237
fldAp,0.16666666666666666,5,5,TGCTCTTTCTGTGAACTGCT,0,1077723
fldAp,0.16666666666666666,5,5,TGCTCGGACCGCGGAGAAAT,0,1169988
fldAp,0.16666666666666666,5,5,TGCGGCACGTTCCAGGTGAG,0,1113395
fldAp,0.16666666666666666,5,5,TGCGAGACTTGGGGATGACC,0,1175866
fldAp,0.16666666666666666,5,5,TGCCTATGTTTCAGGTGGCT,0,1177179
fldAp,0.16666666666666666,5,5,TGCCGTAAACCCAATCGAAT,0,1128075
fldAp,0.16666666666666666,5,5,TGCCGGAATGCCGTATATAT,0,1095902
fldAp,0.16666666666666666,5,5,TGCCGCAAATCGCCGACCGT,0,1143802
fldAp,0.16666666666666666,5,5,TGCCGAACTAAGAGTCAAAA,0,1087378
fldAp,0.16666666666666666,5,5,TGCCCGTGGCTTTTTTTGGT,0,1164344
fldAp,0.16666666666666666,5,5,TGCCATGGGTGTTTTAAATA,0,1164256
fldAp,0.16666666666666666,5,5,TGCATAGGAAGGGTATTAGT,0,1083337
fldAp,0.16666666666666666,5,5,TGCAGACATCGTGCTAAGAC,0,1160242
fldAp,0.16666666666666666,5,5,TGCACTTTGATCACGATAAT,0,1161677
fldAp,0.16666666666666666,5,5,TGCACTTGCTGGGCGGTCTG,0,1145145
fldAp,0.16666666666666666,5,5,TGCACGAGCCTCCCACGGCT,0,1088865
fldAp,0.16666666666666666,5,5,TGCACCTTGTAGCACCTAGC,0,1081556
fldAp,0.16666666666666666,5,5,TGCACCATGGACACGGAGCT,0,1176285
fldAp,0.16666666666666666,5,5,TGATTGGTTTTACAGTATAA,0,1071468
fldAp,0.16666666666666666,5,5,TGATTAGGGCCTCTTCCCCA,0,1093831
fldAp,0.16666666666666666,5,5,TGATGTTTCGGGCACAAGTG,0,1156408
fldAp,0.16666666666666666,5,5,TGATGGTAATATACAACCTA,0,1168138
fldAp,0.16666666666666666,5,5,TGATGGGGGGTTATTAACGT,0,1100117
fldAp,0.16666666666666666,5,5,TGATGATAGCCAGGGTCGGT,0,1137567
fldAp,0.16666666666666666,5,5,TGATCCTGGTTTGCCCTTCG,0,1100482
fldAp,0.16666666666666666,5,5,TGATATTGGCTTTACAGGGC,0,1114185
fldAp,0.16666666666666666,5,5,TGATATTAAAGGCAAGCGAG,0,1110923
fldAp,0.16666666666666666,5,5,TGATACAATCAACCGTCTCC,0,1166902
fldAp,0.16666666666666666,5,5,TGATACAACACGATGATTAC,0,1176145
fldAp,0.16666666666666666,5,5,TGAGTATAGGTAACACTACA,0,1126129
fldAp,0.16666666666666666,5,5,TGAGGCAGCTTTCCATAAAA,0,1094509
fldAp,0.16666666666666666,5,5,TGAGATACACGGTCCACGAG,0,1088931
fldAp,0.16666666666666666,5,5,TGACTTACGTACAATCTATA,0,1064737
fldAp,0.16666666666666666,5,5,TGACTGCCCGTGACAACGCT,0,1080667
fldAp,0.16666666666666666,5,5,TGACGCCCGATCACCGTGGG,0,1083623
fldAp,0.16666666666666666,5,5,TGACGACAGGCTCCGCTGAC,0,1164362
fldAp,0.16666666666666666,5,5,TGACCTCGTTCAGGGCACGT,0,1160608
fldAp,0.16666666666666666,5,5,TGACCGACGTAAGCGTACCA,0,1089964
fldAp,0.16666666666666666,5,5,TGACCATTACAGAACGCTTC,0,1137579
fldAp,0.16666666666666666,5,5,TGACATCCATACCCCCTTAT,0,1103688
fldAp,0.16666666666666666,5,5,TGACACAGAACGGTTTCGAA,0,1173790
fldAp,0.16666666666666666,5,5,TGAATGTGGGCCTGGTCGTC,0,1179871
fldAp,0.16666666666666666,5,5,TGAATAGAACTTTGGTCATC,0,1080787
fldAp,0.16666666666666666,5,5,TGAAGACTGGGTTGACGGTT,0,1105576
fldAp,0.16666666666666666,5,5,TGAACTGCCTCTAAAGGCGA,0,1183819
fldAp,0.16666666666666666,5,5,TGAACTAATTGCAGTATGTC,0,1152079
fldAp,0.16666666666666666,5,5,TCTTTGGGTTTAGGCAGGAG,0,1173862
fldAp,0.16666666666666666,5,5,TCTTGGGATAGAGTAGAACA,0,1118476
fldAp,0.16666666666666666,5,5,TCTTAGTGGCGTGGCCGACG,0,1130509
fldAp,0.16666666666666666,5,5,TCTGGTCAGCGCCCCGGACG,0,1147469
fldAp,0.16666666666666666,5,5,TCTGGTAGTATAGCTTGGGC,0,1155759
fldAp,0.16666666666666666,5,5,TCTGGGTCGAGCGCGGGAGC,0,1076452
fldAp,0.16666666666666666,5,5,TCTGGGTAATTACACGCGGT,0,1148496
fldAp,0.16666666666666666,5,5,TCTGAGTTTCTAACGCGTCC,0,1118512
fldAp,0.16666666666666666,5,5,TCTGAGTCACAAGATCATCG,0,1142362
fldAp,0.16666666666666666,5,5,TCTGAGGGGATCTAGTTTAT,0,1123865
fldAp,0.16666666666666666,5,5,TCTGACGGAGATGTCGCCGA,0,1075495
fldAp,0.16666666666666666,5,5,TCTGAAGTGCCACCCTGTTT,0,1084743
fldAp,0.16666666666666666,5,5,TCTCTTAGGCTCTAAACATT,0,1170417
fldAp,0.16666666666666666,5,5,TCTCTGCGAGTTCCTATGAA,0,1140071
fldAp,0.16666666666666666,5,5,TCTCGTCGGTGTAGGAGTAG,0,1105920
fldAp,0.16666666666666666,5,5,TCTCGTAACGTGAGGGCCTG,0,1185051
fldAp,0.16666666666666666,5,5,TCTCGACCAATAACAACCAA,0,1088522
fldAp,0.16666666666666666,5,5,TCTCCGCTCGTACTCGCGTA,0,1087073
fldAp,0.16666666666666666,5,5,TCTCCGCTAGTAGGAACGCA,0,1108088
fldAp,0.16666666666666666,5,5,TCTCCCTCATAGCTAGACGT,0,1112879
fldAp,0.16666666666666666,5,5,TCTCAGTGGCCCACGCTATA,0,1143374
fldAp,0.16666666666666666,5,5,TCTACGGTAGGGTATGTGGC,0,1152306
fldAp,0.16666666666666666,5,5,TCTACGCACTGGCGGGCGTA,0,1099180
fldAp,0.16666666666666666,5,5,TCTACATCTACTCGGAACCT,0,1102806
fldAp,0.16666666666666666,5,5,TCTAAGCAGCCACACGGCTA,0,1105577
fldAp,0.16666666666666666,5,5,TCGTTAGGCGTAACGCGAGC,0,1165314
fldAp,0.16666666666666666,5,5,TCGTGTGATTGATGCGGGAT,0,1096890
fldAp,0.16666666666666666,5,5,TCGTGTATCCATACACGCAG,0,1176547
fldAp,0.16666666666666666,5,5,TCGTCATTTGGATATTATTG,0,1139562
fldAp,0.16666666666666666,5,5,TCGTACGTGGGCCGTGATGT,0,1176538
fldAp,0.16666666666666666,5,5,TCGTACCTCAGATCCTACCG,0,1139026
fldAp,0.16666666666666666,5,5,TCGGTGTAAGATAGCCTTGC,0,1098223
fldAp,0.16666666666666666,5,5,TCGGTACATTCGAAGATGCA,0,1120761
fldAp,0.16666666666666666,5,5,TCGGGTAGAATTCCGGCTGC,0,1104965
fldAp,0.16666666666666666,5,5,TCGGGAGATCATTGACCTAG,0,1109604
fldAp,0.16666666666666666,5,5,TCGGCATCGCATATCCAAGT,0,1069259
fldAp,0.16666666666666666,5,5,TCGGCAATGGGCCTCCCATG,0,1156707
fldAp,0.16666666666666666,5,5,TCGGATGCGAGTCGTAGCTA,0,1108594
fldAp,0.16666666666666666,5,5,TCGGATATGTCATTCTGCCA,0,1132254
fldAp,0.16666666666666666,5,5,TCGGAGCAATACGACTTGAC,0,1123482
fldAp,0.16666666666666666,5,5,TCGCTGACAGAAATTCTACT,0,1167695
fldAp,0.16666666666666666,5,5,TCGCGATACGCAGGGTTTCT,0,1165128
fldAp,0.16666666666666666,5,5,TCGCGAGCATATGGAGCACA,0,1138347
fldAp,0.16666666666666666,5,5,TCGCGAGATTGCTAGCGGTG,0,1074594
fldAp,0.16666666666666666,5,5,TCGCCGTAAATATCGGTCAC,0,1131229
fldAp,0.16666666666666666,5,5,TCGCCCTCAACAAGTTGTTA,0,1099720
fldAp,0.16666666666666666,5,5,TCGATTAGCACACATGCTCC,0,1113158
fldAp,0.16666666666666666,5,5,TCGATGGCGCGGATTTGGAA,0,1113398
fldAp,0.16666666666666666,5,5,TCGATACTTGCAGGTACCAC,0,1176578
fldAp,0.16666666666666666,5,5,TCGAGGCTGGTTCTGACTGC,0,1101420
fldAp,0.16666666666666666,5,5,TCGAGGCTGGACAAGACTAC,0,1147009
fldAp,0.16666666666666666,5,5,TCGAGGCGAAGTAGTGAGAA,0,1177290
fldAp,0.16666666666666666,5,5,TCGAACGGATCTCTGCATTC,0,1097352
fldAp,0.16666666666666666,5,5,TCCTGATGCTACTCGACCAT,0,1075185
fldAp,0.16666666666666666,5,5,TCCTCAAGGGTCTGTGTCTG,0,1080274
fldAp,0.16666666666666666,5,5,TCCGTCTTAAGGAAATCGGT,0,1103894
fldAp,0.16666666666666666,5,5,TCCGGTAGGGTTCAGAGGTA,0,1133638
fldAp,0.16666666666666666,5,5,TCCGGGAGTGTGTTCCACTC,0,1148166
fldAp,0.16666666666666666,5,5,TCCGATTTAGCGTATAGACA,0,1164441
fldAp,0.16666666666666666,5,5,TCCGACCGTTTCGGTATCGT,0,1105980
fldAp,0.16666666666666666,5,5,TCCCGTAAACGGGCTTCACA,0,1082136
fldAp,0.16666666666666666,5,5,TCCCGGGGCGTCATCCTAAC,0,1100390
fldAp,0.16666666666666666,5,5,TCCCGGCTTGGACAAAGTAC,0,1141731
fldAp,0.16666666666666666,5,5,TCCCCGCGCCATGCTGGCCC,0,1068899
fldAp,0.16666666666666666,5,5,TCCCCGCACTCCTATGATTG,0,1169252
fldAp,0.16666666666666666,5,5,TCCCAGTGGCCCAGAAGTGC,0,1149363
fldAp,0.16666666666666666,5,5,TCCATCCGTGCTTATAACCT,0,1152636
fldAp,0.16666666666666666,5,5,TCCATCAGGTCTCAGTTGAA,0,1100849
fldAp,0.16666666666666666,5,5,TCCAGGTAGGCTCGGCGCTC,0,1158559
fldAp,0.16666666666666666,5,5,TCCAGAGGCGCGGTTGTTTG,0,1179163
fldAp,0.16666666666666666,5,5,TCCACATAAGCCTCAAGATC,0,1136102
fldAp,0.16666666666666666,5,5,TCCAAGACACTTGCTATCAG,0,1086725
fldAp,0.16666666666666666,5,5,TCCAAAGACTGAGTACCTTC,0,1094829
fldAp,0.16666666666666666,5,5,TCATTTCGGGGTCAGCTGAC,0,1131499
fldAp,0.16666666666666666,5,5,TCATTCTGAAGTGGATGCTC,0,1145895
fldAp,0.16666666666666666,5,5,TCATGTACGCTTGGTTCCAC,0,1162926
fldAp,0.16666666666666666,5,5,TCATGGTGAGGGGGAGAGGG,0,1087620
fldAp,0.16666666666666666,5,5,TCATGGTGAAAACACGACTG,0,1094980
fldAp,0.16666666666666666,5,5,TCATCTGCAAGGCTGTAGGC,0,1158147
fldAp,0.16666666666666666,5,5,TCATCGAACAGAGATGTTAT,0,1165943
fldAp,0.16666666666666666,5,5,TCATCCTTCCAAGCGACACT,0,1141638
fldAp,0.16666666666666666,5,5,TCATCCACTCCGATTATATC,0,1166974
fldAp,0.16666666666666666,5,5,TCAGGGTATCTCCGCCACTT,0,1184107
fldAp,0.16666666666666666,5,5,TCAGGCGGCGAGTCATTGTA,0,1152855
fldAp,0.16666666666666666,5,5,TCAGGAATTTCGTGTGCCCC,0,1121524
fldAp,0.16666666666666666,5,5,TCAGCCCGTCATCCCACTCC,0,1123751
fldAp,0.16666666666666666,5,5,TCAGCATTAACACCGGCTGT,0,1166071
fldAp,0.16666666666666666,5,5,TCACTCAAATCGGGCACCAG,0,1117979
fldAp,0.16666666666666666,5,5,TCACGTTGTGTGGGCCGAGG,0,1116616
fldAp,0.16666666666666666,5,5,TCACGGTCCAGTTACAGGAG,0,1102097
fldAp,0.16666666666666666,5,5,TCACGACTATCTTAGTATGT,0,1164732
fldAp,0.16666666666666666,5,5,TCACCCATACAGTCGTATAC,0,1123401
fldAp,0.16666666666666666,5,5,TCAATCTGCGATCAGTAACG,0,1083537
fldAp,0.16666666666666666,5,5,TCAAGCGAAGATCGCTATGT,0,1126385
fldAp,0.16666666666666666,5,5,TCAAGCATAGGGCGACCCCA,0,1102495
fldAp,0.16666666666666666,5,5,TCAACCTTAGGCCAATTTAT,0,1110396
fldAp,0.16666666666666666,5,5,TATTTGTCATAGCCTTAGGG,0,1138234
fldAp,0.16666666666666666,5,5,TATTCGACTCTTCTTTTCCG,0,1172510
fldAp,0.16666666666666666,5,5,TATGTCTGCGCGAATAGGAT,0,1122496
fldAp,0.16666666666666666,5,5,TATGGGCCTTACCCCAAAAG,0,1132497
fldAp,0.16666666666666666,5,5,TATGGAAGCGGTGCTGATTC,0,1170842
fldAp,0.16666666666666666,5,5,TATGATAATAAGACCAAAGT,0,1070210
fldAp,0.16666666666666666,5,5,TATCTTCAATGGCTCGCATG,0,1143608
fldAp,0.16666666666666666,5,5,TATCGGGCCTACAAGGGGCG,0,1072576
fldAp,0.16666666666666666,5,5,TATCGAGGAGAATGCTTGCG,0,1074027
fldAp,0.16666666666666666,5,5,TATCCGGCGCGCATGCCGCT,0,1149968
fldAp,0.16666666666666666,5,5,TATCCCGGATCAATACAGGA,0,1101408
fldAp,0.16666666666666666,5,5,TATATGGGCCGATCCAATGA,0,1177003
fldAp,0.16666666666666666,5,5,TATATGCGGCATCGCTCCTA,0,1156579
fldAp,0.16666666666666666,5,5,TATATAGAGTGCTGTCAGCT,0,1085902
fldAp,0.16666666666666666,5,5,TATAGTTCAATGCCTTGATT,0,1149637
fldAp,0.16666666666666666,5,5,TATAGCCCGTAACTATTCTC,0,1185136
fldAp,0.16666666666666666,5,5,TATACACTCATGTTGCGTAT,0,1156766
fldAp,0.16666666666666666,5,5,TATAAGCTAGTGAGCGGCGG,0,1186151
fldAp,0.16666666666666666,5,5,TATAACCGAAACAGGAAGTC,0,1151065
fldAp,0.16666666666666666,5,5,TATAAAATTTTCCGTGGCAG,0,1089365
fldAp,0.16666666666666666,5,5,TAGTATTGCGACCTCTTTAT,0,1131128
fldAp,0.16666666666666666,5,5,TAGGTTTGATGCCACGTTGT,0,1066977
fldAp,0.16666666666666666,5,5,TAGGGGAGCGATGGAAGCAG,0,1166750
fldAp,0.16666666666666666,5,5,TAGGAAGCCGCTAAATGTCA,0,1175168
fldAp,0.16666666666666666,5,5,TAGCTCGTCAAGACGTCACC,0,1065114
fldAp,0.16666666666666666,5,5,TAGCTCCACATGGGGATTGG,0,1065057
fldAp,0.16666666666666666,5,5,TAGCGGAACTCTGTTCAGGT,0,1075659
fldAp,0.16666666666666666,5,5,TAGCCGGGAGGAGTAAAAAA,0,1161767
fldAp,0.16666666666666666,5,5,TAGCACTCACCGACGTAGGA,0,1175203
fldAp,0.16666666666666666,5,5,TAGATTTGTACGCCACCAAT,0,1151145
fldAp,0.16666666666666666,5,5,TAGAGTGGCGGATTCGCCGC,0,1127275
fldAp,0.16666666666666666,5,5,TAGAACGTAGGAGTTTTGTT,0,1076470
fldAp,0.16666666666666666,5,5,TAGAACAATTCCGACCGTTC,0,1135116
fldAp,0.16666666666666666,5,5,TACTTCTATTGGGCGCGAAC,0,1113707
fldAp,0.16666666666666666,5,5,TACTTATTGGCAGGACGCAG,0,1089822
fldAp,0.16666666666666666,5,5,TACTCCGAAGAGTTCCGGGA,0,1129528
fldAp,0.16666666666666666,5,5,TACTAGACTCATAGATCCAG,0,1112651
fldAp,0.16666666666666666,5,5,TACGTTCCAATCTCTAATCA,0,1124428
fldAp,0.16666666666666666,5,5,TACGTTATTCAATAGCCTAC,0,1128959
fldAp,0.16666666666666666,5,5,TACGTCGCCATCTGGTAAAC,0,1183394
fldAp,0.16666666666666666,5,5,TACGTATTCTAGAATGCCCT,0,1094138
fldAp,0.16666666666666666,5,5,TACGGAACAACACTGTTCCT,0,1075786
fldAp,0.16666666666666666,5,5,TACGATACAGAGTCGCTTTC,0,1080769
fldAp,0.16666666666666666,5,5,TACGAAATGGTTTCGTGGTG,0,1064731
fldAp,0.16666666666666666,5,5,TACCTGGCCCCAGGTGAATG,0,1149647
fldAp,0.16666666666666666,5,5,TACCTGGCCAAAATGCTTAC,0,1160480
fldAp,0.16666666666666666,5,5,TACCTCTGGGCAACATGGAT,0,1159305
fldAp,0.16666666666666666,5,5,TACCTAGCCTCTGCTCAGTG,0,1186005
fldAp,0.16666666666666666,5,5,TACCGTAAGCTTGGCCCGTC,0,1098942
fldAp,0.16666666666666666,5,5,TACCCGTAAACTGGCTGGCC,0,1157703
fldAp,0.16666666666666666,5,5,TACATCGGTTCTCCGCATAT,0,1104927
fldAp,0.16666666666666666,5,5,TACATCACGTAGATGTCCCC,0,1160478
fldAp,0.16666666666666666,5,5,TACAGCACGCGTTCAAATAG,0,1146681
fldAp,0.16666666666666666,5,5,TACAGAGCGGATAAAAAGCA,0,1180083
fldAp,0.16666666666666666,5,5,TACAAGTTATATGGACCCGG,0,1150247
fldAp,0.16666666666666666,5,5,TACAACAGTCAGGTTCGAGG,0,1140266
fldAp,0.16666666666666666,5,5,TAATTTAAAGTTGGTCATGC,0,1096089
fldAp,0.16666666666666666,5,5,TAATGTTTGAATTGTATAAA,0,1092040
fldAp,0.16666666666666666,5,5,TAATCGGACCAATTAGGGGG,0,1099034
fldAp,0.16666666666666666,5,5,TAATCCGTACTCAACGGTTC,0,1150056
fldAp,0.16666666666666666,5,5,TAATATGAACGGCGCGTCTG,0,1121455
fldAp,0.16666666666666666,5,5,TAATATCCCTCGAGCTTTTC,0,1178818
fldAp,0.16666666666666666,5,5,TAAGTCTTCAAACATGCTCG,0,1163452
fldAp,0.16666666666666666,5,5,TAAGCTTTTACACATTCACC,0,1075390
fldAp,0.16666666666666666,5,5,TAAGCGGGCATCCGAGCTCC,0,1131866
fldAp,0.16666666666666666,5,5,TAAGCAGGTTATTCGTCCCC,0,1129986
fldAp,0.16666666666666666,5,5,TAAGAGAATGGTTAACCGCA,0,1101479
fldAp,0.16666666666666666,5,5,TAACGGTAATAGGGTTCCCC,0,1171340
fldAp,0.16666666666666666,5,5,TAACCTTCGCGGGGCCTAGG,0,1077861
fldAp,0.16666666666666666,5,5,TAACAAACATCAGTGAAAGA,0,1083457
fldAp,0.16666666666666666,5,5,TAAATGTCCGATAACGAACC,0,1131021
fldAp,0.16666666666666666,5,5,TAAATGAGACGAATACGAGT,0,1106607
fldAp,0.16666666666666666,5,5,TAAATACCGGTTGTGATCTC,0,1114714
fldAp,0.16666666666666666,5,5,TAAAGTGAATAAGAGCAGAC,0,1075086
fldAp,0.16666666666666666,5,5,TAAAGGTCCCACGAGTTCAA,0,1118771
fldAp,0.16666666666666666,5,5,TAAAGAAGCCACTATGATAC,0,1144117
fldAp,0.16666666666666666,5,5,TAAACACTAGGGTCGAACAG,0,1094856
fldAp,0.16666666666666666,5,5,TAAACACAACAGTTTTGCGT,0,1113932
fldAp,0.16666666666666666,5,5,TAAAAGTGATGCGGAATTCC,0,1106601
fldAp,0.16666666666666666,5,5,GTTTTTGGATCTTAAAGTAG,0,1099199
fldAp,0.16666666666666666,5,5,GTTTTCCACTGATTGGTCCG,0,1160331
fldAp,0.16666666666666666,5,5,GTTTGTGTCAGTGTAAAGTA,0,1094210
fldAp,0.16666666666666666,5,5,GTTTGAGCCCGGGACGGAGG,0,1113646
fldAp,0.16666666666666666,5,5,GTTTCGTCCGAGCACGACAT,0,1089634
fldAp,0.16666666666666666,5,5,GTTTATGTTACCGTGGTTGG,0,1115061
fldAp,0.16666666666666666,5,5,GTTGTTGTGGATCATCCGTC,0,1097075
fldAp,0.16666666666666666,5,5,GTTGTCGGGTCCGGGGTGTC,0,1123757
fldAp,0.16666666666666666,5,5,GTTGGCGGTTGAGGTAAAGA,0,1155892
fldAp,0.16666666666666666,5,5,GTTGCCTTTTGTTATGGACC,0,1170305
fldAp,0.16666666666666666,5,5,GTTGCCATAGCTCTCCTATG,0,1073103
fldAp,0.16666666666666666,5,5,GTTGAGCTCGCACGACTACT,0,1165658
fldAp,0.16666666666666666,5,5,GTTGAGCTATATGGCGGTTT,0,1118429
fldAp,0.16666666666666666,5,5,GTTGAAGGTATTTCATAAGG,0,1115856
fldAp,0.16666666666666666,5,5,GTTGAACGGCGTACCCGATC,0,1129980
fldAp,0.16666666666666666,5,5,GTTCTTAGTGTCGTCAACTT,0,1160606
fldAp,0.16666666666666666,5,5,GTTCTGCGAACGCTATATAT,0,1156618
fldAp,0.16666666666666666,5,5,GTTCTGATCCGAGAAGAACT,0,1185143
fldAp,0.16666666666666666,5,5,GTTCGTTCAGTTAGGTTACT,0,1098755
fldAp,0.16666666666666666,5,5,GTTCGGGGCATTCACGAGGC,0,1156201
fldAp,0.16666666666666666,5,5,GTTCGGGGCAGGTCAGGAGT,0,1129433
fldAp,0.16666666666666666,5,5,GTTAGTAAAAGTGACCCATT,0,1065036
fldAp,0.16666666666666666,5,5,GTTAGGGAACTACAGTACAT,0,1138760
fldAp,0.16666666666666666,5,5,GTTAAATTTTATTATTGGGA,0,1118890
fldAp,0.16666666666666666,5,5,GTGTTTCGTCACAGACACCT,0,1163969
fldAp,0.16666666666666666,5,5,GTGTTCTATGAGTAGGATGT,0,1107431
fldAp,0.16666666666666666,5,5,GTGTTCCCCAATTGTCACAA,0,1097995
fldAp,0.16666666666666666,5,5,GTGTTCACAGATGCCGAGGG,0,1177143
fldAp,0.16666666666666666,5,5,GTGTGGGGGCCTAGCTGTGG,0,1069414
fldAp,0.16666666666666666,5,5,GTGTGCAGGCTTTATATATC,0,1127343
fldAp,0.16666666666666666,5,5,GTGGTTTTTCTGGTGCCCGT,0,1083978
fldAp,0.16666666666666666,5,5,GTGGTCCGGTTGTGGGGGTA,0,1162728
fldAp,0.16666666666666666,5,5,GTGGGGAAAGCCTGCAAGCG,0,1092356
fldAp,0.16666666666666666,5,5,GTGGGAAATAGCGCCATCGG,0,1074302
fldAp,0.16666666666666666,5,5,GTGGCTGTTTCTGGAAACAA,0,1150238
fldAp,0.16666666666666666,5,5,GTGGCTGTACTTAGTTGGTT,0,1062992
fldAp,0.16666666666666666,5,5,GTGGCACTTTTACGCCAATT,0,1166929
fldAp,0.16666666666666666,5,5,GTGGATTTACGCACTCAAAA,0,1106828
fldAp,0.16666666666666666,5,5,GTGGAAGGTGTTTACTCTTC,0,1127196
fldAp,0.16666666666666666,5,5,GTGCGGGCCGACGACGCTAT,0,1106498
fldAp,0.16666666666666666,5,5,GTGCCTCCCGTAAAGAGTTA,0,1178727
fldAp,0.16666666666666666,5,5,GTGCCGTAAAGTATTTAGTT,0,1096365
fldAp,0.16666666666666666,5,5,GTGCATGCCCATCCCACCCA,0,1087382
fldAp,0.16666666666666666,5,5,GTGATGCTGGGCCATTAATT,0,1073435
fldAp,0.16666666666666666,5,5,GTGATCCCCAATCGTTGACC,0,1078786
fldAp,0.16666666666666666,5,5,GTGAGCATTCATGTCAGGGT,0,1086524
fldAp,0.16666666666666666,5,5,GTGACTGCACTGGAACGATA,0,1114582
fldAp,0.16666666666666666,5,5,GTGACCGTAGAGCGGACGAA,0,1126809
fldAp,0.16666666666666666,5,5,GTGAAGGTCGAAAAGTATCC,0,1168503
fldAp,0.16666666666666666,5,5,GTGAAGCATATGGTAGTCAA,0,1185165
fldAp,0.16666666666666666,5,5,GTGAACGCAAAGTGTTTTAG,0,1097113
fldAp,0.16666666666666666,5,5,GTGAAAACGTGTCTCCTCGA,0,1156829
fldAp,0.16666666666666666,5,5,GTCTTTCGAAGGGAAAAAGA,0,1078289
fldAp,0.16666666666666666,5,5,GTCTTGAAGGTTTTGTACCA,0,1169036
fldAp,0.16666666666666666,5,5,GTCTGTCTGAGAATGAGCTA,0,1079225
fldAp,0.16666666666666666,5,5,GTCTGGAGTGTGAATCTCTC,0,1144710
fldAp,0.16666666666666666,5,5,GTCTGCCTAAAAATATGTTT,0,1184178
fldAp,0.16666666666666666,5,5,GTCTGCACCTAACATCACGA,0,1146228
fldAp,0.16666666666666666,5,5,GTCTGACAATATCGGCAGCG,0,1130412
fldAp,0.16666666666666666,5,5,GTCTCCTGCATCGAACATCG,0,1175565
fldAp,0.16666666666666666,5,5,GTCTCCCCATGGCTTTTTGA,0,1177597
fldAp,0.16666666666666666,5,5,GTCTAGGTAGGGTCCGATCC,0,1123749
fldAp,0.16666666666666666,5,5,GTCTAGGGGGTTGTAAGCGT,0,1129583
fldAp,0.16666666666666666,5,5,GTCTAATCCGAGGAGGGATT,0,1186459
fldAp,0.16666666666666666,5,5,GTCGTGCTTGCAAGTATTAC,0,1177320
fldAp,0.16666666666666666,5,5,GTCGTCAACTCAGGAACGTA,0,1123647
fldAp,0.16666666666666666,5,5,GTCGGTCACGCAAGTGCGAC,0,1122607
fldAp,0.16666666666666666,5,5,GTCGGCCTGTTACTCACCAA,0,1162669
fldAp,0.16666666666666666,5,5,GTCGCTCACTCCGCGATCAG,0,1106201
fldAp,0.16666666666666666,5,5,GTCCTGCTTGCATGGACTGT,0,1078997
fldAp,0.16666666666666666,5,5,GTCCTACAGGGGCATATATC,0,1153508
fldAp,0.16666666666666666,5,5,GTCCGACTAGCAAATACAAT,0,1134354
fldAp,0.16666666666666666,5,5,GTCCCGGAATATACAAAAAT,0,1149798
fldAp,0.16666666666666666,5,5,GTCCCATGACTCAACATGCG,0,1112041
fldAp,0.16666666666666666,5,5,GTCCATGCCAGTGGGGGCCT,0,1068683
fldAp,0.16666666666666666,5,5,GTCCAATTTAAAGTTGCTGT,0,1136354
fldAp,0.16666666666666666,5,5,GTCCAAGAGAAGGACAGCCC,0,1087173
fldAp,0.16666666666666666,5,5,GTCATTCTGAACTTTTGAGT,0,1185332
fldAp,0.16666666666666666,5,5,GTCATTATTCACATCCTTCT,0,1167984
fldAp,0.16666666666666666,5,5,GTCATAGACGACCAGCGCTG,0,1089130
fldAp,0.16666666666666666,5,5,GTCAGTTTACCGATGATATC,0,1078423
fldAp,0.16666666666666666,5,5,GTCAGGAAGCTTTTCTCGGA,0,1151257
fldAp,0.16666666666666666,5,5,GTCAGCGGCCGGGTAAACTA,0,1075044
fldAp,0.16666666666666666,5,5,GTCAGCGAAAGGATGTCCGA,0,1177021
fldAp,0.16666666666666666,5,5,GTCAGCAGTTACGCCTACAG,0,1143847
fldAp,0.16666666666666666,5,5,GTCACTGCTCGAGCTGAACG,0,1113163
fldAp,0.16666666666666666,5,5,GTCACTCATAACGCACAGGA,0,1170692
fldAp,0.16666666666666666,5,5,GTCACGGGCCAGGGGCGGTA,0,1072264
fldAp,0.16666666666666666,5,5,GTCAATCGCGGATCCCGATT,0,1089005
fldAp,0.16666666666666666,5,5,GTCAAGGAGGCTCGATGCGC,0,1079443
fldAp,0.16666666666666666,5,5,GTATATCAGTTGTACACTAC,0,1142855
fldAp,0.16666666666666666,5,5,GTATATAGAGATTGCCGGTC,0,1129260
fldAp,0.16666666666666666,5,5,GTAGTATCCTTGTCAAATCC,0,1136770
fldAp,0.16666666666666666,5,5,GTAGTAGTCCAGTCATTGTT,0,1118792
fldAp,0.16666666666666666,5,5,GTAGCAGGAGCGCCAGCATC,0,1087118
fldAp,0.16666666666666666,5,5,GTAGACTAACTCTACAGCTG,0,1153599
fldAp,0.16666666666666666,5,5,GTACTTAGTAGGCATTTGAA,0,1069940
fldAp,0.16666666666666666,5,5,GTACTACAAGTACGCGCCCC,0,1183601
fldAp,0.16666666666666666,5,5,GTACACGTCCAGTTTTTTGG,0,1075735
fldAp,0.16666666666666666,5,5,GTACACAATACCGTTTGTTC,0,1090144
fldAp,0.16666666666666666,5,5,GTAACGATGAGGGTTCCACA,0,1147976
fldAp,0.16666666666666666,5,5,GTAACCTGGAGATATATGTT,0,1072825
fldAp,0.16666666666666666,5,5,GTAAAGGCGTAAGAGGGCCA,0,1092559
fldAp,0.16666666666666666,5,5,GTAAAACCACCGATGTCGGG,0,1083515
fldAp,0.16666666666666666,5,5,GGTTTTTCTACAGACACACA,0,1126020
fldAp,0.16666666666666666,5,5,GGTTTTACACGACATCCGAG,0,1182103
fldAp,0.16666666666666666,5,5,GGTTGTCTCTCCAAGAGTCA,0,1112253
fldAp,0.16666666666666666,5,5,GGTTGCCATCACTATTGATG,0,1168848
fldAp,0.16666666666666666,5,5,GGTTCGACCAAAGGTTGTTA,0,1178833
fldAp,0.16666666666666666,5,5,GGTTAACGGATTATACCGAA,0,1112901
fldAp,0.16666666666666666,5,5,GGTGTTAAGTTGAATTTAAT,0,1149466
fldAp,0.16666666666666666,5,5,GGTGCTCCGCTGTCTAATCT,0,1067168
fldAp,0.16666666666666666,5,5,GGTGAGTCTACTCGAGAGAT,0,1112312
fldAp,0.16666666666666666,5,5,GGTCTTCAGGTTCTATCCGG,0,1082483
fldAp,0.16666666666666666,5,5,GGTCTATTCTACATTGCTCG,0,1168050
fldAp,0.16666666666666666,5,5,GGTCGCGGGTTTGCTATCAT,0,1097028
fldAp,0.16666666666666666,5,5,GGTCGCACTGTTCAGCGGTC,0,1099190
fldAp,0.16666666666666666,5,5,GGTCGAAACGAGTTCCAACC,0,1174798
fldAp,0.16666666666666666,5,5,GGTCCATTATTGTTCGAGTA,0,1147190
fldAp,0.16666666666666666,5,5,GGTCCATGCGCATCTTTATT,0,1104337
fldAp,0.16666666666666666,5,5,GGTCATTGGAGAAGGATTCC,0,1101480
fldAp,0.16666666666666666,5,5,GGTCACACTACTGACTGAGT,0,1135489
fldAp,0.16666666666666666,5,5,GGTAGTTTGGCTTTGGCCAC,0,1075176
fldAp,0.16666666666666666,5,5,GGTAGTTTCTCGTCAGGAGT,0,1110292
fldAp,0.16666666666666666,5,5,GGTAGCGAAAGCAGAAGTTC,0,1129590
fldAp,0.16666666666666666,5,5,GGTACTACGTAAGCGTTTCC,0,1148817
fldAp,0.16666666666666666,5,5,GGTACACCCCTCGTATATCA,0,1090740
fldAp,0.16666666666666666,5,5,GGTAATCACACAACGGCCGA,0,1076559
fldAp,0.16666666666666666,5,5,GGGTTTGCCGAAACACGGAA,0,1085888
fldAp,0.16666666666666666,5,5,GGGTTTGATTCTGTTAATTT,0,1110616
fldAp,0.16666666666666666,5,5,GGGTTCGCATTGTAGGTAAA,0,1110551
fldAp,0.16666666666666666,5,5,GGGTTCCACGACGCCGTACG,0,1128023
fldAp,0.16666666666666666,5,5,GGGTTAACTTTGGCACCAGG,0,1067730
fldAp,0.16666666666666666,5,5,GGGTGGAGACCGGAGCGGCA,0,1180287
fldAp,0.16666666666666666,5,5,GGGTGCTATAGTGGCACTTC,0,1165694
fldAp,0.16666666666666666,5,5,GGGTCTCCGATGCTCCTCAT,0,1131148
fldAp,0.16666666666666666,5,5,GGGTCCGTATGCTAGGTAGT,0,1103673
fldAp,0.16666666666666666,5,5,GGGTCAGCCGCAAGCCTCAG,0,1153005
fldAp,0.16666666666666666,5,5,GGGTAGTCTGTCCACGGGCT,0,1165228
fldAp,0.16666666666666666,5,5,GGGTAGATATAGCCGGAACT,0,1102219
fldAp,0.16666666666666666,5,5,GGGGTACCCTAAATCATGAC,0,1088886
fldAp,0.16666666666666666,5,5,GGGGGATCCCACAGACCCCC,0,1129899
fldAp,0.16666666666666666,5,5,GGGGGACCCAGTCTTGTTGA,0,1148294
fldAp,0.16666666666666666,5,5,GGGGCGAATGTCACCATGAT,0,1086629
fldAp,0.16666666666666666,5,5,GGGGACTTGGAGTCTTCGAT,0,1171343
fldAp,0.16666666666666666,5,5,GGGCTCAGGGGTCCCTAATC,0,1124496
fldAp,0.16666666666666666,5,5,GGGCGTTCGTGTAGAGGAGT,0,1106759
fldAp,0.16666666666666666,5,5,GGGCGTATTGCGAGGTTACA,0,1122752
fldAp,0.16666666666666666,5,5,GGGCGGTCCACTCGAAGCCG,0,1145511
fldAp,0.16666666666666666,5,5,GGGCGCCTTGGAGAATTATA,0,1178123
fldAp,0.16666666666666666,5,5,GGGCCATTATGGAAATAGGA,0,1165618
fldAp,0.16666666666666666,5,5,GGGCCAACCGAGGCGGACAA,0,1122842
fldAp,0.16666666666666666,5,5,GGGCACCTTCAGTTTGGGCA,0,1146038
fldAp,0.16666666666666666,5,5,GGGATTCTAATCATAGCGCC,0,1090798
fldAp,0.16666666666666666,5,5,GGGATGTTACTAACAAACCC,0,1154974
fldAp,0.16666666666666666,5,5,GGGATGGCATTATTAGTGGA,0,1082071
fldAp,0.16666666666666666,5,5,GGGATCGAACAAAAGGACGT,0,1116404
fldAp,0.16666666666666666,5,5,GGGAGCCTTAGTTTTGAAAG,0,1152945
fldAp,0.16666666666666666,5,5,GGGACTCTTATGCTCCGTTA,0,1075426
fldAp,0.16666666666666666,5,5,GGGACGTCCACGCATGCGGT,0,1074602
fldAp,0.16666666666666666,5,5,GGGACGGACACGCTCAATTT,0,1081332
fldAp,0.16666666666666666,5,5,GGGAAGGGGAGACCCTCCTG,0,1117743
fldAp,0.16666666666666666,5,5,GGGAACCTTAAAGAGGTAAC,0,1067358
fldAp,0.16666666666666666,5,5,GGCTTGCCTGTCGCTTTCCA,0,1066876
fldAp,0.16666666666666666,5,5,GGCTTCACCTGATCGTAAAG,0,1122997
fldAp,0.16666666666666666,5,5,GGCTTCACATATCGATAGCT,0,1177661
fldAp,0.16666666666666666,5,5,GGCTGATCTTGACCCCTGCA,0,1120409
fldAp,0.16666666666666666,5,5,GGCTCATTTATCTAATGCCT,0,1107470
fldAp,0.16666666666666666,5,5,GGCTAGGACATGCCCATCGT,0,1107884
fldAp,0.16666666666666666,5,5,GGCTACGCATTCGGCACAGT,0,1180998
fldAp,0.16666666666666666,5,5,GGCGGTAGGCTATCCATAGG,0,1091239
fldAp,0.16666666666666666,5,5,GGCGGTAATGGTGCGGGCTT,0,1094003
fldAp,0.16666666666666666,5,5,GGCGGGGGCCATTTCACTTG,0,1079800
fldAp,0.16666666666666666,5,5,GGCGCTAGAGATCAGAAGTA,0,1068493
fldAp,0.16666666666666666,5,5,GGCGATTCAGCGCCGCATTT,0,1104772
fldAp,0.16666666666666666,5,5,GGCGAATCCAATTCGAAACT,0,1185030
fldAp,0.16666666666666666,5,5,GGCCTCATTTCAGATCGACC,0,1154754
fldAp,0.16666666666666666,5,5,GGCCTAGCCCTTGCGCTTAG,0,1074544
fldAp,0.16666666666666666,5,5,GGCCGTGCTTTGCCTGGAGT,0,1137335
fldAp,0.16666666666666666,5,5,GGCCGCCTAGCGAGCTCCGG,0,1109796
fldAp,0.16666666666666666,5,5,GGCCGAAGGGTGCCTAGTGG,0,1149963
fldAp,0.16666666666666666,5,5,GGCCGAAAGTACATACGAGC,0,1070664
fldAp,0.16666666666666666,5,5,GGCCACGGTTCCGGCGGAAT,0,1100256
fldAp,0.16666666666666666,5,5,GGCCACGGATGCTATTGTTG,0,1168998
fldAp,0.16666666666666666,5,5,GGCCACCTTTCCCGGACGGG,0,1132809
fldAp,0.16666666666666666,5,5,GGCATCTGTACGCGTATCGA,0,1071131
fldAp,0.16666666666666666,5,5,GGCAGGTCTGTCAGTGTGGT,0,1168737
fldAp,0.16666666666666666,5,5,GGCACTCAGGGCCTAGACCT,0,1151549
fldAp,0.16666666666666666,5,5,GGCACGGCATTTACTGGCTT,0,1096614
fldAp,0.16666666666666666,5,5,GGCACGGCAGGGTAGAATGT,0,1161880
fldAp,0.16666666666666666,5,5,GGCACCGGCACACCATCGTG,0,1072569
fldAp,0.16666666666666666,5,5,GGATTAAAGCTCTTGTCCAG,0,1168965
fldAp,0.16666666666666666,5,5,GGATGCTTGCGCGTACTCTA,0,1180695
fldAp,0.16666666666666666,5,5,GGATGAACAACAACTCTCCA,0,1102824
fldAp,0.16666666666666666,5,5,GGATGAAAGTAAGCCTTAGA,0,1159552
fldAp,0.16666666666666666,5,5,GGATCTTATCAGTTCATCTA,0,1181449
fldAp,0.16666666666666666,5,5,GGATATTTAGAATAGTCGAA,0,1142943
fldAp,0.16666666666666666,5,5,GGATATCTCCTTTGAATGCA,0,1120691
fldAp,0.16666666666666666,5,5,GGATACTGTATGCCAGCGCA,0,1129657
fldAp,0.16666666666666666,5,5,GGAGTCAGTCAGCGAAGACT,0,1141999
fldAp,0.16666666666666666,5,5,GGAGTACGCGTTTTTCCAGT,0,1165060
fldAp,0.16666666666666666,5,5,GGAGGATGTGGGCACGCCAA,0,1140977
fldAp,0.16666666666666666,5,5,GGAGCGCGCAGGGGAAGTCT,0,1097917
fldAp,0.16666666666666666,5,5,GGAGACGACATCAGGTGGGA,0,1161261
fldAp,0.16666666666666666,5,5,GGAGAACCAGGCAGCTCGCT,0,1177213
fldAp,0.16666666666666666,5,5,GGACTTAGACACTGCAAATC,0,1101248
fldAp,0.16666666666666666,5,5,GGACGTACGACCTTCCCGTG,0,1150654
fldAp,0.16666666666666666,5,5,GGACGCTGCGCTTTGTGTGA,0,1136017
fldAp,0.16666666666666666,5,5,GGACGACATAAACCTTTAGG,0,1089624
fldAp,0.16666666666666666,5,5,GGACCGTATAGCAGGAGACC,0,1169346
fldAp,0.16666666666666666,5,5,GGACCCGTACTTGGCAGCCG,0,1092033
fldAp,0.16666666666666666,5,5,GGACCACACTGTTTCGTCTG,0,1141337
fldAp,0.16666666666666666,5,5,GGACATTTTTCTTGTGCAGC,0,1185039
fldAp,0.16666666666666666,5,5,GGACAAGCTTAAATATAGCT,0,1115026
fldAp,0.16666666666666666,5,5,GGAATTGGAAGGGGATCCGG,0,1130057
fldAp,0.16666666666666666,5,5,GGAATTGAATGCATCCTAAC,0,1083057
fldAp,0.16666666666666666,5,5,GGAATCAGTAATAATCGGAA,0,1097758
fldAp,0.16666666666666666,5,5,GGAAGGTTCAGGTACATGAG,0,1097462
fldAp,0.16666666666666666,5,5,GGAAGGTACTCACGCAGGAG,0,1136180
fldAp,0.16666666666666666,5,5,GGAAGGAGACGATATTGCTA,0,1157017
fldAp,0.16666666666666666,5,5,GGAAGACTGGGGGCGCTCTT,0,1177761
fldAp,0.16666666666666666,5,5,GGAACAACAACAAGCCAGTA,0,1145039
fldAp,0.16666666666666666,5,5,GGAAAACCAAGTCCATGGTC,0,1116113
fldAp,0.16666666666666666,5,5,GCTTTTCACAGGACTGATTG,0,1182951
fldAp,0.16666666666666666,5,5,GCTTGCCACGCGATACGAGC,0,1075754
fldAp,0.16666666666666666,5,5,GCTTGAAAGCTGACGCTTTA,0,1086236
fldAp,0.16666666666666666,5,5,GCTTCTTTGCGTCGTTAAGG,0,1126870
fldAp,0.16666666666666666,5,5,GCTTCTGTCGTGGTACAATG,0,1182310
fldAp,0.16666666666666666,5,5,GCTTCTCTTACAATGGACAC,0,1090284
fldAp,0.16666666666666666,5,5,GCTTACATTTCATTTGCAAA,0,1166331
fldAp,0.16666666666666666,5,5,GCTGTGGGATATGTAACAGA,0,1164355
fldAp,0.16666666666666666,5,5,GCTGGAGGCGCTAATGGTGC,0,1142254
fldAp,0.16666666666666666,5,5,GCTGGAATGCTTTGGATTGT,0,1143951
fldAp,0.16666666666666666,5,5,GCTGAGCGCAGAAATTACGG,0,1126869
fldAp,0.16666666666666666,5,5,GCTGAGCAGGCTATCCGAGC,0,1135019
fldAp,0.16666666666666666,5,5,GCTGAAAGGAGGGGATCGGC,0,1131243
fldAp,0.16666666666666666,5,5,GCTCTGGGGTCACTGCAGCA,0,1063736
fldAp,0.16666666666666666,5,5,GCTCTGCCTGATCCGGGGTG,0,1107451
fldAp,0.16666666666666666,5,5,GCTCTAGGCTCCGCTGCCGA,0,1179178
fldAp,0.16666666666666666,5,5,GCTACTTCTTCAGTCCTATG,0,1164370
fldAp,0.16666666666666666,5,5,GCTACGCAGTGTAGGTCAGG,0,1158171
fldAp,0.16666666666666666,5,5,GCTACGCAATGTATCTCGAG,0,1133518
fldAp,0.16666666666666666,5,5,GCTAATACACAGCACTTGAG,0,1098000
fldAp,0.16666666666666666,5,5,GCTAAAGTCACGGCATGTAC,0,1084371
fldAp,0.16666666666666666,5,5,GCGTGGCGTAGCTCCCTAGT,0,1132636
fldAp,0.16666666666666666,5,5,GCGTCTTACGGAGTCTAATA,0,1134590
fldAp,0.16666666666666666,5,5,GCGTCAAACTGCGCAAGACA,0,1159261
fldAp,0.16666666666666666,5,5,GCGTAGCCGATTAACCGATG,0,1117580
fldAp,0.16666666666666666,5,5,GCGTAGAAACGACTGGTATT,0,1082627
fldAp,0.16666666666666666,5,5,GCGGTTCATGGCGGTAAATA,0,1182875
fldAp,0.16666666666666666,5,5,GCGGCTACTGCATGCGGGCT,0,1168356
fldAp,0.16666666666666666,5,5,GCGGCTAACAGGACTGAGTA,0,1130854
fldAp,0.16666666666666666,5,5,GCGGCAGGACTATCGTTGGT,0,1085608
fldAp,0.16666666666666666,5,5,GCGGCAGAACTCGGAAGAGC,0,1076156
fldAp,0.16666666666666666,5,5,GCGGACTGCATTTGCCTGAT,0,1103167
fldAp,0.16666666666666666,5,5,GCGGAATACGGGCCGTCAAT,0,1105266
fldAp,0.16666666666666666,5,5,GCGCGTCGAAGGTCGAAAAA,0,1075046
fldAp,0.16666666666666666,5,5,GCGCGGTCGTACGATAACAT,0,1168279
fldAp,0.16666666666666666,5,5,GCGCGGCGAACGACCACTCA,0,1134756
fldAp,0.16666666666666666,5,5,GCGCGCGAACTGTTAGGGAT,0,1150908
fldAp,0.16666666666666666,5,5,GCGCCGGCATGCTGGAATTA,0,1180841
fldAp,0.16666666666666666,5,5,GCGCCACGATGAAACACAAC,0,1066991
fldAp,0.16666666666666666,5,5,GCGCAGTGGGCTCTCATCGC,0,1085717
fldAp,0.16666666666666666,5,5,GCGATGTTCCTGGACAGTAG,0,1134726
fldAp,0.16666666666666666,5,5,GCGATCAATAACCTAGGTTC,0,1091165
fldAp,0.16666666666666666,5,5,GCGATACCGGGCATTTAGGT,0,1158554
fldAp,0.16666666666666666,5,5,GCGACGGGGCACAACTATTA,0,1175184
fldAp,0.16666666666666666,5,5,GCGAACTCGCAGTCTTCTCA,0,1071528
fldAp,0.16666666666666666,5,5,GCGAAACCTAATGCGCTCTT,0,1095151
fldAp,0.16666666666666666,5,5,GCCTTTATACCGTGGCACTG,0,1168767
fldAp,0.16666666666666666,5,5,GCCTTTACGTAGACCATCAG,0,1087845
fldAp,0.16666666666666666,5,5,GCCTGTTTACACCCCGCACT,0,1095472
fldAp,0.16666666666666666,5,5,GCCTGTAATTATCTCTGCAT,0,1138900
fldAp,0.16666666666666666,5,5,GCCTGGCTACCGGCCTCACG,0,1108331
fldAp,0.16666666666666666,5,5,GCCTGCTCAGCACCATTAGC,0,1154171
fldAp,0.16666666666666666,5,5,GCCTGCGTCGCGACAGGATT,0,1100844
fldAp,0.16666666666666666,5,5,GCCTGAAGGCGGGAGATTCG,0,1152114
fldAp,0.16666666666666666,5,5,GCCTCAAAATCCGGGGAGGC,0,1088877
fldAp,0.16666666666666666,5,5,GCCTAAGCGGTACTTTCTAA,0,1083965
fldAp,0.16666666666666666,5,5,GCCGTAGTTGCATCACGCGA,0,1065885
fldAp,0.16666666666666666,5,5,GCCGTACGTACGCTGGTGGA,0,1120148
fldAp,0.16666666666666666,5,5,GCCGCTGATGTCCGTTCGTA,0,1083145
fldAp,0.16666666666666666,5,5,GCCGAGCTCTGTCACCTGTT,0,1136962
fldAp,0.16666666666666666,5,5,GCCGACGCTCATCTGTCAAA,0,1080403
fldAp,0.16666666666666666,5,5,GCCGAAGCGCAAAATCGTTC,0,1084038
fldAp,0.16666666666666666,5,5,GCCCTTATGAGCTCACTGTA,0,1097718
fldAp,0.16666666666666666,5,5,GCCCTGCTCGCGCCAGTTCG,0,1089708
fldAp,0.16666666666666666,5,5,GCCCGTGTCAGCATCGAGAT,0,1108978
fldAp,0.16666666666666666,5,5,GCCCGCAGGATTAGTGCTCT,0,1106426
fldAp,0.16666666666666666,5,5,GCCCCCTCTAGCGATGCTGT,0,1122973
fldAp,0.16666666666666666,5,5,GCCCATCTTTGGATGTAACC,0,1077535
fldAp,0.16666666666666666,5,5,GCCCATAAAAGCGGCCGAAG,0,1184441
fldAp,0.16666666666666666,5,5,GCCATGCAATCGGTGAAGAG,0,1090354
fldAp,0.16666666666666666,5,5,GCCATAAGGGTCAGGGGCAT,0,1162645
fldAp,0.16666666666666666,5,5,GCCAGGTAGACGTCTGATTG,0,1117012
fldAp,0.16666666666666666,5,5,GCCAGCCAACCATTAACTAG,0,1131391
fldAp,0.16666666666666666,5,5,GCCACTCCGCTACGATCAGT,0,1108476
fldAp,0.16666666666666666,5,5,GCCAATATACCACCATTCAC,0,1128119
fldAp,0.16666666666666666,5,5,GCCAAGCTTTAAGATCTGCC,0,1173095
fldAp,0.16666666666666666,5,5,GCCAAAGTTCAACCCTGGGA,0,1088534
fldAp,0.16666666666666666,5,5,GCATTTTTCGTATTGTCTTT,0,1149003
fldAp,0.16666666666666666,5,5,GCATTGCCAATCTTAATTCA,0,1143089
fldAp,0.16666666666666666,5,5,GCATTAAAGAGAAAAGCGAC,0,1159884
fldAp,0.16666666666666666,5,5,GCATGTTCGCGGACACCGGC,0,1111988
fldAp,0.16666666666666666,5,5,GCATGCCCCGTCCTCCGCTG,0,1077479
fldAp,0.16666666666666666,5,5,GCATGAAAACGCATTGCTAG,0,1110415
fldAp,0.16666666666666666,5,5,GCATCTGTTATCATGATTGT,0,1125970
fldAp,0.16666666666666666,5,5,GCATCTAGATAGGATGTGTA,0,1076444
fldAp,0.16666666666666666,5,5,GCATCGTAATGCGGGACAGA,0,1186563
fldAp,0.16666666666666666,5,5,GCATCGGCCAGTAGGCACCT,0,1098294
fldAp,0.16666666666666666,5,5,GCATCACATCATATTCGAGG,0,1065732
fldAp,0.16666666666666666,5,5,GCATAGCGTACTCAAGCGTG,0,1069214
fldAp,0.16666666666666666,5,5,GCAGTCTTTTAGGAAGCAGT,0,1094028
fldAp,0.16666666666666666,5,5,GCAGGGGCAGCCATGACGGT,0,1066560
fldAp,0.16666666666666666,5,5,GCAGGGACGACAGGTGACGC,0,1122245
fldAp,0.16666666666666666,5,5,GCAGCTGTAAACTTTATCTA,0,1164033
fldAp,0.16666666666666666,5,5,GCAGCGCTTCAACACTTGAG,0,1112745
fldAp,0.16666666666666666,5,5,GCAGCGCTAGCGTCCCATCT,0,1182523
fldAp,0.16666666666666666,5,5,GCAGCCTTTAGCGACGCAAA,0,1070891
fldAp,0.16666666666666666,5,5,GCAGAGCGACAACCTTATAG,0,1108270
fldAp,0.16666666666666666,5,5,GCAGAGCACACACTGCGCGC,0,1150287
fldAp,0.16666666666666666,5,5,GCACTGATATAACTTCGGCC,0,1132426
fldAp,0.16666666666666666,5,5,GCACTATGGCGGATTGACTG,0,1185315
fldAp,0.16666666666666666,5,5,GCACGTGAGCAAGGAACACT,0,1089530
fldAp,0.16666666666666666,5,5,GCACCAAACCACCAGGAGTA,0,1093765
fldAp,0.16666666666666666,5,5,GCACAAAGCTAACAGCGTAT,0,1134643
fldAp,0.16666666666666666,5,5,GCAATGCGGGGGGCCTTTAT,0,1097798
fldAp,0.16666666666666666,5,5,GCAAGGGCTTGCTTATGGAG,0,1094947
fldAp,0.16666666666666666,5,5,GCAAGGGCCGGTACTAACGT,0,1102027
fldAp,0.16666666666666666,5,5,GCAAGCGTTTTTCTTAAACA,0,1150659
fldAp,0.16666666666666666,5,5,GCAAGCCGTGTACCTCCCCC,0,1163802
fldAp,0.16666666666666666,5,5,GCAAGCATGTCTTCCCGTGA,0,1102542
fldAp,0.16666666666666666,5,5,GCAACTCGCTAGGTGTTGCG,0,1129779
fldAp,0.16666666666666666,5,5,GCAAATTGGCTTGGTTCCAT,0,1141736
fldAp,0.16666666666666666,5,5,GCAAAGACTCAGAAGTAATG,0,1070351
fldAp,0.16666666666666666,5,5,GATTTGTACGGGGCTCTTCA,0,1101046
fldAp,0.16666666666666666,5,5,GATTGTGGTCCGTGCTATGG,0,1150338
fldAp,0.16666666666666666,5,5,GATTGTGACTCCTGGACTTC,0,1104336
fldAp,0.16666666666666666,5,5,GATTGTAAGGAGCAACGGCA,0,1134014
fldAp,0.16666666666666666,5,5,GATTGCTACAGATCTCTGAC,0,1163908
fldAp,0.16666666666666666,5,5,GATTCCTGCATAGTGAGTGA,0,1153108
fldAp,0.16666666666666666,5,5,GATTCAATGCGTAGTGCATT,0,1147376
fldAp,0.16666666666666666,5,5,GATTCAATCTACCCGCGTGG,0,1132781
fldAp,0.16666666666666666,5,5,GATGTCAGACTTGTGTAGAA,0,1079545
fldAp,0.16666666666666666,5,5,GATGGTTATCGTCACAGCTA,0,1110675
fldAp,0.16666666666666666,5,5,GATGGTGATCGGCGGTCTAA,0,1148502
fldAp,0.16666666666666666,5,5,GATGGCTGGATTACCAGCTG,0,1092862
fldAp,0.16666666666666666,5,5,GATGCGGGACCAGATTCCAA,0,1075609
fldAp,0.16666666666666666,5,5,GATGCCTACTGGACTGCTAA,0,1179003
fldAp,0.16666666666666666,5,5,GATGATTCCTCACGCGGTTA,0,1067184
fldAp,0.16666666666666666,5,5,GATGATACAATGCGTTAAGT,0,1068743
fldAp,0.16666666666666666,5,5,GATGAGAATGAGGGTTATTA,0,1125842
fldAp,0.16666666666666666,5,5,GATGAATATCTATGGCGGCA,0,1144397
fldAp,0.16666666666666666,5,5,GATGAAGGGCATCAACCTTA,0,1082017
fldAp,0.16666666666666666,5,5,GATGAACCGTGGTAGGTGAA,0,1176068
fldAp,0.16666666666666666,5,5,GATCGTAGAAACCTAGCGTA,0,1133693
fldAp,0.16666666666666666,5,5,GATCGCCTCTTTTAGCGGTG,0,1151710
fldAp,0.16666666666666666,5,5,GATCCTATGATGCCGAACTG,0,1100673
fldAp,0.16666666666666666,5,5,GATCATTATACTGGAACAAG,0,1092051
fldAp,0.16666666666666666,5,5,GATCATGCTGGTAAAGGTAT,0,1079978
fldAp,0.16666666666666666,5,5,GATCAGGTCACTGCTAGGAA,0,1092712
fldAp,0.16666666666666666,5,5,GATCAGCTCCAGGTCTTATT,0,1130105
fldAp,0.16666666666666666,5,5,GATCACTCGCGGTCGCATCA,0,1176789
fldAp,0.16666666666666666,5,5,GATCAATACGCACAATAAGA,0,1156654
fldAp,0.16666666666666666,5,5,GATATTCCCCGTCCTAAGTG,0,1102845
fldAp,0.16666666666666666,5,5,GATAGTGCGGGGTTGGGTGA,0,1122666
fldAp,0.16666666666666666,5,5,GATAGGGTCACGTAGTGGTG,0,1081446
fldAp,0.16666666666666666,5,5,GATAGGACGTCACAGGTCAT,0,1179530
fldAp,0.16666666666666666,5,5,GATACTGCATCGGTTTAAAT,0,1149033
fldAp,0.16666666666666666,5,5,GATAAGTCCTGACGGCGTTT,0,1087435
fldAp,0.16666666666666666,5,5,GAGTTTAGGCTAATACCGTC,0,1065227
fldAp,0.16666666666666666,5,5,GAGTTGGTGGCTCCGCAAGG,0,1183396
fldAp,0.16666666666666666,5,5,GAGTTCTTGAGGACCTTCGA,0,1090763
fldAp,0.16666666666666666,5,5,GAGTGAACCAGATCTCATCT,0,1147028
fldAp,0.16666666666666666,5,5,GAGTCTGCGGATTCATGGTT,0,1089212
fldAp,0.16666666666666666,5,5,GAGGTCATCTGCAGTGGGGT,0,1101386
fldAp,0.16666666666666666,5,5,GAGGGGGGTGATAGCTCATC,0,1130906
fldAp,0.16666666666666666,5,5,GAGGGCGTATACATGGTGCT,0,1180942
fldAp,0.16666666666666666,5,5,GAGGGAGTGCGGCGGGGGCA,0,1186444
fldAp,0.16666666666666666,5,5,GAGGAGTGCCAGAACGTGTA,0,1091615
fldAp,0.16666666666666666,5,5,GAGCTTGAGTTAGGTACCTG,0,1170526
fldAp,0.16666666666666666,5,5,GAGCTCCAGGAGGGGTTCAA,0,1177943
fldAp,0.16666666666666666,5,5,GAGCGGGTCCTGTGGAAGGT,0,1168145
fldAp,0.16666666666666666,5,5,GAGCGGAACTGACCGTTTAC,0,1186779
fldAp,0.16666666666666666,5,5,GAGCCGGTGTAAGCACGGAG,0,1128369
fldAp,0.16666666666666666,5,5,GAGCCGCTCCTGAAAGGACT,0,1120974
fldAp,0.16666666666666666,5,5,GAGCCAATAGAGGCGTGACG,0,1184092
fldAp,0.16666666666666666,5,5,GAGCAGCCGGATGTATCAGG,0,1128546
fldAp,0.16666666666666666,5,5,GAGATTAGGGACGAATGGCC,0,1144543
fldAp,0.16666666666666666,5,5,GAGATGCCATTGGTGTGTAT,0,1083538
fldAp,0.16666666666666666,5,5,GAGATCAGTTAAATCTTAGT,0,1179671
fldAp,0.16666666666666666,5,5,GAGACGTCATCGCTTGTATT,0,1175155
fldAp,0.16666666666666666,5,5,GAGACACTCCGTTCGTTTAA,0,1078892
fldAp,0.16666666666666666,5,5,GAGAATCCGAGTGCACCCAG,0,1070189
fldAp,0.16666666666666666,5,5,GAGAAAACGAAATGATTTGC,0,1105110
fldAp,0.16666666666666666,5,5,GACTTTGATCGGAACCGTGG,0,1081631
fldAp,0.16666666666666666,5,5,GACTGTTAAGAGCTGAGTGT,0,1181176
fldAp,0.16666666666666666,5,5,GACTGAGCGAGGGGCCGCGA,0,1153735
fldAp,0.16666666666666666,5,5,GACTATCTCTCTCGCCCTTG,0,1163052
fldAp,0.16666666666666666,5,5,GACTACGGACCGCCGATTTA,0,1163517
fldAp,0.16666666666666666,5,5,GACGTTCCGTCGTCCGCGGC,0,1154882
fldAp,0.16666666666666666,5,5,GACGTCTCGACTCCGGATGA,0,1073945
fldAp,0.16666666666666666,5,5,GACGTATCCGTGTCGGGCAA,0,1156753
fldAp,0.16666666666666666,5,5,GACGGGCAACCAAGCCCACA,0,1137147
fldAp,0.16666666666666666,5,5,GACGGATCTATTAAAGGAAT,0,1098716
fldAp,0.16666666666666666,5,5,GACGGACCCTAAGTTCGGTG,0,1122410
fldAp,0.16666666666666666,5,5,GACGGAACATCCTTGTAGTA,0,1121706
fldAp,0.16666666666666666,5,5,GACGCATGCTCCTGTACAAA,0,1064422
fldAp,0.16666666666666666,5,5,GACGATTGGTCCATGTAAAT,0,1128103
fldAp,0.16666666666666666,5,5,GACGAGGTTTGAATTCAACG,0,1163694
fldAp,0.16666666666666666,5,5,GACCTGACAACACACTGTCA,0,1105296
fldAp,0.16666666666666666,5,5,GACCTAATGCGAGAGGATGC,0,1163752
fldAp,0.16666666666666666,5,5,GACCGTATTATATGAGATAT,0,1113579
fldAp,0.16666666666666666,5,5,GACCGACGGACCGTTAACTA,0,1133837
fldAp,0.16666666666666666,5,5,GACCCCTTTGCAAGCGGCGA,0,1129673
fldAp,0.16666666666666666,5,5,GACCATAAGCTTGTACAGTT,0,1165155
fldAp,0.16666666666666666,5,5,GACCAGGCCTGTTATATTCA,0,1099168
fldAp,0.16666666666666666,5,5,GACCAGCCCATCCTTTAGTG,0,1159321
fldAp,0.16666666666666666,5,5,GACCACGCGGGTGGTGGAGC,0,1098825
fldAp,0.16666666666666666,5,5,GACCACGCGACGATGGGACT,0,1109468
fldAp,0.16666666666666666,5,5,GACCACATCGCGCTCGTTCA,0,1139954
fldAp,0.16666666666666666,5,5,GACATTGATCGCGGCTTGGA,0,1154406
fldAp,0.16666666666666666,5,5,GACATGCGTGTGTCTCATCT,0,1157766
fldAp,0.16666666666666666,5,5,GACATCTCGGGTAATTATTC,0,1165210
fldAp,0.16666666666666666,5,5,GACAGATGATTCGGGAGAGT,0,1174875
fldAp,0.16666666666666666,5,5,GACACGGCTAGGGGAAAGGG,0,1107459
fldAp,0.16666666666666666,5,5,GACACCCCGAGTGCCCACTG,0,1128299
fldAp,0.16666666666666666,5,5,GACAAGGATACACAATGGTA,0,1186803
fldAp,0.16666666666666666,5,5,GAATTTGGTCTTTCAGCCCT,0,1123008
fldAp,0.16666666666666666,5,5,GAATTTCACCGGTGCGTCGA,0,1080436
fldAp,0.16666666666666666,5,5,GAATTAGATTGAGTGGGACA,0,1173237
fldAp,0.16666666666666666,5,5,GAATGTGGCCTGGCTAGGAG,0,1174661
fldAp,0.16666666666666666,5,5,GAATCTCGCCGATCTTGGAT,0,1083249
fldAp,0.16666666666666666,5,5,GAATCGAGGCCGGGTTCGTA,0,1170109
fldAp,0.16666666666666666,5,5,GAATCGAACACCTACAAAGA,0,1138655
fldAp,0.16666666666666666,5,5,GAATCCTTGGAAAAAGCGGG,0,1151692
fldAp,0.16666666666666666,5,5,GAATAGCGTTAATTTAGTAT,0,1132401
fldAp,0.16666666666666666,5,5,GAATACTTGTAGCTTGCGTC,0,1077363
fldAp,0.16666666666666666,5,5,GAAGTTAATCGAGGTCTAGG,0,1149300
fldAp,0.16666666666666666,5,5,GAAGTGCGGGTACTCTCGAT,0,1130995
fldAp,0.16666666666666666,5,5,GAAGTCCATACAATTACTGA,0,1076320
fldAp,0.16666666666666666,5,5,GAAGAGAGCCGTTTTAGCTA,0,1082327
fldAp,0.16666666666666666,5,5,GAACTCGCGGGGAATCAGAC,0,1086318
fldAp,0.16666666666666666,5,5,GAACGAAGTAATAAATGAGG,0,1068250
fldAp,0.16666666666666666,5,5,GAACCGACCCATCCGCACGA,0,1089794
fldAp,0.16666666666666666,5,5,GAACCCTTCAGAGGACATGT,0,1105676
fldAp,0.16666666666666666,5,5,GAAATTGCTTTACTGATTTT,0,1116921
fldAp,0.16666666666666666,5,5,GAAAGGTTGAGGCAGGGGGT,0,1134239
fldAp,0.16666666666666666,5,5,GAAAGACTAAACGATCTAGA,0,1074150
fldAp,0.16666666666666666,5,5,GAAACGCCTTCTAGCGAGGT,0,1127026
fldAp,0.16666666666666666,5,5,GAAAACTCTTACTATCGAAA,0,1174221
fldAp,0.16666666666666666,5,5,GAAAAAGTCGGTGTCCTACG,0,1071265
fldAp,0.16666666666666666,5,5,GAAAAACGGCGTTCGTAAGA,0,1175274
fldAp,0.16666666666666666,5,5,GAAAAACCTGTGATGTGCTA,0,1065624
fldAp,0.16666666666666666,5,5,CTTTTAGAGCAATGGCCACA,0,1169050
fldAp,0.16666666666666666,5,5,CTTTGTGGTATCTCACGCAT,0,1157720
fldAp,0.16666666666666666,5,5,CTTTGCTTTACCAAGCACAT,0,1114294
fldAp,0.16666666666666666,5,5,CTTTGCCCCACTTATTTATG,0,1150043
fldAp,0.16666666666666666,5,5,CTTTCTGTCAGACACTAAAC,0,1156856
fldAp,0.16666666666666666,5,5,CTTTAGGAGCCCATACAGAA,0,1109948
fldAp,0.16666666666666666,5,5,CTTGTCTCAGGAATTATGAT,0,1164147
fldAp,0.16666666666666666,5,5,CTTGTCGGAATCGAAACGGG,0,1104724
fldAp,0.16666666666666666,5,5,CTTGGCGTGACTCTAATTTG,0,1145663
fldAp,0.16666666666666666,5,5,CTTGGAAGGACAGGACTGTA,0,1081456
fldAp,0.16666666666666666,5,5,CTTGACGTTCAAATGGCAGT,0,1139472
fldAp,0.16666666666666666,5,5,CTTGACAGATACCTCAGAAC,0,1143184
fldAp,0.16666666666666666,5,5,CTTCTGGCTGAGCGTCCGTA,0,1175241
fldAp,0.16666666666666666,5,5,CTTCGAGGCAAGCTACGTTT,0,1071259
fldAp,0.16666666666666666,5,5,CTTCAGACGAAGTTCTGTTA,0,1152309
fldAp,0.16666666666666666,5,5,CTTCACGTGGTTATATGGAT,0,1100279
fldAp,0.16666666666666666,5,5,CTTCACGCCGAAGCACTATC,0,1118076
fldAp,0.16666666666666666,5,5,CTTATAGAGACGCTAAGTGA,0,1135924
fldAp,0.16666666666666666,5,5,CTTAGTCTACCCGTTCTGAA,0,1163929
fldAp,0.16666666666666666,5,5,CTTAAGAATCTCCATATTTT,0,1087023
fldAp,0.16666666666666666,5,5,CTTAACTGCAGCGCTGATAT,0,1107269
fldAp,0.16666666666666666,5,5,CTGTTTGCGAGCTGGGCTGT,0,1165905
fldAp,0.16666666666666666,5,5,CTGTTTCGTGCAACCTCGAC,0,1069790
fldAp,0.16666666666666666,5,5,CTGTTGGCATGTGCCGGAGA,0,1164350
fldAp,0.16666666666666666,5,5,CTGTGCGGTTACTTTATCGC,0,1176831
fldAp,0.16666666666666666,5,5,CTGTGCAAAAACATGGTGTG,0,1097482
fldAp,0.16666666666666666,5,5,CTGTGATTCTACGCTCCGTG,0,1105494
fldAp,0.16666666666666666,5,5,CTGTCCTCGAACGCTTTAAA,0,1147057
fldAp,0.16666666666666666,5,5,CTGTCCGATGAAAGAGGTGA,0,1161264
fldAp,0.16666666666666666,5,5,CTGTCCCATCTACTGGGCAA,0,1069263
fldAp,0.16666666666666666,5,5,CTGTACACGCTTGAAACTGG,0,1068384
fldAp,0.16666666666666666,5,5,CTGGTGGTCAAGCTACTTCA,0,1108868
fldAp,0.16666666666666666,5,5,CTGGTGAGGAACCTATGCTT,0,1105280
fldAp,0.16666666666666666,5,5,CTGGGTGCATCGCCGCGGTC,0,1087779
fldAp,0.16666666666666666,5,5,CTGGGGATTGCCCAACACTT,0,1089019
fldAp,0.16666666666666666,5,5,CTGGCTTCCAAACCGTGGAG,0,1123585
fldAp,0.16666666666666666,5,5,CTGGCTTAGACGGGGAGATA,0,1162449
fldAp,0.16666666666666666,5,5,CTGGCCTTATGCCAAATACT,0,1093539
fldAp,0.16666666666666666,5,5,CTGGCACCTGTCGGGAATGG,0,1140552
fldAp,0.16666666666666666,5,5,CTGGAGCATCCTATATATGA,0,1066445
fldAp,0.16666666666666666,5,5,CTGGAGAGAGGTTGGTCCCG,0,1122984
fldAp,0.16666666666666666,5,5,CTGGAATCCATAAAGCGATC,0,1147954
fldAp,0.16666666666666666,5,5,CTGGAACAGCTGAGAAGCCT,0,1157968
fldAp,0.16666666666666666,5,5,CTGGAAACCGTGCTTATGGT,0,1112811
fldAp,0.16666666666666666,5,5,CTGCGGTTATTCGCTTGCGG,0,1172740
fldAp,0.16666666666666666,5,5,CTGCGGGGCAGTCGTAACCG,0,1077644
fldAp,0.16666666666666666,5,5,CTGCGGGCTTGTAAACGTAT,0,1145299
fldAp,0.16666666666666666,5,5,CTGCGGATGATAGCGCCCCA,0,1154898
fldAp,0.16666666666666666,5,5,CTGCGCCTGGTCCTCGGTGG,0,1171771
fldAp,0.16666666666666666,5,5,CTGCGCCTAATGAATAAATG,0,1075319
fldAp,0.16666666666666666,5,5,CTGCATCAGTAATGAATGAC,0,1184348
fldAp,0.16666666666666666,5,5,CTGCATACATGTATGAGGGA,0,1099267
fldAp,0.16666666666666666,5,5,CTGCACTGAAGCGGACCCTG,0,1069398
fldAp,0.16666666666666666,5,5,CTGCAATTCAACTCAAGTCG,0,1141672
fldAp,0.16666666666666666,5,5,CTGATTGGCTGCTGGTAGCC,0,1078501
fldAp,0.16666666666666666,5,5,CTGATTGCGGCTGTTGGCGG,0,1098201
fldAp,0.16666666666666666,5,5,CTGATCACGCATCTATAAGC,0,1129510
fldAp,0.16666666666666666,5,5,CTGAGTCGCGTAGTGATTGT,0,1168662
fldAp,0.16666666666666666,5,5,CTGAGCGATTACGTTGGGTA,0,1081381
fldAp,0.16666666666666666,5,5,CTGACTCTCAGTCCCGTATG,0,1140434
fldAp,0.16666666666666666,5,5,CTGACCTATATTTGTAAGGG,0,1125493
fldAp,0.16666666666666666,5,5,CTGAAAATTCCAATTCTCCT,0,1105406
fldAp,0.16666666666666666,5,5,CTGAAAAACTCTCCCAATGG,0,1169676
fldAp,0.16666666666666666,5,5,CTCTGTAACGGTAATGGCTA,0,1066322
fldAp,0.16666666666666666,5,5,CTCTGAGGGTATGTGTGACA,0,1100035
fldAp,0.16666666666666666,5,5,CTCTGACGTTGCATACAGAT,0,1079857
fldAp,0.16666666666666666,5,5,CTCTGAAGGGTTGGGCATTT,0,1109942
fldAp,0.16666666666666666,5,5,CTCTAGCCTGTTAGTGCTAT,0,1183708
fldAp,0.16666666666666666,5,5,CTCGTGGACGGGCATTATTA,0,1176610
fldAp,0.16666666666666666,5,5,CTCGGCGGACTCGGTAGCTG,0,1076906
fldAp,0.16666666666666666,5,5,CTCGGACGCAAACGGGAAGT,0,1186549
fldAp,0.16666666666666666,5,5,CTCGCCCTTCACCCATTCTA,0,1169005
fldAp,0.16666666666666666,5,5,CTCGATAGCGCGGCTGGGGA,0,1183748
fldAp,0.16666666666666666,5,5,CTCGAGGTCGCAAGTCAACA,0,1107782
fldAp,0.16666666666666666,5,5,CTCCTGTCATTTTTGTAAAA,0,1083544
fldAp,0.16666666666666666,5,5,CTCCTCCTGGTGCAGATTGC,0,1184590
fldAp,0.16666666666666666,5,5,CTCCTCCCCATATTGAACAT,0,1167072
fldAp,0.16666666666666666,5,5,CTCCGATTAATTGTAGTCGC,0,1082881
fldAp,0.16666666666666666,5,5,CTCCGATGCCGGTCATAGCA,0,1089748
fldAp,0.16666666666666666,5,5,CTCCCTCCCCACCTGAGCAG,0,1179349
fldAp,0.16666666666666666,5,5,CTCCCCCGCACCGGCAAGTC,0,1098545
fldAp,0.16666666666666666,5,5,CTCCCCCAGATGCTAGTCTC,0,1083835
fldAp,0.16666666666666666,5,5,CTCCACGTGAACAAAAATCG,0,1165026
fldAp,0.16666666666666666,5,5,CTCATTAGGCAAACGTATTC,0,1182658
fldAp,0.16666666666666666,5,5,CTCATAGACATATGAACGTT,0,1063177
fldAp,0.16666666666666666,5,5,CTCAGTTTACCTGTTAGGTA,0,1158969
fldAp,0.16666666666666666,5,5,CTCAGAAGAGCCATGCCCGG,0,1112847
fldAp,0.16666666666666666,5,5,CTCACGGAATTTGCACAGCT,0,1145975
fldAp,0.16666666666666666,5,5,CTATTCAAATAATGTGAGCG,0,1150894
fldAp,0.16666666666666666,5,5,CTATTAGACGAGAGCAATTG,0,1100857
fldAp,0.16666666666666666,5,5,CTATGCTGATCCACCGACCT,0,1082129
fldAp,0.16666666666666666,5,5,CTATGCACGGAAAAGCTTCA,0,1070892
fldAp,0.16666666666666666,5,5,CTATCGCTACCACTTGCTAT,0,1094935
fldAp,0.16666666666666666,5,5,CTATAGTAGGTAACCGGTAC,0,1186490
fldAp,0.16666666666666666,5,5,CTATACTTCTCCTGTTAGTG,0,1178991
fldAp,0.16666666666666666,5,5,CTAGTGTGCTGGGTGCTAGT,0,1130271
fldAp,0.16666666666666666,5,5,CTAGTGAGAGTTGCTAGAAG,0,1075003
fldAp,0.16666666666666666,5,5,CTAGGTTTTCTCCTCACATA,0,1174295
fldAp,0.16666666666666666,5,5,CTAGGGTGAAAATGGGGGAG,0,1122627
fldAp,0.16666666666666666,5,5,CTAGGGATTGTCTACACGGT,0,1103235
fldAp,0.16666666666666666,5,5,CTAGGCTCTTTATGACGGTT,0,1129438
fldAp,0.16666666666666666,5,5,CTAGGAGTGCCGCCAGTGAT,0,1158545
fldAp,0.16666666666666666,5,5,CTAGCGGTCGTTTCGTCAAA,0,1079629
fldAp,0.16666666666666666,5,5,CTAGCGCTTGACCGGTGGCC,0,1152638
fldAp,0.16666666666666666,5,5,CTAGCCGCCACTAATGCTCG,0,1086702
fldAp,0.16666666666666666,5,5,CTAGAAGGTGCCCCATATGG,0,1148810
fldAp,0.16666666666666666,5,5,CTACTTTAGGGCTGTGAGAG,0,1150319
fldAp,0.16666666666666666,5,5,CTACTAACGGTATGCAATCT,0,1130309
fldAp,0.16666666666666666,5,5,CTACGTCCAGGGACTGCTAT,0,1177662
fldAp,0.16666666666666666,5,5,CTACGTAACTCCAGGGATGC,0,1078928
fldAp,0.16666666666666666,5,5,CTACGGTAGCTACCTTGGCA,0,1172350
fldAp,0.16666666666666666,5,5,CTACGAGCGGGTGCCAAGGG,0,1153415
fldAp,0.16666666666666666,5,5,CTACGACTGCACATATTCAC,0,1143021
fldAp,0.16666666666666666,5,5,CTACGAAGATCGGATAATTC,0,1108661
fldAp,0.16666666666666666,5,5,CTACCGGAGCTCACACAACA,0,1132325
fldAp,0.16666666666666666,5,5,CTACCCAAATAAGGCATTTA,0,1127270
fldAp,0.16666666666666666,5,5,CTACATTTAATGACGGAGCT,0,1166893
fldAp,0.16666666666666666,5,5,CTACAAGCATAAATTACGGA,0,1077118
fldAp,0.16666666666666666,5,5,CTAATCCCCCGGGAATGTGC,0,1128019
fldAp,0.16666666666666666,5,5,CTAATAACATTCGAGAGTAA,0,1163832
fldAp,0.16666666666666666,5,5,CTAAGTTCCTCGTCAATCAG,0,1086622
fldAp,0.16666666666666666,5,5,CTAACGCAGTTGGCCACAGA,0,1089020
fldAp,0.16666666666666666,5,5,CTAAAGCTACTTGAACTCAG,0,1157264
fldAp,0.16666666666666666,5,5,CGTTTCTAGTCAAAGGTCCT,0,1144054
fldAp,0.16666666666666666,5,5,CGTTATCACCACATGCTTTG,0,1173630
fldAp,0.16666666666666666,5,5,CGTTATATGACCTAAACGTA,0,1093012
fldAp,0.16666666666666666,5,5,CGTTAGGGGGGATTGTGCAA,0,1071138
fldAp,0.16666666666666666,5,5,CGTGGTGGCAACACAGCGAT,0,1145307
fldAp,0.16666666666666666,5,5,CGTGCCCATCCCGCCGCTAA,0,1157614
fldAp,0.16666666666666666,5,5,CGTGACGAACGGCACTGTCG,0,1137859
fldAp,0.16666666666666666,5,5,CGTCTTTGGGCGGACTGTTC,0,1096805
fldAp,0.16666666666666666,5,5,CGTCTATCTTAGCACGATTA,0,1075798
fldAp,0.16666666666666666,5,5,CGTCGTAACGACCGGTCACG,0,1084639
fldAp,0.16666666666666666,5,5,CGTCGATTGGGTCCCGTTCC,0,1113629
fldAp,0.16666666666666666,5,5,CGTCCGCCTTAATGTCCTGG,0,1145739
fldAp,0.16666666666666666,5,5,CGTCAGGGGGGAGTGCGAAG,0,1183343
fldAp,0.16666666666666666,5,5,CGTCAGATTCTAGGCTAACG,0,1063769
fldAp,0.16666666666666666,5,5,CGTATTTTTCTGGAGCTGCG,0,1089150
fldAp,0.16666666666666666,5,5,CGTAGTGAGCGCCGCGGCCC,0,1100090
fldAp,0.16666666666666666,5,5,CGTAGGGGCAAATCATGCAA,0,1112480
fldAp,0.16666666666666666,5,5,CGTAGCCTCGGAGCCAAATA,0,1102331
fldAp,0.16666666666666666,5,5,CGTACGTATTACGGGAAACC,0,1107189
fldAp,0.16666666666666666,5,5,CGTACCCGCGGCTACGTTAA,0,1070074
fldAp,0.16666666666666666,5,5,CGGTTTCGTATAGCTAAACT,0,1157843
fldAp,0.16666666666666666,5,5,CGGTTTCGCAACCTGAGTTT,0,1093688
fldAp,0.16666666666666666,5,5,CGGTGTTAGTGCAACAGGTA,0,1091499
fldAp,0.16666666666666666,5,5,CGGTGTAAAACTCTCTAGAT,0,1127976
fldAp,0.16666666666666666,5,5,CGGTATAGATTCTCTTGGTA,0,1117297
fldAp,0.16666666666666666,5,5,CGGTAGATTATTCAACACAC,0,1066650
fldAp,0.16666666666666666,5,5,CGGTAAATTTTAGGCTCAGT,0,1128725
fldAp,0.16666666666666666,5,5,CGGGCCACAGAGGGAAATAA,0,1172493
fldAp,0.16666666666666666,5,5,CGGGCACGATAACTTGGGAA,0,1092317
fldAp,0.16666666666666666,5,5,CGGGAGGTCGCTGCCATCGA,0,1171994
fldAp,0.16666666666666666,5,5,CGGGACTCACCAGTTGGTTG,0,1143007
fldAp,0.16666666666666666,5,5,CGGGACTAAGTTCTAACGTG,0,1075493
fldAp,0.16666666666666666,5,5,CGGGAACGGTGTCTCAAACT,0,1101648
fldAp,0.16666666666666666,5,5,CGGCTTGTGTGGAGTAGAGG,0,1128964
fldAp,0.16666666666666666,5,5,CGGCTTGACCGCCTCGGGAA,0,1132039
fldAp,0.16666666666666666,5,5,CGGCTCAAATTTGGGACCCT,0,1092224
fldAp,0.16666666666666666,5,5,CGGCGTTGATGTCCATTAAT,0,1153125
fldAp,0.16666666666666666,5,5,CGGCGTAGAATACAGTTGAA,0,1082507
fldAp,0.16666666666666666,5,5,CGGCGACTAAGGGCAGATGC,0,1109336
fldAp,0.16666666666666666,5,5,CGGCGAACCCGATACAGCTT,0,1105653
fldAp,0.16666666666666666,5,5,CGGCCTTATGTATAGTTTCT,0,1115040
fldAp,0.16666666666666666,5,5,CGGCCTGGAGATTGGCGCAT,0,1093702
fldAp,0.16666666666666666,5,5,CGGCCGCGTACATAGGCCCC,0,1082548
fldAp,0.16666666666666666,5,5,CGGCCCCCTGGTAAACCTAA,0,1104003
fldAp,0.16666666666666666,5,5,CGGCAGCAGTCTGCTGGTAA,0,1166022
fldAp,0.16666666666666666,5,5,CGGCACGCCGCTCATCTGAG,0,1099384
fldAp,0.16666666666666666,5,5,CGGCAAGTCGCAGTCTTTTC,0,1121296
fldAp,0.16666666666666666,5,5,CGGCAACGCCTCGGTGTATG,0,1158153
fldAp,0.16666666666666666,5,5,CGGATTTGATGCACGGCCGT,0,1163808
fldAp,0.16666666666666666,5,5,CGGATTGTCCCAATAGGTAT,0,1183757
fldAp,0.16666666666666666,5,5,CGGATGTACCTCAGCGACTC,0,1075771
fldAp,0.16666666666666666,5,5,CGGATCAGTTTGGTGTCCCA,0,1093002
fldAp,0.16666666666666666,5,5,CGGATATGGGGAACAGTGCT,0,1099511
fldAp,0.16666666666666666,5,5,CGGAGGTTCAGCTGCGCCAG,0,1127128
fldAp,0.16666666666666666,5,5,CGGAGGAAGTCTGGCTGGCC,0,1155706
fldAp,0.16666666666666666,5,5,CGGAGCCCGGAGGAGATCAC,0,1066615
fldAp,0.16666666666666666,5,5,CGGAGATTTGCCGTTTACCA,0,1181387
fldAp,0.16666666666666666,5,5,CGCTTCCATTGTCTATAATG,0,1119103
fldAp,0.16666666666666666,5,5,CGCTGGTTGACCGGGACGCC,0,1156759
fldAp,0.16666666666666666,5,5,CGCTGAGCCTCTTGCGTAGC,0,1078013
fldAp,0.16666666666666666,5,5,CGCTCGTATTGGGTCGTCCA,0,1148309
fldAp,0.16666666666666666,5,5,CGCTACACTGGATGGTTCGG,0,1114373
fldAp,0.16666666666666666,5,5,CGCGTGTCTGGACAAGTCTC,0,1131945
fldAp,0.16666666666666666,5,5,CGCGGTAGTGAAGGTGGACC,0,1096894
fldAp,0.16666666666666666,5,5,CGCGCCAACAAGGTCTCTTT,0,1079863
fldAp,0.16666666666666666,5,5,CGCGCAGGCTGGTACAGCGG,0,1175032
fldAp,0.16666666666666666,5,5,CGCGATTTTCTAAAGCGGTT,0,1118422
fldAp,0.16666666666666666,5,5,CGCGATGGTGCCAACTTAGG,0,1115842
fldAp,0.16666666666666666,5,5,CGCGATATGTGATATGCTAG,0,1163842
fldAp,0.16666666666666666,5,5,CGCGAAAATGTGCTCAGATA,0,1090066
fldAp,0.16666666666666666,5,5,CGCCTGGTTTCAAGGTACAA,0,1140675
fldAp,0.16666666666666666,5,5,CGCCTGCAATATATATAGTA,0,1127528
fldAp,0.16666666666666666,5,5,CGCCTCGGGCATGGTTTATC,0,1149533
fldAp,0.16666666666666666,5,5,CGCCGGGGCTAGGGGTGTCT,0,1083144
fldAp,0.16666666666666666,5,5,CGCCCCGTTTACGGGAATTC,0,1175374
fldAp,0.16666666666666666,5,5,CGCCATGCGAATCTCTGTAT,0,1076916
fldAp,0.16666666666666666,5,5,CGCCACAGTGAGCAATATAG,0,1148916
fldAp,0.16666666666666666,5,5,CGCCAATCCACCTTAGATTA,0,1111645
fldAp,0.16666666666666666,5,5,CGCCAACCTCTAGGCTTCAG,0,1097793
fldAp,0.16666666666666666,5,5,CGCCAAAAGAAGGGACAGAA,0,1139537
fldAp,0.16666666666666666,5,5,CGCATGATCGTCTTACTTCT,0,1178439
fldAp,0.16666666666666666,5,5,CGCAGCTAACTGCTTACAAA,0,1075990
fldAp,0.16666666666666666,5,5,CGCAGCGATTCTGGCTCGGC,0,1146222
fldAp,0.16666666666666666,5,5,CGCACATCCGTCGGCCGCGT,0,1114785
fldAp,0.16666666666666666,5,5,CGCAATCCTTGGGAAGGCGA,0,1073043
fldAp,0.16666666666666666,5,5,CGCAAGGGAGTATTGTTTCC,0,1086239
fldAp,0.16666666666666666,5,5,CGCAACCGGAGATCCTTGGA,0,1127586
fldAp,0.16666666666666666,5,5,CGATTAGTGCACTAGCAGTA,0,1122661
fldAp,0.16666666666666666,5,5,CGATGGTCCGCAAAAAGTTG,0,1083554
fldAp,0.16666666666666666,5,5,CGATCTAACGATTGCTCGCG,0,1124665
fldAp,0.16666666666666666,5,5,CGATCGGTTCCTTTTCATGC,0,1108289
fldAp,0.16666666666666666,5,5,CGATCCCTAAGCTCTGTAAG,0,1109929
fldAp,0.16666666666666666,5,5,CGATCCCCCAGCCAGACTTT,0,1109528
fldAp,0.16666666666666666,5,5,CGATATTTGTCCAAGTGGGT,0,1103164
fldAp,0.16666666666666666,5,5,CGATACCTCTCGCGTTGCAG,0,1174409
fldAp,0.16666666666666666,5,5,CGATAATGGCGAAAGCTTTT,0,1086710
fldAp,0.16666666666666666,5,5,CGATAATCTGTTCGTCGCCC,0,1184473
fldAp,0.16666666666666666,5,5,CGAGTAGCCTGGCGACGTAT,0,1091454
fldAp,0.16666666666666666,5,5,CGAGCTAGCATATAAGACAT,0,1180866
fldAp,0.16666666666666666,5,5,CGAGATCCATCAACTAATCA,0,1176130
fldAp,0.16666666666666666,5,5,CGAGAAGCTGGGATGATGTA,0,1136577
fldAp,0.16666666666666666,5,5,CGACTTGAACCACGCGCTGG,0,1070129
fldAp,0.16666666666666666,5,5,CGACTCTGCTAACCTGAGCG,0,1185683
fldAp,0.16666666666666666,5,5,CGACATTTGGCAGCAAGAGA,0,1169861
fldAp,0.16666666666666666,5,5,CGACAGATTTATCATTGGGG,0,1090329
fldAp,0.16666666666666666,5,5,CGAATGGCAAGAAGCTGACG,0,1121303
fldAp,0.16666666666666666,5,5,CGAATAGTGGGCAGCGAATC,0,1063421
fldAp,0.16666666666666666,5,5,CGAAGTCGAGTCGAGCCTGA,0,1165771
fldAp,0.16666666666666666,5,5,CGAACGGTGCGTAACTCCTT,0,1182762
fldAp,0.16666666666666666,5,5,CGAACCTTTTACTAAAATTA,0,1162402
fldAp,0.16666666666666666,5,5,CGAAATGCGACTTTGCTGCG,0,1119963
fldAp,0.16666666666666666,5,5,CGAAAGAACTTGGGCCTAGT,0,1145774
fldAp,0.16666666666666666,5,5,CGAAACTCTCGCGGGTTATC,0,1173401
fldAp,0.16666666666666666,5,5,CCTTTAGTCACACTCGAGCA,0,1142401
fldAp,0.16666666666666666,5,5,CCTTTAATGTCGTCAGTGAT,0,1153217
fldAp,0.16666666666666666,5,5,CCTTGGATAATAGTCTCAAG,0,1162538
fldAp,0.16666666666666666,5,5,CCTTGAGGCCATATAATTTT,0,1119055
fldAp,0.16666666666666666,5,5,CCTTCTGGGGACCCAGCGTT,0,1087781
fldAp,0.16666666666666666,5,5,CCTTATGGCGCGCGACACGC,0,1102074
fldAp,0.16666666666666666,5,5,CCTGTGGTTAATCAACGTCC,0,1126650
fldAp,0.16666666666666666,5,5,CCTGCTTCCGGGTTATCTCT,0,1178351
fldAp,0.16666666666666666,5,5,CCTGAGGAGTATTACGATTG,0,1067366
fldAp,0.16666666666666666,5,5,CCTGAGATTAGTGGGATGGG,0,1074772
fldAp,0.16666666666666666,5,5,CCTGACTGTGTGAAACTGGG,0,1138541
fldAp,0.16666666666666666,5,5,CCTGACCAGTCCTGGAAACC,0,1105776
fldAp,0.16666666666666666,5,5,CCTGAAGACTATCACGCATT,0,1138683
fldAp,0.16666666666666666,5,5,CCTGAAATTCAACTTCGATC,0,1073715
fldAp,0.16666666666666666,5,5,CCTCTGTGACGTTACCAGTG,0,1184400
fldAp,0.16666666666666666,5,5,CCTCTGGTCCAGAGATGCGT,0,1094451
fldAp,0.16666666666666666,5,5,CCTCTAGTGATGGAGGCCAT,0,1167522
fldAp,0.16666666666666666,5,5,CCTCTAGTCTGTAGCAAACT,0,1185384
fldAp,0.16666666666666666,5,5,CCTCTAGATAGGTTAAACAC,0,1123992
fldAp,0.16666666666666666,5,5,CCTCGTACACTCTTCGCTCA,0,1168275
fldAp,0.16666666666666666,5,5,CCTCCGTAATGGCGAGTCTT,0,1186163
fldAp,0.16666666666666666,5,5,CCTCCGCGGTCAAGAACCAA,0,1122669
fldAp,0.16666666666666666,5,5,CCTATTTTAGTATTTCGGTG,0,1090067
fldAp,0.16666666666666666,5,5,CCTAGGGCTGACCCTTCCGA,0,1121406
fldAp,0.16666666666666666,5,5,CCTAGAAGTTCGACCGAAGA,0,1180429
fldAp,0.16666666666666666,5,5,CCTACGTTATCCACTTCCAG,0,1153781
fldAp,0.16666666666666666,5,5,CCTACGGTGAAGCCCGGATA,0,1158130
fldAp,0.16666666666666666,5,5,CCTACATGGCGGGTCAAGCT,0,1082962
fldAp,0.16666666666666666,5,5,CCGTTTCTTACAAGTCACCC,0,1143810
fldAp,0.16666666666666666,5,5,CCGTTCTTTTACAACCCTAC,0,1182521
fldAp,0.16666666666666666,5,5,CCGTGTAATGCCATATCGCA,0,1181733
fldAp,0.16666666666666666,5,5,CCGTGAGCGAAACAATTGTC,0,1124716
fldAp,0.16666666666666666,5,5,CCGTCTCGTACTAAGGGCCA,0,1093490
fldAp,0.16666666666666666,5,5,CCGTCTATAATGTCCAAGTA,0,1072050
fldAp,0.16666666666666666,5,5,CCGTCCACAACCCCGGCGTC,0,1138931
fldAp,0.16666666666666666,5,5,CCGTACTCTCAATGACGAGA,0,1162990
fldAp,0.16666666666666666,5,5,CCGTAAGGGTCAGTACCGAG,0,1125497
fldAp,0.16666666666666666,5,5,CCGGTTTCGTCTGGTGCACT,0,1145369
fldAp,0.16666666666666666,5,5,CCGGTAAATGACCAATAGGT,0,1158976
fldAp,0.16666666666666666,5,5,CCGGGATTGGCCCCACAGTG,0,1180510
fldAp,0.16666666666666666,5,5,CCGGCCAGATACTAAGTTGT,0,1141836
fldAp,0.16666666666666666,5,5,CCGGCAGGGTACCTTCCGCT,0,1133364
fldAp,0.16666666666666666,5,5,CCGGCACCTGGATACTTCTA,0,1110695
fldAp,0.16666666666666666,5,5,CCGGATTCGTAGCGCTAGGG,0,1066874
fldAp,0.16666666666666666,5,5,CCGGAGTTATAAGTCTCTAG,0,1162632
fldAp,0.16666666666666666,5,5,CCGGAGGGTCATATCGGCTA,0,1064211
fldAp,0.16666666666666666,5,5,CCGGACCTGGTTGTACCCTC,0,1162936
fldAp,0.16666666666666666,5,5,CCGCTTTACGTGAGAGTCAA,0,1071338
fldAp,0.16666666666666666,5,5,CCGCTAGTTAAAATCATAAG,0,1164784
fldAp,0.16666666666666666,5,5,CCGCTAGCAATCTTTGCATG,0,1107933
fldAp,0.16666666666666666,5,5,CCGCCCAGTCTCATAGGACT,0,1130984
fldAp,0.16666666666666666,5,5,CCGCCACATGGGGATTATGA,0,1127651
fldAp,0.16666666666666666,5,5,CCGCAGATTCTATTTGCACT,0,1179823
fldAp,0.16666666666666666,5,5,CCGCAGAACATATTGTCATG,0,1111214
fldAp,0.16666666666666666,5,5,CCGATCAGGGGGCACGCCAC,0,1176348
fldAp,0.16666666666666666,5,5,CCGAGGACGGTCGGTCTTCG,0,1100936
fldAp,0.16666666666666666,5,5,CCGAGACGGAGGGAAAGTAT,0,1139352
fldAp,0.16666666666666666,5,5,CCGAAGGGTTTCAAGTCCGG,0,1163906
fldAp,0.16666666666666666,5,5,CCGAACGATCTATTGCTCAT,0,1175238
fldAp,0.16666666666666666,5,5,CCGAAAGTATCACCAAAACT,0,1084833
fldAp,0.16666666666666666,5,5,CCCTTGGTTTACCTCCCTAG,0,1177133
fldAp,0.16666666666666666,5,5,CCCTTAACCTAGAGTAAGTG,0,1167393
fldAp,0.16666666666666666,5,5,CCCTGCTCAGCTTTATTGGA,0,1084618
fldAp,0.16666666666666666,5,5,CCCTGAGCATGTGAAACTAC,0,1117967
fldAp,0.16666666666666666,5,5,CCCTGACCAAGCGGGCGCAT,0,1184621
fldAp,0.16666666666666666,5,5,CCCTCTATTCCTCCCTACTC,0,1102621
fldAp,0.16666666666666666,5,5,CCCTCGTCACGGCTGCTGTT,0,1148321
fldAp,0.16666666666666666,5,5,CCCTCCGAAGCTACGCGTTA,0,1182734
fldAp,0.16666666666666666,5,5,CCCGTGTGATCCCAACGGCA,0,1162436
fldAp,0.16666666666666666,5,5,CCCGTCGCCCCCATGTCATG,0,1090454
fldAp,0.16666666666666666,5,5,CCCGTCATGCTTCAGCTTGC,0,1087962
fldAp,0.16666666666666666,5,5,CCCGTACCCGTGTTCAGAAA,0,1152322
fldAp,0.16666666666666666,5,5,CCCGGGAGTGTAGGACGGGT,0,1112636
fldAp,0.16666666666666666,5,5,CCCGGCCCCCGTGGAATGAG,0,1163767
fldAp,0.16666666666666666,5,5,CCCGGATCAAGGCGGTAATA,0,1182500
fldAp,0.16666666666666666,5,5,CCCGCTTAAAGGCAATGATT,0,1111027
fldAp,0.16666666666666666,5,5,CCCGCTAGATGCGGGTGTAT,0,1079032
fldAp,0.16666666666666666,5,5,CCCCTTGGAACGGTCTTTCT,0,1098516
fldAp,0.16666666666666666,5,5,CCCCTTGAACTGTTTCGGCT,0,1179363
fldAp,0.16666666666666666,5,5,CCCCTGTGAAACTCCCGCTC,0,1086804
fldAp,0.16666666666666666,5,5,CCCCTCTTCACAGTTCAAGG,0,1149470
fldAp,0.16666666666666666,5,5,CCCCGCGAGCCAACCGAAGT,0,1182739
fldAp,0.16666666666666666,5,5,CCCCCTCCGCGTTCGGCAAT,0,1168099
fldAp,0.16666666666666666,5,5,CCCCCGCCGGTTCGCACGGG,0,1102941
fldAp,0.16666666666666666,5,5,CCCCAGGATTTTAGAAAGGT,0,1146758
fldAp,0.16666666666666666,5,5,CCCAGTTCTCTTGCGAGAGC,0,1090567
fldAp,0.16666666666666666,5,5,CCCAGGATGGATAAAACGTA,0,1147273
fldAp,0.16666666666666666,5,5,CCCAGCCGTAAGCAGGACCC,0,1170107
fldAp,0.16666666666666666,5,5,CCCAAGCCCGAGAGAGTCAC,0,1161495
fldAp,0.16666666666666666,5,5,CCATTTCGGTCCTTTCATCT,0,1075972
fldAp,0.16666666666666666,5,5,CCATTTCGACTAATGTGTAA,0,1154510
fldAp,0.16666666666666666,5,5,CCATTCACAATAGAAACATC,0,1111738
fldAp,0.16666666666666666,5,5,CCATTACAAATGGGTCAGAC,0,1076762
fldAp,0.16666666666666666,5,5,CCATTAACGTACTTCCATGC,0,1131894
fldAp,0.16666666666666666,5,5,CCATGCGGCTTAAGCTCTCA,0,1128773
fldAp,0.16666666666666666,5,5,CCATGATCGGTGAGGGAGCA,0,1086998
fldAp,0.16666666666666666,5,5,CCATCTTCTACCTACACAGT,0,1158951
fldAp,0.16666666666666666,5,5,CCATCGCTGGAATTCTCGCC,0,1066758
fldAp,0.16666666666666666,5,5,CCATATCACCCGGAATTCAT,0,1113958
fldAp,0.16666666666666666,5,5,CCAGTCTACGCCGGTATATA,0,1167523
fldAp,0.16666666666666666,5,5,CCAGTAGGTGGTGGCTGCTA,0,1083618
fldAp,0.16666666666666666,5,5,CCAGGTTACTGTATAGGTAC,0,1160283
fldAp,0.16666666666666666,5,5,CCAGGATAAAGCTGCTTTGC,0,1099213
fldAp,0.16666666666666666,5,5,CCAGGACGCGGTCCCAGCCA,0,1136960
fldAp,0.16666666666666666,5,5,CCAGATTGATTGGTATCTAT,0,1121328
fldAp,0.16666666666666666,5,5,CCAGATCAATGAACAGTCAG,0,1122597
fldAp,0.16666666666666666,5,5,CCAGACGCGGTGTTCCCCAA,0,1068974
fldAp,0.16666666666666666,5,5,CCAGAATGGCCCTTGCACGG,0,1079678
fldAp,0.16666666666666666,5,5,CCACTTACGCTGCGACTTTG,0,1113212
fldAp,0.16666666666666666,5,5,CCACCGGCGGTAGTTCCTTC,0,1086529
fldAp,0.16666666666666666,5,5,CCACCCTACTAAATGTGCGA,0,1180852
fldAp,0.16666666666666666,5,5,CCACATGTCGTCAAGTCCGA,0,1151886
fldAp,0.16666666666666666,5,5,CCACACCATGTCTTGTGTGT,0,1154863
fldAp,0.16666666666666666,5,5,CCACAAACCGTGCAGCGGAA,0,1173472
fldAp,0.16666666666666666,5,5,CCAATTCTTATGGCCAGCTA,0,1064706
fldAp,0.16666666666666666,5,5,CCAATATGCCGCGATAAGAT,0,1122366
fldAp,0.16666666666666666,5,5,CCAAGTTTGCACCGAAACTG,0,1156636
fldAp,0.16666666666666666,5,5,CCAAGTGAATGTTAGTCGCG,0,1126982
fldAp,0.16666666666666666,5,5,CCAACGTGCCGGGGCGAAAC,0,1147336
fldAp,0.16666666666666666,5,5,CCAAAAGGCCGCTCACACCC,0,1063862
fldAp,0.16666666666666666,5,5,CATTTGGATGCGGGCGCGTG,0,1178321
fldAp,0.16666666666666666,5,5,CATTTCTCTTAAGTAGCAAT,0,1158528
fldAp,0.16666666666666666,5,5,CATTTATGTAAGGGGCCGTC,0,1149873
fldAp,0.16666666666666666,5,5,CATTTAGACGGATGTTACTG,0,1149805
fldAp,0.16666666666666666,5,5,CATGTAGACGACGACGATTT,0,1176232
fldAp,0.16666666666666666,5,5,CATGGTTTCAAACCGCCCCA,0,1122453
fldAp,0.16666666666666666,5,5,CATGGGACAATATGGTTTGT,0,1112288
fldAp,0.16666666666666666,5,5,CATGCTGTTGCCGGATAGCG,0,1088411
fldAp,0.16666666666666666,5,5,CATGCTACGGATGACCGCTC,0,1083421
fldAp,0.16666666666666666,5,5,CATGCGACGTAAGATCCCAG,0,1093786
fldAp,0.16666666666666666,5,5,CATGATCTTTCCCAACGGAC,0,1174528
fldAp,0.16666666666666666,5,5,CATGAGACAAACAGTATGGT,0,1123407
fldAp,0.16666666666666666,5,5,CATCTTGCTTTCCTGGCCAC,0,1135746
fldAp,0.16666666666666666,5,5,CATCTTCCAGTAGCGCCCTT,0,1084533
fldAp,0.16666666666666666,5,5,CATCGTCTTCATGATCATTC,0,1075162
fldAp,0.16666666666666666,5,5,CATCGGGCACGTTCTCAATA,0,1176854
fldAp,0.16666666666666666,5,5,CATCCTACCGGGTCCCGACT,0,1182396
fldAp,0.16666666666666666,5,5,CATCCGTACTAAGTGCACTT,0,1129297
fldAp,0.16666666666666666,5,5,CATCATAAGGTCGTTTCCAA,0,1132873
fldAp,0.16666666666666666,5,5,CATCAGCTTGGCTCTCTATT,0,1102999
fldAp,0.16666666666666666,5,5,CATATGGATGTCAAACACAC,0,1078486
fldAp,0.16666666666666666,5,5,CATAGGCTAGTAAACCTAGG,0,1065638
fldAp,0.16666666666666666,5,5,CATAGGCAGTCCTTTCAGTT,0,1105275
fldAp,0.16666666666666666,5,5,CATAGCCTAGAATAATTCAT,0,1119784
fldAp,0.16666666666666666,5,5,CATAGATGAGGAGTCTCGCA,0,1154743
fldAp,0.16666666666666666,5,5,CATACGCACGACTCCGCCCC,0,1183861
fldAp,0.16666666666666666,5,5,CATACAGGCGCCATGGCAAA,0,1131420
fldAp,0.16666666666666666,5,5,CAGTTCGTCATTGGACTCAC,0,1106132
fldAp,0.16666666666666666,5,5,CAGTTCGAATGGAGGACTCC,0,1063439
fldAp,0.16666666666666666,5,5,CAGTTATATTTATATTAGCT,0,1154956
fldAp,0.16666666666666666,5,5,CAGTTAGGCAGTGTGTCCCT,0,1162935
fldAp,0.16666666666666666,5,5,CAGTTACTCGGTAAAAAGGG,0,1133939
fldAp,0.16666666666666666,5,5,CAGTGTTTCGAGGGAGGCGA,0,1136330
fldAp,0.16666666666666666,5,5,CAGTGTATGAAGACTGGTCT,0,1079008
fldAp,0.16666666666666666,5,5,CAGTGGTTGGGTGCGAAAAG,0,1166004
fldAp,0.16666666666666666,5,5,CAGTGGACACGTCATCTTGT,0,1146546
fldAp,0.16666666666666666,5,5,CAGTCTGTATTACACGAAAG,0,1155228
fldAp,0.16666666666666666,5,5,CAGTCTGTATCCGGCGGGGA,0,1098882
fldAp,0.16666666666666666,5,5,CAGTCTCCACAACCGTGCCT,0,1124179
fldAp,0.16666666666666666,5,5,CAGTCCGAGCTCTAAACGGA,0,1139349
fldAp,0.16666666666666666,5,5,CAGTAAACGGACGCGGTCAC,0,1117373
fldAp,0.16666666666666666,5,5,CAGGTTTAGTCTCTGCAAGC,0,1130260
fldAp,0.16666666666666666,5,5,CAGGTTGTCCTATATCGTTG,0,1125174
fldAp,0.16666666666666666,5,5,CAGGTTCGCCTCGATTGGTT,0,1139974
fldAp,0.16666666666666666,5,5,CAGGGCGCTGACAGTTCGAC,0,1132017
fldAp,0.16666666666666666,5,5,CAGGCTCCCAGCTCAGGATG,0,1155283
fldAp,0.16666666666666666,5,5,CAGGCCACCCCTACGAGACC,0,1128831
fldAp,0.16666666666666666,5,5,CAGGAGTCCTAACGGGAGAT,0,1077766
fldAp,0.16666666666666666,5,5,CAGGACATTCATGCACTAGC,0,1168051
fldAp,0.16666666666666666,5,5,CAGCCGTACTTACATAGAGC,0,1128485
fldAp,0.16666666666666666,5,5,CAGCATACTTTAGCTATTTT,0,1066398
fldAp,0.16666666666666666,5,5,CAGCATACGACGTGGTGTCA,0,1121904
fldAp,0.16666666666666666,5,5,CAGATACTAAATGCCATACA,0,1071378
fldAp,0.16666666666666666,5,5,CAGACGGTGGAATGTAGATT,0,1182123
fldAp,0.16666666666666666,5,5,CAGAACTACTTCAGTATAGT,0,1100507
fldAp,0.16666666666666666,5,5,CACTTATTACCGAGTGGTAT,0,1088955
fldAp,0.16666666666666666,5,5,CACTGGAACTTAATAGCGCC,0,1121757
fldAp,0.16666666666666666,5,5,CACTGATATCCCTGCCACTT,0,1176361
fldAp,0.16666666666666666,5,5,CACTCTCAGAATATGTACAG,0,1164243
fldAp,0.16666666666666666,5,5,CACTAAGGCCCAGACATCAC,0,1177870
fldAp,0.16666666666666666,5,5,CACGTGTGGCAGAGTATGCA,0,1076760
fldAp,0.16666666666666666,5,5,CACGTAGAGCTCTGACACTG,0,1106809
fldAp,0.16666666666666666,5,5,CACGCGGGAAAGTTGCCTCG,0,1176214
fldAp,0.16666666666666666,5,5,CACGATTGAGCGTATTAGGG,0,1171228
fldAp,0.16666666666666666,5,5,CACGACGTAAGCCTGCGGGC,0,1136836
fldAp,0.16666666666666666,5,5,CACCTATTGATTAACTTCTA,0,1092998
fldAp,0.16666666666666666,5,5,CACCTACGAGCCTAGGGGCA,0,1157535
fldAp,0.16666666666666666,5,5,CACCGTCCGGGTCGCCTCAC,0,1104970
fldAp,0.16666666666666666,5,5,CACCGTCCCAGTAGCAGGAA,0,1082425
fldAp,0.16666666666666666,5,5,CACCGTAGGAATGTCGCCAT,0,1150219
fldAp,0.16666666666666666,5,5,CACCGTAACCGGATTAGGAG,0,1106358
fldAp,0.16666666666666666,5,5,CACCCGATTGCCCAATTGAA,0,1142908
fldAp,0.16666666666666666,5,5,CACCCCTCTTAAATCAGTCC,0,1166272
fldAp,0.16666666666666666,5,5,CACCCCAGTGAGGCTAGATC,0,1123970
fldAp,0.16666666666666666,5,5,CACCAGCGCCATAATTTGAT,0,1079235
fldAp,0.16666666666666666,5,5,CACCAGCGAATCGCCCCTCT,0,1119691
fldAp,0.16666666666666666,5,5,CACATGGCACTCACAGATGA,0,1182448
fldAp,0.16666666666666666,5,5,CACATGGAGATCGCAGAGGG,0,1081555
fldAp,0.16666666666666666,5,5,CACATCAGTGAGCAATGGCA,0,1147037
fldAp,0.16666666666666666,5,5,CACACATCCCCCGTTTCTAT,0,1123725
fldAp,0.16666666666666666,5,5,CACAAATACTAGAAAATGCC,0,1120001
fldAp,0.16666666666666666,5,5,CAATTTGGCGTCTCTAAGTC,0,1150540
fldAp,0.16666666666666666,5,5,CAATTTCCCAGATGACGACA,0,1178480
fldAp,0.16666666666666666,5,5,CAATTGGACTACGCTTCGAC,0,1117035
fldAp,0.16666666666666666,5,5,CAATTCTGGAGGACTTCTTG,0,1145118
fldAp,0.16666666666666666,5,5,CAATTAAAGCTAAAGCATCT,0,1080179
fldAp,0.16666666666666666,5,5,CAATATTTGACTATACAGAG,0,1109652
fldAp,0.16666666666666666,5,5,CAATACTTGGCACGAAACGG,0,1158590
fldAp,0.16666666666666666,5,5,CAATACCCTTACCCCGCTTG,0,1097071
fldAp,0.16666666666666666,5,5,CAAGTGTCCATGCAGGTCTT,0,1123079
fldAp,0.16666666666666666,5,5,CAAGTGCCGCTACAGAAATC,0,1167383
fldAp,0.16666666666666666,5,5,CAAGTGACATATGTATAGAC,0,1077076
fldAp,0.16666666666666666,5,5,CAAGTCGGTCATGGTGTATA,0,1083401
fldAp,0.16666666666666666,5,5,CAAGGAAAAGCATTCGCATT,0,1079526
fldAp,0.16666666666666666,5,5,CAAGCGACTAGCCTGCACGG,0,1087473
fldAp,0.16666666666666666,5,5,CAAGCACCTGCGTTGGTCGC,0,1094836
fldAp,0.16666666666666666,5,5,CAACGGGTGGGTTAGTGGCA,0,1066630
fldAp,0.16666666666666666,5,5,CAACGCGTGAAGAATCAGCT,0,1086155
fldAp,0.16666666666666666,5,5,CAACGATATTACTCCTGTGG,0,1118233
fldAp,0.16666666666666666,5,5,CAACCTGATCGCTCCTTTAT,0,1077657
fldAp,0.16666666666666666,5,5,CAACATGACCGGTTCAGCAC,0,1094603
fldAp,0.16666666666666666,5,5,CAACAGTCATTTTTTTCGAT,0,1105598
fldAp,0.16666666666666666,5,5,CAACACGCAACCCATAACAT,0,1075259
fldAp,0.16666666666666666,5,5,CAAATCGAAATCCTTGACAT,0,1093731
fldAp,0.16666666666666666,5,5,CAAATCCCCCGTGGGGAATA,0,1085561
fldAp,0.16666666666666666,5,5,CAAAGTGTTCCAACTGGTGT,0,1117657
fldAp,0.16666666666666666,5,5,CAAAGAGACCCGCGGTAGAC,0,1176302
fldAp,0.16666666666666666,5,5,CAAACTCGACACCTACAAGG,0,1072874
fldAp,0.16666666666666666,5,5,CAAACGGTATGGTCAGAGAG,0,1082808
fldAp,0.16666666666666666,5,5,CAAAAGGGGCCGACACCTTT,0,1108160
fldAp,0.16666666666666666,5,5,CAAAACAGGAAGTCCCCCGG,0,1159981
fldAp,0.16666666666666666,5,5,CAAAAAGTTCTCGAGGACCG,0,1155272
fldAp,0.16666666666666666,5,5,CAAAAAACTACGTATTTGAA,0,1123059
fldAp,0.16666666666666666,5,5,ATTTGTGTCGAGTGCAGCTT,0,1070642
fldAp,0.16666666666666666,5,5,ATTTCGGCGCAGACCAATGA,0,1136920
fldAp,0.16666666666666666,5,5,ATTTATAGGCCTGTATGTTT,0,1131554
fldAp,0.16666666666666666,5,5,ATTTATAGCTTCAACGAGTG,0,1124591
fldAp,0.16666666666666666,5,5,ATTTAGCGTCGATATCGAGT,0,1133841
fldAp,0.16666666666666666,5,5,ATTTAGCAGTGGCGCACACT,0,1131220
fldAp,0.16666666666666666,5,5,ATTTACCGATGTGTATCTGC,0,1145886
fldAp,0.16666666666666666,5,5,ATTGTTGGTCACTTTAATGC,0,1131971
fldAp,0.16666666666666666,5,5,ATTGTGACGGGTGAATCGTT,0,1149566
fldAp,0.16666666666666666,5,5,ATTGTCGCAGCTAATCTTGA,0,1124980
fldAp,0.16666666666666666,5,5,ATTGTCAATCGGGATCTCTT,0,1112073
fldAp,0.16666666666666666,5,5,ATTGTAGATTCGTGTCAAGG,0,1133001
fldAp,0.16666666666666666,5,5,ATTGGTTTAAAGGTTCACGC,0,1099932
fldAp,0.16666666666666666,5,5,ATTGGACCGTCGCGGCGTGG,0,1183174
fldAp,0.16666666666666666,5,5,ATTGCGGTCGGCACAATGAC,0,1067540
fldAp,0.16666666666666666,5,5,ATTGCAGAACTCCTACAATG,0,1132972
fldAp,0.16666666666666666,5,5,ATTGATGTTGCGTGTGTACG,0,1097579
fldAp,0.16666666666666666,5,5,ATTGAGAAACGGGGCAAATA,0,1181166
fldAp,0.16666666666666666,5,5,ATTGACCGCTGTTAATAAGA,0,1070596
fldAp,0.16666666666666666,5,5,ATTGAATACATCACTGTGGA,0,1124592
fldAp,0.16666666666666666,5,5,ATTGAAACGAATGGTTCTGG,0,1159751
fldAp,0.16666666666666666,5,5,ATTCTTGGCTATCGTATAAT,0,1110698
fldAp,0.16666666666666666,5,5,ATTCTGAAAGGTACCAACGA,0,1133193
fldAp,0.16666666666666666,5,5,ATTCGTTGATTCAGAGTAAA,0,1155284
fldAp,0.16666666666666666,5,5,ATTCGGAGTGTGCTTAGCGT,0,1095476
fldAp,0.16666666666666666,5,5,ATTCGCATTACCACATATTC,0,1127422
fldAp,0.16666666666666666,5,5,ATTCACTGTCAGGAGGCAGT,0,1110587
fldAp,0.16666666666666666,5,5,ATTCACACCCGCCATTGTAT,0,1167911
fldAp,0.16666666666666666,5,5,ATTATGAGGGTTCAGGATAC,0,1106783
fldAp,0.16666666666666666,5,5,ATTATAGCCCCAGAATATGT,0,1088372
fldAp,0.16666666666666666,5,5,ATTACGTATAGCGTGAAGAT,0,1066369
fldAp,0.16666666666666666,5,5,ATTACAGAGGTAGTCTCCTG,0,1152225
fldAp,0.16666666666666666,5,5,ATTAATGCGGCACCTCACCG,0,1170261
fldAp,0.16666666666666666,5,5,ATTAAGAGAGCTTCTTTGTG,0,1168921
fldAp,0.16666666666666666,5,5,ATGTTTTACAATTAGAGTAA,0,1177865
fldAp,0.16666666666666666,5,5,ATGTTCGAGTTAACCGGCCC,0,1125626
fldAp,0.16666666666666666,5,5,ATGTTACATATTAAATTGGA,0,1100571
fldAp,0.16666666666666666,5,5,ATGTGTCATGTACGCTGTAT,0,1081860
fldAp,0.16666666666666666,5,5,ATGTGTAACATGCGATTATG,0,1092223
fldAp,0.16666666666666666,5,5,ATGTGCGGGGTCGCACTTAA,0,1141262
fldAp,0.16666666666666666,5,5,ATGTGCCCTCACGTGACTCT,0,1077258
fldAp,0.16666666666666666,5,5,ATGTAGGTCGGACCAGTCTA,0,1184308
fldAp,0.16666666666666666,5,5,ATGTAGATATAAGCTGGGCG,0,1074975
fldAp,0.16666666666666666,5,5,ATGTAAATGGGTAACCGTAC,0,1092737
fldAp,0.16666666666666666,5,5,ATGGTTAGGAGAGGTAATAA,0,1181201
fldAp,0.16666666666666666,5,5,ATGGGATTTTCGCCGCTACC,0,1165660
fldAp,0.16666666666666666,5,5,ATGGGATGGGCCAAGTAAAA,0,1183079
fldAp,0.16666666666666666,5,5,ATGGCTGGGCTTATCATACG,0,1170912
fldAp,0.16666666666666666,5,5,ATGGCGGCGTAGTATGATCG,0,1070261
fldAp,0.16666666666666666,5,5,ATGGCCGTTGTGAAACACCC,0,1125616
fldAp,0.16666666666666666,5,5,ATGGCAGGAATACAGTGACA,0,1074295
fldAp,0.16666666666666666,5,5,ATGGCACGTTTCTTGGATAG,0,1155104
fldAp,0.16666666666666666,5,5,ATGGCAAGTAAATCGACGAA,0,1155941
fldAp,0.16666666666666666,5,5,ATGGACGGCACGTTTGATAT,0,1076242
fldAp,0.16666666666666666,5,5,ATGCTTGATCCAGGGTGGCG,0,1182439
fldAp,0.16666666666666666,5,5,ATGCTGGCATCAGTTACCTC,0,1129866
fldAp,0.16666666666666666,5,5,ATGCGGTCTTAGCCACTAAA,0,1121589
fldAp,0.16666666666666666,5,5,ATGCGGAGCCTAGATGGCAG,0,1130092
fldAp,0.16666666666666666,5,5,ATGCCGCAGACAAGATGTGT,0,1112935
fldAp,0.16666666666666666,5,5,ATGATCAAAAGACTCGTCAG,0,1176188
fldAp,0.16666666666666666,5,5,ATGAGTGGTCTGCTCGAACA,0,1167483
fldAp,0.16666666666666666,5,5,ATGAGAGGGCGAGTTGGAGT,0,1149444
fldAp,0.16666666666666666,5,5,ATGAGAACAATTGTTGCATG,0,1166384
fldAp,0.16666666666666666,5,5,ATGACTCAGCGCACTCAACA,0,1139905
fldAp,0.16666666666666666,5,5,ATGACCGCGTTAGACTTCCT,0,1136060
fldAp,0.16666666666666666,5,5,ATGAACAGCAAGACAAGCTG,0,1130617
fldAp,0.16666666666666666,5,5,ATCTGTTGCACGTGAGAAGA,0,1126110
fldAp,0.16666666666666666,5,5,ATCTGCGTGAGCTAGGGTGG,0,1175648
fldAp,0.16666666666666666,5,5,ATCTGATCACACTCCTGTCC,0,1174429
fldAp,0.16666666666666666,5,5,ATCTACTGTGGCGGTCTTGT,0,1123113
fldAp,0.16666666666666666,5,5,ATCTAATCTGGTGTATAGGG,0,1182234
fldAp,0.16666666666666666,5,5,ATCGGTACGGTCGCCACGTT,0,1157782
fldAp,0.16666666666666666,5,5,ATCGGGGCTAGCTGAAAAAA,0,1067912
fldAp,0.16666666666666666,5,5,ATCGGCGCCCGGATCGTTCA,0,1090054
fldAp,0.16666666666666666,5,5,ATCGGAGTAAGAGTTTATAT,0,1088933
fldAp,0.16666666666666666,5,5,ATCGCATGATTCCAAGATTG,0,1083397
fldAp,0.16666666666666666,5,5,ATCGCAGTCAAGTTCCTCGA,0,1126444
fldAp,0.16666666666666666,5,5,ATCGATTTTTCCTTTACGTT,0,1117303
fldAp,0.16666666666666666,5,5,ATCGATGGAATTGAATCGAA,0,1116301
fldAp,0.16666666666666666,5,5,ATCGACAATTTACATAGGAT,0,1070859
fldAp,0.16666666666666666,5,5,ATCCTACTCTATAAACCCGC,0,1142866
fldAp,0.16666666666666666,5,5,ATCCGAGTCTAGAAATGATG,0,1141924
fldAp,0.16666666666666666,5,5,ATCCACCCAGGAGTCAAATA,0,1175342
fldAp,0.16666666666666666,5,5,ATCATGGGGCCAGATGGGTT,0,1103350
fldAp,0.16666666666666666,5,5,ATCATGATATTACCCTCGCT,0,1142957
fldAp,0.16666666666666666,5,5,ATCAGTTTACTCCTCGGCTA,0,1104490
fldAp,0.16666666666666666,5,5,ATCACTTCTTAAAGAAGGTA,0,1096147
fldAp,0.16666666666666666,5,5,ATCACTATATGTGCGATGGT,0,1064921
fldAp,0.16666666666666666,5,5,ATCACCAGGTTTGTTTTTCG,0,1100355
fldAp,0.16666666666666666,5,5,ATCAAGGAAACGAGCTTCTC,0,1088640
fldAp,0.16666666666666666,5,5,ATCAACTCGGCGCAGAATTT,0,1090984
fldAp,0.16666666666666666,5,5,ATCAACGCAGAATTCGACGG,0,1161072
fldAp,0.16666666666666666,5,5,ATCAACCGCCCTCGCTATCA,0,1173770
fldAp,0.16666666666666666,5,5,ATATGCGTTGCGCAGACAGT,0,1161379
fldAp,0.16666666666666666,5,5,ATATGCCGAGAATCAAGGGA,0,1168060
fldAp,0.16666666666666666,5,5,ATATCATGCATTTAACCAAT,0,1160789
fldAp,0.16666666666666666,5,5,ATATATTCCAGACATCGACG,0,1081450
fldAp,0.16666666666666666,5,5,ATATACAGTCCCTTTTCTCG,0,1165236
fldAp,0.16666666666666666,5,5,ATATAATCCATGGCCGATTC,0,1068265
fldAp,0.16666666666666666,5,5,ATATAACGTAACGCTGTGGT,0,1121962
fldAp,0.16666666666666666,5,5,ATAGGTTTTAGCTGATCACC,0,1156777
fldAp,0.16666666666666666,5,5,ATAGGTCGGGACTGGTGGAC,0,1180618
fldAp,0.16666666666666666,5,5,ATAGGAAATAGCGGGGGGAT,0,1141402
fldAp,0.16666666666666666,5,5,ATAGCGGCGCGCGGACGATA,0,1070501
fldAp,0.16666666666666666,5,5,ATAGACAATGTGCATGGCAG,0,1176161
fldAp,0.16666666666666666,5,5,ATAGAACTTCTGTGGCACAG,0,1170660
fldAp,0.16666666666666666,5,5,ATAGAAACAGATTTGACTCT,0,1137455
fldAp,0.16666666666666666,5,5,ATACGGTAAGCGTGCACAAC,0,1084731
fldAp,0.16666666666666666,5,5,ATACGAAGGTAACACCAACC,0,1138738
fldAp,0.16666666666666666,5,5,ATACCAAGGTGTGAGTTAGG,0,1121975
fldAp,0.16666666666666666,5,5,ATACACTGGGAGGTCGTCCG,0,1160955
fldAp,0.16666666666666666,5,5,ATAAGTCGTAGCCTAGAAGG,0,1097078
fldAp,0.16666666666666666,5,5,ATAAGTACTTCTAAGCCTTA,0,1120986
fldAp,0.16666666666666666,5,5,ATAAGGGCAGCGTGACTATA,0,1095255
fldAp,0.16666666666666666,5,5,ATAAGGATAAACTGGTCTAC,0,1094571
fldAp,0.16666666666666666,5,5,ATAACGGGGAAAAAGGCTAG,0,1167120
fldAp,0.16666666666666666,5,5,ATAAATAACGCGGCTGAGTC,0,1172643
fldAp,0.16666666666666666,5,5,ATAAAGGGGATCTAGGCGTA,0,1168007
fldAp,0.16666666666666666,5,5,ATAAACGCTAACTTTCAAAT,0,1158127
fldAp,0.16666666666666666,5,5,ATAAAAAGATCGTTCCACGG,0,1063751
fldAp,0.16666666666666666,5,5,AGTTTATTGGGCAATCTCGC,0,1184242
fldAp,0.16666666666666666,5,5,AGTTTAGGGCCAAAACTGAT,0,1088926
fldAp,0.16666666666666666,5,5,AGTTTACTCATCAGATAAAT,0,1130058
fldAp,0.16666666666666666,5,5,AGTTTACTAACTGACTAATT,0,1070467
fldAp,0.16666666666666666,5,5,AGTTTAAGGGGGGGTATAAA,0,1114955
fldAp,0.16666666666666666,5,5,AGTTGGCTGGCACATATGTA,0,1096814
fldAp,0.16666666666666666,5,5,AGTTGCGTGGCCACTATGAC,0,1064616
fldAp,0.16666666666666666,5,5,AGTTGATATGGATTCGGATC,0,1111541
fldAp,0.16666666666666666,5,5,AGTTCCCATTCGCAGCATTG,0,1076342
fldAp,0.16666666666666666,5,5,AGTTATGTCCAGGGTAAGTG,0,1183119
fldAp,0.16666666666666666,5,5,AGTTAGGGCGGCAATTGGGG,0,1082983
fldAp,0.16666666666666666,5,5,AGTGTGAAGCCCGGTAGTGG,0,1173310
fldAp,0.16666666666666666,5,5,AGTGTCGATGGGTGTGCAAG,0,1183303
fldAp,0.16666666666666666,5,5,AGTGTAGTACCAACGTGCCA,0,1182119
fldAp,0.16666666666666666,5,5,AGTGTACCGCATAGAAAGGT,0,1169610
fldAp,0.16666666666666666,5,5,AGTGGTCAGTTTCGTTAAAC,0,1149882
fldAp,0.16666666666666666,5,5,AGTGGGTGCATTGGCTCGCT,0,1182585
fldAp,0.16666666666666666,5,5,AGTGGCTGTGTATATGCCTA,0,1165011
fldAp,0.16666666666666666,5,5,AGTGGCCTGGCATATTTAGT,0,1150350
fldAp,0.16666666666666666,5,5,AGTGGAAAGCCGCCGCGACG,0,1135284
fldAp,0.16666666666666666,5,5,AGTGCTTGCGTTTCAAGAAG,0,1102462
fldAp,0.16666666666666666,5,5,AGTGCTTAGCGCTACAAACC,0,1077692
fldAp,0.16666666666666666,5,5,AGTGCGCTTACTAAGGTCGT,0,1077858
fldAp,0.16666666666666666,5,5,AGTGCCTTTTCTAGGTGATA,0,1102101
fldAp,0.16666666666666666,5,5,AGTGATGACCGCCGCTCCCG,0,1138926
fldAp,0.16666666666666666,5,5,AGTCTTCGATGCACGGGCTT,0,1118866
fldAp,0.16666666666666666,5,5,AGTCTGTTAGGCTTATACTA,0,1166625
fldAp,0.16666666666666666,5,5,AGTCTCTGCTAAGTATTCGC,0,1112787
fldAp,0.16666666666666666,5,5,AGTCTCAGATCAGGCAACAT,0,1137161
fldAp,0.16666666666666666,5,5,AGTCCAGCTCCCAATATCTA,0,1093167
fldAp,0.16666666666666666,5,5,AGTATTACCGCGCGTGTCAA,0,1093327
fldAp,0.16666666666666666,5,5,AGTATGCTTCACGTAGTCTC,0,1129007
fldAp,0.16666666666666666,5,5,AGTATCCTTAACTTGGTGAG,0,1152228
fldAp,0.16666666666666666,5,5,AGTACCAGACATCTCCCGCA,0,1113329
fldAp,0.16666666666666666,5,5,AGTAATCCATCAACACGTTT,0,1089578
fldAp,0.16666666666666666,5,5,AGGTTGCGTTATGTTAAATT,0,1130643
fldAp,0.16666666666666666,5,5,AGGTTCTGGAACATACCCAT,0,1148091
fldAp,0.16666666666666666,5,5,AGGTTCTCGAGTTTATTAGA,0,1151381
fldAp,0.16666666666666666,5,5,AGGTGTTCTATTCTTTGGGA,0,1082313
fldAp,0.16666666666666666,5,5,AGGTGCATGGGATATTGGTA,0,1142022
fldAp,0.16666666666666666,5,5,AGGTCCATCGGTAGCGCCTC,0,1161662
fldAp,0.16666666666666666,5,5,AGGTACACAACAACTCAGCA,0,1178766
fldAp,0.16666666666666666,5,5,AGGGGGTTCGATTACCACAT,0,1103739
fldAp,0.16666666666666666,5,5,AGGGGGCTTGTTAAGTTCTA,0,1141399
fldAp,0.16666666666666666,5,5,AGGGGGAGTTAGGAAGCACT,0,1065717
fldAp,0.16666666666666666,5,5,AGGGCTGGCATGCTTAGCGC,0,1107012
fldAp,0.16666666666666666,5,5,AGGGATGTCAAGGATATTGG,0,1124278
fldAp,0.16666666666666666,5,5,AGGGAGTCGGCGGGCATGTT,0,1177296
fldAp,0.16666666666666666,5,5,AGGCTTGGCCACACGCGTGT,0,1071223
fldAp,0.16666666666666666,5,5,AGGCTGGATTATTAACATAG,0,1118166
fldAp,0.16666666666666666,5,5,AGGCTCTTCTGTTCTTCAGA,0,1167946
fldAp,0.16666666666666666,5,5,AGGCTCTCAGCTCGGGGCCT,0,1135330
fldAp,0.16666666666666666,5,5,AGGCTATTGAGGGTAATAAC,0,1118509
fldAp,0.16666666666666666,5,5,AGGCGGGCAGGACTCCATTA,0,1073939
fldAp,0.16666666666666666,5,5,AGGCGGAATTTCCAGCTGGG,0,1166861
fldAp,0.16666666666666666,5,5,AGGCGAACTACCGTATGACC,0,1156716
fldAp,0.16666666666666666,5,5,AGGCGAAAAGGTCGGCGAAC,0,1157374
fldAp,0.16666666666666666,5,5,AGGCCCTCGATACGCACGCA,0,1169154
fldAp,0.16666666666666666,5,5,AGGCATCGCAATATACGGAT,0,1087684
fldAp,0.16666666666666666,5,5,AGGCATAAACCTCAAGCGTC,0,1184488
fldAp,0.16666666666666666,5,5,AGGCACGGCAGGTGCGTTAG,0,1129292
fldAp,0.16666666666666666,5,5,AGGCACAGGGCCACACAACG,0,1164378
fldAp,0.16666666666666666,5,5,AGGCAAGCTAAGGGTGGTTA,0,1098940
fldAp,0.16666666666666666,5,5,AGGATGAGTCTAACAGGACG,0,1092117
fldAp,0.16666666666666666,5,5,AGGAGAGATTTAATTGGGAC,0,1115765
fldAp,0.16666666666666666,5,5,AGGAATCCCATCGCTGAGGC,0,1077217
fldAp,0.16666666666666666,5,5,AGGAACAGGTGCAGAACGAC,0,1149168
fldAp,0.16666666666666666,5,5,AGGAAATTGGAGAGCTGAAG,0,1094845
fldAp,0.16666666666666666,5,5,AGCTGTCGGGTGGTCAGGCT,0,1182382
fldAp,0.16666666666666666,5,5,AGCTCGGACCTACATCATGG,0,1176993
fldAp,0.16666666666666666,5,5,AGCTCCAGGTGAGTTTTGAT,0,1079927
fldAp,0.16666666666666666,5,5,AGCTAGGGACATCGCCCGAT,0,1161496
fldAp,0.16666666666666666,5,5,AGCTACCATAGGGAGGAGCT,0,1106877
fldAp,0.16666666666666666,5,5,AGCGTTCGGTAAAAGGCCCA,0,1069250
fldAp,0.16666666666666666,5,5,AGCGTGTTCCCCAGAAATCA,0,1093558
fldAp,0.16666666666666666,5,5,AGCGCCTATCCTGCCGGCGT,0,1130264
fldAp,0.16666666666666666,5,5,AGCGCCGCGTAGCATGATCA,0,1130521
fldAp,0.16666666666666666,5,5,AGCGCACGAGAGCGTAGAGG,0,1171323
fldAp,0.16666666666666666,5,5,AGCCTTGGCATCTCTATAAC,0,1080792
fldAp,0.16666666666666666,5,5,AGCCTCTCGGCCTCGCCATT,0,1065625
fldAp,0.16666666666666666,5,5,AGCCTAGAAGGCTCAGCTTG,0,1082899
fldAp,0.16666666666666666,5,5,AGCCGCTTGATTGAGATGGG,0,1144795
fldAp,0.16666666666666666,5,5,AGCCGCCCAAGCAGTTTTCA,0,1166756
fldAp,0.16666666666666666,5,5,AGCCGACGTGAAAGTAAGGC,0,1154423
fldAp,0.16666666666666666,5,5,AGCCCCGCGGAACCCACTTG,0,1164175
fldAp,0.16666666666666666,5,5,AGCCACGTGATAGACCGTTA,0,1186202
fldAp,0.16666666666666666,5,5,AGCCACACTGAGCGAAACCC,0,1174719
fldAp,0.16666666666666666,5,5,AGCCAAGCGAGGGGTTTACA,0,1106797
fldAp,0.16666666666666666,5,5,AGCATTTGTGTCGTTCACAA,0,1130484
fldAp,0.16666666666666666,5,5,AGCATCTCCGACCAAGTAGA,0,1079467
fldAp,0.16666666666666666,5,5,AGCATCTAAAGCATTTACTC,0,1118176
fldAp,0.16666666666666666,5,5,AGCATCGGGACACTCTACGT,0,1139147
fldAp,0.16666666666666666,5,5,AGCATAGGAGCCGGATCTGC,0,1141934
fldAp,0.16666666666666666,5,5,AGCAGTGCGATGGTTTCATA,0,1129045
fldAp,0.16666666666666666,5,5,AGCAGGAGTACTGCAGGATT,0,1146555
fldAp,0.16666666666666666,5,5,AGCAGCATCATTGCGACGCA,0,1066508
fldAp,0.16666666666666666,5,5,AGCAGATACGTGAATTGAGC,0,1154513
fldAp,0.16666666666666666,5,5,AGCAGAAGCTTCACGATAGT,0,1070247
fldAp,0.16666666666666666,5,5,AGCACACCTAGATAGGACCT,0,1146860
fldAp,0.16666666666666666,5,5,AGCAATGTGTCTGACCTATC,0,1129071
fldAp,0.16666666666666666,5,5,AGCAAGGGAAGGGTGAGAGG,0,1106145
fldAp,0.16666666666666666,5,5,AGCAAAATGGCTTGTCACAT,0,1183112
fldAp,0.16666666666666666,5,5,AGATTCGCGAATCGCATCGT,0,1077196
fldAp,0.16666666666666666,5,5,AGATGTAGGCCGAGATCGGT,0,1094732
fldAp,0.16666666666666666,5,5,AGATGCCCATACTCAGGGAC,0,1090518
fldAp,0.16666666666666666,5,5,AGATGACTCCATATACTATG,0,1157959
fldAp,0.16666666666666666,5,5,AGATCGGCGCATTTATGACT,0,1099142
fldAp,0.16666666666666666,5,5,AGATCGGAGCCAGCACCATA,0,1184575
fldAp,0.16666666666666666,5,5,AGATCATCGATAAGCTTGTC,0,1078517
fldAp,0.16666666666666666,5,5,AGATATGTTGACCTGTCGGA,0,1142130
fldAp,0.16666666666666666,5,5,AGATATGTAACCCTCTACAA,0,1104713
fldAp,0.16666666666666666,5,5,AGATAGGGGGCGTGAACGCA,0,1150181
fldAp,0.16666666666666666,5,5,AGAGATTTTAAAGTCGGAAC,0,1134476
fldAp,0.16666666666666666,5,5,AGACTCAGTAGAATTGAAAG,0,1115348
fldAp,0.16666666666666666,5,5,AGACGGGAAAATTCGCTTGT,0,1135584
fldAp,0.16666666666666666,5,5,AGACGCCTGGGTGAGATGGA,0,1176033
fldAp,0.16666666666666666,5,5,AGACCTTGAAAGCCGATTAT,0,1175532
fldAp,0.16666666666666666,5,5,AGACACAGGGTTTTCATTTA,0,1159641
fldAp,0.16666666666666666,5,5,AGAATCTTTCCGCGGCGTAA,0,1076864
fldAp,0.16666666666666666,5,5,AGAATCGTCACCGGGCGTTG,0,1155804
fldAp,0.16666666666666666,5,5,AGAAGTCGTCTAATAGCGCT,0,1068850
fldAp,0.16666666666666666,5,5,AGAAGGTGCACAAGCACCTT,0,1153974
fldAp,0.16666666666666666,5,5,AGAAGGACCGCACTCGCTGA,0,1155051
fldAp,0.16666666666666666,5,5,ACTTGGCGAAGTCGTTAATA,0,1162409
fldAp,0.16666666666666666,5,5,ACTTGCCTTGCTCGCCTGCG,0,1157222
fldAp,0.16666666666666666,5,5,ACTTGAGAAGCTGCGCTCCG,0,1076737
fldAp,0.16666666666666666,5,5,ACTTCGGCCGCTGTGACCAT,0,1110829
fldAp,0.16666666666666666,5,5,ACTTATTGTTCATGTAACAT,0,1120206
fldAp,0.16666666666666666,5,5,ACTGTTTTTTTCGTTGTTCT,0,1135216
fldAp,0.16666666666666666,5,5,ACTGTTGAATGTTGGCGCGT,0,1178817
fldAp,0.16666666666666666,5,5,ACTGGTACACTCGCCGTTGC,0,1155765
fldAp,0.16666666666666666,5,5,ACTGGATCCGAGTATTATCT,0,1170748
fldAp,0.16666666666666666,5,5,ACTGCTCGCACTGAGCAGTG,0,1133056
fldAp,0.16666666666666666,5,5,ACTGCACTTGTTATAACGCT,0,1177475
fldAp,0.16666666666666666,5,5,ACTGATTATTAGGATGGTGT,0,1114836
fldAp,0.16666666666666666,5,5,ACTCTGCCTGCAAGTGAATG,0,1122124
fldAp,0.16666666666666666,5,5,ACTCCATACAGGTGAATTTA,0,1074210
fldAp,0.16666666666666666,5,5,ACTATAGTGCATGAGATATA,0,1154906
fldAp,0.16666666666666666,5,5,ACTACTCCGGCGCACGGAGT,0,1097909
fldAp,0.16666666666666666,5,5,ACTACCTAACGTCTGGCGGA,0,1067211
fldAp,0.16666666666666666,5,5,ACTAATGATTGGTTCTGGCG,0,1084727
fldAp,0.16666666666666666,5,5,ACGTTTGGGCAATTAGGTTC,0,1100329
fldAp,0.16666666666666666,5,5,ACGTTCCTGCTTAGACCAAC,0,1122159
fldAp,0.16666666666666666,5,5,ACGTGCAAGCTAGTGAATAA,0,1151877
fldAp,0.16666666666666666,5,5,ACGTCCCGCGGACGAAGAAG,0,1180104
fldAp,0.16666666666666666,5,5,ACGTCACGCTAATTCGTGAG,0,1154857
fldAp,0.16666666666666666,5,5,ACGGTTTGGGAACGGGTTCC,0,1126014
fldAp,0.16666666666666666,5,5,ACGGTTGTTTCCCTCCTGAG,0,1099048
fldAp,0.16666666666666666,5,5,ACGGTTATATATCCCCGGTT,0,1100226
fldAp,0.16666666666666666,5,5,ACGGTATTAGTCAGTCTAGA,0,1154539
fldAp,0.16666666666666666,5,5,ACGGGGTCGGCCCGAAGTGG,0,1108251
fldAp,0.16666666666666666,5,5,ACGGGGCTGGGAAACGCGGG,0,1148284
fldAp,0.16666666666666666,5,5,ACGGCTTAAGTTTATGGAGG,0,1145546
fldAp,0.16666666666666666,5,5,ACGGCCGGAACATAGCCCGA,0,1134457
fldAp,0.16666666666666666,5,5,ACGGATCTTCACCCAGGGCG,0,1153517
fldAp,0.16666666666666666,5,5,ACGGATAGATTCGCAACTGA,0,1141925
fldAp,0.16666666666666666,5,5,ACGGAGTTGGCGGTGTGGGG,0,1070011
fldAp,0.16666666666666666,5,5,ACGGAGTGTGTCGCGAGAGG,0,1109212
fldAp,0.16666666666666666,5,5,ACGGAACAATTGGTTGAGGT,0,1107881
fldAp,0.16666666666666666,5,5,ACGCTCCGCAAATGTGCCTT,0,1116781
fldAp,0.16666666666666666,5,5,ACGCGGTGCTTTCATCCTGC,0,1159810
fldAp,0.16666666666666666,5,5,ACGCGCAACGCATCATAGAT,0,1102502
fldAp,0.16666666666666666,5,5,ACGCGACTAAGGTGTATGGT,0,1069578
fldAp,0.16666666666666666,5,5,ACGCCGAATCTCACGTTACA,0,1069692
fldAp,0.16666666666666666,5,5,ACGCATACACGGACTTTCGC,0,1120279
fldAp,0.16666666666666666,5,5,ACGATTGACCGTTATAGGCA,0,1099069
fldAp,0.16666666666666666,5,5,ACGATGGGACCCGGACGTAA,0,1130831
fldAp,0.16666666666666666,5,5,ACGATCTCATGACTGGGTTC,0,1153379
fldAp,0.16666666666666666,5,5,ACGACTGCAAGGAATTTTAC,0,1179209
fldAp,0.16666666666666666,5,5,ACGACGATAGAAGGGCATCT,0,1155393
fldAp,0.16666666666666666,5,5,ACGACAGCCTTTACAAATAT,0,1091366
fldAp,0.16666666666666666,5,5,ACGACAAGGATAAGGAAAAC,0,1075928
fldAp,0.16666666666666666,5,5,ACGAATTTCCGCACCGGCAT,0,1135774
fldAp,0.16666666666666666,5,5,ACGAAGTATTCTCCAACCTT,0,1070699
fldAp,0.16666666666666666,5,5,ACGAAGTAACGCACCTTGGA,0,1149483
fldAp,0.16666666666666666,5,5,ACGAAGATACCAAAGGATAG,0,1086011
fldAp,0.16666666666666666,5,5,ACGAACAGTAAAACGGCTCA,0,1100814
fldAp,0.16666666666666666,5,5,ACGAAAGAGCGGGATTCAGC,0,1078464
fldAp,0.16666666666666666,5,5,ACGAAACATCTTACTAAAAT,0,1158635
fldAp,0.16666666666666666,5,5,ACCTTACGGCGTCAACTTCA,0,1106205
fldAp,0.16666666666666666,5,5,ACCTTACCTACCGGTCTGAT,0,1135397
fldAp,0.16666666666666666,5,5,ACCTGGAAATTCATGCTTGT,0,1088246
fldAp,0.16666666666666666,5,5,ACCTGCATAATAACTGTCCC,0,1117599
fldAp,0.16666666666666666,5,5,ACCTCCGAGGCGTCGTGAGT,0,1174864
fldAp,0.16666666666666666,5,5,ACCTATTAACAAAGGTCGCT,0,1080262
fldAp,0.16666666666666666,5,5,ACCGTGCGCGCACCGGGGCG,0,1160653
fldAp,0.16666666666666666,5,5,ACCGTCTGTGAGGGTCAAAA,0,1154035
fldAp,0.16666666666666666,5,5,ACCGTCGCCACTAAATGTGC,0,1150397
fldAp,0.16666666666666666,5,5,ACCGGTTGGAAAAGTAATGA,0,1149164
fldAp,0.16666666666666666,5,5,ACCGGATGGTCGGGGGGGTG,0,1134083
fldAp,0.16666666666666666,5,5,ACCGCTAACGGAAGGCGTGG,0,1088538
fldAp,0.16666666666666666,5,5,ACCGCCGGCTTTCATATTAT,0,1142336
fldAp,0.16666666666666666,5,5,ACCGAGGAGGCTAGGATATG,0,1162906
fldAp,0.16666666666666666,5,5,ACCCTGGGGTCCCCGTCGAG,0,1177106
fldAp,0.16666666666666666,5,5,ACCCTATGAGGTAGAGCGCA,0,1105493
fldAp,0.16666666666666666,5,5,ACCCGGGGTCAAACGGCGCT,0,1090537
fldAp,0.16666666666666666,5,5,ACCCGAGGGATGGGGTCTGA,0,1148301
fldAp,0.16666666666666666,5,5,ACCCCTGCCGTGTGAGGTAA,0,1074892
fldAp,0.16666666666666666,5,5,ACCCCTACATATTTCCTCGA,0,1147786
fldAp,0.16666666666666666,5,5,ACCCCGTGTAATGTCGGGCA,0,1181736
fldAp,0.16666666666666666,5,5,ACCCACTGTACTGAACATGA,0,1082948
fldAp,0.16666666666666666,5,5,ACCCACCTGAGCTAAGATAT,0,1130244
fldAp,0.16666666666666666,5,5,ACCCAACAACCCGGTGGCAG,0,1136611
fldAp,0.16666666666666666,5,5,ACCATGCCCTTATTGCTCCT,0,1151459
fldAp,0.16666666666666666,5,5,ACCAGGTTACTCCGGAAGAG,0,1132804
fldAp,0.16666666666666666,5,5,ACCACGTTGGTGCCGGGACG,0,1069813
fldAp,0.16666666666666666,5,5,ACCACCGCACTACAAAGCCA,0,1108424
fldAp,0.16666666666666666,5,5,ACCAAACGAAAGCGGGCACT,0,1084852
fldAp,0.16666666666666666,5,5,ACATTCCAAACGTGGGAGGG,0,1157940
fldAp,0.16666666666666666,5,5,ACATGGTGACGCGGATTATT,0,1063868
fldAp,0.16666666666666666,5,5,ACATGGGGGTGAAAAAATGG,0,1095802
fldAp,0.16666666666666666,5,5,ACATCTACTTCCTGACTTTC,0,1129340
fldAp,0.16666666666666666,5,5,ACATCCATAGAAAATAGCAA,0,1069297
fldAp,0.16666666666666666,5,5,ACATATGAGTCCGTTCGAAA,0,1071822
fldAp,0.16666666666666666,5,5,ACATACTAAGTGAGCAGGTG,0,1145834
fldAp,0.16666666666666666,5,5,ACAGTGGGGCTAACACACAC,0,1115356
fldAp,0.16666666666666666,5,5,ACAGTGCGCCGTTTATTGTT,0,1092214
fldAp,0.16666666666666666,5,5,ACAGCGTTACGTGGCCACTC,0,1138854
fldAp,0.16666666666666666,5,5,ACAGCCGCTTGAGGTATCGT,0,1181224
fldAp,0.16666666666666666,5,5,ACAGCCCCCTATTGCTTGTC,0,1098206
fldAp,0.16666666666666666,5,5,ACACTGGGCATGCCAGTGAG,0,1114620
fldAp,0.16666666666666666,5,5,ACACGGCGTACTCAATAGTT,0,1121551
fldAp,0.16666666666666666,5,5,ACACATTTTTCTTACGGGTT,0,1081390
fldAp,0.16666666666666666,5,5,ACAAGTGTCTGCCGCACGCT,0,1107446
fldAp,0.16666666666666666,5,5,ACAAGCAGCATTCGACTAGA,0,1181014
fldAp,0.16666666666666666,5,5,ACAACTCGTCTAGAACCAAA,0,1185830
fldAp,0.16666666666666666,5,5,ACAACCTTATATGCCTAATA,0,1136029
fldAp,0.16666666666666666,5,5,ACAACCCGGGGTAGTCATAC,0,1097322
fldAp,0.16666666666666666,5,5,ACAACCAGAAGGAGAGAGTC,0,1161284
fldAp,0.16666666666666666,5,5,ACAACAAATAGTGTTCCTAG,0,1134054
fldAp,0.16666666666666666,5,5,ACAAACGTATCAGAACTGTG,0,1064139
fldAp,0.16666666666666666,5,5,AATTTTTGCAATGCCTGCAG,0,1161003
fldAp,0.16666666666666666,5,5,AATTTAAGTATGGGTGTTGC,0,1079976
fldAp,0.16666666666666666,5,5,AATTGTTCTTTAACGCTGAA,0,1176059
fldAp,0.16666666666666666,5,5,AATTCTGACGGGCCTATTGA,0,1156329
fldAp,0.16666666666666666,5,5,AATTCGCAGAGACCGACGAA,0,1079112
fldAp,0.16666666666666666,5,5,AATTCGAATATACGGAGATC,0,1077087
fldAp,0.16666666666666666,5,5,AATTATTGAGCCGAGCGTCT,0,1092560
fldAp,0.16666666666666666,5,5,AATTATAGATCCTTAGACTC,0,1109703
fldAp,0.16666666666666666,5,5,AATTAGATTTAATTAGCGTG,0,1151753
fldAp,0.16666666666666666,5,5,AATTACGCGAGTCGCCTCTT,0,1140145
fldAp,0.16666666666666666,5,5,AATGTTGCACATGCTGTCTC,0,1074991
fldAp,0.16666666666666666,5,5,AATGTTGCAAGACAGGTACC,0,1085141
fldAp,0.16666666666666666,5,5,AATGTGGTCCAGACATCGCA,0,1163471
fldAp,0.16666666666666666,5,5,AATGGTTTTGGAGGGACCTC,0,1153453
fldAp,0.16666666666666666,5,5,AATGGATATGAAGCCATGTT,0,1088787
fldAp,0.16666666666666666,5,5,AATGGATAACGGTGTGGTAC,0,1161114
fldAp,0.16666666666666666,5,5,AATGCTAACGGATACTATAG,0,1089905
fldAp,0.16666666666666666,5,5,AATGATAGGGCTTAGGACGC,0,1171393
fldAp,0.16666666666666666,5,5,AATGATAACGAAGGAGCCAG,0,1162797
fldAp,0.16666666666666666,5,5,AATGAGGGACCGCGTAAGAA,0,1075255
fldAp,0.16666666666666666,5,5,AATCTTACGATAGAACTACT,0,1133063
fldAp,0.16666666666666666,5,5,AATCTGTAGATCTCTTGGAA,0,1075097
fldAp,0.16666666666666666,5,5,AATCTGGCGCTAACTCTACT,0,1121240
fldAp,0.16666666666666666,5,5,AATCGTTGTTTAGTAATTTA,0,1107224
fldAp,0.16666666666666666,5,5,AATCGCCAGCAAATTCCGGA,0,1141340
fldAp,0.16666666666666666,5,5,AATCCCATTTATATTATAAC,0,1138929
fldAp,0.16666666666666666,5,5,AATCCCAGGGTACTCCAGGT,0,1087183
fldAp,0.16666666666666666,5,5,AATATGTTTGGCGACCTGAC,0,1139917
fldAp,0.16666666666666666,5,5,AATATAAGTGACTGCATACG,0,1077269
fldAp,0.16666666666666666,5,5,AATAGTCCCTTTCTGATATA,0,1114960
fldAp,0.16666666666666666,5,5,AATAGCCACGCCACTTCGCT,0,1100220
fldAp,0.16666666666666666,5,5,AATAGAGCACCGCAACTTGG,0,1072964
fldAp,0.16666666666666666,5,5,AAGTTTTGACTAAAAGGCAT,0,1123728
fldAp,0.16666666666666666,5,5,AAGTTTAAGGGGCAAAGACC,0,1065824
fldAp,0.16666666666666666,5,5,AAGTGTTGGCGAAACGTTCA,0,1119430
fldAp,0.16666666666666666,5,5,AAGTCCCACTCAGATTCAAG,0,1181817
fldAp,0.16666666666666666,5,5,AAGTCAGAGCTGGTTCAGCA,0,1129096
fldAp,0.16666666666666666,5,5,AAGTACCTCAACACGTTCTT,0,1183120
fldAp,0.16666666666666666,5,5,AAGTACAGCCGTCAATTCCA,0,1142128
fldAp,0.16666666666666666,5,5,AAGTAATCAGCCGTGGTTTC,0,1087646
fldAp,0.16666666666666666,5,5,AAGGTTTTGAGGGTCTGCCT,0,1071870
fldAp,0.16666666666666666,5,5,AAGGTTACCATTTCATCAAT,0,1097899
fldAp,0.16666666666666666,5,5,AAGGGGCCAGCTTGTTAGGA,0,1171645
fldAp,0.16666666666666666,5,5,AAGGGCTATCACCATGCGAC,0,1170476
fldAp,0.16666666666666666,5,5,AAGGGCGCGAAATTATATCT,0,1178731
fldAp,0.16666666666666666,5,5,AAGGCACTATTCGATGCTAA,0,1091933
fldAp,0.16666666666666666,5,5,AAGGATTCTAGTCGCTGTGT,0,1152386
fldAp,0.16666666666666666,5,5,AAGGAGGAGGCGGCGGGTCT,0,1096037
fldAp,0.16666666666666666,5,5,AAGCTTTAAAATTCCTCTCA,0,1094966
fldAp,0.16666666666666666,5,5,AAGCTACCTAACTCATATGC,0,1081464
fldAp,0.16666666666666666,5,5,AAGCGTCGGCGACTACGACT,0,1085800
fldAp,0.16666666666666666,5,5,AAGCGTAGTCGCGCAAGGTG,0,1099340
fldAp,0.16666666666666666,5,5,AAGCAGCGATAGTCTGCATT,0,1079313
fldAp,0.16666666666666666,5,5,AAGCAACCACGGCTCTCCTA,0,1113565
fldAp,0.16666666666666666,5,5,AAGATTAGCGCTTTCTGTGC,0,1089961
fldAp,0.16666666666666666,5,5,AAGATCACAAGCGGACTCAG,0,1130689
fldAp,0.16666666666666666,5,5,AAGAGCAACCATCCACTCAT,0,1174095
fldAp,0.16666666666666666,5,5,AACTTGGGGTGCTACACTGT,0,1088492
fldAp,0.16666666666666666,5,5,AACTTATTTAGATGCGCAAT,0,1184345
fldAp,0.16666666666666666,5,5,AACTTAACAGGACGGCCTAT,0,1113031
fldAp,0.16666666666666666,5,5,AACTCCTATGCTTATCGGGA,0,1169318
fldAp,0.16666666666666666,5,5,AACTCCGAGCGTTCTGGTGA,0,1165987
fldAp,0.16666666666666666,5,5,AACTAGGTTTTAGCGAGGTC,0,1166277
fldAp,0.16666666666666666,5,5,AACTACGAATGTGGACGCTC,0,1064243
fldAp,0.16666666666666666,5,5,AACGTGCCCGTCCCAGAGAT,0,1167875
fldAp,0.16666666666666666,5,5,AACGTCAGATACTAATGGTA,0,1134066
fldAp,0.16666666666666666,5,5,AACGGAAGGTGCGGCTATCA,0,1124436
fldAp,0.16666666666666666,5,5,AACGAACTACATCAGTTAAT,0,1070705
fldAp,0.16666666666666666,5,5,AACCTTCTACGGAGTGGAAT,0,1117073
fldAp,0.16666666666666666,5,5,AACCTGCAATGTATAGTTGC,0,1163595
fldAp,0.16666666666666666,5,5,AACCTCCGTTCAGGGGACAA,0,1166408
fldAp,0.16666666666666666,5,5,AACCTAGATGTGGCCCTTAC,0,1179980
fldAp,0.16666666666666666,5,5,AACCGTAAGTTTGGTGAGGT,0,1081124
fldAp,0.16666666666666666,5,5,AACCGGTTAGCAGATCGCTT,0,1177227
fldAp,0.16666666666666666,5,5,AACCCCTTGTAGATGATTCA,0,1134309
fldAp,0.16666666666666666,5,5,AACCCCTCACCATAAACAAG,0,1128189
fldAp,0.16666666666666666,5,5,AACCCCCAACAATTGGCGCG,0,1164363
fldAp,0.16666666666666666,5,5,AACATCGGTCCTTAACACCG,0,1186343
fldAp,0.16666666666666666,5,5,AACATAGGGGACGGTTCGTT,0,1163966
fldAp,0.16666666666666666,5,5,AACATAGGCGCCCTTATGGG,0,1121909
fldAp,0.16666666666666666,5,5,AACAGTTAATCGTTCGTCTT,0,1162576
fldAp,0.16666666666666666,5,5,AACAGACTGCGCTGTCACGT,0,1165805
fldAp,0.16666666666666666,5,5,AACACAGGGACACGTGTTAT,0,1096608
fldAp,0.16666666666666666,5,5,AACAAAAGTCGCGAGCTTTG,0,1094577
fldAp,0.16666666666666666,5,5,AAATTGGCGTAGCAATTGTG,0,1185639
fldAp,0.16666666666666666,5,5,AAATTGCCTCGAGATGTTTA,0,1112866
fldAp,0.16666666666666666,5,5,AAATTCCCGGCACTGGACGT,0,1171127
fldAp,0.16666666666666666,5,5,AAATGGTGACGGACGGGAGT,0,1079013
fldAp,0.16666666666666666,5,5,AAATGGCTCGGTAATGGTTA,0,1067766
fldAp,0.16666666666666666,5,5,AAATGCCACACGCCTCATCC,0,1135117
fldAp,0.16666666666666666,5,5,AAATGCAGGAAAACGTCTCT,0,1123864
fldAp,0.16666666666666666,5,5,AAATCTTGTAAGTCGTATTG,0,1118553
fldAp,0.16666666666666666,5,5,AAATCCAATGTGTTGCCAGA,0,1071415
fldAp,0.16666666666666666,5,5,AAATCATCAACCGGCTACCT,0,1163429
fldAp,0.16666666666666666,5,5,AAATAATGACCTTAGTACGG,0,1182741
fldAp,0.16666666666666666,5,5,AAATAATAAAGCGTAAAGCC,0,1113111
fldAp,0.16666666666666666,5,5,AAAGTATGGGATAAAGTATA,0,1163945
fldAp,0.16666666666666666,5,5,AAAGGGGTTTGAATATCGTT,0,1167980
fldAp,0.16666666666666666,5,5,AAAGGGGATTTTCACATCTC,0,1175206
fldAp,0.16666666666666666,5,5,AAAGGAAGATCACACTCATA,0,1063148
fldAp,0.16666666666666666,5,5,AAAGCTTATGAATCGCCGGA,0,1084719
fldAp,0.16666666666666666,5,5,AAAGCCGCAATGGTTCACCC,0,1171759
fldAp,0.16666666666666666,5,5,AAAGAAGAAGAATCTCTGGT,0,1130774
fldAp,0.16666666666666666,5,5,AAAGAAAAACCCTACACAGA,0,1094976
fldAp,0.16666666666666666,5,5,AAACTTGCCTACACCTGTAT,0,1178583
fldAp,0.16666666666666666,5,5,AAACTTGACGTGAAAACCTC,0,1174468
fldAp,0.16666666666666666,5,5,AAACTAATGCATTCGCCTGA,0,1130051
fldAp,0.16666666666666666,5,5,AAACTAAAAGCCGCAGCAAA,0,1121687
fldAp,0.16666666666666666,5,5,AAACGGATCAGCCTCAACAG,0,1158244
fldAp,0.16666666666666666,5,5,AAAATGTGCATGCTAGTTTG,0,1116001
fldAp,0.16666666666666666,5,5,AAAAGTTGATTATTCAAGCA,0,1108352
fldAp,0.16666666666666666,5,5,AAAAGACTTTGATCCGAGTG,0,1066120
fldAp,0.16666666666666666,5,5,AAAACCTTACGAGTCAGTCA,0,1079702
fldAp,0.16666666666666666,5,5,AAAACCAGCGAAATGGAAAT,0,1132119
fldAp,0.16666666666666666,5,5,AAAAATCACCATCGGACTTC,0,1098977
fldAp,0.16666666666666666,5,5,AAAAAGATTGCAATCCTAAC,0,1125900
fldAp,0.2,4,4,TTTTTTTGGTGGGGCCAGGG,0,1184264
fldAp,0.2,4,4,TTTTTGGCATCATGCAATTT,0,1077665
fldAp,0.2,4,4,TTTTTGAACCCACATCCGTT,0,1144377
fldAp,0.2,4,4,TTTTTCTGGACTCCATGAAC,0,1085126
fldAp,0.2,4,4,TTTTTACGCTGACGCTTAAA,0,1070752
fldAp,0.2,4,4,TTTTTAAGAGCTCATGATAT,0,1092781
fldAp,0.2,4,4,TTTTGGAGATATCGCAGAGT,0,1168149
fldAp,0.2,4,4,TTTTGATGTCATGCGCCCGT,0,1081153
fldAp,0.2,4,4,TTTTGATGCGTGGTAGTAAC,0,1178983
fldAp,0.2,4,4,TTTTGACGCTTTGGTATACA,0,1163277
fldAp,0.2,4,4,TTTTCTTGCGACGGCATATC,0,1166956
fldAp,0.2,4,4,TTTTCTCAGTCTCATCCCTT,0,1177000
fldAp,0.2,4,4,TTTTCCGCCTGAATTCGAGG,0,1073765
fldAp,0.2,4,4,TTTTCATGCTCGACCCTACA,0,1107086
fldAp,0.2,4,4,TTTTCAGGGCGTTGCGCACC,0,1075877
fldAp,0.2,4,4,TTTTAGCCGACAGAAGTGTA,0,1122184
fldAp,0.2,4,4,TTTTAATTTCGGTGAGCATC,0,1087229
fldAp,0.2,4,4,TTTGTTGTCCCTGGACTGCG,0,1160151
fldAp,0.2,4,4,TTTGTTACCAGCGGGAGCTA,0,1088497
fldAp,0.2,4,4,TTTGTCATGCCGTATACTGT,0,1101332
fldAp,0.2,4,4,TTTGCCGCATTGTCCGCCGG,0,1139025
fldAp,0.2,4,4,TTTGATACGGTTAATGATGA,0,1067558
fldAp,0.2,4,4,TTTGAATACCCTACGAGGTA,0,1177936
fldAp,0.2,4,4,TTTGAAAGTGAGGCCAGGCT,0,1157868
fldAp,0.2,4,4,TTTCTGGGTTTAGGGATGCA,0,1117563
fldAp,0.2,4,4,TTTCTCAGGTAAATATTAGT,0,1147345
fldAp,0.2,4,4,TTTCTCAGACTCCCCGGTGG,0,1155730
fldAp,0.2,4,4,TTTCTAAATGCATTTCTGAT,0,1092676
fldAp,0.2,4,4,TTTCGCGGGATAGCCTCCGG,0,1152314
fldAp,0.2,4,4,TTTCGCGCCACATTCGAGCG,0,1070944
fldAp,0.2,4,4,TTTCGCCGTATCCGGAAAGG,0,1112197
fldAp,0.2,4,4,TTTCGAGTCGCAACGTAAGT,0,1065135
fldAp,0.2,4,4,TTTCGAGCAGCACTGTGCAA,0,1134156
fldAp,0.2,4,4,TTTCCTGCCTTGCTCGCTTG,0,1099929
fldAp,0.2,4,4,TTTCCGGCCCGGTGTGTGCA,0,1083617
fldAp,0.2,4,4,TTTCCAAGACACTTTATCTT,0,1119929
fldAp,0.2,4,4,TTTCAGTACCAACCCAGAGG,0,1143225
fldAp,0.2,4,4,TTTCAGGCGCGGTCACGCAA,0,1179827
fldAp,0.2,4,4,TTTCAAGCTATATTCATTTA,0,1150077
fldAp,0.2,4,4,TTTATTGTCAGCGTATTACT,0,1142347
fldAp,0.2,4,4,TTTATACGTTACCCATCGAT,0,1122588
fldAp,0.2,4,4,TTTATAAATAGCCCGTTAAA,0,1084646
fldAp,0.2,4,4,TTTAGAGTACGTCAGGGATA,0,1098978
fldAp,0.2,4,4,TTTACCCGGTACCCCTGCTA,0,1095593
fldAp,0.2,4,4,TTTACACGATGGGTGAGATT,0,1067091
fldAp,0.2,4,4,TTTAATCGTGTGAATTCCTC,0,1128722
fldAp,0.2,4,4,TTGTTTCCGGAAAACCTAGA,0,1072577
fldAp,0.2,4,4,TTGTTGCCCAACTTGGTATT,0,1154655
fldAp,0.2,4,4,TTGTTCCGTGCCAATTAAAC,0,1088935
fldAp,0.2,4,4,TTGTGATAGAGATTTCAAGA,0,1104782
fldAp,0.2,4,4,TTGTCTGAAGTCAATCCCCA,0,1077679
fldAp,0.2,4,4,TTGTCTAGGGAGCCGGAGAC,0,1115675
fldAp,0.2,4,4,TTGTCCCGGATTCAAGGGGT,0,1109635
fldAp,0.2,4,4,TTGTCAAAGGGTCTTCGTTG,0,1149523
fldAp,0.2,4,4,TTGTAGGGGATGCCCTATTC,0,1102827
fldAp,0.2,4,4,TTGGTTGTGTGGAGTGTAGG,0,1162238
fldAp,0.2,4,4,TTGGTGGGGTTCTTGTACGA,0,1185077
fldAp,0.2,4,4,TTGGTGCCAGCTCAGTGCCA,0,1073817
fldAp,0.2,4,4,TTGGGGATGTCGCAGATCAC,0,1089040
fldAp,0.2,4,4,TTGGGGATGCCCAGATTCAT,0,1158270
fldAp,0.2,4,4,TTGGCTGGAGTTTCAAACGT,0,1124875
fldAp,0.2,4,4,TTGGCGTGCGAGATTAAATA,0,1102744
fldAp,0.2,4,4,TTGGCGGTCATTCTCCGAAT,0,1140488
fldAp,0.2,4,4,TTGGAGGATCACTCGGACAC,0,1119159
fldAp,0.2,4,4,TTGGACATCCCGATTCCTAA,0,1098400
fldAp,0.2,4,4,TTGCTGGTGCACACGGGGTG,0,1145132
fldAp,0.2,4,4,TTGCGTCATGCCTGTATTAT,0,1069791
fldAp,0.2,4,4,TTGCGTCACTGTTAGTTTGT,0,1153238
fldAp,0.2,4,4,TTGCGGAGTCTTTCAACTTA,0,1110826
fldAp,0.2,4,4,TTGCCTATATGCCAACTGCC,0,1101082
fldAp,0.2,4,4,TTGCCGCCGAATGCGACACA,0,1116240
fldAp,0.2,4,4,TTGCATTACTGGGGATGTTT,0,1172863
fldAp,0.2,4,4,TTGCATCGGGGCACCAAGCG,0,1067296
fldAp,0.2,4,4,TTGCAAGTACTATCGAAACA,0,1130008
fldAp,0.2,4,4,TTGATTCCGGATTGCTCGTC,0,1092192
fldAp,0.2,4,4,TTGATCGTCCTTCTGGAAAG,0,1076673
fldAp,0.2,4,4,TTGAGCTCGCTAACTCATCT,0,1141608
fldAp,0.2,4,4,TTGACTCATGTATAGTGAAA,0,1173135
fldAp,0.2,4,4,TTGACCGCCGGCCGGTGAAT,0,1165374
fldAp,0.2,4,4,TTGACCGCAAGGGCTCCAAC,0,1141059
fldAp,0.2,4,4,TTGACAATCAGAGCGGACGC,0,1117625
fldAp,0.2,4,4,TTGAACAGTCTCCATTACAT,0,1173082
fldAp,0.2,4,4,TTCTGTTTTTGAGCCCCTAC,0,1100061
fldAp,0.2,4,4,TTCTGTGCCCCCCGGGGAGT,0,1125799
fldAp,0.2,4,4,TTCTGGGACAGTCCTAGACC,0,1100424
fldAp,0.2,4,4,TTCTGGCTCAATCATGTCTC,0,1165868
fldAp,0.2,4,4,TTCTGGAGACCATACCGGGA,0,1123694
fldAp,0.2,4,4,TTCTGAATTCTCTTCAAGCA,0,1116802
fldAp,0.2,4,4,TTCTCCCATGCAATGCCGCC,0,1102494
fldAp,0.2,4,4,TTCTAAAATAAACCGACTGT,0,1182943
fldAp,0.2,4,4,TTCGTGCCACGCCTAACCTC,0,1067556
fldAp,0.2,4,4,TTCGGTAGAACCTTAGACAA,0,1173759
fldAp,0.2,4,4,TTCGGGCCTAATAGTGCGTA,0,1082897
fldAp,0.2,4,4,TTCGGGCCAAGGATTCCGCT,0,1086248
fldAp,0.2,4,4,TTCGGCTCGGAAATATTCTT,0,1135149
fldAp,0.2,4,4,TTCGGATAAGGCTTCTCCGG,0,1123223
fldAp,0.2,4,4,TTCGGACAATCCACAGTATA,0,1089218
fldAp,0.2,4,4,TTCGCTAATAAGAGTGCGAT,0,1074886
fldAp,0.2,4,4,TTCGATATAGAGTCACTCAC,0,1157204
fldAp,0.2,4,4,TTCGAATTTTGTGGTATTTC,0,1072695
fldAp,0.2,4,4,TTCGAAAGTATGGTAGATTG,0,1147456
fldAp,0.2,4,4,TTCCTTCGGGATGTACGTTT,0,1156672
fldAp,0.2,4,4,TTCCGCTACGCTTCGCTTAA,0,1121617
fldAp,0.2,4,4,TTCCGATAGCTCCACCCCTC,0,1118014
fldAp,0.2,4,4,TTCCGAATTCCGGCGTATGT,0,1162547
fldAp,0.2,4,4,TTCCCAACCTGCTAAAGGAA,0,1134177
fldAp,0.2,4,4,TTCCAGAAGGTCTTGACTGC,0,1170383
fldAp,0.2,4,4,TTCCACCGGTCAGATAGGAG,0,1094473
fldAp,0.2,4,4,TTCATTACCGGCTAGCCAGT,0,1079793
fldAp,0.2,4,4,TTCATTAACGCCAGTCCATT,0,1103037
fldAp,0.2,4,4,TTCATGGTACTGTCTCAAGC,0,1072163
fldAp,0.2,4,4,TTCATCTCAAGAGCAAGACC,0,1099154
fldAp,0.2,4,4,TTCAGATAGTACAGATGCGA,0,1071300
fldAp,0.2,4,4,TTCAGAGGCACAGGGAGCAA,0,1177898
fldAp,0.2,4,4,TTCAGACCCGTTTACACCCC,0,1076297
fldAp,0.2,4,4,TTCAAGCAAGGCTTGTCGTG,0,1127815
fldAp,0.2,4,4,TTATTAGTATCCCTTTGGTT,0,1159052
fldAp,0.2,4,4,TTATGGCCGAGAACAGCCCA,0,1176549
fldAp,0.2,4,4,TTATGGCCAAGCTCCACTCT,0,1086836
fldAp,0.2,4,4,TTATGCGGCGACAGACTACA,0,1117741
fldAp,0.2,4,4,TTATGACCAGGCCTCAACCG,0,1163782
fldAp,0.2,4,4,TTATCCCGGAGTAAAAGGCT,0,1169209
fldAp,0.2,4,4,TTATCATGAGTAGAGTTAAG,0,1077673
fldAp,0.2,4,4,TTATAGCATGCGCCAGGGAC,0,1142378
fldAp,0.2,4,4,TTATACTGGGGAAAGTATTT,0,1138565
fldAp,0.2,4,4,TTATACGTCTCAGGACCGTT,0,1129051
fldAp,0.2,4,4,TTATACGCGAACAATCAAGG,0,1078255
fldAp,0.2,4,4,TTATAAACGACTTAGGTTCT,0,1096174
fldAp,0.2,4,4,TTAGTGTATTAACGAATTAA,0,1095965
fldAp,0.2,4,4,TTAGGCACTTTAGCAATCTT,0,1158286
fldAp,0.2,4,4,TTAGGCACATCCCTTGTGCT,0,1073568
fldAp,0.2,4,4,TTAGATCAAATCTTGGTGAG,0,1104246
fldAp,0.2,4,4,TTAGAGATTGAATAGCCCCT,0,1078681
fldAp,0.2,4,4,TTACTCTGGCTTGAATAAGG,0,1106944
fldAp,0.2,4,4,TTACTAATAGACTAGAGGTC,0,1143289
fldAp,0.2,4,4,TTACGCCGGGCGAAGATCGT,0,1127834
fldAp,0.2,4,4,TTACGATCTTACTACGTTTC,0,1135773
fldAp,0.2,4,4,TTACGAACCCCAGAGGAATT,0,1104316
fldAp,0.2,4,4,TTACCTCCTCCCCGCGATAC,0,1088767
fldAp,0.2,4,4,TTACAGTGAAGACAGGGCCC,0,1112198
fldAp,0.2,4,4,TTACACTCGGACACCAGAGG,0,1090714
fldAp,0.2,4,4,TTACACGGCGAAGGCCTAAT,0,1171552
fldAp,0.2,4,4,TTACAACGAGAAGTCCGAAT,0,1120188
fldAp,0.2,4,4,TTAAGTTACTTTCGTGGTTA,0,1093660
fldAp,0.2,4,4,TTAAGTCCCTTAGAGACGCT,0,1075432
fldAp,0.2,4,4,TTAACAGGGCACCGGATAAA,0,1168902
fldAp,0.2,4,4,TTAAATACGCCAACCAAGAG,0,1157735
fldAp,0.2,4,4,TTAAATAACCATATGACCCA,0,1154034
fldAp,0.2,4,4,TGTTTTTGTTTGATCGGTTA,0,1112287
fldAp,0.2,4,4,TGTTTTCTTGTGGCCCAAAC,0,1174915
fldAp,0.2,4,4,TGTTGTCGAGGAACCTAGAC,0,1131299
fldAp,0.2,4,4,TGTTGGCACGTCATGGGACG,0,1133488
fldAp,0.2,4,4,TGTTCCGTACGCACAAAGGA,0,1143756
fldAp,0.2,4,4,TGTTCCCAACTTTAAAGGAC,0,1145736
fldAp,0.2,4,4,TGTTAACGTTCGTGCAAATC,0,1106292
fldAp,0.2,4,4,TGTGTTGGAGATGATGCTAA,0,1185282
fldAp,0.2,4,4,TGTGTTAGTCACCGGGACAC,0,1107980
fldAp,0.2,4,4,TGTGTAGCTCCATCGGAAGT,0,1159921
fldAp,0.2,4,4,TGTGGTTAAGAGCAACCACT,0,1143121
fldAp,0.2,4,4,TGTGGTCGGCACCGGCCACG,0,1141403
fldAp,0.2,4,4,TGTGGCGGCTTGCTGACTCA,0,1166730
fldAp,0.2,4,4,TGTGCGTTAAGTCACGGTAT,0,1112087
fldAp,0.2,4,4,TGTGCGCGTGGAATGCTGTA,0,1173558
fldAp,0.2,4,4,TGTGCGACCGACGGGACGCA,0,1127718
fldAp,0.2,4,4,TGTGCCGCGTTCCACCAGGC,0,1144939
fldAp,0.2,4,4,TGTGCAACGGGGCTCCCGAA,0,1067618
fldAp,0.2,4,4,TGTCTGGTTGGGAGTACGTA,0,1121058
fldAp,0.2,4,4,TGTCTGACTATCGTTCAAAT,0,1136205
fldAp,0.2,4,4,TGTCTCCTGCTTTGGGTCGT,0,1100156
fldAp,0.2,4,4,TGTCTCCAATTATCTGTCCC,0,1101644
fldAp,0.2,4,4,TGTCGTCGTGCTTAGACCCC,0,1168200
fldAp,0.2,4,4,TGTCGGCTATTCGCACAAAT,0,1133674
fldAp,0.2,4,4,TGTCGGCCAAATCGTACGAG,0,1156563
fldAp,0.2,4,4,TGTCCTGGAGCTCGACCGCA,0,1139049
fldAp,0.2,4,4,TGTCCCTTTGCATTTACGAT,0,1130576
fldAp,0.2,4,4,TGTCATAGAACGGTCGTTTA,0,1167696
fldAp,0.2,4,4,TGTCAGCCCGGTTTTACATG,0,1154344
fldAp,0.2,4,4,TGTCACGGCACTATACTCGT,0,1092110
fldAp,0.2,4,4,TGTCAATAGGTGCTCGTGGT,0,1098313
fldAp,0.2,4,4,TGTCAATACAGACATAGCGT,0,1111263
fldAp,0.2,4,4,TGTAGAGGTCCGAATAAACT,0,1086297
fldAp,0.2,4,4,TGTAGAATAGTGCCACATAA,0,1139443
fldAp,0.2,4,4,TGTACCGCGTTAATCGCAAT,0,1147088
fldAp,0.2,4,4,TGTAATCTTCTGCATATTTA,0,1144491
fldAp,0.2,4,4,TGTAAGCGATTCGAGGTCAG,0,1137398
fldAp,0.2,4,4,TGGTTTTATAGGGTCTGTTT,0,1072316
fldAp,0.2,4,4,TGGTTGAATGCATCCTATGG,0,1147816
fldAp,0.2,4,4,TGGTGGGCTTGAAAGACTGC,0,1181982
fldAp,0.2,4,4,TGGTCTCCTTGTTGTCGCTG,0,1123961
fldAp,0.2,4,4,TGGTCGGGTAGATATGTGGT,0,1095966
fldAp,0.2,4,4,TGGTCCATTTCTTAAAAATT,0,1074578
fldAp,0.2,4,4,TGGTAGTCATGGATACGCTC,0,1090109
fldAp,0.2,4,4,TGGTAGAGCTTAGCTAGGGA,0,1109156
fldAp,0.2,4,4,TGGTAACTATTCTGATACGG,0,1068748
fldAp,0.2,4,4,TGGGTAGTCGCATGCCGGCG,0,1164092
fldAp,0.2,4,4,TGGGTACCTATGGGCGAGTG,0,1070408
fldAp,0.2,4,4,TGGGGTAAGGACTTCGCCCC,0,1093495
fldAp,0.2,4,4,TGGGGGCACAGGGTGCGGAC,0,1181904
fldAp,0.2,4,4,TGGGGGAATTATCCTCTCTA,0,1064948
fldAp,0.2,4,4,TGGGGCATGGGGAAGCCCTA,0,1164141
fldAp,0.2,4,4,TGGGCACCTAAAAAATAAAC,0,1152861
fldAp,0.2,4,4,TGGGATGATTTAATAGCCAG,0,1067846
fldAp,0.2,4,4,TGGGACATGAAACTTTGGTC,0,1108141
fldAp,0.2,4,4,TGGGACAGGCTCTTTCATCC,0,1099833
fldAp,0.2,4,4,TGGCTAGATCGTATGTCCGG,0,1147448
fldAp,0.2,4,4,TGGCGCACGTATCTAGTCTC,0,1100370
fldAp,0.2,4,4,TGGCCACTTGACGCGGCTAT,0,1111068
fldAp,0.2,4,4,TGGCAGTTCAATCTCCGGGG,0,1179021
fldAp,0.2,4,4,TGGCAGTCCAGTTCTCCACT,0,1105999
fldAp,0.2,4,4,TGGCAGACTATGGCGAGAGG,0,1144341
fldAp,0.2,4,4,TGGATTGTCTCCGTGTTAAG,0,1138564
fldAp,0.2,4,4,TGGATCGCTGGGCGTTCCTT,0,1123825
fldAp,0.2,4,4,TGGAGGGCTGCATTTCACCC,0,1129119
fldAp,0.2,4,4,TGGAGATTGTGGCATAATGG,0,1154847
fldAp,0.2,4,4,TGGAGACCGAGGGTACTTTC,0,1159406
fldAp,0.2,4,4,TGGAGAAGCGTTTGCTAATG,0,1166506
fldAp,0.2,4,4,TGGACTTATTAAGACGAGAA,0,1102965
fldAp,0.2,4,4,TGGAAGACCGCGCTTCCGAC,0,1165661
fldAp,0.2,4,4,TGGAACCTTTGCTAGAGCAG,0,1102775
fldAp,0.2,4,4,TGGAACCTGGATGGTTACTC,0,1123741
fldAp,0.2,4,4,TGCTTTTTTACTGTATATAC,0,1068327
fldAp,0.2,4,4,TGCTTGCTGTGCAACTCGCA,0,1147311
fldAp,0.2,4,4,TGCTGTCCTGGTGGCCGAGT,0,1136345
fldAp,0.2,4,4,TGCTGGCAAAATTACGGGCT,0,1186793
fldAp,0.2,4,4,TGCTGCCGGCTGTGTTATCA,0,1072035
fldAp,0.2,4,4,TGCTGAAAAAATTCCCCACG,0,1137923
fldAp,0.2,4,4,TGCTCTAGCCTGACCCGCTT,0,1149977
fldAp,0.2,4,4,TGCGTACTGTCCATACTCGC,0,1183530
fldAp,0.2,4,4,TGCGTAATCTTCGCTATAAC,0,1142293
fldAp,0.2,4,4,TGCGGTCCTTGGGTACAGTC,0,1115490
fldAp,0.2,4,4,TGCGATTGAAATGCGAGTGA,0,1084952
fldAp,0.2,4,4,TGCGAGGGTTTCGGCTTATG,0,1122368
fldAp,0.2,4,4,TGCCTGGTGAATGGTTCGGA,0,1149778
fldAp,0.2,4,4,TGCCTAGTAAACTGGTGCCT,0,1093083
fldAp,0.2,4,4,TGCCGGTCGCAGGGTGGTTA,0,1076602
fldAp,0.2,4,4,TGCCGGTATATGATCTTCCT,0,1145976
fldAp,0.2,4,4,TGCCGAAACCTTCGGCAGCT,0,1105465
fldAp,0.2,4,4,TGCCCTATTGAACGTTGCAC,0,1076624
fldAp,0.2,4,4,TGCCCGGATGTCGCGAAAGG,0,1068629
fldAp,0.2,4,4,TGCCCCTTTGGAGAGAGGCT,0,1104697
fldAp,0.2,4,4,TGCCAGGGGTGATTGGACGA,0,1105643
fldAp,0.2,4,4,TGCCAGCTTATAAGGGCGGG,0,1064361
fldAp,0.2,4,4,TGCCAGACGCGTAGCTGCTG,0,1066635
fldAp,0.2,4,4,TGCATGTCAACGTAGTAAGA,0,1101913
fldAp,0.2,4,4,TGCATAGAAAGCTTCTTTTG,0,1145196
fldAp,0.2,4,4,TGCACGATTTCTTACTCAGT,0,1167691
fldAp,0.2,4,4,TGCACAGGGGGGCCGTTTTA,0,1120966
fldAp,0.2,4,4,TGCAAGGTTCCAGGCGGTGG,0,1096336
fldAp,0.2,4,4,TGCAACCATGTTTATGCGAT,0,1097315
fldAp,0.2,4,4,TGCAAAAAACGGGAGGGTCA,0,1148813
fldAp,0.2,4,4,TGATGTAGTACTAGCGGATT,0,1173536
fldAp,0.2,4,4,TGATCGCTCCGATGCCGGCT,0,1138358
fldAp,0.2,4,4,TGATCGAGTATAGTTCTTTA,0,1178487
fldAp,0.2,4,4,TGATCGAGCTTTATTCGGCG,0,1092548
fldAp,0.2,4,4,TGATAAGGCGAAGGCGACAA,0,1122402
fldAp,0.2,4,4,TGAGTTACGGAGGAAGAATG,0,1074247
fldAp,0.2,4,4,TGAGGGGTAGTTTCGGGTTT,0,1085319
fldAp,0.2,4,4,TGAGGAGAGATCTCACCTTA,0,1127336
fldAp,0.2,4,4,TGAGGACTCCAGATTTCACT,0,1090784
fldAp,0.2,4,4,TGAGCCTAGTGTTCATGGAG,0,1147353
fldAp,0.2,4,4,TGAGATTTAACCGTCATACG,0,1072055
fldAp,0.2,4,4,TGAGACCGCAGGTCCGCTAC,0,1089294
fldAp,0.2,4,4,TGACTCTCATTAATTGTAAA,0,1118009
fldAp,0.2,4,4,TGACTCACCGGTGGGCTGCA,0,1090330
fldAp,0.2,4,4,TGACGGCAAATGTAATCTGC,0,1179273
fldAp,0.2,4,4,TGACCTTATGGTCAAATGTT,0,1151627
fldAp,0.2,4,4,TGACCACTGCAGTAATTGAA,0,1101741
fldAp,0.2,4,4,TGAATGCTCAAGTGATTTAT,0,1160788
fldAp,0.2,4,4,TGAATCAGTTCACAAGGGTT,0,1173115
fldAp,0.2,4,4,TGAAGTTGTGAAAGGTGCTT,0,1143308
fldAp,0.2,4,4,TGAACCGACAACCATGATTC,0,1097513
fldAp,0.2,4,4,TGAAAGTTCGTCCTTCCGAT,0,1126682
fldAp,0.2,4,4,TCTTTACGTTGCCATCGGTC,0,1082306
fldAp,0.2,4,4,TCTTGGGAGATCCCCCGCGA,0,1182690
fldAp,0.2,4,4,TCTTCTACCTTCGATTCAAC,0,1134349
fldAp,0.2,4,4,TCTTCCCCATGCCGGTCCTT,0,1185983
fldAp,0.2,4,4,TCTTCATCGACGTCTAAATA,0,1171990
fldAp,0.2,4,4,TCTTCAGCTTGAGCATTCGT,0,1103812
fldAp,0.2,4,4,TCTTACACCGTATTGGAATG,0,1144122
fldAp,0.2,4,4,TCTGTGCTGCATTGGTTCGG,0,1102069
fldAp,0.2,4,4,TCTGTCTTGCTAAGCAGGAT,0,1097356
fldAp,0.2,4,4,TCTGTAGTTTCTATAAGTCG,0,1093595
fldAp,0.2,4,4,TCTGGTTAAAGTGTTACGGC,0,1140402
fldAp,0.2,4,4,TCTGCACCCCGGTCCGAGAA,0,1070838
fldAp,0.2,4,4,TCTGCAACTAGGCCGTATTA,0,1152952
fldAp,0.2,4,4,TCTGAGCAATCAGTCAATGT,0,1175929
fldAp,0.2,4,4,TCTGACTTCGCGGAGGGAAA,0,1145382
fldAp,0.2,4,4,TCTGAAGGGGTCTTTGGAGA,0,1130291
fldAp,0.2,4,4,TCTGAAGGCCCCGGGAACTG,0,1135335
fldAp,0.2,4,4,TCTCTGCTTAAGACATCACT,0,1077680
fldAp,0.2,4,4,TCTCGAGTAATTAGCTACCT,0,1133156
fldAp,0.2,4,4,TCTCATTCAGCGTCAATCGA,0,1156215
fldAp,0.2,4,4,TCTCATCGCAAGCCAAGATA,0,1111643
fldAp,0.2,4,4,TCTCAGAGCTGGCTGAGTGG,0,1152134
fldAp,0.2,4,4,TCTCACAATGATTCCAGTGG,0,1085406
fldAp,0.2,4,4,TCTAGTTATTCAGTCTAAAT,0,1114507
fldAp,0.2,4,4,TCTAGAGACATTCTCCACAA,0,1167872
fldAp,0.2,4,4,TCTACGCTTCCGGGAAACAG,0,1132177
fldAp,0.2,4,4,TCTACCAGATCCGGCCTCCG,0,1127977
fldAp,0.2,4,4,TCTAAGGTTCACACTAATTT,0,1111954
fldAp,0.2,4,4,TCTAACAGGGGTATCAAAGG,0,1143541
fldAp,0.2,4,4,TCTAAATTCGCGCGGCCGCG,0,1112729
fldAp,0.2,4,4,TCGTTTTCTGGCAGTGTCTC,0,1175625
fldAp,0.2,4,4,TCGTTGGCAATTTTTTGGAC,0,1086625
fldAp,0.2,4,4,TCGTTGAAAGCGACGCAATC,0,1095234
fldAp,0.2,4,4,TCGTGCCGCAACCTGTGAGA,0,1104476
fldAp,0.2,4,4,TCGTGACGTGGTAAATCGAA,0,1149522
fldAp,0.2,4,4,TCGTCACCGGCAAAAGTGCT,0,1163007
fldAp,0.2,4,4,TCGTCAAGGAAAGTCATTTG,0,1089367
fldAp,0.2,4,4,TCGTAGGGCCGTTAAGTTAT,0,1137138
fldAp,0.2,4,4,TCGTACAGTCAGTCCTGTAA,0,1134654
fldAp,0.2,4,4,TCGTAATCTAGAGAAGCTGG,0,1093110
fldAp,0.2,4,4,TCGGTTTGTCGCTCCTACGT,0,1145189
fldAp,0.2,4,4,TCGGTCAGACAGGCGTCCTA,0,1131555
fldAp,0.2,4,4,TCGGGTGAATGAAATGTTCA,0,1081677
fldAp,0.2,4,4,TCGGGTCGGGTCGGACGCTT,0,1068298
fldAp,0.2,4,4,TCGGGCCTTTTTTGAACGGT,0,1122293
fldAp,0.2,4,4,TCGGCTCATCACCACACGTG,0,1120995
fldAp,0.2,4,4,TCGGCGGTTGGCCGACCACA,0,1176090
fldAp,0.2,4,4,TCGGCCATGTGTGTACATGA,0,1082991
fldAp,0.2,4,4,TCGGATCCGCAGCATCTTAT,0,1117467
fldAp,0.2,4,4,TCGGAGAGATCCCCTTCGTG,0,1119118
fldAp,0.2,4,4,TCGCTTTGTCAATCAACTAA,0,1130413
fldAp,0.2,4,4,TCGCTTGTTTAGACATTGAC,0,1092869
fldAp,0.2,4,4,TCGCTTATCGTAGATTCGTA,0,1075657
fldAp,0.2,4,4,TCGCGCTCTACTGAACCAGA,0,1084993
fldAp,0.2,4,4,TCGCCATCGTAATTAACTGA,0,1073611
fldAp,0.2,4,4,TCGCATGGTTTACGTTTTTC,0,1157452
fldAp,0.2,4,4,TCGCATGCACAACTATAACA,0,1101989
fldAp,0.2,4,4,TCGCAGATAACGTAGAGACA,0,1071933
fldAp,0.2,4,4,TCGCACAGCAGGTGTCAGGG,0,1134952
fldAp,0.2,4,4,TCGCAAAGGCACTGCTCTAG,0,1165528
fldAp,0.2,4,4,TCGATTGGGAATGAGAATAG,0,1165154
fldAp,0.2,4,4,TCGATGCGCGCGGGCTCGTC,0,1153678
fldAp,0.2,4,4,TCGATCAAATTTAAGAGACG,0,1087326
fldAp,0.2,4,4,TCGATACAGTGACATGAAGT,0,1143796
fldAp,0.2,4,4,TCGAGATGCAAGGACGTTCC,0,1099399
fldAp,0.2,4,4,TCGACTCATGACCAGAACCA,0,1182625
fldAp,0.2,4,4,TCGACAACTCACACGTATAA,0,1076479
fldAp,0.2,4,4,TCGAATCGTAGGCAAGGTAA,0,1070845
fldAp,0.2,4,4,TCCTTTATACGCCTCGCTGG,0,1138737
fldAp,0.2,4,4,TCCTTCACACGTGTTCAAAT,0,1099613
fldAp,0.2,4,4,TCCTGTTTTTATTTTGGGAA,0,1131608
fldAp,0.2,4,4,TCCTGTTCGTAAAGTATGCT,0,1091135
fldAp,0.2,4,4,TCCTCCCTTGAGTAATGGCA,0,1094456
fldAp,0.2,4,4,TCCTCATCTTCTTCGCAACT,0,1183667
fldAp,0.2,4,4,TCCGGATGGTTCCCGGATCC,0,1064697
fldAp,0.2,4,4,TCCGGAGCCAGCTTGTGGGG,0,1160641
fldAp,0.2,4,4,TCCGGAAATAAGGTAGGGGG,0,1090224
fldAp,0.2,4,4,TCCGCTCTTCTCCAAACTCT,0,1166330
fldAp,0.2,4,4,TCCGCACTTGTCGGGGTTCA,0,1149607
fldAp,0.2,4,4,TCCGCACTACTCGTCGGACG,0,1150882
fldAp,0.2,4,4,TCCGCAAGGGTAAATAGACC,0,1140671
fldAp,0.2,4,4,TCCGATAAGTTTGAGCCTTG,0,1158970
fldAp,0.2,4,4,TCCCGTCTTGAGCCCTCTCC,0,1150948
fldAp,0.2,4,4,TCCCCCTCGACGGTTCTGCA,0,1143533
fldAp,0.2,4,4,TCCAGGTGATGGAGTGGAGA,0,1142802
fldAp,0.2,4,4,TCCAGGATGGCCCTAAATTG,0,1160533
fldAp,0.2,4,4,TCCACTGCAGTTCGTGAGGT,0,1178894
fldAp,0.2,4,4,TCCAATCATGGCAGGTTACA,0,1098228
fldAp,0.2,4,4,TCATTCCAGCATTAGCTTCT,0,1081064
fldAp,0.2,4,4,TCATGCGTTACCTCTGGCGA,0,1142023
fldAp,0.2,4,4,TCATGCACGCTGGAAGCTAT,0,1168331
fldAp,0.2,4,4,TCATGAGGATTAGCGTTGCG,0,1088602
fldAp,0.2,4,4,TCATGAGAAACTCATCCGCG,0,1141453
fldAp,0.2,4,4,TCATCTGTTTGAGGCTACAG,0,1079974
fldAp,0.2,4,4,TCATCGCTCGCCGCAGTTCT,0,1182143
fldAp,0.2,4,4,TCATCAACCTGATAAATATC,0,1063057
fldAp,0.2,4,4,TCATATCGCCGGCGTGGAAT,0,1095951
fldAp,0.2,4,4,TCATATACCCCCGTAACAAA,0,1088262
fldAp,0.2,4,4,TCATACGACCGAACTTTTAG,0,1072902
fldAp,0.2,4,4,TCATACCTGCCGCTCTTCGT,0,1101891
fldAp,0.2,4,4,TCATACCGGGGAGACTGTAA,0,1151494
fldAp,0.2,4,4,TCAGTGCACATCCAATGCTA,0,1098297
fldAp,0.2,4,4,TCAGGGCGCCATTGCGCTAA,0,1179923
fldAp,0.2,4,4,TCAGGGAAATGACTTGTCCA,0,1082777
fldAp,0.2,4,4,TCAGCTATGTTTCCCTGTCT,0,1161580
fldAp,0.2,4,4,TCAGCGGCGTTTTAAGGTGA,0,1094939
fldAp,0.2,4,4,TCAGCCAATACAAGTTTTGT,0,1178232
fldAp,0.2,4,4,TCAGACTACCCTTTGACCTT,0,1084390
fldAp,0.2,4,4,TCAGACAGCAATTCATATAC,0,1072817
fldAp,0.2,4,4,TCACTTCGTTCCTACGGCCT,0,1095601
fldAp,0.2,4,4,TCACTGGACTTAAGCGTGCT,0,1120619
fldAp,0.2,4,4,TCACTGGAAGCCGTACGTCA,0,1180701
fldAp,0.2,4,4,TCACGCATGGTTGCTACAGC,0,1175624
fldAp,0.2,4,4,TCACGCAGTGATAATGGCTA,0,1141418
fldAp,0.2,4,4,TCACGAGAGTCACCCTGGCT,0,1170684
fldAp,0.2,4,4,TCACCTATGCATACCTTGAT,0,1173225
fldAp,0.2,4,4,TCACATCGTTTGCAGCTGGG,0,1071688
fldAp,0.2,4,4,TCACACCTGGGGGAGCATAT,0,1111841
fldAp,0.2,4,4,TCAATTTAGACTAGCTTCGC,0,1136026
fldAp,0.2,4,4,TCAATCGTCTCCCAAACCAC,0,1141833
fldAp,0.2,4,4,TCAAGTTTATTAATTTTTTG,0,1071586
fldAp,0.2,4,4,TCAAGTCGTAATAATAGACG,0,1157353
fldAp,0.2,4,4,TCAAGCGGCTCAGAGTCGGA,0,1176491
fldAp,0.2,4,4,TCAAGCCCATCTGTTAGGCC,0,1085456
fldAp,0.2,4,4,TCAAGAAGGAACTCGTCAAG,0,1122707
fldAp,0.2,4,4,TCAAAGGTGCCCGGTTGATA,0,1118940
fldAp,0.2,4,4,TCAAACGCGCCGCGCGCAAG,0,1161115
fldAp,0.2,4,4,TATTGTGGGCTATGCCTCGT,0,1167381
fldAp,0.2,4,4,TATTGCTAGGCTAGAAGTTA,0,1122727
fldAp,0.2,4,4,TATTGAGAAAGGGGACAATG,0,1124688
fldAp,0.2,4,4,TATTCGTGTCCTGGATATAC,0,1114394
fldAp,0.2,4,4,TATTCCGAAATCCGGGATCA,0,1063082
fldAp,0.2,4,4,TATTCCAATCGCTCCATCTC,0,1175852
fldAp,0.2,4,4,TATTAGTTCGATCATAAGGA,0,1087184
fldAp,0.2,4,4,TATGTTTATGAAGGAGTTTC,0,1162737
fldAp,0.2,4,4,TATGTTCACATGGGATTCGT,0,1114319
fldAp,0.2,4,4,TATGTCTCGTCAACTTGCGA,0,1113302
fldAp,0.2,4,4,TATGTCCTGATAAGAAACGG,0,1092854
fldAp,0.2,4,4,TATGTATGCCAGGTGATGTA,0,1162704
fldAp,0.2,4,4,TATGTAGCTTTACGCAGCGG,0,1111742
fldAp,0.2,4,4,TATGCCTAAGCACAGTGCCA,0,1147471
fldAp,0.2,4,4,TATGCAGTTCACAAATTCTA,0,1182127
fldAp,0.2,4,4,TATGCAATCATCCTTGATTA,0,1131674
fldAp,0.2,4,4,TATCTGGCATGTTACTCGAA,0,1073580
fldAp,0.2,4,4,TATCTCAACCGATTATAAGT,0,1088233
fldAp,0.2,4,4,TATCTAACGTACTGATTCAT,0,1183182
fldAp,0.2,4,4,TATCGTGGCGTTAGGTTAAG,0,1114708
fldAp,0.2,4,4,TATCGGAGTTTATATGGCGA,0,1093091
fldAp,0.2,4,4,TATCGCGGTTTAGAATGTTC,0,1064138
fldAp,0.2,4,4,TATATAATAAAACCGACTCT,0,1171809
fldAp,0.2,4,4,TATAGCTTGAAGTTCCGCTT,0,1184492
fldAp,0.2,4,4,TATAGAAAAATACACTAAGT,0,1129348
fldAp,0.2,4,4,TATAAGGCAAAGCACCGGCA,0,1080018
fldAp,0.2,4,4,TATAACTTCCGATTGTCTGA,0,1075343
fldAp,0.2,4,4,TATAAATGCATCTCACGGAG,0,1066718
fldAp,0.2,4,4,TAGTAGCGACTGGGGCATAT,0,1185990
fldAp,0.2,4,4,TAGGTTTATGGCTGTTCTTT,0,1082674
fldAp,0.2,4,4,TAGGTGCGCCAACCATTACT,0,1182546
fldAp,0.2,4,4,TAGGTGACACGTACTTGTTT,0,1158274
fldAp,0.2,4,4,TAGGTAAGTATGTTGGTAAC,0,1168753
fldAp,0.2,4,4,TAGGTAACGTGCGGGTATAT,0,1104991
fldAp,0.2,4,4,TAGGGGGGTGGGTCTATACG,0,1120043
fldAp,0.2,4,4,TAGGGACCAGATCCATGTAC,0,1124829
fldAp,0.2,4,4,TAGGGAAAGTTGCTGGGTAC,0,1131365
fldAp,0.2,4,4,TAGGCTGGCGTCTTAACGTA,0,1072571
fldAp,0.2,4,4,TAGGATATAAAGCGAACCTA,0,1129200
fldAp,0.2,4,4,TAGGACTGTTTATCATATAA,0,1136917
fldAp,0.2,4,4,TAGGACCGAATAACGTGTCA,0,1104205
fldAp,0.2,4,4,TAGGAACATGGATTTTGTGA,0,1122931
fldAp,0.2,4,4,TAGCTGATTCAAATACAAAT,0,1080668
fldAp,0.2,4,4,TAGCTGAGGGGGAGTGCTGA,0,1088758
fldAp,0.2,4,4,TAGCTATCTAGTGACCTATG,0,1072267
fldAp,0.2,4,4,TAGCGGTCCGAAAAAGGTGA,0,1119854
fldAp,0.2,4,4,TAGCGCCATCGGCTGCCAGT,0,1122100
fldAp,0.2,4,4,TAGCGACGCCCCCTGATTTT,0,1066861
fldAp,0.2,4,4,TAGCCGGGCTTTGAGTATGG,0,1090910
fldAp,0.2,4,4,TAGCCCTCACCTTAGTGGCT,0,1115825
fldAp,0.2,4,4,TAGCCCAGAGCCGTGAAGGC,0,1147626
fldAp,0.2,4,4,TAGATTTATGGAGACCCAAT,0,1112645
fldAp,0.2,4,4,TAGATTTAGCTGAAAGAAGA,0,1176739
fldAp,0.2,4,4,TAGAGGCCTGTGAGGTCGTC,0,1121351
fldAp,0.2,4,4,TAGACTCGCAAACTGGGGAG,0,1085021
fldAp,0.2,4,4,TAGACACTTTTGAATCTCTC,0,1156792
fldAp,0.2,4,4,TACTTGTCCTAGTTTCCCAC,0,1110893
fldAp,0.2,4,4,TACTTGGACATTGCGGTGTT,0,1103829
fldAp,0.2,4,4,TACTTCACCGTGTATCCTCT,0,1069571
fldAp,0.2,4,4,TACTGGGTTTGCATACAAGT,0,1114984
fldAp,0.2,4,4,TACTCGCACGCCATGCGGCC,0,1099745
fldAp,0.2,4,4,TACTCCTATTACTAGGGTCT,0,1130936
fldAp,0.2,4,4,TACTCAAGATTCCTAGAGTC,0,1142768
fldAp,0.2,4,4,TACTACGTTTAGACGCGGTA,0,1133851
fldAp,0.2,4,4,TACGTGAGATTTCTCTGATT,0,1111494
fldAp,0.2,4,4,TACGTCAACCCGAACCAGGG,0,1147822
fldAp,0.2,4,4,TACGGTGCACCATCCTGAGC,0,1078463
fldAp,0.2,4,4,TACGGTACCGTCCCCAGGCC,0,1071605
fldAp,0.2,4,4,TACGGGGGTAGATGGGCTAC,0,1078327
fldAp,0.2,4,4,TACGGGCTGATTGATGCGGG,0,1182552
fldAp,0.2,4,4,TACGGCCTGAGTGCTGATGC,0,1129861
fldAp,0.2,4,4,TACGGAACGAGTGTATGAAC,0,1167603
fldAp,0.2,4,4,TACGACGGAGAAGCAGTCAA,0,1098892
fldAp,0.2,4,4,TACGACCGTAAAGTACCACC,0,1102067
fldAp,0.2,4,4,TACCTACCGCGACACGTATC,0,1079656
fldAp,0.2,4,4,TACCGTAACAATTGCCGAAG,0,1157826
fldAp,0.2,4,4,TACCGGGGGCTGCGCTTTAG,0,1070935
fldAp,0.2,4,4,TACCGGGCGAGTTTTTTACG,0,1086978
fldAp,0.2,4,4,TACCCGCGGGCCGGTCAGAT,0,1069207
fldAp,0.2,4,4,TACATGCAAACCATGGGATG,0,1127046
fldAp,0.2,4,4,TACACGTTAGACATCACAAG,0,1173070
fldAp,0.2,4,4,TACAATGTAATTTAGTTAAT,0,1140684
fldAp,0.2,4,4,TACAAGTGAGTCTCGCCATG,0,1099053
fldAp,0.2,4,4,TAATTCGAATTTATCACCCC,0,1120982
fldAp,0.2,4,4,TAATGCGGGGTGGCTGTTCC,0,1167440
fldAp,0.2,4,4,TAATGCGCCCGCAATCTCAA,0,1092311
fldAp,0.2,4,4,TAATGAGTTGTTGGTAATCC,0,1114521
fldAp,0.2,4,4,TAATCGCCATGCGACTTATT,0,1094490
fldAp,0.2,4,4,TAATAGATAAGAGGCCGCTC,0,1109044
fldAp,0.2,4,4,TAATACTTGGAACCCTCACT,0,1099145
fldAp,0.2,4,4,TAATAACAGTGTCGTCCTGA,0,1144535
fldAp,0.2,4,4,TAAGTTTCATTGCTTCAGAC,0,1089112
fldAp,0.2,4,4,TAAGTTAAGCTTGATAGTAA,0,1143652
fldAp,0.2,4,4,TAAGTGATAACTCTAGCTCC,0,1114138
fldAp,0.2,4,4,TAAGGTGGCTTCTCCTGTAT,0,1086552
fldAp,0.2,4,4,TAAGGTGAGGCGGCCAGACA,0,1117218
fldAp,0.2,4,4,TAAGGGGTAACGGTTCACAT,0,1068944
fldAp,0.2,4,4,TAAGGGCATAGCCTTTTAAT,0,1110625
fldAp,0.2,4,4,TAAGCAATCGGGGGACCTTT,0,1129502
fldAp,0.2,4,4,TAAGAAGGCATGAGGAGTCG,0,1073918
fldAp,0.2,4,4,TAACTTGTAGACTCACAGAC,0,1183309
fldAp,0.2,4,4,TAACTGGTATGTCAGAAACG,0,1086137
fldAp,0.2,4,4,TAACTGCCCGCAAGCTAGAT,0,1169521
fldAp,0.2,4,4,TAACTCCCAGCATCCTCGGT,0,1099589
fldAp,0.2,4,4,TAACGGGCATTACGACATCT,0,1075619
fldAp,0.2,4,4,TAACGCATTTTTAAGTTCAG,0,1163672
fldAp,0.2,4,4,TAACGAACCGGGCCCAGGTT,0,1079709
fldAp,0.2,4,4,TAACCCTCGACCTATACCCT,0,1081584
fldAp,0.2,4,4,TAAATGACAATTTGGGAGCG,0,1184701
fldAp,0.2,4,4,TAAATAATATCGTTGGGAAA,0,1071136
fldAp,0.2,4,4,TAAATAAATCCGGTTCTGCT,0,1178904
fldAp,0.2,4,4,TAAAGTAGTACATCCACTTC,0,1105883
fldAp,0.2,4,4,TAAAGACTTAACCCGCGACT,0,1156354
fldAp,0.2,4,4,TAAACGGTTGACATCAATTC,0,1157540
fldAp,0.2,4,4,TAAACGGTGTCACTCGGTCC,0,1144828
fldAp,0.2,4,4,TAAACCGCACCTGTCCCACG,0,1110763
fldAp,0.2,4,4,TAAACACTAGATCGTCTTTT,0,1147820
fldAp,0.2,4,4,TAAAATCGTTATTCATTTAG,0,1150041
fldAp,0.2,4,4,TAAAATAAGAATACTGAAGA,0,1082310
fldAp,0.2,4,4,GTTTCGTCGGGTCTGTCACA,0,1151706
fldAp,0.2,4,4,GTTTCGGCATAGAAGCCTTA,0,1135483
fldAp,0.2,4,4,GTTTCGAGGTGGACGCGGAC,0,1116879
fldAp,0.2,4,4,GTTTATACTAGGATCAATCA,0,1138932
fldAp,0.2,4,4,GTTTAGTATCCTGATACTAA,0,1069315
fldAp,0.2,4,4,GTTGTTCATCCGCTTAATAA,0,1151807
fldAp,0.2,4,4,GTTGTAGTGAACACCACTAT,0,1175188
fldAp,0.2,4,4,GTTGGGAGTTACAGTCCGCT,0,1119583
fldAp,0.2,4,4,GTTGGCATGATGGACTAAGC,0,1093237
fldAp,0.2,4,4,GTTGGAATGTGTTTATGAAA,0,1074391
fldAp,0.2,4,4,GTTCTTTTGAGGTCCAAGAC,0,1097226
fldAp,0.2,4,4,GTTCTGCCCTTGAAGGCCTT,0,1175018
fldAp,0.2,4,4,GTTCTCCGTGTCGCCACTGA,0,1181990
fldAp,0.2,4,4,GTTCTAGGAGGAAAGTGTCA,0,1084458
fldAp,0.2,4,4,GTTCGTGTGAGGGCGATTTT,0,1086494
fldAp,0.2,4,4,GTTCGCGAGCGATTTCCAGG,0,1155031
fldAp,0.2,4,4,GTTCCTGACCGTTTACTGGT,0,1160873
fldAp,0.2,4,4,GTTCATTACGTGATCATGCC,0,1120940
fldAp,0.2,4,4,GTTCATACATTAATACCGTT,0,1142513
fldAp,0.2,4,4,GTTCAGGTTTAATGAATGGC,0,1066982
fldAp,0.2,4,4,GTTATTGAGAACCAGTCTGC,0,1173470
fldAp,0.2,4,4,GTTATATAAAGTGGCCGACT,0,1129904
fldAp,0.2,4,4,GTTATACTAAGGATATATCA,0,1173222
fldAp,0.2,4,4,GTTATAAGACGAACGGTCCA,0,1154485
fldAp,0.2,4,4,GTTACTTTGAACTTACGGTA,0,1076002
fldAp,0.2,4,4,GTTACTTGCCTATCTCGTTA,0,1143680
fldAp,0.2,4,4,GTTACGTGCCCCCAGGATCA,0,1176224
fldAp,0.2,4,4,GTTACGACCAAACGAACAGG,0,1124753
fldAp,0.2,4,4,GTTAATGGGTACCCAATGAG,0,1116409
fldAp,0.2,4,4,GTTAACTTGATGGTCGCGTC,0,1107284
fldAp,0.2,4,4,GTTAACCGTTTACGCTATTC,0,1184610
fldAp,0.2,4,4,GTTAAAAGGATTGACAATTG,0,1170523
fldAp,0.2,4,4,GTGTTAACTGCAAGCGTAAT,0,1097239
fldAp,0.2,4,4,GTGTGATTTGCCACACCCTT,0,1126013
fldAp,0.2,4,4,GTGTCGGGTCGAGTCGTAAT,0,1145520
fldAp,0.2,4,4,GTGTCGCTTTGTTTAAGTAG,0,1172724
fldAp,0.2,4,4,GTGTATCATGCTTCACACGA,0,1068328
fldAp,0.2,4,4,GTGGTGAAAGGATTTGGAGC,0,1130467
fldAp,0.2,4,4,GTGGTAGGACAATCGTCTAC,0,1106195
fldAp,0.2,4,4,GTGGGTGGGTGTTTTAACCC,0,1081334
fldAp,0.2,4,4,GTGGCTGTGGGCCAGTTCGC,0,1105164
fldAp,0.2,4,4,GTGGCCCCGTAGGCTTGTCA,0,1085023
fldAp,0.2,4,4,GTGGCACTGCTCAACATTCA,0,1108628
fldAp,0.2,4,4,GTGGCAAGTCCGACGAGTCC,0,1123894
fldAp,0.2,4,4,GTGGAAGATAAATAGTAACG,0,1112652
fldAp,0.2,4,4,GTGCTTGACGGAAGAAAGGT,0,1116706
fldAp,0.2,4,4,GTGCTGTGCAACTTGCTTGC,0,1141532
fldAp,0.2,4,4,GTGCTGAACGATCATGTACC,0,1080600
fldAp,0.2,4,4,GTGCTATAGAAACCCTCATC,0,1083692
fldAp,0.2,4,4,GTGCGTTCGATTTACTGGGA,0,1183009
fldAp,0.2,4,4,GTGCGTCCCCTATTTACAAC,0,1135386
fldAp,0.2,4,4,GTGCCGGTCAAATCAAATTT,0,1183588
fldAp,0.2,4,4,GTGCCGGCAGGATCACGCTC,0,1179278
fldAp,0.2,4,4,GTGCCCCTCCGGGTGACGCT,0,1163711
fldAp,0.2,4,4,GTGCCAGTCTGGACGGCGTA,0,1181607
fldAp,0.2,4,4,GTGATTTACACACAGCAAGT,0,1165857
fldAp,0.2,4,4,GTGAGTTTAAGTCCGACTAG,0,1076945
fldAp,0.2,4,4,GTGAGTGGTCCTGCAAATCT,0,1156008
fldAp,0.2,4,4,GTGAGCCAATTTGCTTTTGA,0,1101844
fldAp,0.2,4,4,GTGAGCATACGCAATTTAGT,0,1098030
fldAp,0.2,4,4,GTGAGATTAGCCGTTGGCGG,0,1065213
fldAp,0.2,4,4,GTGACACTACCTCTTTAGAT,0,1167951
fldAp,0.2,4,4,GTGAATCGAGTCACCCCCTT,0,1128354
fldAp,0.2,4,4,GTGAAATAGACTTGTATACC,0,1101477
fldAp,0.2,4,4,GTCTTACTCACTGAAAAGCC,0,1097694
fldAp,0.2,4,4,GTCTGCCATTTATCATTCTT,0,1067591
fldAp,0.2,4,4,GTCTGCAAAGGATCATCGGT,0,1101872
fldAp,0.2,4,4,GTCTCTGTGCGACGGTGCAA,0,1177054
fldAp,0.2,4,4,GTCTCAGGGAAGTGGAAGCC,0,1150582
fldAp,0.2,4,4,GTCTCAAGATTCAGCCCAGC,0,1101580
fldAp,0.2,4,4,GTCGTAATATCCAATCCCCA,0,1140464
fldAp,0.2,4,4,GTCGGTCTCGATCTAACATC,0,1163529
fldAp,0.2,4,4,GTCGGGCGTCAACTCGGACT,0,1106789
fldAp,0.2,4,4,GTCGGGCCACGGTAACATAT,0,1096918
fldAp,0.2,4,4,GTCGCCGCTCTGTGCGCAGT,0,1169162
fldAp,0.2,4,4,GTCGCAGTATAGCCCCAAGG,0,1111759
fldAp,0.2,4,4,GTCGATCTATAATGATGTAT,0,1154460
fldAp,0.2,4,4,GTCGATCGGACCCGGCATGG,0,1159640
fldAp,0.2,4,4,GTCGAATTGTGTATTCATTT,0,1165263
fldAp,0.2,4,4,GTCCTGTGCGGGAAATCTCA,0,1077008
fldAp,0.2,4,4,GTCCGCGGCGTTACCGAAAA,0,1116152
fldAp,0.2,4,4,GTCCCTGGCAGATTTTAGAG,0,1144480
fldAp,0.2,4,4,GTCCCGGTCTGATACTCTCC,0,1157108
fldAp,0.2,4,4,GTCCAGTGTAAGGTTTGGCC,0,1122362
fldAp,0.2,4,4,GTCATTCGCTTATGTTCCAG,0,1112106
fldAp,0.2,4,4,GTCATGGGGCGCTTGCCCTG,0,1069995
fldAp,0.2,4,4,GTCATCCCCGGGGCTCAGGA,0,1180265
fldAp,0.2,4,4,GTCATATACAACGTCCGTAC,0,1071902
fldAp,0.2,4,4,GTCATAGCCATTATTGTCAA,0,1117311
fldAp,0.2,4,4,GTCAGCGCTTTATTGCCATT,0,1163055
fldAp,0.2,4,4,GTCAGCCCAAAGTGGTGGTA,0,1065140
fldAp,0.2,4,4,GTCAGATTTAGCAAATAGTT,0,1089972
fldAp,0.2,4,4,GTCACTGTCGTCTACGATAC,0,1154861
fldAp,0.2,4,4,GTCACTGGGGATCCCATTTA,0,1130126
fldAp,0.2,4,4,GTCACGATCAGCGTCAGTGC,0,1114027
fldAp,0.2,4,4,GTCACCGACCCAATTTAAAA,0,1135993
fldAp,0.2,4,4,GTATTGGGTACCTACAGCCT,0,1089520
fldAp,0.2,4,4,GTATGGGACGAATCCCGATA,0,1138055
fldAp,0.2,4,4,GTATGCCCAGCGCGAGGGGA,0,1143216
fldAp,0.2,4,4,GTATGCACACGGAGCTTTCG,0,1164271
fldAp,0.2,4,4,GTATCGAGTCGCTCACCAAA,0,1181051
fldAp,0.2,4,4,GTATCCTATCCGGGATCGAA,0,1138915
fldAp,0.2,4,4,GTATATGGCGCGGGCTCTAA,0,1098325
fldAp,0.2,4,4,GTATAATATAATCTTCCCTG,0,1159798
fldAp,0.2,4,4,GTATAACGTATACTTAAAGG,0,1072040
fldAp,0.2,4,4,GTAGGTAGCACAGGCCTGAA,0,1150755
fldAp,0.2,4,4,GTAGGGCGCTTGTAAACTGA,0,1185154
fldAp,0.2,4,4,GTAGGCTTTATTAGCGCAGT,0,1155151
fldAp,0.2,4,4,GTAGCCTGATAAGATTCATA,0,1100840
fldAp,0.2,4,4,GTAGCATGGAAAAGTAAGCA,0,1089121
fldAp,0.2,4,4,GTAGCAATAACGGCGAACCA,0,1149634
fldAp,0.2,4,4,GTAGAAACCCGAAAAGAAAC,0,1137063
fldAp,0.2,4,4,GTACTTGGTCGAAGCCTTCA,0,1139955
fldAp,0.2,4,4,GTACGTTCCAGGGTGCGGCC,0,1122595
fldAp,0.2,4,4,GTACGGCTTCGGATGTTCAT,0,1183180
fldAp,0.2,4,4,GTACCATCAGTCGTAACTTA,0,1111834
fldAp,0.2,4,4,GTACATGCAAGAGGTGAAGT,0,1094814
fldAp,0.2,4,4,GTACACATCGACCGGCCGCC,0,1094352
fldAp,0.2,4,4,GTAATCTGATGACCCTCATG,0,1186945
fldAp,0.2,4,4,GTAACGCCGCACTTGATGGT,0,1177536
fldAp,0.2,4,4,GTAACATACACCCGTTAGCA,0,1157053
fldAp,0.2,4,4,GTAACACCAATTAGCTTAAT,0,1143793
fldAp,0.2,4,4,GTAAATGTCTTGCCTTCAAA,0,1175426
fldAp,0.2,4,4,GTAAACCTCGTCAGCCAGTG,0,1126877
fldAp,0.2,4,4,GTAAAACGCCTGGCATCCCT,0,1186115
fldAp,0.2,4,4,GGTTTTTTTTCTCTCCGCCT,0,1164068
fldAp,0.2,4,4,GGTTTTGATACGCGGGAGAA,0,1084861
fldAp,0.2,4,4,GGTTTGTTCTGAAGAGTCGT,0,1100888
fldAp,0.2,4,4,GGTTTCGATGTTCTAAGGGA,0,1175331
fldAp,0.2,4,4,GGTTGTTACCAACTACCACC,0,1101726
fldAp,0.2,4,4,GGTTGTGCATGACACGCTGA,0,1072665
fldAp,0.2,4,4,GGTTCACCGAGTCGCCAACC,0,1143038
fldAp,0.2,4,4,GGTTCACATGCGGCCTAGCC,0,1079917
fldAp,0.2,4,4,GGTTATCCTCGTTCTAGTAC,0,1087311
fldAp,0.2,4,4,GGTTATCAGTAATGTCATTT,0,1118828
fldAp,0.2,4,4,GGTTACACCAGGCGAAACCA,0,1136913
fldAp,0.2,4,4,GGTGTTACGGCTTCACAATA,0,1075325
fldAp,0.2,4,4,GGTGTCCACGCACCCTATTT,0,1078245
fldAp,0.2,4,4,GGTGATTGTTTGGTTAGCTC,0,1164339
fldAp,0.2,4,4,GGTGATTATAGTCACTCTTT,0,1105456
fldAp,0.2,4,4,GGTCTGAGGAAATCGTCATC,0,1176333
fldAp,0.2,4,4,GGTCTGACTTTGCGCCTTCA,0,1173767
fldAp,0.2,4,4,GGTCGTGCTGCTTGAAAGGT,0,1084165
fldAp,0.2,4,4,GGTCGCTTCGGCACCGGCAT,0,1115236
fldAp,0.2,4,4,GGTCGCGGTCCTTAGTGGCT,0,1175673
fldAp,0.2,4,4,GGTCCTGGAGGGATGCTCTT,0,1107289
fldAp,0.2,4,4,GGTCCTCATGCACTACAAAT,0,1082819
fldAp,0.2,4,4,GGTCCGGGACGGCACGTGAA,0,1128662
fldAp,0.2,4,4,GGTCCGATTGATAGCGACTT,0,1075465
fldAp,0.2,4,4,GGTCCCCGTCAACGCACTGT,0,1176822
fldAp,0.2,4,4,GGTCCACGGAGAATAGCCCA,0,1081674
fldAp,0.2,4,4,GGTCAGTCAGACGTAGTGCC,0,1083219
fldAp,0.2,4,4,GGTCACAAGTTCCGGTTCTT,0,1177002
fldAp,0.2,4,4,GGTCAAGGCTAGAAAGGAGA,0,1143227
fldAp,0.2,4,4,GGTCAAATTATTAAAATGTT,0,1065830
fldAp,0.2,4,4,GGTATAGAATCAAGCCGCAA,0,1081033
fldAp,0.2,4,4,GGTAGCGACAATGTCGATGA,0,1113596
fldAp,0.2,4,4,GGTACTCCTGAATACAAGAA,0,1160101
fldAp,0.2,4,4,GGTAAGTGTTATATAGGTTG,0,1113291
fldAp,0.2,4,4,GGTAACTACATCTGTGTCGT,0,1137886
fldAp,0.2,4,4,GGGTTTATAGTAATCGGGCA,0,1102766
fldAp,0.2,4,4,GGGTTTAAAAAAGACCTGGG,0,1136806
fldAp,0.2,4,4,GGGTTGTTAGCCACTCGCCA,0,1129932
fldAp,0.2,4,4,GGGTTCTGCCAGGTCGCTCC,0,1071254
fldAp,0.2,4,4,GGGTGCGGTCGTAACTTGAC,0,1111131
fldAp,0.2,4,4,GGGTGCGACCAGAGTTCAGC,0,1135531
fldAp,0.2,4,4,GGGTGCCCATTCTCAAAAAT,0,1160755
fldAp,0.2,4,4,GGGTCATTATAACCTTGGGG,0,1129755
fldAp,0.2,4,4,GGGTAGTGTGACTCGTCAAG,0,1103609
fldAp,0.2,4,4,GGGTACGTGCAATCCTGGTC,0,1128035
fldAp,0.2,4,4,GGGGGTGGGAAAACCTTCTT,0,1132414
fldAp,0.2,4,4,GGGGGTCGCCCTTGGTAGGG,0,1105327
fldAp,0.2,4,4,GGGGGGTGTAATTACGAATG,0,1123375
fldAp,0.2,4,4,GGGGGCGTGTAGAATGGGGG,0,1173623
fldAp,0.2,4,4,GGGGGATAACCGAGGAGGAT,0,1132779
fldAp,0.2,4,4,GGGGGAGAGTAACACACTGG,0,1089923
fldAp,0.2,4,4,GGGGGACTGAGAATTAGAGC,0,1105391
fldAp,0.2,4,4,GGGGGACCCGCCGTGTTCTA,0,1186310
fldAp,0.2,4,4,GGGGAGTGCTAATGGCGCAA,0,1150713
fldAp,0.2,4,4,GGGGAGCCTGCCAGAATATT,0,1069582
fldAp,0.2,4,4,GGGGAACATGCATTAGCGCA,0,1120572
fldAp,0.2,4,4,GGGCTTTATTGGGCAGGAAC,0,1164335
fldAp,0.2,4,4,GGGCGTGTCCCTATGAACGC,0,1098968
fldAp,0.2,4,4,GGGCGGGATCACTACTTGTT,0,1138927
fldAp,0.2,4,4,GGGCGGACGCAGAAATGTCT,0,1126633
fldAp,0.2,4,4,GGGCGCTTCGGTTCCACGTG,0,1102008
fldAp,0.2,4,4,GGGCGCGGGCAAACCTACCC,0,1145933
fldAp,0.2,4,4,GGGCGCATGGCTAATTACAA,0,1184185
fldAp,0.2,4,4,GGGCGAAACGCCTGCATCCG,0,1096898
fldAp,0.2,4,4,GGGCCTAACCCATAGTGATA,0,1166511
fldAp,0.2,4,4,GGGCCGCAGTTTAATCGTCC,0,1136441
fldAp,0.2,4,4,GGGCATGTCTACCGCAAGTA,0,1167703
fldAp,0.2,4,4,GGGCATATTGCTAATGGCAA,0,1138919
fldAp,0.2,4,4,GGGCATACCTTAAGTTGTAT,0,1176152
fldAp,0.2,4,4,GGGCAGACACTGACGATGCA,0,1143670
fldAp,0.2,4,4,GGGATGATCCATTCCCCAGG,0,1135385
fldAp,0.2,4,4,GGGATGAAGTGAGCAGCATT,0,1081401
fldAp,0.2,4,4,GGGATCCGAACTCTATATAC,0,1143919
fldAp,0.2,4,4,GGGATCAAGAAAGTCTATCT,0,1101225
fldAp,0.2,4,4,GGGATATAAAGGTATACTGT,0,1154577
fldAp,0.2,4,4,GGGATAAACCGAAGCACTGA,0,1124954
fldAp,0.2,4,4,GGGAGCTATCGAAGAGTGAC,0,1145227
fldAp,0.2,4,4,GGGAGAAGTTGTATAGGGAG,0,1137949
fldAp,0.2,4,4,GGGACAAATCACTTAATTGC,0,1133089
fldAp,0.2,4,4,GGGAATGACCTGTTAATTAA,0,1161081
fldAp,0.2,4,4,GGGAACGACGTATAGGGAGA,0,1097755
fldAp,0.2,4,4,GGCTTTCAGCTTCGAGACGA,0,1065387
fldAp,0.2,4,4,GGCTTGCTTCTCACGCTTGT,0,1155210
fldAp,0.2,4,4,GGCTTGCGCCTACGAGGAAC,0,1182144
fldAp,0.2,4,4,GGCTGTCGTTGGTTGCGGGA,0,1173389
fldAp,0.2,4,4,GGCTGGAATGCCTAATTAGT,0,1157162
fldAp,0.2,4,4,GGCTCTAGCAAGGGTCCGAT,0,1111653
fldAp,0.2,4,4,GGCTATACAGCTTTTACCGG,0,1171812
fldAp,0.2,4,4,GGCTAGGAGTGATTTGCTGT,0,1154357
fldAp,0.2,4,4,GGCGTTATGTGCACATGTTA,0,1072698
fldAp,0.2,4,4,GGCGGTCGAGTTATCACGGA,0,1139047
fldAp,0.2,4,4,GGCGCCACTGATATCAGTAT,0,1073200
fldAp,0.2,4,4,GGCGCATGTTGTTCTACTCA,0,1160661
fldAp,0.2,4,4,GGCGAGTAGCGGTCCTAAGA,0,1177367
fldAp,0.2,4,4,GGCGAGGGACACGCCCCGCT,0,1118159
fldAp,0.2,4,4,GGCGAACCATCAGAATCTCA,0,1186097
fldAp,0.2,4,4,GGCCTTTAGTATCATATACT,0,1112746
fldAp,0.2,4,4,GGCCTTGTCGTAATAACATT,0,1178982
fldAp,0.2,4,4,GGCCTGCAAATGCGACGGGT,0,1099353
fldAp,0.2,4,4,GGCCTCCGCTTCTCGCCACC,0,1161430
fldAp,0.2,4,4,GGCCGTAGGCTCTCCCCTGT,0,1117687
fldAp,0.2,4,4,GGCCGGCTACATAAAAGATT,0,1089542
fldAp,0.2,4,4,GGCCGCTTAATCCCGTCGAC,0,1164885
fldAp,0.2,4,4,GGCCCTGTACATAGCTCCAC,0,1152138
fldAp,0.2,4,4,GGCCCTCGCGTCATGGGAAT,0,1083741
fldAp,0.2,4,4,GGCCCTCAACCGACAGGGCA,0,1181504
fldAp,0.2,4,4,GGCCCGGGCAAAATCCGGGT,0,1098007
fldAp,0.2,4,4,GGCCCATTAATTCATGTTAT,0,1155632
fldAp,0.2,4,4,GGCCCATGGGGAAGATTACG,0,1073442
fldAp,0.2,4,4,GGCCCATATAAAGGCTTCAT,0,1185583
fldAp,0.2,4,4,GGCCAACGCTCATTCTGGCA,0,1132527
fldAp,0.2,4,4,GGCATTTCCTGGCGGGACGG,0,1069782
fldAp,0.2,4,4,GGCATGCTGAGCGGTTAGGT,0,1138852
fldAp,0.2,4,4,GGCATGCGGCTTTTATTGTT,0,1127078
fldAp,0.2,4,4,GGCATCACAAGCTCTAGCCA,0,1069990
fldAp,0.2,4,4,GGCAGTGATCGTATTTAGCT,0,1130393
fldAp,0.2,4,4,GGCAGTACCAGCCTCGGGTT,0,1079239
fldAp,0.2,4,4,GGCAGCATTTACTGTTCAGC,0,1102721
fldAp,0.2,4,4,GGCAGAGGTGGACCGGAGAC,0,1164571
fldAp,0.2,4,4,GGCACGGCGTCTCGAATGCA,0,1165683
fldAp,0.2,4,4,GGCACACTGCGCTCTGCTCA,0,1123314
fldAp,0.2,4,4,GGCAATGTAACTTTCAAGGG,0,1131819
fldAp,0.2,4,4,GGCAAGGATTCGCGCCCAGT,0,1163722
fldAp,0.2,4,4,GGCAAGCATTGCTCAACACC,0,1148619
fldAp,0.2,4,4,GGCAACACTCGCGGGAAATG,0,1135938
fldAp,0.2,4,4,GGATTCCTCTTCATCGTATT,0,1083073
fldAp,0.2,4,4,GGATTCCCACCCGGAAATTG,0,1071920
fldAp,0.2,4,4,GGATTACAGAACAAGCTCGC,0,1180544
fldAp,0.2,4,4,GGATTAACTTGGATTTTGGG,0,1152626
fldAp,0.2,4,4,GGATCGTTACTTCAGCGGTG,0,1180336
fldAp,0.2,4,4,GGATAAAGGATTGCGGATCA,0,1108857
fldAp,0.2,4,4,GGAGTAGTTGCTAGTCCCAG,0,1141616
fldAp,0.2,4,4,GGAGTACGCAAGGTAAAAAG,0,1095033
fldAp,0.2,4,4,GGAGGGCCACGTGGTGGCCA,0,1160235
fldAp,0.2,4,4,GGAGGGCAATCAACGCCAGC,0,1185407
fldAp,0.2,4,4,GGAGGCTCTGAAACGTCTAG,0,1132778
fldAp,0.2,4,4,GGAGCTACACTGGTCCGCCA,0,1139420
fldAp,0.2,4,4,GGAGACACCCACGACGATCG,0,1106502
fldAp,0.2,4,4,GGAGAATCCTGAGCGGAAAC,0,1175854
fldAp,0.2,4,4,GGACTGTTGGATCGCCAGGA,0,1181786
fldAp,0.2,4,4,GGACTGGATGAGTACTTCTA,0,1112527
fldAp,0.2,4,4,GGACACATCTTGATATCGCA,0,1070606
fldAp,0.2,4,4,GGAATGGTTCGCTATGGTCT,0,1102341
fldAp,0.2,4,4,GGAATCCATATTGTACAGTC,0,1183298
fldAp,0.2,4,4,GGAATCATGTGTAACGAGTA,0,1083138
fldAp,0.2,4,4,GGAAGAGTTCCGCGGACCAA,0,1140139
fldAp,0.2,4,4,GGAACTTGGGACTTTAGCGC,0,1075236
fldAp,0.2,4,4,GGAAATTGCCGGCACGGTAG,0,1120417
fldAp,0.2,4,4,GGAAATCGCCCGATTAGGCT,0,1077053
fldAp,0.2,4,4,GGAAAAGGACCGGTTAAGGC,0,1122345
fldAp,0.2,4,4,GCTTTTTGTTGAAATATTGC,0,1088759
fldAp,0.2,4,4,GCTTTTACTTCATTCGCCAA,0,1154704
fldAp,0.2,4,4,GCTTTGTTAGGCGAATATGC,0,1123851
fldAp,0.2,4,4,GCTTTACCGAATCCCTGTGG,0,1137452
fldAp,0.2,4,4,GCTTTAACGGGAGCACGGTT,0,1068049
fldAp,0.2,4,4,GCTTGTGGTCATAATATCAA,0,1131131
fldAp,0.2,4,4,GCTTGCCAGCAGTCCTGATA,0,1152903
fldAp,0.2,4,4,GCTTCTTTAGAAACTGATTA,0,1069480
fldAp,0.2,4,4,GCTGTTTACTGCAGTCCCTC,0,1154784
fldAp,0.2,4,4,GCTGTATAAGAGGGTGTACT,0,1097117
fldAp,0.2,4,4,GCTGGCCGTGTGCGTTGATG,0,1074619
fldAp,0.2,4,4,GCTGCGCATACAACGAACTA,0,1069481
fldAp,0.2,4,4,GCTGCAATTAGTTCAGCCGG,0,1119802
fldAp,0.2,4,4,GCTGATGCGGATGTGGCTGA,0,1180270
fldAp,0.2,4,4,GCTGAGTGGGCCGCAGGCGA,0,1122113
fldAp,0.2,4,4,GCTGACGGAGGGAGTAGGGG,0,1158074
fldAp,0.2,4,4,GCTGACAAAATTCTCAGCTA,0,1066752
fldAp,0.2,4,4,GCTCTTTTCGCTTCTCTTAT,0,1180528
fldAp,0.2,4,4,GCTCGTACCGTCTCGAGATT,0,1127580
fldAp,0.2,4,4,GCTCGATGCAGGCGGCTATG,0,1180954
fldAp,0.2,4,4,GCTCGACTGCCATTGTTGTA,0,1177074
fldAp,0.2,4,4,GCTCCGTCGAATAAACAAGA,0,1147765
fldAp,0.2,4,4,GCTCCGTCCTCACCTTAAGG,0,1106349
fldAp,0.2,4,4,GCTCCAGTGCTTGAGGTCAG,0,1172642
fldAp,0.2,4,4,GCTCCAGGCGCGGGGATCGA,0,1070587
fldAp,0.2,4,4,GCTCATTTTGAGTACCTTTT,0,1072418
fldAp,0.2,4,4,GCTCATTCTGCAGGTTGAAC,0,1094512
fldAp,0.2,4,4,GCTCATAATCTCAACATGCG,0,1104307
fldAp,0.2,4,4,GCTCAGCCGGGTCAACAACA,0,1090116
fldAp,0.2,4,4,GCTCACACAAGCTCTTGCTC,0,1136178
fldAp,0.2,4,4,GCTATTACTATCTATCACTG,0,1093092
fldAp,0.2,4,4,GCTATCTTCTCCAATCGCCA,0,1145566
fldAp,0.2,4,4,GCTACCGCAGCAAGGGATGT,0,1080992
fldAp,0.2,4,4,GCTACAATCTTTTCCAAGAT,0,1168761
fldAp,0.2,4,4,GCGTTTGTAAAAATACAATA,0,1077357
fldAp,0.2,4,4,GCGTGTCAGTGCTGTGGTAG,0,1111658
fldAp,0.2,4,4,GCGTCTGTCTAGCACGCTCA,0,1091340
fldAp,0.2,4,4,GCGTCGCCGGGGGTCGGCCT,0,1162232
fldAp,0.2,4,4,GCGTATCTGGCTATGACAGT,0,1102346
fldAp,0.2,4,4,GCGTAGGCCGACAGATTGCC,0,1130381
fldAp,0.2,4,4,GCGTACTCGTACACGCAAGT,0,1173080
fldAp,0.2,4,4,GCGGTTCATCGCTTCGTATC,0,1114164
fldAp,0.2,4,4,GCGGTCGGGAGTTAACTCAA,0,1104762
fldAp,0.2,4,4,GCGGGATTGGGGTACCGGGC,0,1126726
fldAp,0.2,4,4,GCGGCTGGAACAAAAACATG,0,1136915
fldAp,0.2,4,4,GCGGATATAACAATATCCTT,0,1145754
fldAp,0.2,4,4,GCGGATAGTGTTCCCGGGAT,0,1133495
fldAp,0.2,4,4,GCGGAGAGTGAGAGACATCA,0,1068324
fldAp,0.2,4,4,GCGCTGAAATCAGGCACTTT,0,1138345
fldAp,0.2,4,4,GCGCGTTGTTCGCATATCAA,0,1161989
fldAp,0.2,4,4,GCGCGTAGATCAATGCCGGT,0,1085186
fldAp,0.2,4,4,GCGCGCTGAGTTCGCGGCTT,0,1074378
fldAp,0.2,4,4,GCGCGCGTTCTGTGAGGAGC,0,1106636
fldAp,0.2,4,4,GCGCGAACCTACCAGATTTA,0,1085523
fldAp,0.2,4,4,GCGCCTGTGTCTGGCGTGCA,0,1097150
fldAp,0.2,4,4,GCGCCAGCACGGTCAGTATT,0,1106608
fldAp,0.2,4,4,GCGCCAGATTTGCTAGTGAT,0,1069053
fldAp,0.2,4,4,GCGCAGCCTATTCGCTTTGT,0,1174235
fldAp,0.2,4,4,GCGCAGATAGCTCTATTGCC,0,1157712
fldAp,0.2,4,4,GCGCAGAGAACACCTTGGGG,0,1169150
fldAp,0.2,4,4,GCGCACCACAGACCAATGCC,0,1070311
fldAp,0.2,4,4,GCGAGGCTGTAGTTGTTCTC,0,1138840
fldAp,0.2,4,4,GCGAGGCATTCGACTCTTCA,0,1115161
fldAp,0.2,4,4,GCGAGAATCGCGGAAGTGGG,0,1097386
fldAp,0.2,4,4,GCGACTCTTTCACCACATCG,0,1126374
fldAp,0.2,4,4,GCGACCGTCGGCGGTTGGAA,0,1159787
fldAp,0.2,4,4,GCGACACGACATCCACGTAT,0,1109064
fldAp,0.2,4,4,GCGAACGGAGTATTTTGGCA,0,1153988
fldAp,0.2,4,4,GCGAACCTAGGCACATAGTC,0,1106420
fldAp,0.2,4,4,GCGAAAAGGTGTAGGGATAT,0,1121865
fldAp,0.2,4,4,GCCTTTATGAGAGCTGTCAG,0,1095839
fldAp,0.2,4,4,GCCTGGCTATGTGAATGAAA,0,1124187
fldAp,0.2,4,4,GCCTGCTCGCACTTGACTCG,0,1111010
fldAp,0.2,4,4,GCCTGCGATACAATTCCAAG,0,1185436
fldAp,0.2,4,4,GCCTCACGCATAATTAATAC,0,1093506
fldAp,0.2,4,4,GCCGGCGTGGGCATATACAA,0,1131255
fldAp,0.2,4,4,GCCGGACCCACTCAGAATTT,0,1115470
fldAp,0.2,4,4,GCCGCCGTTGGATGAAAGCC,0,1083534
fldAp,0.2,4,4,GCCGCCAAGCCAGGTTACTT,0,1140538
fldAp,0.2,4,4,GCCCTGCATGTTATCGTTTC,0,1178225
fldAp,0.2,4,4,GCCCTCTGGACCAATTTTAC,0,1134682
fldAp,0.2,4,4,GCCCGTGTGGAGGGAAAAGC,0,1177648
fldAp,0.2,4,4,GCCCGCCGTCTTTATGTTTG,0,1146968
fldAp,0.2,4,4,GCCCCAGATCCAAATACGGG,0,1179260
fldAp,0.2,4,4,GCCCATTCCCTCTTTAGACG,0,1106440
fldAp,0.2,4,4,GCCCACGCTGTAAGTGGGGA,0,1140850
fldAp,0.2,4,4,GCCCAAGCTGGAATGTAGCT,0,1126813
fldAp,0.2,4,4,GCCATTACTGCATGACTGCT,0,1147425
fldAp,0.2,4,4,GCCATTAAAAGGATACAATA,0,1065040
fldAp,0.2,4,4,GCCATCTCTTGCGCTCCCAT,0,1084623
fldAp,0.2,4,4,GCCAGGGGCCTAGCCGGGAT,0,1067508
fldAp,0.2,4,4,GCCAGGGCGCAAGGCTCGGC,0,1174452
fldAp,0.2,4,4,GCCAGCGGCCTATGTCCTTG,0,1107894
fldAp,0.2,4,4,GCCAGACCAGCAACGGCCGC,0,1132431
fldAp,0.2,4,4,GCCACGTCTTGATCCCATCA,0,1155792
fldAp,0.2,4,4,GCCACGCTGGGAATTTGCCG,0,1077646
fldAp,0.2,4,4,GCCACCGGGCTCCCCTAATC,0,1129783
fldAp,0.2,4,4,GCATTGGATCATGCTATAGG,0,1074629
fldAp,0.2,4,4,GCATTCACCATATCGGTTGG,0,1152122
fldAp,0.2,4,4,GCATTATTAATGACACGGCT,0,1185257
fldAp,0.2,4,4,GCATGTTCGGATCCGACCTA,0,1182084
fldAp,0.2,4,4,GCATGCTGGAACTAAAGCCT,0,1131979
fldAp,0.2,4,4,GCATCCATGAGGCGTTGGAC,0,1186000
fldAp,0.2,4,4,GCATCACTTGACGATCACCC,0,1105008
fldAp,0.2,4,4,GCATATGAGGCGGTAACAAG,0,1068862
fldAp,0.2,4,4,GCATAAGAGTTGCGAAAGGT,0,1123967
fldAp,0.2,4,4,GCAGTGGCGGGCGCCATGTC,0,1124517
fldAp,0.2,4,4,GCAGGTCAACCAGGTCCAGA,0,1174386
fldAp,0.2,4,4,GCAGGCTAACCTAACCGTCG,0,1119295
fldAp,0.2,4,4,GCAGCTGCGAGTGCTATGGA,0,1176439
fldAp,0.2,4,4,GCAGCGGATGTGCGTCACGC,0,1090146
fldAp,0.2,4,4,GCACTCCCCGCGCTGCTAAA,0,1148462
fldAp,0.2,4,4,GCACGTGGGTAGGTGCCACG,0,1086598
fldAp,0.2,4,4,GCACGTATGCCGATGATTAC,0,1087956
fldAp,0.2,4,4,GCACGCCTTGAGTTACAGAC,0,1159225
fldAp,0.2,4,4,GCACAGAGAGATTTTGGATA,0,1156741
fldAp,0.2,4,4,GCACAAGTCCCAGCGAGAAA,0,1167170
fldAp,0.2,4,4,GCAATTCATATGTATGCTAG,0,1133723
fldAp,0.2,4,4,GCAATTCAGGGTTCCCCCCA,0,1101943
fldAp,0.2,4,4,GCAATTATGAAAACATACCA,0,1137038
fldAp,0.2,4,4,GCAACTGCGAGTTGCTATAC,0,1148012
fldAp,0.2,4,4,GCAAATCACGAAGAGTCGGC,0,1080525
fldAp,0.2,4,4,GATTGTTCAGTGCGTCTTGG,0,1165099
fldAp,0.2,4,4,GATTGCTGGGGAATGTCGGA,0,1063078
fldAp,0.2,4,4,GATTGAGGTATTGATACAGC,0,1121838
fldAp,0.2,4,4,GATTGAATTGTTACGGTCTG,0,1144114
fldAp,0.2,4,4,GATTACCTCGGTGCCAGTAA,0,1080011
fldAp,0.2,4,4,GATGTAGGCGACAATTTGCG,0,1157401
fldAp,0.2,4,4,GATGGTATGGTTTGTTAGGG,0,1149071
fldAp,0.2,4,4,GATGGGACGATCGCGGCGCT,0,1122506
fldAp,0.2,4,4,GATGGCTGGATAGTGGGGTG,0,1089339
fldAp,0.2,4,4,GATGCGTGGGATACAGCGGT,0,1070616
fldAp,0.2,4,4,GATGCGCTGCGGCTATTCGA,0,1079109
fldAp,0.2,4,4,GATGAGGGGCCAGCGCAGTA,0,1071698
fldAp,0.2,4,4,GATGAGGGCAACTCATCCTA,0,1123255
fldAp,0.2,4,4,GATGACGTGAAAAAACAAGT,0,1138922
fldAp,0.2,4,4,GATGAAGTGAGTCCCTTGAA,0,1167728
fldAp,0.2,4,4,GATCGGTTATCAATGTTCCA,0,1093892
fldAp,0.2,4,4,GATCCTGAGATCGTTTCGTG,0,1084077
fldAp,0.2,4,4,GATCCGCCACGGGTGGGGTT,0,1138210
fldAp,0.2,4,4,GATCCCCTGACATTGCCCCA,0,1165656
fldAp,0.2,4,4,GATCAGAGAGAAGGCCTTCG,0,1100232
fldAp,0.2,4,4,GATCAGAAGACAAAGCGTGG,0,1149883
fldAp,0.2,4,4,GATAGGTCCCCAACGCCGGT,0,1175381
fldAp,0.2,4,4,GATAGCTTGAGATAGTCCAC,0,1085311
fldAp,0.2,4,4,GATACTACCAGGAGACAGTG,0,1093676
fldAp,0.2,4,4,GATACGCTTACCGATGAGGA,0,1091056
fldAp,0.2,4,4,GATACCTTGGCTCAAACATA,0,1124183
fldAp,0.2,4,4,GATAAGGAGCGCGTCATGCG,0,1127152
fldAp,0.2,4,4,GATAAGAGGTTAGGGAGATC,0,1183908
fldAp,0.2,4,4,GATAAAACGCGGATTTTAAC,0,1158431
fldAp,0.2,4,4,GAGTTTGGTATGCTCAGATA,0,1141008
fldAp,0.2,4,4,GAGTTGGTCCGGGTTTCTCC,0,1158179
fldAp,0.2,4,4,GAGTTGCCACGCAAAAATGA,0,1175940
fldAp,0.2,4,4,GAGTTACTATCCACAGTAGT,0,1123088
fldAp,0.2,4,4,GAGTGCCAGTTGCGCTCAAT,0,1182230
fldAp,0.2,4,4,GAGTGAGGTATACCTCTCAA,0,1092099
fldAp,0.2,4,4,GAGTGACAACGGGTAGAACA,0,1144412
fldAp,0.2,4,4,GAGTGAAAATTGTGAGATTA,0,1127408
fldAp,0.2,4,4,GAGTCCTTTCGGTACTCTGG,0,1183178
fldAp,0.2,4,4,GAGTACGAAATTTGACAAGG,0,1171979
fldAp,0.2,4,4,GAGTACCGTTGTTCGGCCGT,0,1159996
fldAp,0.2,4,4,GAGTAACTTCTTGTTTCCTA,0,1071935
fldAp,0.2,4,4,GAGGTCAGACGCCCCGGCCG,0,1133118
fldAp,0.2,4,4,GAGGGGTACAACATTTGCTC,0,1145056
fldAp,0.2,4,4,GAGGGGACCTGTAATAAGCT,0,1157528
fldAp,0.2,4,4,GAGGCTTTCGAACTTTGAGT,0,1159843
fldAp,0.2,4,4,GAGGCGTTTCTCTATTGCGA,0,1171042
fldAp,0.2,4,4,GAGGCGTAATCGTCTAGTTG,0,1135771
fldAp,0.2,4,4,GAGGCGGGCTCATATACGCT,0,1063578
fldAp,0.2,4,4,GAGGCCCGCATTGGGTTAAT,0,1165329
fldAp,0.2,4,4,GAGGATTATGAGAAAGGCAT,0,1093808
fldAp,0.2,4,4,GAGGAAATTTTACAGCGGTT,0,1109934
fldAp,0.2,4,4,GAGCTTTTTGTGGAGGTGAG,0,1146076
fldAp,0.2,4,4,GAGCTCGAGCGGTTTACCAC,0,1115640
fldAp,0.2,4,4,GAGCTAGGTCACATATAGAT,0,1179761
fldAp,0.2,4,4,GAGCGTGCCGAACCAGACTT,0,1071813
fldAp,0.2,4,4,GAGCGAGTGTACACTATTGC,0,1093872
fldAp,0.2,4,4,GAGCGAATTTAGTGCATGGG,0,1161107
fldAp,0.2,4,4,GAGCCAGCTAAATCCCTTGA,0,1094819
fldAp,0.2,4,4,GAGCCACCACAGCGGCCCCA,0,1142155
fldAp,0.2,4,4,GAGCATCACCAGGTTGGTTA,0,1148270
fldAp,0.2,4,4,GAGCAATTGTTTTTTACAGT,0,1182749
fldAp,0.2,4,4,GAGATTGCCACTTTAAGCTA,0,1099055
fldAp,0.2,4,4,GAGATCTGGATCTTATTGAA,0,1168752
fldAp,0.2,4,4,GAGATATCAATTCTTTGATC,0,1072048
fldAp,0.2,4,4,GAGAGGTAAAAATTCCTTGC,0,1108179
fldAp,0.2,4,4,GAGACGTCGTGGGGACATAG,0,1141360
fldAp,0.2,4,4,GAGACGTACAAAGTAAGTCA,0,1100932
fldAp,0.2,4,4,GAGACGGCTTGCCGTTGTTT,0,1174742
fldAp,0.2,4,4,GAGACATTGACTGGAAGCTT,0,1180252
fldAp,0.2,4,4,GAGAACCACCAAATCCCATT,0,1087931
fldAp,0.2,4,4,GACTTGTATCCGTAGGACAT,0,1130306
fldAp,0.2,4,4,GACTTGCACAGTGACCACGT,0,1063787
fldAp,0.2,4,4,GACTTATATAATCGGCGTCC,0,1065034
fldAp,0.2,4,4,GACTGTCGCGCAGGCTAACT,0,1165712
fldAp,0.2,4,4,GACTGGACATTTAGATCAGT,0,1104339
fldAp,0.2,4,4,GACTAAGGGTGTAAACCGGA,0,1165758
fldAp,0.2,4,4,GACTAAGGACATCATTGGCG,0,1151352
fldAp,0.2,4,4,GACTAAGAGCTTTACGGGTT,0,1159663
fldAp,0.2,4,4,GACGTGGGTACAATCCTCGT,0,1126476
fldAp,0.2,4,4,GACGCTACGGCCGACTCGGT,0,1150228
fldAp,0.2,4,4,GACGCAGTCACAGATAGATA,0,1132464
fldAp,0.2,4,4,GACCTGTGTCATGGGAGACG,0,1167816
fldAp,0.2,4,4,GACCTGCGGATCAGGGTGTA,0,1167056
fldAp,0.2,4,4,GACCTGAACCCGCTCTAGAT,0,1131366
fldAp,0.2,4,4,GACCTCCTGACTGTGGCCTC,0,1094721
fldAp,0.2,4,4,GACCGTAAACGCAGCGGTAT,0,1096122
fldAp,0.2,4,4,GACCCTGTTTCACTGAAAAG,0,1109811
fldAp,0.2,4,4,GACCCCAGCTGCTGCAAAAT,0,1169409
fldAp,0.2,4,4,GACCATCGTAGGGCGTCAGG,0,1073117
fldAp,0.2,4,4,GACCACAGTCCTTGCTTTGA,0,1106596
fldAp,0.2,4,4,GACATGGCGAAGATAAGACC,0,1113321
fldAp,0.2,4,4,GACAGTATAGGCAAGAGGCG,0,1129060
fldAp,0.2,4,4,GACAGCGTGACTTATCCAAT,0,1095386
fldAp,0.2,4,4,GACAGCGTAACGAGATGAAT,0,1133257
fldAp,0.2,4,4,GACAGCGAGAATCAGCGATA,0,1101878
fldAp,0.2,4,4,GACACAAACCGTGTGATATT,0,1136483
fldAp,0.2,4,4,GACAAGCCAGTGGCTGACCC,0,1081299
fldAp,0.2,4,4,GAATCCTGATTTGATGGTGC,0,1149299
fldAp,0.2,4,4,GAATATAAGAACATTTCAGC,0,1167071
fldAp,0.2,4,4,GAATAGGTACACTTTGGATT,0,1175630
fldAp,0.2,4,4,GAATACTCCGCCTGCCAGTG,0,1092211
fldAp,0.2,4,4,GAAGTTCCAGCGGTCGGTAG,0,1145233
fldAp,0.2,4,4,GAAGTTACTATGCATTCGCA,0,1162455
fldAp,0.2,4,4,GAAGTGCTAAAATTATCGAT,0,1123081
fldAp,0.2,4,4,GAAGTGCGAATTACACTGAA,0,1174341
fldAp,0.2,4,4,GAAGGGTTATTGTGGACCAG,0,1085593
fldAp,0.2,4,4,GAAGGGAGGTATTATTGAAC,0,1064375
fldAp,0.2,4,4,GAAGCTGGCATTTATGCGTG,0,1102926
fldAp,0.2,4,4,GAAGCGGACATGAGTAAGTT,0,1159990
fldAp,0.2,4,4,GAAGCATACGGCGGGGCTCA,0,1152382
fldAp,0.2,4,4,GAAGAGGTATCTAAGGTGCA,0,1158102
fldAp,0.2,4,4,GAAGACCGGGACGTCAGCCA,0,1133818
fldAp,0.2,4,4,GAACTTCGCGTATTCCGGCT,0,1122894
fldAp,0.2,4,4,GAACTGGGGGCTCGCGCACC,0,1182506
fldAp,0.2,4,4,GAACGCTAATGTTGCATTAT,0,1147963
fldAp,0.2,4,4,GAACCGGGGGAGACCGTGGC,0,1067279
fldAp,0.2,4,4,GAACCCGCGGCTCGCGTAAT,0,1122248
fldAp,0.2,4,4,GAACCCCGATTCATCCGTCT,0,1078461
fldAp,0.2,4,4,GAACCCCATTCAGAGCAGCT,0,1157027
fldAp,0.2,4,4,GAACAGGCCGGCTCGAATAA,0,1102271
fldAp,0.2,4,4,GAACACTAAGTAGCATGTGT,0,1115995
fldAp,0.2,4,4,GAACACCACTCACTATTTCT,0,1108886
fldAp,0.2,4,4,GAAATTTCTCAGTTCGTTTT,0,1091177
fldAp,0.2,4,4,GAAATTGGCACCATTCGCAT,0,1138766
fldAp,0.2,4,4,GAAATGATCAAGCGCGATGG,0,1069777
fldAp,0.2,4,4,GAAAGGTATCCTCGTGGGCT,0,1173638
fldAp,0.2,4,4,GAAAGCGACCCAATGTGTGG,0,1096730
fldAp,0.2,4,4,GAAAGCATGCACTCGAGACA,0,1172717
fldAp,0.2,4,4,GAAACATCCAATTCGGAGCA,0,1137577
fldAp,0.2,4,4,GAAAACCATTGGACGTGAAG,0,1142162
fldAp,0.2,4,4,GAAAAAGGGAGCACAACCCT,0,1111481
fldAp,0.2,4,4,GAAAAAAGCTGTACCTTACA,0,1161516
fldAp,0.2,4,4,CTTTTTGGGGCTGACGCTCA,0,1165600
fldAp,0.2,4,4,CTTTTGTTATTAGGCCCACT,0,1069823
fldAp,0.2,4,4,CTTTTGAATCAGGCACACTC,0,1105396
fldAp,0.2,4,4,CTTTTCTAATCGCGTTTCTA,0,1069922
fldAp,0.2,4,4,CTTTGACGTCAAGAGCTTCG,0,1067135
fldAp,0.2,4,4,CTTTCTCGATGTAGAAGATC,0,1168981
fldAp,0.2,4,4,CTTTCCGAGCCAGATAATCT,0,1165202
fldAp,0.2,4,4,CTTTACGCGGGACTGCTCCC,0,1164338
fldAp,0.2,4,4,CTTGTCAGGCGGGTATTAGT,0,1143954
fldAp,0.2,4,4,CTTGGTTAAATCTTGAGAAG,0,1099560
fldAp,0.2,4,4,CTTGGGTTCGACGTGAGCCC,0,1068844
fldAp,0.2,4,4,CTTGGGGAAAAGTGTTAACA,0,1100452
fldAp,0.2,4,4,CTTGGCGTAACTCGGGCGGA,0,1135252
fldAp,0.2,4,4,CTTGGACCCAGTTGGCTGCA,0,1075715
fldAp,0.2,4,4,CTTGGAAAGTAGAGGAAGTA,0,1077202
fldAp,0.2,4,4,CTTGCTTTCAAATAGGTGCA,0,1180971
fldAp,0.2,4,4,CTTGCGGGAACCTCAAGAGG,0,1111203
fldAp,0.2,4,4,CTTGCAGGAAAAGATGTTTG,0,1104914
fldAp,0.2,4,4,CTTCTGGGGCGGGATCAACC,0,1105731
fldAp,0.2,4,4,CTTCTCCCTGCCCGGAGTGG,0,1092378
fldAp,0.2,4,4,CTTCGAGTGGACTTGAAAAA,0,1077109
fldAp,0.2,4,4,CTTCCCGACATCCCAGACGT,0,1181111
fldAp,0.2,4,4,CTTCATACGTCCCGCTACCT,0,1087898
fldAp,0.2,4,4,CTTCAGGAATACATACTGCG,0,1090929
fldAp,0.2,4,4,CTTATTCAAGGTTACCTGTG,0,1099872
fldAp,0.2,4,4,CTTATCCCTGGGAACCACAT,0,1182837
fldAp,0.2,4,4,CTTAGTATCCCTCTTAATCT,0,1144940
fldAp,0.2,4,4,CTTAGGTTCGAATAAGCCAG,0,1093897
fldAp,0.2,4,4,CTTAGGAATCAGAGTCTTTA,0,1072099
fldAp,0.2,4,4,CTTACAGTGAAAGGCGTGCG,0,1178575
fldAp,0.2,4,4,CTTAAGAGGGGGATTAGGCA,0,1139158
fldAp,0.2,4,4,CTGTTTGCCTCATCTGGGTG,0,1153540
fldAp,0.2,4,4,CTGTTGTGGGCTGGTATCAC,0,1077639
fldAp,0.2,4,4,CTGTTGACGTCACGCTGGGA,0,1183475
fldAp,0.2,4,4,CTGTTACGAAAAGACGACTC,0,1180598
fldAp,0.2,4,4,CTGTGCATTGTTAGCATAAA,0,1159971
fldAp,0.2,4,4,CTGTGACCCACGCGATACAT,0,1097320
fldAp,0.2,4,4,CTGTCTGCGTAATTCGATGT,0,1104313
fldAp,0.2,4,4,CTGTCGGGTGGCTCCGCATG,0,1085445
fldAp,0.2,4,4,CTGTCACTGACGCCTAAAGT,0,1124493
fldAp,0.2,4,4,CTGTATGAATCTCTTGGTGT,0,1107253
fldAp,0.2,4,4,CTGGTGCGAAGGAAACGAAC,0,1175440
fldAp,0.2,4,4,CTGGTATTTAAGCGTTTCGT,0,1069713
fldAp,0.2,4,4,CTGGGCCGATATCCGAACCA,0,1128902
fldAp,0.2,4,4,CTGGATGCAAGAAACGCCAC,0,1129113
fldAp,0.2,4,4,CTGGATCCAAGCTGGTAGTA,0,1085167
fldAp,0.2,4,4,CTGCGGTCACGAATCAGACA,0,1072047
fldAp,0.2,4,4,CTGCCTCTCTAGCTTTAGAC,0,1129370
fldAp,0.2,4,4,CTGCATTGATGGCTGTGACG,0,1068783
fldAp,0.2,4,4,CTGCATGAGGTGGCTGGGTT,0,1179683
fldAp,0.2,4,4,CTGCAGAGGCGGATACCCCC,0,1118269
fldAp,0.2,4,4,CTGCACACTAAAAAGGGCGT,0,1069226
fldAp,0.2,4,4,CTGATGTCGTAGTACCTCTC,0,1161467
fldAp,0.2,4,4,CTGACTGAGGGCAGTATAAA,0,1096728
fldAp,0.2,4,4,CTGACTCTATGCTCCTGCGT,0,1148163
fldAp,0.2,4,4,CTGAATAGCTGCTCTGCAGA,0,1067052
fldAp,0.2,4,4,CTGAACCAGTGTAACATGGA,0,1068406
fldAp,0.2,4,4,CTCTTACGGTAGTCGGGCTT,0,1170927
fldAp,0.2,4,4,CTCTGTTCTCGAGACACCCC,0,1134132
fldAp,0.2,4,4,CTCTGGAGCTCTTCACTAGC,0,1124190
fldAp,0.2,4,4,CTCTCGGGCGGAGATATACA,0,1103242
fldAp,0.2,4,4,CTCTCAGTGGTTAGGGATAC,0,1092246
fldAp,0.2,4,4,CTCTATGTAGGTTATATCAG,0,1147766
fldAp,0.2,4,4,CTCTAGTAGAACTGTTACCA,0,1112212
fldAp,0.2,4,4,CTCTACTTCACCCCCCGGTA,0,1097049
fldAp,0.2,4,4,CTCGTTTCTTCGTCCTCGGT,0,1171574
fldAp,0.2,4,4,CTCGTTATAGATGCTCTCCG,0,1072524
fldAp,0.2,4,4,CTCGTCTTCCTCCTAATGCG,0,1174324
fldAp,0.2,4,4,CTCGTCTTAGAGTCGCACTC,0,1137968
fldAp,0.2,4,4,CTCGTCGCCATGGTTTGAGT,0,1115467
fldAp,0.2,4,4,CTCGTAACTCAGCGCTGGTT,0,1184067
fldAp,0.2,4,4,CTCGGGTGTATTCAGTCAAG,0,1137854
fldAp,0.2,4,4,CTCGGGTCCTATGAAGGAGC,0,1149785
fldAp,0.2,4,4,CTCGGGCTTGCCATACTCTG,0,1082220
fldAp,0.2,4,4,CTCGGCCGAGTTGCTAGATA,0,1080187
fldAp,0.2,4,4,CTCGCCGAAATTACCGGCCC,0,1134586
fldAp,0.2,4,4,CTCGCATTCAGGAAGTTACT,0,1074776
fldAp,0.2,4,4,CTCGAGAGTGCGAATTACGG,0,1172358
fldAp,0.2,4,4,CTCCTTAAATTCCCACCGTT,0,1130638
fldAp,0.2,4,4,CTCCTGGAAGGTTTTCGCCG,0,1152113
fldAp,0.2,4,4,CTCCTCATGTCTTGTCAGTA,0,1145492
fldAp,0.2,4,4,CTCCTACGCTTCACTTTCTC,0,1180937
fldAp,0.2,4,4,CTCCGTTAAGTGACGTCCAA,0,1129461
fldAp,0.2,4,4,CTCCGTGCGCTTCCGGGTTT,0,1065644
fldAp,0.2,4,4,CTCCGGATGGGCTCAACGAA,0,1122628
fldAp,0.2,4,4,CTCCGCATACGCCTGTCGTA,0,1164390
fldAp,0.2,4,4,CTCCCGGAAGGCTCCGACGC,0,1165389
fldAp,0.2,4,4,CTCCACAGGGGGGAAGCTGG,0,1177284
fldAp,0.2,4,4,CTCATTACCTGCGTTGTGAT,0,1160562
fldAp,0.2,4,4,CTCATGGCAGAGGGTAGGGT,0,1078226
fldAp,0.2,4,4,CTCAGGTCGGGCGACGAGAC,0,1169541
fldAp,0.2,4,4,CTCAGGAAGCGTTAATGTGT,0,1126750
fldAp,0.2,4,4,CTCACTACTGGCTGCTCCGT,0,1170059
fldAp,0.2,4,4,CTATTGGGAGAATGCCTGGG,0,1085886
fldAp,0.2,4,4,CTATTAGATCTTGTTACGAG,0,1177382
fldAp,0.2,4,4,CTATTAAGGAGGCGGCCTGC,0,1132850
fldAp,0.2,4,4,CTATGTACGAGGCTGTTGTT,0,1128286
fldAp,0.2,4,4,CTATGGGATGTTTGTGCTAA,0,1076177
fldAp,0.2,4,4,CTATGGCTGCTTGGCCTTTC,0,1101519
fldAp,0.2,4,4,CTATGCAAGAAAGTTCCGGA,0,1170536
fldAp,0.2,4,4,CTATCACTGGTTTGGAGCGT,0,1128972
fldAp,0.2,4,4,CTAGTCACAAAAACTTCCTG,0,1178728
fldAp,0.2,4,4,CTAGTATCTCGGGCGACGAG,0,1170102
fldAp,0.2,4,4,CTAGTAGATAAACTCCAATA,0,1097082
fldAp,0.2,4,4,CTAGGGGTCGGACCGCGTTA,0,1066556
fldAp,0.2,4,4,CTAGGGCCGTGTGAAAATGT,0,1163893
fldAp,0.2,4,4,CTAGGGAGACACCGTGCGAC,0,1117526
fldAp,0.2,4,4,CTAGGATGGCCTTAGATCGG,0,1081092
fldAp,0.2,4,4,CTAGCGCTGTTCAACGAAGT,0,1156952
fldAp,0.2,4,4,CTAGCAGATGTGTAATAGAC,0,1162371
fldAp,0.2,4,4,CTAGAAGTGTGCCCGGTTTT,0,1128105
fldAp,0.2,4,4,CTACTTGAGGTACCCTTCTA,0,1150835
fldAp,0.2,4,4,CTACTCTTTCGAGGCTAGCA,0,1114729
fldAp,0.2,4,4,CTACTCCGGACCGGTCTGAA,0,1103261
fldAp,0.2,4,4,CTACGGCACTCAATGGCGCT,0,1125685
fldAp,0.2,4,4,CTACGCTGGTAAAGGTTCTT,0,1129154
fldAp,0.2,4,4,CTACGATAGTGTTCCCCCTT,0,1125177
fldAp,0.2,4,4,CTACCAGCTGTCTTGGAGTG,0,1153364
fldAp,0.2,4,4,CTACATCCGAGTCTGTGGCA,0,1183944
fldAp,0.2,4,4,CTACAGGACAGCAAATAGAG,0,1163800
fldAp,0.2,4,4,CTACAAGTCAGTGACGTAAT,0,1072239
fldAp,0.2,4,4,CTAATGTCAGCGTGATTGCA,0,1117664
fldAp,0.2,4,4,CTAATATTCGCTAGAGAGGC,0,1096995
fldAp,0.2,4,4,CTAATAGACAGATGCTATGA,0,1108312
fldAp,0.2,4,4,CTAATAAAACCCGGACCGTA,0,1186785
fldAp,0.2,4,4,CTAAGTCCCTAAGGGGTGGA,0,1081132
fldAp,0.2,4,4,CTAAGTCCCATAACCGTACT,0,1072172
fldAp,0.2,4,4,CTAACTTTTGCTGGAGCGAG,0,1135742
fldAp,0.2,4,4,CTAACTCTTTAAGGTGATGA,0,1068754
fldAp,0.2,4,4,CTAACCGCTGGCTGATTGGT,0,1095331
fldAp,0.2,4,4,CTAACAAGAGTCATCGCACG,0,1082195
fldAp,0.2,4,4,CTAAATCCGCTGGACTGTCT,0,1145952
fldAp,0.2,4,4,CGTTTCAACTGTTAGTCAGG,0,1144769
fldAp,0.2,4,4,CGTTGTCATGGCTAAGTACA,0,1072919
fldAp,0.2,4,4,CGTTGGTAATCCACCAGAAC,0,1143647
fldAp,0.2,4,4,CGTTGATAATAGTGGTTCTG,0,1143297
fldAp,0.2,4,4,CGTTCCACGCAGCCGTCCAC,0,1149065
fldAp,0.2,4,4,CGTTATTTGTGGTGGCTTAA,0,1123890
fldAp,0.2,4,4,CGTTAAGGGAGCGGGAATGC,0,1081748
fldAp,0.2,4,4,CGTTAAATGGATGGTAATTG,0,1173231
fldAp,0.2,4,4,CGTGTGAAGATCAGTTCTTT,0,1079557
fldAp,0.2,4,4,CGTGTCTGGTAAAGGCCGTG,0,1136208
fldAp,0.2,4,4,CGTGGGACTGCCGGTTTGCT,0,1111838
fldAp,0.2,4,4,CGTGGCTCAGTAATTCGAAT,0,1107245
fldAp,0.2,4,4,CGTGCCGTCGGTTGATCAGG,0,1134142
fldAp,0.2,4,4,CGTGAGTAATAGAAGCCCGT,0,1140557
fldAp,0.2,4,4,CGTCTTTAGTACCGTATCTC,0,1144020
fldAp,0.2,4,4,CGTCTCTATTCTAATCTTGA,0,1185843
fldAp,0.2,4,4,CGTCTAGATTCATATTTCTT,0,1133372
fldAp,0.2,4,4,CGTCTAAATGTTTCCAATGT,0,1130249
fldAp,0.2,4,4,CGTCGTTTTGTATCGGCGCA,0,1178171
fldAp,0.2,4,4,CGTCGTTACGTCACCTGCTA,0,1186250
fldAp,0.2,4,4,CGTCGGGGATCCGATTTAAA,0,1091919
fldAp,0.2,4,4,CGTCGATGAGCTGGCTTGGT,0,1145745
fldAp,0.2,4,4,CGTCGAACAGCGATTCCCGT,0,1079714
fldAp,0.2,4,4,CGTCCTAGGGGCCGGGATAT,0,1163219
fldAp,0.2,4,4,CGTCCATCTAAGTTATACTT,0,1117774
fldAp,0.2,4,4,CGTCATGCTTGTTGTAATCG,0,1159477
fldAp,0.2,4,4,CGTCAAAGGTCTGGTGAACT,0,1089206
fldAp,0.2,4,4,CGTATCCTGAGTCACTGGGG,0,1099037
fldAp,0.2,4,4,CGTAGTCCGTGGTCGTCTAC,0,1161102
fldAp,0.2,4,4,CGTAGGGAAGTTAGTTTGAC,0,1131023
fldAp,0.2,4,4,CGTAGCACCGCGCGGGTAGT,0,1118692
fldAp,0.2,4,4,CGTAGAAAGTCAGCAATCTG,0,1169518
fldAp,0.2,4,4,CGTACATCAGGTTCGCATAC,0,1179129
fldAp,0.2,4,4,CGGTTTGGGGCCCAGCGCGT,0,1159575
fldAp,0.2,4,4,CGGTTGTGGTACCGACCGGG,0,1064498
fldAp,0.2,4,4,CGGTTCCTCCAACGTCTCAA,0,1140560
fldAp,0.2,4,4,CGGTTCCATCAGTCGTTTTA,0,1106587
fldAp,0.2,4,4,CGGTGGGTGAATTGCAGTTA,0,1096601
fldAp,0.2,4,4,CGGTGCACCGGTGAATTCAA,0,1169955
fldAp,0.2,4,4,CGGTGACCTTTCTCCACATA,0,1117688
fldAp,0.2,4,4,CGGTCATTGCATAAATCAGG,0,1142938
fldAp,0.2,4,4,CGGTCATGTCGTGTAGGACT,0,1095990
fldAp,0.2,4,4,CGGTCAGTTGATGCTGTCTA,0,1140435
fldAp,0.2,4,4,CGGTAGACTTCCTAGAGAAA,0,1135210
fldAp,0.2,4,4,CGGGTGCCTATAGATGAATC,0,1065621
fldAp,0.2,4,4,CGGGTACTACTGTTCGTCGG,0,1157270
fldAp,0.2,4,4,CGGGGTCCATCCATAGCGTC,0,1133139
fldAp,0.2,4,4,CGGGGCCTTCGCGAACGCAT,0,1134635
fldAp,0.2,4,4,CGGGGCATGGGCCTCTTCAT,0,1076323
fldAp,0.2,4,4,CGGGGAACGGAAACCCCAAA,0,1083018
fldAp,0.2,4,4,CGGGATTCCGTTCGTCATCA,0,1123237
fldAp,0.2,4,4,CGGGAGGAACCGAAGGACCA,0,1128922
fldAp,0.2,4,4,CGGGAACGTGGCGACTGGAA,0,1087506
fldAp,0.2,4,4,CGGGAACAATACTAAGACGG,0,1074673
fldAp,0.2,4,4,CGGCTGGGCTGTGGTTTTCA,0,1177709
fldAp,0.2,4,4,CGGCGTCTTAGTGAGACCGC,0,1089343
fldAp,0.2,4,4,CGGCGTATTACCCGGCACAT,0,1184292
fldAp,0.2,4,4,CGGCGCGTCACATGATCTGC,0,1147011
fldAp,0.2,4,4,CGGCGATTTTCTTCAGCGAA,0,1171916
fldAp,0.2,4,4,CGGCATTCAGGTCGTCACAG,0,1099092
fldAp,0.2,4,4,CGGCATGGGGGGTCTCCAGA,0,1070452
fldAp,0.2,4,4,CGGCACTCAAGTATGACTTG,0,1170103
fldAp,0.2,4,4,CGGCACAAAGAGCTTGTTTG,0,1124670
fldAp,0.2,4,4,CGGATCCGAGGATTTTCCTT,0,1160913
fldAp,0.2,4,4,CGGATCCCTGACATGTAAAT,0,1126617
fldAp,0.2,4,4,CGGATCCATGCCACGTGACT,0,1156367
fldAp,0.2,4,4,CGGACTGGGGCCATTACATA,0,1157445
fldAp,0.2,4,4,CGGAATATGCCCAATCTTGT,0,1093769
fldAp,0.2,4,4,CGGAAGTAGCCCTGTACATC,0,1096616
fldAp,0.2,4,4,CGGAACGCTTCTTGATCAGA,0,1101233
fldAp,0.2,4,4,CGGAAAATCAATGGTTGATC,0,1149779
fldAp,0.2,4,4,CGGAAAATATCAGATTCTTT,0,1167967
fldAp,0.2,4,4,CGCTTAGGATATGAAACACT,0,1096858
fldAp,0.2,4,4,CGCTTAAATGCCGAGTCAAT,0,1070317
fldAp,0.2,4,4,CGCTGCCTCCCGTAGATATT,0,1184116
fldAp,0.2,4,4,CGCTGAGCATATTCTAATGT,0,1090158
fldAp,0.2,4,4,CGCTCTGGGTGGAGCTAGGA,0,1070812
fldAp,0.2,4,4,CGCTCCATCAGGCGTGCCGG,0,1115656
fldAp,0.2,4,4,CGCTCACGATTTGGGGACGA,0,1168114
fldAp,0.2,4,4,CGCTAGTACGATCGCCAGCC,0,1079911
fldAp,0.2,4,4,CGCGGTTTGGCGAAATGGGT,0,1181609
fldAp,0.2,4,4,CGCGCTACTTAAGACTAAGT,0,1150069
fldAp,0.2,4,4,CGCGAGACATTGTAACTCAT,0,1085423
fldAp,0.2,4,4,CGCGAAGGCAGCTGTACTAC,0,1122500
fldAp,0.2,4,4,CGCCTTGGCGACGACTAGAC,0,1098131
fldAp,0.2,4,4,CGCCTGATCGCGCTTGCCAT,0,1076769
fldAp,0.2,4,4,CGCCGGGCACAGGCTGAAGT,0,1174534
fldAp,0.2,4,4,CGCCCGATTTGTGCTTCACA,0,1077758
fldAp,0.2,4,4,CGCCCCAAGCCCACTACGGG,0,1115034
fldAp,0.2,4,4,CGCCCATACTGGACGTGATG,0,1156397
fldAp,0.2,4,4,CGCCCAAAGCTAGAAGCTGT,0,1084889
fldAp,0.2,4,4,CGCCAAGGTGCACCTTCCAG,0,1066317
fldAp,0.2,4,4,CGCATTCGGCGGTATCCGCA,0,1069887
fldAp,0.2,4,4,CGCATTAAAGACGTTCATGA,0,1117326
fldAp,0.2,4,4,CGCATGTTAACATGACAGCG,0,1080610
fldAp,0.2,4,4,CGCATGGCCATTTTGTCAGA,0,1112759
fldAp,0.2,4,4,CGCATAAACTTTTTCTTAGA,0,1111656
fldAp,0.2,4,4,CGCAGTGTTATGTGTGCACA,0,1105272
fldAp,0.2,4,4,CGCAGTGTAACGAGAGACTT,0,1117653
fldAp,0.2,4,4,CGCAGGTTTTTGAATGCAGT,0,1081468
fldAp,0.2,4,4,CGCAGCTCCACGAGAAAGTA,0,1120616
fldAp,0.2,4,4,CGCAGATTAGGCGTTCAGCG,0,1076232
fldAp,0.2,4,4,CGCACGTGGAATAGCTTTGA,0,1109513
fldAp,0.2,4,4,CGCAATTCTACAACCAAATT,0,1129595
fldAp,0.2,4,4,CGCAATGGTGAACGCTCTCC,0,1097181
fldAp,0.2,4,4,CGCAAGTGTTTTGTCTGGGG,0,1131583
fldAp,0.2,4,4,CGCAAGGGACGCATTTATTC,0,1103297
fldAp,0.2,4,4,CGCAACATAGCCGTCGTCCG,0,1063080
fldAp,0.2,4,4,CGATTTAGATTAGGAGCTGG,0,1092022
fldAp,0.2,4,4,CGATTGTCGCCGTACGTGGT,0,1184920
fldAp,0.2,4,4,CGATTCTACCCGGTAGTCGC,0,1107902
fldAp,0.2,4,4,CGATTAATTTAATCCGAGAC,0,1103849
fldAp,0.2,4,4,CGATCGAATCCTGTTCGTCT,0,1125041
fldAp,0.2,4,4,CGATAATATAAACTCGCGCA,0,1124269
fldAp,0.2,4,4,CGAGTATGCCGGACCTCTTT,0,1131968
fldAp,0.2,4,4,CGAGGTACATGGTGTCCGGT,0,1074108
fldAp,0.2,4,4,CGAGGTAAGCGTCGGCAAAC,0,1177160
fldAp,0.2,4,4,CGAGCTAGGCATGTACGGAT,0,1078979
fldAp,0.2,4,4,CGAGCTACGCCCATCGTGGG,0,1154430
fldAp,0.2,4,4,CGAGCGATAATTATGGTTCC,0,1092718
fldAp,0.2,4,4,CGAGATGATAGCAGAGTACT,0,1174020
fldAp,0.2,4,4,CGAGACGTGAGAGATTGGTT,0,1069575
fldAp,0.2,4,4,CGAGAAGAAGTGTGATTGAT,0,1174271
fldAp,0.2,4,4,CGACTGCTTAGTGATGGTGC,0,1157054
fldAp,0.2,4,4,CGACTCTCTAGCAGACGCCT,0,1070899
fldAp,0.2,4,4,CGACGGTCCCGGCGCTCACT,0,1115025
fldAp,0.2,4,4,CGACGGCTTCCAGTTATGTC,0,1091599
fldAp,0.2,4,4,CGACGGCGAAGGTTAGCCCT,0,1094358
fldAp,0.2,4,4,CGACCACTAGCGCTGGTTAT,0,1067300
fldAp,0.2,4,4,CGACAGGCTGGGAGACGCGG,0,1181388
fldAp,0.2,4,4,CGACACCGGAATAACAAGCT,0,1121682
fldAp,0.2,4,4,CGAATTTTATTCGATATAGT,0,1137543
fldAp,0.2,4,4,CGAATCGATCGTCGCACGAG,0,1087002
fldAp,0.2,4,4,CGAATAGCATCAGGTACACA,0,1120843
fldAp,0.2,4,4,CGAAGCTTAAACACACCTGA,0,1090196
fldAp,0.2,4,4,CGAAGCTACACGCAAACTTG,0,1107889
fldAp,0.2,4,4,CGAAGCGACAGAGTCACTTA,0,1069941
fldAp,0.2,4,4,CGAAGCCATCTCACTTTTTT,0,1065671
fldAp,0.2,4,4,CGAAGATCCAAATCACGGGG,0,1130853
fldAp,0.2,4,4,CGAACCGGTTAAAATTAATA,0,1081550
fldAp,0.2,4,4,CGAAACCAGAAGGCGTTCTT,0,1153020
fldAp,0.2,4,4,CCTTTTCTTTACGCTCCGTG,0,1074438
fldAp,0.2,4,4,CCTTGTAAGTATACATGTTC,0,1160438
fldAp,0.2,4,4,CCTTGGCGGTGGGCTTGGGG,0,1125107
fldAp,0.2,4,4,CCTTGCGTCGCATGGTTATA,0,1184780
fldAp,0.2,4,4,CCTTCATTAGGCATTAGCGA,0,1072049
fldAp,0.2,4,4,CCTTCAAGTCAGGCCTTCCT,0,1176031
fldAp,0.2,4,4,CCTTACTATGGCGAGCCGTG,0,1115731
fldAp,0.2,4,4,CCTTACGGCAGTTTCCATCA,0,1132493
fldAp,0.2,4,4,CCTGTACCAAGGTAATGGGA,0,1185837
fldAp,0.2,4,4,CCTGGGGCTCAGACATAGAG,0,1078689
fldAp,0.2,4,4,CCTGGATCACTCGCTACGAA,0,1127605
fldAp,0.2,4,4,CCTGGACTTTAGTTAATCCA,0,1070936
fldAp,0.2,4,4,CCTGCAGTGGGCGTCTACTT,0,1116880
fldAp,0.2,4,4,CCTCTGGCAAGGGGTCCGTT,0,1157283
fldAp,0.2,4,4,CCTCTCTCCGCTCTTGTGAT,0,1139569
fldAp,0.2,4,4,CCTCGGATTAAATGGGTCGT,0,1173918
fldAp,0.2,4,4,CCTCCCGCACAGGGATGCTT,0,1110999
fldAp,0.2,4,4,CCTCCAACTTGACTGTGTGG,0,1087190
fldAp,0.2,4,4,CCTCATTTAGGTCGTCCCAA,0,1076953
fldAp,0.2,4,4,CCTCATGTTTGCTCATACTC,0,1163373
fldAp,0.2,4,4,CCTCAAGACTGGGAGTTCGT,0,1090666
fldAp,0.2,4,4,CCTATCTCCCTAATCTAGGA,0,1071055
fldAp,0.2,4,4,CCTAGACCGGGTATTGGCTG,0,1074758
fldAp,0.2,4,4,CCTAATTCTGGTACGCCGGA,0,1155479
fldAp,0.2,4,4,CCTAAGCTCGTTGTGCGGAA,0,1142168
fldAp,0.2,4,4,CCGTTGGGCATTCACAGGGA,0,1165208
fldAp,0.2,4,4,CCGTTCGGGTAATCTTCTCA,0,1126814
fldAp,0.2,4,4,CCGTGTGCCGAAGGCAGTAG,0,1095046
fldAp,0.2,4,4,CCGTGATTTACCAATAGCGT,0,1130949
fldAp,0.2,4,4,CCGTCTTAGCGAGGCCGAGC,0,1111862
fldAp,0.2,4,4,CCGTCGGAGCTGGTTGTTCA,0,1108426
fldAp,0.2,4,4,CCGGTTTTGGGCATCGCTAC,0,1090128
fldAp,0.2,4,4,CCGGGTCGGTTAATGAGTCG,0,1109785
fldAp,0.2,4,4,CCGGGCTTAGCAACTGCGCA,0,1115908
fldAp,0.2,4,4,CCGGGCTGTGAGGTGCTCGT,0,1176251
fldAp,0.2,4,4,CCGGGAGGCGGGGGCTAGAA,0,1063823
fldAp,0.2,4,4,CCGGCTACGGTGATATCTTC,0,1097286
fldAp,0.2,4,4,CCGGCTACCCCAGGGAAATC,0,1090990
fldAp,0.2,4,4,CCGGCCTTCTTTACCTTAAA,0,1081869
fldAp,0.2,4,4,CCGGCATTTGGATCGCCCAT,0,1067497
fldAp,0.2,4,4,CCGGACCAGGACCTCACGCA,0,1070933
fldAp,0.2,4,4,CCGGAACCAGGGCTTTTCGT,0,1094831
fldAp,0.2,4,4,CCGCTTCCTGTACCCAGAGA,0,1122411
fldAp,0.2,4,4,CCGCTGGAAGGGACTCATGC,0,1082952
fldAp,0.2,4,4,CCGCTCGGATCCGCGGACAG,0,1184048
fldAp,0.2,4,4,CCGCCGCGAGGGTCCCTAGC,0,1071637
fldAp,0.2,4,4,CCGCAGAGGCGTCAAAGGCA,0,1079728
fldAp,0.2,4,4,CCGCACTAGACAATAGCACC,0,1084739
fldAp,0.2,4,4,CCGAATGATATACAGAAGTA,0,1123937
fldAp,0.2,4,4,CCGAATGACTCAAACAGTGG,0,1109632
fldAp,0.2,4,4,CCCTTTCATAGCACTTATGT,0,1117778
fldAp,0.2,4,4,CCCTTAGTTGGCGCTTATAA,0,1108506
fldAp,0.2,4,4,CCCTGCAGCTCAATACTCGT,0,1099262
fldAp,0.2,4,4,CCCTGATTAGCAGACTTCAC,0,1092876
fldAp,0.2,4,4,CCCTGACCTGTCTTGCTGTC,0,1163062
fldAp,0.2,4,4,CCCTCGGTAGTATAATACCG,0,1172811
fldAp,0.2,4,4,CCCTCAGAACATTATGGGCT,0,1064156
fldAp,0.2,4,4,CCCTAGTCGAGCTTCGGACT,0,1163204
fldAp,0.2,4,4,CCCGTTGAAGACATTCTATT,0,1116717
fldAp,0.2,4,4,CCCGGTATTGTAAACAGACG,0,1100662
fldAp,0.2,4,4,CCCGGCGGGATTCGCCCGGT,0,1108446
fldAp,0.2,4,4,CCCGCTGATATCGTGTTGTA,0,1170986
fldAp,0.2,4,4,CCCGATGTAATGGCAAGTAT,0,1095178
fldAp,0.2,4,4,CCCGATCCTACTACGCAAGA,0,1130999
fldAp,0.2,4,4,CCCCTTTGCGTACGTAGGCT,0,1065303
fldAp,0.2,4,4,CCCCTTGTTCAACCGAGTGT,0,1128296
fldAp,0.2,4,4,CCCCTTGGCTGCGGAGATGT,0,1081137
fldAp,0.2,4,4,CCCCTAGTTACTATTTCCTT,0,1113538
fldAp,0.2,4,4,CCCCGTTGTGCTACGGAGCA,0,1168561
fldAp,0.2,4,4,CCCCGTCTCCCCGAACGGAA,0,1103513
fldAp,0.2,4,4,CCCCGAGGTGAACAGCACCC,0,1165172
fldAp,0.2,4,4,CCCCGAGGATGCTATATAAT,0,1170142
fldAp,0.2,4,4,CCCCCGTTATGGCTGTCGTC,0,1093884
fldAp,0.2,4,4,CCCCCGCCTGCGGTCCCCAT,0,1150704
fldAp,0.2,4,4,CCCCATGTTTTCGCTCCCAC,0,1108259
fldAp,0.2,4,4,CCCCAGGAGGCATGCATGGA,0,1133882
fldAp,0.2,4,4,CCCCAAGTCTCGTGTGTACC,0,1088598
fldAp,0.2,4,4,CCCATGCAGTTAAGCGCGTC,0,1123420
fldAp,0.2,4,4,CCCATCAGAGAGTCGGAATA,0,1120132
fldAp,0.2,4,4,CCCATAGCCTTCAAGATCTG,0,1099858
fldAp,0.2,4,4,CCCAGGCTGTTCCTAGCCGG,0,1066830
fldAp,0.2,4,4,CCCACTCATCTGTAGGCTTT,0,1168461
fldAp,0.2,4,4,CCCAAGTCTATTACAGCACG,0,1071358
fldAp,0.2,4,4,CCCAACTCATCAGTTGCCCG,0,1126175
fldAp,0.2,4,4,CCATTGTTTCTGTAAGAAGA,0,1150458
fldAp,0.2,4,4,CCATTGCTAAGGCTCCGTAG,0,1178443
fldAp,0.2,4,4,CCATTCATACTATACCTTTC,0,1072909
fldAp,0.2,4,4,CCATGTGATGGCCCTCATCC,0,1117335
fldAp,0.2,4,4,CCATGCCTAGCGGTCAGGAA,0,1074898
fldAp,0.2,4,4,CCATCTGAAACACCAACTAG,0,1169563
fldAp,0.2,4,4,CCATCTCTGCGCCTGGGATT,0,1112246
fldAp,0.2,4,4,CCATCGCGAGTATCATTAGT,0,1183239
fldAp,0.2,4,4,CCATCGAGGACGAGCAGTAC,0,1154591
fldAp,0.2,4,4,CCATCCTGGCAATGCGAAAG,0,1154330
fldAp,0.2,4,4,CCATAGGGACGCAAGTAAAA,0,1110716
fldAp,0.2,4,4,CCAGTTTGAGAGAGCGAATA,0,1161454
fldAp,0.2,4,4,CCAGTTGAAGTTTGTTTGGA,0,1158739
fldAp,0.2,4,4,CCAGTACAATGCTAAGGGTA,0,1184277
fldAp,0.2,4,4,CCAGTAATCCACCTTGGCCG,0,1067620
fldAp,0.2,4,4,CCAGTAAATAACTCGCCTTA,0,1173240
fldAp,0.2,4,4,CCAGGCGTCTTGGACGGATA,0,1178184
fldAp,0.2,4,4,CCAGCGCCCCTAACCACAAG,0,1183042
fldAp,0.2,4,4,CCAGCGAACAGCAACATCCG,0,1166611
fldAp,0.2,4,4,CCAGCAGGGACTTTGATTGT,0,1144721
fldAp,0.2,4,4,CCAGACTACTGACTGACGGT,0,1145191
fldAp,0.2,4,4,CCAGACAAGACTTTTACGCC,0,1136429
fldAp,0.2,4,4,CCACTTGGTTACACGTTACG,0,1117262
fldAp,0.2,4,4,CCACTATTTTTGTTTCTGAG,0,1131210
fldAp,0.2,4,4,CCACGGATCTCACGCCCAGG,0,1130734
fldAp,0.2,4,4,CCACGAGTAAAGGAATGCAT,0,1175615
fldAp,0.2,4,4,CCACCGGCGAGTAGATAAGC,0,1070907
fldAp,0.2,4,4,CCACCCTCGGCGTAAAGGAT,0,1115474
fldAp,0.2,4,4,CCACATTCTGGCTCTATAGC,0,1088521
fldAp,0.2,4,4,CCACAGGTCGGGTCATTAAG,0,1112714
fldAp,0.2,4,4,CCACAGAGGTACGGCCCGGT,0,1115587
fldAp,0.2,4,4,CCACAGAAGGGCTTGAGGAT,0,1109930
fldAp,0.2,4,4,CCAACGAACGGCTCTGAACC,0,1129692
fldAp,0.2,4,4,CCAAAGTCGGCGTGTTACTC,0,1170414
fldAp,0.2,4,4,CCAAAGTACCGGGTCTGAGG,0,1093147
fldAp,0.2,4,4,CCAAAGCTCCCGTTTCTCAG,0,1068446
fldAp,0.2,4,4,CCAAAATTTAATTAGCTTTT,0,1155827
fldAp,0.2,4,4,CCAAAACGTGATGCGAGGCG,0,1107995
fldAp,0.2,4,4,CATTTGGGTCACGCAAATCG,0,1065049
fldAp,0.2,4,4,CATTTCCCGCGATTGCATCT,0,1164967
fldAp,0.2,4,4,CATTGGGTAGCCCAGCTCAA,0,1094385
fldAp,0.2,4,4,CATTGGGCGCTAACTATGCA,0,1077973
fldAp,0.2,4,4,CATTGATTGGAGGCTATAGA,0,1129350
fldAp,0.2,4,4,CATTGATCCCGGAAGCGTAA,0,1115250
fldAp,0.2,4,4,CATTATCTAACCAGTGGAGA,0,1096433
fldAp,0.2,4,4,CATTATCACACGTTAAGATA,0,1172026
fldAp,0.2,4,4,CATTAGTCAGGGTCTTGCAT,0,1129906
fldAp,0.2,4,4,CATTAGGTGATGTCCCAGCT,0,1073198
fldAp,0.2,4,4,CATGTGAGTTATCCGACAGG,0,1100537
fldAp,0.2,4,4,CATGGTGGTCGCAGTTGAAT,0,1099204
fldAp,0.2,4,4,CATGCCCATATGTGAGACTG,0,1090121
fldAp,0.2,4,4,CATGAGTATTTCGTCACTTT,0,1146778
fldAp,0.2,4,4,CATGAGGAAAGAATAGCACC,0,1105322
fldAp,0.2,4,4,CATGAGATGGGGAACAGAGG,0,1161468
fldAp,0.2,4,4,CATGAAGCTACACACATTGC,0,1075451
fldAp,0.2,4,4,CATCTTTGACCAAACATTGC,0,1164843
fldAp,0.2,4,4,CATCTGGTGCATCGGCCATC,0,1181882
fldAp,0.2,4,4,CATCTGACTACAGCCCATTC,0,1147967
fldAp,0.2,4,4,CATCTCACTGAACAGTACGC,0,1146536
fldAp,0.2,4,4,CATCCGCATGCTCTGGAGGA,0,1147701
fldAp,0.2,4,4,CATCCCAGATGTGTCCGTCT,0,1066201
fldAp,0.2,4,4,CATCCATTGACAATCAACTG,0,1153482
fldAp,0.2,4,4,CATCCACTGAGACCGAGGAC,0,1156137
fldAp,0.2,4,4,CATCATTCCCTGACCCAAGG,0,1105125
fldAp,0.2,4,4,CATCATGTGGTTCTCCCCAT,0,1152898
fldAp,0.2,4,4,CATCACGAAGCTCCTTAAAG,0,1174066
fldAp,0.2,4,4,CATCAAGGCCAGGGTGCCGG,0,1141183
fldAp,0.2,4,4,CATATTGTACCTGGCCATGG,0,1107552
fldAp,0.2,4,4,CATATGTTAGTGCAATCTAT,0,1166469
fldAp,0.2,4,4,CATAGTGATTAGTGACGATT,0,1094979
fldAp,0.2,4,4,CATAGTCGGCCTAAGACATA,0,1180801
fldAp,0.2,4,4,CATACCGTTCTGGGGGGTCG,0,1157715
fldAp,0.2,4,4,CATAAGTCTCTGATAGTGCT,0,1136342
fldAp,0.2,4,4,CATAAGTATCCTGTCTTGAA,0,1135588
fldAp,0.2,4,4,CATAAATGTGGAAATTGACG,0,1093896
fldAp,0.2,4,4,CAGTTGAAATCGTGGAAAGA,0,1142157
fldAp,0.2,4,4,CAGTTATACGACAACCTCTT,0,1153961
fldAp,0.2,4,4,CAGTGTAGGACACGGTCTCA,0,1103917
fldAp,0.2,4,4,CAGTGGGTTGCGCCAAAACC,0,1075890
fldAp,0.2,4,4,CAGTGCCACCGAGTTCCTCG,0,1094186
fldAp,0.2,4,4,CAGTCATTTGCAACGGAGAC,0,1073527
fldAp,0.2,4,4,CAGTATGAGAAGAGCTAGGT,0,1154986
fldAp,0.2,4,4,CAGTATCTAGGCGAGAGTAA,0,1110486
fldAp,0.2,4,4,CAGTATCATAGGCATGCTGA,0,1149734
fldAp,0.2,4,4,CAGTAGGGCGTACTATCTCA,0,1145881
fldAp,0.2,4,4,CAGTACCGTCAGGAACCTAG,0,1129842
fldAp,0.2,4,4,CAGTAACCCCCTTTGGCATT,0,1158958
fldAp,0.2,4,4,CAGGTTTCGTCGGTCCGCAG,0,1164945
fldAp,0.2,4,4,CAGGTTGTTGTTTAGTCTCG,0,1181495
fldAp,0.2,4,4,CAGGTGTAGGGTAGGTAAAC,0,1085118
fldAp,0.2,4,4,CAGGTGGCCTGGATCGGCCT,0,1106956
fldAp,0.2,4,4,CAGGTACAGCATGCGTGCGC,0,1182343
fldAp,0.2,4,4,CAGGGCTTAAAGCCTAATGA,0,1131659
fldAp,0.2,4,4,CAGGGATAAGTACAGGCCCC,0,1103594
fldAp,0.2,4,4,CAGGCTTTTCGTATTGTGGA,0,1072263
fldAp,0.2,4,4,CAGGCTAGTACACCGAATTG,0,1132733
fldAp,0.2,4,4,CAGGCCCGATGTTGGACCAC,0,1103607
fldAp,0.2,4,4,CAGGCACATGGCAAAGAAGC,0,1177869
fldAp,0.2,4,4,CAGGATGTATGTAAATTTGC,0,1104376
fldAp,0.2,4,4,CAGCTTCATCGTCCTACTAA,0,1081138
fldAp,0.2,4,4,CAGCTCTGATTCCTCGAAAC,0,1074049
fldAp,0.2,4,4,CAGCTAATTATAGGGTATTC,0,1139343
fldAp,0.2,4,4,CAGCGTTAGATTAGCATTTG,0,1143860
fldAp,0.2,4,4,CAGCGGCCAGGATCCACGAC,0,1170242
fldAp,0.2,4,4,CAGCGCGCTCATCAAACAAG,0,1065937
fldAp,0.2,4,4,CAGCGATGAGTTTGATCCCT,0,1092700
fldAp,0.2,4,4,CAGCGACTTAAAGTTTGGCT,0,1127214
fldAp,0.2,4,4,CAGCCGCGGACAATCTCGAT,0,1127411
fldAp,0.2,4,4,CAGCCCGCGTGGCTCATGCC,0,1104355
fldAp,0.2,4,4,CAGCCCAAGTATTAAAGCCC,0,1175026
fldAp,0.2,4,4,CAGCCATGAGCTGGGAGCCA,0,1146500
fldAp,0.2,4,4,CAGCAACTGTTCACCGGGTT,0,1126671
fldAp,0.2,4,4,CAGATAGGAGTTCGGATAAA,0,1090036
fldAp,0.2,4,4,CAGAGTGGCTTACAACTTAC,0,1149828
fldAp,0.2,4,4,CAGAGCAGTCTGAAGAGTAT,0,1068330
fldAp,0.2,4,4,CAGACGGCCCGTTCCTGGTA,0,1077747
fldAp,0.2,4,4,CAGACGCGGGGATATTTGGA,0,1094282
fldAp,0.2,4,4,CAGACACTTGTTCGCGTCTC,0,1154138
fldAp,0.2,4,4,CAGACACTATGATGCTGCTT,0,1079556
fldAp,0.2,4,4,CAGAATGCATAAGCGCACTC,0,1089246
fldAp,0.2,4,4,CAGAAGGGAAATTGCTCTTA,0,1165762
fldAp,0.2,4,4,CACTTCATCCCCCATTTTAA,0,1113550
fldAp,0.2,4,4,CACTGTTTAGGGGTATAATT,0,1078381
fldAp,0.2,4,4,CACTGGCTATAAGTACCATT,0,1122161
fldAp,0.2,4,4,CACTGATTATGTCAATTTCA,0,1079665
fldAp,0.2,4,4,CACTCGCGAGTAGACGCATC,0,1091448
fldAp,0.2,4,4,CACTCCAAATAGACAATCGG,0,1071835
fldAp,0.2,4,4,CACTATCCTGGGTTCAAGGT,0,1181064
fldAp,0.2,4,4,CACTATAGGTTACCAATCTA,0,1091257
fldAp,0.2,4,4,CACTATACTTGAAACTTTCG,0,1165999
fldAp,0.2,4,4,CACGTGCTCCATACCATGTA,0,1086669
fldAp,0.2,4,4,CACGTCTCGCTCCAGGACGA,0,1139507
fldAp,0.2,4,4,CACGGAATCACCGTGAATCT,0,1099751
fldAp,0.2,4,4,CACGGAAGACTATGCTTGTT,0,1179725
fldAp,0.2,4,4,CACGCCGGGGGCTACAATCG,0,1179735
fldAp,0.2,4,4,CACGCCGACGAGCCTTTCAC,0,1088760
fldAp,0.2,4,4,CACGCATAGGTTATTTCTTA,0,1152041
fldAp,0.2,4,4,CACGAGTGGTTTACGGGTTG,0,1085147
fldAp,0.2,4,4,CACGAACCGCGAAAAAAGTT,0,1127134
fldAp,0.2,4,4,CACCTGGTGTGATGTCATGC,0,1154001
fldAp,0.2,4,4,CACCTGCGAAATATGGCGAC,0,1170342
fldAp,0.2,4,4,CACCGCAAATCAAGGGTCTC,0,1158747
fldAp,0.2,4,4,CACCGACTTCCTGTGTATGC,0,1068894
fldAp,0.2,4,4,CACCGACTCTACAACTGGTG,0,1075744
fldAp,0.2,4,4,CACCCCAATCACATATATTA,0,1179933
fldAp,0.2,4,4,CACCCAGCTAAGGAGAGATC,0,1121532
fldAp,0.2,4,4,CACCAGGGATCTTCGATCTA,0,1151347
fldAp,0.2,4,4,CACCAGAGTCGTTCCGGACA,0,1155719
fldAp,0.2,4,4,CACCACGGAAAATTCCACAG,0,1128632
fldAp,0.2,4,4,CACCAACCCGACAATCGTGT,0,1119128
fldAp,0.2,4,4,CACATCGAAAGTTATCTTGT,0,1130518
fldAp,0.2,4,4,CACATCCATTCCTTACGGCT,0,1159987
fldAp,0.2,4,4,CACAGTGCATAAGATGGGAA,0,1128820
fldAp,0.2,4,4,CACAGCGACAGTAGCCCAGT,0,1158988
fldAp,0.2,4,4,CACAGCCCAGCTTATCTGCG,0,1117016
fldAp,0.2,4,4,CACAGAGAGCGACTGGTCTC,0,1160577
fldAp,0.2,4,4,CACAGAACTTCTGTTGAGAG,0,1136118
fldAp,0.2,4,4,CACACTAGACCTCTATGCTT,0,1091732
fldAp,0.2,4,4,CACACGTATGCGTAAGGATT,0,1168529
fldAp,0.2,4,4,CACACATCGCAGGTTAAGTT,0,1139012
fldAp,0.2,4,4,CACACAACCGCGAACATGAT,0,1073620
fldAp,0.2,4,4,CACACAAATGATATGTATCT,0,1119095
fldAp,0.2,4,4,CACAATTGGCTATGTAAGTC,0,1103881
fldAp,0.2,4,4,CACAATAATCTTGTGTAAGC,0,1177348
fldAp,0.2,4,4,CACAACCTAGGGATCATAAA,0,1143749
fldAp,0.2,4,4,CAATTTCATAACCTTCTTCT,0,1169858
fldAp,0.2,4,4,CAATTTATGGCGCCACTACG,0,1102841
fldAp,0.2,4,4,CAATGCTAGTAGATCTTACA,0,1078527
fldAp,0.2,4,4,CAATGCCCTGTGAACCACAT,0,1076820
fldAp,0.2,4,4,CAATCTTAGTACATTGGTCA,0,1097590
fldAp,0.2,4,4,CAATCTACAAATCCATTTGT,0,1184272
fldAp,0.2,4,4,CAATCCGACCGGCATAACCT,0,1096508
fldAp,0.2,4,4,CAATCCACCGACCTTTTCAA,0,1110099
fldAp,0.2,4,4,CAATAGTCCCGGACTATCTA,0,1144792
fldAp,0.2,4,4,CAATAGGAGCGGGGCAGCAG,0,1169421
fldAp,0.2,4,4,CAATAGCGACATGGGCTCAC,0,1172287
fldAp,0.2,4,4,CAAGTTTTGATGACATATCA,0,1111953
fldAp,0.2,4,4,CAAGTGTGGGACGGACCGAC,0,1142281
fldAp,0.2,4,4,CAAGGTCGGGAACGGCTACA,0,1116961
fldAp,0.2,4,4,CAAGATGACATACCGCCCGA,0,1123774
fldAp,0.2,4,4,CAAGATCGCGTATACCTCCT,0,1165379
fldAp,0.2,4,4,CAACTTAATTAAATTCAGCT,0,1066677
fldAp,0.2,4,4,CAACTCCGAGAGAGAGGGAA,0,1186098
fldAp,0.2,4,4,CAACGTTCGATTACCTAGTT,0,1153846
fldAp,0.2,4,4,CAACGTCTGAGGCCTTCTTC,0,1067189
fldAp,0.2,4,4,CAACGCTCGACGACTTAGAC,0,1085299
fldAp,0.2,4,4,CAACGACTTCATTTTTGCAT,0,1173887
fldAp,0.2,4,4,CAACCGCGTCTAGGACCTTA,0,1068051
fldAp,0.2,4,4,CAACCCAGTCCGGTTATCTG,0,1183644
fldAp,0.2,4,4,CAACCATATTCACCAGGTGA,0,1172648
fldAp,0.2,4,4,CAACCAGCAGAGGTAGAGTG,0,1082332
fldAp,0.2,4,4,CAACATGGAGCGTTAGCGTA,0,1109235
fldAp,0.2,4,4,CAACATCTAAAAACGAGTCA,0,1164035
fldAp,0.2,4,4,CAACATATCACTGGGACGCT,0,1121949
fldAp,0.2,4,4,CAACAGCAACAGGTACTATC,0,1186506
fldAp,0.2,4,4,CAACACGAGCCTCTCAATTC,0,1133887
fldAp,0.2,4,4,CAAATTATTAGCAGGTTCAC,0,1176619
fldAp,0.2,4,4,CAAATTATACTGCACGTTTG,0,1086835
fldAp,0.2,4,4,CAAATCCCCGTCTTGACATT,0,1149644
fldAp,0.2,4,4,CAAATACGAGCGTCGAGAAG,0,1070836
fldAp,0.2,4,4,CAAATAACCTTGCAATTTGG,0,1131052
fldAp,0.2,4,4,CAAAGCTACGCCTCGTTGGC,0,1151106
fldAp,0.2,4,4,CAAAATTTGCTAACCCCGTA,0,1148996
fldAp,0.2,4,4,CAAAAGCCGCGTGTCTCACA,0,1152590
fldAp,0.2,4,4,ATTTTTAGTCGCCTAGGCGA,0,1140021
fldAp,0.2,4,4,ATTTTGGAATGCCGGTGGGA,0,1151580
fldAp,0.2,4,4,ATTTGTAGTTACACTCGATT,0,1185058
fldAp,0.2,4,4,ATTTGCGAAAGATGAGCTCA,0,1114389
fldAp,0.2,4,4,ATTTGCCACAGATTCCCGTT,0,1136596
fldAp,0.2,4,4,ATTTCTTCAAACTCGCAGTT,0,1119219
fldAp,0.2,4,4,ATTTCTGCTTCCAACTTAAA,0,1160327
fldAp,0.2,4,4,ATTTCGACCGGGAGAGCAGA,0,1153487
fldAp,0.2,4,4,ATTTCACCCGCTAAGCCTGG,0,1133501
fldAp,0.2,4,4,ATTTCAATCTGCCCCTATGT,0,1120712
fldAp,0.2,4,4,ATTGTGTACAGCGGCCAATT,0,1185221
fldAp,0.2,4,4,ATTGTCTCTTCAGAACGCGA,0,1106356
fldAp,0.2,4,4,ATTGTCGCCCGCTGGAAGCT,0,1063969
fldAp,0.2,4,4,ATTGGTAGATGTGCGCACAT,0,1158126
fldAp,0.2,4,4,ATTGGGTACGGTCCTTTTAA,0,1147056
fldAp,0.2,4,4,ATTGGCAATAACCGGAAGAT,0,1104679
fldAp,0.2,4,4,ATTGGAGCACTGTTTGTTTG,0,1070449
fldAp,0.2,4,4,ATTGGACTCGTTTAGGATAT,0,1089249
fldAp,0.2,4,4,ATTGGACACTTTTACGTCAA,0,1130531
fldAp,0.2,4,4,ATTGCGGGGTCAAAACCCCT,0,1179527
fldAp,0.2,4,4,ATTGCGCGTAGCTTACACGC,0,1183382
fldAp,0.2,4,4,ATTCTGCGAGCCCGATAGCG,0,1147949
fldAp,0.2,4,4,ATTCTCGTAGTCGGCGCTGT,0,1177707
fldAp,0.2,4,4,ATTCTAAATTACAAGGCGGC,0,1158057
fldAp,0.2,4,4,ATTCGCTTACAGGTGGGATT,0,1102503
fldAp,0.2,4,4,ATTCCGGCTAACGGCCCATT,0,1109147
fldAp,0.2,4,4,ATTCATGTTGCTCCCCGCTA,0,1130650
fldAp,0.2,4,4,ATTCATCAACAACGCTTCGC,0,1111348
fldAp,0.2,4,4,ATTCAGGTTAAGGGAACGCG,0,1111848
fldAp,0.2,4,4,ATTCAGATATTAACTTATTA,0,1162233
fldAp,0.2,4,4,ATTCACGAGTTCATCCATCC,0,1120340
fldAp,0.2,4,4,ATTCAATGGGATTTCTTTTT,0,1168748
fldAp,0.2,4,4,ATTATTCGCCTGTGTAGTTT,0,1068864
fldAp,0.2,4,4,ATTATCTAAGGTCCCGGATT,0,1119201
fldAp,0.2,4,4,ATTATATGTCGTGCTTGTAA,0,1184593
fldAp,0.2,4,4,ATTAGGTCATTCATACCTGC,0,1125573
fldAp,0.2,4,4,ATTAGCGACGGCTTTAAATC,0,1074866
fldAp,0.2,4,4,ATTAGCACGAGATACGTCTC,0,1101755
fldAp,0.2,4,4,ATTACCCCGGGACGAGTTCG,0,1136768
fldAp,0.2,4,4,ATTAACTGTGATGGAGAGGG,0,1128276
fldAp,0.2,4,4,ATTAACATACGCTCGACTTT,0,1128900
fldAp,0.2,4,4,ATTAAAAAAACTTATTGCCC,0,1082311
fldAp,0.2,4,4,ATGTTACGTGCATCAAATTT,0,1084062
fldAp,0.2,4,4,ATGTGACAAAATGATCTGTG,0,1088052
fldAp,0.2,4,4,ATGTCTTACATTATGCTTGG,0,1165800
fldAp,0.2,4,4,ATGTCTAGATGGGCAACCCC,0,1166752
fldAp,0.2,4,4,ATGTCAGACGACCACACTGG,0,1146790
fldAp,0.2,4,4,ATGTATGAGGTCTGTATAAA,0,1079456
fldAp,0.2,4,4,ATGTAATCAGCTCACATCGC,0,1098829
fldAp,0.2,4,4,ATGGTGCTGACGGGATACCT,0,1169066
fldAp,0.2,4,4,ATGGTACGTTAGGCTCTCAA,0,1074830
fldAp,0.2,4,4,ATGGTACGGGACAGTACGGT,0,1177727
fldAp,0.2,4,4,ATGGGAAGTATACTACCTCC,0,1092108
fldAp,0.2,4,4,ATGGGAAGGATATTGATCCC,0,1102984
fldAp,0.2,4,4,ATGGCTACAGGCTGGGGACT,0,1130440
fldAp,0.2,4,4,ATGGCTAAATCCAGTTCTGC,0,1078200
fldAp,0.2,4,4,ATGGCGGCCTGTTCGCACGG,0,1175015
fldAp,0.2,4,4,ATGGCGCTGCTAACGAGGGT,0,1159643
fldAp,0.2,4,4,ATGGCCGGATACAAACGTTT,0,1099719
fldAp,0.2,4,4,ATGGCCAAATGTCTATGTTT,0,1082680
fldAp,0.2,4,4,ATGGAGTGTAGTGAAACTCG,0,1074862
fldAp,0.2,4,4,ATGGACAGATCGTCGTCATC,0,1098625
fldAp,0.2,4,4,ATGCTGGGGTGTTCCACAGT,0,1155322
fldAp,0.2,4,4,ATGCTCCGATACCGGCAATG,0,1070418
fldAp,0.2,4,4,ATGCCCTTTAGAAGCCCTAG,0,1081945
fldAp,0.2,4,4,ATGCCACGTGGCGTCATCTT,0,1137214
fldAp,0.2,4,4,ATGCATGTTTAATGTTTTCA,0,1083470
fldAp,0.2,4,4,ATGCATACAGGTACTTGTCA,0,1173356
fldAp,0.2,4,4,ATGATTGACTGCTTGTCACG,0,1160189
fldAp,0.2,4,4,ATGAGTAATACTACTGGATT,0,1112135
fldAp,0.2,4,4,ATGAGGCGGCTCAGCATGCT,0,1172880
fldAp,0.2,4,4,ATGAGCAGAGGGCTGTTTTC,0,1184344
fldAp,0.2,4,4,ATGAGAGGTCGCTTAGGTAT,0,1093768
fldAp,0.2,4,4,ATGACCTCCTAAGCGAGAGA,0,1123455
fldAp,0.2,4,4,ATGACCAATTTGGCTTGCTC,0,1082141
fldAp,0.2,4,4,ATGAATCCTCAAATAGAGGG,0,1103657
fldAp,0.2,4,4,ATGAATACGGCGGGAGTCCC,0,1143618
fldAp,0.2,4,4,ATGAAGTAACTTGTATCGAC,0,1182758
fldAp,0.2,4,4,ATCTTTCTGGGGGCATGCTT,0,1151377
fldAp,0.2,4,4,ATCTTGGACGGTTGCCGAAC,0,1131758
fldAp,0.2,4,4,ATCTTCAGATGTTGAAATTG,0,1086386
fldAp,0.2,4,4,ATCTTATGCGTAGACTTCTT,0,1064871
fldAp,0.2,4,4,ATCTGTACCTAGGGGCGAAC,0,1159414
fldAp,0.2,4,4,ATCTGGCTGTAAATTTGGAC,0,1172723
fldAp,0.2,4,4,ATCTCTACGGAAGGCTGGTG,0,1109447
fldAp,0.2,4,4,ATCTCCCTGCGACGCTGGAT,0,1182107
fldAp,0.2,4,4,ATCTAGGAGGGTAGTCATGT,0,1071154
fldAp,0.2,4,4,ATCGTGGTAGTTAGGAAAAG,0,1126118
fldAp,0.2,4,4,ATCGTGAGAACCACCGGGAA,0,1162877
fldAp,0.2,4,4,ATCGTATAGCCAATGGATGA,0,1186833
fldAp,0.2,4,4,ATCGTATACGTGGTGCGGAC,0,1108584
fldAp,0.2,4,4,ATCGTAGACGGCCTCTATTC,0,1095706
fldAp,0.2,4,4,ATCGGGATTCAGGGTAGTAG,0,1170714
fldAp,0.2,4,4,ATCGGAGCTACTTCGAGGTG,0,1083077
fldAp,0.2,4,4,ATCGGAGAGCCGCAGCTAGA,0,1150141
fldAp,0.2,4,4,ATCGCTGATCGCCGCCACGG,0,1066468
fldAp,0.2,4,4,ATCGCGGATGGAACGCTTAT,0,1074114
fldAp,0.2,4,4,ATCGCCGACTTCTGGGACCC,0,1108081
fldAp,0.2,4,4,ATCGCACGTAGTCAAACGTA,0,1163034
fldAp,0.2,4,4,ATCGAGTCAAACTCGGACAC,0,1079306
fldAp,0.2,4,4,ATCGAGGACTACTTCTCAGT,0,1068560
fldAp,0.2,4,4,ATCGAGCGCTCTGACCTCGT,0,1147566
fldAp,0.2,4,4,ATCGACAACGTATAAGCGGT,0,1119848
fldAp,0.2,4,4,ATCGAAAGCGAAGGGAAACA,0,1074612
fldAp,0.2,4,4,ATCCTTTGACACGCCTTCCT,0,1110553
fldAp,0.2,4,4,ATCCGATCCAATGGGCATTG,0,1072053
fldAp,0.2,4,4,ATCCCTTGAAATATCACCCA,0,1166732
fldAp,0.2,4,4,ATCAGGCGGGGGAATCGGAA,0,1110152
fldAp,0.2,4,4,ATCAATGCAACATATAAGAC,0,1171174
fldAp,0.2,4,4,ATATTTGTTTGGGGATGTTT,0,1126692
fldAp,0.2,4,4,ATATTCTTGAAGGGTCTAGT,0,1180024
fldAp,0.2,4,4,ATATTCCAAGGGGATTCGGT,0,1077143
fldAp,0.2,4,4,ATATTAGTGCGTTGTGGACT,0,1111404
fldAp,0.2,4,4,ATATGCGATTTAAAGTCCAT,0,1145623
fldAp,0.2,4,4,ATATAGCACAGAGGGTGGAC,0,1125925
fldAp,0.2,4,4,ATAGTTGCACCTTTAATTTG,0,1175229
fldAp,0.2,4,4,ATAGGGCGCCTCTAGTCTTA,0,1148889
fldAp,0.2,4,4,ATAGGCGCACCCCCGCTGTA,0,1105761
fldAp,0.2,4,4,ATAGGCCCGGCAGCATATAG,0,1174149
fldAp,0.2,4,4,ATAGGAGTCCGATTGGCACA,0,1130858
fldAp,0.2,4,4,ATAGCGGTTGAGCCAGCGCC,0,1178925
fldAp,0.2,4,4,ATAGCCCATGCTGGTTGAAC,0,1155211
fldAp,0.2,4,4,ATACTTGGTTGATCCGACTC,0,1169978
fldAp,0.2,4,4,ATACTGCAGGGTTTTTTTTT,0,1076657
fldAp,0.2,4,4,ATACGTACGCCCATAGCACA,0,1071759
fldAp,0.2,4,4,ATACGACATTGTAAAAGAAG,0,1124192
fldAp,0.2,4,4,ATACGACAGGGTAGTAAGAA,0,1185401
fldAp,0.2,4,4,ATACCTCGCCCTTGGTGTGG,0,1157282
fldAp,0.2,4,4,ATACACCCGAGGTCTCATTT,0,1122753
fldAp,0.2,4,4,ATAATCTTGTCATGACCGTC,0,1070150
fldAp,0.2,4,4,ATAATCACCCGTAAAATAAC,0,1163678
fldAp,0.2,4,4,ATAAGGTGTCCCCATTGCTA,0,1086251
fldAp,0.2,4,4,ATAAGACGAGGTAAAGGTGG,0,1076995
fldAp,0.2,4,4,ATAAGAACGATGGTGGGCAT,0,1177757
fldAp,0.2,4,4,ATAACTTGGGCGTCGGGGAT,0,1140593
fldAp,0.2,4,4,ATAACCAACTATAGTTGTTT,0,1065785
fldAp,0.2,4,4,ATAACATATATGTATAAAGT,0,1121350
fldAp,0.2,4,4,ATAACAAAAAAAGAAGGACC,0,1113409
fldAp,0.2,4,4,ATAAAGTGATGCAGTGGGCT,0,1113692
fldAp,0.2,4,4,ATAAAGACGGGGGTACAATA,0,1178251
fldAp,0.2,4,4,AGTTTCATGAAGCTCGTTTG,0,1164263
fldAp,0.2,4,4,AGTTGGTGAACACATGGTAA,0,1172299
fldAp,0.2,4,4,AGTTGGAGGCGCCTTAGAAT,0,1099178
fldAp,0.2,4,4,AGTTCTGGTCACACCTTGGT,0,1144860
fldAp,0.2,4,4,AGTTATCATCAGTTATTTAG,0,1153225
fldAp,0.2,4,4,AGTTAGCGCAAGATGGTATA,0,1122271
fldAp,0.2,4,4,AGTTAAGACGAGATTCGATC,0,1071934
fldAp,0.2,4,4,AGTGTGGAGTAGACCGACAC,0,1150021
fldAp,0.2,4,4,AGTGTCGGCAAAATCTGCAT,0,1137473
fldAp,0.2,4,4,AGTGTATGTGCTAGAAAGTC,0,1083809
fldAp,0.2,4,4,AGTGGTCCCCTCTTGGTCGT,0,1104094
fldAp,0.2,4,4,AGTGGGTTCGCGATCGTATG,0,1106505
fldAp,0.2,4,4,AGTGGGTTAGACTTTGCTCT,0,1176779
fldAp,0.2,4,4,AGTGGCGAAGCCTAACTCAG,0,1164447
fldAp,0.2,4,4,AGTGGATATAGCGGTTCATT,0,1179754
fldAp,0.2,4,4,AGTGGAGGAAGTAAAAAGGC,0,1181059
fldAp,0.2,4,4,AGTGGAAACCTCTATAAACG,0,1064305
fldAp,0.2,4,4,AGTGATCACTCTGGGCGTTC,0,1147256
fldAp,0.2,4,4,AGTGATCAAACCCTAGCGCT,0,1183598
fldAp,0.2,4,4,AGTGAGATTAAGAGAATTCT,0,1073265
fldAp,0.2,4,4,AGTCTAGTCAACGGCCAAAC,0,1110516
fldAp,0.2,4,4,AGTCGTGAGCAACAGGAAGA,0,1140135
fldAp,0.2,4,4,AGTCGGGAGTAGTCGGCTGG,0,1104338
fldAp,0.2,4,4,AGTCACGCAGTTACTGAGTC,0,1169340
fldAp,0.2,4,4,AGTCAATTTGCCTACTAGAA,0,1066326
fldAp,0.2,4,4,AGTCAAGGTTATATGGTTCA,0,1115492
fldAp,0.2,4,4,AGTATTCGATTGGACAAGCC,0,1149044
fldAp,0.2,4,4,AGTATGTGCCCTCACAGTGC,0,1140573
fldAp,0.2,4,4,AGTATGTCTAATGGGCGGCA,0,1147411
fldAp,0.2,4,4,AGTATAGCTAAGATTAAAGG,0,1104320
fldAp,0.2,4,4,AGTACTTTCGGGAGTGCGTT,0,1071663
fldAp,0.2,4,4,AGTACGACGGATCCCATAGA,0,1131250
fldAp,0.2,4,4,AGTACAGGAAAGCGGGCATC,0,1150194
fldAp,0.2,4,4,AGTACAATTTAGAATTGAGT,0,1182852
fldAp,0.2,4,4,AGTAAGTGGTATCATATCAA,0,1131136
fldAp,0.2,4,4,AGTAAATTCCGTTTCGCTAT,0,1090585
fldAp,0.2,4,4,AGGTTTCCGGTATAGGCTTG,0,1082326
fldAp,0.2,4,4,AGGTGTCACCTCACCGGATT,0,1186763
fldAp,0.2,4,4,AGGTGGATCGGTGCCTACTA,0,1070308
fldAp,0.2,4,4,AGGTGCTTAAAGTACCGAAT,0,1163019
fldAp,0.2,4,4,AGGTGCGATCGTCCGCCACC,0,1169166
fldAp,0.2,4,4,AGGTGAGCTTATCTCACGAC,0,1075457
fldAp,0.2,4,4,AGGTCGGCCGCGGGCTCGTA,0,1077337
fldAp,0.2,4,4,AGGTATGCGAGGATCGGTAT,0,1185989
fldAp,0.2,4,4,AGGTATAAAGTGTACGGTCA,0,1140093
fldAp,0.2,4,4,AGGTAGCGTTCCGGCTCTAT,0,1172658
fldAp,0.2,4,4,AGGGTGTGTGTCTGATACAT,0,1173325
fldAp,0.2,4,4,AGGGTGTACCAAAACCTTCG,0,1140954
fldAp,0.2,4,4,AGGGTCCTTGAAAACTTTTA,0,1153891
fldAp,0.2,4,4,AGGGTCATAATACACCAAAC,0,1091654
fldAp,0.2,4,4,AGGGGTCTTTTCACATTGGT,0,1138680
fldAp,0.2,4,4,AGGGGTCACTCGCCAATCAT,0,1144649
fldAp,0.2,4,4,AGGGCCTATAACCAATTAGA,0,1132019
fldAp,0.2,4,4,AGGGCCGGAGAAGCCTTAGG,0,1100878
fldAp,0.2,4,4,AGGGCCACGCTTCAACCGTA,0,1155071
fldAp,0.2,4,4,AGGCTGTCATCTAGTCACTT,0,1101572
fldAp,0.2,4,4,AGGCTGGCCGATGTCTTTGA,0,1147987
fldAp,0.2,4,4,AGGCTCCACCTAGTTGGGGG,0,1072557
fldAp,0.2,4,4,AGGCTCAATACGGCCGCACA,0,1184028
fldAp,0.2,4,4,AGGCGCCCGGAGGTAAAGAC,0,1153361
fldAp,0.2,4,4,AGGCCTGGAGGGAAGCGTCC,0,1077764
fldAp,0.2,4,4,AGGCCGTCTTAAAATCGTTC,0,1145434
fldAp,0.2,4,4,AGGCCGCCTATTGAAACCCA,0,1093480
fldAp,0.2,4,4,AGGCCGAGGAGCTATCCTAA,0,1063811
fldAp,0.2,4,4,AGGCCCCTGAACAAGAGCAG,0,1146939
fldAp,0.2,4,4,AGGCAGTGAGTCCGCAGAAC,0,1164261
fldAp,0.2,4,4,AGGATGCAGAAGGCGAGCGT,0,1162159
fldAp,0.2,4,4,AGGATACTCAAGCTCTCGAG,0,1137983
fldAp,0.2,4,4,AGGAGTCATCATGGTATCAT,0,1148442
fldAp,0.2,4,4,AGGAGGAGTCGTAAGGAGTC,0,1111406
fldAp,0.2,4,4,AGGAGCGGGTGCTACCTGAA,0,1148186
fldAp,0.2,4,4,AGGACTGCGCAGGATTTGGG,0,1176278
fldAp,0.2,4,4,AGGACAGTCACCCGTTATCT,0,1107617
fldAp,0.2,4,4,AGGAAGGTTAAGAGTTATAC,0,1068433
fldAp,0.2,4,4,AGGAACTATAAATGTCATGA,0,1170644
fldAp,0.2,4,4,AGGAACGACTCTTAGAAGTA,0,1126912
fldAp,0.2,4,4,AGCTTGTTAATTTCGTATGG,0,1153748
fldAp,0.2,4,4,AGCTTCCTCTTCGCGTGAGA,0,1125498
fldAp,0.2,4,4,AGCTTAAGTATTGGTGGTAT,0,1092353
fldAp,0.2,4,4,AGCTGGCATAGTCTTCTCTG,0,1117873
fldAp,0.2,4,4,AGCTCTGCCATCTCACAGGT,0,1103252
fldAp,0.2,4,4,AGCTCTACTATATCGTGTTC,0,1123489
fldAp,0.2,4,4,AGCTCTAAGTATCCTGTAAC,0,1091009
fldAp,0.2,4,4,AGCTCCGCATTATGGGGCAG,0,1068801
fldAp,0.2,4,4,AGCTAGGCGGCCTTATTCAC,0,1141314
fldAp,0.2,4,4,AGCTACGGAGGGGCCGCGTA,0,1101762
fldAp,0.2,4,4,AGCGTTCGGAAGCGAACCCC,0,1176767
fldAp,0.2,4,4,AGCGTCGATATCTTTAGGGC,0,1122812
fldAp,0.2,4,4,AGCGTCCCGGTCGGTCGTCA,0,1140404
fldAp,0.2,4,4,AGCGGAAACCGGGAGCTATC,0,1065755
fldAp,0.2,4,4,AGCGCATAGCCCATCATATA,0,1178016
fldAp,0.2,4,4,AGCGCAGAGTTGAAGGGTTG,0,1123386
fldAp,0.2,4,4,AGCGATGGATAAGCGAAATT,0,1084650
fldAp,0.2,4,4,AGCCTCTGGTACCACCGCTA,0,1124972
fldAp,0.2,4,4,AGCCGCATTGCTCGGTACTT,0,1079127
fldAp,0.2,4,4,AGCCGACTATGGAGCCAGGT,0,1085003
fldAp,0.2,4,4,AGCCGAACCGGGACAAGGTG,0,1081225
fldAp,0.2,4,4,AGCCCTGGGATTGGCATGGT,0,1064428
fldAp,0.2,4,4,AGCCCTATCGGTCTGTTATG,0,1120706
fldAp,0.2,4,4,AGCCCCTATCACAGTGACCC,0,1097199
fldAp,0.2,4,4,AGCCCCGGGCTACGCGGTTA,0,1164619
fldAp,0.2,4,4,AGCCAACGCTGGACTCACTG,0,1088106
fldAp,0.2,4,4,AGCATCGATATGAGAACGTA,0,1149068
fldAp,0.2,4,4,AGCAGTGTGTTCCCCGTAAA,0,1173372
fldAp,0.2,4,4,AGCAGGATCTCCAAGTACTT,0,1162101
fldAp,0.2,4,4,AGCAGCACTTCGGCGGAATA,0,1104686
fldAp,0.2,4,4,AGCACTTACAGTCTCGGTAC,0,1175478
fldAp,0.2,4,4,AGCACGCTTTCTCTATTTAA,0,1133344
fldAp,0.2,4,4,AGCACCTATGGGTGACATAC,0,1136760
fldAp,0.2,4,4,AGCAAATGGGCGACTTATGG,0,1118235
fldAp,0.2,4,4,AGCAAAAGCGCATTCATGAT,0,1174988
fldAp,0.2,4,4,AGCAAAAGCCCACAGAGTAC,0,1067041
fldAp,0.2,4,4,AGATTGTTACGCTCTTGTCT,0,1085920
fldAp,0.2,4,4,AGATGTATGCTATCCGCAGA,0,1161895
fldAp,0.2,4,4,AGATGGTCGTTTGGAAGCAT,0,1157775
fldAp,0.2,4,4,AGATGATTTACCATAATAAC,0,1171743
fldAp,0.2,4,4,AGATGATACAACGGTCAAAA,0,1176083
fldAp,0.2,4,4,AGATCTTTTGCGCGCAACAC,0,1184664
fldAp,0.2,4,4,AGATCTCTTGCTGATGAGAA,0,1112869
fldAp,0.2,4,4,AGATCTAGCAAAAACGGGTG,0,1150230
fldAp,0.2,4,4,AGATCGGACAACTCGCGAAT,0,1134325
fldAp,0.2,4,4,AGATCAGAAAAAAAAGGCTA,0,1125194
fldAp,0.2,4,4,AGATAAGCCGATGTCTGCGT,0,1086613
fldAp,0.2,4,4,AGAGTTTTAAGAGGGCATAC,0,1136351
fldAp,0.2,4,4,AGAGTGCTAAGAGGCTGAAA,0,1142154
fldAp,0.2,4,4,AGAGTCATCCCGTCCGTAGG,0,1163870
fldAp,0.2,4,4,AGAGGTGGAGGAAGCAAGCA,0,1166359
fldAp,0.2,4,4,AGAGCTCATAGCTAGCACCT,0,1089011
fldAp,0.2,4,4,AGAGCTCAAAAAAATATAAC,0,1094848
fldAp,0.2,4,4,AGAGCCCCGGCCTTTAGTAT,0,1084903
fldAp,0.2,4,4,AGACTTGGCTGCAACAGTAC,0,1153063
fldAp,0.2,4,4,AGACTTACACGCTTACCTAT,0,1138979
fldAp,0.2,4,4,AGACTCATTGGGATTCTGCG,0,1180489
fldAp,0.2,4,4,AGACGTGGAACGCCACATCT,0,1117356
fldAp,0.2,4,4,AGACGGCTTCAAGTTGCATT,0,1170498
fldAp,0.2,4,4,AGACGGCGAGAAAGCTACCT,0,1096632
fldAp,0.2,4,4,AGACCCTCCGTAATTGTCCT,0,1140885
fldAp,0.2,4,4,AGACCACAGTGGTTCTAGTG,0,1127970
fldAp,0.2,4,4,AGACCACAATGATCTGGCTG,0,1138666
fldAp,0.2,4,4,AGACAGTTGTACCCAGGTTC,0,1148632
fldAp,0.2,4,4,AGACAACAACCTATCGAGCA,0,1082411
fldAp,0.2,4,4,AGAAGTGGTTACCACAGATC,0,1074436
fldAp,0.2,4,4,AGAAGTCAACTCACTGCTCG,0,1076164
fldAp,0.2,4,4,AGAAGGATGAACCACCCTGT,0,1127452
fldAp,0.2,4,4,AGAAGCCTCCGGATAACGAG,0,1119212
fldAp,0.2,4,4,AGAAGAGTGTCGCTAGCGTT,0,1068326
fldAp,0.2,4,4,AGAACTTCAAAAGCTAGGTT,0,1090857
fldAp,0.2,4,4,AGAACATTGGCATGGGGGTA,0,1096950
fldAp,0.2,4,4,ACTTTGCGAACTTTGGCACG,0,1144801
fldAp,0.2,4,4,ACTTTCAAATCCCGCAGCCC,0,1089400
fldAp,0.2,4,4,ACTTGTGGCTGAATTCTGCC,0,1150547
fldAp,0.2,4,4,ACTTCTGCTAGATATAGTGG,0,1150831
fldAp,0.2,4,4,ACTTCAGTGGAGGATTCCGG,0,1098168
fldAp,0.2,4,4,ACTTCACTCAGGTGTTTTTA,0,1085272
fldAp,0.2,4,4,ACTTATCATCCCAAGGTAGT,0,1106558
fldAp,0.2,4,4,ACTTAATTCGGACACCAGGT,0,1077251
fldAp,0.2,4,4,ACTGTGCAAGACGAGACTCA,0,1075672
fldAp,0.2,4,4,ACTGTCTACGGAGTAATACG,0,1172973
fldAp,0.2,4,4,ACTGTACCGCATGACGCTCC,0,1115213
fldAp,0.2,4,4,ACTGGTACCTTTTGTTAACG,0,1082299
fldAp,0.2,4,4,ACTGGGCATTAAGACGGGTG,0,1107006
fldAp,0.2,4,4,ACTGGACTCAGGTCGGAATC,0,1116051
fldAp,0.2,4,4,ACTGGACATGTTTCGAGTTT,0,1123726
fldAp,0.2,4,4,ACTGCGTAGGGCTGCCATCT,0,1100864
fldAp,0.2,4,4,ACTGCCTTCAACATGTAGGT,0,1133750
fldAp,0.2,4,4,ACTGCACCCTAACCATGGAC,0,1130592
fldAp,0.2,4,4,ACTCGTCTTTAAAGGAGGTT,0,1116042
fldAp,0.2,4,4,ACTCGTCCGATGGGGGCCGT,0,1069044
fldAp,0.2,4,4,ACTCGGTACATGCCTCCTAG,0,1089581
fldAp,0.2,4,4,ACTCGCATTATTAGCTTGCC,0,1159802
fldAp,0.2,4,4,ACTCGCATGTCAACAGACGA,0,1106237
fldAp,0.2,4,4,ACTCGAGTAACTCCACACGA,0,1120528
fldAp,0.2,4,4,ACTCCTCCTAGCCCACGCAG,0,1088138
fldAp,0.2,4,4,ACTCCGGATCTGAAGGGACC,0,1090351
fldAp,0.2,4,4,ACTCCGAATGTGCGTTGTCA,0,1088533
fldAp,0.2,4,4,ACTCAGGGAGTGCAGTTAGG,0,1116400
fldAp,0.2,4,4,ACTCAATCCGTTCCCATAAA,0,1066467
fldAp,0.2,4,4,ACTATTTTGGTTCCGGCTAT,0,1099062
fldAp,0.2,4,4,ACTATGACATCTTCACGATG,0,1185890
fldAp,0.2,4,4,ACTATAGCCCCGGGCGGATC,0,1089887
fldAp,0.2,4,4,ACTAGGTCCCCTGGACTGGT,0,1114211
fldAp,0.2,4,4,ACTAGCAACCGGCATTGAGG,0,1168475
fldAp,0.2,4,4,ACTACTGTAGCACTCGCGAA,0,1133216
fldAp,0.2,4,4,ACTACCGTCTGTGCAGTGCG,0,1066821
fldAp,0.2,4,4,ACTACCAGCGTGTTCAACCG,0,1119783
fldAp,0.2,4,4,ACTAAGTCACTCCTGTAGAG,0,1086700
fldAp,0.2,4,4,ACTAAGCAGGGGTGCAGTGG,0,1159204
fldAp,0.2,4,4,ACTAACGGTTTATGCGGCTA,0,1151265
fldAp,0.2,4,4,ACTAAATCTTGGTTTCCGCC,0,1174668
fldAp,0.2,4,4,ACTAAAGTGTTTACGCTGGA,0,1093966
fldAp,0.2,4,4,ACTAAAGTCGCGATCTGATA,0,1171374
fldAp,0.2,4,4,ACGTTTACTACCCTATATTC,0,1076234
fldAp,0.2,4,4,ACGTTAGAAGTCGGTCACAG,0,1131580
fldAp,0.2,4,4,ACGTGTGACTTTAGATAATC,0,1071826
fldAp,0.2,4,4,ACGTGTAGGCGGGTTGTTTC,0,1108119
fldAp,0.2,4,4,ACGTGGCTGCGTATTGTCCA,0,1181088
fldAp,0.2,4,4,ACGTGCACGAATTTCCGCGG,0,1169348
fldAp,0.2,4,4,ACGTGAGCCAACGGATCCAA,0,1070578
fldAp,0.2,4,4,ACGTCTAGCCTGAGAGACGA,0,1136103
fldAp,0.2,4,4,ACGTCGTTAGGAGTAATGGA,0,1136974
fldAp,0.2,4,4,ACGTATCGTAAGGCACGATG,0,1073438
fldAp,0.2,4,4,ACGGTTACTCAGTGCCCTCC,0,1086388
fldAp,0.2,4,4,ACGGTGCCTCTTGCGCTCGA,0,1134173
fldAp,0.2,4,4,ACGGTCTAACAGGAGTCGCG,0,1107200
fldAp,0.2,4,4,ACGGTCAAATATCTAGCACT,0,1175167
fldAp,0.2,4,4,ACGGGTGTGGGTCAAGTGGA,0,1152876
fldAp,0.2,4,4,ACGGGTCAGAACGCATTCGA,0,1098839
fldAp,0.2,4,4,ACGGGGTTGGCCCGGTGAAT,0,1179612
fldAp,0.2,4,4,ACGGGCTTAATTGGCGCTGG,0,1103120
fldAp,0.2,4,4,ACGGGCAGACGTGGGTGTTA,0,1116692
fldAp,0.2,4,4,ACGGCCGGTGGTAGAGAGCT,0,1069100
fldAp,0.2,4,4,ACGGATCAGCCAGTGAGTCA,0,1099442
fldAp,0.2,4,4,ACGGAGAACTTGGAAAGAGA,0,1088076
fldAp,0.2,4,4,ACGGAGAAAATGGCGGTGAG,0,1174166
fldAp,0.2,4,4,ACGCTCGGCACAGATCGCCC,0,1173215
fldAp,0.2,4,4,ACGCTATATACCAGCTTGCT,0,1175409
fldAp,0.2,4,4,ACGCTAGGCGCTCACACTGA,0,1068833
fldAp,0.2,4,4,ACGCTAGCTGGTGTCCGTGT,0,1064575
fldAp,0.2,4,4,ACGCTACAGTTCTCTGCTCT,0,1073901
fldAp,0.2,4,4,ACGCGTGCATAAACGCAATT,0,1122036
fldAp,0.2,4,4,ACGCGGGATCTGCCGACAAG,0,1162754
fldAp,0.2,4,4,ACGCGGCACGGTAACCCAAG,0,1186088
fldAp,0.2,4,4,ACGCCTGGCAGGACCCCTCC,0,1099156
fldAp,0.2,4,4,ACGCCACACACTTCGGATGA,0,1127574
fldAp,0.2,4,4,ACGCCAACTGGGGTTGCATG,0,1080993
fldAp,0.2,4,4,ACGCATTCCCCAACCCTGAA,0,1115898
fldAp,0.2,4,4,ACGCAGGCGTTCCGCCTCGT,0,1110687
fldAp,0.2,4,4,ACGATCAATCGTGGCACTAT,0,1139929
fldAp,0.2,4,4,ACGAGTGGGGCGTGCATTCA,0,1127515
fldAp,0.2,4,4,ACGACAGTGCGGTCCCTGCA,0,1122709
fldAp,0.2,4,4,ACGAACGTAGCGTCCTCTAG,0,1153310
fldAp,0.2,4,4,ACCTTTCAAAAGTAGTTACT,0,1114523
fldAp,0.2,4,4,ACCTGGACGGCTCTGCGGCA,0,1128738
fldAp,0.2,4,4,ACCTGAAATGTCCTAAATAT,0,1151880
fldAp,0.2,4,4,ACCTCGTGCAGCAGCCCTCT,0,1101763
fldAp,0.2,4,4,ACCTCAGATGCGAAAACTGT,0,1163633
fldAp,0.2,4,4,ACCGTGGGAGTGTACGGCGA,0,1141812
fldAp,0.2,4,4,ACCGTGCGGTATGCTGTTTC,0,1176498
fldAp,0.2,4,4,ACCGTACTTACCAACCGCAT,0,1121953
fldAp,0.2,4,4,ACCGGCTCCAGCGTGTCAAG,0,1153716
fldAp,0.2,4,4,ACCGGCCAATGCACTAAAAT,0,1121999
fldAp,0.2,4,4,ACCGGAGGAGCAATTAGTGT,0,1100501
fldAp,0.2,4,4,ACCGCTTCTAGAATCTAAGC,0,1095937
fldAp,0.2,4,4,ACCGCATTGCAGACCGCTCC,0,1144635
fldAp,0.2,4,4,ACCGACCGTTGGAGGCACGA,0,1152643
fldAp,0.2,4,4,ACCGAAAGGACGTTGTAAGT,0,1077324
fldAp,0.2,4,4,ACCCTCTAGTAAATCCGCTA,0,1172855
fldAp,0.2,4,4,ACCCTCCTAGACTACTAGAT,0,1078258
fldAp,0.2,4,4,ACCCGGTAGAAGAGCCCTCC,0,1165084
fldAp,0.2,4,4,ACCCGCATACTACAACTGGC,0,1177712
fldAp,0.2,4,4,ACCCGATAAGGAAGTCAGAC,0,1117212
fldAp,0.2,4,4,ACCCCTTGCTAGGCTTCTAC,0,1120784
fldAp,0.2,4,4,ACCCCGGTCCAACCTGTCAC,0,1093086
fldAp,0.2,4,4,ACCCATGGTGCCCCCACTCT,0,1129737
fldAp,0.2,4,4,ACCCATCTTCCTCTCCAAAC,0,1132785
fldAp,0.2,4,4,ACCCACACTTCTCGTTGCCT,0,1176330
fldAp,0.2,4,4,ACCCACAAGTGCCCGTTCGG,0,1117606
fldAp,0.2,4,4,ACCCAATCATGGGAACAGGG,0,1127706
fldAp,0.2,4,4,ACCATATGGGACAGCTAAAC,0,1153919
fldAp,0.2,4,4,ACCAGTTCATAAAGTCTGGA,0,1093022
fldAp,0.2,4,4,ACCAGTCGCATGGCAACACT,0,1102224
fldAp,0.2,4,4,ACCAGTATGAGTGGGGAAGA,0,1110918
fldAp,0.2,4,4,ACCAGGCATACAACCCCAAA,0,1091627
fldAp,0.2,4,4,ACCAGCGTCGCCGCCGGGGT,0,1158213
fldAp,0.2,4,4,ACCACCCCGAGATGACCGTA,0,1162736
fldAp,0.2,4,4,ACCACAGTAAGATCAAACCC,0,1123070
fldAp,0.2,4,4,ACATTTTCCCGAGGTACGGG,0,1098139
fldAp,0.2,4,4,ACATTGGTACAGTTTCGATC,0,1121097
fldAp,0.2,4,4,ACATTGGACGACTCGAGGTC,0,1177055
fldAp,0.2,4,4,ACATTCTGTATTCTGACTTT,0,1086652
fldAp,0.2,4,4,ACATTCAAGGATAGAACATT,0,1168755
fldAp,0.2,4,4,ACATTACGTTAGTTAGCACC,0,1115286
fldAp,0.2,4,4,ACATGTATCGGAAGACCCAC,0,1065222
fldAp,0.2,4,4,ACATGGGGGTCGTCTCTTAA,0,1127677
fldAp,0.2,4,4,ACATGGGGGGTCAACTAAAT,0,1136025
fldAp,0.2,4,4,ACATCGACAACGTGACAGGC,0,1076845
fldAp,0.2,4,4,ACATATCAGTGGCTTAAGGT,0,1098502
fldAp,0.2,4,4,ACATAGCCCAGAATCATCTG,0,1066443
fldAp,0.2,4,4,ACATACAAACAATACCGCTA,0,1155078
fldAp,0.2,4,4,ACAGTTCTGGTCGAATGTTT,0,1148786
fldAp,0.2,4,4,ACAGTTAGTGACCAATTTAC,0,1123246
fldAp,0.2,4,4,ACAGGTCTGCTTGGCAAGCG,0,1161427
fldAp,0.2,4,4,ACAGGTACGCGGGTAATGCA,0,1068252
fldAp,0.2,4,4,ACAGGATTGGGGGAGCTTAC,0,1122698
fldAp,0.2,4,4,ACAGCTCCTAGTAGCGGACA,0,1121049
fldAp,0.2,4,4,ACAGAGTATAGCAAAGGATC,0,1117920
fldAp,0.2,4,4,ACACTTCGTAATATGCCTAG,0,1063572
fldAp,0.2,4,4,ACACTGTGCTCGGAGCCTAG,0,1085557
fldAp,0.2,4,4,ACACTCTCACATTCTCGTGC,0,1101590
fldAp,0.2,4,4,ACACGTCGATTTTCGCTGAA,0,1150446
fldAp,0.2,4,4,ACACGGGGCCAGTTAGGACC,0,1099288
fldAp,0.2,4,4,ACACGCATGTGCGCAGCAAA,0,1132343
fldAp,0.2,4,4,ACACATTCTGGCAATCGGTC,0,1147647
fldAp,0.2,4,4,ACACACCGGAGCCAGAATAT,0,1115750
fldAp,0.2,4,4,ACACACAACGGCATATTTCT,0,1099198
fldAp,0.2,4,4,ACACAACCTTAGAGACGCCG,0,1143278
fldAp,0.2,4,4,ACAATCGAGGAACTCGAAAG,0,1080703
fldAp,0.2,4,4,ACAATCACGTATACATCGTG,0,1109563
fldAp,0.2,4,4,ACAACTTTCTGCTACCTTAG,0,1076523
fldAp,0.2,4,4,ACAACTCGTAGGCGGGGTGT,0,1173792
fldAp,0.2,4,4,ACAACCAGGGCAGTATAATG,0,1109213
fldAp,0.2,4,4,ACAAATTAAGTATGACGGAG,0,1185263
fldAp,0.2,4,4,AATTTCACGCTTCTCGCATT,0,1150554
fldAp,0.2,4,4,AATTTACTGAGGACACTTCC,0,1088703
fldAp,0.2,4,4,AATTTAAGGCCCAAGACAAG,0,1131804
fldAp,0.2,4,4,AATTGTAGCTAGCGCCAGTC,0,1087013
fldAp,0.2,4,4,AATTGTAAGCCCTTTTCCAA,0,1131488
fldAp,0.2,4,4,AATTGCTAATCTTCAAAGCG,0,1174103
fldAp,0.2,4,4,AATTGCCCAAATCATTGAAT,0,1129231
fldAp,0.2,4,4,AATTGCATGCCTTCAGGTGG,0,1080539
fldAp,0.2,4,4,AATTCTAAGTCTAGGAGACA,0,1101847
fldAp,0.2,4,4,AATGTTATGTTGTGCGTGCA,0,1171778
fldAp,0.2,4,4,AATGTACTCGCTGACGACTC,0,1090514
fldAp,0.2,4,4,AATGGACACGGGTTTGTGTG,0,1186775
fldAp,0.2,4,4,AATGCTCTCACGCTATGCGC,0,1070015
fldAp,0.2,4,4,AATGCTCCTCACGTCTAACA,0,1076006
fldAp,0.2,4,4,AATGCGTAAAATCATCAGAG,0,1115178
fldAp,0.2,4,4,AATGCCTGGGCTTTTTCTAT,0,1068841
fldAp,0.2,4,4,AATGCCGGAAGTATGACTCG,0,1176158
fldAp,0.2,4,4,AATGATGGGCTATCTTAATC,0,1126667
fldAp,0.2,4,4,AATGATCTGAGTCCAGGGAG,0,1107776
fldAp,0.2,4,4,AATGAGTTGCCTTCGCTTGA,0,1076426
fldAp,0.2,4,4,AATGAACTTCCGCGCGTGGT,0,1175104
fldAp,0.2,4,4,AATCTGAGCCTCCGAGCCTA,0,1125510
fldAp,0.2,4,4,AATCTCGCGGCGCCGCCGTT,0,1133831
fldAp,0.2,4,4,AATCTCATAGGTGGTCGATT,0,1135041
fldAp,0.2,4,4,AATCTACAGGCGCAAGCCCC,0,1154421
fldAp,0.2,4,4,AATCGGTTGGTCTCATCGTC,0,1098928
fldAp,0.2,4,4,AATCGGTCGAACGACATGTC,0,1161194
fldAp,0.2,4,4,AATCGCTGTGACATTTGGAC,0,1141354
fldAp,0.2,4,4,AATCCTCTTTGTAGGCCATC,0,1153681
fldAp,0.2,4,4,AATCCCAAGCTCCAGACCTC,0,1152259
fldAp,0.2,4,4,AATCATATTTCACCAGTAAT,0,1176888
fldAp,0.2,4,4,AATCAGAGGGCACCCAAGAA,0,1104608
fldAp,0.2,4,4,AATATTCTTCGGTCATTCGG,0,1085177
fldAp,0.2,4,4,AATATGAATAGGTCAGCGTC,0,1116953
fldAp,0.2,4,4,AATAGACTAATCTCTATGAG,0,1141908
fldAp,0.2,4,4,AATACTCGCCAGCTCGGGCG,0,1152991
fldAp,0.2,4,4,AATACACACCGGCGTCGTGA,0,1129174
fldAp,0.2,4,4,AATAATTCGCTGGTCCCGGT,0,1130118
fldAp,0.2,4,4,AATAACGTTCGGCTGACGCA,0,1119333
fldAp,0.2,4,4,AATAAAGGGAGACGTCGTCG,0,1130665
fldAp,0.2,4,4,AAGTTCGTCGAAGTCCGTTA,0,1069816
fldAp,0.2,4,4,AAGTGTCTCCTATTCCTCGA,0,1136500
fldAp,0.2,4,4,AAGTGTCGGGAAAATAAGAG,0,1123564
fldAp,0.2,4,4,AAGTGTCAGAGTACGTGGGA,0,1078542
fldAp,0.2,4,4,AAGTCGGATGCCAGGTACGG,0,1130060
fldAp,0.2,4,4,AAGTCGAAGTTGGGCCGGCT,0,1156860
fldAp,0.2,4,4,AAGTCCTCATCTAGAAGAGT,0,1170913
fldAp,0.2,4,4,AAGTCCAATGTCTATCCTGC,0,1081900
fldAp,0.2,4,4,AAGGTGTTGTCGAAGGACGA,0,1182198
fldAp,0.2,4,4,AAGGTGTGAGTGTCTGGCGT,0,1085740
fldAp,0.2,4,4,AAGGTCGTTTATAATCGTAA,0,1185752
fldAp,0.2,4,4,AAGGTATATAGGGTGCGAAG,0,1130258
fldAp,0.2,4,4,AAGGGCGCCCTCGCCGTCTC,0,1184866
fldAp,0.2,4,4,AAGGCTGCCCTAGCAGTGAT,0,1138535
fldAp,0.2,4,4,AAGGCGGGGGTAAACATGGA,0,1115602
fldAp,0.2,4,4,AAGGCCCCAAACCCCGACTT,0,1094054
fldAp,0.2,4,4,AAGGATTATGCTGATTGTCG,0,1127947
fldAp,0.2,4,4,AAGGAGTAGACTATCAATCG,0,1183582
fldAp,0.2,4,4,AAGGAGGCAAGGAATCTTAC,0,1172800
fldAp,0.2,4,4,AAGGAGACTACAGGGATTTT,0,1162420
fldAp,0.2,4,4,AAGCTCCGACGTTCAGCACA,0,1157591
fldAp,0.2,4,4,AAGCTACACAAATTCTGGTG,0,1175627
fldAp,0.2,4,4,AAGCGTGTCCCCCTTAAGAA,0,1166401
fldAp,0.2,4,4,AAGCGGTGGGGATGTCACAT,0,1124690
fldAp,0.2,4,4,AAGCGATGTTCAGAGGCCAG,0,1095643
fldAp,0.2,4,4,AAGCATCCTCGGGAATTGCG,0,1086180
fldAp,0.2,4,4,AAGCATATGAGTATACGGGG,0,1121320
fldAp,0.2,4,4,AAGCATAGACGGGCGGGGGT,0,1133024
fldAp,0.2,4,4,AAGAGGCTGTTTCAGATCAT,0,1134506
fldAp,0.2,4,4,AAGAGGACTACTTACCTGTT,0,1078932
fldAp,0.2,4,4,AAGAGAGTGGTACTCCGGCT,0,1087453
fldAp,0.2,4,4,AAGACGAGGCAGTCCTTACA,0,1122697
fldAp,0.2,4,4,AAGAACGGTCGTGTCCCCAA,0,1075730
fldAp,0.2,4,4,AAGAACATACCATCCAACTC,0,1183007
fldAp,0.2,4,4,AAGAAATTATGTACTAGCCA,0,1087861
fldAp,0.2,4,4,AACTTTTTTACTGCGACGCT,0,1096605
fldAp,0.2,4,4,AACTTTATAGGCTATTTGTT,0,1165406
fldAp,0.2,4,4,AACTTGGCTGCCATACAATT,0,1154793
fldAp,0.2,4,4,AACTTGCAATAGTTCCCCTA,0,1088018
fldAp,0.2,4,4,AACTTCAAGCCATAGCCAGA,0,1081443
fldAp,0.2,4,4,AACTTATGGGGGGGTCAAAT,0,1152949
fldAp,0.2,4,4,AACTCTTGAGGGTCTCCGAT,0,1135329
fldAp,0.2,4,4,AACTCGTCCCACTAGCCCTA,0,1088330
fldAp,0.2,4,4,AACTCCAGCACTTGTTATGA,0,1135080
fldAp,0.2,4,4,AACTCCAGATCCTGTTACAG,0,1124756
fldAp,0.2,4,4,AACTCATGATACAACAAACT,0,1121572
fldAp,0.2,4,4,AACTCACTAAAACTCAACCG,0,1162428
fldAp,0.2,4,4,AACTAGCCGGATCCGGTCGG,0,1153359
fldAp,0.2,4,4,AACTACATCGTGTAGCAGGC,0,1162537
fldAp,0.2,4,4,AACTAACTAAGAATAAATGA,0,1169018
fldAp,0.2,4,4,AACGTTACTACAGAACGAAC,0,1154625
fldAp,0.2,4,4,AACGTCATGACGTAGCGTTT,0,1132300
fldAp,0.2,4,4,AACGTACCAGCATGTAAGCA,0,1186831
fldAp,0.2,4,4,AACGTAATCCCGACATCAAT,0,1160677
fldAp,0.2,4,4,AACGGGCTCATAGCTAGCTG,0,1173386
fldAp,0.2,4,4,AACGCTTGTTCGGTGCTCTA,0,1152683
fldAp,0.2,4,4,AACGCTACCATTAAATTTCC,0,1081480
fldAp,0.2,4,4,AACGCCCCCCCCAGATTTAC,0,1069409
fldAp,0.2,4,4,AACGAGTAACTAATCCCAGT,0,1083142
fldAp,0.2,4,4,AACGAACACCGAACCGGTAG,0,1122780
fldAp,0.2,4,4,AACCTGCTAGTTCGCGTCAC,0,1079258
fldAp,0.2,4,4,AACCGTGACTGGTTTAGGGG,0,1103890
fldAp,0.2,4,4,AACCGTCGTGTCAATTCGAA,0,1096459
fldAp,0.2,4,4,AACCGGCTTTGATCCTAGAG,0,1086201
fldAp,0.2,4,4,AACCGAGCAGACTACTGATT,0,1101821
fldAp,0.2,4,4,AACCCTGGTGGGACCCCTTG,0,1099981
fldAp,0.2,4,4,AACCCGAAGCCCAGGTTGGT,0,1138416
fldAp,0.2,4,4,AACCCAATGGCACCATAGGT,0,1147217
fldAp,0.2,4,4,AACATACAGTAGAACAGGAA,0,1099339
fldAp,0.2,4,4,AACAGTTTTTCACACGGTTA,0,1067683
fldAp,0.2,4,4,AACAGGTGGGGGCTCGTTGC,0,1153119
fldAp,0.2,4,4,AACAGCGTAATGTGTTGGAA,0,1103381
fldAp,0.2,4,4,AACAGCGCACCTCATGTATT,0,1064873
fldAp,0.2,4,4,AACAGCAACTCCTCACGCCC,0,1068322
fldAp,0.2,4,4,AACAGAGCGAAGAATGGTTT,0,1086490
fldAp,0.2,4,4,AACACCGTTGTGGTCTCCGT,0,1071770
fldAp,0.2,4,4,AAATTGGGGCCGCTGTCTCT,0,1101779
fldAp,0.2,4,4,AAATTGAATGATAAATTGTA,0,1122114
fldAp,0.2,4,4,AAATTACTGACAAACGCTGC,0,1158600
fldAp,0.2,4,4,AAATGTGCCTCGCTCTGGTC,0,1096802
fldAp,0.2,4,4,AAATGGCACTGTATGTGCCC,0,1184209
fldAp,0.2,4,4,AAATCGGTGAGCGGAATCCG,0,1178498
fldAp,0.2,4,4,AAATCGGCAATTTTCATTAC,0,1120300
fldAp,0.2,4,4,AAATCGGACGGTCCCGTTGC,0,1080739
fldAp,0.2,4,4,AAATCCTGTGATAGCATGCA,0,1095213
fldAp,0.2,4,4,AAATCAACTTCAGCCGAGTA,0,1143062
fldAp,0.2,4,4,AAATAGCTGGCGTATCGGGC,0,1184017
fldAp,0.2,4,4,AAATACAGCCCGGCTTCCGT,0,1090481
fldAp,0.2,4,4,AAATAAGTTCCTAGCTGTGA,0,1107011
fldAp,0.2,4,4,AAATAAAACTAGCAGAGTGA,0,1136124
fldAp,0.2,4,4,AAAGTCTTAGGTGATAAAGG,0,1090959
fldAp,0.2,4,4,AAAGTATTCGTTTCGATACT,0,1083386
fldAp,0.2,4,4,AAAGGTGTTGAGGTCAATCG,0,1080952
fldAp,0.2,4,4,AAAGGTGGTTAGTGTATCGA,0,1140594
fldAp,0.2,4,4,AAAGCCGTTTAACCGTATGT,0,1067293
fldAp,0.2,4,4,AAAGATGCTTTTACATTGCA,0,1157304
fldAp,0.2,4,4,AAAGAGGTACGTAGATAAAA,0,1098815
fldAp,0.2,4,4,AAACTTTTTGCTCACTCAGA,0,1149315
fldAp,0.2,4,4,AAACTTCTCCCAGAGTACAT,0,1156233
fldAp,0.2,4,4,AAACTGCGCATAACAGCAGA,0,1182373
fldAp,0.2,4,4,AAACTCCTTCAGGAGTGTAC,0,1106976
fldAp,0.2,4,4,AAACCTCACGGCTACTGTAG,0,1153741
fldAp,0.2,4,4,AAAATTTTAGTACTAGGCGG,0,1074153
fldAp,0.2,4,4,AAAATGGGGCCGAGGGTCAG,0,1108969
fldAp,0.2,4,4,AAAATGACTGTGTGCTGTGC,0,1070072
fldAp,0.2,4,4,AAAATAATGGTGTCGAATCA,0,1091624
fldAp,0.2,4,4,AAAAGTGTTCAGATTTTTGT,0,1127503
fldAp,0.2,4,4,AAAAGTGCACAGCCCGATCG,0,1090898
fldAp,0.2,4,4,AAAAGGTACAGAGCAACATT,0,1174966
fldAp,0.2,4,4,AAAAGCTGTTGTTTCGGAAT,0,1098743
fldAp,0.2,4,4,AAAAAGCTCCAATCGGAATT,0,1104975
fldAp,0.25,3,3,TTTTTTCACTGTTTGGCGGC,0,1151993
fldAp,0.25,3,3,TTTTTGGTTGGACTGCTATG,0,1134789
fldAp,0.25,3,3,TTTTTGGCAACGGCGGTGAA,0,1069117
fldAp,0.25,3,3,TTTTGTGCACGCGGACAAAA,0,1167564
fldAp,0.25,3,3,TTTTGACGTCTACTCACTTG,0,1113087
fldAp,0.25,3,3,TTTTGAATGCACCATGGGTA,0,1075445
fldAp,0.25,3,3,TTTTGAAGTATGTCCCTAGA,0,1065112
fldAp,0.25,3,3,TTTTCTCGAAATACTATAGG,0,1068846
fldAp,0.25,3,3,TTTTCGGGAGTGTTATGTCA,0,1130235
fldAp,0.25,3,3,TTTTCGGATTCGTTTCCCGT,0,1068651
fldAp,0.25,3,3,TTTTCGGAAATTGGGTCGCG,0,1087876
fldAp,0.25,3,3,TTTTCACGCTGCTGCCTTGA,0,1170402
fldAp,0.25,3,3,TTTTACCCTATCATGAAGTC,0,1164972
fldAp,0.25,3,3,TTTGTCTTGGTCCGATCGAA,0,1120058
fldAp,0.25,3,3,TTTGGTTTGGAAATGAAAAG,0,1065079
fldAp,0.25,3,3,TTTGGTAAGAACGCATGTCC,0,1163099
fldAp,0.25,3,3,TTTGGGATCGGTTCCCCGTA,0,1103572
fldAp,0.25,3,3,TTTGGCAACGAGGATGCTTC,0,1109486
fldAp,0.25,3,3,TTTGCTTCGAATGCATTCGG,0,1120897
fldAp,0.25,3,3,TTTGCCATGTACGCTTTCCC,0,1090032
fldAp,0.25,3,3,TTTGCAGCCGTCAAGGGACA,0,1077834
fldAp,0.25,3,3,TTTGCAAGTCCCACACCGGA,0,1117290
fldAp,0.25,3,3,TTTGATATTATTCGGAGTAG,0,1139162
fldAp,0.25,3,3,TTTGAACTGCATTCAATCAA,0,1116186
fldAp,0.25,3,3,TTTCTTTCCGACGCGCCGCA,0,1073145
fldAp,0.25,3,3,TTTCTTGATGCATTCTTTGA,0,1135940
fldAp,0.25,3,3,TTTCTCTTTAATATGGGCTC,0,1075006
fldAp,0.25,3,3,TTTCTCGTTAATCCGAAGCA,0,1157130
fldAp,0.25,3,3,TTTCGTAACATGATTATACG,0,1140578
fldAp,0.25,3,3,TTTCGGTAAGCTGTCCATAT,0,1136846
fldAp,0.25,3,3,TTTCGCGGTTTGAGTGAGCT,0,1100772
fldAp,0.25,3,3,TTTCGCGATCTTGAGTGAGT,0,1177547
fldAp,0.25,3,3,TTTCGAGTGCAATGATCGTG,0,1072979
fldAp,0.25,3,3,TTTCGACATTACGCGCACGA,0,1152914
fldAp,0.25,3,3,TTTCGAACCCTATGGGCCGG,0,1093460
fldAp,0.25,3,3,TTTCGAAATCTTTTAGTCTG,0,1128188
fldAp,0.25,3,3,TTTCCTTTCTCCGGTTTCTT,0,1123498
fldAp,0.25,3,3,TTTCCTGAACATGATAGATT,0,1170533
fldAp,0.25,3,3,TTTCAGAGCAGGTCTCGGCC,0,1084212
fldAp,0.25,3,3,TTTATTTCGGACAGGGGCGG,0,1086181
fldAp,0.25,3,3,TTTATACGGAAACGGGTTGT,0,1069647
fldAp,0.25,3,3,TTTAGTCGTTGGCGTCGTGC,0,1088002
fldAp,0.25,3,3,TTTAGCGCGCGCACCGGACA,0,1151281
fldAp,0.25,3,3,TTTAGCATTTTACTGTTTAC,0,1070312
fldAp,0.25,3,3,TTTACACGCGCAACCCTAAG,0,1159672
fldAp,0.25,3,3,TTTAATTGACAGCCTAGCCA,0,1109653
fldAp,0.25,3,3,TTTAATTCATATCGTGCTAA,0,1080872
fldAp,0.25,3,3,TTTAATGATTCCTACGGTCG,0,1134655
fldAp,0.25,3,3,TTTAATGAGCGAAATACTCC,0,1102415
fldAp,0.25,3,3,TTTAATAATTTTTCTTGACA,0,1163503
fldAp,0.25,3,3,TTTAAGGGCCTTGAATACTT,0,1131218
fldAp,0.25,3,3,TTTAAACACCCTGCCCGTTT,0,1160936
fldAp,0.25,3,3,TTGTTTGTGAGATACAACTC,0,1080922
fldAp,0.25,3,3,TTGTTGCTGCGCGTCATAAG,0,1180341
fldAp,0.25,3,3,TTGTTGCATTACAGCCGGGT,0,1090434
fldAp,0.25,3,3,TTGTTGAACGTGCCACGTCT,0,1096367
fldAp,0.25,3,3,TTGTTCAGCTGCTTCTAGAG,0,1094567
fldAp,0.25,3,3,TTGTGCTAGAGACGGCGCGG,0,1166959
fldAp,0.25,3,3,TTGTGCCCCGAGCTCATACC,0,1166203
fldAp,0.25,3,3,TTGTGAGTGCGGACGTTCGT,0,1169173
fldAp,0.25,3,3,TTGTGAATTTCTCATAGTAA,0,1163896
fldAp,0.25,3,3,TTGTCGTCAGCTCGGATCAT,0,1150164
fldAp,0.25,3,3,TTGTCGTATTTCGTCCAACC,0,1067948
fldAp,0.25,3,3,TTGTCATCTGACCACATTTG,0,1170803
fldAp,0.25,3,3,TTGTCAGTGATAAAACAGTA,0,1140035
fldAp,0.25,3,3,TTGTCACCCTGCCTCCTAAC,0,1158209
fldAp,0.25,3,3,TTGTAGGGAGTAAAACTGCG,0,1122616
fldAp,0.25,3,3,TTGTACCCACGCGGCTCGAT,0,1103512
fldAp,0.25,3,3,TTGGTCCAACTCGGTTCTGC,0,1136724
fldAp,0.25,3,3,TTGGGTGGCACGAATGGAGG,0,1086076
fldAp,0.25,3,3,TTGGGGCTCCCGTGGGCGGA,0,1165079
fldAp,0.25,3,3,TTGGGGAGGCTGGACGTGGG,0,1109629
fldAp,0.25,3,3,TTGGGCGAACTCGAGTGTCC,0,1144762
fldAp,0.25,3,3,TTGGGATTACGGTCCCGTCT,0,1134189
fldAp,0.25,3,3,TTGGGATGCTGTGTCGGTAC,0,1081583
fldAp,0.25,3,3,TTGGGATCTTGCGGGATTTC,0,1115852
fldAp,0.25,3,3,TTGGGAGGCCTTTGCTTTCC,0,1157706
fldAp,0.25,3,3,TTGGCCCGATGCGTCCGTGA,0,1126737
fldAp,0.25,3,3,TTGGCACAAGGCTGGGATTG,0,1107448
fldAp,0.25,3,3,TTGCTATTCGGAGTGATTAC,0,1065721
fldAp,0.25,3,3,TTGCGCTTAAGTGAACTTCA,0,1155050
fldAp,0.25,3,3,TTGCCCCCAACGCATATGGT,0,1171715
fldAp,0.25,3,3,TTGCATCTCCAAGAAACATC,0,1171805
fldAp,0.25,3,3,TTGCATCGCTAAACCATCAC,0,1176676
fldAp,0.25,3,3,TTGCAGTGCCGGAGTAAAGT,0,1153231
fldAp,0.25,3,3,TTGCAGGGGTTCGGACACTC,0,1080675
fldAp,0.25,3,3,TTGCACCTCGCAAGGCAAGC,0,1134041
fldAp,0.25,3,3,TTGCAAAGCGTAAGGGCAGC,0,1166275
fldAp,0.25,3,3,TTGATTTGAATCCAGTTGTA,0,1131786
fldAp,0.25,3,3,TTGATTCAGAGGTCGCTTTA,0,1169230
fldAp,0.25,3,3,TTGATTAGCTCCAAAATTTG,0,1171530
fldAp,0.25,3,3,TTGATCATGCTGTGTTAACA,0,1130255
fldAp,0.25,3,3,TTGACTAAACGCGGAGACAC,0,1138517
fldAp,0.25,3,3,TTGACGCATTCATTAGTGAG,0,1063380
fldAp,0.25,3,3,TTGACCTGAGCAGTCGAAAT,0,1114496
fldAp,0.25,3,3,TTGACAACGAACGCCCTTCG,0,1067381
fldAp,0.25,3,3,TTGAAGGATAAGCATTACTG,0,1148251
fldAp,0.25,3,3,TTGAACCCACTTGGTATACG,0,1100029
fldAp,0.25,3,3,TTGAAAAAGTCTCTGTCTAC,0,1066622
fldAp,0.25,3,3,TTCTTTACAAACTCATTTTC,0,1093844
fldAp,0.25,3,3,TTCTGATTGTTAGAGTTCTG,0,1086785
fldAp,0.25,3,3,TTCTGATCCTGCACGCCCAA,0,1138653
fldAp,0.25,3,3,TTCTCTGGCCATCAGGAGGC,0,1085769
fldAp,0.25,3,3,TTCTCTACGGACCGGATACG,0,1181934
fldAp,0.25,3,3,TTCTCAAAGACCCATGAAGA,0,1126380
fldAp,0.25,3,3,TTCTAGACGGAATGCAAACG,0,1178569
fldAp,0.25,3,3,TTCTACTTGCGTCGCTCTTG,0,1168758
fldAp,0.25,3,3,TTCGTGCTATCCGAGCGTTT,0,1164565
fldAp,0.25,3,3,TTCGGTATGGACGCCAGCCA,0,1163479
fldAp,0.25,3,3,TTCGGGCGCGATTGCCTCGC,0,1116500
fldAp,0.25,3,3,TTCGGATTCAGCCACCTGGC,0,1176063
fldAp,0.25,3,3,TTCGGAATACGCTTTGGGGT,0,1155251
fldAp,0.25,3,3,TTCGCTCGGTGACCCCGTTT,0,1160744
fldAp,0.25,3,3,TTCGATGGCAAAACTATCTT,0,1102022
fldAp,0.25,3,3,TTCGAGTCGGCGGCGTTCGC,0,1148303
fldAp,0.25,3,3,TTCGACCTCGGCGGGTTATG,0,1170441
fldAp,0.25,3,3,TTCGAATGATTAGGCCACCG,0,1109390
fldAp,0.25,3,3,TTCGAAGGGAAATGCCTGTA,0,1154553
fldAp,0.25,3,3,TTCCTGGCATAAACGGTGTT,0,1113825
fldAp,0.25,3,3,TTCCTCAACACGGGTCCTAG,0,1101124
fldAp,0.25,3,3,TTCCTATACCAAACGGTTTT,0,1105107
fldAp,0.25,3,3,TTCCGGGGGGGTTCTAGGTA,0,1157858
fldAp,0.25,3,3,TTCCGCATTTGGACAATGCA,0,1070494
fldAp,0.25,3,3,TTCCAGGGGGAACATTAGTG,0,1111135
fldAp,0.25,3,3,TTCCACCGGAGCGTCATGCC,0,1090140
fldAp,0.25,3,3,TTCCACAGGGCCACCCACGT,0,1108855
fldAp,0.25,3,3,TTCATTTTCTTTGAGCTATG,0,1179350
fldAp,0.25,3,3,TTCAGTGCCTACCTCGGCAT,0,1177556
fldAp,0.25,3,3,TTCAGCTCTTTATACCGAAC,0,1126421
fldAp,0.25,3,3,TTCAGCTCTGTAGATAAAGG,0,1076876
fldAp,0.25,3,3,TTCAGCTAACCGACATCACA,0,1145290
fldAp,0.25,3,3,TTCAGAATCGACGACAGTCT,0,1171045
fldAp,0.25,3,3,TTCAGAAGATAATTGAGTGT,0,1183439
fldAp,0.25,3,3,TTCACCTGAAGTGCACGTGC,0,1125316
fldAp,0.25,3,3,TTCACCATATCGGAGACTGG,0,1179739
fldAp,0.25,3,3,TTCACACTGCCTCCCAACGT,0,1106456
fldAp,0.25,3,3,TTATTATAAGTGCGCGTGGA,0,1108579
fldAp,0.25,3,3,TTATTACGCCGCACCTAGAC,0,1092476
fldAp,0.25,3,3,TTATGTATTACATGTAGTCG,0,1089204
fldAp,0.25,3,3,TTATGATCCCGAGGAACCTA,0,1105187
fldAp,0.25,3,3,TTATCTTCAAAGATTGAGTC,0,1135121
fldAp,0.25,3,3,TTATCGGGTTGCAACAGTCA,0,1184404
fldAp,0.25,3,3,TTATATTAGTGAGTCAGATC,0,1126388
fldAp,0.25,3,3,TTATATCCGGGCGAACCTTA,0,1128888
fldAp,0.25,3,3,TTATACACAGGGGTGAACCT,0,1112044
fldAp,0.25,3,3,TTATAATCGGTTCAATGGAG,0,1085986
fldAp,0.25,3,3,TTAGTAGTCCTTGGAGCGCC,0,1186907
fldAp,0.25,3,3,TTAGGCATGGTTGGAGATTC,0,1165733
fldAp,0.25,3,3,TTAGGCATGGACAGAATGAA,0,1072315
fldAp,0.25,3,3,TTAGATACCCGCACCAGGTC,0,1182661
fldAp,0.25,3,3,TTAGAGATCCAGAAAGCCTT,0,1185601
fldAp,0.25,3,3,TTAGACGTTACATAATTTAT,0,1065121
fldAp,0.25,3,3,TTACTGAAGACAGCTAGTTT,0,1124343
fldAp,0.25,3,3,TTACTATGAAGTAGCTTTGC,0,1069342
fldAp,0.25,3,3,TTACTAGACGAATGGGTGAA,0,1152869
fldAp,0.25,3,3,TTACGTTCTCCTCTCTTCGT,0,1162054
fldAp,0.25,3,3,TTACGGTTATGTTCTGCTGC,0,1068796
fldAp,0.25,3,3,TTACCCGATATATACTGTCT,0,1175336
fldAp,0.25,3,3,TTACCAAGCCCCCGGTATGA,0,1104136
fldAp,0.25,3,3,TTACCAAAAGCTAGCAGGAC,0,1085207
fldAp,0.25,3,3,TTACACATGCTCTGTAAGGT,0,1168143
fldAp,0.25,3,3,TTACACATAAAGGCGTGCAC,0,1078118
fldAp,0.25,3,3,TTAATGCGTGAGCGTTCTGC,0,1119472
fldAp,0.25,3,3,TTAATCGCGGAATGTTGAAA,0,1074484
fldAp,0.25,3,3,TTAATAGTCCTCGCTTATTA,0,1147883
fldAp,0.25,3,3,TTAAGTGACAGGCATGGGGT,0,1150464
fldAp,0.25,3,3,TTAAGTACGAGGGTGGACAG,0,1114751
fldAp,0.25,3,3,TTAAGGAGATCTATTAAAGC,0,1132245
fldAp,0.25,3,3,TTAAGCTTTCGTGTACTTTA,0,1116666
fldAp,0.25,3,3,TTAAGCTAAGGTGTGCGCAG,0,1175533
fldAp,0.25,3,3,TTAAGCCGGTAGTGCGTAAT,0,1161308
fldAp,0.25,3,3,TTAACTTTCACTGAACAAAA,0,1074888
fldAp,0.25,3,3,TTAACCGTCTTCTTAACTTA,0,1177816
fldAp,0.25,3,3,TTAACAGGCATCGGCGGCAT,0,1086423
fldAp,0.25,3,3,TTAAAGTCCCGCGAGTGTAG,0,1113880
fldAp,0.25,3,3,TTAAAGCTATGGGCGACGAT,0,1161713
fldAp,0.25,3,3,TTAAAGCGTGAATAGAGGAT,0,1133142
fldAp,0.25,3,3,TTAAACAGCGGTCACCTCTG,0,1063404
fldAp,0.25,3,3,TGTTTTTGCGACGTCTACAC,0,1140619
fldAp,0.25,3,3,TGTTTTCGAATCGGCTGACA,0,1083134
fldAp,0.25,3,3,TGTTTGTTAAGCTAAGGTGC,0,1143691
fldAp,0.25,3,3,TGTTTCGCCGGAGACCCATA,0,1171836
fldAp,0.25,3,3,TGTTTATCATAGAGGCGACT,0,1158996
fldAp,0.25,3,3,TGTTGTGGTGCGTGCTAGGT,0,1158795
fldAp,0.25,3,3,TGTTGGCTATCGTCCCCAAT,0,1143031
fldAp,0.25,3,3,TGTTGATATATTACAGGTTC,0,1129040
fldAp,0.25,3,3,TGTTGACCTCCCAGCGCTGG,0,1155147
fldAp,0.25,3,3,TGTTCTATCAATATCGAGCG,0,1126959
fldAp,0.25,3,3,TGTTCCGAGAGAATACTCTG,0,1151883
fldAp,0.25,3,3,TGTTAGTTTATTGTTTTCAT,0,1069327
fldAp,0.25,3,3,TGTTAGTTCAGTGAAGTGTT,0,1086707
fldAp,0.25,3,3,TGTTACATAGCGTGCCCCCC,0,1072479
fldAp,0.25,3,3,TGTTAAAAGACGCCGATTAG,0,1139838
fldAp,0.25,3,3,TGTGTTAAATACTGTTAACG,0,1143066
fldAp,0.25,3,3,TGTGTCTATTCGTTTGAGGT,0,1099871
fldAp,0.25,3,3,TGTGGTTGGGATCTGAGGTG,0,1169351
fldAp,0.25,3,3,TGTGCTAATTATTGAGATGT,0,1100817
fldAp,0.25,3,3,TGTGATTGTCAATAGGGTCG,0,1104242
fldAp,0.25,3,3,TGTGAGCAGTAGCGTTGGTT,0,1162242
fldAp,0.25,3,3,TGTCTGCCCGCCTTGTCCAC,0,1098136
fldAp,0.25,3,3,TGTCTCCGGTCACTAAGTCA,0,1159240
fldAp,0.25,3,3,TGTCGTTAATTGAGCTAGAT,0,1168041
fldAp,0.25,3,3,TGTCGTAACAACACGGACCC,0,1146854
fldAp,0.25,3,3,TGTCGGTCGGTTTCCGAGAC,0,1152854
fldAp,0.25,3,3,TGTCGAATCCCCTACACATG,0,1130935
fldAp,0.25,3,3,TGTCCAAGGTAGTGAAATGT,0,1089184
fldAp,0.25,3,3,TGTCATCGGAGGCGTGACTG,0,1172968
fldAp,0.25,3,3,TGTCACTCATACTATCCGCT,0,1145667
fldAp,0.25,3,3,TGTCACCGGTTGGGTGTGAA,0,1107773
fldAp,0.25,3,3,TGTATTTAAGGGGCGCACAC,0,1138674
fldAp,0.25,3,3,TGTATGGTGTACTGAGGGGG,0,1139254
fldAp,0.25,3,3,TGTATGATTTGAATAGGTGG,0,1128435
fldAp,0.25,3,3,TGTAGTTTTTGGGCTGGCAT,0,1127805
fldAp,0.25,3,3,TGTACTGCCCGTCATATCCA,0,1064194
fldAp,0.25,3,3,TGTACTATATGATACCTCTG,0,1076591
fldAp,0.25,3,3,TGTAATCGGGAGTTAGAAGC,0,1071930
fldAp,0.25,3,3,TGTAACGCTTGTGCTTAGTC,0,1133283
fldAp,0.25,3,3,TGGTTTGATTAGATGCGTAA,0,1178942
fldAp,0.25,3,3,TGGTTAGTCATACACATCCT,0,1141142
fldAp,0.25,3,3,TGGTGTGTCCCTAGAGAGCG,0,1115296
fldAp,0.25,3,3,TGGTGTAGGTATCCCGTAAT,0,1127144
fldAp,0.25,3,3,TGGTGGTAGATACGTGAGTG,0,1120095
fldAp,0.25,3,3,TGGTCTGCCAATGGTGTTTG,0,1147288
fldAp,0.25,3,3,TGGTCGTTCGTTAAATTGAT,0,1143697
fldAp,0.25,3,3,TGGTCCAGCCATGATTGGCC,0,1081678
fldAp,0.25,3,3,TGGTAGTCTGATTACGTTCA,0,1152529
fldAp,0.25,3,3,TGGTACTTGTCGCGGTGTGG,0,1170972
fldAp,0.25,3,3,TGGGTTCCCGATGGTAGATA,0,1078929
fldAp,0.25,3,3,TGGGTCATTGGACACGGTGT,0,1171149
fldAp,0.25,3,3,TGGGTCACTCAGTCATTATA,0,1150353
fldAp,0.25,3,3,TGGGTCAAATCGGTTTCTAA,0,1069573
fldAp,0.25,3,3,TGGGGTCTCCTAATCCACGC,0,1133719
fldAp,0.25,3,3,TGGGCGATCACGTCAAGTCT,0,1124097
fldAp,0.25,3,3,TGGGCCGGTGTACTTTGGTG,0,1068358
fldAp,0.25,3,3,TGGGCAAGCGCCGTGCTAAA,0,1106514
fldAp,0.25,3,3,TGGGATGGTTGATCACTTGG,0,1087766
fldAp,0.25,3,3,TGGGAATATATAGCAGATGC,0,1115037
fldAp,0.25,3,3,TGGGAACCGCTCGGTAGGAA,0,1160225
fldAp,0.25,3,3,TGGCTTGAAAGGCACACAGT,0,1160393
fldAp,0.25,3,3,TGGCTCAAAATGACATTCTC,0,1159972
fldAp,0.25,3,3,TGGCGAAAGATTAGCCGAGC,0,1143198
fldAp,0.25,3,3,TGGCCCAATCAATTTTGGCT,0,1096925
fldAp,0.25,3,3,TGGCCACTGCTACTCAGGAG,0,1155142
fldAp,0.25,3,3,TGGATATGAGAAAGGTCCAA,0,1114894
fldAp,0.25,3,3,TGGAGTGCCCTCCGGCGGGA,0,1106503
fldAp,0.25,3,3,TGGACCGTTATTGGGAAGAG,0,1080449
fldAp,0.25,3,3,TGGAAGGGAAACCTGTCTTC,0,1075338
fldAp,0.25,3,3,TGGAAGATGCGGCGATCGGA,0,1131119
fldAp,0.25,3,3,TGGAAACGCTGGGTTTAGTC,0,1107128
fldAp,0.25,3,3,TGCTTTTGCCTTGCCCTAAT,0,1129267
fldAp,0.25,3,3,TGCTTCTCGGAGCCTACGTG,0,1139584
fldAp,0.25,3,3,TGCTGAGGTGTTTATTTCAA,0,1124923
fldAp,0.25,3,3,TGCTCTCAGCTCTTCCCGGT,0,1075085
fldAp,0.25,3,3,TGCTCGCGTACCTTGGAGTC,0,1116199
fldAp,0.25,3,3,TGCTCCCTATCTGACAGTTA,0,1174250
fldAp,0.25,3,3,TGCTAGGCAGCTATGATTCA,0,1071356
fldAp,0.25,3,3,TGCTAGAACAGGAATTGCTG,0,1063335
fldAp,0.25,3,3,TGCTACCAACACTCTTCTTT,0,1173458
fldAp,0.25,3,3,TGCTAAGGCTAGCTTTCTAA,0,1120193
fldAp,0.25,3,3,TGCTAACCTACTTGAATAAA,0,1111649
fldAp,0.25,3,3,TGCTAAAGTGCGGAAAGCCC,0,1117869
fldAp,0.25,3,3,TGCGTTAAACTGTGCATGTA,0,1140292
fldAp,0.25,3,3,TGCGTGTAACTTACTAACAC,0,1129065
fldAp,0.25,3,3,TGCGTCGGGTTGCTTCGTGA,0,1155317
fldAp,0.25,3,3,TGCGGTTAAGGTCTAGGGTA,0,1123898
fldAp,0.25,3,3,TGCGGTACGTCTAGTTGGAA,0,1090270
fldAp,0.25,3,3,TGCGGCCGGTATCGGAGTAA,0,1088592
fldAp,0.25,3,3,TGCGACTGGACACAAGCCCC,0,1172286
fldAp,0.25,3,3,TGCGACAAGTCAGGCTTCGC,0,1092254
fldAp,0.25,3,3,TGCGAAGCCATTACGTGTTG,0,1159123
fldAp,0.25,3,3,TGCGAACTGAGCGGGCTCTT,0,1127420
fldAp,0.25,3,3,TGCCTTCCGTGCCCACGTGG,0,1127484
fldAp,0.25,3,3,TGCCTGACCACTAAGTATCC,0,1118421
fldAp,0.25,3,3,TGCCTCGTGGGGTTTGGGGG,0,1092098
fldAp,0.25,3,3,TGCCTCGTCCTAGGAAGAGC,0,1152029
fldAp,0.25,3,3,TGCCTAGTGAAGGCCTGGTT,0,1117287
fldAp,0.25,3,3,TGCCGGAGGCCGCTCGCGGC,0,1094109
fldAp,0.25,3,3,TGCCGCTCAGGTACGCCAAA,0,1177572
fldAp,0.25,3,3,TGCCGATTAATTCCGGAGCA,0,1095578
fldAp,0.25,3,3,TGCCCATGGATGACAACACG,0,1070035
fldAp,0.25,3,3,TGCCCAGAAAATGACAGGAA,0,1092715
fldAp,0.25,3,3,TGCCATGGCCTAAACTGCGC,0,1150542
fldAp,0.25,3,3,TGCCACATCAATAGCACGAG,0,1108806
fldAp,0.25,3,3,TGCATGGAAGGAGGGCACTG,0,1106673
fldAp,0.25,3,3,TGCAGGTTCCAGCTACAGTA,0,1125636
fldAp,0.25,3,3,TGCAGGTCTAGCAATGAACA,0,1152397
fldAp,0.25,3,3,TGCAGGCTAAACCTGTGGCT,0,1135325
fldAp,0.25,3,3,TGCAGGCGATGCGCATTTGT,0,1169010
fldAp,0.25,3,3,TGCAATATGGGGTAAACGGG,0,1098408
fldAp,0.25,3,3,TGCAACACACGGTTCCATCT,0,1117784
fldAp,0.25,3,3,TGCAAACTCCAGGACGGATT,0,1105641
fldAp,0.25,3,3,TGATTTCCAAGCTACATTTG,0,1111708
fldAp,0.25,3,3,TGATTTATAAGTTGAGTCAA,0,1068177
fldAp,0.25,3,3,TGATGCGCATCCGTACGGAT,0,1137557
fldAp,0.25,3,3,TGATGCGATCATCTCGATTG,0,1110579
fldAp,0.25,3,3,TGATCGCGTTCTGCTACGCT,0,1115129
fldAp,0.25,3,3,TGATCGCCGATAAGGGGGAC,0,1064152
fldAp,0.25,3,3,TGATCCGGGACTTTAACAGA,0,1088337
fldAp,0.25,3,3,TGATCAGCTGCATCACGAGC,0,1119043
fldAp,0.25,3,3,TGATAGACCACCACGAAATT,0,1132522
fldAp,0.25,3,3,TGATACTGGTATGGCACTAG,0,1160015
fldAp,0.25,3,3,TGAGTTTGACTAACTTGCCT,0,1129295
fldAp,0.25,3,3,TGAGTGGACTACTCCGTGTC,0,1151635
fldAp,0.25,3,3,TGAGGGAGGGATCGATCCAC,0,1161303
fldAp,0.25,3,3,TGAGGCCACACCGTGGCGAA,0,1148642
fldAp,0.25,3,3,TGAGGATCCGATGGTGTGCT,0,1077709
fldAp,0.25,3,3,TGAGGAATGTTCACACAAAT,0,1094389
fldAp,0.25,3,3,TGAGGAACGGAGACCGGAGC,0,1068173
fldAp,0.25,3,3,TGAGCCTCCAGTTCACGATT,0,1184577
fldAp,0.25,3,3,TGAGCCCAATACTCTCCTAT,0,1094651
fldAp,0.25,3,3,TGAGAGCATTTGCGGATGGA,0,1119593
fldAp,0.25,3,3,TGACTTTTAGCGAGCCATAC,0,1120002
fldAp,0.25,3,3,TGACCTAAAGCAAGGGTTGC,0,1179525
fldAp,0.25,3,3,TGACCGGCGACCCCGCATCC,0,1120269
fldAp,0.25,3,3,TGACCGAAACGTTTTCTTTT,0,1105287
fldAp,0.25,3,3,TGACCCGGGCTGTAGGGGAC,0,1178524
fldAp,0.25,3,3,TGACCACAAATACGCCGTTC,0,1092849
fldAp,0.25,3,3,TGAATTCTGTTATATTCCGC,0,1181845
fldAp,0.25,3,3,TGAACTATGCGAACGTTAAA,0,1102075
fldAp,0.25,3,3,TGAACGCGTAGGATCCAGGT,0,1172928
fldAp,0.25,3,3,TGAACATTTCCCACCTCTCT,0,1091283
fldAp,0.25,3,3,TGAAACGACCGATGGTACAA,0,1090357
fldAp,0.25,3,3,TCTTTGGAGCGGGCCGCGAC,0,1106744
fldAp,0.25,3,3,TCTTCCCGAGATGACATTGT,0,1137239
fldAp,0.25,3,3,TCTTATGGAGATGGTGACAC,0,1109751
fldAp,0.25,3,3,TCTTAATGTCTGATATCTAA,0,1182297
fldAp,0.25,3,3,TCTTAACTGAACTTGAAGGC,0,1141251
fldAp,0.25,3,3,TCTGGTGAGGACCCACACTC,0,1070696
fldAp,0.25,3,3,TCTGCCGACTAGGATCTCGA,0,1129121
fldAp,0.25,3,3,TCTGATCAGTGCTACCCGGT,0,1163700
fldAp,0.25,3,3,TCTGAGCTACGTTATGTGAA,0,1122429
fldAp,0.25,3,3,TCTGAATTGAACTTCCGTCT,0,1168196
fldAp,0.25,3,3,TCTGAACGGCTCCAACAGGG,0,1121169
fldAp,0.25,3,3,TCTCGTACAGGTACGCGATG,0,1160297
fldAp,0.25,3,3,TCTCGTAATGGGCCAATGAT,0,1127618
fldAp,0.25,3,3,TCTCGACTTCGTAATTAAAT,0,1148894
fldAp,0.25,3,3,TCTCGAACTCCGGTGAAGTC,0,1107510
fldAp,0.25,3,3,TCTCCCCGGGACACGGCAAG,0,1086703
fldAp,0.25,3,3,TCTCAGACGAGAACTTTGTG,0,1159970
fldAp,0.25,3,3,TCTCAATCAGCAGGACTTGA,0,1092982
fldAp,0.25,3,3,TCTATATTAGCCCTGTTACC,0,1131117
fldAp,0.25,3,3,TCTAGGGATCGACGCCTCAC,0,1139810
fldAp,0.25,3,3,TCTAGATCGGTCTTAGAGGG,0,1088494
fldAp,0.25,3,3,TCTAGAGATTGGCTTCGGGT,0,1128762
fldAp,0.25,3,3,TCTAGAAAGAGATTGATAGC,0,1166280
fldAp,0.25,3,3,TCTACGGTCATAGGAAGTGA,0,1068226
fldAp,0.25,3,3,TCTAATTTGCGCGTTGCCTT,0,1155579
fldAp,0.25,3,3,TCGTTCATAAATTACGTAGA,0,1102423
fldAp,0.25,3,3,TCGTGTACTATTTATTGCAG,0,1122158
fldAp,0.25,3,3,TCGTGGGGCAACTCTATAGG,0,1103603
fldAp,0.25,3,3,TCGTGAGCCACTGGCGGTAA,0,1068243
fldAp,0.25,3,3,TCGTCCTAGGTTTGGTTTTA,0,1066661
fldAp,0.25,3,3,TCGTCATTCTAAAACAACGG,0,1085212
fldAp,0.25,3,3,TCGTCACCACTTAAATCCTA,0,1087300
fldAp,0.25,3,3,TCGTAGGAGTGATGTAATGT,0,1144571
fldAp,0.25,3,3,TCGTACCGAAACCAGGATTA,0,1131864
fldAp,0.25,3,3,TCGGTCCAATCGCTAAGCGT,0,1096714
fldAp,0.25,3,3,TCGGTCAAGCGCCGATTCGT,0,1063091
fldAp,0.25,3,3,TCGGGTAGTAAGTGCTCATC,0,1177508
fldAp,0.25,3,3,TCGGGGGACGCTAGGCCCCA,0,1129858
fldAp,0.25,3,3,TCGGGCAAATAGTACTTTCT,0,1143189
fldAp,0.25,3,3,TCGGCGAGGTCAAGTATTCA,0,1073514
fldAp,0.25,3,3,TCGGAGGCTTGGAAGTGATG,0,1072689
fldAp,0.25,3,3,TCGGAGCTCCATACTGGTGC,0,1084288
fldAp,0.25,3,3,TCGGAAGAATGTCCAGGTGG,0,1112671
fldAp,0.25,3,3,TCGCTGTGGCGACGCAGTCG,0,1115651
fldAp,0.25,3,3,TCGCCTCGGTTAATCGCGGT,0,1160721
fldAp,0.25,3,3,TCGCCGGGGTATCGCAATTG,0,1088722
fldAp,0.25,3,3,TCGCCATTGACGTATCGGTC,0,1098931
fldAp,0.25,3,3,TCGCATCGAAATCACCCATA,0,1127524
fldAp,0.25,3,3,TCGCAGTCCTAACATACTGT,0,1138289
fldAp,0.25,3,3,TCGCACCTGGCACTACGTTC,0,1178821
fldAp,0.25,3,3,TCGATTTACAGTGACAACTG,0,1065733
fldAp,0.25,3,3,TCGATTGTGTCCTTCGGGGT,0,1086701
fldAp,0.25,3,3,TCGATTAGCGTCATCTTAAA,0,1161478
fldAp,0.25,3,3,TCGATGGGTAAGCGATGGCG,0,1065961
fldAp,0.25,3,3,TCGATACGACGTCGCTTTAG,0,1113314
fldAp,0.25,3,3,TCGAGGGTATACATCCTATC,0,1092151
fldAp,0.25,3,3,TCGAGCCAGAGTAGGTGCCC,0,1102575
fldAp,0.25,3,3,TCGAGATGCCGCACGTAGAT,0,1149687
fldAp,0.25,3,3,TCGACCGAAGGGCACAGTGG,0,1124707
fldAp,0.25,3,3,TCGACAGTAATGCGTCGGGG,0,1114310
fldAp,0.25,3,3,TCGAATACCATTATCCATCC,0,1136830
fldAp,0.25,3,3,TCGAACCACTAAAACCCCCC,0,1135637
fldAp,0.25,3,3,TCGAAAGATCGCCACGGTGG,0,1091216
fldAp,0.25,3,3,TCCTGGGTTAAATGTAGACA,0,1156645
fldAp,0.25,3,3,TCCTGAGTCGCTAGACGGCC,0,1164949
fldAp,0.25,3,3,TCCTCGTTTCGTGGATGATT,0,1132908
fldAp,0.25,3,3,TCCTCCTCTTGGATCCGAGG,0,1173534
fldAp,0.25,3,3,TCCTATCCTTTTGTCGATAT,0,1184415
fldAp,0.25,3,3,TCCGTAAGAATTACCATCTG,0,1125528
fldAp,0.25,3,3,TCCGGGCAAGGGGCTTCTAA,0,1153218
fldAp,0.25,3,3,TCCGGCGGCGCAAGTTTTTA,0,1098858
fldAp,0.25,3,3,TCCGCAGGCAAGGCAGAAGA,0,1111563
fldAp,0.25,3,3,TCCGCACTAACCCAGACGTA,0,1149016
fldAp,0.25,3,3,TCCGACTGGGAGTTATTGTG,0,1133631
fldAp,0.25,3,3,TCCGACGGTGTACAAATCTC,0,1065334
fldAp,0.25,3,3,TCCGAAATGTGAAGACCCTG,0,1073219
fldAp,0.25,3,3,TCCCTGACGCAGAATCCGAC,0,1156428
fldAp,0.25,3,3,TCCCTCCTGCAAAAGCCTCC,0,1123098
fldAp,0.25,3,3,TCCCTAGGTAATCGAGAACC,0,1150078
fldAp,0.25,3,3,TCCCTAAGCGTTAATGAGCC,0,1125587
fldAp,0.25,3,3,TCCCGGTCTAGGTTGTAAAA,0,1162112
fldAp,0.25,3,3,TCCCCATTCGCGCTCGCCTT,0,1119803
fldAp,0.25,3,3,TCCCCAGACGTCGCCCTAGT,0,1165040
fldAp,0.25,3,3,TCCATTCTTTAGACCAGGGA,0,1078204
fldAp,0.25,3,3,TCCATCTTAGCTGGGGTATT,0,1072382
fldAp,0.25,3,3,TCCAGAGGACAGGGGCACGG,0,1157984
fldAp,0.25,3,3,TCCACTGCTAGTTCTAGGAA,0,1131749
fldAp,0.25,3,3,TCCACTCTGCACAGGTTACA,0,1123742
fldAp,0.25,3,3,TCCACGCTCAGCGGATTAAT,0,1073303
fldAp,0.25,3,3,TCCAAGGTGCCTACCATTTC,0,1092574
fldAp,0.25,3,3,TCCAAACGGTGCTCGACTCA,0,1103076
fldAp,0.25,3,3,TCATTGGAGGCTCTACTACT,0,1095017
fldAp,0.25,3,3,TCATTGACCAGAGCTAGTGG,0,1116782
fldAp,0.25,3,3,TCATTCTTTCCGTGCCTTGG,0,1087014
fldAp,0.25,3,3,TCATCGACCTGACAGTACAG,0,1119199
fldAp,0.25,3,3,TCATCACAGGATCGCACTGT,0,1108054
fldAp,0.25,3,3,TCATCAACTTGCCTGGAAGG,0,1077207
fldAp,0.25,3,3,TCATATATCAGGGTACCCAA,0,1170296
fldAp,0.25,3,3,TCATAGGCGCGTCCTTGCAG,0,1175240
fldAp,0.25,3,3,TCATACTGGTGAGTCTGTCG,0,1101759
fldAp,0.25,3,3,TCATAATCATATGGATAGGA,0,1162882
fldAp,0.25,3,3,TCAGTTGTCACCCGGAGTTA,0,1089006
fldAp,0.25,3,3,TCAGTGAAAACCAGAGAATA,0,1080606
fldAp,0.25,3,3,TCAGTCTTAACTTAATTTGG,0,1110980
fldAp,0.25,3,3,TCAGTAATAATACCAGACTG,0,1117439
fldAp,0.25,3,3,TCAGGCTGTTTGTAATTCAC,0,1100307
fldAp,0.25,3,3,TCAGGAGAGCAGGGCTTATT,0,1122325
fldAp,0.25,3,3,TCAGCGTATGACGAGCTCTA,0,1158203
fldAp,0.25,3,3,TCAGACTGGCACGTTATCAG,0,1180637
fldAp,0.25,3,3,TCAGAAATGAATTGTCAAGT,0,1142811
fldAp,0.25,3,3,TCACTGAGCTTTTTCCTACA,0,1104068
fldAp,0.25,3,3,TCACGTGAAAAGACTCAGTC,0,1099565
fldAp,0.25,3,3,TCACGGTGAGCGGGCTATAG,0,1141254
fldAp,0.25,3,3,TCACGGGGCCATGCAAGGAG,0,1181357
fldAp,0.25,3,3,TCACGCGCCTATAGTCTTCG,0,1078265
fldAp,0.25,3,3,TCACCTCTTCGAAGTCGGTA,0,1065714
fldAp,0.25,3,3,TCACATTTCTTAGGTGTTGT,0,1120150
fldAp,0.25,3,3,TCACATCAAAGTTTGTGGCG,0,1136780
fldAp,0.25,3,3,TCACAGGTTCAGTGGGTGTC,0,1097328
fldAp,0.25,3,3,TCACAGGTCAACCTCACGGG,0,1091045
fldAp,0.25,3,3,TCACACCCGCTGCAAATCAG,0,1149350
fldAp,0.25,3,3,TCACAAATTGCTCGGATTAC,0,1126656
fldAp,0.25,3,3,TCAATTGATATTGGTCGAAG,0,1094868
fldAp,0.25,3,3,TCAATCATATATTTATTTTC,0,1147367
fldAp,0.25,3,3,TCAATAGGTGTGCGGAGCAT,0,1090897
fldAp,0.25,3,3,TCAAGGATCTGGTAGTAGTG,0,1132525
fldAp,0.25,3,3,TCAAGCGGAAGGACTACAGG,0,1080019
fldAp,0.25,3,3,TCAAGAGCTATAATGATGAG,0,1172763
fldAp,0.25,3,3,TCAAGAGCAGACACACACAA,0,1137698
fldAp,0.25,3,3,TCAACGTAAGTTCTTTCAGG,0,1180080
fldAp,0.25,3,3,TCAACCCCGTGGCGCAGACT,0,1107832
fldAp,0.25,3,3,TCAACCCACTGTTCTTGTAA,0,1100235
fldAp,0.25,3,3,TCAACATCCCCTTTCATAAG,0,1077117
fldAp,0.25,3,3,TCAAAGTGAAACATAAGTCG,0,1185043
fldAp,0.25,3,3,TCAAAGAATCACTTAGCGAG,0,1108899
fldAp,0.25,3,3,TCAAACCATGTCGTGGGTCC,0,1107095
fldAp,0.25,3,3,TCAAAATGGCATGTTTGACA,0,1086853
fldAp,0.25,3,3,TCAAAACTGCGTAGTTTGGT,0,1146389
fldAp,0.25,3,3,TATTTTTTTCGGACACCTCA,0,1100520
fldAp,0.25,3,3,TATTTGATGGTGGCCCCGGC,0,1069199
fldAp,0.25,3,3,TATTTCATATGCCAATGGAC,0,1086868
fldAp,0.25,3,3,TATTTCAATGTCACGTATTA,0,1177649
fldAp,0.25,3,3,TATTCCAGAGAGCACTGTCG,0,1112886
fldAp,0.25,3,3,TATTAAGCGAACGGGTTAGA,0,1178483
fldAp,0.25,3,3,TATGTGCGAGTCGCAGCCAA,0,1152145
fldAp,0.25,3,3,TATGTCCGTCTCCAAGTTCA,0,1100238
fldAp,0.25,3,3,TATGGTAGCATGAGTAGTCA,0,1069586
fldAp,0.25,3,3,TATGGGAGCCTCGGAAAACA,0,1132645
fldAp,0.25,3,3,TATGCTGCGCAATGGACCAC,0,1071699
fldAp,0.25,3,3,TATGCGTGGTTGGGGTTTGT,0,1063408
fldAp,0.25,3,3,TATGCGACTCCCAAGCAACA,0,1130408
fldAp,0.25,3,3,TATGCCAATAGCAGTTTAAA,0,1106900
fldAp,0.25,3,3,TATGATATTCACGATGTGGT,0,1167100
fldAp,0.25,3,3,TATGATATGACCATGCGTTT,0,1087510
fldAp,0.25,3,3,TATGAGCGGAATGCGCCTTC,0,1085892
fldAp,0.25,3,3,TATGACAGGCCGCCGAGTAA,0,1105196
fldAp,0.25,3,3,TATCTTGGTTAGCGATACGG,0,1147710
fldAp,0.25,3,3,TATCTGTGTAACATGCCTGC,0,1161184
fldAp,0.25,3,3,TATCGGTAAGAAGAGTTCAC,0,1160674
fldAp,0.25,3,3,TATCGCTTACATGACCACGC,0,1100164
fldAp,0.25,3,3,TATCGAAGGTTTATTTGTCC,0,1100555
fldAp,0.25,3,3,TATCCGGGATGATTGAGGAC,0,1166172
fldAp,0.25,3,3,TATAGTGCAGTCCTTCTTGG,0,1085904
fldAp,0.25,3,3,TATAGCGTGTTCAGTTCGCG,0,1131701
fldAp,0.25,3,3,TATACCCTATCCCGCGGGTG,0,1182702
fldAp,0.25,3,3,TATACCACCGGGTGCGAGAT,0,1139900
fldAp,0.25,3,3,TATAATCCACGTGGAGCGTC,0,1136948
fldAp,0.25,3,3,TATAACGGTCAGAGTCTTAG,0,1094713
fldAp,0.25,3,3,TAGTATACCCTAGCTTAGAG,0,1151387
fldAp,0.25,3,3,TAGTAAGGACGGATACCAAT,0,1105481
fldAp,0.25,3,3,TAGGGTCGCTTTGACACACA,0,1100141
fldAp,0.25,3,3,TAGGGTACAACCCGATAATC,0,1116108
fldAp,0.25,3,3,TAGGGATGACCCCAACGGTT,0,1125871
fldAp,0.25,3,3,TAGGGAGCGTCAGTGCAGTT,0,1083318
fldAp,0.25,3,3,TAGGGACTACCCGTAGATGT,0,1074773
fldAp,0.25,3,3,TAGGCTGCGTGTATACAACG,0,1177642
fldAp,0.25,3,3,TAGGCGGTCTTCCGCGGGGA,0,1131614
fldAp,0.25,3,3,TAGGCCTAGGATAGCTCGCG,0,1078672
fldAp,0.25,3,3,TAGGCACTCGCGTTAGGCAA,0,1144107
fldAp,0.25,3,3,TAGGATCTCCGTTTTGCATC,0,1077315
fldAp,0.25,3,3,TAGGATCCCTAACGACGAGA,0,1128278
fldAp,0.25,3,3,TAGGACCTGGGGCCAACGCA,0,1163683
fldAp,0.25,3,3,TAGCTTCTAACAAGTTGGAT,0,1075167
fldAp,0.25,3,3,TAGCTTATTGCTCTCCGCCC,0,1122783
fldAp,0.25,3,3,TAGCTATCCGTACTTAATGC,0,1137862
fldAp,0.25,3,3,TAGCGCTATTCCGGTGGTGG,0,1104097
fldAp,0.25,3,3,TAGCGATGTTCATAATTGAA,0,1152666
fldAp,0.25,3,3,TAGCGAGGGATCCTGGCACT,0,1107784
fldAp,0.25,3,3,TAGCCTCACAATTCTACAAT,0,1125349
fldAp,0.25,3,3,TAGCACTAGGCATCAAGGAT,0,1174088
fldAp,0.25,3,3,TAGCACAAGTTAATTAGTAC,0,1063400
fldAp,0.25,3,3,TAGCAAGGTCCAGCACCGAT,0,1122010
fldAp,0.25,3,3,TAGCAAGGGTGTTTTCTTAT,0,1075585
fldAp,0.25,3,3,TAGATTACGAGCCTCAGAAT,0,1122899
fldAp,0.25,3,3,TAGATCGGATGGATTTTCAC,0,1062985
fldAp,0.25,3,3,TAGATCCTAGGGGCTCGTGT,0,1139790
fldAp,0.25,3,3,TAGATAAATCTCTAGATAGG,0,1125789
fldAp,0.25,3,3,TAGAGGACTCTGCTGGCCGA,0,1179651
fldAp,0.25,3,3,TAGAGATATGACCTCCCGTC,0,1156580
fldAp,0.25,3,3,TAGACATGATTACGGGTAGG,0,1085916
fldAp,0.25,3,3,TAGACATAGTTAAGATAGAC,0,1150246
fldAp,0.25,3,3,TACTTTGTTTTCAGCATTTC,0,1150906
fldAp,0.25,3,3,TACTTTCACATCACCGGGTC,0,1072511
fldAp,0.25,3,3,TACTGTTGGTCCTGATTTCT,0,1162637
fldAp,0.25,3,3,TACTCGACATGGGGATCAGG,0,1103442
fldAp,0.25,3,3,TACTCAAATGCGCCGGATTT,0,1152164
fldAp,0.25,3,3,TACTAATCGAGATCGCAAGT,0,1082523
fldAp,0.25,3,3,TACGTCCACGAGGACTTACC,0,1137016
fldAp,0.25,3,3,TACGGTAGATAACATTCGCC,0,1122170
fldAp,0.25,3,3,TACGGATCGGTACGAAAAGG,0,1121459
fldAp,0.25,3,3,TACGGAGTGAGGACCCCATC,0,1181089
fldAp,0.25,3,3,TACGCGCGCTCGACCTACGA,0,1090576
fldAp,0.25,3,3,TACCTGTCCTGGGGGCGCTA,0,1091441
fldAp,0.25,3,3,TACCTGGCGTTGTCTATTCT,0,1169852
fldAp,0.25,3,3,TACCTGAGCCTCGATTGCCC,0,1162326
fldAp,0.25,3,3,TACCTCCCCTCCAAAGTCCT,0,1107882
fldAp,0.25,3,3,TACCGGTTGGTGCTACGAAT,0,1115146
fldAp,0.25,3,3,TACCGCTCAGGACACAGCGA,0,1154379
fldAp,0.25,3,3,TACCCGGCATGTAGAGGACG,0,1119761
fldAp,0.25,3,3,TACCCACTTGGGATCCGGAA,0,1185970
fldAp,0.25,3,3,TACCCAAAGACCCCGTGTGG,0,1100129
fldAp,0.25,3,3,TACCATGCGTCGAGGCTTCT,0,1108573
fldAp,0.25,3,3,TACATAGTTTGGTTAAAGGG,0,1173808
fldAp,0.25,3,3,TACACTCGGACCCCATCCAC,0,1167852
fldAp,0.25,3,3,TACACAGTGATGCCGCCCTC,0,1125235
fldAp,0.25,3,3,TACAATCTCCTATTGGGGTG,0,1121489
fldAp,0.25,3,3,TACAAGGTGGGCGCTCGTTC,0,1186201
fldAp,0.25,3,3,TAATTGTCTTCGCATTGGAA,0,1107190
fldAp,0.25,3,3,TAATTCAACATCTCGGAATG,0,1161555
fldAp,0.25,3,3,TAATTACCACTCTCGAGACA,0,1075439
fldAp,0.25,3,3,TAATGTGTGCATCAGCACAG,0,1091847
fldAp,0.25,3,3,TAATGGTCGCTTGAACGAAA,0,1083813
fldAp,0.25,3,3,TAATCCACTGGTTGCTTGCC,0,1184416
fldAp,0.25,3,3,TAATATTCTTATGGAACACA,0,1093799
fldAp,0.25,3,3,TAATATCCCGGAGCGGGCCT,0,1143439
fldAp,0.25,3,3,TAAGTGGCTTACTGTTCACT,0,1097855
fldAp,0.25,3,3,TAAGTGAGGTGGTGGACCAC,0,1159483
fldAp,0.25,3,3,TAAGTAGGCGGGCCACGTTC,0,1090619
fldAp,0.25,3,3,TAAGGTGCTCTGGAAACCGT,0,1174147
fldAp,0.25,3,3,TAAGGCGCCCCATTGGTAAT,0,1075262
fldAp,0.25,3,3,TAAGGCAGGCCATCCCTTAC,0,1093701
fldAp,0.25,3,3,TAAGGATCGGGGCCTAGTTC,0,1128414
fldAp,0.25,3,3,TAAGGAATAAAATTGCGGAC,0,1176556
fldAp,0.25,3,3,TAAGCTGCTATGCCTGCCGT,0,1138753
fldAp,0.25,3,3,TAAGCGGATTACCCCTCAAC,0,1155357
fldAp,0.25,3,3,TAAGCGACTTACCGCTACTT,0,1095555
fldAp,0.25,3,3,TAAGCCAAGTTCGCAATAAG,0,1078131
fldAp,0.25,3,3,TAAGCAGAGCCGTGCGCTTT,0,1185505
fldAp,0.25,3,3,TAAGATTGCACACTCTGACG,0,1145533
fldAp,0.25,3,3,TAAGATTAGCGGGTAACAAT,0,1124452
fldAp,0.25,3,3,TAACTCGGGCTTCAACTTAC,0,1144816
fldAp,0.25,3,3,TAACGTGGTGCGGGGTGCAA,0,1157231
fldAp,0.25,3,3,TAACGTGCCTGCGTGGCGTT,0,1112039
fldAp,0.25,3,3,TAACGGTATTCTTCATTCCG,0,1064677
fldAp,0.25,3,3,TAACGGGGGGCGGTAGACAT,0,1177982
fldAp,0.25,3,3,TAACGGGACGGTTTCGGAAT,0,1152955
fldAp,0.25,3,3,TAACCTCAGGGACATTTTTT,0,1064130
fldAp,0.25,3,3,TAACAGCCAATCTTTTGGAT,0,1178296
fldAp,0.25,3,3,TAACAAAGATTTTGAGTTCG,0,1161238
fldAp,0.25,3,3,TAAATAGATCACCTTGGCCG,0,1159791
fldAp,0.25,3,3,TAAAGTGGTCACGTTAGGCG,0,1159979
fldAp,0.25,3,3,TAAAGAGAGAGCGGGAAGAT,0,1081039
fldAp,0.25,3,3,TAAAACTGGATAGTGGTACC,0,1164858
fldAp,0.25,3,3,TAAAACAACGCTGTCCAGCG,0,1067848
fldAp,0.25,3,3,TAAAAAGGCACTCAAGCCCT,0,1095002
fldAp,0.25,3,3,GTTTTTACGCCAGGTGTTAA,0,1177947
fldAp,0.25,3,3,GTTTTGGACCAAGTGCTGAC,0,1148312
fldAp,0.25,3,3,GTTTTCCTACAGCATAGGCA,0,1072875
fldAp,0.25,3,3,GTTTGCTGTTAGGCCCAGAG,0,1104218
fldAp,0.25,3,3,GTTTCGGCAACGCTGACTTT,0,1141140
fldAp,0.25,3,3,GTTTCATGTCGTGGGGTTCA,0,1165375
fldAp,0.25,3,3,GTTTCACTCTCGAGGTGCTA,0,1103934
fldAp,0.25,3,3,GTTTCACTAATGGCAAAAGG,0,1164854
fldAp,0.25,3,3,GTTTCAAAAGCCTTTACGAG,0,1071803
fldAp,0.25,3,3,GTTTATTCCGGCGTGGGGGG,0,1109938
fldAp,0.25,3,3,GTTTATCGACGACCACGCGT,0,1071173
fldAp,0.25,3,3,GTTTAGGAGGACGGGTTTAC,0,1180332
fldAp,0.25,3,3,GTTTAGCTGCAGACGTTCAG,0,1114034
fldAp,0.25,3,3,GTTTAGCGGTTTAGTCAAAT,0,1177875
fldAp,0.25,3,3,GTTTAAACTCCCTCGTTTTC,0,1171982
fldAp,0.25,3,3,GTTGTTGCATTGCGTGTTGT,0,1152807
fldAp,0.25,3,3,GTTGTCTGCTGAGGGGATGG,0,1123968
fldAp,0.25,3,3,GTTGTATAACATTCGTTCAG,0,1128020
fldAp,0.25,3,3,GTTGTACGTGTTCCCGCGGT,0,1156795
fldAp,0.25,3,3,GTTGGATTAATCATCAGACG,0,1133757
fldAp,0.25,3,3,GTTGCGTGGGCCACCAAGTA,0,1093498
fldAp,0.25,3,3,GTTGCGCTTAGTTCTGACTT,0,1063986
fldAp,0.25,3,3,GTTGATTTCCACATGACGCG,0,1138503
fldAp,0.25,3,3,GTTGAGTAAGTTTTGCCACA,0,1175859
fldAp,0.25,3,3,GTTGAGAGCAAGCTCCTAAA,0,1144573
fldAp,0.25,3,3,GTTGAGACCCTGGTTACCTA,0,1076422
fldAp,0.25,3,3,GTTCTTGCACTGGAACCAGT,0,1168165
fldAp,0.25,3,3,GTTCTTGAATGGTGGCCCCA,0,1132160
fldAp,0.25,3,3,GTTCTGAGTTTCATAACCCC,0,1067485
fldAp,0.25,3,3,GTTCTATCCACACAAGAGCC,0,1107045
fldAp,0.25,3,3,GTTCTACTTCTGGATTACCA,0,1185756
fldAp,0.25,3,3,GTTCGTGAACACTGCCAAGG,0,1109388
fldAp,0.25,3,3,GTTCGACCCATCCAAGGGCA,0,1070255
fldAp,0.25,3,3,GTTCCTCCGCCATGTCGTAG,0,1157852
fldAp,0.25,3,3,GTTCCAAAGACAACGCAATG,0,1063987
fldAp,0.25,3,3,GTTCATGTTTCTATAATATC,0,1130951
fldAp,0.25,3,3,GTTCATCCAATCGATTAACC,0,1063245
fldAp,0.25,3,3,GTTCAGAGGAGAGATGTACC,0,1134415
fldAp,0.25,3,3,GTTCACAGGACACCGTTCAA,0,1168167
fldAp,0.25,3,3,GTTCAAAAGGTTTGGTCACT,0,1064208
fldAp,0.25,3,3,GTTATTTAACGTATTGCATC,0,1125474
fldAp,0.25,3,3,GTTATTGGTTGTGGTCAGGC,0,1097330
fldAp,0.25,3,3,GTTATCGACTCCACCGCGTC,0,1064593
fldAp,0.25,3,3,GTTATCCCAGAGGCATCGCG,0,1148290
fldAp,0.25,3,3,GTTATCAGTGCACTAGGTGC,0,1077314
fldAp,0.25,3,3,GTTAGGGGGCCGTAAATCAG,0,1088723
fldAp,0.25,3,3,GTTAGGCTGCTCAGAGGTTT,0,1096335
fldAp,0.25,3,3,GTTAGATTGCTCTAGACCGT,0,1102230
fldAp,0.25,3,3,GTTAGAATACTAACTATTTG,0,1131905
fldAp,0.25,3,3,GTTACGGGCAGGTGCAGACA,0,1069590
fldAp,0.25,3,3,GTTACCTCTATATAAAGTTA,0,1157436
fldAp,0.25,3,3,GTTACCCATGCATTGTCGCC,0,1119234
fldAp,0.25,3,3,GTTACAACCGGTGGACGAAG,0,1156871
fldAp,0.25,3,3,GTTAAGAATCTCGACATTTG,0,1179383
fldAp,0.25,3,3,GTTAAATGGGAGGTTAATAA,0,1171833
fldAp,0.25,3,3,GTGTTATGGACGATGTGTAG,0,1176664
fldAp,0.25,3,3,GTGTGTAAAATTCCGAATAA,0,1142630
fldAp,0.25,3,3,GTGTGGCCTTTCTTGACGTA,0,1105730
fldAp,0.25,3,3,GTGTGCTATTGTTTTGGAGT,0,1069415
fldAp,0.25,3,3,GTGTGCATGCGAGTCCAGAG,0,1137556
fldAp,0.25,3,3,GTGTCTGGACGCCTTTGAAA,0,1136230
fldAp,0.25,3,3,GTGTCGCCAATTCATGGCCT,0,1092299
fldAp,0.25,3,3,GTGTCGCATGCCTAAACAAA,0,1115187
fldAp,0.25,3,3,GTGTAGGCCCGGGTGATCGC,0,1064490
fldAp,0.25,3,3,GTGTAGCGGGACTGAAATGT,0,1068739
fldAp,0.25,3,3,GTGTAACCAGGCCGCACCAT,0,1172734
fldAp,0.25,3,3,GTGGTGTGCGCTCGAGGCCC,0,1102090
fldAp,0.25,3,3,GTGGTCCTGTGTCGTTGTAT,0,1132549
fldAp,0.25,3,3,GTGGGTCCCGTATGGAATGA,0,1124772
fldAp,0.25,3,3,GTGGGACTGTAAAGGACCGG,0,1176728
fldAp,0.25,3,3,GTGGGACCCCCTCCGCGGCA,0,1085334
fldAp,0.25,3,3,GTGGCCTGCGATGCAAGGTT,0,1076315
fldAp,0.25,3,3,GTGGCCGGATGGGATTTCAT,0,1065311
fldAp,0.25,3,3,GTGGAGATAACAGAGGGCGC,0,1171742
fldAp,0.25,3,3,GTGCTCCCGTCTCCACATTC,0,1131018
fldAp,0.25,3,3,GTGCTAGTGTGCGCTGGGTT,0,1151252
fldAp,0.25,3,3,GTGCTACTCGGGTGGGCACC,0,1125307
fldAp,0.25,3,3,GTGCTAATTCCCCGGTGACG,0,1184530
fldAp,0.25,3,3,GTGCGCGACGCCGATAAGCC,0,1067852
fldAp,0.25,3,3,GTGCCTGGCCGGTCGCACGA,0,1160885
fldAp,0.25,3,3,GTGCCCCCAACGGAGCGGTC,0,1180045
fldAp,0.25,3,3,GTGCCCAGGCATAGACCAAT,0,1170156
fldAp,0.25,3,3,GTGCCCAATAGCATACCCAC,0,1142253
fldAp,0.25,3,3,GTGCCATCTCGAGGTCAAAT,0,1075768
fldAp,0.25,3,3,GTGCATCAGAATGAACAACG,0,1119543
fldAp,0.25,3,3,GTGCACATAGCAAGAAACAC,0,1178083
fldAp,0.25,3,3,GTGCACACGGGTACCGTTCT,0,1161183
fldAp,0.25,3,3,GTGCAAACTATGACCGCAGG,0,1099590
fldAp,0.25,3,3,GTGATTGATTGTGGCTAAGC,0,1125112
fldAp,0.25,3,3,GTGATGCCCGTGTGCCGCGT,0,1121978
fldAp,0.25,3,3,GTGATCCCCCCAAAACTGCG,0,1144663
fldAp,0.25,3,3,GTGATCCAGTCTTGGGTTTA,0,1085946
fldAp,0.25,3,3,GTGAGGCGCACAATAGACAT,0,1171121
fldAp,0.25,3,3,GTGACGACTACGAGCGGATC,0,1125326
fldAp,0.25,3,3,GTGAATTAGAATTCGTCCTA,0,1074120
fldAp,0.25,3,3,GTGAAGTGCCGGCTCACTTG,0,1104327
fldAp,0.25,3,3,GTGAAAATTGGAAGTTGACC,0,1074032
fldAp,0.25,3,3,GTCTTTAAACGGCCTTCTTT,0,1146117
fldAp,0.25,3,3,GTCTTCCAAGGACACTGTGT,0,1161532
fldAp,0.25,3,3,GTCTTACCGCATGTCAACAA,0,1077664
fldAp,0.25,3,3,GTCTGGCACATGGAGTCCCC,0,1162205
fldAp,0.25,3,3,GTCTGCCCGCCTCAAGACGA,0,1112833
fldAp,0.25,3,3,GTCTCTATTGGTGGAGGTCT,0,1094252
fldAp,0.25,3,3,GTCTCAGTGGGCTGGGAATT,0,1179616
fldAp,0.25,3,3,GTCTCAATCGGTGTACGATT,0,1175248
fldAp,0.25,3,3,GTCTAGAACTGAATACTCAT,0,1160807
fldAp,0.25,3,3,GTCGTCACGAGCCCCCTTAT,0,1102392
fldAp,0.25,3,3,GTCGGTGTGGCATCGGAGAC,0,1177455
fldAp,0.25,3,3,GTCGGGCTGGCTGCACAAGG,0,1130729
fldAp,0.25,3,3,GTCGCTGTTTCAGTGAATAG,0,1150469
fldAp,0.25,3,3,GTCGCTATGGGGCCGCAGAT,0,1136056
fldAp,0.25,3,3,GTCGCAGCACGGCCCGGAAG,0,1121528
fldAp,0.25,3,3,GTCGAGGTACGAGGCGTCAC,0,1107344
fldAp,0.25,3,3,GTCGAACTTGCGAGGGAGAT,0,1172854
fldAp,0.25,3,3,GTCCTTGAGTGTCGCAGAGA,0,1091789
fldAp,0.25,3,3,GTCCTTACGAATTGAGATCA,0,1134154
fldAp,0.25,3,3,GTCCTACTCCAGCACTCGGA,0,1091922
fldAp,0.25,3,3,GTCCGTTGCCAGCGTTGGCG,0,1091462
fldAp,0.25,3,3,GTCCGGCGTTTTCGGACGAT,0,1154988
fldAp,0.25,3,3,GTCCGATTTGAAACTGTGGT,0,1166648
fldAp,0.25,3,3,GTCCCGGGATCTGTCCGTAT,0,1099746
fldAp,0.25,3,3,GTCCCATCTTCAGCTGGGTA,0,1143294
fldAp,0.25,3,3,GTCCAGTATAATATGATTGC,0,1164902
fldAp,0.25,3,3,GTCCACAACTTACAATAACA,0,1153962
fldAp,0.25,3,3,GTCATTTAAATTAGGTCCAT,0,1098667
fldAp,0.25,3,3,GTCATGGATAGAGCTTTCGA,0,1182301
fldAp,0.25,3,3,GTCATGAGGATCGACCGTGT,0,1127681
fldAp,0.25,3,3,GTCATGAGATCTTCCACCTC,0,1067009
fldAp,0.25,3,3,GTCAGGTTGGCTCGCAGAGT,0,1182345
fldAp,0.25,3,3,GTCAGGCGCAGTAGCGCACG,0,1160344
fldAp,0.25,3,3,GTCAGCATTGTTATCAACCC,0,1159248
fldAp,0.25,3,3,GTCAGCAACGAAACGGGTCT,0,1133000
fldAp,0.25,3,3,GTCAGATCAATAACTCCGTT,0,1065788
fldAp,0.25,3,3,GTCACTGTACACTCCATCGT,0,1175523
fldAp,0.25,3,3,GTCACGGGCTCGTCAGTGGA,0,1146368
fldAp,0.25,3,3,GTCACGCCTTCCATTAGATC,0,1112644
fldAp,0.25,3,3,GTCAATAAGCATAACAGTTC,0,1175386
fldAp,0.25,3,3,GTATTGCCACTGCGACCTTG,0,1123388
fldAp,0.25,3,3,GTATTCCATCCCCGGCGCTC,0,1158649
fldAp,0.25,3,3,GTATTAAAATACGGGGGTAG,0,1067780
fldAp,0.25,3,3,GTATGTGAAATGACATCCGG,0,1129677
fldAp,0.25,3,3,GTATGCAGCGGTGCACCCTG,0,1185434
fldAp,0.25,3,3,GTATCGTCTACGCTTGTTCC,0,1125987
fldAp,0.25,3,3,GTATCGCTGATCACCTTTCT,0,1096779
fldAp,0.25,3,3,GTATCCTTGCGAAGAAATCT,0,1072662
fldAp,0.25,3,3,GTATATGGTGCTACACGCAC,0,1103359
fldAp,0.25,3,3,GTATATCCGCGGGCCACCAA,0,1168889
fldAp,0.25,3,3,GTATAGGGCGGACTACTTTC,0,1149923
fldAp,0.25,3,3,GTAGTATCAAACATAGCGAA,0,1116977
fldAp,0.25,3,3,GTAGGTTTTAATACGTCTAG,0,1129801
fldAp,0.25,3,3,GTAGGTGACTGTCTCGCCGT,0,1067110
fldAp,0.25,3,3,GTAGGACGCCTATGTCCTTT,0,1080526
fldAp,0.25,3,3,GTAGCATACCTAGAGAGTCC,0,1142808
fldAp,0.25,3,3,GTAGAAAATATAGGCAACCC,0,1128433
fldAp,0.25,3,3,GTACTGCTGTCGAATATAGC,0,1071252
fldAp,0.25,3,3,GTACTGAACATAGGGCTGTG,0,1113802
fldAp,0.25,3,3,GTACTCACAAATGCGAGAAG,0,1116372
fldAp,0.25,3,3,GTACGTAGAGATGTATCGAG,0,1173968
fldAp,0.25,3,3,GTACGCCAGAAATTTTCAAA,0,1071907
fldAp,0.25,3,3,GTACCGTAGAGTCGGTTGGA,0,1079379
fldAp,0.25,3,3,GTACCGCTGTGTTTCCGTCG,0,1163840
fldAp,0.25,3,3,GTACCGAAGCAAAAACGATG,0,1152927
fldAp,0.25,3,3,GTACCCTATCACGATGCACC,0,1080424
fldAp,0.25,3,3,GTACCACCTTTAAGATATAT,0,1102627
fldAp,0.25,3,3,GTACCAACAGATAGCCCGAT,0,1114897
fldAp,0.25,3,3,GTACAAGTCTTAGTGCGGCA,0,1069106
fldAp,0.25,3,3,GTAATCATTGAGGGGCTACG,0,1084086
fldAp,0.25,3,3,GTAATAGCCGCATCATGTAC,0,1101757
fldAp,0.25,3,3,GTAAGTAAGGTGCGCGAGCT,0,1069900
fldAp,0.25,3,3,GTAACGTTTGCTGGGAGTGA,0,1114593
fldAp,0.25,3,3,GTAACGCGACCGAGAACTGT,0,1088798
fldAp,0.25,3,3,GTAACACTCACATTCGCTCA,0,1073013
fldAp,0.25,3,3,GTAAAATTTCCAACGATCGA,0,1178305
fldAp,0.25,3,3,GTAAAAATGTAACAGTTTTG,0,1154533
fldAp,0.25,3,3,GGTTTTGGCTATGTTAGCGT,0,1110970
fldAp,0.25,3,3,GGTTTGGTCCCAGCGGGTCT,0,1128672
fldAp,0.25,3,3,GGTTTGACTTAAAGCTTAGC,0,1141128
fldAp,0.25,3,3,GGTTTCGAGAAGCAACGACG,0,1082260
fldAp,0.25,3,3,GGTTTCCTAACTCTATGCTA,0,1072329
fldAp,0.25,3,3,GGTTTAGGGGGGATATTATA,0,1068042
fldAp,0.25,3,3,GGTTTAACCCTAGTCACTAT,0,1103348
fldAp,0.25,3,3,GGTTGGTAAGGGGTGAGTAT,0,1166152
fldAp,0.25,3,3,GGTTGGCTCGATGACTTTCT,0,1064217
fldAp,0.25,3,3,GGTTGCCTGAGGGGACTTCA,0,1153694
fldAp,0.25,3,3,GGTTCGCATTGGCTTCTCGC,0,1179686
fldAp,0.25,3,3,GGTTCGAGCAGTCTGATCCG,0,1093526
fldAp,0.25,3,3,GGTTCATAGTGGATTTTCAG,0,1068868
fldAp,0.25,3,3,GGTTATCAGCTACTAACAAA,0,1137154
fldAp,0.25,3,3,GGTGTTTCAACATGGCACTG,0,1126772
fldAp,0.25,3,3,GGTGTCACTGCTATTGGTAA,0,1089527
fldAp,0.25,3,3,GGTGTAAAGGTTTGAGCCTG,0,1073229
fldAp,0.25,3,3,GGTGGGTTCATAAGACAATT,0,1172828
fldAp,0.25,3,3,GGTGGGGTGAGGGTTAATCC,0,1184174
fldAp,0.25,3,3,GGTGGAAGCCTGAACTGTTA,0,1112523
fldAp,0.25,3,3,GGTGCTACGCTCTCATAAAG,0,1074142
fldAp,0.25,3,3,GGTGCCGCCCGCCAGTCACG,0,1161974
fldAp,0.25,3,3,GGTGCCCACAGGCCTAGCTT,0,1113666
fldAp,0.25,3,3,GGTGATACATACAGGAACGT,0,1151553
fldAp,0.25,3,3,GGTGAGGACTGCAGCCCAGT,0,1110568
fldAp,0.25,3,3,GGTGAGCCTACCTAGTTTGT,0,1137644
fldAp,0.25,3,3,GGTGACTAGGGAAAATAGGG,0,1086930
fldAp,0.25,3,3,GGTGACTAACCTTTAGGACA,0,1078402
fldAp,0.25,3,3,GGTCGTAGCCTCCGTGTTTC,0,1155818
fldAp,0.25,3,3,GGTCGGCCAGGCATTGGTTG,0,1088732
fldAp,0.25,3,3,GGTCCGGGTGGTAGGCATAT,0,1146383
fldAp,0.25,3,3,GGTCCGGCTGCCAGCGAGCC,0,1171616
fldAp,0.25,3,3,GGTCCGACTGCAAGAATTTA,0,1128639
fldAp,0.25,3,3,GGTCCCTGATCATTGAGCGA,0,1186409
fldAp,0.25,3,3,GGTCCCGCACCGCTTCCATG,0,1083165
fldAp,0.25,3,3,GGTCCCCCCAAAATTATGCT,0,1073545
fldAp,0.25,3,3,GGTCCATCCCACGGATTACA,0,1166954
fldAp,0.25,3,3,GGTCAGAACTCATGCGTCAG,0,1176552
fldAp,0.25,3,3,GGTATGCGCTTATTTTCAAC,0,1068160
fldAp,0.25,3,3,GGTAGGCGTGTCACACTCCA,0,1121587
fldAp,0.25,3,3,GGTACCGTGTTACGTGATTC,0,1105421
fldAp,0.25,3,3,GGTAATGTGCCGCGGCACAC,0,1127721
fldAp,0.25,3,3,GGTAAGTCAAACAGGTCAGT,0,1150364
fldAp,0.25,3,3,GGTAACAGAGACGTCCAGTT,0,1172490
fldAp,0.25,3,3,GGGTTTGGACAGCCCGATGA,0,1124915
fldAp,0.25,3,3,GGGTTGGCGCCTCAAATGTA,0,1166209
fldAp,0.25,3,3,GGGTTATGGTTATCATACTT,0,1157302
fldAp,0.25,3,3,GGGTGTTGGGTAAAACACAG,0,1118678
fldAp,0.25,3,3,GGGTGTATAGTCTAGCTCGA,0,1131689
fldAp,0.25,3,3,GGGTGTACACCGCAGCGGTA,0,1130524
fldAp,0.25,3,3,GGGTGCGACTTGTGAGTGAA,0,1112524
fldAp,0.25,3,3,GGGTGATAGACACAGTCGTA,0,1073499
fldAp,0.25,3,3,GGGTGAGCTGATCACAAAAA,0,1147433
fldAp,0.25,3,3,GGGTGACGTTCGTACGCCAC,0,1158277
fldAp,0.25,3,3,GGGTCTGTACGCGCAGTCAC,0,1180386
fldAp,0.25,3,3,GGGTCAGTCGTAAGAGTCCT,0,1096351
fldAp,0.25,3,3,GGGTCAGTAGTAGGTGGTAG,0,1178873
fldAp,0.25,3,3,GGGTCACGCAAAATGGCTCG,0,1106740
fldAp,0.25,3,3,GGGTAGTTCAAATCCGTGCC,0,1121695
fldAp,0.25,3,3,GGGTACTGATTGAATAACCA,0,1105790
fldAp,0.25,3,3,GGGTACGGCTGAACCGAGGA,0,1179598
fldAp,0.25,3,3,GGGTACCCACAAAAAGCCGG,0,1167439
fldAp,0.25,3,3,GGGGTCTACAGTAGGTCTCG,0,1066990
fldAp,0.25,3,3,GGGGTCAAATGCACGCATAA,0,1174309
fldAp,0.25,3,3,GGGGTACCATCGAGCTAGGG,0,1170237
fldAp,0.25,3,3,GGGGGTGGTTACATAATAGA,0,1122660
fldAp,0.25,3,3,GGGGGACACCTTCCGCGGCT,0,1165381
fldAp,0.25,3,3,GGGGGAAGGCCCGTATCATG,0,1112575
fldAp,0.25,3,3,GGGGCGGTGGAGCTTCAAAT,0,1145469
fldAp,0.25,3,3,GGGCTGATCGGCGCCCTCTT,0,1099394
fldAp,0.25,3,3,GGGCTAGCTAAAGGATTTAG,0,1091662
fldAp,0.25,3,3,GGGCGGGGTGTATTTGCCCG,0,1166907
fldAp,0.25,3,3,GGGCGGACATCTGGTGGGAG,0,1183224
fldAp,0.25,3,3,GGGCAGGTCAAAACAAAGTA,0,1140149
fldAp,0.25,3,3,GGGCACGGCCTGTGTCCCGT,0,1183952
fldAp,0.25,3,3,GGGATTAGATGCGGTGCCCC,0,1099576
fldAp,0.25,3,3,GGGATGGTAGGCGATCGTAA,0,1088328
fldAp,0.25,3,3,GGGAGCGGTGCTAGGAGACA,0,1073844
fldAp,0.25,3,3,GGGAGCCACGAAGAATGATA,0,1096655
fldAp,0.25,3,3,GGGACTAGGGACTAGCTCGA,0,1165481
fldAp,0.25,3,3,GGGACGCCGCATTTAAGACT,0,1113591
fldAp,0.25,3,3,GGGACGACGCCATAGGGTGG,0,1104794
fldAp,0.25,3,3,GGGACCGTGGCGTCTGAATT,0,1071388
fldAp,0.25,3,3,GGGAACGAAGTTCGGAAGTC,0,1132315
fldAp,0.25,3,3,GGGAAAGTGCGACGACCGCT,0,1086407
fldAp,0.25,3,3,GGCTTGCGTCTACTCTGTAC,0,1083829
fldAp,0.25,3,3,GGCTTGAGTAGGAATAACCG,0,1078296
fldAp,0.25,3,3,GGCTTCTATCCCGTTCGGCG,0,1112873
fldAp,0.25,3,3,GGCTTCGCGCCTAGGGCAGA,0,1079649
fldAp,0.25,3,3,GGCTTAAAACGAATCCCAGA,0,1128484
fldAp,0.25,3,3,GGCTGTTTTGCGGGGCAGTT,0,1089694
fldAp,0.25,3,3,GGCTGTCGGCAAAAGCCAGA,0,1082268
fldAp,0.25,3,3,GGCTGTATCGTACACTTACG,0,1138602
fldAp,0.25,3,3,GGCTCTTCGGCAACCCTGGT,0,1118894
fldAp,0.25,3,3,GGCTCCAAGATCTTTAAGAT,0,1179786
fldAp,0.25,3,3,GGCTCAGCAGATATACGGGT,0,1063375
fldAp,0.25,3,3,GGCTATATGTACGCTATTGA,0,1101039
fldAp,0.25,3,3,GGCTACTGGCCAAGGTCAAG,0,1114961
fldAp,0.25,3,3,GGCTACGGCACACTACAAGC,0,1100489
fldAp,0.25,3,3,GGCGTGTTATGGCGTACAAA,0,1115993
fldAp,0.25,3,3,GGCGTCCTAATCGTTGGGAA,0,1096707
fldAp,0.25,3,3,GGCGGGCTTCCGCCACCCTG,0,1166423
fldAp,0.25,3,3,GGCGGGAAGTGATGCTTATG,0,1106196
fldAp,0.25,3,3,GGCGGCGGGCCAAGCGGCCT,0,1115569
fldAp,0.25,3,3,GGCGGATATTCCATTAACCC,0,1159977
fldAp,0.25,3,3,GGCGCGGCCTTGTCAAAGGG,0,1082281
fldAp,0.25,3,3,GGCGAGTTACCATAGTCGAG,0,1089325
fldAp,0.25,3,3,GGCGAGCGGTGCGCGCAGAA,0,1146601
fldAp,0.25,3,3,GGCGAATATGATCCAGCAGT,0,1175587
fldAp,0.25,3,3,GGCCGTCGTTTTATTAGATG,0,1134067
fldAp,0.25,3,3,GGCCGTCCCGTGTTGCGGAA,0,1073149
fldAp,0.25,3,3,GGCCGACTTGGGCACGGGCA,0,1130323
fldAp,0.25,3,3,GGCCCTTCAGTGTAGGTCAA,0,1076363
fldAp,0.25,3,3,GGCCCGTGCCTCAGATTTAA,0,1174440
fldAp,0.25,3,3,GGCCATGATGGTTTGAGAAT,0,1167163
fldAp,0.25,3,3,GGCCACGACCGACTATAAGT,0,1099495
fldAp,0.25,3,3,GGCATTTAGGTCTTATTCAC,0,1156832
fldAp,0.25,3,3,GGCATGTCCACGGCATTGGT,0,1178414
fldAp,0.25,3,3,GGCATCGGTTAGGGTAGATT,0,1136832
fldAp,0.25,3,3,GGCAGTCCACTTGAATCTAT,0,1184482
fldAp,0.25,3,3,GGCACACGGAAACGAGCTTT,0,1101620
fldAp,0.25,3,3,GGCAACTTGCGGGACATTTC,0,1127099
fldAp,0.25,3,3,GGCAACCTCGATCCACTAAC,0,1126748
fldAp,0.25,3,3,GGCAAAAAAGTCTCGCTTGA,0,1117989
fldAp,0.25,3,3,GGATTTTGTACTAATTCGTC,0,1135511
fldAp,0.25,3,3,GGATTTCGTTAATGCGATTT,0,1114539
fldAp,0.25,3,3,GGATTCTGCATCTGCCTCTT,0,1086062
fldAp,0.25,3,3,GGATGTCAGCGTGAAGTCCT,0,1126403
fldAp,0.25,3,3,GGATGGGGTTAGCCTGCTCA,0,1129594
fldAp,0.25,3,3,GGATGCGGAGGCACAGGTAT,0,1165345
fldAp,0.25,3,3,GGATCTCTTTCAAGGCTATC,0,1067472
fldAp,0.25,3,3,GGATCTCACTGGGCAGCATT,0,1127082
fldAp,0.25,3,3,GGATCCAAGACATGCCGGTG,0,1078455
fldAp,0.25,3,3,GGATCAATGTTCTTATTCGA,0,1089029
fldAp,0.25,3,3,GGATATCGTATAGGCTTTGG,0,1159068
fldAp,0.25,3,3,GGATACTGGGGTTGTGGCTT,0,1163754
fldAp,0.25,3,3,GGATAATGGTTATGACACGT,0,1084887
fldAp,0.25,3,3,GGATAATGAAGGACCTTGAA,0,1139347
fldAp,0.25,3,3,GGAGTGTCTCGGGTGTACAG,0,1076924
fldAp,0.25,3,3,GGAGTGAAACGCTGCAGATG,0,1069165
fldAp,0.25,3,3,GGAGTATATGCCCAGAAGTC,0,1146783
fldAp,0.25,3,3,GGAGTAGTCATTGCTGGCAA,0,1103257
fldAp,0.25,3,3,GGAGGTAAGGATGGGAATAT,0,1071750
fldAp,0.25,3,3,GGAGGGGGGATCGAAACCTT,0,1114139
fldAp,0.25,3,3,GGAGGGACAAACTGCTTAGT,0,1077879
fldAp,0.25,3,3,GGAGGCCCATGGAGTATGGT,0,1174428
fldAp,0.25,3,3,GGAGGCATCACTGCTACATA,0,1154203
fldAp,0.25,3,3,GGAGCTCATGTTCCTTGGTG,0,1069458
fldAp,0.25,3,3,GGAGCGATTCTCGGGGGAGA,0,1153354
fldAp,0.25,3,3,GGAGCCGTTATAAAAATGAG,0,1115431
fldAp,0.25,3,3,GGAGATTGGCGGAAGCTTTA,0,1140257
fldAp,0.25,3,3,GGAGATGTTTCGCGTTAATC,0,1176072
fldAp,0.25,3,3,GGAGATCTTCTCCCGGTCCT,0,1112075
fldAp,0.25,3,3,GGAGAGTCACAAAGAAGCAT,0,1170474
fldAp,0.25,3,3,GGAGAGGTTATTGAAATGGT,0,1120336
fldAp,0.25,3,3,GGAGAGACAATTGTAAGGTC,0,1078276
fldAp,0.25,3,3,GGACTTTGATATACGCCGCA,0,1091909
fldAp,0.25,3,3,GGACTGGCTCGACCTCAACG,0,1133277
fldAp,0.25,3,3,GGACTCCACTCTTAGACACT,0,1098504
fldAp,0.25,3,3,GGACTATACTCTTGCGGAGC,0,1179073
fldAp,0.25,3,3,GGACGTGTCCATTTGAACCA,0,1172015
fldAp,0.25,3,3,GGACGGGATATACTACCAGC,0,1132893
fldAp,0.25,3,3,GGACGAGGTCACAGAACGCT,0,1183860
fldAp,0.25,3,3,GGACCCGCCTGGTTCCAATG,0,1100740
fldAp,0.25,3,3,GGACCCAAATAGTTGATCGC,0,1114392
fldAp,0.25,3,3,GGACCAGGGTAGATAGCTAT,0,1140975
fldAp,0.25,3,3,GGACCAAACTATTATCTGAA,0,1067503
fldAp,0.25,3,3,GGACACATGACATCATGCGC,0,1125782
fldAp,0.25,3,3,GGAATTTGTTCCTGCCGAAA,0,1110612
fldAp,0.25,3,3,GGAATTACTTGCATTTGGGT,0,1177011
fldAp,0.25,3,3,GGAATGTCATGCGTGTATGT,0,1132247
fldAp,0.25,3,3,GGAATGCGTGCGCGGATGGT,0,1125502
fldAp,0.25,3,3,GGAATGCATTGGGGAGCCCT,0,1181751
fldAp,0.25,3,3,GGAATCGCCCCCAAGAAATG,0,1133055
fldAp,0.25,3,3,GGAAGGCACCCATAGCTTCG,0,1070697
fldAp,0.25,3,3,GGAAGGACGCTCGCCGTTTT,0,1084721
fldAp,0.25,3,3,GGAAGCGAGGCGTTAAATTG,0,1182385
fldAp,0.25,3,3,GGAACTCGAGCCAATACTGT,0,1099160
fldAp,0.25,3,3,GGAACTACACCTGCCGCTGT,0,1118168
fldAp,0.25,3,3,GGAACGTATTTGCCTTTACT,0,1158185
fldAp,0.25,3,3,GGAAATAGAGCCTCAAAACA,0,1077037
fldAp,0.25,3,3,GGAAAATTGATTCATCGCTT,0,1183815
fldAp,0.25,3,3,GGAAAATATCATGCCGATCA,0,1176151
fldAp,0.25,3,3,GCTTGTTGAGACTCGGGGTG,0,1080967
fldAp,0.25,3,3,GCTTGTAAAGTTGGCTTTTA,0,1079277
fldAp,0.25,3,3,GCTTCGGGCTTGACAAGGAA,0,1081475
fldAp,0.25,3,3,GCTTATGCCGGTAGCGCTGA,0,1153902
fldAp,0.25,3,3,GCTTATGCATGTATATGGTT,0,1178986
fldAp,0.25,3,3,GCTTAGATCGAGGCAGAACG,0,1097190
fldAp,0.25,3,3,GCTTACGACCGCGAGGATGT,0,1117158
fldAp,0.25,3,3,GCTGTGACCCGAATGCGATC,0,1182952
fldAp,0.25,3,3,GCTGTGAATCCGTACAGTAC,0,1175009
fldAp,0.25,3,3,GCTGGGACTTGGTGAAACGT,0,1099574
fldAp,0.25,3,3,GCTGGGAAGGGAGGCGCCAG,0,1100934
fldAp,0.25,3,3,GCTGCCTGTCAGGCTCGTTA,0,1079797
fldAp,0.25,3,3,GCTGCAGAACATACATACGC,0,1177237
fldAp,0.25,3,3,GCTGACAATTCATACTGAAC,0,1170396
fldAp,0.25,3,3,GCTGAATGCGATAGCAGGGG,0,1173912
fldAp,0.25,3,3,GCTCTTGTGGATGTAATTTA,0,1077469
fldAp,0.25,3,3,GCTCTCCCGGGCGGCGCTAG,0,1091601
fldAp,0.25,3,3,GCTCTCCCATTACGTGCAAA,0,1128976
fldAp,0.25,3,3,GCTCTACGACTGCAATGTTG,0,1150061
fldAp,0.25,3,3,GCTCGAGCATAGGCAAACCG,0,1110349
fldAp,0.25,3,3,GCTCGAACACCAGTCGATAG,0,1140299
fldAp,0.25,3,3,GCTCCTCGGTTACCGCAGCA,0,1102630
fldAp,0.25,3,3,GCTCCGGCGCGATATTTTTG,0,1121623
fldAp,0.25,3,3,GCTCCGATCCGTGGGCTACT,0,1178360
fldAp,0.25,3,3,GCTCCCGGCCCAAAATAGGA,0,1119081
fldAp,0.25,3,3,GCTCATTGGTAATCTCATCC,0,1080151
fldAp,0.25,3,3,GCTCATCCCAGCGAGGTTGG,0,1168614
fldAp,0.25,3,3,GCTCAGGGTACTCATGTTGG,0,1161279
fldAp,0.25,3,3,GCTATGTACGGTCCTCTGGC,0,1148169
fldAp,0.25,3,3,GCTATGGTAAGCCAGGTAGT,0,1150884
fldAp,0.25,3,3,GCTAGTCAAACTAGGTCAAA,0,1162197
fldAp,0.25,3,3,GCTAGCCCCACGCCTTTAAA,0,1103724
fldAp,0.25,3,3,GCTACGGTACTTACCTACCG,0,1095881
fldAp,0.25,3,3,GCTACGCTTAAGATTAGGCG,0,1125565
fldAp,0.25,3,3,GCTACAGTCTACTCAGATCT,0,1064362
fldAp,0.25,3,3,GCTAATTTTCTCGACGGTAT,0,1167215
fldAp,0.25,3,3,GCTAAGTGTACGCGCATATT,0,1123043
fldAp,0.25,3,3,GCGTTTTGTACTCTGGCATA,0,1178994
fldAp,0.25,3,3,GCGTTGTCATCTCAACCAAC,0,1175702
fldAp,0.25,3,3,GCGTTACCCTTATGAGCACG,0,1096443
fldAp,0.25,3,3,GCGTGTCTGTGATATCATTC,0,1149290
fldAp,0.25,3,3,GCGTGACTAGGAACTCATTG,0,1097939
fldAp,0.25,3,3,GCGTCCAGGGCATGCAGATG,0,1140543
fldAp,0.25,3,3,GCGTATACTAACGCTGTAAG,0,1096719
fldAp,0.25,3,3,GCGTAGGTGACCATCGCGGT,0,1083625
fldAp,0.25,3,3,GCGTAGGATGTGGGGTCGAT,0,1120101
fldAp,0.25,3,3,GCGTACCATCCTGACAGTGC,0,1070510
fldAp,0.25,3,3,GCGTAAATTCATGGGGGGCG,0,1115647
fldAp,0.25,3,3,GCGGTTCAAGATGCATCATT,0,1064370
fldAp,0.25,3,3,GCGGGTTTGCACCACGTGCC,0,1136326
fldAp,0.25,3,3,GCGGGTAGCATGCCCATCAG,0,1082720
fldAp,0.25,3,3,GCGGGAAGAATAAGTTTAGA,0,1122634
fldAp,0.25,3,3,GCGGCCACACCATATCATAT,0,1116105
fldAp,0.25,3,3,GCGGCAGGTTTCTCATTGAG,0,1099038
fldAp,0.25,3,3,GCGGAAACAGCTTGCCACTT,0,1154079
fldAp,0.25,3,3,GCGCTGAGTTTTGCGTCCTA,0,1139669
fldAp,0.25,3,3,GCGCTGAGCGGCCAGTCTAT,0,1130411
fldAp,0.25,3,3,GCGCGTTTATCGCTCTCATT,0,1149366
fldAp,0.25,3,3,GCGCGTATCACATGTACCCA,0,1082953
fldAp,0.25,3,3,GCGCCGTGGTCTAAATCGGA,0,1086766
fldAp,0.25,3,3,GCGCCGTATGCGCAGCTGAC,0,1182823
fldAp,0.25,3,3,GCGCCCTATCCAATTTCATT,0,1142749
fldAp,0.25,3,3,GCGCATCGCGAGCGGCGGTA,0,1097257
fldAp,0.25,3,3,GCGCAGTTCGCGCAATCTAT,0,1096906
fldAp,0.25,3,3,GCGATTCGAATGTGGGCGGA,0,1098837
fldAp,0.25,3,3,GCGATGTCCAGCTTCCGAGT,0,1077346
fldAp,0.25,3,3,GCGAGTACCCAACGTAGTTA,0,1163469
fldAp,0.25,3,3,GCGAGATTGCACTCTGTAGT,0,1101728
fldAp,0.25,3,3,GCGACTATGCTGTCAACAAG,0,1071800
fldAp,0.25,3,3,GCGACGACCCGTATGCGAGC,0,1170834
fldAp,0.25,3,3,GCGACGAACGTCACAATCGG,0,1106303
fldAp,0.25,3,3,GCGACAGTAATTGTGCCCGT,0,1112679
fldAp,0.25,3,3,GCGAACTAACACAAGGGAAT,0,1183246
fldAp,0.25,3,3,GCGAAACCCGGACTTTATTT,0,1096900
fldAp,0.25,3,3,GCCTTTATCTACCAACTATC,0,1066928
fldAp,0.25,3,3,GCCTTTAGAGTTACTACTTT,0,1072586
fldAp,0.25,3,3,GCCTTACGTGTTCTCGGAGT,0,1087731
fldAp,0.25,3,3,GCCTGACAACTTGAACTACG,0,1140867
fldAp,0.25,3,3,GCCTCGAAACCTCGAATGAT,0,1107816
fldAp,0.25,3,3,GCCTCCCGGATAACCCGAAA,0,1076838
fldAp,0.25,3,3,GCCTAGAGAGAAGATGTCTC,0,1165428
fldAp,0.25,3,3,GCCTACCGTGACCCTGAGGT,0,1122972
fldAp,0.25,3,3,GCCGTGGTCCGTGCGTATAA,0,1098800
fldAp,0.25,3,3,GCCGTGGACTGCATCCGATG,0,1176097
fldAp,0.25,3,3,GCCGTAATACCAGATTTCCT,0,1158531
fldAp,0.25,3,3,GCCGCGGTATATTTGTCATA,0,1162734
fldAp,0.25,3,3,GCCGCGAAAGTGGGTAGAGG,0,1115987
fldAp,0.25,3,3,GCCGCCTTAGGTCCTGCGCC,0,1078304
fldAp,0.25,3,3,GCCGCACACGTCGGCCCCTC,0,1093650
fldAp,0.25,3,3,GCCGATCGATGTTACATACC,0,1092358
fldAp,0.25,3,3,GCCGATCCAGCGCTGGACAG,0,1149897
fldAp,0.25,3,3,GCCGAGTTCCAGTTCGGGTT,0,1103589
fldAp,0.25,3,3,GCCCTGGATGGTGGTAAAAA,0,1149352
fldAp,0.25,3,3,GCCCTGAAGGATGACATTTT,0,1131954
fldAp,0.25,3,3,GCCCTACCCCCCATATCGGA,0,1098053
fldAp,0.25,3,3,GCCCCCACCTTCTTATTAGT,0,1104967
fldAp,0.25,3,3,GCCCCCAATTCTCGCTTTTC,0,1099582
fldAp,0.25,3,3,GCCCCAGGAAGTTCGTCCTA,0,1083078
fldAp,0.25,3,3,GCCCAGGAAGGACTGTGATC,0,1147429
fldAp,0.25,3,3,GCCCAGCGGATAATGAGTAA,0,1076185
fldAp,0.25,3,3,GCCCACGGGCTTACTTTATG,0,1121056
fldAp,0.25,3,3,GCCATTTTGTGTGCTGTTGT,0,1139021
fldAp,0.25,3,3,GCCATTTGCTATTAATTACA,0,1138187
fldAp,0.25,3,3,GCCATTGAGCCCCGGCTTGA,0,1105514
fldAp,0.25,3,3,GCCATGCCCTCACGGCGATC,0,1170664
fldAp,0.25,3,3,GCCATACGTGAGCAGGTGCT,0,1158968
fldAp,0.25,3,3,GCCAGTTTTAGTTAGGCATA,0,1186109
fldAp,0.25,3,3,GCCAGACCGTAGGCCGACGC,0,1180607
fldAp,0.25,3,3,GCCAGACATACAGGCCGAAT,0,1129229
fldAp,0.25,3,3,GCCACGGCGGACTGCGCGTG,0,1105012
fldAp,0.25,3,3,GCATTCTTGGCGGTTGTTAT,0,1084785
fldAp,0.25,3,3,GCATTCTGTCCGACATAAGC,0,1172876
fldAp,0.25,3,3,GCATTCTGAGCGCAAAAGAC,0,1149879
fldAp,0.25,3,3,GCATTATACGAGTGCCACAC,0,1099535
fldAp,0.25,3,3,GCATCTTAACATATTAAACT,0,1161164
fldAp,0.25,3,3,GCATCGACGCGGTCACAGAA,0,1149104
fldAp,0.25,3,3,GCATCCCTTTACTCATGCAT,0,1122834
fldAp,0.25,3,3,GCATCACGTAATGGTGCATG,0,1097598
fldAp,0.25,3,3,GCATCACGCAAGGTTCATGG,0,1168485
fldAp,0.25,3,3,GCATACGTCACCAAATGCGA,0,1156555
fldAp,0.25,3,3,GCATACGAATAAACTTGGCG,0,1182853
fldAp,0.25,3,3,GCATAACCTCTCAAAGTCTA,0,1067057
fldAp,0.25,3,3,GCATAAAGATCCTTTTGGAA,0,1084857
fldAp,0.25,3,3,GCAGTGTCACGGATGGTGCC,0,1068750
fldAp,0.25,3,3,GCAGTCATCGTATCTTGGTG,0,1074462
fldAp,0.25,3,3,GCAGTAGAGGCAGCTATGCG,0,1129753
fldAp,0.25,3,3,GCAGGTTAATGTACTGATGG,0,1181595
fldAp,0.25,3,3,GCAGGAATTTTGCTCATCGC,0,1169616
fldAp,0.25,3,3,GCAGCGCTCTTAGTGTGAGC,0,1115777
fldAp,0.25,3,3,GCAGCGACACGAGTAGGACC,0,1091924
fldAp,0.25,3,3,GCAGCCTGCCACAACAAAGA,0,1166733
fldAp,0.25,3,3,GCAGACCTGGGGTATAGAGA,0,1064354
fldAp,0.25,3,3,GCACGTTCGCTGGACAGCGA,0,1091687
fldAp,0.25,3,3,GCACGTCGAGACTGGGTTTC,0,1141458
fldAp,0.25,3,3,GCACGGCTAAGGGCGCGGAG,0,1140075
fldAp,0.25,3,3,GCACGGACGGTGGCTTGACA,0,1154006
fldAp,0.25,3,3,GCACGGACCGGCGATATGCA,0,1069552
fldAp,0.25,3,3,GCACGCGGGCAGCGCCAGAT,0,1179844
fldAp,0.25,3,3,GCACGCGCAACAACGGTTTA,0,1076749
fldAp,0.25,3,3,GCACGCAGGACTCAGACTGT,0,1176455
fldAp,0.25,3,3,GCACACAGGGTCGTTACAAG,0,1114846
fldAp,0.25,3,3,GCACAACTTCGAGTGATTTA,0,1078502
fldAp,0.25,3,3,GCAATGGGGGGGGGTAACGT,0,1149057
fldAp,0.25,3,3,GCAATGGAGTACGTTACCTT,0,1127902
fldAp,0.25,3,3,GCAATACAAAGTCCCTAGTA,0,1124849
fldAp,0.25,3,3,GCAAGGGTGGAAAGTGGAAA,0,1097047
fldAp,0.25,3,3,GCAACTTCTTCGCAAATGGC,0,1064476
fldAp,0.25,3,3,GCAACCTAAACTGATCCCAA,0,1165334
fldAp,0.25,3,3,GCAACCGAACCAAGTCCATC,0,1169156
fldAp,0.25,3,3,GCAAAGTCGGGCAACTCTAG,0,1168100
fldAp,0.25,3,3,GCAAAGCGAGCCAGCGGTTT,0,1101205
fldAp,0.25,3,3,GCAAAAGTCAAGTCTATGTC,0,1148181
fldAp,0.25,3,3,GATTTTCGAGTAAAGGTAGG,0,1068742
fldAp,0.25,3,3,GATTTGTTAACCAGGTAATC,0,1178730
fldAp,0.25,3,3,GATTTAGTACGTATCCCTGC,0,1081212
fldAp,0.25,3,3,GATTTAGGGTCCACTTGACC,0,1161553
fldAp,0.25,3,3,GATTTAGCGGGTACGGCTTT,0,1167437
fldAp,0.25,3,3,GATTGTGAATCAGCAACAGG,0,1105223
fldAp,0.25,3,3,GATTGTCAACGCAATGATAC,0,1127174
fldAp,0.25,3,3,GATTGAGAGCACTTTAGACT,0,1111073
fldAp,0.25,3,3,GATTCTATATAGGCTAGGCT,0,1150741
fldAp,0.25,3,3,GATTCCCAGCTCAGACCAAT,0,1087443
fldAp,0.25,3,3,GATTCAGGCAGTAGCAAGGG,0,1147767
fldAp,0.25,3,3,GATTATGGTAGAGTGCGGGC,0,1120330
fldAp,0.25,3,3,GATTAGCAACCTGATCAACC,0,1178027
fldAp,0.25,3,3,GATTACGGCGGCGTGCGGCG,0,1119515
fldAp,0.25,3,3,GATTAAAGCAATACTTCATA,0,1094841
fldAp,0.25,3,3,GATGTTACGGGCTTCCCTGA,0,1185855
fldAp,0.25,3,3,GATGTGAGATAGGGAAGACC,0,1168400
fldAp,0.25,3,3,GATGTAATTGTTTCCTCAAA,0,1177530
fldAp,0.25,3,3,GATGATAGGGGTAGAACTCA,0,1071412
fldAp,0.25,3,3,GATGACTCTCCAACAACCGG,0,1174892
fldAp,0.25,3,3,GATGACTATCCCAGATAGAG,0,1185099
fldAp,0.25,3,3,GATGACGCTGCTGTGACGCT,0,1182945
fldAp,0.25,3,3,GATGACAGGATCAGTGTTCT,0,1074911
fldAp,0.25,3,3,GATCTGCCTTCTTCTTCAGG,0,1098215
fldAp,0.25,3,3,GATCTGAGTTGCAAGCGTTC,0,1129241
fldAp,0.25,3,3,GATCGTGAACGACCCCACCG,0,1077062
fldAp,0.25,3,3,GATCGTCTCACGTCCGATAC,0,1100179
fldAp,0.25,3,3,GATCGTCCATTGAAGACGCT,0,1081669
fldAp,0.25,3,3,GATCGTCACTAGCCCAGGTA,0,1183729
fldAp,0.25,3,3,GATCGGAAGTTAATAAAGCG,0,1081051
fldAp,0.25,3,3,GATCCTCCCCGAAATGCGCG,0,1155933
fldAp,0.25,3,3,GATCCTAGGTAATCCGATGT,0,1123940
fldAp,0.25,3,3,GATCCCGTTTAAGAGGCCCA,0,1134593
fldAp,0.25,3,3,GATCATAAATAAATCGCAGA,0,1073639
fldAp,0.25,3,3,GATCAACTCGTTGGAATTCG,0,1111318
fldAp,0.25,3,3,GATATTGACCGCTCCTCACT,0,1176766
fldAp,0.25,3,3,GATATTCTATACCACAGCTA,0,1114744
fldAp,0.25,3,3,GATATCTAATGGTCCGGCCA,0,1181436
fldAp,0.25,3,3,GATATAGGAACTACTGCTTT,0,1160153
fldAp,0.25,3,3,GATAGTACTCCCTCTGAAGA,0,1075452
fldAp,0.25,3,3,GATAGAGCTGGGTGAATTAC,0,1183532
fldAp,0.25,3,3,GATACGTCGCTGTTACAATG,0,1072168
fldAp,0.25,3,3,GATACACACTGGCTCCGCCA,0,1155820
fldAp,0.25,3,3,GATAAGGCGGGAAAACGAAT,0,1071051
fldAp,0.25,3,3,GATAAGCCGAATGTCGACGT,0,1182445
fldAp,0.25,3,3,GATAAGCAAGACGCTGCCCC,0,1154180
fldAp,0.25,3,3,GATAAGACTCCGACTCTTAT,0,1150301
fldAp,0.25,3,3,GATAACGAGGAGATAATGAG,0,1122495
fldAp,0.25,3,3,GAGTGTTGATTGGTAGCTGG,0,1106159
fldAp,0.25,3,3,GAGTGGGTCCCCAAGTATCC,0,1170528
fldAp,0.25,3,3,GAGTCTTTGATGTACAGAAT,0,1172455
fldAp,0.25,3,3,GAGTCTGGGAAAAACCATGT,0,1175107
fldAp,0.25,3,3,GAGTCGATGCGCCACGAACT,0,1091735
fldAp,0.25,3,3,GAGTCCTCACCGGGTGGTTA,0,1102973
fldAp,0.25,3,3,GAGTATGTCTTTAAGCAATG,0,1140987
fldAp,0.25,3,3,GAGTAGTCATGATAACGGTC,0,1179648
fldAp,0.25,3,3,GAGGTTTCGCGTTGTACGAA,0,1129921
fldAp,0.25,3,3,GAGGTTGGCAACACGACATT,0,1091022
fldAp,0.25,3,3,GAGGTCACAGCTGGTGAGCT,0,1069831
fldAp,0.25,3,3,GAGGGTGGGCCGACTTACAG,0,1167763
fldAp,0.25,3,3,GAGGGTCTTTGTTTAGGGTA,0,1138618
fldAp,0.25,3,3,GAGGGTCTGTGGTAAGAGAG,0,1140952
fldAp,0.25,3,3,GAGGCGGAGTTGCTGTTGAC,0,1085302
fldAp,0.25,3,3,GAGGCGAGGAGCCCGGAAAG,0,1141288
fldAp,0.25,3,3,GAGGCCGCTGTTGCTTACGT,0,1113465
fldAp,0.25,3,3,GAGGACATACCTTACAATCC,0,1077782
fldAp,0.25,3,3,GAGCTTAGGCGTGAGTCCGT,0,1182162
fldAp,0.25,3,3,GAGCTGTGCAGACCAAAGTG,0,1167767
fldAp,0.25,3,3,GAGCTAAGGATCATGGAACG,0,1143744
fldAp,0.25,3,3,GAGCGAGATTGCACTGCATT,0,1181395
fldAp,0.25,3,3,GAGCCGGCCGCTCATCTAGC,0,1138649
fldAp,0.25,3,3,GAGCCGAATCTTCCTGAAAC,0,1110743
fldAp,0.25,3,3,GAGCCATTCTAGTTCATGCG,0,1121548
fldAp,0.25,3,3,GAGCCAGCTAGGGCCGCCTT,0,1157446
fldAp,0.25,3,3,GAGCACGCCTTAACCCTCTA,0,1165950
fldAp,0.25,3,3,GAGATTTCACACCTACTAAA,0,1173060
fldAp,0.25,3,3,GAGATTTAGGTCTATGTTTA,0,1131215
fldAp,0.25,3,3,GAGATCACATCAGCGCTTAC,0,1148900
fldAp,0.25,3,3,GAGAGTGAAGGTAGCCAGCC,0,1143385
fldAp,0.25,3,3,GAGAGCAGATGGCTGTTGGC,0,1100874
fldAp,0.25,3,3,GAGACTCCCACTGTAATGCC,0,1069974
fldAp,0.25,3,3,GAGACTCCAGAACACTGGGG,0,1108942
fldAp,0.25,3,3,GAGAATAAGGGGGAAAGAAA,0,1123648
fldAp,0.25,3,3,GAGAAGCAGCAGATCTGAAA,0,1162458
fldAp,0.25,3,3,GAGAAACTCGCAACTTGACA,0,1168546
fldAp,0.25,3,3,GACTTGCAGACGGCATCTAG,0,1119979
fldAp,0.25,3,3,GACTGTAGTATCGCGCGGCT,0,1152580
fldAp,0.25,3,3,GACTGACTGAAAAATCAGGC,0,1151487
fldAp,0.25,3,3,GACTCGGGTGCCCGAAATGA,0,1088120
fldAp,0.25,3,3,GACTCGGCCGTATTGGGGCA,0,1151547
fldAp,0.25,3,3,GACTCCATCCACAGCAGAGG,0,1182864
fldAp,0.25,3,3,GACTCATCACTAGGGTAGTA,0,1123018
fldAp,0.25,3,3,GACTATATCTATAATTTGCA,0,1081877
fldAp,0.25,3,3,GACGGGAGCATTATCCTAGG,0,1090118
fldAp,0.25,3,3,GACGCTTTGAATTTCACCTG,0,1121848
fldAp,0.25,3,3,GACGCCGGTTCAGACTTTAA,0,1073654
fldAp,0.25,3,3,GACGCCCCTTTGGGTCACTA,0,1170235
fldAp,0.25,3,3,GACGCATCTCCGAAGCTCTC,0,1186760
fldAp,0.25,3,3,GACGCATAGAACGTACATTT,0,1140785
fldAp,0.25,3,3,GACGACATTAAGCGGTCTCG,0,1177153
fldAp,0.25,3,3,GACCTTCAGGTGTCGGACCG,0,1149650
fldAp,0.25,3,3,GACCGCTGGGCGTAGAACCG,0,1069888
fldAp,0.25,3,3,GACCCCAGCGTAGGTATGTC,0,1093772
fldAp,0.25,3,3,GACCACTAAGTGTACCCCCA,0,1065676
fldAp,0.25,3,3,GACCAAAACAATAACATATC,0,1093225
fldAp,0.25,3,3,GACATCGTAAAGCTGTTCTC,0,1170159
fldAp,0.25,3,3,GACAGTCCTCCTGTTGTTCC,0,1079381
fldAp,0.25,3,3,GACAGGCCTAATTCTGGTCA,0,1175019
fldAp,0.25,3,3,GACACTCGTATTCCATCCCC,0,1124062
fldAp,0.25,3,3,GACACTCATATCGGAATAAA,0,1139801
fldAp,0.25,3,3,GACACTATATGCATTGGTTG,0,1099149
fldAp,0.25,3,3,GACACAGTTATACACCCGAT,0,1151393
fldAp,0.25,3,3,GACACACGTAAAGAACACAT,0,1106049
fldAp,0.25,3,3,GACAAAGTCCTTATTCCACA,0,1160716
fldAp,0.25,3,3,GAATTTGGTCCCATCTGCAT,0,1163386
fldAp,0.25,3,3,GAATTTACAAGGTAGAGCTG,0,1128424
fldAp,0.25,3,3,GAATTAGAGACTCTAGTAGT,0,1109395
fldAp,0.25,3,3,GAATTACAAACTTCGGACGG,0,1123558
fldAp,0.25,3,3,GAATGTCCCAGTAAGGTGGT,0,1178912
fldAp,0.25,3,3,GAATGTAGCGGGGGCGGGAC,0,1075646
fldAp,0.25,3,3,GAATGAACGAAGGGTGCAGC,0,1150877
fldAp,0.25,3,3,GAATCCTAGTGGCTGCTCAT,0,1159610
fldAp,0.25,3,3,GAATAACGCAGGATCCGGGA,0,1108625
fldAp,0.25,3,3,GAAGTTAGCTAATCAACATT,0,1150058
fldAp,0.25,3,3,GAAGGGGACAGGGTTAATTC,0,1086443
fldAp,0.25,3,3,GAAGGCGTTTTAGGAAGTTG,0,1160303
fldAp,0.25,3,3,GAAGGCCCCGTTTAACAATC,0,1133632
fldAp,0.25,3,3,GAAGCTGCCTGCACTCTTAT,0,1095437
fldAp,0.25,3,3,GAAGCCCCATCATTACAGTC,0,1075857
fldAp,0.25,3,3,GAAGATCATTATTTCAATAA,0,1067854
fldAp,0.25,3,3,GAAGAGTCAAGATTCGTTAT,0,1163042
fldAp,0.25,3,3,GAACTGAGGACCTAGCACTC,0,1104055
fldAp,0.25,3,3,GAACTCTCGGACCGCTCTCA,0,1109754
fldAp,0.25,3,3,GAACGCTTCGATGTTCACGA,0,1122162
fldAp,0.25,3,3,GAACGCTCGCTCCGCTTTGG,0,1105255
fldAp,0.25,3,3,GAACAACTGAGTTGGCCGTG,0,1132582
fldAp,0.25,3,3,GAACAAAGCAAGCCCATGAC,0,1174417
fldAp,0.25,3,3,GAAATCGGCCAATCCCCTGG,0,1166923
fldAp,0.25,3,3,GAAATATGCGCGTGATAGTA,0,1144866
fldAp,0.25,3,3,GAAATATAGGACCTTTGATA,0,1171679
fldAp,0.25,3,3,GAAACTCATCGCACGTTGTT,0,1186867
fldAp,0.25,3,3,GAAACGTGACAGCGCCGATC,0,1153350
fldAp,0.25,3,3,GAAACCCTCCTAAGCGTAGG,0,1099305
fldAp,0.25,3,3,GAAACCATCATGTCGTAGAC,0,1153512
fldAp,0.25,3,3,GAAACATCCGACACACGGTT,0,1143609
fldAp,0.25,3,3,GAAAATGGTGGTAAATTGCA,0,1091607
fldAp,0.25,3,3,CTTTTCTGAGACCAATTTAA,0,1118660
fldAp,0.25,3,3,CTTTGTGTGGGTGTAGCACA,0,1111995
fldAp,0.25,3,3,CTTTGTACGAGACACTTGAG,0,1103814
fldAp,0.25,3,3,CTTTGAACTCGTTGTGTCTC,0,1099676
fldAp,0.25,3,3,CTTTATCTCGGCTTGTTAGG,0,1168078
fldAp,0.25,3,3,CTTTACGTCGCGGGATTCCT,0,1078390
fldAp,0.25,3,3,CTTGTTGGAAACACTCACGT,0,1156073
fldAp,0.25,3,3,CTTGGTTACATTCGCAACCA,0,1160947
fldAp,0.25,3,3,CTTGGTAATCCAGCACTCAC,0,1184124
fldAp,0.25,3,3,CTTGGGGATCCCACCTTCTC,0,1173474
fldAp,0.25,3,3,CTTGGAGAGAGCGAACAGGG,0,1102974
fldAp,0.25,3,3,CTTGCTCCCCCTATAGCCAG,0,1150304
fldAp,0.25,3,3,CTTGCGCAGGAGAATCACCT,0,1106820
fldAp,0.25,3,3,CTTGCCCTGAATTCAAATCT,0,1072178
fldAp,0.25,3,3,CTTGCCCAGTGCTGAACCAC,0,1172177
fldAp,0.25,3,3,CTTGCAATTGATAGCCCCAT,0,1102066
fldAp,0.25,3,3,CTTCTTTGCGTTCCACATTC,0,1106203
fldAp,0.25,3,3,CTTCTAGAAACTCATTGCTA,0,1143379
fldAp,0.25,3,3,CTTCGTGGGGGGCCGCTCCT,0,1110284
fldAp,0.25,3,3,CTTCGGTCCTAGTGCGCGGT,0,1168510
fldAp,0.25,3,3,CTTCGGGAAATGTTTATTAC,0,1158785
fldAp,0.25,3,3,CTTCGACAATTTATCCTGCA,0,1154854
fldAp,0.25,3,3,CTTCCCGGCAGTTACACTAT,0,1081835
fldAp,0.25,3,3,CTTCCACGTCCCGGAGCATG,0,1180896
fldAp,0.25,3,3,CTTCATTGTCACTCCCCCCA,0,1121428
fldAp,0.25,3,3,CTTCATTACTTACTGCTAAA,0,1113648
fldAp,0.25,3,3,CTTCATGCCTAATATATTCT,0,1101744
fldAp,0.25,3,3,CTTATTGGATATGTACTAGC,0,1169332
fldAp,0.25,3,3,CTTATTCAGTACTTGAGACC,0,1161345
fldAp,0.25,3,3,CTTATTATAGAAGGTTCGGA,0,1146074
fldAp,0.25,3,3,CTTATGGCGGCTACAAGTCT,0,1112574
fldAp,0.25,3,3,CTTAGTCTTCCACACTGCGC,0,1114028
fldAp,0.25,3,3,CTTAGGTCGTTAAATTGTGG,0,1159639
fldAp,0.25,3,3,CTTAGGGTGTTCGCACTTCA,0,1153606
fldAp,0.25,3,3,CTTACGGTCTTAGGTTTAAG,0,1135049
fldAp,0.25,3,3,CTTAATAGATCGTGCTTCGA,0,1077801
fldAp,0.25,3,3,CTTAAGTCGGGCAGTAGGGC,0,1115023
fldAp,0.25,3,3,CTTAAAAGAGTCTTTCTGTT,0,1077869
fldAp,0.25,3,3,CTTAAAACCGCACCCCTTAG,0,1164118
fldAp,0.25,3,3,CTGTGTAGTACATTAGCATC,0,1122910
fldAp,0.25,3,3,CTGTGCAACCCGGTTAGCGA,0,1071913
fldAp,0.25,3,3,CTGTGAGTGAGTCGGCCCAC,0,1080907
fldAp,0.25,3,3,CTGTCTGGCGATGCGACTGT,0,1152617
fldAp,0.25,3,3,CTGTCGTCTACGAGGGCCGC,0,1111123
fldAp,0.25,3,3,CTGTCCTTCCCGACCGGCCT,0,1163449
fldAp,0.25,3,3,CTGTCAGTTGGTTGATATGC,0,1130941
fldAp,0.25,3,3,CTGTATTTTGAGTGCCCCAG,0,1134136
fldAp,0.25,3,3,CTGTACAAAGGATTCCTCGG,0,1084301
fldAp,0.25,3,3,CTGTAAATTACATCGGAGCT,0,1084732
fldAp,0.25,3,3,CTGGTGTTTACCACAACCGA,0,1120191
fldAp,0.25,3,3,CTGGTGCTTTATAGGGAGGC,0,1177341
fldAp,0.25,3,3,CTGGTCTAAGAAGATCCATA,0,1177127
fldAp,0.25,3,3,CTGGGGCTCATGTGGCGTGA,0,1183946
fldAp,0.25,3,3,CTGGGCTCGAGAAAAGCACT,0,1128644
fldAp,0.25,3,3,CTGGGACCATGCTCGCCGTA,0,1176851
fldAp,0.25,3,3,CTGGCTCCCTGCAGCTGTCA,0,1095779
fldAp,0.25,3,3,CTGGCGCCCTACTTCTTATT,0,1169220
fldAp,0.25,3,3,CTGGCCGGGGTTTCTAGTGA,0,1123896
fldAp,0.25,3,3,CTGGAGTGGGCTTAAGCGCG,0,1107349
fldAp,0.25,3,3,CTGGAGCCCAGAAAGGATCT,0,1094132
fldAp,0.25,3,3,CTGCTTTTAATCCATATGTA,0,1170987
fldAp,0.25,3,3,CTGCTGACGGCACGGTACAT,0,1185390
fldAp,0.25,3,3,CTGCTCAACCTGGTTGTTGT,0,1160854
fldAp,0.25,3,3,CTGCGTTTGAAGTAGGATGC,0,1180093
fldAp,0.25,3,3,CTGCGGGGAGGCGTGTCCTG,0,1154901
fldAp,0.25,3,3,CTGCGCCTTGGCACACGATC,0,1162922
fldAp,0.25,3,3,CTGCGAGCAACTGCAGGGTC,0,1144990
fldAp,0.25,3,3,CTGCCGGTCTCCGAAAAGGA,0,1176358
fldAp,0.25,3,3,CTGCCGGGCATTTAATTCCA,0,1100583
fldAp,0.25,3,3,CTGCCCCAGGCTCACGAGTC,0,1118256
fldAp,0.25,3,3,CTGCCATTAGCGCCGTTTTA,0,1086764
fldAp,0.25,3,3,CTGCCATGGAGAGGCTGCGC,0,1131751
fldAp,0.25,3,3,CTGCATTGGTACGCGCAAAT,0,1173686
fldAp,0.25,3,3,CTGCAGTTTTCATACTACCA,0,1175943
fldAp,0.25,3,3,CTGCACGCACCTGAGGGAGT,0,1096857
fldAp,0.25,3,3,CTGCACAGCCGATTATGATT,0,1104825
fldAp,0.25,3,3,CTGATTATGCATTACGGAAC,0,1079891
fldAp,0.25,3,3,CTGATAGGCACGTCCCACCG,0,1092111
fldAp,0.25,3,3,CTGAGCTGGTATGTTGACAA,0,1184561
fldAp,0.25,3,3,CTGAGATTGCAGCAGGCCTA,0,1136256
fldAp,0.25,3,3,CTGACGTCTATGAAGCAATA,0,1072837
fldAp,0.25,3,3,CTGACATGGACTTGGGAACA,0,1114135
fldAp,0.25,3,3,CTGAATTCGCATCTAATGGA,0,1080341
fldAp,0.25,3,3,CTCTTGAGCCCTTCGAACCA,0,1177078
fldAp,0.25,3,3,CTCTTAGATACCTTGAACTA,0,1179661
fldAp,0.25,3,3,CTCTGTTCTTGTGTGTTCTT,0,1177972
fldAp,0.25,3,3,CTCTCGAGCCATTATCTCAA,0,1117611
fldAp,0.25,3,3,CTCGTTCTGAATTTGGAGGG,0,1169354
fldAp,0.25,3,3,CTCGTTCCACTTGCGATCTC,0,1088157
fldAp,0.25,3,3,CTCGTGTAAGTTGTTGTGCA,0,1086113
fldAp,0.25,3,3,CTCGTCGTGTCCGGGAGAGC,0,1085274
fldAp,0.25,3,3,CTCGGTTCAAGCGGGATCTC,0,1136197
fldAp,0.25,3,3,CTCGCTCTCGAATTGTTATT,0,1155275
fldAp,0.25,3,3,CTCGCAGCTGGACACCAATA,0,1154503
fldAp,0.25,3,3,CTCGACCTAGGACACCATAT,0,1138988
fldAp,0.25,3,3,CTCGACAGATCCCAGGCTTT,0,1102686
fldAp,0.25,3,3,CTCCTTAGGGGGGGGTCCGC,0,1173063
fldAp,0.25,3,3,CTCCCGCGTGTATTCGCAAA,0,1127863
fldAp,0.25,3,3,CTCCACCTGGAGGTCGTGTG,0,1099203
fldAp,0.25,3,3,CTCCACACAGCTTGCGCTCT,0,1095925
fldAp,0.25,3,3,CTCCAAAGCCAAGGCGTGCT,0,1137379
fldAp,0.25,3,3,CTCATCGTCTCGCGCCGGCA,0,1173635
fldAp,0.25,3,3,CTCATCAAACCTACAGGATT,0,1115596
fldAp,0.25,3,3,CTCATATGAAGCCAAAGGTA,0,1166808
fldAp,0.25,3,3,CTCAGTGGGCTACTGAGCCG,0,1183461
fldAp,0.25,3,3,CTCAGTGCCGGTATCGTACT,0,1139237
fldAp,0.25,3,3,CTCAGGAACCGTAACCAAAG,0,1134746
fldAp,0.25,3,3,CTCAGCGGATATTGATACGG,0,1099148
fldAp,0.25,3,3,CTCAGCCCAGCTAACTCATG,0,1102761
fldAp,0.25,3,3,CTCACCTTGCTCCGATGAGT,0,1162939
fldAp,0.25,3,3,CTCACCAAAGACCTATGGGA,0,1145393
fldAp,0.25,3,3,CTCAACGGCATCTGGGCCGT,0,1161980
fldAp,0.25,3,3,CTCAAACGAGGATGGGCTCC,0,1169994
fldAp,0.25,3,3,CTATTGTGGAATCGTGGAGG,0,1186898
fldAp,0.25,3,3,CTATTAGGCATGTCTGAGAT,0,1182328
fldAp,0.25,3,3,CTATTAGCGCTTAATCGCTT,0,1181094
fldAp,0.25,3,3,CTATGTGTTGTGCGGATTTT,0,1137786
fldAp,0.25,3,3,CTATGGTTTATTGGACTCAG,0,1146683
fldAp,0.25,3,3,CTATGACACGGCACAGCCCT,0,1132718
fldAp,0.25,3,3,CTATCTGAGGAGATTAATCC,0,1127782
fldAp,0.25,3,3,CTATCAACTACACGTTCGTT,0,1169528
fldAp,0.25,3,3,CTATATCCCTCGCGTAAGAC,0,1084656
fldAp,0.25,3,3,CTATAGCCTCATTGAGCCGA,0,1101966
fldAp,0.25,3,3,CTATACTTCCACGATCCCAC,0,1116267
fldAp,0.25,3,3,CTAGTTACTCACTTGTCTTG,0,1095835
fldAp,0.25,3,3,CTAGTATTATCGAGGACGTT,0,1088890
fldAp,0.25,3,3,CTAGTACTGTCTGACAATCG,0,1145893
fldAp,0.25,3,3,CTAGTACACTGTGGAGTTTT,0,1135137
fldAp,0.25,3,3,CTAGGCAGACATGGGCTTTA,0,1116329
fldAp,0.25,3,3,CTAGCGTAATCAGGTGTACT,0,1134318
fldAp,0.25,3,3,CTAGCCCTGCTAGCCCGACT,0,1072987
fldAp,0.25,3,3,CTAGCAATGCAGGCAGGCGT,0,1080855
fldAp,0.25,3,3,CTAGAGTGTTTACTCGACTC,0,1124877
fldAp,0.25,3,3,CTAGAGGATGTAACGCGGAT,0,1180623
fldAp,0.25,3,3,CTACTTTGTGGGGTATGCTA,0,1099134
fldAp,0.25,3,3,CTACTTTATTCTTGACAGGT,0,1133200
fldAp,0.25,3,3,CTACTGGACGTGCCTTGGAT,0,1155355
fldAp,0.25,3,3,CTACTCGGTTTAGTTATCGT,0,1079422
fldAp,0.25,3,3,CTACGCTACATGGCTCTACT,0,1085808
fldAp,0.25,3,3,CTACGCCCGGAGATTCTCTC,0,1147882
fldAp,0.25,3,3,CTACGCAGTTTACGGCCCTT,0,1176179
fldAp,0.25,3,3,CTACGCAACTACATTGCTAT,0,1154484
fldAp,0.25,3,3,CTAATTCCATGCGGGACACA,0,1078796
fldAp,0.25,3,3,CTAATAACATGTTAAGACAG,0,1116574
fldAp,0.25,3,3,CTAAGTCATCGGGCTGGAAG,0,1142920
fldAp,0.25,3,3,CTAAGGTCTTTCGTATGCTC,0,1112215
fldAp,0.25,3,3,CTAAGGATTCCACTACGCTT,0,1157134
fldAp,0.25,3,3,CTAAGCCGAGGATATCATTG,0,1125575
fldAp,0.25,3,3,CTAACCTGGAATAAGGAAAA,0,1071374
fldAp,0.25,3,3,CTAACAGGTCCGATTACTAA,0,1158672
fldAp,0.25,3,3,CTAACAAACGGCCGTCGGGT,0,1116810
fldAp,0.25,3,3,CTAAATAACGATAGGGGCTG,0,1103587
fldAp,0.25,3,3,CTAAAGGGAATGTGTTGTAT,0,1133873
fldAp,0.25,3,3,CGTTTTTATTAACATACCGA,0,1122804
fldAp,0.25,3,3,CGTTTCGCAGATAAATCCAA,0,1112538
fldAp,0.25,3,3,CGTTTAAACGTATTGGTTGG,0,1076544
fldAp,0.25,3,3,CGTTGGCGTTTTGGTAATTC,0,1088381
fldAp,0.25,3,3,CGTTGCCTCGTTATCGCCCA,0,1143970
fldAp,0.25,3,3,CGTTGATCAACTAGAAAGGC,0,1155965
fldAp,0.25,3,3,CGTTCGTATGCATATCATGG,0,1105644
fldAp,0.25,3,3,CGTTCGCTGTCAGTCTTGCA,0,1135388
fldAp,0.25,3,3,CGTTCAACCTCGGTAGTGCT,0,1149496
fldAp,0.25,3,3,CGTTAGCACCTGGTTCTGCA,0,1138654
fldAp,0.25,3,3,CGTTACGTTGCGAAGAGATG,0,1164091
fldAp,0.25,3,3,CGTTAAGATGCTTGTCAGAC,0,1156369
fldAp,0.25,3,3,CGTTAACGCATGTCCAACGT,0,1113518
fldAp,0.25,3,3,CGTGTCCATAAGAAAAACTT,0,1146072
fldAp,0.25,3,3,CGTGGCTAGCTAGCCTGAAA,0,1157024
fldAp,0.25,3,3,CGTGGACCCATAGTGTCATC,0,1078372
fldAp,0.25,3,3,CGTGCTTCAGAGCGTGGCAA,0,1087249
fldAp,0.25,3,3,CGTGCGCTATGCGTTTCAAC,0,1074371
fldAp,0.25,3,3,CGTGCCAAGACGGAGGTCGT,0,1107283
fldAp,0.25,3,3,CGTGATTAAATATCTTAGTC,0,1112053
fldAp,0.25,3,3,CGTGATGGGTACGTTATCAG,0,1121443
fldAp,0.25,3,3,CGTGATCGATTAGCCAAAAT,0,1119068
fldAp,0.25,3,3,CGTGATATAGAATAATAGAC,0,1101184
fldAp,0.25,3,3,CGTCGCATCAACTGTTCGAT,0,1182369
fldAp,0.25,3,3,CGTCCGCGTAGGGAAAGGGC,0,1125784
fldAp,0.25,3,3,CGTCCGAGAGGCACAGCAGT,0,1074301
fldAp,0.25,3,3,CGTCCCCAGTTGTCGCGTCC,0,1075593
fldAp,0.25,3,3,CGTCAGTGAGGCTATTAGCG,0,1080780
fldAp,0.25,3,3,CGTCAATAACTCGTTTCGTA,0,1173625
fldAp,0.25,3,3,CGTATTTTAGGTACGGAGTC,0,1143517
fldAp,0.25,3,3,CGTATTGATCTGCCGACGTT,0,1129452
fldAp,0.25,3,3,CGTATACAGGAACACGGGAC,0,1070506
fldAp,0.25,3,3,CGTAGGCGAGCATGAAACTG,0,1066763
fldAp,0.25,3,3,CGTAGCGGGGTCGCTGTCAT,0,1180349
fldAp,0.25,3,3,CGTAGCCGGGAAGTAGCACT,0,1153321
fldAp,0.25,3,3,CGTAGATGTGCATGGAGTCA,0,1139691
fldAp,0.25,3,3,CGTACTCTACGTATATTCCA,0,1143644
fldAp,0.25,3,3,CGTACTAGAATAGTAAGCGT,0,1133181
fldAp,0.25,3,3,CGTACATACTTTCCGACCTG,0,1072977
fldAp,0.25,3,3,CGTAATCGCCCGCCCGCATG,0,1139363
fldAp,0.25,3,3,CGTAACGCTGTTCCTAGCTT,0,1175284
fldAp,0.25,3,3,CGTAAATTTATCGAGAAACA,0,1134380
fldAp,0.25,3,3,CGGTTTATTCTAAAGTCAAG,0,1154364
fldAp,0.25,3,3,CGGTTCGGTCACAGAGGACA,0,1123464
fldAp,0.25,3,3,CGGTTCGCCGGATCGTAGAA,0,1175303
fldAp,0.25,3,3,CGGTTCCGCCTAGAGAATAG,0,1099923
fldAp,0.25,3,3,CGGTGTGAGGCCGTGCATAT,0,1096171
fldAp,0.25,3,3,CGGTGGTCGATCGAATGTTA,0,1154522
fldAp,0.25,3,3,CGGTGCCGTACAACCTGTAG,0,1070325
fldAp,0.25,3,3,CGGTCTTTGGGAGTATGTGT,0,1072983
fldAp,0.25,3,3,CGGTCAGTGCTTGGGGGTGT,0,1162587
fldAp,0.25,3,3,CGGTCAATTTGGCCGAGTCC,0,1075815
fldAp,0.25,3,3,CGGTATCGCTAGTTACTTTG,0,1158374
fldAp,0.25,3,3,CGGGTCACAGGCGTTGTCTA,0,1165141
fldAp,0.25,3,3,CGGGGGATGGGGCCTCCACG,0,1159923
fldAp,0.25,3,3,CGGGGCGGATAATGCACCAA,0,1151148
fldAp,0.25,3,3,CGGGGAATTTAGTGTCAGCT,0,1070498
fldAp,0.25,3,3,CGGGGAAGCCGGATAATTAC,0,1152510
fldAp,0.25,3,3,CGGGGAAAACATACTGAGTG,0,1152496
fldAp,0.25,3,3,CGGGCTTCTCCGCTGGTAAG,0,1133255
fldAp,0.25,3,3,CGGGCTACAGAATCCGATAT,0,1102165
fldAp,0.25,3,3,CGGGCGACAGAATGACATTC,0,1129354
fldAp,0.25,3,3,CGGGCAGCTCGGTATTGTCA,0,1164958
fldAp,0.25,3,3,CGGGATTGCGTTGAATGCGT,0,1065313
fldAp,0.25,3,3,CGGGAGCTTATTCCTGGCAA,0,1140831
fldAp,0.25,3,3,CGGGACCAAAGCTAGTTTCC,0,1101122
fldAp,0.25,3,3,CGGGACACATGACCACTGTA,0,1171444
fldAp,0.25,3,3,CGGGAACGGCGTGGTCGCAA,0,1162105
fldAp,0.25,3,3,CGGCTTGTCCCGGATGCGGT,0,1184034
fldAp,0.25,3,3,CGGCTTACACGCAGCTTAAC,0,1071808
fldAp,0.25,3,3,CGGCTGGACCCTTGCCGGGT,0,1098446
fldAp,0.25,3,3,CGGCGTCCATCTCATGGAAT,0,1128908
fldAp,0.25,3,3,CGGCGGTTGCTCTTCCTCAC,0,1076215
fldAp,0.25,3,3,CGGCGGATTAGGGGTTACCT,0,1072031
fldAp,0.25,3,3,CGGCGGATTAGCGCAGGCCT,0,1064358
fldAp,0.25,3,3,CGGCGACATAGGCGCCGAGC,0,1133381
fldAp,0.25,3,3,CGGCCTGTTGAGGTATACAG,0,1099412
fldAp,0.25,3,3,CGGCATTCACTGCTTGATTT,0,1155173
fldAp,0.25,3,3,CGGCAGTAGAAGTTCGACTG,0,1068656
fldAp,0.25,3,3,CGGCAGACACGACGACATCA,0,1180699
fldAp,0.25,3,3,CGGCACGATCTGTTAGCGGT,0,1142736
fldAp,0.25,3,3,CGGCAATTCACCTAAGTCCA,0,1135272
fldAp,0.25,3,3,CGGATGGTGCCTAGAGATTC,0,1078954
fldAp,0.25,3,3,CGGATATGCAGAAAATTATT,0,1124137
fldAp,0.25,3,3,CGGATACTGACCTTGTTTTG,0,1076197
fldAp,0.25,3,3,CGGATAATTTTCCGTAATCA,0,1140076
fldAp,0.25,3,3,CGGAGGGGATCCCGCACCAT,0,1127600
fldAp,0.25,3,3,CGGAGCGGGACGACGATCCT,0,1141556
fldAp,0.25,3,3,CGGACTACATTTCTTAAATA,0,1149819
fldAp,0.25,3,3,CGGACGTATCGTGACGACCC,0,1073724
fldAp,0.25,3,3,CGGACCTCCAACACAGGAGG,0,1070411
fldAp,0.25,3,3,CGGACCAAGACACGTCTGAT,0,1129105
fldAp,0.25,3,3,CGGACAAGCGCAGGCATCAT,0,1107111
fldAp,0.25,3,3,CGCTTGAGGCCCATACCAGG,0,1163262
fldAp,0.25,3,3,CGCTGTGGCCACAATACAGA,0,1165451
fldAp,0.25,3,3,CGCTGGAGTACGTCTAAACG,0,1076675
fldAp,0.25,3,3,CGCTGATTTACAGCCCTGGG,0,1140314
fldAp,0.25,3,3,CGCTGACTTGATGGGCCTCC,0,1165323
fldAp,0.25,3,3,CGCTCTTTGAGTGGCGGAGT,0,1167083
fldAp,0.25,3,3,CGCTCGACCTGGGAATGTAC,0,1166969
fldAp,0.25,3,3,CGCTCCTTGGCTTCCGGCCT,0,1176740
fldAp,0.25,3,3,CGCTCCTGACGCGTGTGTAA,0,1148452
fldAp,0.25,3,3,CGCTCCGGAGACCGGACGGA,0,1088383
fldAp,0.25,3,3,CGCTATGTGAGAGGGGGCGT,0,1158384
fldAp,0.25,3,3,CGCTAGGTGTGTGTTTGTGG,0,1160781
fldAp,0.25,3,3,CGCTAGAGCCCAACGCTTAT,0,1139328
fldAp,0.25,3,3,CGCTAATGGACAAGACCGCG,0,1128541
fldAp,0.25,3,3,CGCGTCTCATAGTTCTGGAT,0,1113490
fldAp,0.25,3,3,CGCGGGGCCTCACATTTTAG,0,1078093
fldAp,0.25,3,3,CGCGGCGGTTTGATCTCCGC,0,1155529
fldAp,0.25,3,3,CGCGGCCAGGCGCGCGCGGA,0,1098153
fldAp,0.25,3,3,CGCGCTTCTAGTCGGCGTAC,0,1153262
fldAp,0.25,3,3,CGCGCTCGCTAATAGCCGAT,0,1161167
fldAp,0.25,3,3,CGCGCCGATCCTCGGTTCGA,0,1083664
fldAp,0.25,3,3,CGCGCAGCGTATAGAGGCGG,0,1064057
fldAp,0.25,3,3,CGCGCAAGAAATATATACTA,0,1142505
fldAp,0.25,3,3,CGCGATGGACGATTCGTCAC,0,1128899
fldAp,0.25,3,3,CGCGAACCAATCACCCATAT,0,1153431
fldAp,0.25,3,3,CGCCTTGGCACCAGGGTAAT,0,1174526
fldAp,0.25,3,3,CGCCTTCTCCTACCTTGGTT,0,1102970
fldAp,0.25,3,3,CGCCTTAATGGGGCAGCCGC,0,1086990
fldAp,0.25,3,3,CGCCTGGGGGTGCGGAGCGC,0,1064580
fldAp,0.25,3,3,CGCCTCGAAAGAGGATGCGT,0,1096346
fldAp,0.25,3,3,CGCCGTGCAGAAACAGGAGC,0,1103811
fldAp,0.25,3,3,CGCCGCACCAGTATGATATT,0,1095787
fldAp,0.25,3,3,CGCCCTGCTAGCGCTTATCT,0,1171395
fldAp,0.25,3,3,CGCCCATGGTATGAGAGTCC,0,1143939
fldAp,0.25,3,3,CGCCATTGTCAGAGTCAGCA,0,1104198
fldAp,0.25,3,3,CGCCATGTATCAATAATGGG,0,1146978
fldAp,0.25,3,3,CGCCAGTCGCTTGTGGCCTC,0,1113134
fldAp,0.25,3,3,CGCATCTACAAGCCTAACCT,0,1185819
fldAp,0.25,3,3,CGCATACCCACGTACGGGCA,0,1174812
fldAp,0.25,3,3,CGCAGTTTTGAGTCTGGGTG,0,1179723
fldAp,0.25,3,3,CGCAGGTAGCCTGTCCCCTT,0,1143104
fldAp,0.25,3,3,CGCAGGGGATGTGAGTCTGA,0,1078670
fldAp,0.25,3,3,CGCAGGCGATGCAGGGAAAT,0,1178998
fldAp,0.25,3,3,CGCAGGATGCACCGGAATAT,0,1124415
fldAp,0.25,3,3,CGCAGATTGCGAGTGTTTTG,0,1184326
fldAp,0.25,3,3,CGCACCGCTGTTGGGGCGTA,0,1136293
fldAp,0.25,3,3,CGCACATGCATAAATGGAAC,0,1088738
fldAp,0.25,3,3,CGCACATACAGCCTGCATAA,0,1172300
fldAp,0.25,3,3,CGCAATCCATTCAGTCTGAT,0,1130458
fldAp,0.25,3,3,CGCAACGTTTCGCTATTGTT,0,1087153
fldAp,0.25,3,3,CGCAACCCTTCCCTACCATG,0,1069366
fldAp,0.25,3,3,CGCAAAACTATGGCAACAAT,0,1079565
fldAp,0.25,3,3,CGATTGTGGTTGGACGACCG,0,1174224
fldAp,0.25,3,3,CGATTGCTAGAACCCCTCCC,0,1115358
fldAp,0.25,3,3,CGATTCTATGAACCGCAAAG,0,1097928
fldAp,0.25,3,3,CGATTAATAAACGTCCGGCT,0,1172931
fldAp,0.25,3,3,CGATGTGTATCAGCCGGATC,0,1176555
fldAp,0.25,3,3,CGATCTTTAGTTCAGGTGTT,0,1072127
fldAp,0.25,3,3,CGATCGCTCCGTACCTCTTG,0,1161070
fldAp,0.25,3,3,CGATCAGTAAAATAGCTCCC,0,1088936
fldAp,0.25,3,3,CGAGTTGGGAACGTCAAAGT,0,1085027
fldAp,0.25,3,3,CGAGTTGCTAGTCGCAAGTC,0,1158428
fldAp,0.25,3,3,CGAGTTCGGCTCGATCATTC,0,1150044
fldAp,0.25,3,3,CGAGTATTTTAGGCTCAAAT,0,1080326
fldAp,0.25,3,3,CGAGTATACTTGACTATACT,0,1180236
fldAp,0.25,3,3,CGAGTACTGGCGTTCCGCAG,0,1096990
fldAp,0.25,3,3,CGAGGTCGAAACCCAAACAG,0,1093893
fldAp,0.25,3,3,CGAGGTACCCGAATGATATG,0,1067838
fldAp,0.25,3,3,CGAGGGGCGGGTGACTGTCA,0,1158636
fldAp,0.25,3,3,CGAGGGCGCGTGGCGCGTAC,0,1068015
fldAp,0.25,3,3,CGAGGGACTTGCACCCGAAA,0,1070686
fldAp,0.25,3,3,CGAGGCGAGGCAATCTCAAT,0,1152897
fldAp,0.25,3,3,CGAGGCCTGGGACAGGATCG,0,1093763
fldAp,0.25,3,3,CGAGCGCGTCCTCACGTTAC,0,1084894
fldAp,0.25,3,3,CGAGAGAGTACTCTCGGCAA,0,1073547
fldAp,0.25,3,3,CGAGACTGTCCAGCATTTAC,0,1126126
fldAp,0.25,3,3,CGAGACTGCGCCATTACTTT,0,1067697
fldAp,0.25,3,3,CGAGACGATTTGCTTGCCAT,0,1100045
fldAp,0.25,3,3,CGAGACCAGGACCCTTCACT,0,1068306
fldAp,0.25,3,3,CGACTGTGGCGATGAACTAT,0,1129207
fldAp,0.25,3,3,CGACTACACCTTACTTATTC,0,1133265
fldAp,0.25,3,3,CGACGTGATCCGGCCGGAGG,0,1148829
fldAp,0.25,3,3,CGACGTATTGTCGCGAGAAA,0,1117041
fldAp,0.25,3,3,CGACGAGTGGCTTCTTGATC,0,1165387
fldAp,0.25,3,3,CGACGAGCGGAATTTAAGAA,0,1160349
fldAp,0.25,3,3,CGACCTTAACTCGACTAATG,0,1164815
fldAp,0.25,3,3,CGACCATCTGCACCATAGGA,0,1069711
fldAp,0.25,3,3,CGACCAACCAAAGGTTGCCG,0,1091899
fldAp,0.25,3,3,CGACAAATTAACAAGATCGC,0,1170465
fldAp,0.25,3,3,CGAATTACCCCCCACCAACG,0,1122180
fldAp,0.25,3,3,CGAATACGACAGGACAGCGG,0,1157160
fldAp,0.25,3,3,CGAAGTCATCTAACTTATAG,0,1130737
fldAp,0.25,3,3,CGAAGCCAGTCGCGGCGACT,0,1139238
fldAp,0.25,3,3,CGAACGTCACACATTGTCGT,0,1173235
fldAp,0.25,3,3,CGAACACCCGTTGAGAGTGT,0,1171075
fldAp,0.25,3,3,CGAAACGCGTGATAAAGGGA,0,1086077
fldAp,0.25,3,3,CCTTTGTGACAGTCGTAATA,0,1094311
fldAp,0.25,3,3,CCTTTCAAGAAAACCAGCGC,0,1161124
fldAp,0.25,3,3,CCTTTATAATCACCACGAAA,0,1083224
fldAp,0.25,3,3,CCTTTAAGGGGTGCCTAATC,0,1070234
fldAp,0.25,3,3,CCTTGCAGTAGTAGTAATAT,0,1117656
fldAp,0.25,3,3,CCTTCTTCAGTCTCACAGGC,0,1100326
fldAp,0.25,3,3,CCTTCTAGCAAGGCCAAAAC,0,1076752
fldAp,0.25,3,3,CCTTCGTCAGCCCGATTAGA,0,1149090
fldAp,0.25,3,3,CCTTCAGCTTTTAATAAATG,0,1119536
fldAp,0.25,3,3,CCTTATACACCGCGGCGATG,0,1082184
fldAp,0.25,3,3,CCTTACCGATAACACGTGAA,0,1183184
fldAp,0.25,3,3,CCTTAATGTTCGCTGCTGAG,0,1106275
fldAp,0.25,3,3,CCTTAATCTTGGGACATCAA,0,1101630
fldAp,0.25,3,3,CCTGTGATTGATTAGAACCA,0,1147033
fldAp,0.25,3,3,CCTGGTGTGATGCAAAGCTA,0,1086476
fldAp,0.25,3,3,CCTGGCTTTCGTACACTGAT,0,1182185
fldAp,0.25,3,3,CCTGGCTGCAGGCGGGTACA,0,1116980
fldAp,0.25,3,3,CCTGGAGGAACACAGCTTCC,0,1184631
fldAp,0.25,3,3,CCTGGACAGGAACTTTGTTG,0,1065674
fldAp,0.25,3,3,CCTGCCGAGGGAACCACGGG,0,1118530
fldAp,0.25,3,3,CCTGATTTTTAGACCAAAAT,0,1069620
fldAp,0.25,3,3,CCTGATATGTTATCAATGAT,0,1128912
fldAp,0.25,3,3,CCTCTTAGTCGGGATCTGGA,0,1156717
fldAp,0.25,3,3,CCTCGTCGTCGTCCGGTAAT,0,1126790
fldAp,0.25,3,3,CCTCGTCCGATGCGTCCCAT,0,1169830
fldAp,0.25,3,3,CCTCGGCCGTTACGTCAGCG,0,1161766
fldAp,0.25,3,3,CCTCCTGAGGGATTCCAGTA,0,1103091
fldAp,0.25,3,3,CCTCCCTCAGTAGAGGGGTT,0,1175912
fldAp,0.25,3,3,CCTCCAAAGAGGCTTAGGAG,0,1080883
fldAp,0.25,3,3,CCTCATTAATTGTCTCCCAT,0,1186894
fldAp,0.25,3,3,CCTCAAACATGTAGACGCAG,0,1167261
fldAp,0.25,3,3,CCTATTCTGTACAATGGGCT,0,1075779
fldAp,0.25,3,3,CCTATGCCAAATAGCACTTG,0,1092552
fldAp,0.25,3,3,CCTATATATATCGGCCGGGG,0,1098664
fldAp,0.25,3,3,CCTATACGTTCTCGCATGGT,0,1141069
fldAp,0.25,3,3,CCTAGTGCATGTACAATTTC,0,1119460
fldAp,0.25,3,3,CCTAGTCAGACGTAAGTTAG,0,1071340
fldAp,0.25,3,3,CCTAGCCAGAGCGCCCGCAA,0,1098657
fldAp,0.25,3,3,CCTACTTGGTCGCAACTGAT,0,1101018
fldAp,0.25,3,3,CCTACTGAGTTTCGATAGGT,0,1096549
fldAp,0.25,3,3,CCTACTAGGCCGGCTGCTGA,0,1176021
fldAp,0.25,3,3,CCTACCTTGGGAGATAGAGT,0,1167082
fldAp,0.25,3,3,CCTACCAACTTTGTGGAGGT,0,1139302
fldAp,0.25,3,3,CCTACAGGTGAAATAAAATA,0,1159778
fldAp,0.25,3,3,CCTACAAGGGACCCTGGTGT,0,1114529
fldAp,0.25,3,3,CCTAATATCCCGTCCTATTA,0,1130677
fldAp,0.25,3,3,CCTAAATACCTGTGCTTGGT,0,1105840
fldAp,0.25,3,3,CCTAAACGACCGCCGCCGTA,0,1114506
fldAp,0.25,3,3,CCGTTCCTGGAAGTCGCTTA,0,1130332
fldAp,0.25,3,3,CCGTTCATCTATGTGTACAG,0,1090626
fldAp,0.25,3,3,CCGTGCTCAGGGTTCTCGGT,0,1122941
fldAp,0.25,3,3,CCGTGAGGGCAGGAGGCGGC,0,1096687
fldAp,0.25,3,3,CCGTCGTCGGATTGCGTTGA,0,1149124
fldAp,0.25,3,3,CCGTCCGGTTCTACTCCGCG,0,1152860
fldAp,0.25,3,3,CCGTCCCTTGGGGTCTAATC,0,1152009
fldAp,0.25,3,3,CCGTACGCCTTGTCAATGGT,0,1072990
fldAp,0.25,3,3,CCGTACGAAGGAACGCGCCT,0,1083464
fldAp,0.25,3,3,CCGGTCCGTCGCGGGCCGTT,0,1183302
fldAp,0.25,3,3,CCGGTACAAAAATGAAGTCG,0,1074579
fldAp,0.25,3,3,CCGGGTTTCTCACACTGGTG,0,1171815
fldAp,0.25,3,3,CCGGGCATTGTTGGCCTCAA,0,1065922
fldAp,0.25,3,3,CCGGGATTTTTCTACAGACC,0,1177878
fldAp,0.25,3,3,CCGGGATGCCCGCACACGAT,0,1106708
fldAp,0.25,3,3,CCGGCTCGTAGCGTGAAAGC,0,1101337
fldAp,0.25,3,3,CCGGCATGTTAGAGTGTTGG,0,1138087
fldAp,0.25,3,3,CCGGCAATCCAATCACGGAA,0,1107622
fldAp,0.25,3,3,CCGGATACGCAGTGCGGTCA,0,1149643
fldAp,0.25,3,3,CCGCTTGGGCAGGATCTTGA,0,1068045
fldAp,0.25,3,3,CCGCTGAGGTATGCCCAGAC,0,1096441
fldAp,0.25,3,3,CCGCTCGTGTGGACTAAGGA,0,1173861
fldAp,0.25,3,3,CCGCTAGTAATTAGGGGCAA,0,1091178
fldAp,0.25,3,3,CCGCTAACGCACTTCGTTCA,0,1153528
fldAp,0.25,3,3,CCGCGGACCTTTTACACCCG,0,1102715
fldAp,0.25,3,3,CCGCGATCCGTCCATGGTGT,0,1092708
fldAp,0.25,3,3,CCGCGAAACTAAGTTGATAG,0,1135876
fldAp,0.25,3,3,CCGCCTGTGTTAGAAGAGCG,0,1181839
fldAp,0.25,3,3,CCGCCGAACGGCCAGGGCGA,0,1097785
fldAp,0.25,3,3,CCGCATTTAGGCGGCTGCAA,0,1137431
fldAp,0.25,3,3,CCGCATGGCTAGGAGTAAGA,0,1171847
fldAp,0.25,3,3,CCGCAGCTAGATAAATTGCG,0,1096208
fldAp,0.25,3,3,CCGCACTGGGATGCTTAGTA,0,1111519
fldAp,0.25,3,3,CCGATGAGGTCTTGGTCATT,0,1106373
fldAp,0.25,3,3,CCGATCAGAAGCTCCACTGA,0,1141309
fldAp,0.25,3,3,CCGATACATGATCTTGTAGC,0,1121384
fldAp,0.25,3,3,CCGAGGTCGTTACAAATGTC,0,1141981
fldAp,0.25,3,3,CCGACTCAAGATAGGTAACA,0,1157112
fldAp,0.25,3,3,CCGACATAGCAAGTGTTTCT,0,1080950
fldAp,0.25,3,3,CCGAAATCCAGGGGTAGGTG,0,1125287
fldAp,0.25,3,3,CCCTTTGTAGAACCGGTATC,0,1158960
fldAp,0.25,3,3,CCCTTGACCGATGCGATGAC,0,1138667
fldAp,0.25,3,3,CCCTTGAACACGTCTCTGGG,0,1158784
fldAp,0.25,3,3,CCCTGTATTTCCTAGTGCTC,0,1177463
fldAp,0.25,3,3,CCCTGATTGCAAGGCTACCT,0,1117134
fldAp,0.25,3,3,CCCTCACTGCTACATTGAGT,0,1090447
fldAp,0.25,3,3,CCCTAACGAAGGTGTCAAAA,0,1111758
fldAp,0.25,3,3,CCCTAACCTTGCCGTTTGAT,0,1082399
fldAp,0.25,3,3,CCCGTGTTCACACTTTGTTA,0,1102228
fldAp,0.25,3,3,CCCGTGGGACTTTTCAACTA,0,1117047
fldAp,0.25,3,3,CCCGGTGCGGCCACTCGGTG,0,1096461
fldAp,0.25,3,3,CCCGGCTCGTCAGAATCGCT,0,1077150
fldAp,0.25,3,3,CCCGGCCTGACTCCGGGTTG,0,1093710
fldAp,0.25,3,3,CCCGGCCAATAATGGAGAGT,0,1064327
fldAp,0.25,3,3,CCCGGATTGGTCCTGACTTT,0,1114412
fldAp,0.25,3,3,CCCGGATCCGGGGTAATATT,0,1177511
fldAp,0.25,3,3,CCCGGAGACCACTCGCATTA,0,1105402
fldAp,0.25,3,3,CCCGGACAAGTATGACTGGA,0,1172716
fldAp,0.25,3,3,CCCGGAAGTGGGGGTCAGTA,0,1113408
fldAp,0.25,3,3,CCCGATCGGGGCACGTGGCC,0,1105432
fldAp,0.25,3,3,CCCGACTAAGTAGACATACT,0,1078094
fldAp,0.25,3,3,CCCGACACCCACTCACGGCA,0,1136660
fldAp,0.25,3,3,CCCGAATGGTTGATAGTGAA,0,1146905
fldAp,0.25,3,3,CCCGAATCGCATCGCTGGAA,0,1102342
fldAp,0.25,3,3,CCCCGCGTGACGGGCAGGTT,0,1156843
fldAp,0.25,3,3,CCCCGAGTGGAAGTTGGGAT,0,1069904
fldAp,0.25,3,3,CCCCCGTGGAGAAACCGCGA,0,1063891
fldAp,0.25,3,3,CCCCCGGGCATGTTCAGCGC,0,1137714
fldAp,0.25,3,3,CCCCCGGACTACTCGTGCAA,0,1081938
fldAp,0.25,3,3,CCCCCGCTCGGATTGGCATC,0,1124675
fldAp,0.25,3,3,CCCCCCGGACAAATGACTAC,0,1068287
fldAp,0.25,3,3,CCCCCCGCGCAAACTGCTGG,0,1092276
fldAp,0.25,3,3,CCCCCAGTATGGGGCATGGC,0,1140393
fldAp,0.25,3,3,CCCCAGGCTCTAAAGCACGA,0,1171041
fldAp,0.25,3,3,CCCCAGCATTAAGCTAACGA,0,1119697
fldAp,0.25,3,3,CCCCAGAGGCTGTGCTAGAT,0,1141478
fldAp,0.25,3,3,CCCCAATGGCCTTCACGTTT,0,1080678
fldAp,0.25,3,3,CCCCAATCATGCACTGCAGA,0,1149351
fldAp,0.25,3,3,CCCCAAAGAGAAAGCTGGTT,0,1181830
fldAp,0.25,3,3,CCCAGGGCGCGTGGGAATAG,0,1082401
fldAp,0.25,3,3,CCCAGAGCTACCACTCCTAT,0,1106496
fldAp,0.25,3,3,CCCACTCAGCATCAGTACAA,0,1071236
fldAp,0.25,3,3,CCCAATCGCCGGGATAAGAA,0,1185470
fldAp,0.25,3,3,CCCAACAAGACCCGCATGAC,0,1068364
fldAp,0.25,3,3,CCATTGGTCTCCGGGAGGAA,0,1158946
fldAp,0.25,3,3,CCATTATCCCAATTAGCCTT,0,1107904
fldAp,0.25,3,3,CCATTAGGCTAGATAAGCAT,0,1168226
fldAp,0.25,3,3,CCATGTGTGTTCTGAAGGAA,0,1063401
fldAp,0.25,3,3,CCATGTGCCGCCTGTGGGGG,0,1164595
fldAp,0.25,3,3,CCATGGTGTCAGTATCCGCT,0,1170226
fldAp,0.25,3,3,CCATGGTGCCAGTGTCATCA,0,1176568
fldAp,0.25,3,3,CCATGGGAGCGCATGTTTGA,0,1169231
fldAp,0.25,3,3,CCATGCGGCAACTGAATGAC,0,1169891
fldAp,0.25,3,3,CCATCATAAACGACCACAGG,0,1157802
fldAp,0.25,3,3,CCAGTGAAAGACTTTGCGTA,0,1112508
fldAp,0.25,3,3,CCAGGTGTGGGCCCGACAAG,0,1071179
fldAp,0.25,3,3,CCAGGATAAATGGTGAAGCG,0,1136001
fldAp,0.25,3,3,CCAGGACTCATTGAGTCACG,0,1172277
fldAp,0.25,3,3,CCAGCATGAGCAATGTCTAC,0,1067535
fldAp,0.25,3,3,CCAGCACATGAGACATATCC,0,1080493
fldAp,0.25,3,3,CCAGATGGGACCTTTGATGG,0,1152925
fldAp,0.25,3,3,CCAGAACACGTTTAAGACAT,0,1135591
fldAp,0.25,3,3,CCACTTATAATGGATTATAC,0,1100059
fldAp,0.25,3,3,CCACTGCACTTGGCACGTGT,0,1120753
fldAp,0.25,3,3,CCACGGTGGAACCTTCACAT,0,1175712
fldAp,0.25,3,3,CCACGGGGAAATCAGAAAGG,0,1088932
fldAp,0.25,3,3,CCACGATAAATGCATAGGGG,0,1065145
fldAp,0.25,3,3,CCACGACGACCTCCAACCAC,0,1138850
fldAp,0.25,3,3,CCACCTGGTTCTGTTTAGCA,0,1079308
fldAp,0.25,3,3,CCACCTCCCGCCCTGACACA,0,1065716
fldAp,0.25,3,3,CCACCAAACGCACTCCCTCC,0,1102703
fldAp,0.25,3,3,CCACAGCCGCCACGATACGT,0,1159739
fldAp,0.25,3,3,CCAATGTTCGTCATCAAATC,0,1099153
fldAp,0.25,3,3,CCAATGTCATTCTTTAAGTT,0,1168558
fldAp,0.25,3,3,CCAATCTGTAAATGGGCCGC,0,1117267
fldAp,0.25,3,3,CCAATATTCCCGATAATCGC,0,1160228
fldAp,0.25,3,3,CCAAGTAGTGTATGTTATCC,0,1107551
fldAp,0.25,3,3,CCAAGGACCCGCAAGTGGAC,0,1138817
fldAp,0.25,3,3,CCAAGCTTTTCGGCTAGCCG,0,1143028
fldAp,0.25,3,3,CCAAGACACCATGCACGTGT,0,1135865
fldAp,0.25,3,3,CCAACCAGCAAGGCTCTATC,0,1142057
fldAp,0.25,3,3,CATTTTGTAAGAAGGATCTA,0,1158029
fldAp,0.25,3,3,CATTTTGCATGGCCCCGCGA,0,1075893
fldAp,0.25,3,3,CATTTTAAAGTCATACGAGG,0,1068826
fldAp,0.25,3,3,CATTTCTCAACTAAATGGTA,0,1181795
fldAp,0.25,3,3,CATTTCTACCATACGAGAGA,0,1126439
fldAp,0.25,3,3,CATTTCACTGGTAGTTGCGC,0,1133959
fldAp,0.25,3,3,CATTGTCTAAAAAACAACGT,0,1121354
fldAp,0.25,3,3,CATTGTCCGTTAAGCCAGGC,0,1147581
fldAp,0.25,3,3,CATTGTAAGCTTACGTCCTT,0,1148824
fldAp,0.25,3,3,CATTGGACAGTTAAGGCAGG,0,1120557
fldAp,0.25,3,3,CATTCTGGGACGCGTCAACC,0,1126219
fldAp,0.25,3,3,CATTCTATCTGGGCAAAACT,0,1136708
fldAp,0.25,3,3,CATTCGGTCAGGCGTACGGG,0,1134249
fldAp,0.25,3,3,CATTCGGCACGGTTATCACC,0,1174515
fldAp,0.25,3,3,CATTCACGCATCAAGAGAAA,0,1073135
fldAp,0.25,3,3,CATTCAAGTATAAGCATACT,0,1170279
fldAp,0.25,3,3,CATTATTTTATGTAGTTTTC,0,1142325
fldAp,0.25,3,3,CATTAGAGACGGGTACGAAC,0,1169282
fldAp,0.25,3,3,CATTACTGGCGAAAGCGTTC,0,1176881
fldAp,0.25,3,3,CATTACACCAGCTTTGGATG,0,1113119
fldAp,0.25,3,3,CATGTGCACTCGGTCACGCT,0,1125586
fldAp,0.25,3,3,CATGGTTCTAATCAGGTTAT,0,1185746
fldAp,0.25,3,3,CATGGCCCGGATATTCCGCT,0,1178301
fldAp,0.25,3,3,CATGCTCGTGTCAACCGTGA,0,1106745
fldAp,0.25,3,3,CATGCACCCACTTCGAGACG,0,1141757
fldAp,0.25,3,3,CATGACCGATAGCCATAACC,0,1118691
fldAp,0.25,3,3,CATCTTGAGTCCCGTGATCA,0,1114774
fldAp,0.25,3,3,CATCTGCGGGGCTATACCTC,0,1131005
fldAp,0.25,3,3,CATCGGGCGATTTTCATGAT,0,1146108
fldAp,0.25,3,3,CATCGGAAGTGTCCAGAGGA,0,1117099
fldAp,0.25,3,3,CATCGCAGCTCCTTCGCCTT,0,1118567
fldAp,0.25,3,3,CATCGCACTGGGAAAAGATG,0,1129242
fldAp,0.25,3,3,CATCCGAGCGTTCATTGTCG,0,1128532
fldAp,0.25,3,3,CATCAGTGCGCCTCATACGC,0,1100552
fldAp,0.25,3,3,CATCAACTGAGTTCGGCTCT,0,1097805
fldAp,0.25,3,3,CATCAAATTTTTATAGACAG,0,1070743
fldAp,0.25,3,3,CATATGGGAAGTCTTAGCGG,0,1148655
fldAp,0.25,3,3,CATATAGCGAGGGGACGGGT,0,1154359
fldAp,0.25,3,3,CATAGGGAAGATGTTAAAGG,0,1184208
fldAp,0.25,3,3,CATAGCTAGCCTGATGAGAC,0,1074781
fldAp,0.25,3,3,CATAGCGTGAGGTCATCGTA,0,1180645
fldAp,0.25,3,3,CATACTTCCCACAGGTCGGA,0,1139181
fldAp,0.25,3,3,CATACAGTAATAAGGATCTG,0,1177060
fldAp,0.25,3,3,CATACAGGCTTTTCATCGTG,0,1131322
fldAp,0.25,3,3,CATACACGTCAAACGCTTAT,0,1100903
fldAp,0.25,3,3,CATACACGGGCCGTGTTAGG,0,1094296
fldAp,0.25,3,3,CATACACCTCGATTAGCCTA,0,1134049
fldAp,0.25,3,3,CAGTTTCGATTACAATTGGT,0,1068669
fldAp,0.25,3,3,CAGTTGCCGAATCGTTAAGC,0,1171443
fldAp,0.25,3,3,CAGTGGGATGGGGTGAGCCC,0,1168232
fldAp,0.25,3,3,CAGTGGCTTATTGGCCAACT,0,1074157
fldAp,0.25,3,3,CAGTCAGAAAGGAATACTTA,0,1143210
fldAp,0.25,3,3,CAGTCACTAGGTGCAAAAAG,0,1157039
fldAp,0.25,3,3,CAGTAGGATCTGTCGTAGAA,0,1172305
fldAp,0.25,3,3,CAGTACGTCTACTAAACACA,0,1182839
fldAp,0.25,3,3,CAGTAAGGAAAGCAGGTATA,0,1167378
fldAp,0.25,3,3,CAGGTGCTATGATCCAGTCG,0,1067483
fldAp,0.25,3,3,CAGGTCTACCGGCCTCCGTG,0,1070502
fldAp,0.25,3,3,CAGGTAAAACTCTACAAGCA,0,1066397
fldAp,0.25,3,3,CAGGGAATTATGCGCAATTC,0,1141450
fldAp,0.25,3,3,CAGGCTGCCGACGTGAAGTA,0,1081980
fldAp,0.25,3,3,CAGGCTCAAACGCGTCCAGA,0,1078860
fldAp,0.25,3,3,CAGGCGCTATCCAGAGGGTA,0,1141901
fldAp,0.25,3,3,CAGGCGCGGGAGTACTGTCA,0,1152126
fldAp,0.25,3,3,CAGGAGTACGACTAACTGCG,0,1167993
fldAp,0.25,3,3,CAGGAACGAGGCTCACTAGG,0,1183242
fldAp,0.25,3,3,CAGCGTTGCTAAGTCCCACA,0,1169701
fldAp,0.25,3,3,CAGCGTCCCGGTCTTCCTGC,0,1088614
fldAp,0.25,3,3,CAGCGGGCGATTTGATCTTA,0,1095586
fldAp,0.25,3,3,CAGCGCTCCGAGCAACAGCG,0,1106616
fldAp,0.25,3,3,CAGCCGTAAATCCATCCTGA,0,1068594
fldAp,0.25,3,3,CAGCATATCGTGGCTTTGTA,0,1166049
fldAp,0.25,3,3,CAGCAACCAGGGGCTCAGCC,0,1086763
fldAp,0.25,3,3,CAGATCGCATAAGGTTTCGA,0,1083272
fldAp,0.25,3,3,CAGATCATACGGCGAACATA,0,1168946
fldAp,0.25,3,3,CAGAGGCCAGGACACCTTCC,0,1083031
fldAp,0.25,3,3,CAGAGCGTCGTGGATTCAGT,0,1178023
fldAp,0.25,3,3,CAGACCCCAGTTTCTACCAC,0,1147827
fldAp,0.25,3,3,CAGAACTTCTTAGGCTGAGA,0,1095883
fldAp,0.25,3,3,CAGAACGCCGCCGAGAATAG,0,1171987
fldAp,0.25,3,3,CAGAAAGGACTAGCCCAGAA,0,1138186
fldAp,0.25,3,3,CACTTTGTTTCTCCGACTGC,0,1082393
fldAp,0.25,3,3,CACTTGGGTATTTCTCGATT,0,1093509
fldAp,0.25,3,3,CACTTCTCTTGATGTAAAGG,0,1071713
fldAp,0.25,3,3,CACTGTCGGTCTCCCTCATC,0,1075592
fldAp,0.25,3,3,CACTGGTATCCGGGGACCGC,0,1071389
fldAp,0.25,3,3,CACTGGGAAAATGCAGGTAA,0,1185356
fldAp,0.25,3,3,CACTGCGGTATATACGAGGC,0,1136776
fldAp,0.25,3,3,CACTCGGGCTCTGCCTACGC,0,1139897
fldAp,0.25,3,3,CACTCCAGGCGAGGCGCTGA,0,1117441
fldAp,0.25,3,3,CACGTTTAAGGGTGTGGTCT,0,1149217
fldAp,0.25,3,3,CACGTTGTTCGTATTGCGTT,0,1183241
fldAp,0.25,3,3,CACGTACTGGAGCGGGTTAC,0,1135242
fldAp,0.25,3,3,CACGTACGCGATGCAGGAGT,0,1160301
fldAp,0.25,3,3,CACGGCAGGAGGTTGCTTAG,0,1116698
fldAp,0.25,3,3,CACGCCCTGCTATTGACCCA,0,1165849
fldAp,0.25,3,3,CACGCAGGCGGCCGCGCACT,0,1157375
fldAp,0.25,3,3,CACGATGAAGTTTCCTAGGC,0,1154092
fldAp,0.25,3,3,CACGAGGCGATCTGTCGCCA,0,1155187
fldAp,0.25,3,3,CACGACTTCGAAAAGAGAAC,0,1132520
fldAp,0.25,3,3,CACGAAGGCGTCATCCAGTC,0,1103256
fldAp,0.25,3,3,CACCTGCCCTCCGGCCCCTT,0,1123433
fldAp,0.25,3,3,CACCTATAGGTCGTTGAGGA,0,1090611
fldAp,0.25,3,3,CACCGTTACACAGCTTGGGG,0,1070547
fldAp,0.25,3,3,CACCGTGTTCTGAGAGGGCA,0,1109931
fldAp,0.25,3,3,CACCGTGAGTGCTATATGCA,0,1089225
fldAp,0.25,3,3,CACCGGTATGTTTCGTTCCA,0,1186694
fldAp,0.25,3,3,CACCGGCAGGTGTTTAGTAA,0,1173084
fldAp,0.25,3,3,CACCGGAGATGCGACGCGAT,0,1123577
fldAp,0.25,3,3,CACCGCTCACGACTCGACAG,0,1124441
fldAp,0.25,3,3,CACCGCGCTAAGATTATGTG,0,1091698
fldAp,0.25,3,3,CACCGCACCTGAGCTCAGCG,0,1104644
fldAp,0.25,3,3,CACCGAGCTCTCATGACCGA,0,1074126
fldAp,0.25,3,3,CACCCTTTTTCTTCGCATCA,0,1132891
fldAp,0.25,3,3,CACCCTAGTCAGAACGGAAG,0,1180694
fldAp,0.25,3,3,CACCCATTGCGAATGCATTT,0,1121390
fldAp,0.25,3,3,CACCATACCAGATGGACGCC,0,1175364
fldAp,0.25,3,3,CACCAGCGCCCCCTAGAGTC,0,1175915
fldAp,0.25,3,3,CACCAGCAGTGCACGTGATG,0,1131294
fldAp,0.25,3,3,CACCACCCCCCCGCAGGCGC,0,1105646
fldAp,0.25,3,3,CACAGTGTCTATTCTCGAAG,0,1142788
fldAp,0.25,3,3,CACAGTGAATAGCGCAGCAT,0,1112127
fldAp,0.25,3,3,CACAGTACCCGAGACTAGAC,0,1085760
fldAp,0.25,3,3,CACAGGTTGATTGCAAATTT,0,1075458
fldAp,0.25,3,3,CACAGGGTCGTATCTGCAAA,0,1141409
fldAp,0.25,3,3,CACACTGGTTGTGGTAAGGG,0,1100373
fldAp,0.25,3,3,CACACGCGTCCGTCACATTA,0,1162260
fldAp,0.25,3,3,CACACGATTGGAAGCTTCTG,0,1134701
fldAp,0.25,3,3,CACACCGCGCTTGACATGCT,0,1104909
fldAp,0.25,3,3,CACACAAAGTGTAGAAAGGG,0,1128723
fldAp,0.25,3,3,CACAATAAGACTGGCCGTCC,0,1073436
fldAp,0.25,3,3,CACAAGGCTATTGGAAGGTG,0,1095702
fldAp,0.25,3,3,CACAACTTGTTCGCTCGGCA,0,1082951
fldAp,0.25,3,3,CACAACCCTCTAACATTAAA,0,1095224
fldAp,0.25,3,3,CACAAAAAACTGGGCTAAAG,0,1097830
fldAp,0.25,3,3,CAATTTAGCTAGCTTCAAAT,0,1087840
fldAp,0.25,3,3,CAATTAGAACGGGGCTCTAG,0,1113245
fldAp,0.25,3,3,CAATGCGTGGAGGGATCCAT,0,1185357
fldAp,0.25,3,3,CAATGACGAATAGTGGGGTA,0,1137210
fldAp,0.25,3,3,CAATCTTCTCTAGAGTTGCC,0,1123556
fldAp,0.25,3,3,CAATCTCACGTCTTACCTCG,0,1081226
fldAp,0.25,3,3,CAATCGTCAAGTTCGTGATG,0,1136253
fldAp,0.25,3,3,CAATCCGCTTCGGTCCCGGG,0,1185496
fldAp,0.25,3,3,CAAGTATTCTTTGAAGGAGT,0,1085893
fldAp,0.25,3,3,CAAGTATTCAGTGATGCTCC,0,1147473
fldAp,0.25,3,3,CAAGTAGATTCAAAACGGAG,0,1095375
fldAp,0.25,3,3,CAAGGTTGGGTTTACCATGT,0,1154181
fldAp,0.25,3,3,CAAGGAGTCATATAACGTAA,0,1141269
fldAp,0.25,3,3,CAAGCTTGTTTTTTCATATT,0,1103307
fldAp,0.25,3,3,CAAGCTGTTGGGGTGGGGAT,0,1128015
fldAp,0.25,3,3,CAAGCAGGTAAGGTTTAAAA,0,1186652
fldAp,0.25,3,3,CAAGATTCCACTGAGCGCAT,0,1091714
fldAp,0.25,3,3,CAAGAGCCTTAAGGGCTTAC,0,1142385
fldAp,0.25,3,3,CAACGTGGAATCCTCTAGCT,0,1138651
fldAp,0.25,3,3,CAACGGATCCAAAGAGTATA,0,1096869
fldAp,0.25,3,3,CAACGCTCTTGTCAGTGCCG,0,1183583
fldAp,0.25,3,3,CAACGCTCTAGCTTGGTGGA,0,1184724
fldAp,0.25,3,3,CAACGCCAGATTAATAAACC,0,1103804
fldAp,0.25,3,3,CAACCTTTCGGTGTGTGTGA,0,1067281
fldAp,0.25,3,3,CAACCGCGTCGTAGTGTTGC,0,1150341
fldAp,0.25,3,3,CAACCGATCGCGGGGGTACC,0,1129099
fldAp,0.25,3,3,CAACCACACTCTTCGGGTGA,0,1182844
fldAp,0.25,3,3,CAACATGCGTTTAAATATGT,0,1082417
fldAp,0.25,3,3,CAACATCTCGCAGCGAATAT,0,1066989
fldAp,0.25,3,3,CAACAGCAGGTATAAGGAGC,0,1119216
fldAp,0.25,3,3,CAACACCTCAGGAATAAGCT,0,1128408
fldAp,0.25,3,3,CAAATGTTGAAAGTAGGGGT,0,1126006
fldAp,0.25,3,3,CAAATGGTAGATGTTTCCGG,0,1125373
fldAp,0.25,3,3,CAAATGATGATGGTCACTCG,0,1181147
fldAp,0.25,3,3,CAAAGGGTCTACGATAGAAT,0,1072322
fldAp,0.25,3,3,CAAAGCTGTGTTTGTAAGCA,0,1065777
fldAp,0.25,3,3,CAAAGCCAGATCAGGCTGAA,0,1180158
fldAp,0.25,3,3,CAAAGCCACGTTGAATCGTA,0,1181527
fldAp,0.25,3,3,CAAAGCATGTTTAGTTAATG,0,1125977
fldAp,0.25,3,3,CAAAGACAGGTGGTATCCCA,0,1173990
fldAp,0.25,3,3,CAAACCATGACTCTGTTGGG,0,1087814
fldAp,0.25,3,3,CAAACATATAAAACTGGCGA,0,1093905
fldAp,0.25,3,3,CAAAAGGATCAGGCATACAT,0,1151309
fldAp,0.25,3,3,CAAAAGAGAAATTGACGCTT,0,1102632
fldAp,0.25,3,3,ATTTTGTAGTCACAGTGTGA,0,1094237
fldAp,0.25,3,3,ATTTGCAGAATGTCATGGAC,0,1182449
fldAp,0.25,3,3,ATTTGAGGGCGGTGTCTCCC,0,1109972
fldAp,0.25,3,3,ATTTGACTGGGGGGCGACCC,0,1070039
fldAp,0.25,3,3,ATTTCTGTGTCTTTTTTACA,0,1070645
fldAp,0.25,3,3,ATTTCTAGCGATTGGTGGTT,0,1160758
fldAp,0.25,3,3,ATTTCGTTAGACTAAGATAC,0,1164028
fldAp,0.25,3,3,ATTTCGCCTGATATGCTGGC,0,1104611
fldAp,0.25,3,3,ATTTATGGTTGCTGTGGGCG,0,1146494
fldAp,0.25,3,3,ATTTACCGGAGTCAACACTG,0,1160232
fldAp,0.25,3,3,ATTTAACCGTGGCGACTTGA,0,1120223
fldAp,0.25,3,3,ATTGTGTCCCACCTAAGGTC,0,1095590
fldAp,0.25,3,3,ATTGGTGACCGCTAAGCATG,0,1127052
fldAp,0.25,3,3,ATTGGTAATATTCAGCGTCG,0,1124654
fldAp,0.25,3,3,ATTGGGGACATTAACCATAG,0,1117497
fldAp,0.25,3,3,ATTGCAGGGCTAACGTGTAC,0,1179813
fldAp,0.25,3,3,ATTGCAAAGGGTACAGCCTA,0,1071837
fldAp,0.25,3,3,ATTGATTAAAATTGTCGCTA,0,1150688
fldAp,0.25,3,3,ATTGATCCTAGACTGCGCTA,0,1066146
fldAp,0.25,3,3,ATTCGTTCCAGGGTAAACAG,0,1144774
fldAp,0.25,3,3,ATTCGGTCTCCAAAGGGTAC,0,1165621
fldAp,0.25,3,3,ATTCGAATAGGGGTCGGCTA,0,1143967
fldAp,0.25,3,3,ATTCGAACTAACCAATTGGG,0,1163790
fldAp,0.25,3,3,ATTCCTGCGCCAGTTATTCA,0,1162820
fldAp,0.25,3,3,ATTCACTAAGGATCCGTGTA,0,1141898
fldAp,0.25,3,3,ATTCACGATACACTAGGTCT,0,1125507
fldAp,0.25,3,3,ATTATTGCCCACTGCTTAGG,0,1082206
fldAp,0.25,3,3,ATTATGAACCACGTCGAATA,0,1075767
fldAp,0.25,3,3,ATTATACGCGCGGCACGCTA,0,1145965
fldAp,0.25,3,3,ATTAGTAATCGGTCCTGGCA,0,1068196
fldAp,0.25,3,3,ATTAGGGATTGAGGGATGAC,0,1067183
fldAp,0.25,3,3,ATTAGGAACCGAATAGCAAT,0,1125181
fldAp,0.25,3,3,ATTAATGGCACGTCAGGCAT,0,1105035
fldAp,0.25,3,3,ATTAAGTTCAGTTTAAAGGG,0,1108347
fldAp,0.25,3,3,ATTAAGGGAGTGCATAAGAT,0,1145211
fldAp,0.25,3,3,ATTAAGGCAAAATTTCGGTG,0,1151921
fldAp,0.25,3,3,ATGTTTTGTGTAAGGCTTCC,0,1139821
fldAp,0.25,3,3,ATGTTAGACCTACGGAGGTC,0,1083624
fldAp,0.25,3,3,ATGTGTGTTCAACCACAAAC,0,1161059
fldAp,0.25,3,3,ATGTGTACGGGCGCCATGAG,0,1145433
fldAp,0.25,3,3,ATGTGGTAGGGTTCCTCGTA,0,1065816
fldAp,0.25,3,3,ATGTGAAAACGCTTGCAACG,0,1158325
fldAp,0.25,3,3,ATGTCTAGTTCATCCCTGGT,0,1125590
fldAp,0.25,3,3,ATGTCGTGTTAATGTAATCG,0,1107334
fldAp,0.25,3,3,ATGTCGGATGGGAGTCACTT,0,1064150
fldAp,0.25,3,3,ATGTCAAAGGCCGTACGTCT,0,1069422
fldAp,0.25,3,3,ATGTATGCTGGTCGTGATGG,0,1148087
fldAp,0.25,3,3,ATGTAGGGCGCGTCAGATAA,0,1071692
fldAp,0.25,3,3,ATGGTTTGCAATATTGGACT,0,1076920
fldAp,0.25,3,3,ATGGTTCCCTGATACTCGGG,0,1143033
fldAp,0.25,3,3,ATGGTAGATACCAGTGCCCC,0,1134599
fldAp,0.25,3,3,ATGGGCCTCGCGAGAGCATT,0,1100519
fldAp,0.25,3,3,ATGGCGGGCTGCCGGGAACC,0,1076300
fldAp,0.25,3,3,ATGGCGGCATCGGACCAAAA,0,1101903
fldAp,0.25,3,3,ATGGCGGAGCCTCAGCGCGG,0,1138596
fldAp,0.25,3,3,ATGGCAAGGCGGATATCCTA,0,1120138
fldAp,0.25,3,3,ATGGAATCGGGCCATGGCAA,0,1108175
fldAp,0.25,3,3,ATGGAACATATTCTTTGACC,0,1063867
fldAp,0.25,3,3,ATGCTACTGGGATGCGGACT,0,1184375
fldAp,0.25,3,3,ATGCGTTTTTAGTAGGCTAT,0,1175402
fldAp,0.25,3,3,ATGCCCGCGTAGGCCAGGCA,0,1069197
fldAp,0.25,3,3,ATGCCATTTCTGACACTCGT,0,1182925
fldAp,0.25,3,3,ATGCCACAAGGACGCCTAGG,0,1167633
fldAp,0.25,3,3,ATGCATACGTTTTGGAGGTA,0,1084178
fldAp,0.25,3,3,ATGCAGATAGCAATATCCCA,0,1111749
fldAp,0.25,3,3,ATGCACTCGTTTCATCCAGA,0,1186341
fldAp,0.25,3,3,ATGATCCATGGTCCCCATGT,0,1181397
fldAp,0.25,3,3,ATGACCACCGGCCGGAAATA,0,1133679
fldAp,0.25,3,3,ATGACATGTGGACGTGACTA,0,1185533
fldAp,0.25,3,3,ATGAATTTGATTTGAGGTGA,0,1107703
fldAp,0.25,3,3,ATGAATAAGATATCGACAGG,0,1184608
fldAp,0.25,3,3,ATGAATAAACATGGATTGCA,0,1129946
fldAp,0.25,3,3,ATCTTGGTCCGTTCGCGGAC,0,1143521
fldAp,0.25,3,3,ATCTTAGGAGGAATCGGTCA,0,1068565
fldAp,0.25,3,3,ATCTTAACTTAACGCCAGAC,0,1087430
fldAp,0.25,3,3,ATCTTAACATCAGTAGGAAA,0,1082137
fldAp,0.25,3,3,ATCTCAACGTCACTGCGTGA,0,1095840
fldAp,0.25,3,3,ATCTATAAGCGGCAGCCCTG,0,1099580
fldAp,0.25,3,3,ATCTAGTCGTGAGTCGTTAC,0,1124520
fldAp,0.25,3,3,ATCTACTTTATTGATTAATA,0,1168291
fldAp,0.25,3,3,ATCTACGCCTATTGCAGGTT,0,1178363
fldAp,0.25,3,3,ATCTACATGTTAATTCTTTC,0,1177310
fldAp,0.25,3,3,ATCGTTGTGATATACGTAAT,0,1131767
fldAp,0.25,3,3,ATCGTTGGGGATGTATGGGC,0,1161960
fldAp,0.25,3,3,ATCGTTGGAGTTAGGGTAGA,0,1136092
fldAp,0.25,3,3,ATCGTGGAAAACTCCCGGCC,0,1115769
fldAp,0.25,3,3,ATCGTGCCCAGTTAAGTTCT,0,1150864
fldAp,0.25,3,3,ATCGGTTGCGCCGTAAGCGA,0,1176425
fldAp,0.25,3,3,ATCGGGTGTCCCGGGAGCGG,0,1133254
fldAp,0.25,3,3,ATCGGCGAGGAAGCTAGCTT,0,1139457
fldAp,0.25,3,3,ATCGGCGAAGCTTAGTCCCA,0,1170554
fldAp,0.25,3,3,ATCGCGCTTCCAAAGTAGGC,0,1138849
fldAp,0.25,3,3,ATCGCCTTCTGCACCGGGCT,0,1072183
fldAp,0.25,3,3,ATCGATCGCTCAACTTTGCC,0,1063002
fldAp,0.25,3,3,ATCGAGGACTTGTCACCTGC,0,1135602
fldAp,0.25,3,3,ATCCTCGCAACCCTATGGTC,0,1115839
fldAp,0.25,3,3,ATCCGTACCTCCCTAGGTCC,0,1177989
fldAp,0.25,3,3,ATCCGGTAATCTGTTAGCTA,0,1162199
fldAp,0.25,3,3,ATCCGCCTGCTAATGCGTCT,0,1157119
fldAp,0.25,3,3,ATCCCTTAGTCAAAGTAGAG,0,1079737
fldAp,0.25,3,3,ATCCCGCACGCGCATTGATT,0,1072074
fldAp,0.25,3,3,ATCCAGGCCGGATCGAACTA,0,1099787
fldAp,0.25,3,3,ATCCAGCGAGATAACACCGT,0,1141263
fldAp,0.25,3,3,ATCCAATAGACCACTTACAC,0,1100083
fldAp,0.25,3,3,ATCCAAAATGCTCACGGCGG,0,1071630
fldAp,0.25,3,3,ATCATTATGGGTTATCCTTT,0,1063841
fldAp,0.25,3,3,ATCATCGCTGATGATAAAAT,0,1077927
fldAp,0.25,3,3,ATCAGGGACGCGGTGGCGTA,0,1137853
fldAp,0.25,3,3,ATCACGTCATAGGTGCCACC,0,1091806
fldAp,0.25,3,3,ATCACCGATACATGTGCGGC,0,1105560
fldAp,0.25,3,3,ATCACATCTTGCTTTATATC,0,1064799
fldAp,0.25,3,3,ATCACACTCTCGCTGGCAAT,0,1182381
fldAp,0.25,3,3,ATCAACATCCTTCGCAATGG,0,1130784
fldAp,0.25,3,3,ATATTGTGATCTATCGTCAT,0,1076186
fldAp,0.25,3,3,ATATTAGTGTCCACAATTGT,0,1179134
fldAp,0.25,3,3,ATATGCATGTCGTCCCAAGA,0,1132856
fldAp,0.25,3,3,ATATGATAAGGACCTTGGAG,0,1067450
fldAp,0.25,3,3,ATATGAGTGCGGCTGTAGTC,0,1168265
fldAp,0.25,3,3,ATATCTATCTTACCTAGTAG,0,1078806
fldAp,0.25,3,3,ATATCACGCTCGATCGAGTA,0,1144399
fldAp,0.25,3,3,ATATATTTGGAATTTAATCT,0,1107523
fldAp,0.25,3,3,ATATATGGACTTTTCGATTC,0,1160514
fldAp,0.25,3,3,ATATATCGATTAATGAGTGA,0,1180463
fldAp,0.25,3,3,ATATACCGGTATGGTCGGAA,0,1067144
fldAp,0.25,3,3,ATATAAATTGAGGACTCGGA,0,1102842
fldAp,0.25,3,3,ATAGTGTGGTTTGTGTCGTT,0,1073915
fldAp,0.25,3,3,ATAGTCGCGAGTGTCTGAAA,0,1146759
fldAp,0.25,3,3,ATAGTAGCTGTGCTGAAGAA,0,1088589
fldAp,0.25,3,3,ATAGTAAATAAGCTTGCTCT,0,1157807
fldAp,0.25,3,3,ATAGGTAGGAGTCGCCAAAA,0,1165511
fldAp,0.25,3,3,ATAGGGTGCTGAGCGTCAGG,0,1088862
fldAp,0.25,3,3,ATAGCGCCAAGGTACAGAGG,0,1164779
fldAp,0.25,3,3,ATAGCCGCCAATTTATAAGA,0,1160651
fldAp,0.25,3,3,ATAGAGCGTGAGCAGCGGGT,0,1101136
fldAp,0.25,3,3,ATAGAAGAATAGGTGGCGTG,0,1134954
fldAp,0.25,3,3,ATACTTCCGGTTATATAACA,0,1081915
fldAp,0.25,3,3,ATACTGAGTGCTTTCACGAC,0,1156385
fldAp,0.25,3,3,ATACTCTGGTTGTCCTCAAT,0,1141690
fldAp,0.25,3,3,ATACTCATATTATGGTCTAT,0,1112653
fldAp,0.25,3,3,ATACTCAGTTACCACAGCAA,0,1161128
fldAp,0.25,3,3,ATACTAGACCTCTTAGGTGT,0,1124913
fldAp,0.25,3,3,ATACGTCGTAGCACGCTGGG,0,1076171
fldAp,0.25,3,3,ATACGCTGTTAGTGATCACG,0,1065493
fldAp,0.25,3,3,ATACGCTGACCTTTGTAATA,0,1077341
fldAp,0.25,3,3,ATACGCTATGTATCAGAATA,0,1087188
fldAp,0.25,3,3,ATACGAAGAGATAAAGCGCT,0,1067410
fldAp,0.25,3,3,ATACCCCACGGCCGTGAGAC,0,1089663
fldAp,0.25,3,3,ATACCATGGACGGTCTTTAC,0,1078939
fldAp,0.25,3,3,ATACCAAAGTCGCACGGCGT,0,1069916
fldAp,0.25,3,3,ATACATGGTCCTCGGGGCTA,0,1164603
fldAp,0.25,3,3,ATACAGGGATGCGCCCATGC,0,1083441
fldAp,0.25,3,3,ATAATTGGGTTGTGAAACTT,0,1142823
fldAp,0.25,3,3,ATAATTACAATCGCAATACG,0,1089959
fldAp,0.25,3,3,ATAAGACACATGGAGAATAT,0,1097610
fldAp,0.25,3,3,ATAACCCGTTAATATAAAAC,0,1063051
fldAp,0.25,3,3,ATAACATGTTTCATTTCTAT,0,1105828
fldAp,0.25,3,3,ATAACACTCGGTGGTTTTCC,0,1081228
fldAp,0.25,3,3,ATAAATAGATGCGTATGGAT,0,1181816
fldAp,0.25,3,3,ATAAAGTACGCAGTACCAGC,0,1074970
fldAp,0.25,3,3,ATAAAGGCAAAGCTTCTCGT,0,1142639
fldAp,0.25,3,3,ATAAAGCCCCGTTCAAGCTG,0,1186575
fldAp,0.25,3,3,ATAAACTGCATCACAGGCTT,0,1182160
fldAp,0.25,3,3,AGTTTTGGGCTACATGGCGG,0,1113877
fldAp,0.25,3,3,AGTTTGGACGGTCCAAGTTA,0,1155145
fldAp,0.25,3,3,AGTTTCACCGGAAGGTGGGG,0,1118502
fldAp,0.25,3,3,AGTTGTACCGTACCCAAATC,0,1152800
fldAp,0.25,3,3,AGTTGGTAAGAGAACTTGGG,0,1090037
fldAp,0.25,3,3,AGTTGCTTTGGATGTGCGAG,0,1137697
fldAp,0.25,3,3,AGTTGCCGCAGCGGAGTCTC,0,1146963
fldAp,0.25,3,3,AGTTGACCCACGGCGCATAG,0,1140757
fldAp,0.25,3,3,AGTTCGTTGTTTGGTGTAAG,0,1186516
fldAp,0.25,3,3,AGTTCGGCCCGTAGTTCAGC,0,1087198
fldAp,0.25,3,3,AGTTAGGACGAAAATGGAGA,0,1165475
fldAp,0.25,3,3,AGTTAGCGTGAAAGGTGTGT,0,1095394
fldAp,0.25,3,3,AGTTACCTATTCAAGGGTTA,0,1085917
fldAp,0.25,3,3,AGTGGGTATAGGTATAAGGT,0,1174242
fldAp,0.25,3,3,AGTGGCCATCATGCGTAGGC,0,1106703
fldAp,0.25,3,3,AGTGGAGATGAAAGTCGCGG,0,1184175
fldAp,0.25,3,3,AGTGCTTAGTAGGGATCAGG,0,1124437
fldAp,0.25,3,3,AGTGCTAAGATCCACCTCAG,0,1160671
fldAp,0.25,3,3,AGTGATGACTAACCGATGGG,0,1158964
fldAp,0.25,3,3,AGTGAGGGCAATGATATATG,0,1126649
fldAp,0.25,3,3,AGTGAGGACTTGAAAGACAC,0,1080853
fldAp,0.25,3,3,AGTCCCTCAAGGCCATATTT,0,1167688
fldAp,0.25,3,3,AGTCCCGACCCGAGCGTGAA,0,1181515
fldAp,0.25,3,3,AGTCCAGTTTTTCAGCGTAA,0,1144250
fldAp,0.25,3,3,AGTCATGGCAAGAGATGGGA,0,1098720
fldAp,0.25,3,3,AGTCATATTCCCCGATATCC,0,1115214
fldAp,0.25,3,3,AGTCAAGGACGATCGTCCCA,0,1115475
fldAp,0.25,3,3,AGTATGGTCAGGGGCGACTC,0,1071143
fldAp,0.25,3,3,AGTATCTCGCGGTGTTAAAA,0,1175174
fldAp,0.25,3,3,AGTAGTGATGCTATTCGTTC,0,1183498
fldAp,0.25,3,3,AGTAGGCCATATGAACGGAT,0,1127024
fldAp,0.25,3,3,AGTAGAGACGGTGCAGGGAA,0,1159654
fldAp,0.25,3,3,AGTACTAAAGCGGGTCAAGA,0,1104675
fldAp,0.25,3,3,AGTACGAGAGTTACATAACT,0,1115740
fldAp,0.25,3,3,AGTACCTAGGACACACTTCG,0,1093146
fldAp,0.25,3,3,AGTACCGGGCATGCCTTGCG,0,1168522
fldAp,0.25,3,3,AGTACCAGGATGCGGTGAAA,0,1119931
fldAp,0.25,3,3,AGTACAGATGTAGATGCCCC,0,1166746
fldAp,0.25,3,3,AGTAATCTAGATTGGAGCAG,0,1115892
fldAp,0.25,3,3,AGGTTTTCAATAATCGATGA,0,1173856
fldAp,0.25,3,3,AGGTTTCTCTGCAGAACGAT,0,1077672
fldAp,0.25,3,3,AGGTTCTCTCTTTATGTTCT,0,1101126
fldAp,0.25,3,3,AGGTTCCTGTTTAATCGAGA,0,1162396
fldAp,0.25,3,3,AGGTTCAGCTGTGCTATGGC,0,1084373
fldAp,0.25,3,3,AGGTTATACATTCTTACGAG,0,1164276
fldAp,0.25,3,3,AGGTGCATATGCCGCTACTA,0,1164955
fldAp,0.25,3,3,AGGTGACGCTACCCCTGGTA,0,1138196
fldAp,0.25,3,3,AGGTCCTTTTGTGTTGCAAG,0,1165091
fldAp,0.25,3,3,AGGTCCTGTACTTGCCGCGT,0,1106296
fldAp,0.25,3,3,AGGTCCGGTTCTTGTCATAG,0,1147321
fldAp,0.25,3,3,AGGTCCGCATTCGTCTGGCA,0,1142690
fldAp,0.25,3,3,AGGTACTGAGATGCTCCAGT,0,1180840
fldAp,0.25,3,3,AGGTACGATATTAGGACTAA,0,1115115
fldAp,0.25,3,3,AGGGTTGCTCTCCTGCGCGA,0,1068788
fldAp,0.25,3,3,AGGGTTCTCAGACATGGCTC,0,1121595
fldAp,0.25,3,3,AGGGTGGAAAACGCTAAGGT,0,1120463
fldAp,0.25,3,3,AGGGTCGCATCTACCACAAC,0,1147539
fldAp,0.25,3,3,AGGGTCAACGACCAGTGTCT,0,1153535
fldAp,0.25,3,3,AGGGTAGGGCACTGCCTCCT,0,1168407
fldAp,0.25,3,3,AGGGTACCGCTCACAGTGTA,0,1154900
fldAp,0.25,3,3,AGGGGTGATCCCACACACGT,0,1081309
fldAp,0.25,3,3,AGGGGCATAGCCTGGGTTTT,0,1138782
fldAp,0.25,3,3,AGGGCTTGGGGATTGTCTCA,0,1066457
fldAp,0.25,3,3,AGGGCGTGAGAATGTTTACC,0,1079197
fldAp,0.25,3,3,AGGGATTGATCGTTATTCGC,0,1079712
fldAp,0.25,3,3,AGGGATAAATGCTAAAGTAT,0,1067047
fldAp,0.25,3,3,AGGGAGGGGCTTTTGCTGAG,0,1096997
fldAp,0.25,3,3,AGGGACTACGACTTTGTAAT,0,1105899
fldAp,0.25,3,3,AGGGAAGGGACACATGTAGA,0,1071675
fldAp,0.25,3,3,AGGCTGCAATGCAGGTGGCA,0,1110766
fldAp,0.25,3,3,AGGCGTGATCGTGAGGCTGA,0,1160117
fldAp,0.25,3,3,AGGCGGAAGTTACGGCGGAG,0,1171333
fldAp,0.25,3,3,AGGCGCTCTGTTAGCAGGAA,0,1117898
fldAp,0.25,3,3,AGGCCCCTAGAGGTCGTTAC,0,1064957
fldAp,0.25,3,3,AGGCCCCGGGCGGTGACCAT,0,1124944
fldAp,0.25,3,3,AGGCCCAAGAAGCATGTTAT,0,1077740
fldAp,0.25,3,3,AGGCCAGTAAAACAGGGAGC,0,1185629
fldAp,0.25,3,3,AGGCCACGAGTTCGGGTTAC,0,1081541
fldAp,0.25,3,3,AGGCATTTCTTTGTGTGGGG,0,1116317
fldAp,0.25,3,3,AGGCATGTTACAGTTCTGGC,0,1089517
fldAp,0.25,3,3,AGGATTGACGGGTCCCGCCT,0,1137867
fldAp,0.25,3,3,AGGATTAGTGTCGCTCAGCG,0,1126273
fldAp,0.25,3,3,AGGATGCCGCGGACCTGTTT,0,1116826
fldAp,0.25,3,3,AGGAGTTTCACCCTAGGAGC,0,1140922
fldAp,0.25,3,3,AGGAGTGCGTCGCCCGGGGT,0,1086708
fldAp,0.25,3,3,AGGAGGGAAAGGGAAATATG,0,1112891
fldAp,0.25,3,3,AGGAGCAGTTGATAATTTCA,0,1177476
fldAp,0.25,3,3,AGGACTCACACCTTGGACTT,0,1116422
fldAp,0.25,3,3,AGGACTAGCTAATTCACATT,0,1165338
fldAp,0.25,3,3,AGGACGGTGCCGTTCCATAC,0,1092991
fldAp,0.25,3,3,AGGACGATCCATGGGCATTG,0,1114488
fldAp,0.25,3,3,AGGACACTTGTGTCAACCCC,0,1078790
fldAp,0.25,3,3,AGGAATTATTAGGCTATCTT,0,1143582
fldAp,0.25,3,3,AGGAAGCAGAGATAACTGGC,0,1169325
fldAp,0.25,3,3,AGGAACAAGTCTGGAATTTT,0,1145869
fldAp,0.25,3,3,AGCTTTTGTAGTCCATAACA,0,1171758
fldAp,0.25,3,3,AGCTTGCGGTCTTTGTACCC,0,1076442
fldAp,0.25,3,3,AGCTTGCGGGGCACCTCGGA,0,1124500
fldAp,0.25,3,3,AGCTTACGATATTTGCGAGT,0,1067192
fldAp,0.25,3,3,AGCTGGCGGCAGCGCCTGTC,0,1086790
fldAp,0.25,3,3,AGCTGCTGTCTCATATATGA,0,1172688
fldAp,0.25,3,3,AGCTGCCACCTGGCGGGCAG,0,1118458
fldAp,0.25,3,3,AGCTCTTTGCATGTGTATCC,0,1084309
fldAp,0.25,3,3,AGCTCGAACATCGACGTCCT,0,1165570
fldAp,0.25,3,3,AGCTCATTAGAAAACATGTA,0,1110282
fldAp,0.25,3,3,AGCTATTATCGTGAAACATT,0,1132816
fldAp,0.25,3,3,AGCTACAAATGCCGTGAACA,0,1146003
fldAp,0.25,3,3,AGCGTTAAAGCTAACGGACG,0,1086322
fldAp,0.25,3,3,AGCGTCCTCTGACACCTTTT,0,1178319
fldAp,0.25,3,3,AGCGTCACTTTACGGTCCGC,0,1128904
fldAp,0.25,3,3,AGCGGGTCACGTCTTAATGG,0,1136217
fldAp,0.25,3,3,AGCGGGATCTGGCGCCCTGA,0,1174262
fldAp,0.25,3,3,AGCGGATCTAAATGTATTCC,0,1137334
fldAp,0.25,3,3,AGCGCTGCTGGATCGAGTGT,0,1119604
fldAp,0.25,3,3,AGCGCACGGACTAGCCCCGC,0,1184025
fldAp,0.25,3,3,AGCGAGAGGACACGGGCCGT,0,1111894
fldAp,0.25,3,3,AGCCTTCCAGGTCAACTACG,0,1133955
fldAp,0.25,3,3,AGCCTCCGCAGCTCGGGCCG,0,1090033
fldAp,0.25,3,3,AGCCGTGTTAATAGTTCTGT,0,1126481
fldAp,0.25,3,3,AGCCGTGTCATAGTCTGCGC,0,1135921
fldAp,0.25,3,3,AGCCGGATCGCAAGACCATC,0,1117454
fldAp,0.25,3,3,AGCCGCAGAAGCGGCGTGAA,0,1161311
fldAp,0.25,3,3,AGCCCTCTTTAGGACTGAAT,0,1180091
fldAp,0.25,3,3,AGCCAGGTAAACAGGCGAGC,0,1174509
fldAp,0.25,3,3,AGCCAGATGGCAATTTGCCC,0,1072827
fldAp,0.25,3,3,AGCCAAACCGCATCAGTACA,0,1168617
fldAp,0.25,3,3,AGCAGTGAGATGCGAATCTC,0,1126153
fldAp,0.25,3,3,AGCAGGTGCCCGACGGCGGC,0,1178606
fldAp,0.25,3,3,AGCAGCGAAAATACTCGGGA,0,1126426
fldAp,0.25,3,3,AGCAGAGACAACTAGGGGCG,0,1082119
fldAp,0.25,3,3,AGCACGTAACGACTGAGCGA,0,1165177
fldAp,0.25,3,3,AGCACATCAACGGGGGACTG,0,1130108
fldAp,0.25,3,3,AGCAACTTGGCCTACCGCGG,0,1183987
fldAp,0.25,3,3,AGCAACGCCTCACATGGCAT,0,1068314
fldAp,0.25,3,3,AGCAAAACGCCGGGGGTCAC,0,1170530
fldAp,0.25,3,3,AGATTTCGCCGTGTGAAGGT,0,1184446
fldAp,0.25,3,3,AGATTTAACAGTGGAACGTC,0,1090448
fldAp,0.25,3,3,AGATTGCAAACGAAGCATTG,0,1086780
fldAp,0.25,3,3,AGATTCTGCTCACGTGAATC,0,1095780
fldAp,0.25,3,3,AGATTAGAGTTCCGCAGCCT,0,1144245
fldAp,0.25,3,3,AGATTACGTTAGCTCCGCTT,0,1118181
fldAp,0.25,3,3,AGATTAAAGCAGTATTCTCC,0,1110972
fldAp,0.25,3,3,AGATGTTGTAGGTAGTTCGG,0,1180997
fldAp,0.25,3,3,AGATGCGGCAAGGGGTACCT,0,1068886
fldAp,0.25,3,3,AGATGCCAAAAGTTCCTTGA,0,1107068
fldAp,0.25,3,3,AGATGAACTAAACACGGTTA,0,1083166
fldAp,0.25,3,3,AGATCGATTACTTGCATTAT,0,1089016
fldAp,0.25,3,3,AGATCGACAATGAGAAGTGC,0,1120092
fldAp,0.25,3,3,AGATCCAGCCGGTGTGCGTT,0,1074130
fldAp,0.25,3,3,AGATCATGATTTGCCCTTGT,0,1131143
fldAp,0.25,3,3,AGATCAAACCAGTGGTTGAG,0,1179266
fldAp,0.25,3,3,AGATACAGTAACAGCGTACC,0,1132450
fldAp,0.25,3,3,AGATAACTCCAGGTCTGCTT,0,1112430
fldAp,0.25,3,3,AGAGTTATACAATATTCGCT,0,1154747
fldAp,0.25,3,3,AGAGTCTGCCGTAACGGTTC,0,1114762
fldAp,0.25,3,3,AGAGTCCGGCTGCTGAGCAA,0,1149933
fldAp,0.25,3,3,AGAGTCACTTGCTTGGCCGC,0,1122613
fldAp,0.25,3,3,AGAGGTTAGCTAGTGACACC,0,1168153
fldAp,0.25,3,3,AGAGGGATGGCGGAGCTAAT,0,1122324
fldAp,0.25,3,3,AGAGCTACCGTAACCACTCG,0,1154688
fldAp,0.25,3,3,AGAGAGGGTGCTATCTTGTG,0,1132506
fldAp,0.25,3,3,AGACTGGCAAGTACTGACTT,0,1085292
fldAp,0.25,3,3,AGACTGAGATAACCGTAAAC,0,1106667
fldAp,0.25,3,3,AGACTCAGGTTACACCACGG,0,1154348
fldAp,0.25,3,3,AGACGGAGAAGCACCGCTTT,0,1167229
fldAp,0.25,3,3,AGACGCACCGTAGCGGCCGA,0,1067971
fldAp,0.25,3,3,AGACCCGAGTTCACCCTCAG,0,1104403
fldAp,0.25,3,3,AGACCCATTAGCCAATTAGG,0,1140811
fldAp,0.25,3,3,AGACAAATGTCGTTACAAGG,0,1136677
fldAp,0.25,3,3,AGAATTCACGCGCCCAATAA,0,1120335
fldAp,0.25,3,3,AGAAGTAGGAGCCTATTCAA,0,1085056
fldAp,0.25,3,3,AGAACCCAATTTGATATGGA,0,1160916
fldAp,0.25,3,3,AGAACCAGGCTTGCCAGATG,0,1097539
fldAp,0.25,3,3,AGAACACAAACGGCTACAAG,0,1071814
fldAp,0.25,3,3,AGAAAGCGCCCCATCTCCTA,0,1085817
fldAp,0.25,3,3,ACTTTTCGACGGATCGCCGG,0,1146071
fldAp,0.25,3,3,ACTTTAGGTTTTAGATTAGC,0,1172282
fldAp,0.25,3,3,ACTTGTACTCCGGTAGTGCT,0,1180366
fldAp,0.25,3,3,ACTTGCTCTAAACACGTGCA,0,1148122
fldAp,0.25,3,3,ACTTGCACCACTAATTCTCA,0,1069776
fldAp,0.25,3,3,ACTTCCCTACTGAATACAAT,0,1183321
fldAp,0.25,3,3,ACTTATTTAGAACGGTCGAA,0,1152316
fldAp,0.25,3,3,ACTTATGGCGCATAGTGTGA,0,1173086
fldAp,0.25,3,3,ACTTACTTTGGAGTATGGTC,0,1146026
fldAp,0.25,3,3,ACTTACTGTGGTGTTTGGTT,0,1065822
fldAp,0.25,3,3,ACTGTAGATTACGCACTAAT,0,1081850
fldAp,0.25,3,3,ACTGGTCCGGGCCTTTAGTC,0,1137584
fldAp,0.25,3,3,ACTGGGAAATCCGCGGACAA,0,1146889
fldAp,0.25,3,3,ACTGGACTAGGAAGAACAAG,0,1090262
fldAp,0.25,3,3,ACTGGAAAAGCCACCTTCTC,0,1160662
fldAp,0.25,3,3,ACTGCTTCGCACCAGCACTG,0,1133507
fldAp,0.25,3,3,ACTGCGTTCGTCTCGACAGT,0,1176426
fldAp,0.25,3,3,ACTGCATTATCCAAAATTCT,0,1076102
fldAp,0.25,3,3,ACTGCAGACTAACTATGTGC,0,1063960
fldAp,0.25,3,3,ACTGCAATAGCTCGAGGACA,0,1088542
fldAp,0.25,3,3,ACTGATGGTCGTGGCGATTT,0,1155960
fldAp,0.25,3,3,ACTCTCCGCGTGTCCGTCAA,0,1120696
fldAp,0.25,3,3,ACTCTAAGCATCGATGGCAC,0,1167596
fldAp,0.25,3,3,ACTCGGGGGTTATTTTCTGT,0,1172450
fldAp,0.25,3,3,ACTCGCCGCGATTCTATAAT,0,1169523
fldAp,0.25,3,3,ACTCCGTCAGTAAAGATATC,0,1121382
fldAp,0.25,3,3,ACTCCAACTGAACAAACGTA,0,1113705
fldAp,0.25,3,3,ACTCAGGGTTAAATTTATAT,0,1123834
fldAp,0.25,3,3,ACTCACCATATGCCCAGGCC,0,1118896
fldAp,0.25,3,3,ACTCACATTTACATCTTGGA,0,1120440
fldAp,0.25,3,3,ACTATTCATGCGACGGCACG,0,1070001
fldAp,0.25,3,3,ACTATGCTGCACGAACTTAA,0,1107886
fldAp,0.25,3,3,ACTATATCCTTATTTGGTTA,0,1153602
fldAp,0.25,3,3,ACTATAAGTAATTTTGAGTG,0,1120472
fldAp,0.25,3,3,ACTAGGGTTGTTCAGTGCAG,0,1136715
fldAp,0.25,3,3,ACTAGCTTAGCATACGGCAG,0,1079768
fldAp,0.25,3,3,ACTACGGATCAGGCCCCTAA,0,1164587
fldAp,0.25,3,3,ACTACCCGTCTGTCCTAACT,0,1129958
fldAp,0.25,3,3,ACTACCACGTTCTTCATGAG,0,1128892
fldAp,0.25,3,3,ACTACAAGCAAGATTTGCTC,0,1134151
fldAp,0.25,3,3,ACTAAGATTTGACGAGGTAA,0,1169767
fldAp,0.25,3,3,ACTAACGTTTGGTTTACGGG,0,1186587
fldAp,0.25,3,3,ACTAAACCTGATGTATGGGA,0,1138821
fldAp,0.25,3,3,ACGTTTGCAGCCCATATTTC,0,1152584
fldAp,0.25,3,3,ACGTTTCAGCCACTTCGGGG,0,1088922
fldAp,0.25,3,3,ACGTGGACCAGTACAACCTC,0,1132702
fldAp,0.25,3,3,ACGTCTTTATAATAACCCTC,0,1102327
fldAp,0.25,3,3,ACGTCCATAGCGGTGGGACC,0,1118815
fldAp,0.25,3,3,ACGTATTAGGGGCGTCGTCT,0,1151076
fldAp,0.25,3,3,ACGTAAAGCGGTAAGGTGCC,0,1090803
fldAp,0.25,3,3,ACGGTGGGAAGGATGGTGAA,0,1074701
fldAp,0.25,3,3,ACGGTGGAGGCTTCGATTGA,0,1141105
fldAp,0.25,3,3,ACGGTGCTGTCGTTACATGT,0,1091923
fldAp,0.25,3,3,ACGGTGCTATAAACACCCCG,0,1128743
fldAp,0.25,3,3,ACGGTGAGCGCCGGCGGCTC,0,1080100
fldAp,0.25,3,3,ACGGTATTATCCGTCCCATA,0,1086422
fldAp,0.25,3,3,ACGGGTTGCCCACTGTAGCA,0,1156572
fldAp,0.25,3,3,ACGGGTTCGCCTTACGCGAT,0,1122659
fldAp,0.25,3,3,ACGGGGGCGTGTTGAAAGTA,0,1081937
fldAp,0.25,3,3,ACGGGGCTACCGCGCTTATT,0,1072285
fldAp,0.25,3,3,ACGGGACCGGGCTGCAGGTT,0,1088054
fldAp,0.25,3,3,ACGGCTTAGGACGGTCACAG,0,1162236
fldAp,0.25,3,3,ACGGCGTATTATATTGTAGA,0,1143032
fldAp,0.25,3,3,ACGGCCTGCACCGCGAGCTA,0,1160479
fldAp,0.25,3,3,ACGGCCCTACAAGGGGGGTT,0,1174907
fldAp,0.25,3,3,ACGGCACTGGGCCTGGTCTA,0,1066454
fldAp,0.25,3,3,ACGGAGTGCCAAAGGTTGCC,0,1119338
fldAp,0.25,3,3,ACGGAGGTGCTTGAGGTTGA,0,1159493
fldAp,0.25,3,3,ACGGACGGTCGGAAAAGTCT,0,1064295
fldAp,0.25,3,3,ACGGACCACTTCACTGCACA,0,1075620
fldAp,0.25,3,3,ACGGACAAGTTCTCAACATC,0,1075508
fldAp,0.25,3,3,ACGGAAAGTCAGGGGCCGAC,0,1182745
fldAp,0.25,3,3,ACGCGCGAGTTTCTGTCATG,0,1163902
fldAp,0.25,3,3,ACGCGCCGCGTAGTGGTCTC,0,1157709
fldAp,0.25,3,3,ACGCCGAGCCAGTGCGTTTA,0,1168424
fldAp,0.25,3,3,ACGCCCATAGGTGATATTGG,0,1106010
fldAp,0.25,3,3,ACGCCCAAGTATGGTGAATA,0,1099282
fldAp,0.25,3,3,ACGCATGCCTGAAGCCCCCG,0,1064958
fldAp,0.25,3,3,ACGCATCGGCGCATCGATAG,0,1126973
fldAp,0.25,3,3,ACGCAGTCATGGCTGTATAG,0,1063189
fldAp,0.25,3,3,ACGCAGGAAATAGGACCACC,0,1087776
fldAp,0.25,3,3,ACGCACACGCTATTTGACAT,0,1130040
fldAp,0.25,3,3,ACGCAACGGGAACTTCCATA,0,1125607
fldAp,0.25,3,3,ACGATGTGAATAAGTCAAGA,0,1180567
fldAp,0.25,3,3,ACGATGGGATTCGATAAGTT,0,1066442
fldAp,0.25,3,3,ACGATGGAGGGATCTAAAAT,0,1156028
fldAp,0.25,3,3,ACGATGCTAGGCTCCTGTAA,0,1153732
fldAp,0.25,3,3,ACGATACTGGATACGCAGAA,0,1117139
fldAp,0.25,3,3,ACGAGTACAGCGGTAATGCG,0,1120174
fldAp,0.25,3,3,ACGACAGGTGCGTCAACGTA,0,1072981
fldAp,0.25,3,3,ACGACACATCTGTGTCTCTT,0,1074022
fldAp,0.25,3,3,ACGAATCCGGGTGTACCCCT,0,1088646
fldAp,0.25,3,3,ACGAACTTATACCGTTTCAA,0,1185788
fldAp,0.25,3,3,ACGAACAACCCGTGTCGCTT,0,1134005
fldAp,0.25,3,3,ACGAAAGGAAAGTGCAGTAG,0,1088870
fldAp,0.25,3,3,ACCTTAATACATTCTGTAGT,0,1079934
fldAp,0.25,3,3,ACCTGGTGTCGCCGCAACTT,0,1080286
fldAp,0.25,3,3,ACCTGGGCCTACGGCGGCGT,0,1179054
fldAp,0.25,3,3,ACCTGGCAATGCCCCTTCCA,0,1066929
fldAp,0.25,3,3,ACCTGAGCTGTCTGGGAATA,0,1144820
fldAp,0.25,3,3,ACCTCTATGTTACAGGCTGT,0,1103339
fldAp,0.25,3,3,ACCTCGGTTCCGACCTTGGT,0,1138338
fldAp,0.25,3,3,ACCTCGGTACGTCAGGCGTC,0,1073012
fldAp,0.25,3,3,ACCTACAGGACAAGGGCAGG,0,1105269
fldAp,0.25,3,3,ACCTAATGCGCTGGTCACAT,0,1116714
fldAp,0.25,3,3,ACCGTATTTCTAACGGGGTC,0,1114589
fldAp,0.25,3,3,ACCGCCATTAAAGCTGAATA,0,1096603
fldAp,0.25,3,3,ACCGAGAGCGGCTACTGATT,0,1177793
fldAp,0.25,3,3,ACCCTCACATCGTGTTGAGT,0,1078538
fldAp,0.25,3,3,ACCCTATTCTTGTCTACTGG,0,1102614
fldAp,0.25,3,3,ACCCGTGGACTACGTAAGGC,0,1068480
fldAp,0.25,3,3,ACCCGCGTTTCCTAGATGCC,0,1083088
fldAp,0.25,3,3,ACCCGCCGGGTTGCTCCCTG,0,1110740
fldAp,0.25,3,3,ACCCCGGCGTTTTCCTCAGT,0,1087185
fldAp,0.25,3,3,ACCCCGAGGGGTGTAAGAAA,0,1066471
fldAp,0.25,3,3,ACCCCCTACCCGCGGCCCAT,0,1088911
fldAp,0.25,3,3,ACCCATTTCGGTTTTTGAAA,0,1099730
fldAp,0.25,3,3,ACCCATAGAGCTCCAAGCTG,0,1180244
fldAp,0.25,3,3,ACCCACGGGCACAGACCATA,0,1153425
fldAp,0.25,3,3,ACCCAATTGATACGGGTCGT,0,1117672
fldAp,0.25,3,3,ACCCAACGTCTTGTACCCTT,0,1095155
fldAp,0.25,3,3,ACCCAACGTCTGGTTATCCC,0,1145554
fldAp,0.25,3,3,ACCCAAAGTTCCGCTCTGAC,0,1143382
fldAp,0.25,3,3,ACCATTGGATTCACTTAAAA,0,1107022
fldAp,0.25,3,3,ACCAGTCCCTACGCGCGGTT,0,1087432
fldAp,0.25,3,3,ACCAGCGCATTTCGTACTTC,0,1160315
fldAp,0.25,3,3,ACCAGCCCTATACATGGATG,0,1089436
fldAp,0.25,3,3,ACCAGCAAGTCTAGTTCAGC,0,1065746
fldAp,0.25,3,3,ACCAAACTCGTCGCAATGGC,0,1157320
fldAp,0.25,3,3,ACATTTTGTCCACAATTGAC,0,1169492
fldAp,0.25,3,3,ACATTTTCGATTGTACCTAA,0,1185146
fldAp,0.25,3,3,ACATTTGGACTATTGCGTCA,0,1103889
fldAp,0.25,3,3,ACATTGGTGGGGCCTTACTC,0,1181226
fldAp,0.25,3,3,ACATTGGACCCTATCACCTT,0,1093062
fldAp,0.25,3,3,ACATTGCACTTGTCATGTCC,0,1087774
fldAp,0.25,3,3,ACATTATCCAACCATGGGAA,0,1135502
fldAp,0.25,3,3,ACATGGTAAAGGATATACCG,0,1077014
fldAp,0.25,3,3,ACATGCGTAGCAATAAGTCG,0,1164549
fldAp,0.25,3,3,ACATGCGATATAGGTGGATC,0,1181731
fldAp,0.25,3,3,ACATCTCAAGCTATTCTGGT,0,1150705
fldAp,0.25,3,3,ACATCCCCGCGCGCCCGTTT,0,1146431
fldAp,0.25,3,3,ACATAGTTGGATCGTAACCT,0,1151044
fldAp,0.25,3,3,ACATACAATACTGATGCGTT,0,1148003
fldAp,0.25,3,3,ACATAAAGCAGGCTTGACGA,0,1155570
fldAp,0.25,3,3,ACAGTTTGTTAGCCGTGTCG,0,1079921
fldAp,0.25,3,3,ACAGTTTATGATAGCGGCAC,0,1110674
fldAp,0.25,3,3,ACAGTATATACCTACGTAAG,0,1114594
fldAp,0.25,3,3,ACAGTAGGAGCAGCTGCGCT,0,1100666
fldAp,0.25,3,3,ACAGGTAGGGGCAACGGAAG,0,1096617
fldAp,0.25,3,3,ACAGGGAACCGTAAAACCAC,0,1175391
fldAp,0.25,3,3,ACAGGCTTCAGACATACGTT,0,1185292
fldAp,0.25,3,3,ACAGGCAAGCGACCCAGGGA,0,1106747
fldAp,0.25,3,3,ACAGGATCTATACCCATGTC,0,1133636
fldAp,0.25,3,3,ACAGCTATCGGGAGGACAGA,0,1107192
fldAp,0.25,3,3,ACAGCGGCATCTGCTATCCT,0,1145912
fldAp,0.25,3,3,ACAGCGAATATCAGACAGCC,0,1077893
fldAp,0.25,3,3,ACAGCCGGGAGATGGGATAG,0,1104163
fldAp,0.25,3,3,ACAGATGTTGTGGTCGCAGA,0,1139226
fldAp,0.25,3,3,ACAGATGCGCGCGGAATGCG,0,1166211
fldAp,0.25,3,3,ACAGATATCCGTAATATATG,0,1102012
fldAp,0.25,3,3,ACACTTTAGAGCGATGTCCT,0,1092595
fldAp,0.25,3,3,ACACGGGACCCCTAGTCACG,0,1104199
fldAp,0.25,3,3,ACACGCCTCCCTAGTTTTCA,0,1107282
fldAp,0.25,3,3,ACACGCCGGCCCTCCGACTT,0,1104155
fldAp,0.25,3,3,ACACCGTGGAAAGGGCTATC,0,1073820
fldAp,0.25,3,3,ACACCGACGTACCCAGTGTT,0,1114059
fldAp,0.25,3,3,ACACCCGGGGTGATTGAACG,0,1073995
fldAp,0.25,3,3,ACACAGGACGGCAGGTTCAT,0,1100945
fldAp,0.25,3,3,ACACACGCTCCGAATCTGGA,0,1127295
fldAp,0.25,3,3,ACAATATCAGCCTTAGCTCT,0,1120791
fldAp,0.25,3,3,ACAAGTGAATCCAATCTTTC,0,1158579
fldAp,0.25,3,3,ACAAGGGCATAGTTTAGGTC,0,1089253
fldAp,0.25,3,3,ACAAGGCCACCGCAACTAGC,0,1156564
fldAp,0.25,3,3,ACAAGCTCGACTCCCGTGAC,0,1071917
fldAp,0.25,3,3,ACAACAGAGGGTATGTGGAC,0,1127192
fldAp,0.25,3,3,ACAAAGCGAACAGACGGTTC,0,1157650
fldAp,0.25,3,3,ACAAACCATCGCCTTCGGAT,0,1179245
fldAp,0.25,3,3,AATTTGCCAGGTCAAAACAT,0,1106179
fldAp,0.25,3,3,AATTTGATTCTAGAATCATA,0,1104473
fldAp,0.25,3,3,AATTTGATCGGCTCCTAGAA,0,1156498
fldAp,0.25,3,3,AATTGTAAGGCATCCCCGAC,0,1063171
fldAp,0.25,3,3,AATTGGGGATACAAGAGGCC,0,1136169
fldAp,0.25,3,3,AATTGGATTTATAGAGTTTT,0,1090009
fldAp,0.25,3,3,AATTGATAGAATGATCTGAA,0,1109752
fldAp,0.25,3,3,AATTGAGGTTGGTTGCCGTA,0,1125121
fldAp,0.25,3,3,AATTGAGCTGCTTCACGCCC,0,1078861
fldAp,0.25,3,3,AATTCGTAACCTACTTTGAG,0,1103754
fldAp,0.25,3,3,AATTCGCTAGGTGGACCTAT,0,1146781
fldAp,0.25,3,3,AATTATCATTAAACGAATTC,0,1153451
fldAp,0.25,3,3,AATTACTAGATCGCAACAAG,0,1089593
fldAp,0.25,3,3,AATTAACAAAAGGGGAGAGA,0,1066759
fldAp,0.25,3,3,AATTAAATAAGAGCCAATTC,0,1125045
fldAp,0.25,3,3,AATGTTATGCTATCAGAGGA,0,1153162
fldAp,0.25,3,3,AATGTGGGAGGAGCGGACGC,0,1159070
fldAp,0.25,3,3,AATGTCTTGTAACTGTGTTG,0,1082051
fldAp,0.25,3,3,AATGGGTAGACGTTCCGGTG,0,1116290
fldAp,0.25,3,3,AATGGACGACAGAATTACCG,0,1123693
fldAp,0.25,3,3,AATGGAAAACCGGTCCGGCC,0,1140027
fldAp,0.25,3,3,AATGCTTCGAGTAGCCACAC,0,1182511
fldAp,0.25,3,3,AATGCTATAGCTGTTATATT,0,1141441
fldAp,0.25,3,3,AATGATGAGGTCTGACGAGA,0,1149508
fldAp,0.25,3,3,AATGAGGTGGATGCAAGGTA,0,1179132
fldAp,0.25,3,3,AATGAGGGAACAGGAGGAAA,0,1138491
fldAp,0.25,3,3,AATGAAGCTTTCACTCATAA,0,1138745
fldAp,0.25,3,3,AATCTTAGGCGCCGTTGCCT,0,1105726
fldAp,0.25,3,3,AATCGATGGTGCTTTCTCCT,0,1160618
fldAp,0.25,3,3,AATCCTATCGATATCGTCGC,0,1142337
fldAp,0.25,3,3,AATCCTACGCAAATATCGAC,0,1081214
fldAp,0.25,3,3,AATCCGGGTAGACACCAGCG,0,1105161
fldAp,0.25,3,3,AATCATGACCGGACGCCCAA,0,1088397
fldAp,0.25,3,3,AATCAATAGGGACCATGAAG,0,1107302
fldAp,0.25,3,3,AATCAAGCGGCTAGAATCAT,0,1066115
fldAp,0.25,3,3,AATATTGGTTATTGAATTAC,0,1068766
fldAp,0.25,3,3,AATATGCAATCGAGGAGACG,0,1184336
fldAp,0.25,3,3,AATATGAAAGAGGTGTCACG,0,1089310
fldAp,0.25,3,3,AATAGTTTTCCTGGGTACTT,0,1172167
fldAp,0.25,3,3,AATAGTTCTCGACTGAGACT,0,1177259
fldAp,0.25,3,3,AATAGTCACGTGTTGTCCCT,0,1179654
fldAp,0.25,3,3,AATAGGCAGACGAATTGTGA,0,1169092
fldAp,0.25,3,3,AATAGCTTCAGATCGGATCT,0,1117005
fldAp,0.25,3,3,AATAGAAAAGTTCGAGCAGA,0,1089783
fldAp,0.25,3,3,AATACTTATTCGGCTGCCCC,0,1141529
fldAp,0.25,3,3,AATACGACTAGAAAGTCGTA,0,1119821
fldAp,0.25,3,3,AATACCTCTCGCGGAATTGC,0,1153610
fldAp,0.25,3,3,AATACAAGTTTTAGAGCGTT,0,1111477
fldAp,0.25,3,3,AATAAGTAGGGCTCTCAGTG,0,1108626
fldAp,0.25,3,3,AATAAACTTGTCGTTTTGCT,0,1090889
fldAp,0.25,3,3,AAGTGGAGATCGATACTGCC,0,1068744
fldAp,0.25,3,3,AAGTGATCGCCGCAGTGGTT,0,1074388
fldAp,0.25,3,3,AAGGTTGGGAACACTCGTCT,0,1149468
fldAp,0.25,3,3,AAGGTCACTGGATGAGCACA,0,1140220
fldAp,0.25,3,3,AAGGTCAATAGCTCTGGGGG,0,1169337
fldAp,0.25,3,3,AAGGGGGCACATGAGTGCGA,0,1086650
fldAp,0.25,3,3,AAGGGATAACAGAGTCTCTG,0,1184721
fldAp,0.25,3,3,AAGGCTTTTCCACCTCGTCG,0,1181499
fldAp,0.25,3,3,AAGGCGACTCGGTCATGTGA,0,1143194
fldAp,0.25,3,3,AAGGCATTCAAAAACCGTTA,0,1096630
fldAp,0.25,3,3,AAGGAGGTGCAACCCCATCT,0,1166963
fldAp,0.25,3,3,AAGGACCGAGCATCTCATTC,0,1136971
fldAp,0.25,3,3,AAGGAATCCGTAAGACTGAC,0,1163044
fldAp,0.25,3,3,AAGGAAGTGAATATCGAGGA,0,1135034
fldAp,0.25,3,3,AAGCTGCAGGGGCCCCCTCA,0,1091357
fldAp,0.25,3,3,AAGCGTATAGGGAGCTTCAA,0,1104785
fldAp,0.25,3,3,AAGCGGCCCGCCTGATAGTC,0,1175380
fldAp,0.25,3,3,AAGCGGACGGAACTGTTCCC,0,1161639
fldAp,0.25,3,3,AAGCCAACGTCATGCTCACG,0,1069240
fldAp,0.25,3,3,AAGCACAGGGTTCATGAAAA,0,1072327
fldAp,0.25,3,3,AAGATGTACTCCAGTGCGAA,0,1146509
fldAp,0.25,3,3,AAGATACGCTTTCCACGGTC,0,1112903
fldAp,0.25,3,3,AAGAGGACTCGCCCCACACA,0,1067285
fldAp,0.25,3,3,AAGACTATGACGTTGATCGG,0,1134157
fldAp,0.25,3,3,AAGACGTGCGCGCCGGTGAA,0,1168176
fldAp,0.25,3,3,AAGACATAAAGAACTCGCGC,0,1070511
fldAp,0.25,3,3,AAGAATGGTGATGATTAAGG,0,1116420
fldAp,0.25,3,3,AAGAAGGTAAACACGGAACA,0,1073880
fldAp,0.25,3,3,AAGAACGCTGAAATGATTGA,0,1073828
fldAp,0.25,3,3,AACTTCTAGGACCGGTCTGA,0,1099653
fldAp,0.25,3,3,AACTTCAACCATCTTCTGAC,0,1181001
fldAp,0.25,3,3,AACTCTTCAAGATTCAGCAG,0,1094820
fldAp,0.25,3,3,AACTCCCTCGGGCATTACGA,0,1099440
fldAp,0.25,3,3,AACTATCCCCTCTGGGGCGT,0,1176064
fldAp,0.25,3,3,AACTAGGAGCGTGTTTCTTG,0,1143926
fldAp,0.25,3,3,AACGTTGATATTCCGAACTT,0,1065929
fldAp,0.25,3,3,AACGTACTCCCGGGCAAATC,0,1096908
fldAp,0.25,3,3,AACGGGGCATTAACAGAGTA,0,1073189
fldAp,0.25,3,3,AACGCGATACACTTCACTTG,0,1156447
fldAp,0.25,3,3,AACGCAGCATCCATGGGATA,0,1103544
fldAp,0.25,3,3,AACGCAGATATACGAGGCCA,0,1174177
fldAp,0.25,3,3,AACGATTTCAGGCTGGCCAG,0,1077682
fldAp,0.25,3,3,AACGATAAAGTTTATTGCAA,0,1166842
fldAp,0.25,3,3,AACCTCAACGCAGGATCTGT,0,1179470
fldAp,0.25,3,3,AACCTAAATTGCGACATTCC,0,1125219
fldAp,0.25,3,3,AACCGAAATACGATTTTGGT,0,1167756
fldAp,0.25,3,3,AACCCGCGCTATAAGCGACC,0,1069209
fldAp,0.25,3,3,AACCCCTTTATACCCGAACT,0,1140631
fldAp,0.25,3,3,AACCCCCTTACGTTAGATGG,0,1124180
fldAp,0.25,3,3,AACCACAGACGCTGGAAGGA,0,1131008
fldAp,0.25,3,3,AACCAAGAAGCTGTTTACCG,0,1106782
fldAp,0.25,3,3,AACATTCTACTCGGCGAAAA,0,1083403
fldAp,0.25,3,3,AACAGGTTCTTTTAGGAGGC,0,1119305
fldAp,0.25,3,3,AACACGTAACCGCCCATATC,0,1100210
fldAp,0.25,3,3,AACACGGCCTACACATAGTC,0,1183693
fldAp,0.25,3,3,AACACGGAGTGGACCCGATT,0,1179426
fldAp,0.25,3,3,AACACGCTTAGTATCCTTAG,0,1100711
fldAp,0.25,3,3,AACAATCCACGGAAATTGCC,0,1066136
fldAp,0.25,3,3,AACAAGCTAGGTCCCCTCAT,0,1078469
fldAp,0.25,3,3,AACAACGCTTTCCAGGAATT,0,1085556
fldAp,0.25,3,3,AACAAACGGGTGGATAGCCC,0,1136015
fldAp,0.25,3,3,AAATTTGCATGTGGTATCGA,0,1078077
fldAp,0.25,3,3,AAATTATACGTGAGGTGTGC,0,1161347
fldAp,0.25,3,3,AAATGTATCAGTCTTTTAGA,0,1128791
fldAp,0.25,3,3,AAATGGTTACTGTAGTGTCA,0,1113597
fldAp,0.25,3,3,AAATGCTTATAACCTCGTCT,0,1092757
fldAp,0.25,3,3,AAATGCCCACCTGATGCTCT,0,1124762
fldAp,0.25,3,3,AAATGAAGAAGGGTGGCAAG,0,1072446
fldAp,0.25,3,3,AAATCGCACCGCATTCATCA,0,1136615
fldAp,0.25,3,3,AAATCCCAGCAGGTTCTCGT,0,1121420
fldAp,0.25,3,3,AAAGTTTTCCGGTGACTTGA,0,1160678
fldAp,0.25,3,3,AAAGTGCCGCGTACGACGGG,0,1126060
fldAp,0.25,3,3,AAAGTCAGCAGAACCCACAA,0,1177534
fldAp,0.25,3,3,AAAGGTTAGAGGCAAAAGCG,0,1148617
fldAp,0.25,3,3,AAAGCGTCGGCACGGGCACA,0,1170768
fldAp,0.25,3,3,AAAGCCGTGAATGTAATGGG,0,1179144
fldAp,0.25,3,3,AAAGATTCCTGATCACGCTG,0,1080698
fldAp,0.25,3,3,AAAGATACACAGCCATATGT,0,1107429
fldAp,0.25,3,3,AAAGACTATCCAGGGATGGG,0,1153011
fldAp,0.25,3,3,AAACTCTTTAGACTATACTG,0,1116239
fldAp,0.25,3,3,AAACGGTTGATTCATAATTG,0,1148563
fldAp,0.25,3,3,AAACGCTACAAGAGGGATTA,0,1104444
fldAp,0.25,3,3,AAACGCCGGAGGTCGGAGGG,0,1185940
fldAp,0.25,3,3,AAACGCACCGTGCTTCTCAA,0,1138328
fldAp,0.25,3,3,AAACCTTCGTGCACTGTTGT,0,1068686
fldAp,0.25,3,3,AAACATGTTGAGGGAGACTT,0,1176263
fldAp,0.25,3,3,AAACATGCCGTGAATGTTTG,0,1126616
fldAp,0.25,3,3,AAACACTTCAGATTCCAACA,0,1145882
fldAp,0.25,3,3,AAACACATTTTGTGATCATT,0,1095359
fldAp,0.25,3,3,AAAATGCATCTGTTCCTAAC,0,1078897
fldAp,0.25,3,3,AAAATCTTGCGGGGTAATCC,0,1092515
fldAp,0.25,3,3,AAAAGTTATGGACGCAATTG,0,1118824
fldAp,0.25,3,3,AAAAGTCGGCCCAATACGGT,0,1163663
fldAp,0.25,3,3,AAAAGGGGTAAGGGATCTGG,0,1180601
fldAp,0.25,3,3,AAAAGGCAAATCAACGCGCT,0,1099951
fldAp,0.3333333333333333,2,2,TTTTTGGCCGGTCCTGCCTA,0,1153987
fldAp,0.3333333333333333,2,2,TTTTTGCTTCCGCCGAGTCC,0,1161299
fldAp,0.3333333333333333,2,2,TTTTTGATTAGTAGAATTTA,0,1083274
fldAp,0.3333333333333333,2,2,TTTTTCTGCGTATCAGTCCA,0,1064097
fldAp,0.3333333333333333,2,2,TTTTTATTATGGGTACGGCT,0,1130453
fldAp,0.3333333333333333,2,2,TTTTTATCTAGAGCGCTAGA,0,1180233
fldAp,0.3333333333333333,2,2,TTTTGTTGGCATTTGCAAGG,0,1149274
fldAp,0.3333333333333333,2,2,TTTTGTCATCGTGCGCGTCG,0,1085086
fldAp,0.3333333333333333,2,2,TTTTGGGGGGTTAGGTACGG,0,1155720
fldAp,0.3333333333333333,2,2,TTTTGGAACGGTGGAAAGTA,0,1147242
fldAp,0.3333333333333333,2,2,TTTTGCGACAGCGTCTAATT,0,1101127
fldAp,0.3333333333333333,2,2,TTTTGACTACGCAATGACAT,0,1152313
fldAp,0.3333333333333333,2,2,TTTTGAATATTGTTCAGGCT,0,1170116
fldAp,0.3333333333333333,2,2,TTTTCACCGCGGATGAATAT,0,1089074
fldAp,0.3333333333333333,2,2,TTTTAGGGCTCTTTCTCTCC,0,1073653
fldAp,0.3333333333333333,2,2,TTTTAGGCGTTGTAAATCAC,0,1068500
fldAp,0.3333333333333333,2,2,TTTTAAGGTTCAAGTTCCGT,0,1095221
fldAp,0.3333333333333333,2,2,TTTGTTTGAACCGACTACGG,0,1176268
fldAp,0.3333333333333333,2,2,TTTGTTCAAAAGGGCGTCTA,0,1114687
fldAp,0.3333333333333333,2,2,TTTGTTATGTGGACGGTATC,0,1177268
fldAp,0.3333333333333333,2,2,TTTGTCGGGAGGGTCACATG,0,1087900
fldAp,0.3333333333333333,2,2,TTTGTATCTCCTATCACACT,0,1074800
fldAp,0.3333333333333333,2,2,TTTGGTACGTGCAGTCTCAC,0,1163662
fldAp,0.3333333333333333,2,2,TTTGGCGGATTTTTCTGGCT,0,1077267
fldAp,0.3333333333333333,2,2,TTTGGATTTGGATGCGTAGG,0,1064072
fldAp,0.3333333333333333,2,2,TTTGGAGTCCATTAAGAACG,0,1068376
fldAp,0.3333333333333333,2,2,TTTGGACTTCCGCATGCTGC,0,1165627
fldAp,0.3333333333333333,2,2,TTTGCTCCCATGTGCAATAA,0,1170289
fldAp,0.3333333333333333,2,2,TTTGCGAACAGCCAAATCGT,0,1127126
fldAp,0.3333333333333333,2,2,TTTGAAGCCAAGTGTCACGT,0,1136408
fldAp,0.3333333333333333,2,2,TTTCTGGGGAGCGGTTGTAC,0,1173791
fldAp,0.3333333333333333,2,2,TTTCTGAGCCTGGGTAGGGT,0,1064045
fldAp,0.3333333333333333,2,2,TTTCTAGCTGAGGTGCCGTT,0,1085339
fldAp,0.3333333333333333,2,2,TTTCTAATTGGGCGCATATG,0,1182161
fldAp,0.3333333333333333,2,2,TTTCGCAGAACCAGCCGGTA,0,1072314
fldAp,0.3333333333333333,2,2,TTTCCTCGTGGATCGGATTT,0,1091770
fldAp,0.3333333333333333,2,2,TTTCCGAGACTTCGTATCCT,0,1115326
fldAp,0.3333333333333333,2,2,TTTCCCTCTCTCTTAAACAG,0,1088245
fldAp,0.3333333333333333,2,2,TTTCACGATCGAATGTAACC,0,1151994
fldAp,0.3333333333333333,2,2,TTTATGAGACTTCGCCGCGA,0,1168070
fldAp,0.3333333333333333,2,2,TTTATCGACATCCTAGCACC,0,1109331
fldAp,0.3333333333333333,2,2,TTTATAGCCCTACTAATGAC,0,1153779
fldAp,0.3333333333333333,2,2,TTTAGGTAACGATTCTTCGT,0,1134515
fldAp,0.3333333333333333,2,2,TTTAGCGACATTTTAAAGCG,0,1078252
fldAp,0.3333333333333333,2,2,TTTAGACAGACGCGCTCTCC,0,1131675
fldAp,0.3333333333333333,2,2,TTTACTACGCCGTTAAGCGG,0,1123723
fldAp,0.3333333333333333,2,2,TTTACTAATCGTCAGGATTC,0,1076111
fldAp,0.3333333333333333,2,2,TTTACCGACTCGCCTCATGT,0,1112904
fldAp,0.3333333333333333,2,2,TTTAATTGTTGACTTTCGGA,0,1076754
fldAp,0.3333333333333333,2,2,TTTAATTGATGCTGTTTCTC,0,1181390
fldAp,0.3333333333333333,2,2,TTTAATTCTGGAACACACGT,0,1156594
fldAp,0.3333333333333333,2,2,TTTAAGCGCGCATACGTGAT,0,1075374
fldAp,0.3333333333333333,2,2,TTTAAGCGCAGAGCATGCCC,0,1119476
fldAp,0.3333333333333333,2,2,TTTAACTATGCGACAATGCT,0,1109455
fldAp,0.3333333333333333,2,2,TTGTTCTAATCCTGATTCGA,0,1108328
fldAp,0.3333333333333333,2,2,TTGTTATAGAGAGGGACAAT,0,1091725
fldAp,0.3333333333333333,2,2,TTGTTAAGCTCCAGGGTCCG,0,1122815
fldAp,0.3333333333333333,2,2,TTGTGTGGTCGGGGGACTAC,0,1144770
fldAp,0.3333333333333333,2,2,TTGTGTCCGTTAGACGACAT,0,1081308
fldAp,0.3333333333333333,2,2,TTGTGCCTGGCGCCCCTAAG,0,1117882
fldAp,0.3333333333333333,2,2,TTGTGACGGCGATCGCTGAT,0,1170412
fldAp,0.3333333333333333,2,2,TTGTGAAGATTGGGACTCTC,0,1162106
fldAp,0.3333333333333333,2,2,TTGTGAACCACGCGCGCGGG,0,1148136
fldAp,0.3333333333333333,2,2,TTGTCTTTACCGTAGCAACT,0,1130535
fldAp,0.3333333333333333,2,2,TTGTCTTGTCGTTTAACAAG,0,1160583
fldAp,0.3333333333333333,2,2,TTGTCTTATCATCAGTGTAG,0,1093201
fldAp,0.3333333333333333,2,2,TTGTCACCAGCCATGAATGA,0,1177069
fldAp,0.3333333333333333,2,2,TTGTCAAATCGGCCACAGAA,0,1134097
fldAp,0.3333333333333333,2,2,TTGTATTAGTGGGTTAGAAT,0,1172009
fldAp,0.3333333333333333,2,2,TTGTATGTTATTGGCAGCTT,0,1105779
fldAp,0.3333333333333333,2,2,TTGTATGTCACGGCAACCTA,0,1134195
fldAp,0.3333333333333333,2,2,TTGTATGGTTCCTAGTAATC,0,1117281
fldAp,0.3333333333333333,2,2,TTGTACTCCAGGGCTCAGAT,0,1144773
fldAp,0.3333333333333333,2,2,TTGTACGCTGGGTAGAAAAT,0,1097165
fldAp,0.3333333333333333,2,2,TTGTAATAATGAGAATACAT,0,1153154
fldAp,0.3333333333333333,2,2,TTGTAACCTATGTTAGGCAT,0,1120497
fldAp,0.3333333333333333,2,2,TTGGTGCAGCCTGGGCAACT,0,1178336
fldAp,0.3333333333333333,2,2,TTGGTCTGATCCGTATCATT,0,1149875
fldAp,0.3333333333333333,2,2,TTGGTATTCGCTCGCTGCAA,0,1116862
fldAp,0.3333333333333333,2,2,TTGGGTGGGACATATAGATC,0,1138214
fldAp,0.3333333333333333,2,2,TTGGGTCCTTGCGCGATATT,0,1078686
fldAp,0.3333333333333333,2,2,TTGGGGGTTGAGCGTTCGAG,0,1100937
fldAp,0.3333333333333333,2,2,TTGGGACGTTATCATCCCGT,0,1086917
fldAp,0.3333333333333333,2,2,TTGGGACCCGACGAGTTTCG,0,1080094
fldAp,0.3333333333333333,2,2,TTGGCTCACGTCTGCATCGC,0,1101195
fldAp,0.3333333333333333,2,2,TTGGCGACCTGAGGAACGCA,0,1097924
fldAp,0.3333333333333333,2,2,TTGGATCTCTACTCAGGCAG,0,1126015
fldAp,0.3333333333333333,2,2,TTGCTTCGGATATCGGCTTC,0,1101865
fldAp,0.3333333333333333,2,2,TTGCTCCTTCGTGCGCGGTG,0,1132915
fldAp,0.3333333333333333,2,2,TTGCTAAGGTCACAGGGAAT,0,1124929
fldAp,0.3333333333333333,2,2,TTGCTAAGCCGCGTCGGATT,0,1120145
fldAp,0.3333333333333333,2,2,TTGCGGTTTATTTGCACCCC,0,1186860
fldAp,0.3333333333333333,2,2,TTGCGGTGTTGCCAGAAGTG,0,1066762
fldAp,0.3333333333333333,2,2,TTGCGGAGGCATGTGAAAGG,0,1120952
fldAp,0.3333333333333333,2,2,TTGCGCTCGCCCCCGGTATA,0,1145209
fldAp,0.3333333333333333,2,2,TTGCCGTCCAGTAGATCTCA,0,1139740
fldAp,0.3333333333333333,2,2,TTGCCCCACCCGGCTGTTTG,0,1117777
fldAp,0.3333333333333333,2,2,TTGCATGTATATCCACAGTG,0,1170784
fldAp,0.3333333333333333,2,2,TTGCATGGAAAGATTGGGTT,0,1085189
fldAp,0.3333333333333333,2,2,TTGATCGGCGGGCACTGGTT,0,1129044
fldAp,0.3333333333333333,2,2,TTGATCCATGCGTACAGCAG,0,1159572
fldAp,0.3333333333333333,2,2,TTGAGGGCAGTCCGCAGGGG,0,1111278
fldAp,0.3333333333333333,2,2,TTGAGGGATTTTCGCAAGTC,0,1086950
fldAp,0.3333333333333333,2,2,TTGAGATTCCTATGAAAACG,0,1064927
fldAp,0.3333333333333333,2,2,TTGACGTTACTAAAACGGAA,0,1067699
fldAp,0.3333333333333333,2,2,TTGACGCTTGGTGCGTAAAA,0,1156475
fldAp,0.3333333333333333,2,2,TTGACAAGGGCAACTTTGAG,0,1103237
fldAp,0.3333333333333333,2,2,TTGAAGTTTGTCGCGTATAC,0,1077184
fldAp,0.3333333333333333,2,2,TTGAAGCCTAATCATGAGTA,0,1069026
fldAp,0.3333333333333333,2,2,TTGAAGATGTCCTAGCCTGT,0,1108894
fldAp,0.3333333333333333,2,2,TTGAACAGTTTTACGGGGCG,0,1105405
fldAp,0.3333333333333333,2,2,TTCTTTACAAGCGAACACGG,0,1159254
fldAp,0.3333333333333333,2,2,TTCTGTGAGCTTTCTCGGTC,0,1130121
fldAp,0.3333333333333333,2,2,TTCTGTCAATGTCGGCAGAG,0,1164432
fldAp,0.3333333333333333,2,2,TTCTGGCTTCCCAGCGCCAG,0,1168533
fldAp,0.3333333333333333,2,2,TTCTGCAGTTGACGAATTGG,0,1092114
fldAp,0.3333333333333333,2,2,TTCTATATGTTACATCCTAT,0,1099880
fldAp,0.3333333333333333,2,2,TTCTAACGGCGAATGCTCGT,0,1131310
fldAp,0.3333333333333333,2,2,TTCGTTTCTATCCTGCAATC,0,1157058
fldAp,0.3333333333333333,2,2,TTCGTTCCGGCAGGTGACGT,0,1113032
fldAp,0.3333333333333333,2,2,TTCGTGGACTAGCCTGAGTC,0,1139817
fldAp,0.3333333333333333,2,2,TTCGGGCACCATTAACTGCT,0,1064698
fldAp,0.3333333333333333,2,2,TTCGGCATAGCTTGGCCCGA,0,1121778
fldAp,0.3333333333333333,2,2,TTCGGCAAGCACAAGGCAAG,0,1107222
fldAp,0.3333333333333333,2,2,TTCGGAAGGGATACGTAACG,0,1096612
fldAp,0.3333333333333333,2,2,TTCGCGGGTAGAGGTTAGAC,0,1108639
fldAp,0.3333333333333333,2,2,TTCGATTACAATTTTTCGGC,0,1177916
fldAp,0.3333333333333333,2,2,TTCGAGGAGTAATCTGGCTG,0,1069216
fldAp,0.3333333333333333,2,2,TTCGAAGATTCCGATCAGCG,0,1070398
fldAp,0.3333333333333333,2,2,TTCGAAAGATTCTCGCTAGA,0,1128039
fldAp,0.3333333333333333,2,2,TTCCTTCGAGTATTAGGCCA,0,1171473
fldAp,0.3333333333333333,2,2,TTCCTGTAGATACCACCCAG,0,1105002
fldAp,0.3333333333333333,2,2,TTCCTCTCAAGCGACAGGGT,0,1147507
fldAp,0.3333333333333333,2,2,TTCCGGCCGACTCTAATCTT,0,1073739
fldAp,0.3333333333333333,2,2,TTCCGGAGCGATCTATATTT,0,1073873
fldAp,0.3333333333333333,2,2,TTCCGAGTTGGTTATACGTC,0,1163016
fldAp,0.3333333333333333,2,2,TTCCATGTCAGTCGCCCGCT,0,1171358
fldAp,0.3333333333333333,2,2,TTCATGTTGCTGCGACATAT,0,1140473
fldAp,0.3333333333333333,2,2,TTCATGCATCGGCCAGGCCG,0,1111963
fldAp,0.3333333333333333,2,2,TTCATATCAAGAATATGCGG,0,1160688
fldAp,0.3333333333333333,2,2,TTCAGATCAACTTCGTTCTT,0,1175333
fldAp,0.3333333333333333,2,2,TTCAGAGAAAATCAACAAAC,0,1153703
fldAp,0.3333333333333333,2,2,TTCACGACCTTCAGCTCAAT,0,1065739
fldAp,0.3333333333333333,2,2,TTCACATCCCCGTGGTTTAC,0,1143429
fldAp,0.3333333333333333,2,2,TTCAATACGCACTGTTTCTT,0,1163920
fldAp,0.3333333333333333,2,2,TTCAACGGTACATGTACGAT,0,1126160
fldAp,0.3333333333333333,2,2,TTATTCCATATGGTAGATTC,0,1131364
fldAp,0.3333333333333333,2,2,TTATTCATCAGGTTAGGACT,0,1123232
fldAp,0.3333333333333333,2,2,TTATTATCGTGATCTGTATA,0,1077968
fldAp,0.3333333333333333,2,2,TTATGGACCCTTCATAGGCA,0,1138226
fldAp,0.3333333333333333,2,2,TTATGAGAGGGCCATGTCTT,0,1119051
fldAp,0.3333333333333333,2,2,TTATGAACATGCGCGGTCTG,0,1164618
fldAp,0.3333333333333333,2,2,TTATGAAATCCCAAGGCTAG,0,1100037
fldAp,0.3333333333333333,2,2,TTATCGTGGCTGGCCGGATG,0,1104100
fldAp,0.3333333333333333,2,2,TTATCCAGTACTGATGAACA,0,1134569
fldAp,0.3333333333333333,2,2,TTATCACCTACTGCCCGGGT,0,1148342
fldAp,0.3333333333333333,2,2,TTATACGATCACGACTAACT,0,1148026
fldAp,0.3333333333333333,2,2,TTAGTAGAACAATACTATAA,0,1088109
fldAp,0.3333333333333333,2,2,TTAGTAACACTCCGATCTGG,0,1120717
fldAp,0.3333333333333333,2,2,TTAGGGCTTGGATCACAATT,0,1169122
fldAp,0.3333333333333333,2,2,TTAGGCTGCAACCGCCCATT,0,1065631
fldAp,0.3333333333333333,2,2,TTAGGCGTGGGTACGTTTTC,0,1123557
fldAp,0.3333333333333333,2,2,TTAGCTGTGGAATCATATCT,0,1142869
fldAp,0.3333333333333333,2,2,TTAGCGTCAATTTGCGCGGT,0,1092657
fldAp,0.3333333333333333,2,2,TTAGCCACCCGCACAGGCGA,0,1067756
fldAp,0.3333333333333333,2,2,TTAGCAAATGGGACCGTAGG,0,1128637
fldAp,0.3333333333333333,2,2,TTAGATTTCCGAGTGTCGGT,0,1154626
fldAp,0.3333333333333333,2,2,TTAGACACCGTAAGGTTACT,0,1163354
fldAp,0.3333333333333333,2,2,TTACTTTCGCGTATTGACGG,0,1095585
fldAp,0.3333333333333333,2,2,TTACTCAAGTCGTAGCGTGT,0,1183749
fldAp,0.3333333333333333,2,2,TTACGTTATGGCCATGGCAT,0,1132067
fldAp,0.3333333333333333,2,2,TTACGTGTCTAACGAACTCT,0,1160509
fldAp,0.3333333333333333,2,2,TTACGTGAACTCATCGTCAG,0,1122015
fldAp,0.3333333333333333,2,2,TTACGGTGGACTTATCAATA,0,1117405
fldAp,0.3333333333333333,2,2,TTACGCTGTGCAAACCGAGA,0,1092729
fldAp,0.3333333333333333,2,2,TTACCTAATAGATCACTCTA,0,1149451
fldAp,0.3333333333333333,2,2,TTACCCGCTACTACTAACTC,0,1078999
fldAp,0.3333333333333333,2,2,TTACCCCGTGTGGTTATGAG,0,1120610
fldAp,0.3333333333333333,2,2,TTACAGCGCGTTAGTCCACT,0,1099581
fldAp,0.3333333333333333,2,2,TTACAGCGCAAACCCCGAGA,0,1063297
fldAp,0.3333333333333333,2,2,TTACAGCAAGTTAGGCACAA,0,1101385
fldAp,0.3333333333333333,2,2,TTAATGATATTTACCTTTGA,0,1134449
fldAp,0.3333333333333333,2,2,TTAACCGTGGGGGGGGACAC,0,1118884
fldAp,0.3333333333333333,2,2,TTAACCGGTGGTGATCTCGA,0,1117276
fldAp,0.3333333333333333,2,2,TTAACCAGCTTAACTTACTA,0,1115458
fldAp,0.3333333333333333,2,2,TTAACACCATCACATTTTGA,0,1181746
fldAp,0.3333333333333333,2,2,TTAAAGGTTCACTGTCCGTT,0,1099275
fldAp,0.3333333333333333,2,2,TTAAAGGCGCCATGATAGTG,0,1165644
fldAp,0.3333333333333333,2,2,TTAAAGACAGATTTAGATTG,0,1126431
fldAp,0.3333333333333333,2,2,TTAAACTGCCGGGGAATATT,0,1178453
fldAp,0.3333333333333333,2,2,TTAAACAGTCGTGTCAAGAG,0,1121094
fldAp,0.3333333333333333,2,2,TTAAAATGACCCAAGGGTTT,0,1183736
fldAp,0.3333333333333333,2,2,TTAAAACTAATGTAAATCCT,0,1163867
fldAp,0.3333333333333333,2,2,TGTTTGTCTGTATGGGAGCG,0,1080025
fldAp,0.3333333333333333,2,2,TGTTTACAACGAGCGGGCCG,0,1121701
fldAp,0.3333333333333333,2,2,TGTTGGTAAATTTCTAGTCC,0,1174688
fldAp,0.3333333333333333,2,2,TGTTGGGCATTAACTACACC,0,1137875
fldAp,0.3333333333333333,2,2,TGTTGAAGGTAGCACAGGGA,0,1155721
fldAp,0.3333333333333333,2,2,TGTTCTATCCCCGGGGACAG,0,1074068
fldAp,0.3333333333333333,2,2,TGTTCCCCATAGTAGTTGTA,0,1103792
fldAp,0.3333333333333333,2,2,TGTTCCAAAATTGGAAGCGA,0,1069599
fldAp,0.3333333333333333,2,2,TGTTCAGTTTCGGGTCTTGA,0,1117879
fldAp,0.3333333333333333,2,2,TGTTATTGACCGGTTTCGCG,0,1124334
fldAp,0.3333333333333333,2,2,TGTTATAGGAGCCTGACACT,0,1086346
fldAp,0.3333333333333333,2,2,TGTTATAAGGTTCCCTGCTT,0,1147150
fldAp,0.3333333333333333,2,2,TGTGTCAAGCGGTGGTCCGG,0,1133198
fldAp,0.3333333333333333,2,2,TGTGTAGATCTAAGGGGTGA,0,1180020
fldAp,0.3333333333333333,2,2,TGTGGCTGGGATAGCGCACA,0,1167442
fldAp,0.3333333333333333,2,2,TGTGGCATGCCGGGGATCAG,0,1143133
fldAp,0.3333333333333333,2,2,TGTGCGGCAATGGGGCGCGG,0,1147973
fldAp,0.3333333333333333,2,2,TGTGCGGACTCGCCTGGAGC,0,1172817
fldAp,0.3333333333333333,2,2,TGTGCATTCGCATAGGTTAA,0,1172614
fldAp,0.3333333333333333,2,2,TGTGAGGTACGCTCGTGTAT,0,1093145
fldAp,0.3333333333333333,2,2,TGTGACTCAGTCAGGAACCC,0,1131226
fldAp,0.3333333333333333,2,2,TGTCTAGCGTACAGAACCCA,0,1131307
fldAp,0.3333333333333333,2,2,TGTCTAATCATAAGGAGCCC,0,1121403
fldAp,0.3333333333333333,2,2,TGTCGTGGCAAGAGCGTTAA,0,1117996
fldAp,0.3333333333333333,2,2,TGTCGGGGACTCTAGACAGA,0,1165086
fldAp,0.3333333333333333,2,2,TGTCGGATCGTCTGATCGTG,0,1102716
fldAp,0.3333333333333333,2,2,TGTCGCCACTGACTGGTCCG,0,1168342
fldAp,0.3333333333333333,2,2,TGTCGATACACGGTGCAGTT,0,1180268
fldAp,0.3333333333333333,2,2,TGTCGAAGTAAATATCATGT,0,1071132
fldAp,0.3333333333333333,2,2,TGTCCCTTGATGCTTGATGA,0,1179817
fldAp,0.3333333333333333,2,2,TGTCCCGAGCGTACGCTAGC,0,1161502
fldAp,0.3333333333333333,2,2,TGTCATAGTTCCACATTCAA,0,1107611
fldAp,0.3333333333333333,2,2,TGTCAGGTAGTTGAACATGT,0,1129111
fldAp,0.3333333333333333,2,2,TGTCACCAATATTACCAAAT,0,1089533
fldAp,0.3333333333333333,2,2,TGTCACAGCAGAGAAGGGAG,0,1119413
fldAp,0.3333333333333333,2,2,TGTATGAAAAAGACACTGTA,0,1120304
fldAp,0.3333333333333333,2,2,TGTATCACATATTGCTAACA,0,1186274
fldAp,0.3333333333333333,2,2,TGTATACGATGTACGAAAAT,0,1178324
fldAp,0.3333333333333333,2,2,TGTAGTTCGGGGTAGGCGAA,0,1113416
fldAp,0.3333333333333333,2,2,TGTAGACCTCAAAGGCAGGC,0,1144234
fldAp,0.3333333333333333,2,2,TGTAGACCGGAAGTAGGTAG,0,1101647
fldAp,0.3333333333333333,2,2,TGTACGGGGGTTGGAGTAAA,0,1106307
fldAp,0.3333333333333333,2,2,TGTACAATCCAGCGCTTCGT,0,1103018
fldAp,0.3333333333333333,2,2,TGTACAAAGGATACTGTCGC,0,1066461
fldAp,0.3333333333333333,2,2,TGTAACAATCACGACCTTTG,0,1139046
fldAp,0.3333333333333333,2,2,TGTAAAGTAGGGCGCAGACT,0,1081663
fldAp,0.3333333333333333,2,2,TGGTTTTGCGATACAGTAGC,0,1099623
fldAp,0.3333333333333333,2,2,TGGTTGTGCTGACAAAGTCC,0,1078678
fldAp,0.3333333333333333,2,2,TGGTTAATGCCCCTGAACTT,0,1168817
fldAp,0.3333333333333333,2,2,TGGTGTTCGTTAGGGGTAAC,0,1124166
fldAp,0.3333333333333333,2,2,TGGTGTGACAAGGCATGTGA,0,1167856
fldAp,0.3333333333333333,2,2,TGGTGTCCTCGAGCGATCTA,0,1066311
fldAp,0.3333333333333333,2,2,TGGTGGAACTTAGTTAGTAT,0,1131004
fldAp,0.3333333333333333,2,2,TGGTGCTATCGTCGGAACTA,0,1110940
fldAp,0.3333333333333333,2,2,TGGTGCCTGTGACGACCGGT,0,1115573
fldAp,0.3333333333333333,2,2,TGGTGAGCTTTTGTACGCGG,0,1068600
fldAp,0.3333333333333333,2,2,TGGTCTGATTTGCGCAACAA,0,1157727
fldAp,0.3333333333333333,2,2,TGGTCGTCTGCCGAGGTAAA,0,1185041
fldAp,0.3333333333333333,2,2,TGGTCCGTTCTGCGCAACAG,0,1178669
fldAp,0.3333333333333333,2,2,TGGTCCCACAAAGTCGCGTG,0,1099478
fldAp,0.3333333333333333,2,2,TGGTATTAACGGCTTTTAGA,0,1082192
fldAp,0.3333333333333333,2,2,TGGTATGTATGCACAGTCTA,0,1183177
fldAp,0.3333333333333333,2,2,TGGTACCTAGACGAGAAGTT,0,1155707
fldAp,0.3333333333333333,2,2,TGGTAATCGATTATTACCCT,0,1151586
fldAp,0.3333333333333333,2,2,TGGGTGAGACGCCCATCCGG,0,1178146
fldAp,0.3333333333333333,2,2,TGGGTCTAAAGTCCCCCTTA,0,1082431
fldAp,0.3333333333333333,2,2,TGGGTCCGCTGGTCGGATGT,0,1154636
fldAp,0.3333333333333333,2,2,TGGGTATGCGTAGCGTTTCC,0,1185542
fldAp,0.3333333333333333,2,2,TGGGGTCCGAGTAATTTAGG,0,1154134
fldAp,0.3333333333333333,2,2,TGGGGTAGGCAAGGGCACTG,0,1183017
fldAp,0.3333333333333333,2,2,TGGGGGCGGGGTGGGCTAAA,0,1112206
fldAp,0.3333333333333333,2,2,TGGGGAGTGGGCTCACAATA,0,1087637
fldAp,0.3333333333333333,2,2,TGGGCACGAATAAAGAATTG,0,1114440
fldAp,0.3333333333333333,2,2,TGGGAGTATGTCCAGTGTGA,0,1119075
fldAp,0.3333333333333333,2,2,TGGGACCGCATAATTCGTTC,0,1174674
fldAp,0.3333333333333333,2,2,TGGGACCCACAAGGGCTCTT,0,1135493
fldAp,0.3333333333333333,2,2,TGGGAATTGAGGGTCATTAG,0,1185205
fldAp,0.3333333333333333,2,2,TGGCTTTTCAAAATGTCAGA,0,1074850
fldAp,0.3333333333333333,2,2,TGGCTTGGCCATTGTTCCTA,0,1150237
fldAp,0.3333333333333333,2,2,TGGCTGAGAACCGTGGAGGA,0,1106884
fldAp,0.3333333333333333,2,2,TGGCTCGGCACTGGATATAA,0,1158997
fldAp,0.3333333333333333,2,2,TGGCTCCTCGGTCAGAGAGC,0,1157018
fldAp,0.3333333333333333,2,2,TGGCTCAAAATGTAAACACA,0,1065837
fldAp,0.3333333333333333,2,2,TGGCGGTCGGGTAATTGGAT,0,1101850
fldAp,0.3333333333333333,2,2,TGGCGGCTCCGCGGCGGGAT,0,1160084
fldAp,0.3333333333333333,2,2,TGGCGCAATTAGTGTATCTA,0,1178066
fldAp,0.3333333333333333,2,2,TGGCCCTGTGACCGAACACC,0,1102869
fldAp,0.3333333333333333,2,2,TGGCATGGCAGATTTCGAAA,0,1153224
fldAp,0.3333333333333333,2,2,TGGCATCGTTTTACTGAGGT,0,1135518
fldAp,0.3333333333333333,2,2,TGGATTCCTTAGAGCTGGTC,0,1153688
fldAp,0.3333333333333333,2,2,TGGATCAGCTATACGATCGG,0,1093647
fldAp,0.3333333333333333,2,2,TGGATAGAGTCGTGCCAATT,0,1176077
fldAp,0.3333333333333333,2,2,TGGATACGACCTTGTACGAT,0,1069064
fldAp,0.3333333333333333,2,2,TGGAGTCCTACATATTTCAT,0,1142399
fldAp,0.3333333333333333,2,2,TGGAGGCCCCGCGTGGTGGA,0,1158789
fldAp,0.3333333333333333,2,2,TGGAGGAACTATCGTAGACA,0,1064687
fldAp,0.3333333333333333,2,2,TGGAGAGTCAACGAACCGCT,0,1171779
fldAp,0.3333333333333333,2,2,TGGAGACGTCGTGCTCGGGT,0,1104926
fldAp,0.3333333333333333,2,2,TGGAGAAGTTCGGAGTGACG,0,1111179
fldAp,0.3333333333333333,2,2,TGGACGGTACCTGTCACGCG,0,1148101
fldAp,0.3333333333333333,2,2,TGGACGACACACACTTACGT,0,1114719
fldAp,0.3333333333333333,2,2,TGGACATCGGCATCACGTAT,0,1094788
fldAp,0.3333333333333333,2,2,TGGAATTTGAAGAATACGGG,0,1132876
fldAp,0.3333333333333333,2,2,TGGAAGTCGTAAATGTCGTA,0,1180577
fldAp,0.3333333333333333,2,2,TGGAAGAGGAGGGCTCGCGC,0,1169695
fldAp,0.3333333333333333,2,2,TGGAACGAAATAAAGTGCTG,0,1176065
fldAp,0.3333333333333333,2,2,TGGAACCAGAGGGAGATTGA,0,1096619
fldAp,0.3333333333333333,2,2,TGGAAACTCTCCTACAGTTG,0,1103695
fldAp,0.3333333333333333,2,2,TGCTTTTATCGGCCATTTCA,0,1140985
fldAp,0.3333333333333333,2,2,TGCTTTGGTTATTAGCCCGA,0,1124730
fldAp,0.3333333333333333,2,2,TGCTTTCCGACATCGGATGT,0,1125216
fldAp,0.3333333333333333,2,2,TGCTGTATGTGACTACTGAG,0,1104844
fldAp,0.3333333333333333,2,2,TGCTCTGCATTTGGATTTGA,0,1141621
fldAp,0.3333333333333333,2,2,TGCTCCAGAGTCACTTAGCG,0,1097823
fldAp,0.3333333333333333,2,2,TGCTCCAAAATATGACCAGT,0,1130326
fldAp,0.3333333333333333,2,2,TGCTCATCCGTACGACCTAC,0,1133384
fldAp,0.3333333333333333,2,2,TGCTCAGTGCACGGCAATGA,0,1074472
fldAp,0.3333333333333333,2,2,TGCGTGGGTCAGAATCACAA,0,1112167
fldAp,0.3333333333333333,2,2,TGCGTCCTCGATCATGTCAT,0,1122532
fldAp,0.3333333333333333,2,2,TGCGTATTTATAACCCTATT,0,1093241
fldAp,0.3333333333333333,2,2,TGCGTATTTAGTGGTATCAA,0,1102967
fldAp,0.3333333333333333,2,2,TGCGGTGGAACTTTAAAGGT,0,1158100
fldAp,0.3333333333333333,2,2,TGCGGCTCGAAATGCACAGC,0,1086415
fldAp,0.3333333333333333,2,2,TGCGGCTAGGCGCTAGAATT,0,1127476
fldAp,0.3333333333333333,2,2,TGCGGCACCACTGACATTTT,0,1105798
fldAp,0.3333333333333333,2,2,TGCGCTACATTGAATGGCGG,0,1158887
fldAp,0.3333333333333333,2,2,TGCGCGGCTAGAATTCACTG,0,1123729
fldAp,0.3333333333333333,2,2,TGCGCGCCCACACGACATCT,0,1145670
fldAp,0.3333333333333333,2,2,TGCGCAGTGCTCAAGTGTTG,0,1133110
fldAp,0.3333333333333333,2,2,TGCGCAGCGACTTAATAACC,0,1140544
fldAp,0.3333333333333333,2,2,TGCGATTCCACGTAGCTCCG,0,1095238
fldAp,0.3333333333333333,2,2,TGCCTTTGCAACTGAGTTGA,0,1123773
fldAp,0.3333333333333333,2,2,TGCCTCGGTCAAGACGATGT,0,1136934
fldAp,0.3333333333333333,2,2,TGCCGGTTCTCAACTTCTAA,0,1100653
fldAp,0.3333333333333333,2,2,TGCCGGTGTACACTGTATCA,0,1161919
fldAp,0.3333333333333333,2,2,TGCCGGGCACAGGAGACCTA,0,1086411
fldAp,0.3333333333333333,2,2,TGCCGGAGATGTGGTTGGTC,0,1108808
fldAp,0.3333333333333333,2,2,TGCCCGAGGAACTGACAATT,0,1138223
fldAp,0.3333333333333333,2,2,TGCCCAACTGCAACGGCCTG,0,1108596
fldAp,0.3333333333333333,2,2,TGCCATAGTTAAACAAGAAC,0,1166624
fldAp,0.3333333333333333,2,2,TGCCAGTCTAAGAAGGCAGT,0,1105112
fldAp,0.3333333333333333,2,2,TGCCAAAATTATAATCAGAC,0,1178380
fldAp,0.3333333333333333,2,2,TGCATAGGCAGGTCCCTGGC,0,1105758
fldAp,0.3333333333333333,2,2,TGCACGCGTGACGTCTCCTT,0,1120430
fldAp,0.3333333333333333,2,2,TGCACCTTTGTATAACGGGG,0,1115499
fldAp,0.3333333333333333,2,2,TGCAATTACACAGATCGCAG,0,1149961
fldAp,0.3333333333333333,2,2,TGCAAGTAAGGTTTGACTTC,0,1128878
fldAp,0.3333333333333333,2,2,TGATTTTTAGCTCTCGGAGA,0,1122437
fldAp,0.3333333333333333,2,2,TGATTCGACGCTTTATCGTT,0,1074777
fldAp,0.3333333333333333,2,2,TGATTATCTCGCAATGATGT,0,1102700
fldAp,0.3333333333333333,2,2,TGATTAGGCAACCGTCTCAA,0,1164593
fldAp,0.3333333333333333,2,2,TGATGCTAGACGAGGGAAAA,0,1156289
fldAp,0.3333333333333333,2,2,TGATGCCATGAGGGACCGTT,0,1115479
fldAp,0.3333333333333333,2,2,TGATCCTGCTTGCGTACGAA,0,1125256
fldAp,0.3333333333333333,2,2,TGATCCTATAGGCGGTTACG,0,1131697
fldAp,0.3333333333333333,2,2,TGATCCCTGACATGGACATT,0,1176922
fldAp,0.3333333333333333,2,2,TGATATTTTGGGCTCCAGTC,0,1135977
fldAp,0.3333333333333333,2,2,TGATAGGCTGTTTTGGGCCA,0,1119786
fldAp,0.3333333333333333,2,2,TGAGTGGGGGTGGAGGGAGA,0,1085412
fldAp,0.3333333333333333,2,2,TGAGTGGAGGTATTCCCGAG,0,1111583
fldAp,0.3333333333333333,2,2,TGAGTATGTAATCTTGGAAC,0,1068355
fldAp,0.3333333333333333,2,2,TGAGTAGATCCCCTAGAATG,0,1184210
fldAp,0.3333333333333333,2,2,TGAGTAGAATACCGATCGGG,0,1068158
fldAp,0.3333333333333333,2,2,TGAGGACCGATAGCCTAAAG,0,1082166
fldAp,0.3333333333333333,2,2,TGAGCGGTATCCGGCCTCGA,0,1098338
fldAp,0.3333333333333333,2,2,TGAGCGGCCGAATGATACCA,0,1164027
fldAp,0.3333333333333333,2,2,TGAGATTCCACGGAGCGAAC,0,1067372
fldAp,0.3333333333333333,2,2,TGAGACCCTCCTGATGGAGC,0,1166438
fldAp,0.3333333333333333,2,2,TGAGAAAGCTAACAGCCGCT,0,1106538
fldAp,0.3333333333333333,2,2,TGACTTAGTTCAATGAGTAA,0,1077769
fldAp,0.3333333333333333,2,2,TGACTCTCGGGCGACGTTCT,0,1100579
fldAp,0.3333333333333333,2,2,TGACGTTGCCACGTGCAGGG,0,1111340
fldAp,0.3333333333333333,2,2,TGACGTTCCCGGGGGCACTA,0,1158282
fldAp,0.3333333333333333,2,2,TGACGGTATCGGGAAACAGC,0,1145375
fldAp,0.3333333333333333,2,2,TGACGGACCTCTACCGCATA,0,1174819
fldAp,0.3333333333333333,2,2,TGACGCAGTTCGTGGCTATA,0,1144717
fldAp,0.3333333333333333,2,2,TGACCCTGAATGAGAAGGAA,0,1167978
fldAp,0.3333333333333333,2,2,TGACCCGTTAGGGGGCAGGG,0,1118252
fldAp,0.3333333333333333,2,2,TGACCCATGGATATCAGACC,0,1185700
fldAp,0.3333333333333333,2,2,TGACATCGGGGGGGCGGTCC,0,1132742
fldAp,0.3333333333333333,2,2,TGACATCACGGCAGTTCAGT,0,1127428
fldAp,0.3333333333333333,2,2,TGACATAAGAAGAACATATT,0,1102712
fldAp,0.3333333333333333,2,2,TGACAAAACCGCACTCGCAA,0,1156606
fldAp,0.3333333333333333,2,2,TGAATTGTTGCGTTGCGCGG,0,1178938
fldAp,0.3333333333333333,2,2,TGAAGTTTCGAATATGATCA,0,1130552
fldAp,0.3333333333333333,2,2,TGAAGTTCGCACAGTTTGGT,0,1109532
fldAp,0.3333333333333333,2,2,TGAAGACTCCTGCTTCTTAC,0,1111482
fldAp,0.3333333333333333,2,2,TGAAGACGAAAGCTATTCCG,0,1073539
fldAp,0.3333333333333333,2,2,TGAACCACTCTGACGACAAG,0,1089605
fldAp,0.3333333333333333,2,2,TGAAATGTGCACCCATTTCT,0,1153166
fldAp,0.3333333333333333,2,2,TGAAAGGTCCGATTAAAATT,0,1094318
fldAp,0.3333333333333333,2,2,TGAAACATATATGTCCATTA,0,1131884
fldAp,0.3333333333333333,2,2,TGAAAAAAATTCCCAGCCGT,0,1097991
fldAp,0.3333333333333333,2,2,TCTTTGCCCGCGCCAGGAGC,0,1079300
fldAp,0.3333333333333333,2,2,TCTTTCTAGGCCATTTACCT,0,1158433
fldAp,0.3333333333333333,2,2,TCTTTAGAGGCCACAAACCA,0,1168257
fldAp,0.3333333333333333,2,2,TCTTGGTAGTTGGACATCAA,0,1186788
fldAp,0.3333333333333333,2,2,TCTTGCTAGCTCAAACTTTA,0,1120156
fldAp,0.3333333333333333,2,2,TCTTGCCCAGACGAAATTCA,0,1107550
fldAp,0.3333333333333333,2,2,TCTTGATACAACTGTAATGG,0,1138692
fldAp,0.3333333333333333,2,2,TCTTGAACCGCAGCCACGGA,0,1078089
fldAp,0.3333333333333333,2,2,TCTTCGGACAATCGAGCCAT,0,1092045
fldAp,0.3333333333333333,2,2,TCTTCCCAGGGGTCATGGCT,0,1083768
fldAp,0.3333333333333333,2,2,TCTTAGCCCGTGGGTGGCGC,0,1077641
fldAp,0.3333333333333333,2,2,TCTTACGTAGTCCTGGATGC,0,1175263
fldAp,0.3333333333333333,2,2,TCTTACAGCCCCTCAAGTGA,0,1121817
fldAp,0.3333333333333333,2,2,TCTTAATTCGTGAGCCGATC,0,1139698
fldAp,0.3333333333333333,2,2,TCTGTTTTACAATCCCCCGA,0,1096301
fldAp,0.3333333333333333,2,2,TCTGTGGTATCAAGCCCGGT,0,1064597
fldAp,0.3333333333333333,2,2,TCTGGGTGGCCTGACCGTTT,0,1098860
fldAp,0.3333333333333333,2,2,TCTGGCAACCATCTAGGGAC,0,1068761
fldAp,0.3333333333333333,2,2,TCTGGACTTGGTGGTGCCAG,0,1069716
fldAp,0.3333333333333333,2,2,TCTGGAACAGCCGGCGATGC,0,1161770
fldAp,0.3333333333333333,2,2,TCTGCTAGTTCATCTTACGA,0,1170246
fldAp,0.3333333333333333,2,2,TCTGCTAACAAAAGGGACGG,0,1159522
fldAp,0.3333333333333333,2,2,TCTCTTCTCCGCGTGATAGG,0,1079084
fldAp,0.3333333333333333,2,2,TCTCTGGTGGAATTAATATA,0,1064497
fldAp,0.3333333333333333,2,2,TCTCTATGGGTTATTACAAT,0,1081407
fldAp,0.3333333333333333,2,2,TCTCTATGAAGTGCTCTGCC,0,1109939
fldAp,0.3333333333333333,2,2,TCTCGTCCTAATGGGGAAAA,0,1144999
fldAp,0.3333333333333333,2,2,TCTCGGTTCTTTTATGTTTA,0,1124963
fldAp,0.3333333333333333,2,2,TCTCGAGTGCCACAAAACCA,0,1101123
fldAp,0.3333333333333333,2,2,TCTCCTTTGGATTCGATCAA,0,1134224
fldAp,0.3333333333333333,2,2,TCTCCTCGCACTCACGCCGG,0,1105769
fldAp,0.3333333333333333,2,2,TCTCCTACCAAATAAGGCCC,0,1144869
fldAp,0.3333333333333333,2,2,TCTCCGGTGAGAAGAATGCT,0,1180361
fldAp,0.3333333333333333,2,2,TCTCCATTAAAGGGTACCAT,0,1078931
fldAp,0.3333333333333333,2,2,TCTCCAGGGTAACGGCGGTC,0,1089396
fldAp,0.3333333333333333,2,2,TCTCACGAATCTGGCACAAC,0,1124842
fldAp,0.3333333333333333,2,2,TCTATTCGCGTGTAGGGTAT,0,1118643
fldAp,0.3333333333333333,2,2,TCTATCACGTGGCGAGTCGT,0,1120700
fldAp,0.3333333333333333,2,2,TCTATACCGTACTCGTGGGC,0,1066221
fldAp,0.3333333333333333,2,2,TCTAGTGGCGGGGCTATGGC,0,1103029
fldAp,0.3333333333333333,2,2,TCTACTCTTCTTTTTAAATC,0,1098394
fldAp,0.3333333333333333,2,2,TCTACCGCCGTTTCCTTGTC,0,1174182
fldAp,0.3333333333333333,2,2,TCTAATTCTAATTAAGGATT,0,1129903
fldAp,0.3333333333333333,2,2,TCTAATGCAAATTCACGAGG,0,1132512
fldAp,0.3333333333333333,2,2,TCTAACTTCGTTCTGATCTC,0,1101453
fldAp,0.3333333333333333,2,2,TCGTTTTACATGGACTCAGG,0,1095099
fldAp,0.3333333333333333,2,2,TCGTTGGCGGTATACCCGCG,0,1122099
fldAp,0.3333333333333333,2,2,TCGTTCTTGAGCAGTGTATT,0,1159736
fldAp,0.3333333333333333,2,2,TCGTTCTGTGTACTTGCTAG,0,1106861
fldAp,0.3333333333333333,2,2,TCGTTAAAGTGCGACGGCCA,0,1083563
fldAp,0.3333333333333333,2,2,TCGTGTGTGTGTAAGGCTTG,0,1145015
fldAp,0.3333333333333333,2,2,TCGTGGTAGAGCAATCATCA,0,1069805
fldAp,0.3333333333333333,2,2,TCGTGGACTGGGAATGAGGA,0,1100524
fldAp,0.3333333333333333,2,2,TCGTGACTCAGTTATGTACT,0,1128396
fldAp,0.3333333333333333,2,2,TCGTCGTTTCCACTGCTCTA,0,1108971
fldAp,0.3333333333333333,2,2,TCGTATTTGGTGGAACCGCA,0,1165476
fldAp,0.3333333333333333,2,2,TCGTAAGGGCTCTGTATGGT,0,1111703
fldAp,0.3333333333333333,2,2,TCGGTATACTTATCAATGTT,0,1143204
fldAp,0.3333333333333333,2,2,TCGGGTGTTAGACTAATGTC,0,1147252
fldAp,0.3333333333333333,2,2,TCGGGTGTAACGGAACACGT,0,1151998
fldAp,0.3333333333333333,2,2,TCGGGGTCACGTTAACTCGA,0,1163747
fldAp,0.3333333333333333,2,2,TCGGCATAGTCGGCTCTAAA,0,1090049
fldAp,0.3333333333333333,2,2,TCGGAGTAAGGCTACGGCCT,0,1141236
fldAp,0.3333333333333333,2,2,TCGGAGAGACCATCTACTCA,0,1139981
fldAp,0.3333333333333333,2,2,TCGGAATGCAACGGTGCAGT,0,1176252
fldAp,0.3333333333333333,2,2,TCGCTGTATAACACGGGACT,0,1068958
fldAp,0.3333333333333333,2,2,TCGCTGCGCGGTGGGATTTG,0,1112556
fldAp,0.3333333333333333,2,2,TCGCTCTGGTAGCAATAGTT,0,1182796
fldAp,0.3333333333333333,2,2,TCGCTACCCCCCCTTTCGTT,0,1098478
fldAp,0.3333333333333333,2,2,TCGCGTTGTGAGTCGCGGTT,0,1149909
fldAp,0.3333333333333333,2,2,TCGCGCTGTGTACAGTTCAG,0,1098254
fldAp,0.3333333333333333,2,2,TCGCGCGGGTCAGAAGCCAT,0,1145547
fldAp,0.3333333333333333,2,2,TCGCCTCTAGTTGTTGGCGC,0,1184778
fldAp,0.3333333333333333,2,2,TCGCCGCTGTGGCTATGCGG,0,1065866
fldAp,0.3333333333333333,2,2,TCGCCGCAACATGGTGTGAT,0,1139247
fldAp,0.3333333333333333,2,2,TCGCCAAGTGCACCTTTAAT,0,1067269
fldAp,0.3333333333333333,2,2,TCGCATATAACACCAGGAGA,0,1132806
fldAp,0.3333333333333333,2,2,TCGCACCGCGTTCCGTGATT,0,1082779
fldAp,0.3333333333333333,2,2,TCGCACACCGGCACGGCACC,0,1138104
fldAp,0.3333333333333333,2,2,TCGATTCATGATTTCTTGTA,0,1151829
fldAp,0.3333333333333333,2,2,TCGATGGCTAACAGTCGATG,0,1103827
fldAp,0.3333333333333333,2,2,TCGAGATTCAGGACTGTTAC,0,1148402
fldAp,0.3333333333333333,2,2,TCGACTGCGCCTACCGGGTC,0,1180658
fldAp,0.3333333333333333,2,2,TCGACTATCGACCTAGCTGG,0,1138034
fldAp,0.3333333333333333,2,2,TCGACGGGGAAATTAAGATC,0,1172873
fldAp,0.3333333333333333,2,2,TCGACCCGATTTTCAACAAA,0,1133184
fldAp,0.3333333333333333,2,2,TCGACAGAAGGAATACCGAG,0,1068595
fldAp,0.3333333333333333,2,2,TCGAATCAACTAGGCGGGAT,0,1114079
fldAp,0.3333333333333333,2,2,TCGAACGAAGCCCAATTCTA,0,1134744
fldAp,0.3333333333333333,2,2,TCGAACATAGCATCGAGACG,0,1095993
fldAp,0.3333333333333333,2,2,TCCTTGGGGTAACCGTTTCA,0,1181004
fldAp,0.3333333333333333,2,2,TCCTTCAAGGCTCTGCACGT,0,1113330
fldAp,0.3333333333333333,2,2,TCCTGTTCGCCGTGGCATCT,0,1161655
fldAp,0.3333333333333333,2,2,TCCTCTTCTTAGTAACAGCT,0,1111986
fldAp,0.3333333333333333,2,2,TCCTCTGTGGAGGTCAGAAA,0,1164703
fldAp,0.3333333333333333,2,2,TCCTAGAAGGACCTGTGCAA,0,1100763
fldAp,0.3333333333333333,2,2,TCCTACGGATGAGTCGTACT,0,1166792
fldAp,0.3333333333333333,2,2,TCCTAATAAGGCTATGGTGA,0,1169179
fldAp,0.3333333333333333,2,2,TCCGTGGCGCCAACAGAGAT,0,1172180
fldAp,0.3333333333333333,2,2,TCCGTCTAGCCGGAGGCCGT,0,1165834
fldAp,0.3333333333333333,2,2,TCCGTACAACCTCAAATGAG,0,1178227
fldAp,0.3333333333333333,2,2,TCCGGGAGTGTTAGCCGACT,0,1080079
fldAp,0.3333333333333333,2,2,TCCGGCCATACTACCAGTGA,0,1166635
fldAp,0.3333333333333333,2,2,TCCGCAGCCACCTATCGTAT,0,1117872
fldAp,0.3333333333333333,2,2,TCCCTTCATTTCGCGGTCTC,0,1157854
fldAp,0.3333333333333333,2,2,TCCCTTCACATGTGGGAGTC,0,1137947
fldAp,0.3333333333333333,2,2,TCCCTAAACAGGCTCAACAA,0,1106921
fldAp,0.3333333333333333,2,2,TCCCGGGAAGACTCCTCGAA,0,1076367
fldAp,0.3333333333333333,2,2,TCCCGAATTAGGCTCTGGGA,0,1087169
fldAp,0.3333333333333333,2,2,TCCCCGCAAGTGTGAGAGGG,0,1093700
fldAp,0.3333333333333333,2,2,TCCCCCAGATTTTGTCCGTA,0,1064836
fldAp,0.3333333333333333,2,2,TCCCCACCTGGTTTCGGTTT,0,1066098
fldAp,0.3333333333333333,2,2,TCCCAATCCTCAGAAAGTTA,0,1079612
fldAp,0.3333333333333333,2,2,TCCATGCATAGGGAGAATTG,0,1083517
fldAp,0.3333333333333333,2,2,TCCATCCAGGAGGGACTGAT,0,1092815
fldAp,0.3333333333333333,2,2,TCCAGTACGTAACCGATATT,0,1067768
fldAp,0.3333333333333333,2,2,TCCACGCTGCTCAGTCACAA,0,1066406
fldAp,0.3333333333333333,2,2,TCCACCGTGGGAGAATCGTG,0,1099825
fldAp,0.3333333333333333,2,2,TCCACAAGCGGGGTCCGAAG,0,1164108
fldAp,0.3333333333333333,2,2,TCATTTTGCAACCCGTGTTT,0,1066230
fldAp,0.3333333333333333,2,2,TCATTTGTTCTTAACTACCC,0,1068232
fldAp,0.3333333333333333,2,2,TCATTGATCGACGGCACTGG,0,1080862
fldAp,0.3333333333333333,2,2,TCATTCTAGTATGAATACAC,0,1179506
fldAp,0.3333333333333333,2,2,TCATTCGAATTGATAATCAC,0,1158423
fldAp,0.3333333333333333,2,2,TCATGGCATCCCAGACGAAA,0,1066179
fldAp,0.3333333333333333,2,2,TCATCTATACAAGAAGCTAC,0,1172181
fldAp,0.3333333333333333,2,2,TCATCTAGACCGAAGGCGTG,0,1080860
fldAp,0.3333333333333333,2,2,TCATCAGGGCCTGGGGGTGA,0,1125568
fldAp,0.3333333333333333,2,2,TCATATCATCTTTGGCCTGA,0,1118049
fldAp,0.3333333333333333,2,2,TCATAGACCACTACGACATT,0,1150227
fldAp,0.3333333333333333,2,2,TCATAATTACAACGTCCGCT,0,1148209
fldAp,0.3333333333333333,2,2,TCAGTTCGAGGCGAATGACT,0,1097903
fldAp,0.3333333333333333,2,2,TCAGTCCGAGGTCATGTTTA,0,1108005
fldAp,0.3333333333333333,2,2,TCAGTATGTTCTAGCGGGTG,0,1074542
fldAp,0.3333333333333333,2,2,TCAGTAAGACTCCCGCTATA,0,1070018
fldAp,0.3333333333333333,2,2,TCAGGTGTTGTTACTGCGCT,0,1096256
fldAp,0.3333333333333333,2,2,TCAGGGGGCTCCCCAGACGG,0,1162497
fldAp,0.3333333333333333,2,2,TCAGGGCAAAAGAGATGTTC,0,1099563
fldAp,0.3333333333333333,2,2,TCAGGCCATAAAGTGTGCCA,0,1147708
fldAp,0.3333333333333333,2,2,TCAGGAGCTAGGACCCACAA,0,1066104
fldAp,0.3333333333333333,2,2,TCAGCTGTCCAAGACCCTTG,0,1129654
fldAp,0.3333333333333333,2,2,TCAGCTGCCTTTCCGACCCA,0,1140160
fldAp,0.3333333333333333,2,2,TCAGCATAGAGATGTCTAAT,0,1070922
fldAp,0.3333333333333333,2,2,TCAGCAGGTCATTTAGATTT,0,1107132
fldAp,0.3333333333333333,2,2,TCAGCACGTTTCATATGAAT,0,1150747
fldAp,0.3333333333333333,2,2,TCAGCAACAAATTCTATTTC,0,1181246
fldAp,0.3333333333333333,2,2,TCAGATCTCTACCCAAAACC,0,1131538
fldAp,0.3333333333333333,2,2,TCAGAGGTCCAGTCTTCAGC,0,1065938
fldAp,0.3333333333333333,2,2,TCAGAATGGGTTGGCGTTTC,0,1066447
fldAp,0.3333333333333333,2,2,TCAGAAGCATACAAATAAGT,0,1138690
fldAp,0.3333333333333333,2,2,TCACTACTGCTGCAAGGCGA,0,1082444
fldAp,0.3333333333333333,2,2,TCACGTTACAGGCGTCGGCT,0,1074460
fldAp,0.3333333333333333,2,2,TCACGTGTACGGAATAGCCA,0,1114391
fldAp,0.3333333333333333,2,2,TCACGTGTAAATTCCGGGAT,0,1102988
fldAp,0.3333333333333333,2,2,TCACGTGCGATATGAATTGG,0,1138363
fldAp,0.3333333333333333,2,2,TCACGCCCTTAGTCGGCGAA,0,1167525
fldAp,0.3333333333333333,2,2,TCACGAGCAGATAGTGTATG,0,1129982
fldAp,0.3333333333333333,2,2,TCACGACTATTGTCGGCGGG,0,1151897
fldAp,0.3333333333333333,2,2,TCACCGTTGCCGTTTGGCCA,0,1131020
fldAp,0.3333333333333333,2,2,TCACCGGATCGTTGTCAGTG,0,1112712
fldAp,0.3333333333333333,2,2,TCACCCTGCTTTTTAACAGA,0,1104159
fldAp,0.3333333333333333,2,2,TCACCCCCACGCTAACCGGT,0,1110141
fldAp,0.3333333333333333,2,2,TCACACGAGAGGTCGATCAG,0,1133869
fldAp,0.3333333333333333,2,2,TCACAAGTTTAGCCGTGCAG,0,1090470
fldAp,0.3333333333333333,2,2,TCACAACTTAGAAAGAGCGC,0,1091572
fldAp,0.3333333333333333,2,2,TCACAACACCGAGGTTCGCT,0,1177468
fldAp,0.3333333333333333,2,2,TCAATTTGTACCTAGGTCAG,0,1081747
fldAp,0.3333333333333333,2,2,TCAATTCTTGGGCCTTGACA,0,1114358
fldAp,0.3333333333333333,2,2,TCAATTCGATTATAGAGGGC,0,1110919
fldAp,0.3333333333333333,2,2,TCAATCGATATTGCGGGCAA,0,1118891
fldAp,0.3333333333333333,2,2,TCAAGCTTCTCAATAAGCTG,0,1069058
fldAp,0.3333333333333333,2,2,TCAAGCTCCATTAAGTCTGC,0,1161428
fldAp,0.3333333333333333,2,2,TCAACTACTACTAAAGTAGT,0,1148791
fldAp,0.3333333333333333,2,2,TCAAAATCGCATGCCTAGAA,0,1098748
fldAp,0.3333333333333333,2,2,TCAAAACAGACCCCTGAGGA,0,1179814
fldAp,0.3333333333333333,2,2,TATTTTTGGGTATTCCATTA,0,1158001
fldAp,0.3333333333333333,2,2,TATTTTGCTTCGGCCTAGGG,0,1168288
fldAp,0.3333333333333333,2,2,TATTTGGTGGCGGGCTTTCC,0,1159307
fldAp,0.3333333333333333,2,2,TATTTCGGGTACGCGTCTAA,0,1182783
fldAp,0.3333333333333333,2,2,TATTGCATTGGTATTGTTAT,0,1079107
fldAp,0.3333333333333333,2,2,TATTCGGTGGATACAAACTC,0,1141153
fldAp,0.3333333333333333,2,2,TATTCGGCGTTTCCCTGCCA,0,1075984
fldAp,0.3333333333333333,2,2,TATTCGGCCGGGTGGGGCCT,0,1105188
fldAp,0.3333333333333333,2,2,TATTCGCCGGCCACATAATC,0,1182305
fldAp,0.3333333333333333,2,2,TATTCGCCGGAGATCGAAAA,0,1111895
fldAp,0.3333333333333333,2,2,TATTATGGCCATCGAGATCA,0,1094452
fldAp,0.3333333333333333,2,2,TATTATCTCCGACGATAACT,0,1121846
fldAp,0.3333333333333333,2,2,TATTAGGCCAGGGCCTTACT,0,1185585
fldAp,0.3333333333333333,2,2,TATTAGCTCGGCTTCATATG,0,1156395
fldAp,0.3333333333333333,2,2,TATTAAGGCGTACCGGCTTT,0,1170662
fldAp,0.3333333333333333,2,2,TATGTACGGGCAAGCCACTA,0,1158779
fldAp,0.3333333333333333,2,2,TATGTAAGTCATAGGAGTCC,0,1168363
fldAp,0.3333333333333333,2,2,TATGGCGTGGAACACACGTC,0,1082437
fldAp,0.3333333333333333,2,2,TATGGAGGGAGGACAGTACT,0,1173228
fldAp,0.3333333333333333,2,2,TATGCGTACCGTAACGCCAG,0,1098790
fldAp,0.3333333333333333,2,2,TATCTTTGTTGAATGCGATC,0,1101654
fldAp,0.3333333333333333,2,2,TATCTTTATTCTTCACGACC,0,1070413
fldAp,0.3333333333333333,2,2,TATCTTAAGGAAGAAATTGA,0,1083099
fldAp,0.3333333333333333,2,2,TATCGATCTGCGGCCCTACG,0,1101164
fldAp,0.3333333333333333,2,2,TATCGAGTTGGTCCAATCAC,0,1146598
fldAp,0.3333333333333333,2,2,TATCGAGGCATAGACCGTTG,0,1150252
fldAp,0.3333333333333333,2,2,TATCCTGCGCTTAACTGGTT,0,1161504
fldAp,0.3333333333333333,2,2,TATCAGTTCTCCAGTAAAAA,0,1065240
fldAp,0.3333333333333333,2,2,TATATTAACCGAGACCACCA,0,1113455
fldAp,0.3333333333333333,2,2,TATATGGGGGTCTTATATCG,0,1150163
fldAp,0.3333333333333333,2,2,TATATGAACATCAAGGCCAA,0,1174906
fldAp,0.3333333333333333,2,2,TATAGTTCGCCTATGTGCGG,0,1140313
fldAp,0.3333333333333333,2,2,TATAATTGCCTGACTAGGAG,0,1175706
fldAp,0.3333333333333333,2,2,TATAATCAGAGGCAACTCAT,0,1139220
fldAp,0.3333333333333333,2,2,TATAAGGAATGGTATGGAAC,0,1151702
fldAp,0.3333333333333333,2,2,TATAAGCCTATATTGTAGGT,0,1095669
fldAp,0.3333333333333333,2,2,TATAACCGGATAATAGACCA,0,1159275
fldAp,0.3333333333333333,2,2,TAGTTAATTATCTAAGCATC,0,1079523
fldAp,0.3333333333333333,2,2,TAGGTGCCTCACTCTGCCCA,0,1080167
fldAp,0.3333333333333333,2,2,TAGGTCATACTCCAAGAATT,0,1166183
fldAp,0.3333333333333333,2,2,TAGGGTGCGAGGTGTCTCGT,0,1148582
fldAp,0.3333333333333333,2,2,TAGGGGAGTCTGGCTTACTC,0,1137955
fldAp,0.3333333333333333,2,2,TAGGGATACGCACAGTTGTA,0,1114518
fldAp,0.3333333333333333,2,2,TAGGCTTAGCCGATGCGGTT,0,1131448
fldAp,0.3333333333333333,2,2,TAGGCGGGCGGCTTTGGCGA,0,1086360
fldAp,0.3333333333333333,2,2,TAGGCCTAGGCACATCTAGG,0,1102337
fldAp,0.3333333333333333,2,2,TAGGCCTACATCGTCGCGCT,0,1152973
fldAp,0.3333333333333333,2,2,TAGGAGCGAGAATGCTAAGG,0,1165772
fldAp,0.3333333333333333,2,2,TAGGACTTCCACGCAGAGAC,0,1151371
fldAp,0.3333333333333333,2,2,TAGGACCTCGCGGGAAATTC,0,1126914
fldAp,0.3333333333333333,2,2,TAGGACCGCGAGGGCGTTGA,0,1116403
fldAp,0.3333333333333333,2,2,TAGGACATTTCGGAGTACGA,0,1115309
fldAp,0.3333333333333333,2,2,TAGGAACAAAGTGTTCCGGG,0,1075983
fldAp,0.3333333333333333,2,2,TAGCTGGCGTGTCCCACTAG,0,1084406
fldAp,0.3333333333333333,2,2,TAGCTCGATAGGGTGAGCGC,0,1086068
fldAp,0.3333333333333333,2,2,TAGCTATGACTGCGTCCAAG,0,1122838
fldAp,0.3333333333333333,2,2,TAGCTAGGGAGCAACGCCGG,0,1164258
fldAp,0.3333333333333333,2,2,TAGCTAACATCAATTGGGTT,0,1182295
fldAp,0.3333333333333333,2,2,TAGCGTTTTGTAGTTTAAAT,0,1068771
fldAp,0.3333333333333333,2,2,TAGCGCTCACCCTGCGCGTT,0,1071970
fldAp,0.3333333333333333,2,2,TAGCCTACCTTATCTTTCTG,0,1068556
fldAp,0.3333333333333333,2,2,TAGCATTGTCATTGGGGGGT,0,1087619
fldAp,0.3333333333333333,2,2,TAGATCGTATAGGGGCAGTA,0,1116071
fldAp,0.3333333333333333,2,2,TAGATCGCATAGGCCCCTGT,0,1071852
fldAp,0.3333333333333333,2,2,TAGATCAGGTGATTCCATGT,0,1090565
fldAp,0.3333333333333333,2,2,TAGATACGTTCATTTGCAGC,0,1145516
fldAp,0.3333333333333333,2,2,TAGATACATCGGGGGAGATA,0,1084337
fldAp,0.3333333333333333,2,2,TAGATAACATTCACTGACAC,0,1092011
fldAp,0.3333333333333333,2,2,TAGAGTTGCGAGTGGCCTCC,0,1157321
fldAp,0.3333333333333333,2,2,TAGAGTGGTACGGGCGGGGA,0,1131676
fldAp,0.3333333333333333,2,2,TAGAGAACGGTGCGACTGCT,0,1108168
fldAp,0.3333333333333333,2,2,TAGACCTGGACGCGCTTCAA,0,1070148
fldAp,0.3333333333333333,2,2,TAGACCGCCTCTGCGCTGGC,0,1086760
fldAp,0.3333333333333333,2,2,TAGAAGTGCGGATGCTCCCT,0,1144486
fldAp,0.3333333333333333,2,2,TACTTGACTGAGGGAATACT,0,1086075
fldAp,0.3333333333333333,2,2,TACTTAGGGCCTCCTTGCGC,0,1090922
fldAp,0.3333333333333333,2,2,TACTGTTTATACACGGAGCA,0,1186187
fldAp,0.3333333333333333,2,2,TACTGGGCCTTGTTAGCTTC,0,1158182
fldAp,0.3333333333333333,2,2,TACTGGAAGACGATGAGCTA,0,1162418
fldAp,0.3333333333333333,2,2,TACTGCGACAGAAGTATCGA,0,1174893
fldAp,0.3333333333333333,2,2,TACTCACGGTGATTCCCTAC,0,1137376
fldAp,0.3333333333333333,2,2,TACTAGCTCGACAATGCATC,0,1069987
fldAp,0.3333333333333333,2,2,TACTACGAAAAGTTTTTTGC,0,1085883
fldAp,0.3333333333333333,2,2,TACGTTCTACGATTCAACGA,0,1186574
fldAp,0.3333333333333333,2,2,TACGTGTACTCATAAGGGCT,0,1172833
fldAp,0.3333333333333333,2,2,TACGTATCCAGGGTTTTGCA,0,1186825
fldAp,0.3333333333333333,2,2,TACGTATAACCAGGGCGCAA,0,1092705
fldAp,0.3333333333333333,2,2,TACGTAATAAGGGATTAATG,0,1099271
fldAp,0.3333333333333333,2,2,TACGGGTCTTTCGTACTTTA,0,1148626
fldAp,0.3333333333333333,2,2,TACGGGATACTGACGTAAGA,0,1182299
fldAp,0.3333333333333333,2,2,TACGGCGGTGAATCGCAAGG,0,1086312
fldAp,0.3333333333333333,2,2,TACGGCCCCGTTCGGGGATT,0,1098015
fldAp,0.3333333333333333,2,2,TACGGAGTGTGGCTTCGGGC,0,1169910
fldAp,0.3333333333333333,2,2,TACGGAGGAGCAATCACGCA,0,1121538
fldAp,0.3333333333333333,2,2,TACGGAAGATATTAAGGTTA,0,1065492
fldAp,0.3333333333333333,2,2,TACGCTCATCGGGCAGAAAA,0,1084996
fldAp,0.3333333333333333,2,2,TACGCATACATTAACGAATT,0,1110717
fldAp,0.3333333333333333,2,2,TACGATCAGTCTCACTGCCG,0,1117936
fldAp,0.3333333333333333,2,2,TACGACGCCTCAGGGTCATC,0,1072169
fldAp,0.3333333333333333,2,2,TACGACGCCTAGGAAGAATC,0,1105006
fldAp,0.3333333333333333,2,2,TACGACCGTGAATTACATAG,0,1118529
fldAp,0.3333333333333333,2,2,TACCTTTGGCATTGAGAGGC,0,1128605
fldAp,0.3333333333333333,2,2,TACCTGCAGATAAGCCGAGC,0,1142511
fldAp,0.3333333333333333,2,2,TACCTACTAGGGTCTCAGAT,0,1116847
fldAp,0.3333333333333333,2,2,TACCTACATAAGACATTGTA,0,1099859
fldAp,0.3333333333333333,2,2,TACCGTCCGTTGTCCCGAAC,0,1132697
fldAp,0.3333333333333333,2,2,TACCCTGCGAGTCGCCCGGA,0,1082122
fldAp,0.3333333333333333,2,2,TACCCCTGTGGGATCTTCCC,0,1112278
fldAp,0.3333333333333333,2,2,TACCCATGTAGTACCCTGGT,0,1128200
fldAp,0.3333333333333333,2,2,TACCATAACAGGCCGACCAA,0,1131677
fldAp,0.3333333333333333,2,2,TACCAGTTCCTACCATTGTG,0,1075154
fldAp,0.3333333333333333,2,2,TACCAGTATTTTATTTCCAC,0,1182169
fldAp,0.3333333333333333,2,2,TACATTTTTAAGTACGGCCG,0,1160517
fldAp,0.3333333333333333,2,2,TACATTGTAAGGAAGCAGGG,0,1178094
fldAp,0.3333333333333333,2,2,TACATCCCAAGGGCTAGTTC,0,1125019
fldAp,0.3333333333333333,2,2,TACATCAACGTGAAATATTA,0,1082125
fldAp,0.3333333333333333,2,2,TACATAGTGGCTCTGCCAGC,0,1154617
fldAp,0.3333333333333333,2,2,TACAGTTGTGGGCCTTCGAC,0,1138597
fldAp,0.3333333333333333,2,2,TACAGCCTCAGCTTCGTGGC,0,1174891
fldAp,0.3333333333333333,2,2,TACAGAAATGACATTTGTGG,0,1066108
fldAp,0.3333333333333333,2,2,TACACTATCTGGCAAGAATC,0,1141620
fldAp,0.3333333333333333,2,2,TACACCCGTCCATCAAGGAA,0,1077840
fldAp,0.3333333333333333,2,2,TACAATATCCACCAGTGTAC,0,1151777
fldAp,0.3333333333333333,2,2,TACAAGTGCCCTAGTCTCCC,0,1110317
fldAp,0.3333333333333333,2,2,TACAAGCCACACCATTAACA,0,1119619
fldAp,0.3333333333333333,2,2,TACAAGACTGCAGCAATAAA,0,1121650
fldAp,0.3333333333333333,2,2,TAATTAATAATCCGTATCAC,0,1175044
fldAp,0.3333333333333333,2,2,TAATGCGATCTACTGGCATG,0,1118633
fldAp,0.3333333333333333,2,2,TAATGCCCGCCGATCGAGTA,0,1067159
fldAp,0.3333333333333333,2,2,TAATCGTTACGTGGCGCGAA,0,1145261
fldAp,0.3333333333333333,2,2,TAATCCTGAAAAGAGAAATG,0,1172566
fldAp,0.3333333333333333,2,2,TAATCACAGATAGTATACGA,0,1116291
fldAp,0.3333333333333333,2,2,TAATATTGTGGGGCCTCCAA,0,1158936
fldAp,0.3333333333333333,2,2,TAATAGGCCGTATTTGCTTT,0,1086591
fldAp,0.3333333333333333,2,2,TAATACACGGATTCAGGTTT,0,1110931
fldAp,0.3333333333333333,2,2,TAAGTGATGTAGTAAATCAA,0,1145837
fldAp,0.3333333333333333,2,2,TAAGTCCGGCTCATTAACGT,0,1101533
fldAp,0.3333333333333333,2,2,TAAGTAAACCCAGCGTCTGA,0,1090531
fldAp,0.3333333333333333,2,2,TAAGCGTCGTAACGCTTGTT,0,1186003
fldAp,0.3333333333333333,2,2,TAAGCGTACAGAGCCATGGC,0,1093109
fldAp,0.3333333333333333,2,2,TAAGATCTGATAACGCTGTC,0,1116284
fldAp,0.3333333333333333,2,2,TAAGACGTGTAGAATTGTTT,0,1127123
fldAp,0.3333333333333333,2,2,TAAGACATGGATAAGCATAC,0,1138348
fldAp,0.3333333333333333,2,2,TAAGAAGTTTCTGATCTAAC,0,1073114
fldAp,0.3333333333333333,2,2,TAAGAAACTGGGGTCAGTAA,0,1108826
fldAp,0.3333333333333333,2,2,TAACTCGGGTCACACCGCGG,0,1154032
fldAp,0.3333333333333333,2,2,TAACGCTTGGCAGGTTACCA,0,1066795
fldAp,0.3333333333333333,2,2,TAACGCCTGATTACTACGCT,0,1146743
fldAp,0.3333333333333333,2,2,TAACGCCAACGCTTACCTGC,0,1107423
fldAp,0.3333333333333333,2,2,TAACCATTTACAAGGATGAA,0,1172088
fldAp,0.3333333333333333,2,2,TAACCATCTGTTTTGCCGGC,0,1143880
fldAp,0.3333333333333333,2,2,TAACATAATATGTGTGGCGC,0,1169692
fldAp,0.3333333333333333,2,2,TAAATTGGTGCACAACCACG,0,1104821
fldAp,0.3333333333333333,2,2,TAAATTGATGTCAAATTGTA,0,1096469
fldAp,0.3333333333333333,2,2,TAAATGAGCCCGTCCGAGTA,0,1126395
fldAp,0.3333333333333333,2,2,TAAATACATTGATGACTCGT,0,1157371
fldAp,0.3333333333333333,2,2,TAAAGGCTTGGACACAATGT,0,1148651
fldAp,0.3333333333333333,2,2,TAAAGGAACAGTAGCAAATT,0,1070225
fldAp,0.3333333333333333,2,2,TAAAGATCCGAAATGCGCGT,0,1079435
fldAp,0.3333333333333333,2,2,TAAAGACACCGACACGTGAC,0,1163378
fldAp,0.3333333333333333,2,2,TAAACCGCCGATGGGGGGCT,0,1165219
fldAp,0.3333333333333333,2,2,TAAAATCGGTGCAGGGGATC,0,1069137
fldAp,0.3333333333333333,2,2,TAAAACGGCGATTGATTCAA,0,1140708
fldAp,0.3333333333333333,2,2,TAAAACCGAGTTGCTAAAGT,0,1158307
fldAp,0.3333333333333333,2,2,TAAAAAACCTCAGGCATAGT,0,1144192
fldAp,0.3333333333333333,2,2,GTTTTGGCTTCTAATTGCAA,0,1076074
fldAp,0.3333333333333333,2,2,GTTTTAGTCGTTTAGTCTAT,0,1077260
fldAp,0.3333333333333333,2,2,GTTTGGTTCACAGATCCAAC,0,1097958
fldAp,0.3333333333333333,2,2,GTTTGGGGCTGAAAAAACCA,0,1098595
fldAp,0.3333333333333333,2,2,GTTTGGAAAGCGAAGCCATA,0,1138235
fldAp,0.3333333333333333,2,2,GTTTGAGTATACTTGGGGTG,0,1111225
fldAp,0.3333333333333333,2,2,GTTTGAAGTAATGCGGGGAA,0,1086140
fldAp,0.3333333333333333,2,2,GTTTCCGTACAATTGAGCTG,0,1112218
fldAp,0.3333333333333333,2,2,GTTTATTTAGCATGTGGGAG,0,1143871
fldAp,0.3333333333333333,2,2,GTTTAGACATAACACACGGT,0,1145198
fldAp,0.3333333333333333,2,2,GTTTAAGCGTGTTCCAAGGT,0,1117578
fldAp,0.3333333333333333,2,2,GTTGTTTTTGAACCGAGTAG,0,1091040
fldAp,0.3333333333333333,2,2,GTTGTTCCTACCAGCGTATT,0,1091325
fldAp,0.3333333333333333,2,2,GTTGTTATTCGTCCACGACG,0,1165234
fldAp,0.3333333333333333,2,2,GTTGTATTCAAAGTCACAAT,0,1084068
fldAp,0.3333333333333333,2,2,GTTGGCGTATCTATTCGCTG,0,1106599
fldAp,0.3333333333333333,2,2,GTTGGAGGGCAGTAGGTCAT,0,1080404
fldAp,0.3333333333333333,2,2,GTTGGAAATATATTACGCCT,0,1069108
fldAp,0.3333333333333333,2,2,GTTGCCTGGACTGGACAACT,0,1117773
fldAp,0.3333333333333333,2,2,GTTGATTTGCAGCATAGAGG,0,1110522
fldAp,0.3333333333333333,2,2,GTTGATAGTCCAGCCCATGA,0,1171737
fldAp,0.3333333333333333,2,2,GTTGAGTATACTTTCCGGGG,0,1159058
fldAp,0.3333333333333333,2,2,GTTCTTACACTCTTCCCCCC,0,1090281
fldAp,0.3333333333333333,2,2,GTTCTGACTTGTGGTCTGCA,0,1074385
fldAp,0.3333333333333333,2,2,GTTCTAATTCAGTGTTAAAA,0,1142940
fldAp,0.3333333333333333,2,2,GTTCGTTAGCAAGTATTCCC,0,1124984
fldAp,0.3333333333333333,2,2,GTTCGTGGTACCGTTACTAA,0,1181496
fldAp,0.3333333333333333,2,2,GTTCGGCAATAAAGCGTCCA,0,1185203
fldAp,0.3333333333333333,2,2,GTTCGACCCATCTAGCTGTT,0,1070238
fldAp,0.3333333333333333,2,2,GTTCCTCACCCTCGTGGTAA,0,1063990
fldAp,0.3333333333333333,2,2,GTTCCCGCTATATTGCCGGG,0,1129877
fldAp,0.3333333333333333,2,2,GTTCCATTCGCAGTGCCGTA,0,1114746
fldAp,0.3333333333333333,2,2,GTTCCACCTAAAACCATGAG,0,1098463
fldAp,0.3333333333333333,2,2,GTTCATGAAGGGTGGGGAAT,0,1139577
fldAp,0.3333333333333333,2,2,GTTCATATCATTATCTCTTC,0,1123938
fldAp,0.3333333333333333,2,2,GTTCATAGTAAAGTTTGCTG,0,1114320
fldAp,0.3333333333333333,2,2,GTTCAGAAGGCACAAGCATG,0,1166837
fldAp,0.3333333333333333,2,2,GTTCAGAACCAAGTTTCCCT,0,1151621
fldAp,0.3333333333333333,2,2,GTTATCGCAAAACTTGTGCT,0,1163128
fldAp,0.3333333333333333,2,2,GTTATAAGCGATTTCCTGCG,0,1131002
fldAp,0.3333333333333333,2,2,GTTAGGGTGTGCATGAAGTC,0,1120349
fldAp,0.3333333333333333,2,2,GTTAGGCTGGGGAGTATGGA,0,1145624
fldAp,0.3333333333333333,2,2,GTTAGCACATCAGCTTACAC,0,1098089
fldAp,0.3333333333333333,2,2,GTTAATACTCGAAATGCCAC,0,1156440
fldAp,0.3333333333333333,2,2,GTTAATAATTTATCCCGTTT,0,1117691
fldAp,0.3333333333333333,2,2,GTTAAGATATATGTTTAAAC,0,1099342
fldAp,0.3333333333333333,2,2,GTTAACGGGTCACTGGTAGT,0,1137769
fldAp,0.3333333333333333,2,2,GTTAACGCTGCGCTCCTCCA,0,1172278
fldAp,0.3333333333333333,2,2,GTTAAACGTGCCGTGGAGGT,0,1179230
fldAp,0.3333333333333333,2,2,GTTAAACAGCCGATCCCGAA,0,1072568
fldAp,0.3333333333333333,2,2,GTTAAAAGATTGGGTCTAAG,0,1146502
fldAp,0.3333333333333333,2,2,GTGTTTATTAGCGATCCCGT,0,1104109
fldAp,0.3333333333333333,2,2,GTGTTGTTGCCACAACGAAC,0,1085471
fldAp,0.3333333333333333,2,2,GTGTTATGATACGGTAGATG,0,1087598
fldAp,0.3333333333333333,2,2,GTGTGTAGTGCATCGCTCTA,0,1164337
fldAp,0.3333333333333333,2,2,GTGTGGGGGCTGGGGATCTT,0,1086750
fldAp,0.3333333333333333,2,2,GTGTGCTGTAGTAAAGCACT,0,1131380
fldAp,0.3333333333333333,2,2,GTGTGATATGTACATTTCAA,0,1172346
fldAp,0.3333333333333333,2,2,GTGTGAGCGGAGGATTGCGG,0,1134130
fldAp,0.3333333333333333,2,2,GTGTGACGTCGTGTCGGGGT,0,1157142
fldAp,0.3333333333333333,2,2,GTGTGAAGGCTAATTATCAG,0,1145349
fldAp,0.3333333333333333,2,2,GTGTCCTATTAAGCCTTACA,0,1101877
fldAp,0.3333333333333333,2,2,GTGTCCATTGTGAGACGGTG,0,1095329
fldAp,0.3333333333333333,2,2,GTGTATTCAAGATCCCCGCT,0,1075454
fldAp,0.3333333333333333,2,2,GTGTAGAGCTTGGATCTGTT,0,1165020
fldAp,0.3333333333333333,2,2,GTGTAGACGTCCGAATCGTC,0,1135150
fldAp,0.3333333333333333,2,2,GTGTACTAGATGTGCCTTAG,0,1168427
fldAp,0.3333333333333333,2,2,GTGTAAAGGAGTGAGGCAGC,0,1148664
fldAp,0.3333333333333333,2,2,GTGGTTAGAGGATTCAAAAA,0,1089405
fldAp,0.3333333333333333,2,2,GTGGTGTTTTGGCCAGGTCT,0,1073150
fldAp,0.3333333333333333,2,2,GTGGTGTGCGCTCAATGTGC,0,1096912
fldAp,0.3333333333333333,2,2,GTGGTGCTAGTTTGCGCCCA,0,1072131
fldAp,0.3333333333333333,2,2,GTGGTCAAGTATAAATAGAC,0,1076941
fldAp,0.3333333333333333,2,2,GTGGTAACGGCACTGTGAGG,0,1184284
fldAp,0.3333333333333333,2,2,GTGGGGCTCCAGCGTAAAAT,0,1166343
fldAp,0.3333333333333333,2,2,GTGGGCCAGACAATACAATA,0,1072580
fldAp,0.3333333333333333,2,2,GTGGCGGTGCTTCGGCACGC,0,1106872
fldAp,0.3333333333333333,2,2,GTGGCGAGGAACCGCATGTA,0,1161346
fldAp,0.3333333333333333,2,2,GTGGCATTTATTTCAGCCTT,0,1115498
fldAp,0.3333333333333333,2,2,GTGGCACGACTAGGGGGGGA,0,1123042
fldAp,0.3333333333333333,2,2,GTGGCACATAAGACCGCTCC,0,1070208
fldAp,0.3333333333333333,2,2,GTGGATTGGACAGAGTCTTG,0,1133721
fldAp,0.3333333333333333,2,2,GTGGATTCTTAAGATAGACA,0,1090126
fldAp,0.3333333333333333,2,2,GTGGATGTTTTCGCGCCTTT,0,1168261
fldAp,0.3333333333333333,2,2,GTGGATGCATGTTGTGCAAT,0,1070296
fldAp,0.3333333333333333,2,2,GTGGATAACTGGATGTCTCC,0,1142831
fldAp,0.3333333333333333,2,2,GTGGAGGTGCTTTCGCTGCA,0,1148223
fldAp,0.3333333333333333,2,2,GTGGACCAAGCAATGTAGGA,0,1150861
fldAp,0.3333333333333333,2,2,GTGGAAGCTTACCATCGAAC,0,1140849
fldAp,0.3333333333333333,2,2,GTGGAAAGTTCACTCAAACT,0,1162808
fldAp,0.3333333333333333,2,2,GTGCTGATATAATTCTACAG,0,1141137
fldAp,0.3333333333333333,2,2,GTGCTCATCCATCAAAAGTA,0,1096484
fldAp,0.3333333333333333,2,2,GTGCTCAATGATGCTGTACA,0,1065511
fldAp,0.3333333333333333,2,2,GTGCTAGGGATCCGGTTCGG,0,1105348
fldAp,0.3333333333333333,2,2,GTGCTACATAGGCATCTTTA,0,1121985
fldAp,0.3333333333333333,2,2,GTGCGTGCGCGGGTAAATGG,0,1097251
fldAp,0.3333333333333333,2,2,GTGCGGTGGGTAACTAGAGG,0,1093621
fldAp,0.3333333333333333,2,2,GTGCGAGACGTGTAGTCGTT,0,1173826
fldAp,0.3333333333333333,2,2,GTGCGAAGATATCGGGTCTG,0,1121321
fldAp,0.3333333333333333,2,2,GTGCCTAGGGGACAGGTTCA,0,1106509
fldAp,0.3333333333333333,2,2,GTGCCGTCGGATTGTATCAG,0,1074672
fldAp,0.3333333333333333,2,2,GTGCATAGGTCGTAAGTCCG,0,1074377
fldAp,0.3333333333333333,2,2,GTGCACTCCATGCGACTATC,0,1182326
fldAp,0.3333333333333333,2,2,GTGCAACCCTCTTCTGGTCC,0,1183471
fldAp,0.3333333333333333,2,2,GTGATTCTGACGTTTTAGAC,0,1183331
fldAp,0.3333333333333333,2,2,GTGATGGTCTTAAGCGGGCA,0,1177307
fldAp,0.3333333333333333,2,2,GTGATGGCACAAATGCGGCG,0,1131447
fldAp,0.3333333333333333,2,2,GTGATCTGGTATTCATATCC,0,1135828
fldAp,0.3333333333333333,2,2,GTGATCCTTACGGTTCGTTA,0,1131962
fldAp,0.3333333333333333,2,2,GTGATCCCTTTCGGAATCTT,0,1099898
fldAp,0.3333333333333333,2,2,GTGAGTACGCCCGACGCTCG,0,1097072
fldAp,0.3333333333333333,2,2,GTGAGGGACCCGGGTAGTTA,0,1079419
fldAp,0.3333333333333333,2,2,GTGAGGAATCACGGACATAA,0,1121711
fldAp,0.3333333333333333,2,2,GTGACTTATTGACATGGCGT,0,1095398
fldAp,0.3333333333333333,2,2,GTGACTGGGAAAACACGGAA,0,1070745
fldAp,0.3333333333333333,2,2,GTGACGAACAAGAAGTCTTC,0,1106668
fldAp,0.3333333333333333,2,2,GTGACATACTTGAAGACGCT,0,1114026
fldAp,0.3333333333333333,2,2,GTGAATGCGGTCGCCGTTTG,0,1103379
fldAp,0.3333333333333333,2,2,GTGAAGCCCTGCCTACCAAT,0,1134505
fldAp,0.3333333333333333,2,2,GTGAACAGGGCCTGAGGCCT,0,1126853
fldAp,0.3333333333333333,2,2,GTGAAAGATTCCTCACTCTA,0,1116198
fldAp,0.3333333333333333,2,2,GTCTTTGCCACCTCAGTGTA,0,1155362
fldAp,0.3333333333333333,2,2,GTCTTTGCACGCGTCGTGAT,0,1122827
fldAp,0.3333333333333333,2,2,GTCTGGGTGTCCTGTCTCAC,0,1081184
fldAp,0.3333333333333333,2,2,GTCTGGGAGGACTTGTGCCC,0,1132633
fldAp,0.3333333333333333,2,2,GTCTCTGCACAACCATTAAT,0,1119289
fldAp,0.3333333333333333,2,2,GTCTCCTTAGTCGAAGTATT,0,1175194
fldAp,0.3333333333333333,2,2,GTCTCCCTAGCATAAGTTTA,0,1101194
fldAp,0.3333333333333333,2,2,GTCTCATTAAGTATTTGACG,0,1147323
fldAp,0.3333333333333333,2,2,GTCTAGGCACGGAAGGGGTG,0,1122712
fldAp,0.3333333333333333,2,2,GTCTAGCAGGTATAAAGGGC,0,1097273
fldAp,0.3333333333333333,2,2,GTCTACCGTAGGAGGCATTC,0,1137144
fldAp,0.3333333333333333,2,2,GTCTACCCGGCGCCGAAATC,0,1088496
fldAp,0.3333333333333333,2,2,GTCTAATGGAGATCTTTACG,0,1176733
fldAp,0.3333333333333333,2,2,GTCTAAATGGCAGGAAGGTC,0,1115011
fldAp,0.3333333333333333,2,2,GTCGTTCTTGATCATAGTTT,0,1138428
fldAp,0.3333333333333333,2,2,GTCGTGACCCCGCTGAGGTG,0,1077972
fldAp,0.3333333333333333,2,2,GTCGTCCTGGGGAAGTTTAG,0,1129675
fldAp,0.3333333333333333,2,2,GTCGTCACCAGTTGGTTGAA,0,1167786
fldAp,0.3333333333333333,2,2,GTCGGTTAAGTTTCGTGGCC,0,1123641
fldAp,0.3333333333333333,2,2,GTCGGGAATGTGCCATGTGA,0,1170390
fldAp,0.3333333333333333,2,2,GTCGAAGGCTTAGCCCGGCG,0,1149118
fldAp,0.3333333333333333,2,2,GTCCTTGCCCGCACTCCCAA,0,1180620
fldAp,0.3333333333333333,2,2,GTCCTTACTCGCACTTCCGG,0,1184714
fldAp,0.3333333333333333,2,2,GTCCTGCGCAAGTAACACAT,0,1065237
fldAp,0.3333333333333333,2,2,GTCCTAAAGATAGGGCTTAG,0,1082610
fldAp,0.3333333333333333,2,2,GTCCGCGTGGGGGGAGCGCA,0,1167630
fldAp,0.3333333333333333,2,2,GTCCGATTTCAGCGTCCAGA,0,1075347
fldAp,0.3333333333333333,2,2,GTCCCCTTTCTAATACGCAA,0,1178172
fldAp,0.3333333333333333,2,2,GTCCCAAGTCGGTGCGCAGC,0,1185477
fldAp,0.3333333333333333,2,2,GTCCAGTGCTATCAGTTAAC,0,1167262
fldAp,0.3333333333333333,2,2,GTCCAATCATTGGACCCGTT,0,1063890
fldAp,0.3333333333333333,2,2,GTCATTCGAGGGACCAACCA,0,1141657
fldAp,0.3333333333333333,2,2,GTCATGTTTAGATCCAAAAA,0,1147040
fldAp,0.3333333333333333,2,2,GTCATCCCGTCACAGGGTTT,0,1103334
fldAp,0.3333333333333333,2,2,GTCATCACGGTTATGATAAT,0,1110721
fldAp,0.3333333333333333,2,2,GTCAGGTTAGTAAAGGTAAC,0,1097058
fldAp,0.3333333333333333,2,2,GTCAGGCCGATCATCGCGGA,0,1154312
fldAp,0.3333333333333333,2,2,GTCAGGACCCCGCGATGCGT,0,1141238
fldAp,0.3333333333333333,2,2,GTCAGCCGTACGGGATAGCT,0,1183997
fldAp,0.3333333333333333,2,2,GTCAGAGCCGTCCCTCGTCA,0,1184137
fldAp,0.3333333333333333,2,2,GTCACCCGATCCACACGGCC,0,1132190
fldAp,0.3333333333333333,2,2,GTCACATCTCAGTCAGTCAA,0,1167567
fldAp,0.3333333333333333,2,2,GTCAATAAGTGCTGCCTTAT,0,1065784
fldAp,0.3333333333333333,2,2,GTCAAATAGGTCTATGCTCA,0,1132374
fldAp,0.3333333333333333,2,2,GTATTAATATGAGTGCAGGT,0,1063089
fldAp,0.3333333333333333,2,2,GTATGTGTGGTCTTCTCCCG,0,1078694
fldAp,0.3333333333333333,2,2,GTATGGCAAGCTATAACAGA,0,1085651
fldAp,0.3333333333333333,2,2,GTATCTGGCTGATATAAATG,0,1083899
fldAp,0.3333333333333333,2,2,GTATCGAATTTCACTGGCAT,0,1130146
fldAp,0.3333333333333333,2,2,GTATCATCGGGTATCGCGGG,0,1066880
fldAp,0.3333333333333333,2,2,GTATCACGTTCTGAACAGAT,0,1143607
fldAp,0.3333333333333333,2,2,GTATATTGAAGTATTGCTCA,0,1154550
fldAp,0.3333333333333333,2,2,GTATATTCCGCTAGTCGCAC,0,1146846
fldAp,0.3333333333333333,2,2,GTATACTCTCTGTGTGCATA,0,1093639
fldAp,0.3333333333333333,2,2,GTATACTCGCTTCCTGAGCC,0,1101413
fldAp,0.3333333333333333,2,2,GTAGTTGCGGGATTATGTAC,0,1116282
fldAp,0.3333333333333333,2,2,GTAGTAGGCATACATGTGCG,0,1163308
fldAp,0.3333333333333333,2,2,GTAGGTGAGCATTTAGAACA,0,1175642
fldAp,0.3333333333333333,2,2,GTAGGTCGCTCTGCTACAAG,0,1157145
fldAp,0.3333333333333333,2,2,GTAGGCTTCATTCCTCTAAT,0,1179877
fldAp,0.3333333333333333,2,2,GTAGGCGTCTAGAGGTACTC,0,1095137
fldAp,0.3333333333333333,2,2,GTAGCGGGACAAAAAGACGG,0,1107426
fldAp,0.3333333333333333,2,2,GTAGATTACAAACGGCAAAT,0,1075647
fldAp,0.3333333333333333,2,2,GTAGAGCGTTTCTCTAGCTT,0,1097372
fldAp,0.3333333333333333,2,2,GTAGACGAATGCTGAAAGCC,0,1145643
fldAp,0.3333333333333333,2,2,GTACTGAAACTTGTAGTTGA,0,1149896
fldAp,0.3333333333333333,2,2,GTACTCAGAGATGAGGTAAA,0,1184313
fldAp,0.3333333333333333,2,2,GTACGTAGGCTGCCGGAGGG,0,1143206
fldAp,0.3333333333333333,2,2,GTACGGACATCTACCATTTC,0,1123163
fldAp,0.3333333333333333,2,2,GTACGCATATGCAATTCGCT,0,1161101
fldAp,0.3333333333333333,2,2,GTACGAATCGGGCGTGACGT,0,1180558
fldAp,0.3333333333333333,2,2,GTACCTCGACCAGGAAAGGA,0,1111794
fldAp,0.3333333333333333,2,2,GTACCCAGGTTGAATGACAG,0,1142410
fldAp,0.3333333333333333,2,2,GTACCATAGCCGCGAATACT,0,1169170
fldAp,0.3333333333333333,2,2,GTACCAGCCTCTACATACTC,0,1110684
fldAp,0.3333333333333333,2,2,GTACCAGAGTCGAAATACGT,0,1074344
fldAp,0.3333333333333333,2,2,GTACCAAAAATCAGTTGGTG,0,1100777
fldAp,0.3333333333333333,2,2,GTACATTTCGCGCTGTGGTT,0,1156858
fldAp,0.3333333333333333,2,2,GTACATCACTAAACATGGTT,0,1069040
fldAp,0.3333333333333333,2,2,GTACATACGTGGAAATCCAT,0,1185201
fldAp,0.3333333333333333,2,2,GTACAAAGTATCCATCTGTG,0,1152036
fldAp,0.3333333333333333,2,2,GTAATACACCCCACACGTTC,0,1176490
fldAp,0.3333333333333333,2,2,GTAAGTCGAGTACTCCCAGG,0,1086854
fldAp,0.3333333333333333,2,2,GTAAGATGCTAGAGGTCCCG,0,1110736
fldAp,0.3333333333333333,2,2,GTAACTTCCCCTGCTCAATT,0,1086282
fldAp,0.3333333333333333,2,2,GTAACTTAGATTCAATGGGT,0,1117176
fldAp,0.3333333333333333,2,2,GTAAATCGCTATGAAAAAGT,0,1074386
fldAp,0.3333333333333333,2,2,GTAAACCTTAAGTGGCGCCA,0,1098422
fldAp,0.3333333333333333,2,2,GTAAACAGGTCTGGACCTGC,0,1081789
fldAp,0.3333333333333333,2,2,GTAAAATCAAGCATGGTCCA,0,1063525
fldAp,0.3333333333333333,2,2,GGTTTCACGTACTGCGCATA,0,1093221
fldAp,0.3333333333333333,2,2,GGTTGTACAGTTCGTATCTC,0,1110173
fldAp,0.3333333333333333,2,2,GGTTGGTAGAGACAGACCGT,0,1064469
fldAp,0.3333333333333333,2,2,GGTTGCTACTATCCATGAGC,0,1152859
fldAp,0.3333333333333333,2,2,GGTTGACGTTCTACCGCCTA,0,1101760
fldAp,0.3333333333333333,2,2,GGTTCTAGAGTCTGGTTGTG,0,1144876
fldAp,0.3333333333333333,2,2,GGTTCTACTTTCATGTCAGC,0,1071764
fldAp,0.3333333333333333,2,2,GGTTCGACTCGTTAATTAGC,0,1146080
fldAp,0.3333333333333333,2,2,GGTTCCTGGATGCCAGGGAG,0,1178292
fldAp,0.3333333333333333,2,2,GGTTCCCGTGTGGACGGTCA,0,1172017
fldAp,0.3333333333333333,2,2,GGTTCAGTGGGATAACATCA,0,1173726
fldAp,0.3333333333333333,2,2,GGTTCAGGCTAAAGACCGAA,0,1176540
fldAp,0.3333333333333333,2,2,GGTTATTGTGGCTTAAAAGG,0,1096145
fldAp,0.3333333333333333,2,2,GGTTAACACACAAGGCGGGA,0,1133821
fldAp,0.3333333333333333,2,2,GGTTAAATTACGGCGACGCT,0,1092133
fldAp,0.3333333333333333,2,2,GGTGTGTCTGGAAGGACTGG,0,1163285
fldAp,0.3333333333333333,2,2,GGTGTGGTCAGCGAGTACCA,0,1131081
fldAp,0.3333333333333333,2,2,GGTGTGGGAGGGATAGTCTG,0,1079198
fldAp,0.3333333333333333,2,2,GGTGTCGTTTCAATCGGGGG,0,1083390
fldAp,0.3333333333333333,2,2,GGTGTCCCCGTTAACCCCGT,0,1163174
fldAp,0.3333333333333333,2,2,GGTGTAATAACCATCTTTAT,0,1152170
fldAp,0.3333333333333333,2,2,GGTGGGGCGTACGCATGTGT,0,1087790
fldAp,0.3333333333333333,2,2,GGTGCGTCATCGATAGCTCC,0,1171033
fldAp,0.3333333333333333,2,2,GGTGCGCATCTTGGGCGGGC,0,1132993
fldAp,0.3333333333333333,2,2,GGTGCCACTTAATGTATGAT,0,1174984
fldAp,0.3333333333333333,2,2,GGTGAGGATGTCGTTTACGC,0,1084415
fldAp,0.3333333333333333,2,2,GGTCTTCGTTATGCTCTAGT,0,1082439
fldAp,0.3333333333333333,2,2,GGTCTTATGGAGTACGCACC,0,1110711
fldAp,0.3333333333333333,2,2,GGTCTGGTGCGTGGCTCTAG,0,1154741
fldAp,0.3333333333333333,2,2,GGTCTGAGGCTCTGCGGGCA,0,1139808
fldAp,0.3333333333333333,2,2,GGTCGGTTGTCCCAGTCTAT,0,1087769
fldAp,0.3333333333333333,2,2,GGTCCTTGGATGTTTAGTCT,0,1182545
fldAp,0.3333333333333333,2,2,GGTCCCCTTTAAATCTGGTT,0,1150686
fldAp,0.3333333333333333,2,2,GGTCCCACTTCAGTGGACAG,0,1122721
fldAp,0.3333333333333333,2,2,GGTCCCAACGCGACGAGTTC,0,1144267
fldAp,0.3333333333333333,2,2,GGTCCATATCATGGTATACT,0,1099841
fldAp,0.3333333333333333,2,2,GGTCCAGCCTACGGCATGGA,0,1152712
fldAp,0.3333333333333333,2,2,GGTCATCATGACAGGCTAGA,0,1076007
fldAp,0.3333333333333333,2,2,GGTCAGGTAAGGCATTCAAA,0,1147370
fldAp,0.3333333333333333,2,2,GGTCAGACCTCGTAGCTCCC,0,1137004
fldAp,0.3333333333333333,2,2,GGTCAGAATCGCCCATAAAG,0,1153999
fldAp,0.3333333333333333,2,2,GGTATGACAAACTTTCCGGG,0,1178244
fldAp,0.3333333333333333,2,2,GGTATGAATTTCATGCTCTA,0,1162173
fldAp,0.3333333333333333,2,2,GGTATCATACGAAATCAGAC,0,1117642
fldAp,0.3333333333333333,2,2,GGTATACTGACTACCAAGAG,0,1124425
fldAp,0.3333333333333333,2,2,GGTAGTGTAGCATTGGCAAA,0,1144330
fldAp,0.3333333333333333,2,2,GGTAGTGACCGTGACAAAAA,0,1114576
fldAp,0.3333333333333333,2,2,GGTAGATTTTCCACGCACTT,0,1118355
fldAp,0.3333333333333333,2,2,GGTAGATTACAAACTTATCT,0,1106053
fldAp,0.3333333333333333,2,2,GGTACGGCGACAGGCACAAA,0,1116423
fldAp,0.3333333333333333,2,2,GGTACGCGGCCCACGGGATC,0,1090647
fldAp,0.3333333333333333,2,2,GGTAATCCTTTGCGTAGGTA,0,1165421
fldAp,0.3333333333333333,2,2,GGTAACTTTCAACCGTATGC,0,1157437
fldAp,0.3333333333333333,2,2,GGGTTGCAAGCGAAGTGTGA,0,1144980
fldAp,0.3333333333333333,2,2,GGGTTGACGAACGTCAGGGT,0,1117401
fldAp,0.3333333333333333,2,2,GGGTTCTTCACGTTTAGACA,0,1086264
fldAp,0.3333333333333333,2,2,GGGTTCTCTAAGTTGACATG,0,1089518
fldAp,0.3333333333333333,2,2,GGGTTCCATCGACTTGTAAT,0,1134931
fldAp,0.3333333333333333,2,2,GGGTTAGGGTGGCAGGCGTA,0,1079771
fldAp,0.3333333333333333,2,2,GGGTTAGGGTAATGTACGTC,0,1105336
fldAp,0.3333333333333333,2,2,GGGTGAGCTCAATAGTTATG,0,1185242
fldAp,0.3333333333333333,2,2,GGGTGACTGTTAGTTGCGTG,0,1161190
fldAp,0.3333333333333333,2,2,GGGTGAACTAACAATGACAA,0,1074375
fldAp,0.3333333333333333,2,2,GGGTCTTTGGAGGCTCCACT,0,1114111
fldAp,0.3333333333333333,2,2,GGGTCTTCGGGCTTTCCGAT,0,1155731
fldAp,0.3333333333333333,2,2,GGGTCTTAACTTCATGGCGA,0,1180193
fldAp,0.3333333333333333,2,2,GGGTCCCCTACGTAGGTGCT,0,1082413
fldAp,0.3333333333333333,2,2,GGGTATCGGAGGGTTTGCAC,0,1183141
fldAp,0.3333333333333333,2,2,GGGTATACAATATTTTCCCC,0,1127415
fldAp,0.3333333333333333,2,2,GGGTACTCAATGATTGAACT,0,1141246
fldAp,0.3333333333333333,2,2,GGGTACTACCATCTATCAGC,0,1067560
fldAp,0.3333333333333333,2,2,GGGTACGGGGATAAGCAGAT,0,1070403
fldAp,0.3333333333333333,2,2,GGGGTTTATCCGCTCCTTGG,0,1089395
fldAp,0.3333333333333333,2,2,GGGGTTGAAGGCAAAGGCTA,0,1155715
fldAp,0.3333333333333333,2,2,GGGGTTATAACGCGTCCAAT,0,1125520
fldAp,0.3333333333333333,2,2,GGGGTGGAAGTGGGAAGCTT,0,1066979
fldAp,0.3333333333333333,2,2,GGGGTGGAAAGATATCTCCA,0,1183967
fldAp,0.3333333333333333,2,2,GGGGTGCAACCGAGGAGGTC,0,1099475
fldAp,0.3333333333333333,2,2,GGGGTGCAAAAAATCGCGAC,0,1147643
fldAp,0.3333333333333333,2,2,GGGGTCCCACAAACCGACCT,0,1103668
fldAp,0.3333333333333333,2,2,GGGGTATCGACAAAGTCCAC,0,1069364
fldAp,0.3333333333333333,2,2,GGGGTAAAGGCACATACTTC,0,1121457
fldAp,0.3333333333333333,2,2,GGGGGGTTAGTTCGCTGAAA,0,1135379
fldAp,0.3333333333333333,2,2,GGGGGGACCCTGGTTTAACT,0,1179088
fldAp,0.3333333333333333,2,2,GGGGCACTGTTGGCATCCTA,0,1126318
fldAp,0.3333333333333333,2,2,GGGGAGAGTACCCTGTCTGT,0,1080519
fldAp,0.3333333333333333,2,2,GGGGACTCTAATGCAAGCTT,0,1151792
fldAp,0.3333333333333333,2,2,GGGGACGCACATATGCACAA,0,1168859
fldAp,0.3333333333333333,2,2,GGGCTTTTTAGGGCATTTGT,0,1173650
fldAp,0.3333333333333333,2,2,GGGCTGGGATATTTAAGTTG,0,1139476
fldAp,0.3333333333333333,2,2,GGGCTGCCCCATGAACGGTT,0,1130549
fldAp,0.3333333333333333,2,2,GGGCGTTACTCATGCGCAGT,0,1135039
fldAp,0.3333333333333333,2,2,GGGCGGATCTCTAGTGGTAA,0,1072447
fldAp,0.3333333333333333,2,2,GGGCGGACGAAGATCCACGT,0,1095117
fldAp,0.3333333333333333,2,2,GGGCGAGAGGTGGGACAAAA,0,1174896
fldAp,0.3333333333333333,2,2,GGGCCGCGCACGTCAGTGGA,0,1116930
fldAp,0.3333333333333333,2,2,GGGCCGCGAAGAAGGTGTAA,0,1098943
fldAp,0.3333333333333333,2,2,GGGCATTACGAAAATGTTCA,0,1176492
fldAp,0.3333333333333333,2,2,GGGCAGTCCTGCATACTAAG,0,1156561
fldAp,0.3333333333333333,2,2,GGGCACGTAGCGAAGCGCGG,0,1065933
fldAp,0.3333333333333333,2,2,GGGATTGTGTCCGCTCTACA,0,1073760
fldAp,0.3333333333333333,2,2,GGGATGTTTGTCTAGAGGAG,0,1105191
fldAp,0.3333333333333333,2,2,GGGATGTCGCTCGATTGTGG,0,1086274
fldAp,0.3333333333333333,2,2,GGGATGTAGGGGAGAAATAG,0,1118627
fldAp,0.3333333333333333,2,2,GGGATCTGACTTTGGGCGTA,0,1146881
fldAp,0.3333333333333333,2,2,GGGAGGTGTAGCAGCGAAAT,0,1140978
fldAp,0.3333333333333333,2,2,GGGAGGCTCACATCATTTAT,0,1152970
fldAp,0.3333333333333333,2,2,GGGAGCGGACACACGGCATA,0,1065636
fldAp,0.3333333333333333,2,2,GGGAGAAATATCATGGGTCC,0,1101026
fldAp,0.3333333333333333,2,2,GGGAGAAACCGTGCAGAACT,0,1116275
fldAp,0.3333333333333333,2,2,GGGACTCAGGTCGATTCCTC,0,1086892
fldAp,0.3333333333333333,2,2,GGGACAAAATTGTAGCAATG,0,1129612
fldAp,0.3333333333333333,2,2,GGGAATTTGCTATTGTTGAT,0,1074787
fldAp,0.3333333333333333,2,2,GGGAATTCGATCAATGCGAT,0,1154212
fldAp,0.3333333333333333,2,2,GGGAAGCTGAAGTGATACTC,0,1095796
fldAp,0.3333333333333333,2,2,GGGAAATTACATGCACCCTA,0,1151465
fldAp,0.3333333333333333,2,2,GGGAAATGTGGAACGCGTGG,0,1147616
fldAp,0.3333333333333333,2,2,GGGAAAATCCGAAGTTCAAA,0,1094442
fldAp,0.3333333333333333,2,2,GGCTTTTAGCCCTAAGGCCG,0,1156061
fldAp,0.3333333333333333,2,2,GGCTTGTTAAAGGTGACCAG,0,1153254
fldAp,0.3333333333333333,2,2,GGCTGTTAGAAGACATGGTC,0,1132122
fldAp,0.3333333333333333,2,2,GGCTGTCTACGCTCGAAGAT,0,1129352
fldAp,0.3333333333333333,2,2,GGCTGGCTGGCAAGTGCTAA,0,1166909
fldAp,0.3333333333333333,2,2,GGCTCTTATGGGGTTGATGG,0,1161054
fldAp,0.3333333333333333,2,2,GGCTCTGGCTGGGCACAATC,0,1094565
fldAp,0.3333333333333333,2,2,GGCTCCCTGTACCACAGGTA,0,1120659
fldAp,0.3333333333333333,2,2,GGCTCATTACGTATATCACT,0,1168545
fldAp,0.3333333333333333,2,2,GGCTCAAGTATGATTGTCAG,0,1130779
fldAp,0.3333333333333333,2,2,GGCTATAGAGAATGTATGAT,0,1102719
fldAp,0.3333333333333333,2,2,GGCTAAAGTTCGGGCAACGA,0,1076017
fldAp,0.3333333333333333,2,2,GGCTAAAGGCGATTAAACTT,0,1078975
fldAp,0.3333333333333333,2,2,GGCGTGTTGATGTCACGATT,0,1176671
fldAp,0.3333333333333333,2,2,GGCGTAACCAAACCCATGAA,0,1138752
fldAp,0.3333333333333333,2,2,GGCGGCCAAAGCATAAATTC,0,1146676
fldAp,0.3333333333333333,2,2,GGCGCGCAAACTGGGCAGAA,0,1123835
fldAp,0.3333333333333333,2,2,GGCGCCACTTTATGGTGAGG,0,1095623
fldAp,0.3333333333333333,2,2,GGCGCAGCGTCGGGTGCGAA,0,1138669
fldAp,0.3333333333333333,2,2,GGCGCAAGCTTCCGCAGGGT,0,1092882
fldAp,0.3333333333333333,2,2,GGCGAGGCCAATGGGATTTG,0,1122104
fldAp,0.3333333333333333,2,2,GGCGACTACCCGACTGATGG,0,1089525
fldAp,0.3333333333333333,2,2,GGCGAAGGGTCACGGCTCCT,0,1144865
fldAp,0.3333333333333333,2,2,GGCGAACCGTGAATCATCGT,0,1136374
fldAp,0.3333333333333333,2,2,GGCGAAAAGTCCCCGAGCAT,0,1070638
fldAp,0.3333333333333333,2,2,GGCCTATGACGGCCAACGCC,0,1098822
fldAp,0.3333333333333333,2,2,GGCCGTATGTCTACAACATT,0,1179460
fldAp,0.3333333333333333,2,2,GGCCGCTGGCACTCGCACCC,0,1120168
fldAp,0.3333333333333333,2,2,GGCCGCGTCAAGGGTCATTT,0,1069885
fldAp,0.3333333333333333,2,2,GGCCGAGCGTTGCCGGTACG,0,1112938
fldAp,0.3333333333333333,2,2,GGCCCGTAATTTTGTTCTGG,0,1118099
fldAp,0.3333333333333333,2,2,GGCCCGGAATGGGAGATGAA,0,1144033
fldAp,0.3333333333333333,2,2,GGCCCGCAGGCTTATGAGCG,0,1110002
fldAp,0.3333333333333333,2,2,GGCCCCACGCGCATGTCGAT,0,1128182
fldAp,0.3333333333333333,2,2,GGCCATACCGCACCTCGTGT,0,1163523
fldAp,0.3333333333333333,2,2,GGCATTCTCTTTGGTTCTGT,0,1086244
fldAp,0.3333333333333333,2,2,GGCATGCGGTTACGCGTGAT,0,1135646
fldAp,0.3333333333333333,2,2,GGCAGCGCGGGCCTAAGGCC,0,1085309
fldAp,0.3333333333333333,2,2,GGCAGAGCCGCAAGCGTATT,0,1150742
fldAp,0.3333333333333333,2,2,GGCAGACTGGTAGATGCCTC,0,1110384
fldAp,0.3333333333333333,2,2,GGCACGTTATCGATTTCAAT,0,1100171
fldAp,0.3333333333333333,2,2,GGCACGGCAGGGGTTTGTAC,0,1078532
fldAp,0.3333333333333333,2,2,GGCACGGATACGCGTTTCAT,0,1131946
fldAp,0.3333333333333333,2,2,GGCACGAAGGTGAGTGGGAC,0,1146587
fldAp,0.3333333333333333,2,2,GGCACATTATTGCATGAAAT,0,1168068
fldAp,0.3333333333333333,2,2,GGCACAACGGGGACAGGTTC,0,1150414
fldAp,0.3333333333333333,2,2,GGCAATATTGGCTTGTAACC,0,1090003
fldAp,0.3333333333333333,2,2,GGCAACCGGATATGTCAGTG,0,1162335
fldAp,0.3333333333333333,2,2,GGCAAATCTTCAGTTGATGG,0,1120042
fldAp,0.3333333333333333,2,2,GGCAAACCTTGGCTTCCCGC,0,1162657
fldAp,0.3333333333333333,2,2,GGATTTTCCCACGTCTACTC,0,1179200
fldAp,0.3333333333333333,2,2,GGATTTGAATGCTAAGATAG,0,1086275
fldAp,0.3333333333333333,2,2,GGATTTCAAGCGGCCCAGCA,0,1077800
fldAp,0.3333333333333333,2,2,GGATTTACTCTATGCCTTTT,0,1106396
fldAp,0.3333333333333333,2,2,GGATTCGATACACAGGAGTG,0,1073766
fldAp,0.3333333333333333,2,2,GGATTATTCTCCACATCATT,0,1067084
fldAp,0.3333333333333333,2,2,GGATGTTTATCCGTTCGCTC,0,1078069
fldAp,0.3333333333333333,2,2,GGATGTCTTATATAAAAGAC,0,1104980
fldAp,0.3333333333333333,2,2,GGATGTAAAATCAAGCTCGT,0,1090952
fldAp,0.3333333333333333,2,2,GGATGGCTTTTCCCTAGTAA,0,1066480
fldAp,0.3333333333333333,2,2,GGATGATGCGTTGTTCTGGA,0,1097089
fldAp,0.3333333333333333,2,2,GGATCGGCAAGAGCATTTAC,0,1151283
fldAp,0.3333333333333333,2,2,GGATCCACATGCACCATGGT,0,1179001
fldAp,0.3333333333333333,2,2,GGATATACTTCACCCACTTG,0,1064464
fldAp,0.3333333333333333,2,2,GGATAGAGGGGCTTTCCGGA,0,1142492
fldAp,0.3333333333333333,2,2,GGATAGACCCCTGAGGGAGT,0,1102579
fldAp,0.3333333333333333,2,2,GGATACCCAAAGTTGCCTTC,0,1134234
fldAp,0.3333333333333333,2,2,GGATAAGGATGAGTGGTGCG,0,1066664
fldAp,0.3333333333333333,2,2,GGATAAAGACTGTCCCAGTT,0,1153420
fldAp,0.3333333333333333,2,2,GGAGTTCATGGTTCAAAGCT,0,1104245
fldAp,0.3333333333333333,2,2,GGAGTTAGCCAGTGGTTCTC,0,1159051
fldAp,0.3333333333333333,2,2,GGAGGGTGCGTTGCACAGGC,0,1165080
fldAp,0.3333333333333333,2,2,GGAGATAATTGTTGAAGAAA,0,1127514
fldAp,0.3333333333333333,2,2,GGAGAAGATCCCATACGGTT,0,1156020
fldAp,0.3333333333333333,2,2,GGACTTGCGGGTCAAAGACC,0,1098742
fldAp,0.3333333333333333,2,2,GGACTGGCTTCCGCAGAACA,0,1171894
fldAp,0.3333333333333333,2,2,GGACGTTTGTTCCCCCGATT,0,1139293
fldAp,0.3333333333333333,2,2,GGACGTTCGCGGGAATATAA,0,1083553
fldAp,0.3333333333333333,2,2,GGACGCGCATTTTATTTGCC,0,1140161
fldAp,0.3333333333333333,2,2,GGACGCCTGAGAACGCCAGC,0,1096817
fldAp,0.3333333333333333,2,2,GGACGATCCGGGCGTACGCA,0,1137721
fldAp,0.3333333333333333,2,2,GGACCTGAATCAACCCACTC,0,1170314
fldAp,0.3333333333333333,2,2,GGACCGCCTTGTGCAGGATT,0,1077880
fldAp,0.3333333333333333,2,2,GGACCCCCACCAAGGTACGT,0,1073231
fldAp,0.3333333333333333,2,2,GGACCAAGAAAGGGCGCCGG,0,1078873
fldAp,0.3333333333333333,2,2,GGACCAAAAACATCTCCCAA,0,1087938
fldAp,0.3333333333333333,2,2,GGAATGAATGCTCCGTGTTG,0,1081867
fldAp,0.3333333333333333,2,2,GGAATAGGGGATGTGGGAGA,0,1096926
fldAp,0.3333333333333333,2,2,GGAATACGTTATCGGGTACA,0,1099790
fldAp,0.3333333333333333,2,2,GGAATAATTAGGGCATGGGT,0,1127335
fldAp,0.3333333333333333,2,2,GGAAGCGACGCAACGCGTGA,0,1070415
fldAp,0.3333333333333333,2,2,GGAAGCAAGGCGGACGCCTA,0,1181663
fldAp,0.3333333333333333,2,2,GGAACTTCGAACGCCCTTGA,0,1077694
fldAp,0.3333333333333333,2,2,GGAACAATAAACTGTGCATG,0,1080060
fldAp,0.3333333333333333,2,2,GGAAATAAAGACGTGCGATC,0,1142972
fldAp,0.3333333333333333,2,2,GGAAAGAACGCGGTGTGTGA,0,1067811
fldAp,0.3333333333333333,2,2,GGAAACTGGGGGCCAACTCC,0,1143641
fldAp,0.3333333333333333,2,2,GCTTTGGCCAGGGGTTGCCT,0,1181540
fldAp,0.3333333333333333,2,2,GCTTTGCTAGCTAGGTAATT,0,1107867
fldAp,0.3333333333333333,2,2,GCTTGTCTTGCAGCCGAGCG,0,1125968
fldAp,0.3333333333333333,2,2,GCTTGTAACATTACTATAGT,0,1147890
fldAp,0.3333333333333333,2,2,GCTTGGGCAAAAGACGGTTC,0,1137427
fldAp,0.3333333333333333,2,2,GCTTGCGGCTCACGGTTCCA,0,1117596
fldAp,0.3333333333333333,2,2,GCTTGCCCCCAGCTTAACCC,0,1106676
fldAp,0.3333333333333333,2,2,GCTTGCACAGATCAAAGCTT,0,1155307
fldAp,0.3333333333333333,2,2,GCTTGATCGTCTATACCGGT,0,1064962
fldAp,0.3333333333333333,2,2,GCTTCTATAGGCATTATCAT,0,1075430
fldAp,0.3333333333333333,2,2,GCTTCTAAAGAGTCGCTGTA,0,1066113
fldAp,0.3333333333333333,2,2,GCTTACGTGGATGAGAGAAT,0,1113055
fldAp,0.3333333333333333,2,2,GCTTACGTGGAGTCTTAAGC,0,1094672
fldAp,0.3333333333333333,2,2,GCTTACACAGTGTAACGGAT,0,1071868
fldAp,0.3333333333333333,2,2,GCTTAATTAGTTCAGTAGAG,0,1110225
fldAp,0.3333333333333333,2,2,GCTTAACACATTCACGTATG,0,1063741
fldAp,0.3333333333333333,2,2,GCTGTTATCTAGGGTTTCAT,0,1102086
fldAp,0.3333333333333333,2,2,GCTGTCTTGAGTGCCCCACA,0,1176305
fldAp,0.3333333333333333,2,2,GCTGTCGTTTGTTTCCTTGA,0,1080782
fldAp,0.3333333333333333,2,2,GCTGTCGGTGAGAGGGTAAT,0,1092385
fldAp,0.3333333333333333,2,2,GCTGTCAGCAACCAAGGAAG,0,1126915
fldAp,0.3333333333333333,2,2,GCTGGTCCCGCTCAGGCGGT,0,1171723
fldAp,0.3333333333333333,2,2,GCTGGTATCATATTAGTTAT,0,1117698
fldAp,0.3333333333333333,2,2,GCTGGACGCAACTCGCCACG,0,1115638
fldAp,0.3333333333333333,2,2,GCTGCTGTTATCGGCCGCAA,0,1071042
fldAp,0.3333333333333333,2,2,GCTGAGGGCGGAGACTAACC,0,1146048
fldAp,0.3333333333333333,2,2,GCTGAATATAGATTCGGAAA,0,1140303
fldAp,0.3333333333333333,2,2,GCTGAAGGTTGAGGATTAGA,0,1098025
fldAp,0.3333333333333333,2,2,GCTGAACGTCAATCGCGGAC,0,1181383
fldAp,0.3333333333333333,2,2,GCTCTCTGCAGTAGTTGGGA,0,1067551
fldAp,0.3333333333333333,2,2,GCTCGTTTATTCTTCGTATG,0,1170654
fldAp,0.3333333333333333,2,2,GCTCGTGAGAACAAATAGGT,0,1109224
fldAp,0.3333333333333333,2,2,GCTCGGCACTCGTTGACACT,0,1139894
fldAp,0.3333333333333333,2,2,GCTCGCTCCTCTAAATGACG,0,1148835
fldAp,0.3333333333333333,2,2,GCTCCTATATTTACATGTGT,0,1153686
fldAp,0.3333333333333333,2,2,GCTCCGTATACTGCGTTTAC,0,1070465
fldAp,0.3333333333333333,2,2,GCTCCGGAGCTTTTTGGTAT,0,1168620
fldAp,0.3333333333333333,2,2,GCTCCCTCGGTGTCTGATGG,0,1169276
fldAp,0.3333333333333333,2,2,GCTCATTGTGAAACTACTTT,0,1137633
fldAp,0.3333333333333333,2,2,GCTCATTGCCATGCCGGGGT,0,1155518
fldAp,0.3333333333333333,2,2,GCTCACACGTATACACAGTG,0,1064060
fldAp,0.3333333333333333,2,2,GCTCAACCGCCAAAGTCTTT,0,1116299
fldAp,0.3333333333333333,2,2,GCTCAACCAGTATGAGCAGC,0,1169992
fldAp,0.3333333333333333,2,2,GCTATGAGCGCGCAGCGAGG,0,1107801
fldAp,0.3333333333333333,2,2,GCTATAGTGCGCCCTGGGTA,0,1164460
fldAp,0.3333333333333333,2,2,GCTATAGCCCACGACCAATG,0,1162228
fldAp,0.3333333333333333,2,2,GCTAGAGGGTTAGCTGAGGC,0,1074958
fldAp,0.3333333333333333,2,2,GCTACTTGTCCTAGCACGTG,0,1075613
fldAp,0.3333333333333333,2,2,GCTACGCAGTATCTCGCGGC,0,1076512
fldAp,0.3333333333333333,2,2,GCTACAAGAGGACTCCTGTA,0,1172160
fldAp,0.3333333333333333,2,2,GCTAAGGGATTTAGCAGTAT,0,1153266
fldAp,0.3333333333333333,2,2,GCTAACGTGGAGACAGAATG,0,1154843
fldAp,0.3333333333333333,2,2,GCGTTTCCTAGGGAAAAGTC,0,1143917
fldAp,0.3333333333333333,2,2,GCGTTATCACCGTTAGCAAG,0,1175213
fldAp,0.3333333333333333,2,2,GCGTGATTTTTAGTGTTGAA,0,1089796
fldAp,0.3333333333333333,2,2,GCGTGATAGACTGCAAAATT,0,1093849
fldAp,0.3333333333333333,2,2,GCGTCTGAGCGTCTGGGTTG,0,1175930
fldAp,0.3333333333333333,2,2,GCGTCTCATCCCATTAGACA,0,1158443
fldAp,0.3333333333333333,2,2,GCGTCTATGAAGGTACGCGA,0,1167446
fldAp,0.3333333333333333,2,2,GCGTCGTGCAGATGTACGCA,0,1127147
fldAp,0.3333333333333333,2,2,GCGTCCGGACCCGTGGGCAT,0,1079009
fldAp,0.3333333333333333,2,2,GCGTCCGATCCAAGTCTGCC,0,1173869
fldAp,0.3333333333333333,2,2,GCGTAGGTTAACTTCATCAG,0,1150840
fldAp,0.3333333333333333,2,2,GCGTACGGGCAAGATGAGGC,0,1092735
fldAp,0.3333333333333333,2,2,GCGTAAGAACGCCGTATCAG,0,1100714
fldAp,0.3333333333333333,2,2,GCGGTGTAAGAGGAAGGGTG,0,1114987
fldAp,0.3333333333333333,2,2,GCGGGTTTATGTTGCCCGAC,0,1134855
fldAp,0.3333333333333333,2,2,GCGGGTTAACCTTCACCATC,0,1166098
fldAp,0.3333333333333333,2,2,GCGGGTACAGAACACGCATC,0,1108310
fldAp,0.3333333333333333,2,2,GCGGGCTTTGAAAAACGGGT,0,1142572
fldAp,0.3333333333333333,2,2,GCGGGCACTTAAGAACGGTG,0,1123852
fldAp,0.3333333333333333,2,2,GCGGGATACTGGAGACCAGT,0,1142067
fldAp,0.3333333333333333,2,2,GCGGGAATTTAGAATGGTTG,0,1088498
fldAp,0.3333333333333333,2,2,GCGGCCGCTCCGATATCCGG,0,1134120
fldAp,0.3333333333333333,2,2,GCGGACGCTTGGTTCTAAAG,0,1141524
fldAp,0.3333333333333333,2,2,GCGCTTTTAACCGACTCTCT,0,1142038
fldAp,0.3333333333333333,2,2,GCGCTTCTGACACATTCGGT,0,1147650
fldAp,0.3333333333333333,2,2,GCGCTTAGACTTTGAACAGA,0,1129332
fldAp,0.3333333333333333,2,2,GCGCGTGTTACCGACGTTTT,0,1167034
fldAp,0.3333333333333333,2,2,GCGCGTGTCTGGCTGGGAGT,0,1069978
fldAp,0.3333333333333333,2,2,GCGCCGAGGCGCAGTCTATG,0,1096338
fldAp,0.3333333333333333,2,2,GCGCCCCAAGCCGAATAATG,0,1117122
fldAp,0.3333333333333333,2,2,GCGCCAAGAAGCCCGGGGAT,0,1163507
fldAp,0.3333333333333333,2,2,GCGCCAACCGTTGTTCAGAA,0,1175872
fldAp,0.3333333333333333,2,2,GCGCACGGTTTCAGATATCA,0,1107428
fldAp,0.3333333333333333,2,2,GCGATTCTATGCATAGCTGA,0,1108101
fldAp,0.3333333333333333,2,2,GCGATGGGTGACAACAGTAA,0,1165904
fldAp,0.3333333333333333,2,2,GCGATATGCAGGGTTTACTC,0,1172211
fldAp,0.3333333333333333,2,2,GCGAGTGCCTCTGCAGCGTC,0,1116957
fldAp,0.3333333333333333,2,2,GCGAGTACTTTATAATGGTT,0,1065136
fldAp,0.3333333333333333,2,2,GCGAGATGTCCTCTCAGTTC,0,1110595
fldAp,0.3333333333333333,2,2,GCGACGAGGCACCCCTTGCA,0,1144996
fldAp,0.3333333333333333,2,2,GCGACGAGCTACGAGCGAGT,0,1103462
fldAp,0.3333333333333333,2,2,GCGACCGTAAATGCGCGATG,0,1106044
fldAp,0.3333333333333333,2,2,GCGACCCGAAACTGTACCGT,0,1103659
fldAp,0.3333333333333333,2,2,GCGACCAAAGTCCTAAAAGG,0,1064781
fldAp,0.3333333333333333,2,2,GCGAAGTGCACATGCCGCTT,0,1115603
fldAp,0.3333333333333333,2,2,GCGAAGGAAATAACATCGGA,0,1103251
fldAp,0.3333333333333333,2,2,GCGAAAGCTTAATCGGTGTT,0,1129103
fldAp,0.3333333333333333,2,2,GCCTTCCGATTACGGCTTGT,0,1077606
fldAp,0.3333333333333333,2,2,GCCTTAATCGCCCCCGTCCC,0,1181949
fldAp,0.3333333333333333,2,2,GCCTCGGAGTCTTGCATCAG,0,1130341
fldAp,0.3333333333333333,2,2,GCCTCGACCCTGGTCATACT,0,1088376
fldAp,0.3333333333333333,2,2,GCCTATTTCATCGGAGACTC,0,1182112
fldAp,0.3333333333333333,2,2,GCCTAGGCGTACACTCACAT,0,1123468
fldAp,0.3333333333333333,2,2,GCCTAGCTGTACTAGCTGCT,0,1080691
fldAp,0.3333333333333333,2,2,GCCTAAGAAGTTCCCTCTCT,0,1146810
fldAp,0.3333333333333333,2,2,GCCGTTGTAATCCCGCTTCA,0,1135331
fldAp,0.3333333333333333,2,2,GCCGTGGGGATCTGGTTGTT,0,1077401
fldAp,0.3333333333333333,2,2,GCCGGTTCCGTTGCGAGTTT,0,1137597
fldAp,0.3333333333333333,2,2,GCCGGTTCAACTTATCTACG,0,1100924
fldAp,0.3333333333333333,2,2,GCCGGGTTGGGAGTTCGGCT,0,1171492
fldAp,0.3333333333333333,2,2,GCCGGGAGTTATAATACAGC,0,1176357
fldAp,0.3333333333333333,2,2,GCCGGCTGGCTTTCCAGTCC,0,1161269
fldAp,0.3333333333333333,2,2,GCCGCTTGTCACATTTATAT,0,1076071
fldAp,0.3333333333333333,2,2,GCCGCTTCGCCCTATTAGTG,0,1123048
fldAp,0.3333333333333333,2,2,GCCGCGGGTCTGGGGACCTG,0,1086086
fldAp,0.3333333333333333,2,2,GCCGCCCTACGGTTTGAGGG,0,1138469
fldAp,0.3333333333333333,2,2,GCCGAGCCAGAAAGGAGAGT,0,1087270
fldAp,0.3333333333333333,2,2,GCCCTTCAGTCTGATTCGGT,0,1113828
fldAp,0.3333333333333333,2,2,GCCCTTACTACTTGAACGTT,0,1114181
fldAp,0.3333333333333333,2,2,GCCCTCCGGGGCTGCCGGAG,0,1140991
fldAp,0.3333333333333333,2,2,GCCCTAACAGAGAAAGGATG,0,1157425
fldAp,0.3333333333333333,2,2,GCCCGTTTGACGTCACGAAT,0,1127737
fldAp,0.3333333333333333,2,2,GCCCGTTTAGCTCCGTATCA,0,1127237
fldAp,0.3333333333333333,2,2,GCCCGCTCCGTATATAGTAC,0,1139560
fldAp,0.3333333333333333,2,2,GCCCCTTGTGCACGAAGTAG,0,1065074
fldAp,0.3333333333333333,2,2,GCCCCTTCTTCGGCGGCGCG,0,1066118
fldAp,0.3333333333333333,2,2,GCCCCGTACCGCGGACATCC,0,1099585
fldAp,0.3333333333333333,2,2,GCCCCCGCCAGTCTCGTTTC,0,1102439
fldAp,0.3333333333333333,2,2,GCCCAAATCGGCGGTACCTT,0,1065156
fldAp,0.3333333333333333,2,2,GCCATTCGAGTGAACTCCTG,0,1101040
fldAp,0.3333333333333333,2,2,GCCATCTGAATTTTCCTATA,0,1150472
fldAp,0.3333333333333333,2,2,GCCATCTCTGTAAGATTAAG,0,1174455
fldAp,0.3333333333333333,2,2,GCCATATAAACTCAACCGAC,0,1156245
fldAp,0.3333333333333333,2,2,GCCATACTAGCCGACCTTCA,0,1167964
fldAp,0.3333333333333333,2,2,GCCAGGGGACGTTACCCTCA,0,1083420
fldAp,0.3333333333333333,2,2,GCCAGGACCCATGATCTGCC,0,1179895
fldAp,0.3333333333333333,2,2,GCCAGCAGCCTCGTTACTCA,0,1159732
fldAp,0.3333333333333333,2,2,GCCAGACCGGGGTATACGAA,0,1182728
fldAp,0.3333333333333333,2,2,GCCACTTCCGCGCATAAGGA,0,1170869
fldAp,0.3333333333333333,2,2,GCCACTGATAAATTTTGAAT,0,1160565
fldAp,0.3333333333333333,2,2,GCCACTGACCCGGGAAGTGA,0,1160576
fldAp,0.3333333333333333,2,2,GCCACTACCCTACACGTTAC,0,1123240
fldAp,0.3333333333333333,2,2,GCCACCTCTGATAGGATTCC,0,1157699
fldAp,0.3333333333333333,2,2,GCCACCTATCGCATCTGCTC,0,1175189
fldAp,0.3333333333333333,2,2,GCCACCCATAAAGCACTACC,0,1119892
fldAp,0.3333333333333333,2,2,GCCACCAGCGCACTTTCGAG,0,1132046
fldAp,0.3333333333333333,2,2,GCCACATATGCTGTTCCGAT,0,1085008
fldAp,0.3333333333333333,2,2,GCCACAGGTGTCACGCACGG,0,1144119
fldAp,0.3333333333333333,2,2,GCCACACATTGATGGCTACT,0,1078563
fldAp,0.3333333333333333,2,2,GCCAATGAAGGACCTCTTTA,0,1140415
fldAp,0.3333333333333333,2,2,GCCAATAATAACAATCCGGA,0,1069801
fldAp,0.3333333333333333,2,2,GCCAATAAACTCGGAGGGGG,0,1067689
fldAp,0.3333333333333333,2,2,GCATTGGAGCATTGTACTAA,0,1087633
fldAp,0.3333333333333333,2,2,GCATTCGGACACCCCGGGGA,0,1077365
fldAp,0.3333333333333333,2,2,GCATTCGCCGCGGTTCCAAA,0,1167011
fldAp,0.3333333333333333,2,2,GCATGTGCAGCGGTAGCAAT,0,1185135
fldAp,0.3333333333333333,2,2,GCATGTATTTCCGACGCGCT,0,1182927
fldAp,0.3333333333333333,2,2,GCATGGTTGGAAAGTACCTT,0,1107959
fldAp,0.3333333333333333,2,2,GCATGGGAGCAAGGAACGAG,0,1109551
fldAp,0.3333333333333333,2,2,GCATGCAGTTCGCACTGGGG,0,1121599
fldAp,0.3333333333333333,2,2,GCATGATTAATCGTAGAACC,0,1136461
fldAp,0.3333333333333333,2,2,GCATGATAACTTCATTAACT,0,1182428
fldAp,0.3333333333333333,2,2,GCATCTCATGAAGGTGTCCC,0,1170049
fldAp,0.3333333333333333,2,2,GCATCGGCAGCACAAACACT,0,1070528
fldAp,0.3333333333333333,2,2,GCATCGCTGATCTCTGTTCT,0,1111280
fldAp,0.3333333333333333,2,2,GCATCATAAGCCCATATCAA,0,1070180
fldAp,0.3333333333333333,2,2,GCATATGGATAGGTATTTCC,0,1184543
fldAp,0.3333333333333333,2,2,GCATATAGGACGTCAGGGGA,0,1067040
fldAp,0.3333333333333333,2,2,GCATAGCCGTAGACGGGGAT,0,1067694
fldAp,0.3333333333333333,2,2,GCAGTGTGCCGATTGTGGCG,0,1132720
fldAp,0.3333333333333333,2,2,GCAGTGCTGACGTGGCACAA,0,1111141
fldAp,0.3333333333333333,2,2,GCAGGTGGTCAGAATTTGTC,0,1123323
fldAp,0.3333333333333333,2,2,GCAGGTACTCCTTAGAAGAT,0,1140192
fldAp,0.3333333333333333,2,2,GCAGGGACACCCTCGTAGCA,0,1170807
fldAp,0.3333333333333333,2,2,GCAGGCTCCAATTTAACGGT,0,1152774
fldAp,0.3333333333333333,2,2,GCAGGACGCCTAAGTCTCGA,0,1138193
fldAp,0.3333333333333333,2,2,GCAGCTGATGCCTCTTACAG,0,1106784
fldAp,0.3333333333333333,2,2,GCAGCTCTCGGTCTCTAAAC,0,1070459
fldAp,0.3333333333333333,2,2,GCAGCGTTCTGATCTGAGAA,0,1087027
fldAp,0.3333333333333333,2,2,GCAGCGTCGGGAATTTCACC,0,1148291
fldAp,0.3333333333333333,2,2,GCAGATTATTTACGATCAAG,0,1139962
fldAp,0.3333333333333333,2,2,GCAGATGCTTATGCGGATCA,0,1126100
fldAp,0.3333333333333333,2,2,GCAGACATACCTTTGCGATG,0,1104318
fldAp,0.3333333333333333,2,2,GCAGAATTATTTCGTTTGGT,0,1130739
fldAp,0.3333333333333333,2,2,GCAGAACCACGGGCCTATGT,0,1083090
fldAp,0.3333333333333333,2,2,GCACTGCAGACTGCTTGTTG,0,1144708
fldAp,0.3333333333333333,2,2,GCACTCTCCCGCACGAAAGT,0,1174179
fldAp,0.3333333333333333,2,2,GCACTAGGTCAGCCCTCAAG,0,1172190
fldAp,0.3333333333333333,2,2,GCACTAGGGAAGTATTTCCA,0,1165774
fldAp,0.3333333333333333,2,2,GCACGTTCATTCGGCTCTCG,0,1142086
fldAp,0.3333333333333333,2,2,GCACGTGACCGTAAGGACAA,0,1142178
fldAp,0.3333333333333333,2,2,GCACGGGAAGCAAGGAAAAC,0,1096054
fldAp,0.3333333333333333,2,2,GCACGCCTTGCGATCCAAGT,0,1104779
fldAp,0.3333333333333333,2,2,GCACATCTGCATTATTAGGT,0,1081672
fldAp,0.3333333333333333,2,2,GCACAGGGGCGGCACAGACT,0,1100248
fldAp,0.3333333333333333,2,2,GCACACCGGCTCGGACAAGA,0,1068006
fldAp,0.3333333333333333,2,2,GCACAAGGGGGCTTGGAGAG,0,1091249
fldAp,0.3333333333333333,2,2,GCACAACTGCTACCATAGCA,0,1148108
fldAp,0.3333333333333333,2,2,GCAATCAGAATTTATTTACC,0,1145829
fldAp,0.3333333333333333,2,2,GCAATAGTTGGGCTCAGCAT,0,1076872
fldAp,0.3333333333333333,2,2,GCAATACAACATTGCATCAG,0,1182128
fldAp,0.3333333333333333,2,2,GCAATAACGCGTATAAGGCT,0,1171481
fldAp,0.3333333333333333,2,2,GCAAGTGACTTTCACTGTTA,0,1147319
fldAp,0.3333333333333333,2,2,GCAACGGCCTACCTTGCCCC,0,1091263
fldAp,0.3333333333333333,2,2,GCAACAGTCATGCAATGACA,0,1083197
fldAp,0.3333333333333333,2,2,GCAAAGAGCGATAGGTGAAC,0,1136824
fldAp,0.3333333333333333,2,2,GCAAACATACGTGCAATAAA,0,1129415
fldAp,0.3333333333333333,2,2,GATTTTCCGCTCAACTCAGC,0,1079905
fldAp,0.3333333333333333,2,2,GATTTTCATCAGTAGGAATT,0,1135400
fldAp,0.3333333333333333,2,2,GATTTTATGGTGCACCAAGA,0,1183945
fldAp,0.3333333333333333,2,2,GATTTTATAGGCAACGTTAA,0,1075999
fldAp,0.3333333333333333,2,2,GATTTGGTTGGTGGTTTATG,0,1168506
fldAp,0.3333333333333333,2,2,GATTTATTCTGTTATCGCAG,0,1110013
fldAp,0.3333333333333333,2,2,GATTTAGAGTGTTCAGTAAT,0,1083106
fldAp,0.3333333333333333,2,2,GATTCAACAACGAATCCTAC,0,1088031
fldAp,0.3333333333333333,2,2,GATTATTGTACCCAAGTCAG,0,1094139
fldAp,0.3333333333333333,2,2,GATTATGATTCGTCCTTCTA,0,1063071
fldAp,0.3333333333333333,2,2,GATTATCTTCTACGTATTGG,0,1092470
fldAp,0.3333333333333333,2,2,GATTATCGGTGTCGGTACAA,0,1174679
fldAp,0.3333333333333333,2,2,GATTATAGACGGAATTTATA,0,1182730
fldAp,0.3333333333333333,2,2,GATTAGCTGAGAAAAGGATC,0,1180201
fldAp,0.3333333333333333,2,2,GATTAGAATTTGACTGTCCG,0,1182358
fldAp,0.3333333333333333,2,2,GATTAAGAGGAACAGTCACC,0,1073732
fldAp,0.3333333333333333,2,2,GATTAAATTACGACGACCGG,0,1128352
fldAp,0.3333333333333333,2,2,GATGTTAACAAGAATACAGT,0,1124810
fldAp,0.3333333333333333,2,2,GATGGTCCTGAGTGGGTCTT,0,1079547
fldAp,0.3333333333333333,2,2,GATGGGCGGTGCCGATTTTC,0,1101019
fldAp,0.3333333333333333,2,2,GATGGGAGCTATCATTACTA,0,1064689
fldAp,0.3333333333333333,2,2,GATGGCCCTTATGATCCGGC,0,1143923
fldAp,0.3333333333333333,2,2,GATGCATAGGGCACTCCCAG,0,1118116
fldAp,0.3333333333333333,2,2,GATGCAGGCGTCGTGTTAGT,0,1161121
fldAp,0.3333333333333333,2,2,GATGAGGCCGGAGGCTGAGT,0,1167986
fldAp,0.3333333333333333,2,2,GATGACCTCATTGCGTCCAG,0,1159209
fldAp,0.3333333333333333,2,2,GATCTTCGGCAGTATCCAAT,0,1110048
fldAp,0.3333333333333333,2,2,GATCTTAGACGCGCAAACAC,0,1073528
fldAp,0.3333333333333333,2,2,GATCGCGCTGGTCCGCTGAT,0,1139804
fldAp,0.3333333333333333,2,2,GATCGCACAGGAACCCTTGT,0,1088510
fldAp,0.3333333333333333,2,2,GATCGAGTGTCTGGGGAATC,0,1072935
fldAp,0.3333333333333333,2,2,GATCCATGTCGTTTCAGAAT,0,1077623
fldAp,0.3333333333333333,2,2,GATCCAGGCGAGTCGTTCAA,0,1184338
fldAp,0.3333333333333333,2,2,GATCCAAATATTGAAGGTGT,0,1068557
fldAp,0.3333333333333333,2,2,GATCATGTCTCCGACCCTCG,0,1181644
fldAp,0.3333333333333333,2,2,GATCAGTTATTTTGGCGAAA,0,1150402
fldAp,0.3333333333333333,2,2,GATCAGGATATGTTCGCGGC,0,1158612
fldAp,0.3333333333333333,2,2,GATCACACAAAGTTTCACAC,0,1082117
fldAp,0.3333333333333333,2,2,GATCACAACAAACCTGTTCA,0,1149884
fldAp,0.3333333333333333,2,2,GATATGATCGCCTTGGTTGA,0,1106500
fldAp,0.3333333333333333,2,2,GATAGCGGGGCACTCTGGTT,0,1125574
fldAp,0.3333333333333333,2,2,GATAGAGAGACCGTGCACCT,0,1097681
fldAp,0.3333333333333333,2,2,GATACTTTCTAGGTGACTAG,0,1123510
fldAp,0.3333333333333333,2,2,GATACGTGCGGGATTACGAT,0,1110944
fldAp,0.3333333333333333,2,2,GATAATGTGCGGAGAAATCT,0,1106290
fldAp,0.3333333333333333,2,2,GATAATGAAAGAGGCGGATT,0,1074278
fldAp,0.3333333333333333,2,2,GATAATCATGGCCAGAGACC,0,1129041
fldAp,0.3333333333333333,2,2,GATAAGTCAATGTAGGCCAA,0,1162451
fldAp,0.3333333333333333,2,2,GATAACTTTTTTATCTGCGG,0,1112517
fldAp,0.3333333333333333,2,2,GATAACTCCATTGGGGCACT,0,1157171
fldAp,0.3333333333333333,2,2,GATAAAGGGCTTGCAGCCAA,0,1121278
fldAp,0.3333333333333333,2,2,GAGTTTTAGCCATTGCGCTC,0,1082684
fldAp,0.3333333333333333,2,2,GAGTTTGGGAACACTCGCCC,0,1068345
fldAp,0.3333333333333333,2,2,GAGTTGAAAGTGGACCATTG,0,1092789
fldAp,0.3333333333333333,2,2,GAGTTCGTCCTTGAAAGGCA,0,1068469
fldAp,0.3333333333333333,2,2,GAGTTCGGGGGACCAGCCGG,0,1178322
fldAp,0.3333333333333333,2,2,GAGTTCCTTGGGTAGTTTGC,0,1112501
fldAp,0.3333333333333333,2,2,GAGTTAGAGTAAGTTGATCG,0,1136426
fldAp,0.3333333333333333,2,2,GAGTGTGTGGTACCAGGGTC,0,1127118
fldAp,0.3333333333333333,2,2,GAGTGCAGCGGGAAGCTACT,0,1134095
fldAp,0.3333333333333333,2,2,GAGTCTTGGTTTCACCTGGT,0,1121980
fldAp,0.3333333333333333,2,2,GAGTCGTCGTGCAGTTAAGG,0,1168159
fldAp,0.3333333333333333,2,2,GAGTCATAGGCTACCTGGGA,0,1136701
fldAp,0.3333333333333333,2,2,GAGTCACTGATTTTCACCGA,0,1107199
fldAp,0.3333333333333333,2,2,GAGTAGAAGCATAGTCGCGT,0,1103450
fldAp,0.3333333333333333,2,2,GAGGTGTTCGACTGGATTAT,0,1153692
fldAp,0.3333333333333333,2,2,GAGGGTGAATTCGTCTATGG,0,1184649
fldAp,0.3333333333333333,2,2,GAGGGTCTTTAAATCGCATA,0,1096045
fldAp,0.3333333333333333,2,2,GAGGGGACGGATGGTAATAA,0,1183871
fldAp,0.3333333333333333,2,2,GAGGGCAAACTGTAAAACCC,0,1164838
fldAp,0.3333333333333333,2,2,GAGGGATCGGAGACGTCTAA,0,1100568
fldAp,0.3333333333333333,2,2,GAGGCTCTGGGGTCCAGCTT,0,1118201
fldAp,0.3333333333333333,2,2,GAGGCCTTCGGCGGTCGGTG,0,1091612
fldAp,0.3333333333333333,2,2,GAGGCAATAGGTCCTCATCC,0,1086671
fldAp,0.3333333333333333,2,2,GAGGATGGAAGTGGGTCGTA,0,1121434
fldAp,0.3333333333333333,2,2,GAGCTGCCGCCCCGGGTAAG,0,1097873
fldAp,0.3333333333333333,2,2,GAGCTCAGGGTACAAGCAGT,0,1182041
fldAp,0.3333333333333333,2,2,GAGCTATCATTCTAAGGTGG,0,1096025
fldAp,0.3333333333333333,2,2,GAGCGTTAAATAACCGTCAT,0,1164675
fldAp,0.3333333333333333,2,2,GAGCGGATCGGTACGTCACT,0,1078212
fldAp,0.3333333333333333,2,2,GAGCCGGTCCGAACCAAGTT,0,1118016
fldAp,0.3333333333333333,2,2,GAGCCCTCAGCGGAACATAT,0,1157398
fldAp,0.3333333333333333,2,2,GAGCCACTTACTGGATGGTT,0,1149492
fldAp,0.3333333333333333,2,2,GAGATTAGCAAGAGAATCTT,0,1181536
fldAp,0.3333333333333333,2,2,GAGATCCCCCGTGTTATATT,0,1075800
fldAp,0.3333333333333333,2,2,GAGATATATGGAACGACAGG,0,1078262
fldAp,0.3333333333333333,2,2,GAGATAGACAGCTGTCTCTC,0,1084017
fldAp,0.3333333333333333,2,2,GAGATACCGTCACATAGAAA,0,1093630
fldAp,0.3333333333333333,2,2,GAGATAATTAGGCGGTAGTC,0,1125678
fldAp,0.3333333333333333,2,2,GAGAGTGGGCGGCCCCAGAA,0,1173538
fldAp,0.3333333333333333,2,2,GAGAGCGCGGGCGTCCGAAA,0,1119870
fldAp,0.3333333333333333,2,2,GAGAGAATCCTTGAACCGAA,0,1134766
fldAp,0.3333333333333333,2,2,GAGACTTCATACTATACTAT,0,1125597
fldAp,0.3333333333333333,2,2,GAGACGTTTGGCCCATTTTC,0,1119686
fldAp,0.3333333333333333,2,2,GAGACCGCGTGAGGGTCGGG,0,1142999
fldAp,0.3333333333333333,2,2,GAGAATCCGTGGAGTCCGGT,0,1084099
fldAp,0.3333333333333333,2,2,GAGAACTTCACTGCCTTCGA,0,1103330
fldAp,0.3333333333333333,2,2,GAGAACTATCTATTACCCAA,0,1174737
fldAp,0.3333333333333333,2,2,GAGAAAGGAGGGGATGCATT,0,1107999
fldAp,0.3333333333333333,2,2,GAGAAACATGCCACTACTTC,0,1064197
fldAp,0.3333333333333333,2,2,GACTTGTAAACACTACTTAG,0,1184533
fldAp,0.3333333333333333,2,2,GACTTGGGAAAGGAACCAGG,0,1080285
fldAp,0.3333333333333333,2,2,GACTTCGCTAGCATTTGAAT,0,1112507
fldAp,0.3333333333333333,2,2,GACTGTCCACAGTCGGGAAC,0,1082774
fldAp,0.3333333333333333,2,2,GACTGTATTTGGTGAGACGG,0,1067474
fldAp,0.3333333333333333,2,2,GACTGGGCCTATCTACAAGA,0,1155163
fldAp,0.3333333333333333,2,2,GACTGCATCTCTGCGAACCT,0,1134431
fldAp,0.3333333333333333,2,2,GACTGATGGCTTTGTTCACT,0,1154985
fldAp,0.3333333333333333,2,2,GACTCTCACGGCAATATTAT,0,1150408
fldAp,0.3333333333333333,2,2,GACTCGTCTGCTTTAGTTAT,0,1076634
fldAp,0.3333333333333333,2,2,GACTCCAAGCTGTGTCCTGG,0,1101596
fldAp,0.3333333333333333,2,2,GACTATCACCCTAACTTATA,0,1084564
fldAp,0.3333333333333333,2,2,GACTAGGTAATCCTCATCTT,0,1068347
fldAp,0.3333333333333333,2,2,GACTACGGGTACCGTAATTA,0,1103400
fldAp,0.3333333333333333,2,2,GACTACGAGACAGCGTGACG,0,1094644
fldAp,0.3333333333333333,2,2,GACTACGAAGTGCCGTTGTT,0,1161196
fldAp,0.3333333333333333,2,2,GACTACCTTCGGGTCAATTG,0,1087060
fldAp,0.3333333333333333,2,2,GACTACCTTCGGCCATCAGA,0,1133077
fldAp,0.3333333333333333,2,2,GACTAATTGAACTCAATGAC,0,1157668
fldAp,0.3333333333333333,2,2,GACGTTCCTGCGTTGCAGCT,0,1148188
fldAp,0.3333333333333333,2,2,GACGTCGATTCCTCCCGTGG,0,1075748
fldAp,0.3333333333333333,2,2,GACGTCCAGCTTACCATTAG,0,1174416
fldAp,0.3333333333333333,2,2,GACGTCAGTCCGACAAGGGG,0,1098890
fldAp,0.3333333333333333,2,2,GACGCTCCACCTGCACTGTC,0,1140550
fldAp,0.3333333333333333,2,2,GACGCGAATCACGGGAACCT,0,1163519
fldAp,0.3333333333333333,2,2,GACGAGCGTCTGTGCTAGCC,0,1079785
fldAp,0.3333333333333333,2,2,GACGACATTACCACTCGCGC,0,1184989
fldAp,0.3333333333333333,2,2,GACCTTCGTCGAAACAGGGT,0,1175030
fldAp,0.3333333333333333,2,2,GACCTGTTGCTTGCGGTAAG,0,1090601
fldAp,0.3333333333333333,2,2,GACCTGGGATTAATCCAGGG,0,1110605
fldAp,0.3333333333333333,2,2,GACCTGCGGAGGCTCATCGT,0,1125702
fldAp,0.3333333333333333,2,2,GACCTGACTGGGGATGGTGA,0,1073392
fldAp,0.3333333333333333,2,2,GACCTGAAAAGGTCACCTGA,0,1138027
fldAp,0.3333333333333333,2,2,GACCTCACCTCCACGGGGCT,0,1170823
fldAp,0.3333333333333333,2,2,GACCTCACAAACAAGCTGGC,0,1143768
fldAp,0.3333333333333333,2,2,GACCCGAAGGTACCTGGTTA,0,1063766
fldAp,0.3333333333333333,2,2,GACATTTGTGAAAGGAGCTC,0,1167558
fldAp,0.3333333333333333,2,2,GACATTCTTGGCCCTAGAGG,0,1085006
fldAp,0.3333333333333333,2,2,GACATCCTCGCCAATCGATA,0,1149191
fldAp,0.3333333333333333,2,2,GACAGGGATAGGACCAATCG,0,1148574
fldAp,0.3333333333333333,2,2,GACAGCTTCGCCAAGCCGGC,0,1086799
fldAp,0.3333333333333333,2,2,GACAGCCCCGCCCGGGCTTC,0,1063288
fldAp,0.3333333333333333,2,2,GACACGAGCAAGGTCGATTA,0,1104722
fldAp,0.3333333333333333,2,2,GACACGACGTTCATTCTTTT,0,1181241
fldAp,0.3333333333333333,2,2,GACAAGGGACTCAACTGCTA,0,1151801
fldAp,0.3333333333333333,2,2,GACAACGCCCTAATAAGGAG,0,1095332
fldAp,0.3333333333333333,2,2,GACAAAGATATCGAAACCTA,0,1156062
fldAp,0.3333333333333333,2,2,GACAAACCGTTGTTCGCACG,0,1152411
fldAp,0.3333333333333333,2,2,GAATTGGCTGTTCGCGTGAG,0,1116480
fldAp,0.3333333333333333,2,2,GAATTAACTGCAATGCGGGG,0,1079138
fldAp,0.3333333333333333,2,2,GAATGTGCCTCTTTTGTGTA,0,1085521
fldAp,0.3333333333333333,2,2,GAATGGAGGCGACGTTTGTG,0,1064460
fldAp,0.3333333333333333,2,2,GAATGATATGCGTTCATTTG,0,1150546
fldAp,0.3333333333333333,2,2,GAATGAAATGTTGCACCCTC,0,1092242
fldAp,0.3333333333333333,2,2,GAATCTAACACATTTCGAGC,0,1164264
fldAp,0.3333333333333333,2,2,GAATCGATCAGACGGCTTCC,0,1140268
fldAp,0.3333333333333333,2,2,GAATCAATGATCCTTGAAGC,0,1129707
fldAp,0.3333333333333333,2,2,GAATAGGCATCTGAGAATGG,0,1155774
fldAp,0.3333333333333333,2,2,GAAGTTTCGCTTCGCTTAAG,0,1175562
fldAp,0.3333333333333333,2,2,GAAGTGTAACGAACATTCTG,0,1172921
fldAp,0.3333333333333333,2,2,GAAGGGCATAGGTATAGCGC,0,1133323
fldAp,0.3333333333333333,2,2,GAAGGCGGTTTGCAGGTCAC,0,1095362
fldAp,0.3333333333333333,2,2,GAAGGACCCGTGCGCGCGGC,0,1125406
fldAp,0.3333333333333333,2,2,GAAGGAATACGGAACAGCGA,0,1067295
fldAp,0.3333333333333333,2,2,GAAGCGTTCCGGTGTTGTCT,0,1122919
fldAp,0.3333333333333333,2,2,GAAGCGCGGACTACGGGGGA,0,1121606
fldAp,0.3333333333333333,2,2,GAAGCGAAATTCGTATGACG,0,1135443
fldAp,0.3333333333333333,2,2,GAAGCCCTCCCCCCCCGCTA,0,1102164
fldAp,0.3333333333333333,2,2,GAAGAAGTGATACCCCGCTG,0,1108463
fldAp,0.3333333333333333,2,2,GAACTTTCCCAACATTGCCC,0,1093296
fldAp,0.3333333333333333,2,2,GAACTCCCCAACTTCTTTCG,0,1074117
fldAp,0.3333333333333333,2,2,GAACTATGGTTAGGATCGCT,0,1088734
fldAp,0.3333333333333333,2,2,GAACGTACGGTCACTATAAC,0,1080283
fldAp,0.3333333333333333,2,2,GAACGTAAGCGACTTTAAAG,0,1119498
fldAp,0.3333333333333333,2,2,GAACGGATCCTTCCAGTTCA,0,1132879
fldAp,0.3333333333333333,2,2,GAACCTATTCGGGGTTCCCA,0,1147368
fldAp,0.3333333333333333,2,2,GAACCTAGGCTACGACGGTT,0,1108777
fldAp,0.3333333333333333,2,2,GAACCGAGTGCTTGAGCCTT,0,1090302
fldAp,0.3333333333333333,2,2,GAACCCCATGCTTCGCGGCT,0,1150769
fldAp,0.3333333333333333,2,2,GAACATGTCGCTCCGTCGGT,0,1180830
fldAp,0.3333333333333333,2,2,GAAATGGCTAACACGTTCAA,0,1146608
fldAp,0.3333333333333333,2,2,GAAATGCTGACCGATAACCT,0,1185399
fldAp,0.3333333333333333,2,2,GAAATCCTCACTCAATTCCG,0,1095039
fldAp,0.3333333333333333,2,2,GAAATAGACAGTACTATGTA,0,1068674
fldAp,0.3333333333333333,2,2,GAAAGCGCCCTAAAGCGGAA,0,1094082
fldAp,0.3333333333333333,2,2,GAAACGATGTCACACCACAA,0,1164715
fldAp,0.3333333333333333,2,2,GAAAATTCGATGCCCGATCA,0,1099636
fldAp,0.3333333333333333,2,2,CTTTTATGCCCGGTCGGCGT,0,1161055
fldAp,0.3333333333333333,2,2,CTTTTAGATATTCGGTACTC,0,1124502
fldAp,0.3333333333333333,2,2,CTTTTAACTTCCAACTCTTA,0,1125595
fldAp,0.3333333333333333,2,2,CTTTGGGACGCCCGAGAGAT,0,1085260
fldAp,0.3333333333333333,2,2,CTTTGCGTTGAGGTCGCCAA,0,1090077
fldAp,0.3333333333333333,2,2,CTTTGCAACGCCCGTCCGTA,0,1082223
fldAp,0.3333333333333333,2,2,CTTTGATTGCGGAACGGAAC,0,1087220
fldAp,0.3333333333333333,2,2,CTTTGATCTGAAGTACTTCA,0,1079117
fldAp,0.3333333333333333,2,2,CTTTCTTAGTCAGTGCCGGA,0,1146584
fldAp,0.3333333333333333,2,2,CTTTCTAGATATGACGGGTG,0,1098873
fldAp,0.3333333333333333,2,2,CTTTCTACTCAGCGGGCCAA,0,1124761
fldAp,0.3333333333333333,2,2,CTTTCGACGATCTAGCGAAT,0,1116715
fldAp,0.3333333333333333,2,2,CTTTCCTTACGAAAGTAGAT,0,1155345
fldAp,0.3333333333333333,2,2,CTTTCCGTTGTTGCATCGGG,0,1182246
fldAp,0.3333333333333333,2,2,CTTTCCCATACCTCTCATAT,0,1159903
fldAp,0.3333333333333333,2,2,CTTTATATTTCGTGGAATAA,0,1120842
fldAp,0.3333333333333333,2,2,CTTTAGCACTATTGAGCTTG,0,1173646
fldAp,0.3333333333333333,2,2,CTTTAGAACTAATTATACGT,0,1170254
fldAp,0.3333333333333333,2,2,CTTTACTCATAGGCGCCCGA,0,1079012
fldAp,0.3333333333333333,2,2,CTTTAAGAGTAATCGATTTT,0,1147995
fldAp,0.3333333333333333,2,2,CTTGTTAGAGCAATCAGGAC,0,1101142
fldAp,0.3333333333333333,2,2,CTTGTCGGGTATGTACGCAT,0,1093214
fldAp,0.3333333333333333,2,2,CTTGTCCCAACTTATCAATG,0,1173571
fldAp,0.3333333333333333,2,2,CTTGTCCATATTTACAAGGA,0,1107106
fldAp,0.3333333333333333,2,2,CTTGTAGCTGCACGGTTCCA,0,1151448
fldAp,0.3333333333333333,2,2,CTTGGGGTCATTACGGGATT,0,1148804
fldAp,0.3333333333333333,2,2,CTTGGGATAATACGTGGTTC,0,1166977
fldAp,0.3333333333333333,2,2,CTTGCGGTGGCCGCGCCCAT,0,1174315
fldAp,0.3333333333333333,2,2,CTTCTTCAGTTACGCAAACC,0,1153527
fldAp,0.3333333333333333,2,2,CTTCTGCTTGGGACCGGTTG,0,1127181
fldAp,0.3333333333333333,2,2,CTTCTAATTTTTCGCTCGGT,0,1149189
fldAp,0.3333333333333333,2,2,CTTCTAAACTGGCACAACTC,0,1115840
fldAp,0.3333333333333333,2,2,CTTCGTCGCCAGCGGTCGGC,0,1094502
fldAp,0.3333333333333333,2,2,CTTCGGTCCCTTCAACTACG,0,1093623
fldAp,0.3333333333333333,2,2,CTTCGGATTAACCACAAAAT,0,1159284
fldAp,0.3333333333333333,2,2,CTTCCTCTGGACAAGACGTT,0,1097580
fldAp,0.3333333333333333,2,2,CTTCCGATGACGGTGACATG,0,1175178
fldAp,0.3333333333333333,2,2,CTTCCCCCGCGTCCTGGGCA,0,1063620
fldAp,0.3333333333333333,2,2,CTTCATGTTTGACCAGTGTC,0,1183578
fldAp,0.3333333333333333,2,2,CTTCATCGCGATCTGTCGCT,0,1091713
fldAp,0.3333333333333333,2,2,CTTCATATAACTCGTGTCTG,0,1124852
fldAp,0.3333333333333333,2,2,CTTCAGGGGAGTTGGGCTAT,0,1166976
fldAp,0.3333333333333333,2,2,CTTCACTGCACGCATCGCTA,0,1112028
fldAp,0.3333333333333333,2,2,CTTATGGCCCACAATGAGTG,0,1134020
fldAp,0.3333333333333333,2,2,CTTATGAGTTGTTCGGGTAG,0,1186055
fldAp,0.3333333333333333,2,2,CTTAGTGCGCAGTAATGGGT,0,1096910
fldAp,0.3333333333333333,2,2,CTTAGTCAGACTCCAAGTAA,0,1068247
fldAp,0.3333333333333333,2,2,CTTAGCAGGGGTTGCAACAA,0,1111964
fldAp,0.3333333333333333,2,2,CTTACCTGGGTCGGTCAGGA,0,1145050
fldAp,0.3333333333333333,2,2,CTTACCAATCACGGGAATCT,0,1177940
fldAp,0.3333333333333333,2,2,CTTAAGGGACCAAGAACTCG,0,1143387
fldAp,0.3333333333333333,2,2,CTTAACATTGCAGATCTTAA,0,1119640
fldAp,0.3333333333333333,2,2,CTTAAACTGCCGGTGAATAT,0,1103898
fldAp,0.3333333333333333,2,2,CTTAAACTAGCATAACCACA,0,1081091
fldAp,0.3333333333333333,2,2,CTGTTCTTTAGCAACCGGCT,0,1124494
fldAp,0.3333333333333333,2,2,CTGTGAGCTAACACAGAGAA,0,1174143
fldAp,0.3333333333333333,2,2,CTGTGACAAATGCGACCCAA,0,1180856
fldAp,0.3333333333333333,2,2,CTGTCCGCTAGGCTAGTACA,0,1091546
fldAp,0.3333333333333333,2,2,CTGTCCGACGAAGAATCTGG,0,1100148
fldAp,0.3333333333333333,2,2,CTGTCCAGAATTTGCGTAAA,0,1158454
fldAp,0.3333333333333333,2,2,CTGTACGTAAAATGTAGGGA,0,1093079
fldAp,0.3333333333333333,2,2,CTGTACATGGGTGTAGCACC,0,1172197
fldAp,0.3333333333333333,2,2,CTGGTTCGCGTACGATAGAT,0,1080264
fldAp,0.3333333333333333,2,2,CTGGGTAACGCAGACGGACT,0,1075260
fldAp,0.3333333333333333,2,2,CTGGGGTTCGTGTCTTACCA,0,1107363
fldAp,0.3333333333333333,2,2,CTGGGGGTGTTGCTCCTCTG,0,1138955
fldAp,0.3333333333333333,2,2,CTGGGAGGTTCGGCGCCGAC,0,1128140
fldAp,0.3333333333333333,2,2,CTGGGAGCTCTCTCCCCGGA,0,1181404
fldAp,0.3333333333333333,2,2,CTGGCGCGGCAGTGTCCATC,0,1109363
fldAp,0.3333333333333333,2,2,CTGGCCGATAGTACAACTAT,0,1146659
fldAp,0.3333333333333333,2,2,CTGGATAATATGAGGTATAG,0,1173392
fldAp,0.3333333333333333,2,2,CTGGAGGGTGAGACCACTAC,0,1116434
fldAp,0.3333333333333333,2,2,CTGGAGGGGGTATTTTCAGG,0,1117781
fldAp,0.3333333333333333,2,2,CTGCTTGCGGGCGCTTGGTT,0,1136149
fldAp,0.3333333333333333,2,2,CTGCTTCAGCGTGAACTTGG,0,1120792
fldAp,0.3333333333333333,2,2,CTGCTGCCTCCCGACAACCA,0,1185278
fldAp,0.3333333333333333,2,2,CTGCTAAGCACCCGGAGGCC,0,1179675
fldAp,0.3333333333333333,2,2,CTGCGTGGATACACATGGGA,0,1081777
fldAp,0.3333333333333333,2,2,CTGCGTCGCGCGGTGGCAGA,0,1075941
fldAp,0.3333333333333333,2,2,CTGCGATGTAAAGTGCGTTA,0,1147427
fldAp,0.3333333333333333,2,2,CTGCCCGAGAACTCCCGACT,0,1111860
fldAp,0.3333333333333333,2,2,CTGCCACACAAGCAATGATG,0,1179916
fldAp,0.3333333333333333,2,2,CTGCAGCAGCTCCCCTGCTG,0,1156015
fldAp,0.3333333333333333,2,2,CTGCACCAACTATTGGGGAT,0,1122991
fldAp,0.3333333333333333,2,2,CTGATTTCGTCCCGGAATGA,0,1071496
fldAp,0.3333333333333333,2,2,CTGATTCGGGTAGCTGGCGT,0,1094898
fldAp,0.3333333333333333,2,2,CTGATGACACGAACGTTAAT,0,1168423
fldAp,0.3333333333333333,2,2,CTGATACAGTTCCGAAATTT,0,1087234
fldAp,0.3333333333333333,2,2,CTGAGTTAATGAATCGAACA,0,1161035
fldAp,0.3333333333333333,2,2,CTGAGTGCGGACTCGTATTA,0,1101211
fldAp,0.3333333333333333,2,2,CTGAGGTCTCGTCCGACCTC,0,1120008
fldAp,0.3333333333333333,2,2,CTGAGGCTTATGTGAATAGA,0,1176618
fldAp,0.3333333333333333,2,2,CTGAGCGCCAAAACCTGCTG,0,1152864
fldAp,0.3333333333333333,2,2,CTGAGAGCAATTAAAAATAA,0,1092132
fldAp,0.3333333333333333,2,2,CTGACTCCGAACCGACTAAC,0,1130192
fldAp,0.3333333333333333,2,2,CTGACTAGGGGTAATCGTAA,0,1121099
fldAp,0.3333333333333333,2,2,CTGACCTCCACATCCTTTGG,0,1132063
fldAp,0.3333333333333333,2,2,CTGACACATAGCTCAAGCCG,0,1087998
fldAp,0.3333333333333333,2,2,CTGACAAAGGGGACTGATGG,0,1178320
fldAp,0.3333333333333333,2,2,CTGAAGCTTAGAAGTTGGCC,0,1106337
fldAp,0.3333333333333333,2,2,CTGAACTTCTACGGTACGTT,0,1104333
fldAp,0.3333333333333333,2,2,CTGAACCTTAAATTACCACT,0,1133754
fldAp,0.3333333333333333,2,2,CTCTTTGACAGTCTGTTCGT,0,1129425
fldAp,0.3333333333333333,2,2,CTCTGTTTTAGGGCGCGCCC,0,1144012
fldAp,0.3333333333333333,2,2,CTCTGTCCTAAGTTATCAGG,0,1142159
fldAp,0.3333333333333333,2,2,CTCTGGGCGTGCCGAAAAAG,0,1075308
fldAp,0.3333333333333333,2,2,CTCTGGAAGACGCAGCGTAA,0,1110535
fldAp,0.3333333333333333,2,2,CTCTGACAAGGGGGGAGACT,0,1170918
fldAp,0.3333333333333333,2,2,CTCTCTAAGCGGGGGGTGCA,0,1171725
fldAp,0.3333333333333333,2,2,CTCTCAGGACCCTTGGACTT,0,1129516
fldAp,0.3333333333333333,2,2,CTCTATTCTCCTGGCATGGA,0,1140549
fldAp,0.3333333333333333,2,2,CTCTATACAGACCTTGAAGA,0,1083451
fldAp,0.3333333333333333,2,2,CTCGTTGTTATTGTCAAATC,0,1155481
fldAp,0.3333333333333333,2,2,CTCGGTGTCCGCCATACTAA,0,1092471
fldAp,0.3333333333333333,2,2,CTCGGACAGGATGTATGAAG,0,1124803
fldAp,0.3333333333333333,2,2,CTCGCTTAGCCATCAGTTGT,0,1113112
fldAp,0.3333333333333333,2,2,CTCGCTATGGGTTGCGAGTG,0,1171235
fldAp,0.3333333333333333,2,2,CTCGCGTTTGAACGATTCTG,0,1137805
fldAp,0.3333333333333333,2,2,CTCGAAGCGTGTATGTTACA,0,1182294
fldAp,0.3333333333333333,2,2,CTCGAAGAGGATAAGTATGT,0,1098658
fldAp,0.3333333333333333,2,2,CTCGAAACGTGACGACTAAT,0,1109214
fldAp,0.3333333333333333,2,2,CTCCTTGACGCAGGTTAGTT,0,1117801
fldAp,0.3333333333333333,2,2,CTCCTGTCGGGCTCTGCGTA,0,1118776
fldAp,0.3333333333333333,2,2,CTCCGTAATGCATATCAGTC,0,1093917
fldAp,0.3333333333333333,2,2,CTCCGGTTAATTGCATTCTC,0,1079398
fldAp,0.3333333333333333,2,2,CTCCGCCTGAGCGCCAGTAT,0,1074312
fldAp,0.3333333333333333,2,2,CTCCGAGCGGAGTGGGTAGT,0,1121554
fldAp,0.3333333333333333,2,2,CTCCCGACATTAGGAGGCGC,0,1123226
fldAp,0.3333333333333333,2,2,CTCCCCCGGTAGGCCGTGCC,0,1171037
fldAp,0.3333333333333333,2,2,CTCCATTCATCTGGATAGTG,0,1121805
fldAp,0.3333333333333333,2,2,CTCCAGACTCCGGGTAAGTG,0,1142141
fldAp,0.3333333333333333,2,2,CTCCACAACGAATCCTATGA,0,1150765
fldAp,0.3333333333333333,2,2,CTCCAAACGAAAAACGGCGT,0,1163009
fldAp,0.3333333333333333,2,2,CTCAGCTGGTGTATTTACTG,0,1082514
fldAp,0.3333333333333333,2,2,CTCAGAGCTTTCACCTGACC,0,1145567
fldAp,0.3333333333333333,2,2,CTCACTTGCGTGGCTATTTC,0,1085730
fldAp,0.3333333333333333,2,2,CTCACCACCCAGAAGTGAGA,0,1169700
fldAp,0.3333333333333333,2,2,CTCAAGATTGCCACCACATT,0,1181234
fldAp,0.3333333333333333,2,2,CTATTTTGTCGGTATGTTCT,0,1070041
fldAp,0.3333333333333333,2,2,CTATTTCCGTGCACTTCTCG,0,1151289
fldAp,0.3333333333333333,2,2,CTATTGTGTGACCTCGGGTT,0,1135512
fldAp,0.3333333333333333,2,2,CTATTCGAATGTAATTATTA,0,1120212
fldAp,0.3333333333333333,2,2,CTATTCAATGGACAATGTAC,0,1069023
fldAp,0.3333333333333333,2,2,CTATTATGTTGAACTTGTGT,0,1068869
fldAp,0.3333333333333333,2,2,CTATGTGCGAGATTGGGACA,0,1112919
fldAp,0.3333333333333333,2,2,CTATGGTCACAGATTAACAG,0,1120461
fldAp,0.3333333333333333,2,2,CTATGAGTCGCAACTGGGCT,0,1151816
fldAp,0.3333333333333333,2,2,CTATCTTTCTTATAGGGTTT,0,1069050
fldAp,0.3333333333333333,2,2,CTATCTCTTTCAGAGGCGCT,0,1139510
fldAp,0.3333333333333333,2,2,CTATCCCAATGCGTGGCTCT,0,1154366
fldAp,0.3333333333333333,2,2,CTATCAAGTACTGATAAGAC,0,1076841
fldAp,0.3333333333333333,2,2,CTATAGTGGACTATCCTTGT,0,1092383
fldAp,0.3333333333333333,2,2,CTAGTTACGACAGATGCGGG,0,1112930
fldAp,0.3333333333333333,2,2,CTAGTGTGATTGCCCTGATA,0,1168224
fldAp,0.3333333333333333,2,2,CTAGTCGGTTTGTAGTACAC,0,1064086
fldAp,0.3333333333333333,2,2,CTAGTATTGACTCCGACGTG,0,1087588
fldAp,0.3333333333333333,2,2,CTAGGAATAGTTACCACGCC,0,1127087
fldAp,0.3333333333333333,2,2,CTAGCTGCTGCGCAAATCGA,0,1076652
fldAp,0.3333333333333333,2,2,CTAGCACGGAAGAAAATGGG,0,1134958
fldAp,0.3333333333333333,2,2,CTAGATAAGACTCAAGCTCA,0,1154515
fldAp,0.3333333333333333,2,2,CTACTGGAAAGCCCCCCGCG,0,1075062
fldAp,0.3333333333333333,2,2,CTACTCTGGGAAAAACGGAT,0,1175894
fldAp,0.3333333333333333,2,2,CTACTCAACCTGGCACACCG,0,1177132
fldAp,0.3333333333333333,2,2,CTACTAGGGGATCTATCGAT,0,1128701
fldAp,0.3333333333333333,2,2,CTACGGAGAAGTACGTGGGG,0,1147236
fldAp,0.3333333333333333,2,2,CTACGCTGTCCACCATTAAC,0,1098592
fldAp,0.3333333333333333,2,2,CTACGCGCATCTCTGCCGGG,0,1092173
fldAp,0.3333333333333333,2,2,CTACGATTCATGCTGTCTAC,0,1076584
fldAp,0.3333333333333333,2,2,CTACGAAACGGTACGAACAA,0,1170693
fldAp,0.3333333333333333,2,2,CTACCTTAGAACAGGCAATT,0,1085626
fldAp,0.3333333333333333,2,2,CTACCTCTTGCAGTTGATTA,0,1074832
fldAp,0.3333333333333333,2,2,CTACCCCGTCCCCCGTTCAG,0,1099396
fldAp,0.3333333333333333,2,2,CTACCATAGAAGCGGCGCCA,0,1152076
fldAp,0.3333333333333333,2,2,CTACAACGGGGCTGGAAGAT,0,1104961
fldAp,0.3333333333333333,2,2,CTAATTTCAAGGCGGTGCGT,0,1127077
fldAp,0.3333333333333333,2,2,CTAATTCAATGTAAGGGACC,0,1067317
fldAp,0.3333333333333333,2,2,CTAATCATAAGCAAATACGT,0,1155614
fldAp,0.3333333333333333,2,2,CTAATCACACGCGTCTAGTA,0,1139058
fldAp,0.3333333333333333,2,2,CTAAGCGCACTCCAAAACGG,0,1164190
fldAp,0.3333333333333333,2,2,CTAACGTCAAATCTGGTGAA,0,1144886
fldAp,0.3333333333333333,2,2,CTAACGGAAGCGGTTCCAAA,0,1122672
fldAp,0.3333333333333333,2,2,CTAAATGCTACCAAGTTCAC,0,1183412
fldAp,0.3333333333333333,2,2,CTAAATAACAAATTCGGTGA,0,1063508
fldAp,0.3333333333333333,2,2,CTAAAGTACGCTGTAATCCT,0,1068098
fldAp,0.3333333333333333,2,2,CTAAAGCCTAACAAGTATTT,0,1150904
fldAp,0.3333333333333333,2,2,CTAAACCAAAACGTGATATT,0,1124737
fldAp,0.3333333333333333,2,2,CGTTTGGCCCTGCGGTTTCC,0,1146770
fldAp,0.3333333333333333,2,2,CGTTTCGTAATCATACTGGC,0,1163749
fldAp,0.3333333333333333,2,2,CGTTGTGTTCATGTGTTACA,0,1144163
fldAp,0.3333333333333333,2,2,CGTTGTCTGGATCGTGTGGC,0,1105734
fldAp,0.3333333333333333,2,2,CGTTGAGGGCAACTTACAAG,0,1164832
fldAp,0.3333333333333333,2,2,CGTTCGCTCCGGAAATGGAG,0,1150089
fldAp,0.3333333333333333,2,2,CGTTCCTATCGAATCATGCG,0,1137442
fldAp,0.3333333333333333,2,2,CGTTCCCAAAGGCGCGATCA,0,1146262
fldAp,0.3333333333333333,2,2,CGTTCCAAGCACAAGAATAG,0,1095391
fldAp,0.3333333333333333,2,2,CGTTCAAAAGATCGGTTATT,0,1134414
fldAp,0.3333333333333333,2,2,CGTTAGTGTAAGTGAAGGCT,0,1101387
fldAp,0.3333333333333333,2,2,CGTTACCTGATTCTAAGCAT,0,1075600
fldAp,0.3333333333333333,2,2,CGTTAAATTGTATTGTGGAA,0,1105292
fldAp,0.3333333333333333,2,2,CGTGTAGTAACATGGGATGT,0,1186152
fldAp,0.3333333333333333,2,2,CGTGGACTTCCCCTAGGAGC,0,1087036
fldAp,0.3333333333333333,2,2,CGTGGAACTTAACTCGTATG,0,1151176
fldAp,0.3333333333333333,2,2,CGTGCGTTTAGCTGCTGCCG,0,1152628
fldAp,0.3333333333333333,2,2,CGTGCGTGGACATGGTGCTA,0,1156656
fldAp,0.3333333333333333,2,2,CGTGCGGGTGTAGCCTCCAA,0,1090653
fldAp,0.3333333333333333,2,2,CGTGCGATATGTTTAACGCG,0,1098095
fldAp,0.3333333333333333,2,2,CGTGATTACAGTTCGTAATG,0,1084900
fldAp,0.3333333333333333,2,2,CGTGATGGGCACTCTTAGGC,0,1163794
fldAp,0.3333333333333333,2,2,CGTGAGGCTGGTCTCATAAA,0,1107432
fldAp,0.3333333333333333,2,2,CGTGAGCCAGCTACCTCGTT,0,1186148
fldAp,0.3333333333333333,2,2,CGTGACTCTAGCGGCTCGGT,0,1105095
fldAp,0.3333333333333333,2,2,CGTGAAAGACCAGGTATATC,0,1088003
fldAp,0.3333333333333333,2,2,CGTCTGTTTAGGGCTCCTGT,0,1173665
fldAp,0.3333333333333333,2,2,CGTCTGCTCACTCCCCGATC,0,1131951
fldAp,0.3333333333333333,2,2,CGTCTAAAAAGTGTGTTTGC,0,1103985
fldAp,0.3333333333333333,2,2,CGTCGTTTAGAGCAGACGTT,0,1126282
fldAp,0.3333333333333333,2,2,CGTCGTCCCGAGTTCCTTCC,0,1125234
fldAp,0.3333333333333333,2,2,CGTCCTTTGTGTCAGGGAAA,0,1102771
fldAp,0.3333333333333333,2,2,CGTCCTTGGCCATTAATTGG,0,1185820
fldAp,0.3333333333333333,2,2,CGTCCGCACAGGGTTCTAGA,0,1178748
fldAp,0.3333333333333333,2,2,CGTCCCTCCACGCATGCTCG,0,1138445
fldAp,0.3333333333333333,2,2,CGTCCCCTATGGCACCCTAC,0,1157032
fldAp,0.3333333333333333,2,2,CGTCCAATGGCAGGTGTAAA,0,1162524
fldAp,0.3333333333333333,2,2,CGTCATAGCGGGTGAGTATT,0,1161689
fldAp,0.3333333333333333,2,2,CGTCAGCCTTTAATATCTCA,0,1137403
fldAp,0.3333333333333333,2,2,CGTCACTCTGGCATCCGGAC,0,1144309
fldAp,0.3333333333333333,2,2,CGTCACAAAATAACCTACTG,0,1085145
fldAp,0.3333333333333333,2,2,CGTCAAGGGGTTCTCGTCTA,0,1114022
fldAp,0.3333333333333333,2,2,CGTCAACCACAGGAGGCCCA,0,1185469
fldAp,0.3333333333333333,2,2,CGTATCCGACAGTTCCGGCG,0,1154794
fldAp,0.3333333333333333,2,2,CGTATACAGCTCCGTGGCAT,0,1120566
fldAp,0.3333333333333333,2,2,CGTAGTGCGAGGTTCGGCCA,0,1070737
fldAp,0.3333333333333333,2,2,CGTAGGCCGAAATACCTGGT,0,1143114
fldAp,0.3333333333333333,2,2,CGTACTTTATATGTAAAAGA,0,1075981
fldAp,0.3333333333333333,2,2,CGTACGTTACGCGTAGCAAT,0,1065781
fldAp,0.3333333333333333,2,2,CGTACGGGGCAAAAGCAATA,0,1088042
fldAp,0.3333333333333333,2,2,CGTACCGTTACACACAATAA,0,1099491
fldAp,0.3333333333333333,2,2,CGTAACGTCCTAAGGAGGGT,0,1153689
fldAp,0.3333333333333333,2,2,CGTAACCAGCTCGCTGTGGG,0,1152430
fldAp,0.3333333333333333,2,2,CGGTTTTACGATGCTCAAGG,0,1184401
fldAp,0.3333333333333333,2,2,CGGTTGGGCGGGAAATGAAG,0,1183194
fldAp,0.3333333333333333,2,2,CGGTTAGTGGTAATATTTAC,0,1161846
fldAp,0.3333333333333333,2,2,CGGTGCCCTTCCAATCAGAG,0,1127704
fldAp,0.3333333333333333,2,2,CGGTGCCACCCGGGAAGAAG,0,1098649
fldAp,0.3333333333333333,2,2,CGGTGAGTACCTCGCTTTAC,0,1107993
fldAp,0.3333333333333333,2,2,CGGTCGCATCGTCCGCGGGG,0,1184111
fldAp,0.3333333333333333,2,2,CGGTCGAGTGTATAACGCTC,0,1117384
fldAp,0.3333333333333333,2,2,CGGTCATGGCTGTTCAGTAT,0,1100896
fldAp,0.3333333333333333,2,2,CGGTCAGCGACGAGTGATAG,0,1182401
fldAp,0.3333333333333333,2,2,CGGGTTGGGTTTACCTCGTG,0,1119343
fldAp,0.3333333333333333,2,2,CGGGTTAACGGATCGTCACA,0,1174808
fldAp,0.3333333333333333,2,2,CGGGTCATGTAGCATACGAG,0,1106431
fldAp,0.3333333333333333,2,2,CGGGTATGATTACGGCCACT,0,1106029
fldAp,0.3333333333333333,2,2,CGGGGTACAATGGGACGCGG,0,1121750
fldAp,0.3333333333333333,2,2,CGGGGGCTCCTTAGTCACAC,0,1163389
fldAp,0.3333333333333333,2,2,CGGGGGACAGAATGGCCTCT,0,1130042
fldAp,0.3333333333333333,2,2,CGGGGCCGATAAGTCGCAAC,0,1162927
fldAp,0.3333333333333333,2,2,CGGGGCACAGCTATAGGTTC,0,1113894
fldAp,0.3333333333333333,2,2,CGGGGACCTTCACGCTCTTT,0,1095014
fldAp,0.3333333333333333,2,2,CGGGCGGTGCTCGTGTATCG,0,1123378
fldAp,0.3333333333333333,2,2,CGGGCGAGCTCATCATTTCA,0,1084927
fldAp,0.3333333333333333,2,2,CGGGCCTGCTGTTCGTGTGC,0,1090149
fldAp,0.3333333333333333,2,2,CGGGCCTGATAACATTTAAC,0,1157514
fldAp,0.3333333333333333,2,2,CGGGCATCAGAGCTCTTTAT,0,1104463
fldAp,0.3333333333333333,2,2,CGGGCAGGGGCTCACTAGAG,0,1068693
fldAp,0.3333333333333333,2,2,CGGGAGCAATTTCGCCTTGT,0,1168354
fldAp,0.3333333333333333,2,2,CGGCTACGGTAGCAGAACCA,0,1180536
fldAp,0.3333333333333333,2,2,CGGCGGATTCGAGCGGGTTT,0,1170410
fldAp,0.3333333333333333,2,2,CGGCGCAGTTACCGCTAGGT,0,1095361
fldAp,0.3333333333333333,2,2,CGGCGATTGCTGTTGTAGAT,0,1181827
fldAp,0.3333333333333333,2,2,CGGCGATACACGTCGTCATA,0,1139464
fldAp,0.3333333333333333,2,2,CGGCGACCGACGAAGTCATC,0,1160424
fldAp,0.3333333333333333,2,2,CGGCCTTATCATAGTGTGAT,0,1144238
fldAp,0.3333333333333333,2,2,CGGCCGACTAGTACCCGCGA,0,1184045
fldAp,0.3333333333333333,2,2,CGGCCCCCCTATCCCCTGAG,0,1160028
fldAp,0.3333333333333333,2,2,CGGCCAATAGGGTACCAGAC,0,1097148
fldAp,0.3333333333333333,2,2,CGGCATTGATCGCACCCAGT,0,1184214
fldAp,0.3333333333333333,2,2,CGGCATGGGCGTCAAAGTCG,0,1099961
fldAp,0.3333333333333333,2,2,CGGCATCTTAAAAATACTGT,0,1077710
fldAp,0.3333333333333333,2,2,CGGCAGGGAGTAGTCCTGAT,0,1140625
fldAp,0.3333333333333333,2,2,CGGCAGCCGTTTTGTAGTGC,0,1135767
fldAp,0.3333333333333333,2,2,CGGCACTGGTAAGTGCATTC,0,1103524
fldAp,0.3333333333333333,2,2,CGGCACGGCATGCTTCTCAC,0,1074057
fldAp,0.3333333333333333,2,2,CGGCACCGGGTCAGTCATAC,0,1091191
fldAp,0.3333333333333333,2,2,CGGCACCGGCGTCCCGTAAG,0,1142833
fldAp,0.3333333333333333,2,2,CGGCAATAATCAGATTAGCA,0,1175177
fldAp,0.3333333333333333,2,2,CGGCAAGAACGGCGGGCGCA,0,1179805
fldAp,0.3333333333333333,2,2,CGGATTAAGCAGCCATTTGT,0,1153015
fldAp,0.3333333333333333,2,2,CGGATACAAGTTCCTAGTGA,0,1101437
fldAp,0.3333333333333333,2,2,CGGATAACTGGGGTAGTGTG,0,1129660
fldAp,0.3333333333333333,2,2,CGGAGTACAAAGGAATGCTG,0,1092137
fldAp,0.3333333333333333,2,2,CGGAGCCGGTCCGTGATCGT,0,1176943
fldAp,0.3333333333333333,2,2,CGGAGAGTCGCGTTAGGATT,0,1063980
fldAp,0.3333333333333333,2,2,CGGAGACTTAAATCCGATGT,0,1174157
fldAp,0.3333333333333333,2,2,CGGAGAAGGATCAGGACTTC,0,1163593
fldAp,0.3333333333333333,2,2,CGGACTCCACCAGTTACGGC,0,1066207
fldAp,0.3333333333333333,2,2,CGGAAGGACGCATTACGTAG,0,1103276
fldAp,0.3333333333333333,2,2,CGGAACGGGATGGTGTCATT,0,1115335
fldAp,0.3333333333333333,2,2,CGGAACCGTAACGTGTAGGT,0,1130688
fldAp,0.3333333333333333,2,2,CGGAAAACGGAGTTACTTCT,0,1156635
fldAp,0.3333333333333333,2,2,CGCTTGCTCGCGTCGCCCTC,0,1064401
fldAp,0.3333333333333333,2,2,CGCTTAGGTTCAATCGCAGG,0,1162419
fldAp,0.3333333333333333,2,2,CGCTGGTTTGTTAGATATAT,0,1097606
fldAp,0.3333333333333333,2,2,CGCTGCATGACATAACGCAG,0,1076361
fldAp,0.3333333333333333,2,2,CGCTCGGTGGGCGAAAAACT,0,1150416
fldAp,0.3333333333333333,2,2,CGCTCAGATCTGCTGGCACA,0,1132851
fldAp,0.3333333333333333,2,2,CGCTCACAGTTGACCTTCAA,0,1166085
fldAp,0.3333333333333333,2,2,CGCTAGGAGACATTCAAAAT,0,1106297
fldAp,0.3333333333333333,2,2,CGCGTCTGCTCTTCTCTGTG,0,1141856
fldAp,0.3333333333333333,2,2,CGCGTCAAGCACAGGTGGTA,0,1099076
fldAp,0.3333333333333333,2,2,CGCGTAGTTCAAGAGTTATC,0,1146973
fldAp,0.3333333333333333,2,2,CGCGGTCACAGTCCAACAGT,0,1074011
fldAp,0.3333333333333333,2,2,CGCGGGTTGTTGGCCCATCG,0,1186377
fldAp,0.3333333333333333,2,2,CGCGGGAGGTGCTGGGAGTT,0,1063887
fldAp,0.3333333333333333,2,2,CGCGGGACCAGGATAATTGT,0,1178757
fldAp,0.3333333333333333,2,2,CGCGGATTGGTTAATGTCAT,0,1182350
fldAp,0.3333333333333333,2,2,CGCGCGTGCGAGGCCATGTC,0,1108433
fldAp,0.3333333333333333,2,2,CGCGCGGCTTTGAAACGGCC,0,1183631
fldAp,0.3333333333333333,2,2,CGCGCGGCTAAAGCTACTAC,0,1174532
fldAp,0.3333333333333333,2,2,CGCGCGACCTTAAGTGATGC,0,1169487
fldAp,0.3333333333333333,2,2,CGCGCCCTATTACATGCTCC,0,1075421
fldAp,0.3333333333333333,2,2,CGCCTGTACGCGGACCGGGA,0,1161566
fldAp,0.3333333333333333,2,2,CGCCTGTAACATCTATACCG,0,1136484
fldAp,0.3333333333333333,2,2,CGCCTCCGGACTAACTAGAG,0,1086253
fldAp,0.3333333333333333,2,2,CGCCGCCACGCTCGTAATTG,0,1115452
fldAp,0.3333333333333333,2,2,CGCCGCAAAAGTCCACTTTA,0,1124075
fldAp,0.3333333333333333,2,2,CGCCGAAGACCGGCTCGTGC,0,1143893
fldAp,0.3333333333333333,2,2,CGCCCTGGAGTTGCCTGGCG,0,1116144
fldAp,0.3333333333333333,2,2,CGCCCTATATGCAGATGGTA,0,1125863
fldAp,0.3333333333333333,2,2,CGCCACTTCCCTTTCCGGTC,0,1175400
fldAp,0.3333333333333333,2,2,CGCCACTACTGACTCGAATG,0,1169702
fldAp,0.3333333333333333,2,2,CGCCACGCGACGTATATTAA,0,1074103
fldAp,0.3333333333333333,2,2,CGCCAAAAGAAGATCTGATG,0,1108870
fldAp,0.3333333333333333,2,2,CGCATGTTGGACCCAACAGC,0,1075598
fldAp,0.3333333333333333,2,2,CGCATGCGCCATACAATTAT,0,1155235
fldAp,0.3333333333333333,2,2,CGCATCTATCAAGGGCCAAC,0,1091828
fldAp,0.3333333333333333,2,2,CGCATCCGGTATATAATTTG,0,1107885
fldAp,0.3333333333333333,2,2,CGCATCCCAAACCACATCGT,0,1119397
fldAp,0.3333333333333333,2,2,CGCATACAGAAGATTATCTC,0,1097522
fldAp,0.3333333333333333,2,2,CGCAGCCAGATTCACTGCTG,0,1111806
fldAp,0.3333333333333333,2,2,CGCAGATTTCGCCACCGCAT,0,1160407
fldAp,0.3333333333333333,2,2,CGCAGAGTATTCGGGGATGG,0,1138427
fldAp,0.3333333333333333,2,2,CGCAGAATGAAATACTGAAG,0,1132714
fldAp,0.3333333333333333,2,2,CGCACTCGGGCACAAGTTAA,0,1173173
fldAp,0.3333333333333333,2,2,CGCACGCTGGCTAAAAGCTG,0,1164353
fldAp,0.3333333333333333,2,2,CGCACCCGGATCCAAGCCGT,0,1157822
fldAp,0.3333333333333333,2,2,CGCACAGGCGGTGATGTGCA,0,1128078
fldAp,0.3333333333333333,2,2,CGATTTATAGCTATGTGCGG,0,1100854
fldAp,0.3333333333333333,2,2,CGATTCTCGGAGATACACTC,0,1113912
fldAp,0.3333333333333333,2,2,CGATGTATGCATGCAGACAC,0,1116330
fldAp,0.3333333333333333,2,2,CGATGTAGCCAGATCGGATG,0,1115176
fldAp,0.3333333333333333,2,2,CGATGGTCAGTCAAGCAGGA,0,1147989
fldAp,0.3333333333333333,2,2,CGATGCTACTCAGTTGACGG,0,1172559
fldAp,0.3333333333333333,2,2,CGATCGCATTCGTTGTCAAT,0,1128755
fldAp,0.3333333333333333,2,2,CGATCATCTGCTCTCAAGTG,0,1181072
fldAp,0.3333333333333333,2,2,CGATCAGCTTTTGAGAACCT,0,1119229
fldAp,0.3333333333333333,2,2,CGATAAGAGTCAACAGAGTC,0,1179647
fldAp,0.3333333333333333,2,2,CGATAACGTTTGTTACACAG,0,1102742
fldAp,0.3333333333333333,2,2,CGAGTCCCTTCCTTGCCGTT,0,1076000
fldAp,0.3333333333333333,2,2,CGAGTATCTCACTCGAAAGT,0,1095069
fldAp,0.3333333333333333,2,2,CGAGGGCCGTCTGGTATAGC,0,1125476
fldAp,0.3333333333333333,2,2,CGAGGCGAACGTAGCTCACG,0,1165902
fldAp,0.3333333333333333,2,2,CGAGGACGGAGGACCCCACG,0,1087201
fldAp,0.3333333333333333,2,2,CGAGCGGCAGGCTGGGGACC,0,1124464
fldAp,0.3333333333333333,2,2,CGAGCGCACTGATATCATGT,0,1146233
fldAp,0.3333333333333333,2,2,CGAGCCCAGCGTGCCGCGTG,0,1093324
fldAp,0.3333333333333333,2,2,CGAGCAAGATCTACTCGGTC,0,1107783
fldAp,0.3333333333333333,2,2,CGAGATAACAAATTGAGGGA,0,1165513
fldAp,0.3333333333333333,2,2,CGAGAGAGGGTCCTACGTCT,0,1124526
fldAp,0.3333333333333333,2,2,CGAGACCCGGTTCGTTACGA,0,1128625
fldAp,0.3333333333333333,2,2,CGAGACCAAATTCACACCGG,0,1117168
fldAp,0.3333333333333333,2,2,CGAGAAATGCTTCAATTAGT,0,1159050
fldAp,0.3333333333333333,2,2,CGACTAGGGATCACTGAATA,0,1083585
fldAp,0.3333333333333333,2,2,CGACGGTCGTTTATGAGAAC,0,1178741
fldAp,0.3333333333333333,2,2,CGACGGAGACTCCAGTGAAT,0,1124626
fldAp,0.3333333333333333,2,2,CGACGAATGGAGGCGTGAGT,0,1121633
fldAp,0.3333333333333333,2,2,CGACCTGCATGCAATGGCGC,0,1176725
fldAp,0.3333333333333333,2,2,CGACAGGATGGTACAAGTTA,0,1153446
fldAp,0.3333333333333333,2,2,CGACAGACCAATTAATGACA,0,1072888
fldAp,0.3333333333333333,2,2,CGACACTTATCTTTTTATCT,0,1077684
fldAp,0.3333333333333333,2,2,CGAATTGGGACATAATATCT,0,1137209
fldAp,0.3333333333333333,2,2,CGAATTGACACTACTCGTTG,0,1168589
fldAp,0.3333333333333333,2,2,CGAATTCTTAAAACATTTGC,0,1093629
fldAp,0.3333333333333333,2,2,CGAATTCGCGTGAGGTGATG,0,1174316
fldAp,0.3333333333333333,2,2,CGAATCTTTTGTCCGTCGGA,0,1084377
fldAp,0.3333333333333333,2,2,CGAATCGGATTGACGGCAAA,0,1152089
fldAp,0.3333333333333333,2,2,CGAATCCGAGTTTGTCTATC,0,1157125
fldAp,0.3333333333333333,2,2,CGAAGTGTTTTCAGCAGACA,0,1150368
fldAp,0.3333333333333333,2,2,CGAAGTACGTTCTCAGAGCT,0,1069484
fldAp,0.3333333333333333,2,2,CGAAGTAATTCCCGCTCTTT,0,1186976
fldAp,0.3333333333333333,2,2,CGAAGGGAATTTGTATTCCG,0,1177258
fldAp,0.3333333333333333,2,2,CGAAGGCTATTGGTCATTTT,0,1151224
fldAp,0.3333333333333333,2,2,CGAAGATACGTACGTTTAAG,0,1186194
fldAp,0.3333333333333333,2,2,CGAAGACCTTCACCGAGTAT,0,1125426
fldAp,0.3333333333333333,2,2,CGAAGAAGCCACACCGAGGA,0,1172442
fldAp,0.3333333333333333,2,2,CGAACTCATGAATTGGTATG,0,1125724
fldAp,0.3333333333333333,2,2,CGAACAACCAGCGGCGGTTC,0,1176729
fldAp,0.3333333333333333,2,2,CCTTTCAACAGGCAAAGACT,0,1091075
fldAp,0.3333333333333333,2,2,CCTTGTGATGACGGAAAAGA,0,1078151
fldAp,0.3333333333333333,2,2,CCTTGGGATACGTTAGTCAC,0,1105173
fldAp,0.3333333333333333,2,2,CCTTGCAGCCCTACCGCTCC,0,1096270
fldAp,0.3333333333333333,2,2,CCTTCCTCGGGCTTTGCATC,0,1170694
fldAp,0.3333333333333333,2,2,CCTTATGCGTAACGCAACGA,0,1178665
fldAp,0.3333333333333333,2,2,CCTTATATCGCCTTTGCTGG,0,1063764
fldAp,0.3333333333333333,2,2,CCTTAGTTGAACTGTACGAC,0,1125699
fldAp,0.3333333333333333,2,2,CCTTACTGAAAGCTAGTGCT,0,1161987
fldAp,0.3333333333333333,2,2,CCTTACCCGCCCAACACATG,0,1185103
fldAp,0.3333333333333333,2,2,CCTGTGTATACGCGAGGAGG,0,1184217
fldAp,0.3333333333333333,2,2,CCTGTGGGCGGCAAGTCCGG,0,1099287
fldAp,0.3333333333333333,2,2,CCTGTCTTGAAGAGTGAACG,0,1151437
fldAp,0.3333333333333333,2,2,CCTGTAAGGTGAACGCAACA,0,1157618
fldAp,0.3333333333333333,2,2,CCTGGTTCATATGACAGGGC,0,1176204
fldAp,0.3333333333333333,2,2,CCTGGTCGGGATCCCTATAA,0,1078394
fldAp,0.3333333333333333,2,2,CCTGGGCATTCTACCTACAT,0,1134965
fldAp,0.3333333333333333,2,2,CCTGGCGCGGCACTAATCCT,0,1101655
fldAp,0.3333333333333333,2,2,CCTGGCATTAGTGGGAAGGT,0,1112831
fldAp,0.3333333333333333,2,2,CCTGGCAACTGTTGACTCGT,0,1129508
fldAp,0.3333333333333333,2,2,CCTGGATTACGATAATCTTT,0,1145000
fldAp,0.3333333333333333,2,2,CCTGCTTCCGGACGTGACCA,0,1090350
fldAp,0.3333333333333333,2,2,CCTGCTCGACTGTCCAACCA,0,1132332
fldAp,0.3333333333333333,2,2,CCTGCTAACTTGTGATATGG,0,1148485
fldAp,0.3333333333333333,2,2,CCTGCGTACTAGACATGGAA,0,1177483
fldAp,0.3333333333333333,2,2,CCTGCGCGCGCCGGGTACTT,0,1063248
fldAp,0.3333333333333333,2,2,CCTGCACCTCCATGGTTATT,0,1149161
fldAp,0.3333333333333333,2,2,CCTGCAAATTTCATCGCACC,0,1144236
fldAp,0.3333333333333333,2,2,CCTGCAAAACTGTCTAGCGG,0,1127413
fldAp,0.3333333333333333,2,2,CCTGATGTGCGGAGTCACCT,0,1115921
fldAp,0.3333333333333333,2,2,CCTGAGGTACCTTGTTTTTG,0,1091373
fldAp,0.3333333333333333,2,2,CCTGAGCTCATCTCGTTCCT,0,1166551
fldAp,0.3333333333333333,2,2,CCTCTTGAAAACCCCAGTGA,0,1179802
fldAp,0.3333333333333333,2,2,CCTCTGGACACCGTTGGCGC,0,1131050
fldAp,0.3333333333333333,2,2,CCTCTGCACCTAGGTGGGCA,0,1146919
fldAp,0.3333333333333333,2,2,CCTCTATCCCCTCGGTCGTC,0,1080861
fldAp,0.3333333333333333,2,2,CCTCTAGTACAGACAGATCG,0,1182994
fldAp,0.3333333333333333,2,2,CCTCGTACTTGTGCCTGAAA,0,1139033
fldAp,0.3333333333333333,2,2,CCTCGTACTTATAACATCGC,0,1115014
fldAp,0.3333333333333333,2,2,CCTCGGGGCGCCCGGCGACA,0,1147029
fldAp,0.3333333333333333,2,2,CCTCGGGCACTGCCGGAAAC,0,1098245
fldAp,0.3333333333333333,2,2,CCTCGCGCTCTGAGCGATAT,0,1087860
fldAp,0.3333333333333333,2,2,CCTCCTATCGAAGTGAACAA,0,1115821
fldAp,0.3333333333333333,2,2,CCTCCGTCGTTCAGCTGTCG,0,1168370
fldAp,0.3333333333333333,2,2,CCTCCCTATTTCTTTACCTT,0,1117914
fldAp,0.3333333333333333,2,2,CCTCCCGACGTTCACCTCAA,0,1134483
fldAp,0.3333333333333333,2,2,CCTCCAACAGGGCACAGTTA,0,1132370
fldAp,0.3333333333333333,2,2,CCTCAGGGAGTATCGACAGG,0,1124514
fldAp,0.3333333333333333,2,2,CCTCAGATTTTCGGGGCTCC,0,1098205
fldAp,0.3333333333333333,2,2,CCTCAATTAAGGAATACCAA,0,1096132
fldAp,0.3333333333333333,2,2,CCTCAATGCCTGAGGTGGAT,0,1164202
fldAp,0.3333333333333333,2,2,CCTCAACGTCGGTGTTCGAA,0,1146785
fldAp,0.3333333333333333,2,2,CCTATTAATGTAATGATGGG,0,1113719
fldAp,0.3333333333333333,2,2,CCTATGAAACACGCTGACCA,0,1101287
fldAp,0.3333333333333333,2,2,CCTAGTGGGTTGTGAGAAAT,0,1097340
fldAp,0.3333333333333333,2,2,CCTAGGGTTAACGGGTCTGA,0,1140386
fldAp,0.3333333333333333,2,2,CCTAGACATTGTTACTGATT,0,1149733
fldAp,0.3333333333333333,2,2,CCTACCGACCCGGATGCGAT,0,1099057
fldAp,0.3333333333333333,2,2,CCTAATCGTAAAACAACCGT,0,1122731
fldAp,0.3333333333333333,2,2,CCTAACTCAACGCAACAACT,0,1072057
fldAp,0.3333333333333333,2,2,CCGTTTTCTTCAGTAGCACA,0,1098533
fldAp,0.3333333333333333,2,2,CCGTTTGATCCTGATACATG,0,1168472
fldAp,0.3333333333333333,2,2,CCGTTTGATCAGTGACATAT,0,1163613
fldAp,0.3333333333333333,2,2,CCGTTTAACCCCAATTTGAC,0,1094826
fldAp,0.3333333333333333,2,2,CCGTTGATGTTAGAGAAAAA,0,1151275
fldAp,0.3333333333333333,2,2,CCGTTCTATCACGCTAAATG,0,1077963
fldAp,0.3333333333333333,2,2,CCGTTCGAGCCATGAAATCT,0,1106353
fldAp,0.3333333333333333,2,2,CCGTTCAGCACCCAGTGGGT,0,1084475
fldAp,0.3333333333333333,2,2,CCGTTACATTCGTTTGAGGC,0,1075645
fldAp,0.3333333333333333,2,2,CCGTGATCCGGGTACCCCAA,0,1069272
fldAp,0.3333333333333333,2,2,CCGTGACAAGGTGTTCGTCG,0,1151625
fldAp,0.3333333333333333,2,2,CCGTGAACTAGCAACGATGT,0,1115464
fldAp,0.3333333333333333,2,2,CCGTCTTCTGTCCACGGCGA,0,1077794
fldAp,0.3333333333333333,2,2,CCGTCTCATTAACGGCATGG,0,1110034
fldAp,0.3333333333333333,2,2,CCGTCAGGTGAGGGTCGTAA,0,1180570
fldAp,0.3333333333333333,2,2,CCGTCAAGGCGCACTTTAAC,0,1134513
fldAp,0.3333333333333333,2,2,CCGTATTAGTCGTCATGTCG,0,1076656
fldAp,0.3333333333333333,2,2,CCGTATCAAAGTGGCGAACC,0,1071665
fldAp,0.3333333333333333,2,2,CCGTACTAATCTGACAGGTT,0,1094991
fldAp,0.3333333333333333,2,2,CCGTACGTAGCTCGTATCCA,0,1087605
fldAp,0.3333333333333333,2,2,CCGTACCCCATGCGTATCGT,0,1176913
fldAp,0.3333333333333333,2,2,CCGTAACGCGAAATCTGATT,0,1116444
fldAp,0.3333333333333333,2,2,CCGGTTTAACGCTCACTTGT,0,1107556
fldAp,0.3333333333333333,2,2,CCGGTGATGTCGTCCCCACA,0,1104201
fldAp,0.3333333333333333,2,2,CCGGTCAGAGAGAGACTTCT,0,1079091
fldAp,0.3333333333333333,2,2,CCGGTACGAAAATATGTATA,0,1118696
fldAp,0.3333333333333333,2,2,CCGGGGGATTAGCCTCAGGG,0,1081461
fldAp,0.3333333333333333,2,2,CCGGGCCGCTTGCGCCCACT,0,1102646
fldAp,0.3333333333333333,2,2,CCGGGCAACCGACACGGTAT,0,1127836
fldAp,0.3333333333333333,2,2,CCGGGATCCGATCCAAATGT,0,1155075
fldAp,0.3333333333333333,2,2,CCGGCTAGCCGAAAAGCGAA,0,1117782
fldAp,0.3333333333333333,2,2,CCGGCTAATACCGATCTGTC,0,1120467
fldAp,0.3333333333333333,2,2,CCGGCTAAACTTATCATACT,0,1075349
fldAp,0.3333333333333333,2,2,CCGGCGAGTTTGTACACCGT,0,1128717
fldAp,0.3333333333333333,2,2,CCGGCCTACAGGGGGCCATC,0,1112490
fldAp,0.3333333333333333,2,2,CCGGCCGTTCAAAAGCGCGT,0,1128461
fldAp,0.3333333333333333,2,2,CCGGATAACAGTACAGGTGT,0,1093502
fldAp,0.3333333333333333,2,2,CCGGAGGCGTTGTATGTGCG,0,1098074
fldAp,0.3333333333333333,2,2,CCGGACTCCACACGGCTTCC,0,1149964
fldAp,0.3333333333333333,2,2,CCGGACGGACCTTGCTAGTT,0,1088960
fldAp,0.3333333333333333,2,2,CCGCTTTCCTGTAACTAAGG,0,1073112
fldAp,0.3333333333333333,2,2,CCGCTTGGATGCAATTAAGG,0,1087678
fldAp,0.3333333333333333,2,2,CCGCTGCAGAAGGACTACAC,0,1178627
fldAp,0.3333333333333333,2,2,CCGCTCGAGGTAAACATCGT,0,1139414
fldAp,0.3333333333333333,2,2,CCGCTACAGTCACCCTGTAT,0,1177551
fldAp,0.3333333333333333,2,2,CCGCGTACGATACTCAGCGT,0,1124595
fldAp,0.3333333333333333,2,2,CCGCGGAGCGATGATTTATC,0,1144469
fldAp,0.3333333333333333,2,2,CCGCGCACTGGGAAAGTTCT,0,1163493
fldAp,0.3333333333333333,2,2,CCGCGAAACGCCATGGCAGT,0,1126286
fldAp,0.3333333333333333,2,2,CCGCCTTTTGCTTAGTGAGC,0,1160184
fldAp,0.3333333333333333,2,2,CCGCCTACAATAGCGAGTAT,0,1108795
fldAp,0.3333333333333333,2,2,CCGCCAAGGACCGCGCGGCC,0,1162446
fldAp,0.3333333333333333,2,2,CCGCACCATTCATTGGGGGG,0,1143073
fldAp,0.3333333333333333,2,2,CCGCACACGGTGCGCTCCGC,0,1071656
fldAp,0.3333333333333333,2,2,CCGATTGTGAGACGTAGGCA,0,1147799
fldAp,0.3333333333333333,2,2,CCGATTAACACCAGTGGTAC,0,1124492
fldAp,0.3333333333333333,2,2,CCGATGAGGATAGCTTTCCT,0,1083308
fldAp,0.3333333333333333,2,2,CCGACGTGATGCTTGGGTCT,0,1070171
fldAp,0.3333333333333333,2,2,CCGACGCATAGCACTTGTAA,0,1147903
fldAp,0.3333333333333333,2,2,CCGACCCCAGTCTCAAGATA,0,1078171
fldAp,0.3333333333333333,2,2,CCCTTTTTATCGCCCTCTAT,0,1112657
fldAp,0.3333333333333333,2,2,CCCTTCTGCTTGATGGATTA,0,1077612
fldAp,0.3333333333333333,2,2,CCCTGTTCACCACCCGAGAT,0,1074528
fldAp,0.3333333333333333,2,2,CCCTGATAAAATAGAGGTGG,0,1156677
fldAp,0.3333333333333333,2,2,CCCTCTATACCGCGGGTTAG,0,1113199
fldAp,0.3333333333333333,2,2,CCCTCCCGACAGGGCGTGGG,0,1065212
fldAp,0.3333333333333333,2,2,CCCTATGAGACTTCAACACT,0,1088973
fldAp,0.3333333333333333,2,2,CCCTAGCTGGATCCCATTAT,0,1075013
fldAp,0.3333333333333333,2,2,CCCTAAGTCCAAGAACAGAC,0,1063242
fldAp,0.3333333333333333,2,2,CCCGTGTCTTGGCTATCTTT,0,1143240
fldAp,0.3333333333333333,2,2,CCCGTCCGACCAAAATTCTC,0,1079544
fldAp,0.3333333333333333,2,2,CCCGGTCGATGGAGTAAAGG,0,1163037
fldAp,0.3333333333333333,2,2,CCCGGTATTCCGAGATGCGT,0,1115469
fldAp,0.3333333333333333,2,2,CCCGGCGGTATGTACAGTGT,0,1082966
fldAp,0.3333333333333333,2,2,CCCGGCATTCGGACCGATCG,0,1148152
fldAp,0.3333333333333333,2,2,CCCGGATTGGTAGTCAGTAC,0,1131418
fldAp,0.3333333333333333,2,2,CCCGGATAGCGTCATTCCGT,0,1177919
fldAp,0.3333333333333333,2,2,CCCGCTTCCTGGGTCATACG,0,1071430
fldAp,0.3333333333333333,2,2,CCCGCGCACGGTGGCTATTA,0,1163220
fldAp,0.3333333333333333,2,2,CCCGCAGATGCATTGATGTA,0,1122915
fldAp,0.3333333333333333,2,2,CCCGATTCGCAGCCCAGTAC,0,1150071
fldAp,0.3333333333333333,2,2,CCCGATCCACAACTGATCGT,0,1171108
fldAp,0.3333333333333333,2,2,CCCGATCATGCCACATGCCT,0,1166417
fldAp,0.3333333333333333,2,2,CCCGAGCTTAGCATACGAAT,0,1150128
fldAp,0.3333333333333333,2,2,CCCGAAGGCCTGTAACCAAG,0,1100151
fldAp,0.3333333333333333,2,2,CCCGAAAAAGCGCTATCAGA,0,1177904
fldAp,0.3333333333333333,2,2,CCCCTTTCCAAGGTATGACT,0,1097455
fldAp,0.3333333333333333,2,2,CCCCTTGTGTGTGGGGTTGG,0,1165386
fldAp,0.3333333333333333,2,2,CCCCGTTGGACCAATAGCCA,0,1171535
fldAp,0.3333333333333333,2,2,CCCCGGACGAACTGAACTTG,0,1074979
fldAp,0.3333333333333333,2,2,CCCCCTCTGGAAACGCTGTC,0,1144494
fldAp,0.3333333333333333,2,2,CCCCCGTTTCTATTATGACT,0,1179962
fldAp,0.3333333333333333,2,2,CCCCATGAATGAGGAGCGAA,0,1090085
fldAp,0.3333333333333333,2,2,CCCCAGGCTAAGCCGTTTAC,0,1107741
fldAp,0.3333333333333333,2,2,CCCCAGCCGTATTGCCCGTC,0,1095846
fldAp,0.3333333333333333,2,2,CCCCACGTGAGCTAGCAGGT,0,1080331
fldAp,0.3333333333333333,2,2,CCCCAACCCGGTGAGCCCCA,0,1100095
fldAp,0.3333333333333333,2,2,CCCATGTAAGCCGGGAGGTG,0,1076517
fldAp,0.3333333333333333,2,2,CCCATCCCAAACCTCACTTT,0,1152116
fldAp,0.3333333333333333,2,2,CCCATAGGCGGAGTATCGAC,0,1101981
fldAp,0.3333333333333333,2,2,CCCATAGCACGGTCGTACGA,0,1111143
fldAp,0.3333333333333333,2,2,CCCAGTCGGATCCCCGGCGA,0,1149688
fldAp,0.3333333333333333,2,2,CCCAGGATGGGACTATGCGG,0,1094699
fldAp,0.3333333333333333,2,2,CCCAGCTAGAAGCGCCTGTT,0,1101030
fldAp,0.3333333333333333,2,2,CCCAGATGTAGCCCCGGGTA,0,1163750
fldAp,0.3333333333333333,2,2,CCCACCGATTCGCACGAGAC,0,1104718
fldAp,0.3333333333333333,2,2,CCCAATAGCTCAGCTCGGTT,0,1180435
fldAp,0.3333333333333333,2,2,CCCAACTCAGCCGTTCGCTC,0,1081050
fldAp,0.3333333333333333,2,2,CCCAACCAGCGGTTGCTCTC,0,1100573
fldAp,0.3333333333333333,2,2,CCATTGTCCCGAGATATCGA,0,1072841
fldAp,0.3333333333333333,2,2,CCATTCGGGGGGCAACAGGC,0,1076237
fldAp,0.3333333333333333,2,2,CCATTCATCCCAGGTAGGGT,0,1162162
fldAp,0.3333333333333333,2,2,CCATGTGGTTCGATCAAGTA,0,1063566
fldAp,0.3333333333333333,2,2,CCATGTCTTCATACCGCCTG,0,1172456
fldAp,0.3333333333333333,2,2,CCATGGGGGTAGCACTGTGC,0,1129168
fldAp,0.3333333333333333,2,2,CCATCTGGGACTCGGAGTGT,0,1177791
fldAp,0.3333333333333333,2,2,CCATCGTGCGACCTCTGCTG,0,1130308
fldAp,0.3333333333333333,2,2,CCATCGACATTCTAACATGG,0,1174811
fldAp,0.3333333333333333,2,2,CCATCCCGCTCACATTGACT,0,1097781
fldAp,0.3333333333333333,2,2,CCATCATGTTTGCGTGGTGT,0,1110688
fldAp,0.3333333333333333,2,2,CCATCAGATACCTACAATGA,0,1134262
fldAp,0.3333333333333333,2,2,CCATACCAAACAGCCTGTAG,0,1157254
fldAp,0.3333333333333333,2,2,CCATAATTTTTCTCTTGCCA,0,1117993
fldAp,0.3333333333333333,2,2,CCAGTTCAGAGATCTGATAG,0,1160409
fldAp,0.3333333333333333,2,2,CCAGTTAGAGCGTGAGTGAT,0,1116637
fldAp,0.3333333333333333,2,2,CCAGTTACTGAGGGGAGTGA,0,1185188
fldAp,0.3333333333333333,2,2,CCAGTGGGAGCAAATCCGCT,0,1145332
fldAp,0.3333333333333333,2,2,CCAGTCGGAGTTTCGCTGGA,0,1119938
fldAp,0.3333333333333333,2,2,CCAGGTCACACGGAACACGG,0,1104082
fldAp,0.3333333333333333,2,2,CCAGGGTGAAACCCCAACAA,0,1143463
fldAp,0.3333333333333333,2,2,CCAGGGCACGCTTACTTACC,0,1129343
fldAp,0.3333333333333333,2,2,CCAGCTTTTGTAGTACTCAC,0,1168665
fldAp,0.3333333333333333,2,2,CCAGCCTGTTTCCTTTGCGG,0,1158979
fldAp,0.3333333333333333,2,2,CCAGCCAACGCGGTATCCAG,0,1092488
fldAp,0.3333333333333333,2,2,CCAGATGCACAATTTGTTCA,0,1147309
fldAp,0.3333333333333333,2,2,CCAGATGAACACAGCCAGAC,0,1102107
fldAp,0.3333333333333333,2,2,CCAGATCCGATAATATGAGT,0,1089326
fldAp,0.3333333333333333,2,2,CCACTGTATATATAAGCGTC,0,1106885
fldAp,0.3333333333333333,2,2,CCACTACCCATTTTTGCGTG,0,1154106
fldAp,0.3333333333333333,2,2,CCACGGATATGGACCGGTCT,0,1091777
fldAp,0.3333333333333333,2,2,CCACGAGCGTGACCCTCTTT,0,1101128
fldAp,0.3333333333333333,2,2,CCACGACCAAGATCCCGACT,0,1127419
fldAp,0.3333333333333333,2,2,CCACCAAAGGTAGTAGAGGT,0,1183687
fldAp,0.3333333333333333,2,2,CCACATGATGACGGATAACC,0,1150568
fldAp,0.3333333333333333,2,2,CCACATATTAAATAGTGCGT,0,1161565
fldAp,0.3333333333333333,2,2,CCACAACGTAACTGTTCACA,0,1158574
fldAp,0.3333333333333333,2,2,CCACAACGGGAGTAGCCGAT,0,1150065
fldAp,0.3333333333333333,2,2,CCAATATCGCTATGCTTGAA,0,1106746
fldAp,0.3333333333333333,2,2,CCAAGTGTGACGACCCACTT,0,1117888
fldAp,0.3333333333333333,2,2,CCAAGTATTGACAGGGAACA,0,1155990
fldAp,0.3333333333333333,2,2,CCAACTAAGGGCGACATAAC,0,1126628
fldAp,0.3333333333333333,2,2,CCAACGTTCATATCACCGGA,0,1172440
fldAp,0.3333333333333333,2,2,CCAACGATACAAACGGGTAC,0,1170952
fldAp,0.3333333333333333,2,2,CCAACGACCTAAGTAACCAA,0,1170469
fldAp,0.3333333333333333,2,2,CCAACAATGAATAGCCTGCC,0,1126836
fldAp,0.3333333333333333,2,2,CCAACAAGAAGAGGTGTTTA,0,1069932
fldAp,0.3333333333333333,2,2,CCAAATAAGTCTTCATTCGT,0,1065503
fldAp,0.3333333333333333,2,2,CCAAAGAGAGATGTTTAGCT,0,1082545
fldAp,0.3333333333333333,2,2,CATTTAAGAGGATGACGAAG,0,1113533
fldAp,0.3333333333333333,2,2,CATTGGGTGCCGGCGTGGCA,0,1096188
fldAp,0.3333333333333333,2,2,CATTGGGCGGTAATGGGTTA,0,1080674
fldAp,0.3333333333333333,2,2,CATTCTGCCAGCGATACCGT,0,1177091
fldAp,0.3333333333333333,2,2,CATTCGCTATGTCTCCCGCA,0,1086483
fldAp,0.3333333333333333,2,2,CATTCCTGTGGCCGGGCACA,0,1066626
fldAp,0.3333333333333333,2,2,CATTCCAAATTCAAGATCAG,0,1085063
fldAp,0.3333333333333333,2,2,CATTCAGACGCACCCGTGGT,0,1135032
fldAp,0.3333333333333333,2,2,CATTCAAGACGTCACTTTTC,0,1170252
fldAp,0.3333333333333333,2,2,CATTAGGAAACTTCAACGTC,0,1139976
fldAp,0.3333333333333333,2,2,CATTAATACAGTCAAGGGAT,0,1164590
fldAp,0.3333333333333333,2,2,CATTAAGACTCGTATGCGCC,0,1146496
fldAp,0.3333333333333333,2,2,CATTAACCTTCCAAAATCCC,0,1101062
fldAp,0.3333333333333333,2,2,CATTAACAATTCGGTGATAC,0,1102043
fldAp,0.3333333333333333,2,2,CATGTTCCTCTCAGGTAACT,0,1088716
fldAp,0.3333333333333333,2,2,CATGTCGGCCGAAAAGTCAA,0,1110398
fldAp,0.3333333333333333,2,2,CATGTCCACGTGATACTCTA,0,1110982
fldAp,0.3333333333333333,2,2,CATGGGGGAGGCTGCGACAG,0,1074934
fldAp,0.3333333333333333,2,2,CATGGGAGGTGGTTAAGTCC,0,1161108
fldAp,0.3333333333333333,2,2,CATGGCGAAGGGTCACACCA,0,1153236
fldAp,0.3333333333333333,2,2,CATGCGGAGCACCGACTGGT,0,1087504
fldAp,0.3333333333333333,2,2,CATGCCGTTCCACCTCCGGG,0,1115639
fldAp,0.3333333333333333,2,2,CATGATAACGGGAGATGCTT,0,1139553
fldAp,0.3333333333333333,2,2,CATGAGTGGAGCACACGTGC,0,1090860
fldAp,0.3333333333333333,2,2,CATGAAGTCCAGGTGACAGA,0,1097262
fldAp,0.3333333333333333,2,2,CATGAACGGGCTGATAGAAC,0,1123827
fldAp,0.3333333333333333,2,2,CATCTGTGTACTCTTTGAGT,0,1098599
fldAp,0.3333333333333333,2,2,CATCTCGGAGGCGAATTGAG,0,1144671
fldAp,0.3333333333333333,2,2,CATCGTGTAGCGAACATGGT,0,1169151
fldAp,0.3333333333333333,2,2,CATCGTCTCCACCAACAAGA,0,1070570
fldAp,0.3333333333333333,2,2,CATCGGGCACATACATAGTC,0,1089002
fldAp,0.3333333333333333,2,2,CATCGAGCATCCTATCCCCT,0,1133210
fldAp,0.3333333333333333,2,2,CATCCTCCGTATTCATAAAG,0,1164861
fldAp,0.3333333333333333,2,2,CATCCCACGGACGCGGAAGG,0,1098071
fldAp,0.3333333333333333,2,2,CATCCAACGCCACAGTAGGG,0,1131982
fldAp,0.3333333333333333,2,2,CATATGGGAGTTCCCCCACT,0,1163380
fldAp,0.3333333333333333,2,2,CATATCCAGACCTTTATTGG,0,1140564
fldAp,0.3333333333333333,2,2,CATAGTCGAAGAATCTGGAG,0,1183829
fldAp,0.3333333333333333,2,2,CATAGGCAGCGTGTTGAGGT,0,1158558
fldAp,0.3333333333333333,2,2,CATAGCATCAGTACTTGACA,0,1146698
fldAp,0.3333333333333333,2,2,CATAGACGACATCGTAACCT,0,1096436
fldAp,0.3333333333333333,2,2,CATACGCGAACCAACAAGCG,0,1162987
fldAp,0.3333333333333333,2,2,CATAATGTGGCAACTAACAG,0,1118752
fldAp,0.3333333333333333,2,2,CATAAGAAGAGTGGCAAAAA,0,1177954
fldAp,0.3333333333333333,2,2,CATAACCTAAGCCACTACGG,0,1166682
fldAp,0.3333333333333333,2,2,CATAAATTGCACGAGGCACT,0,1123944
fldAp,0.3333333333333333,2,2,CAGTTCGATAAACCTAACGC,0,1097832
fldAp,0.3333333333333333,2,2,CAGTGGTTTGGCATCCCTAA,0,1164472
fldAp,0.3333333333333333,2,2,CAGTCTGAGTAGGTCAGTTA,0,1114966
fldAp,0.3333333333333333,2,2,CAGTCTAAACTAGGTGAGGT,0,1122803
fldAp,0.3333333333333333,2,2,CAGTCCTATCTTAATTCGAT,0,1154811
fldAp,0.3333333333333333,2,2,CAGTCCCGGTGCGACTGTCG,0,1140269
fldAp,0.3333333333333333,2,2,CAGTAGGGGCGATAGAGGAT,0,1069227
fldAp,0.3333333333333333,2,2,CAGTACTCGATGTCCATAGT,0,1110383
fldAp,0.3333333333333333,2,2,CAGTAACCTTAACGTCGTTC,0,1168476
fldAp,0.3333333333333333,2,2,CAGTAAAGATTGGAAATGTG,0,1080052
fldAp,0.3333333333333333,2,2,CAGTAAAATAAACACTTGAG,0,1153734
fldAp,0.3333333333333333,2,2,CAGGTTTGTTAGAGCCCCGA,0,1158643
fldAp,0.3333333333333333,2,2,CAGGTGTCTCCACTGCCCGT,0,1122626
fldAp,0.3333333333333333,2,2,CAGGTGCTCGGACTCTATAT,0,1073175
fldAp,0.3333333333333333,2,2,CAGGTGACTCACATTTTTAG,0,1133187
fldAp,0.3333333333333333,2,2,CAGGTCCTCCTTCACCATGA,0,1167255
fldAp,0.3333333333333333,2,2,CAGGTATGGCACCCTCTCAT,0,1169129
fldAp,0.3333333333333333,2,2,CAGGTAGCCGTCGTAGGACA,0,1108143
fldAp,0.3333333333333333,2,2,CAGGGTTGCGTCTGTTAATT,0,1116413
fldAp,0.3333333333333333,2,2,CAGGGGGGTGTGTCAGGGAG,0,1128603
fldAp,0.3333333333333333,2,2,CAGGGGCAAATAAGGGTATA,0,1170256
fldAp,0.3333333333333333,2,2,CAGGGCCTCACTGTCAGAAC,0,1099144
fldAp,0.3333333333333333,2,2,CAGGGATCAGTTGTACCCAT,0,1165984
fldAp,0.3333333333333333,2,2,CAGGCGGACGGGCTCCGGGG,0,1084615
fldAp,0.3333333333333333,2,2,CAGGCCGTGATTTTTCAACA,0,1137250
fldAp,0.3333333333333333,2,2,CAGGCCGGCCTGCGGGTTAT,0,1113290
fldAp,0.3333333333333333,2,2,CAGGCACCCTACATACATAA,0,1159484
fldAp,0.3333333333333333,2,2,CAGGCAACTGGACAAGCTAG,0,1110163
fldAp,0.3333333333333333,2,2,CAGGAGACATGCTATGTCCG,0,1090154
fldAp,0.3333333333333333,2,2,CAGGACCTCGCAGCCTCTAG,0,1140189
fldAp,0.3333333333333333,2,2,CAGGACAAGCTTCCGCAGGG,0,1173752
fldAp,0.3333333333333333,2,2,CAGGAAAGGCACCGGTACTC,0,1088736
fldAp,0.3333333333333333,2,2,CAGGAAACCATACACTACCA,0,1100785
fldAp,0.3333333333333333,2,2,CAGGAAACACGTGGCGAATG,0,1180370
fldAp,0.3333333333333333,2,2,CAGCTTGGTTGGGAGCATTA,0,1074805
fldAp,0.3333333333333333,2,2,CAGCTTCCTACTTTACGATA,0,1077669
fldAp,0.3333333333333333,2,2,CAGCTGAAGTTTGCATCGCT,0,1092588
fldAp,0.3333333333333333,2,2,CAGCTAATAATGAAATTTAC,0,1118833
fldAp,0.3333333333333333,2,2,CAGCGGGGCTGGCGTCGAGT,0,1080310
fldAp,0.3333333333333333,2,2,CAGCGGCTGATTATCTTCTT,0,1103595
fldAp,0.3333333333333333,2,2,CAGCGCATGCCGGTCCCCAA,0,1177605
fldAp,0.3333333333333333,2,2,CAGCGAGGTGAGAACTTCCC,0,1110933
fldAp,0.3333333333333333,2,2,CAGCCGCCACCGGCTGTCCA,0,1143199
fldAp,0.3333333333333333,2,2,CAGCATCGGAGCGCAATTTG,0,1148898
fldAp,0.3333333333333333,2,2,CAGCAGGCTATGTTTTCAAA,0,1152148
fldAp,0.3333333333333333,2,2,CAGCACTTAAACCACAAAGA,0,1168610
fldAp,0.3333333333333333,2,2,CAGATGGAGAGTTGACAGAT,0,1173466
fldAp,0.3333333333333333,2,2,CAGATGCGCAAATGCGTTGG,0,1117026
fldAp,0.3333333333333333,2,2,CAGATGCCGAGAGAATACTT,0,1186449
fldAp,0.3333333333333333,2,2,CAGATAATCTGATATGTTAT,0,1072688
fldAp,0.3333333333333333,2,2,CAGAGGTCCCAATAGGTTAG,0,1164490
fldAp,0.3333333333333333,2,2,CAGAGCGTACACTATTGGAG,0,1144096
fldAp,0.3333333333333333,2,2,CAGAGCCCTCAACGGCAGGA,0,1111753
fldAp,0.3333333333333333,2,2,CAGAGAAGCGAGCAGTGCAA,0,1076594
fldAp,0.3333333333333333,2,2,CAGACTCACAGCAACGATAG,0,1110739
fldAp,0.3333333333333333,2,2,CAGACGATTTAGAGGGGAAC,0,1137396
fldAp,0.3333333333333333,2,2,CAGACGAGCCTCGCACTAGA,0,1140575
fldAp,0.3333333333333333,2,2,CAGACGACTGACCCTTTATC,0,1162133
fldAp,0.3333333333333333,2,2,CAGAAGCGAGGGGGTGAGTG,0,1172760
fldAp,0.3333333333333333,2,2,CAGAACGTCCGTCTATTCGT,0,1111127
fldAp,0.3333333333333333,2,2,CACTTTGAACAGTTTTGTCA,0,1100595
fldAp,0.3333333333333333,2,2,CACTTGCATCTGGAGGAGGA,0,1124813
fldAp,0.3333333333333333,2,2,CACTTATTGGCGGTCGTCGA,0,1124593
fldAp,0.3333333333333333,2,2,CACTTATGATATTGACCAGA,0,1185258
fldAp,0.3333333333333333,2,2,CACTTATCCTGGGAGGTATC,0,1110281
fldAp,0.3333333333333333,2,2,CACTGTGTGGCGAGTCTAGA,0,1069543
fldAp,0.3333333333333333,2,2,CACTGCTCGGCGAACTCCCA,0,1097776
fldAp,0.3333333333333333,2,2,CACTCTCCCTTGATCATCGA,0,1080545
fldAp,0.3333333333333333,2,2,CACTCGGGCCATCATGGTCA,0,1087031
fldAp,0.3333333333333333,2,2,CACTCATCAAGCCGTGGGGT,0,1075035
fldAp,0.3333333333333333,2,2,CACTAGGGAAGCTAATTGCC,0,1144983
fldAp,0.3333333333333333,2,2,CACTACAAGAAGTCGGGAAG,0,1141445
fldAp,0.3333333333333333,2,2,CACTAATCCCTCGGTCGCTC,0,1177222
fldAp,0.3333333333333333,2,2,CACGTTCCGAAAACACAAAC,0,1072901
fldAp,0.3333333333333333,2,2,CACGTTACATGTGAAGTATG,0,1159249
fldAp,0.3333333333333333,2,2,CACGTCTTGCCTCGGTGTCA,0,1120941
fldAp,0.3333333333333333,2,2,CACGTACGCGTGGGTACGAA,0,1114092
fldAp,0.3333333333333333,2,2,CACGGTTTCATATGCTGTGT,0,1141164
fldAp,0.3333333333333333,2,2,CACGGTGCGCTAGTTCATAA,0,1134423
fldAp,0.3333333333333333,2,2,CACGGTACGCAATACATCCC,0,1124814
fldAp,0.3333333333333333,2,2,CACGGGCGATGGGTTCCCCT,0,1176984
fldAp,0.3333333333333333,2,2,CACGGCGTCTTCCGTACGTA,0,1069982
fldAp,0.3333333333333333,2,2,CACGCGATGATGTATAATTC,0,1164944
fldAp,0.3333333333333333,2,2,CACGCCCTATACAACCAGCC,0,1118417
fldAp,0.3333333333333333,2,2,CACGCAAATTCCGACTGACA,0,1117760
fldAp,0.3333333333333333,2,2,CACGATTAGCTCTCCGCAGT,0,1153038
fldAp,0.3333333333333333,2,2,CACGATACTCTGGTCCTAAC,0,1113556
fldAp,0.3333333333333333,2,2,CACCTTGCCAGGAAAGGGCT,0,1084544
fldAp,0.3333333333333333,2,2,CACCTGCAACTTGGGGGCGA,0,1178005
fldAp,0.3333333333333333,2,2,CACCTCAGTTTGGAATCTGC,0,1147936
fldAp,0.3333333333333333,2,2,CACCTAGTGGAGCTTTAAGG,0,1137954
fldAp,0.3333333333333333,2,2,CACCGACACAATGCCACAGT,0,1160221
fldAp,0.3333333333333333,2,2,CACCGAATATGATGCCAAGC,0,1120839
fldAp,0.3333333333333333,2,2,CACCCTCCAACCGAGTCATC,0,1148842
fldAp,0.3333333333333333,2,2,CACCCAGGACTCTGTTCCCT,0,1091265
fldAp,0.3333333333333333,2,2,CACCACGTATTGGGCACGTA,0,1143695
fldAp,0.3333333333333333,2,2,CACCACAAGCCAGTTCAGGG,0,1104397
fldAp,0.3333333333333333,2,2,CACCAATTGTGCCCTCAGCA,0,1091076
fldAp,0.3333333333333333,2,2,CACCAATGTCCGGGGTGCAA,0,1169234
fldAp,0.3333333333333333,2,2,CACCAACGGGGTGTTGACCC,0,1106592
fldAp,0.3333333333333333,2,2,CACATCATTAGCATGATTAA,0,1132400
fldAp,0.3333333333333333,2,2,CACATCACGATAATCAAATT,0,1098722
fldAp,0.3333333333333333,2,2,CACAGTCCGTTAAACGCGAT,0,1173795
fldAp,0.3333333333333333,2,2,CACAGGTTGATTATGGGTCC,0,1140851
fldAp,0.3333333333333333,2,2,CACAGGTACTCCCGATTCGT,0,1091824
fldAp,0.3333333333333333,2,2,CACAGGGGGACACTACCATG,0,1166768
fldAp,0.3333333333333333,2,2,CACAGCCTCCGGGACCGGAA,0,1088835
fldAp,0.3333333333333333,2,2,CACACGGGAGTGCTTCAAAG,0,1092154
fldAp,0.3333333333333333,2,2,CACACCCACGTAATCACCTA,0,1090617
fldAp,0.3333333333333333,2,2,CACAATTCTGGTTGTGGTGT,0,1095804
fldAp,0.3333333333333333,2,2,CACAACGACTTCATCTGAAC,0,1158455
fldAp,0.3333333333333333,2,2,CAATTGCCGACTGCTCGTCG,0,1169983
fldAp,0.3333333333333333,2,2,CAATGTCATTCGTTCGGGGG,0,1107001
fldAp,0.3333333333333333,2,2,CAATGGTCCGCAAATTGGGA,0,1172279
fldAp,0.3333333333333333,2,2,CAATGGGAAGTTCGACATTG,0,1138314
fldAp,0.3333333333333333,2,2,CAATGGATCACTTAGGAAGC,0,1089744
fldAp,0.3333333333333333,2,2,CAATGATTGCTAACTGACGG,0,1143273
fldAp,0.3333333333333333,2,2,CAATGAGAAGGTCAGGACAT,0,1161394
fldAp,0.3333333333333333,2,2,CAATCTGAAACGATGCAGTA,0,1095013
fldAp,0.3333333333333333,2,2,CAATCGTGGCGGGAGTGTAA,0,1159834
fldAp,0.3333333333333333,2,2,CAATCCGCTCGGTAGATGTT,0,1161043
fldAp,0.3333333333333333,2,2,CAATAGGTATTACACTAACT,0,1158414
fldAp,0.3333333333333333,2,2,CAATAAGTCTAGATGACGTT,0,1090987
fldAp,0.3333333333333333,2,2,CAAGTTAAAAAACGACTAGA,0,1168977
fldAp,0.3333333333333333,2,2,CAAGTGATCTCATCTATCAA,0,1177801
fldAp,0.3333333333333333,2,2,CAAGGTGTGTGTTGCGGTGG,0,1125973
fldAp,0.3333333333333333,2,2,CAAGGGTTTCGTGCATAGGA,0,1164332
fldAp,0.3333333333333333,2,2,CAAGGATCCGATCAAAGGGT,0,1170791
fldAp,0.3333333333333333,2,2,CAAGGAATTCGGGATGAGTT,0,1070348
fldAp,0.3333333333333333,2,2,CAAGGAAAGATCCCCCGAGC,0,1092495
fldAp,0.3333333333333333,2,2,CAAGCCTTTAGTGTTAAGCA,0,1159642
fldAp,0.3333333333333333,2,2,CAAGCCTCGAGAGGTCGTGT,0,1065767
fldAp,0.3333333333333333,2,2,CAAGCCCCAAGGCTCTCCTC,0,1076803
fldAp,0.3333333333333333,2,2,CAAGATCTTAGGCTCATTCA,0,1156806
fldAp,0.3333333333333333,2,2,CAAGAGCGAGCGGCTTCGGG,0,1113571
fldAp,0.3333333333333333,2,2,CAAGAGCCGGTAAAGGAAAT,0,1155342
fldAp,0.3333333333333333,2,2,CAAGACCTTAGAGAGTCCCT,0,1094883
fldAp,0.3333333333333333,2,2,CAAGACCCGCCATACATCCG,0,1128030
fldAp,0.3333333333333333,2,2,CAAGAAGAGAACGGTCAGTA,0,1084723
fldAp,0.3333333333333333,2,2,CAAGAACCGGTACGCCTCGC,0,1144190
fldAp,0.3333333333333333,2,2,CAACTTACTGGTCCCAGAAT,0,1138239
fldAp,0.3333333333333333,2,2,CAACTGCCTGTCGCCCTAGA,0,1145465
fldAp,0.3333333333333333,2,2,CAACGGTATAAAAAACGGGA,0,1098758
fldAp,0.3333333333333333,2,2,CAACGGGGAACGGTGCACAT,0,1170088
fldAp,0.3333333333333333,2,2,CAACGAGGTATGAGAGGTAG,0,1134666
fldAp,0.3333333333333333,2,2,CAACGAGGAGTACGCCAAGC,0,1177053
fldAp,0.3333333333333333,2,2,CAACGACTGCCCGGCCGCTA,0,1181516
fldAp,0.3333333333333333,2,2,CAACCTGTTGTGCCCGCTGG,0,1112494
fldAp,0.3333333333333333,2,2,CAACCGTGTCGCATACCGGA,0,1112143
fldAp,0.3333333333333333,2,2,CAACCGTCACTGTGCTGTTC,0,1167259
fldAp,0.3333333333333333,2,2,CAACAGGTCCAAGGGGTACT,0,1074910
fldAp,0.3333333333333333,2,2,CAAATGTGGACCGAGCCGTT,0,1182319
fldAp,0.3333333333333333,2,2,CAAATGAGAAGGATGATGGA,0,1073815
fldAp,0.3333333333333333,2,2,CAAATCACGACCGGGAGGTA,0,1070584
fldAp,0.3333333333333333,2,2,CAAAGTAAACTGGACTTCGG,0,1134504
fldAp,0.3333333333333333,2,2,CAAAGCTACTCATGAGGCTC,0,1093438
fldAp,0.3333333333333333,2,2,CAAAGCAGTAAGTAACAATG,0,1102391
fldAp,0.3333333333333333,2,2,CAAAGAGCCAGTCATTGAGT,0,1154582
fldAp,0.3333333333333333,2,2,CAAACTGTTGGATTTGAGGA,0,1123051
fldAp,0.3333333333333333,2,2,CAAACCACATGATGGCTCTC,0,1176614
fldAp,0.3333333333333333,2,2,CAAACACAAGTCGGCCATCA,0,1068470
fldAp,0.3333333333333333,2,2,CAAACAAGTGTGGCGCTTCG,0,1085462
fldAp,0.3333333333333333,2,2,CAAAAATTGTGCTACGCGGC,0,1152725
fldAp,0.3333333333333333,2,2,CAAAAAGCCAGTCGAAAAAG,0,1104206
fldAp,0.3333333333333333,2,2,CAAAAACAATTACCTTAGTC,0,1155799
fldAp,0.3333333333333333,2,2,ATTTTTTACTCACCAAAGGT,0,1114172
fldAp,0.3333333333333333,2,2,ATTTTTCGTTATAATGTGGT,0,1155920
fldAp,0.3333333333333333,2,2,ATTTTTCGCTGGTTATAGAA,0,1143418
fldAp,0.3333333333333333,2,2,ATTTTTATTGCTTTTGTGCG,0,1091858
fldAp,0.3333333333333333,2,2,ATTTTTAGTAACCGTCTCAA,0,1150169
fldAp,0.3333333333333333,2,2,ATTTTCTTTCCACTCGGAGT,0,1075709
fldAp,0.3333333333333333,2,2,ATTTTAGGGTGATCCCAGAC,0,1164857
fldAp,0.3333333333333333,2,2,ATTTGTCGGCACCGCCAACC,0,1092093
fldAp,0.3333333333333333,2,2,ATTTGTAATCGTGAGAAATT,0,1101947
fldAp,0.3333333333333333,2,2,ATTTGGGTACCGAAGAGTAT,0,1139830
fldAp,0.3333333333333333,2,2,ATTTGGCCGAACGTAGGCTA,0,1127495
fldAp,0.3333333333333333,2,2,ATTTGATCACTATCTCAGCC,0,1087943
fldAp,0.3333333333333333,2,2,ATTTGAGGAAGCCTGCTCTG,0,1183183
fldAp,0.3333333333333333,2,2,ATTTGACCAACGATACAACA,0,1182906
fldAp,0.3333333333333333,2,2,ATTTCATGGGATTCCAACTT,0,1104087
fldAp,0.3333333333333333,2,2,ATTTATCGCCTTACCAGTTA,0,1090180
fldAp,0.3333333333333333,2,2,ATTTAGTTGCTCATACGGTT,0,1127838
fldAp,0.3333333333333333,2,2,ATTTAGTACACCGGGTTCAG,0,1167250
fldAp,0.3333333333333333,2,2,ATTTACTGCCGACACTGTAG,0,1112747
fldAp,0.3333333333333333,2,2,ATTTAATTGGAGTGAGTAAG,0,1087033
fldAp,0.3333333333333333,2,2,ATTTAACTGTCATAAAGACT,0,1078373
fldAp,0.3333333333333333,2,2,ATTGTCAGAATAGACTTTTA,0,1163592
fldAp,0.3333333333333333,2,2,ATTGGGTTCTCGGGGGAAAG,0,1118096
fldAp,0.3333333333333333,2,2,ATTGGCTTAAACTCCTTCGC,0,1150663
fldAp,0.3333333333333333,2,2,ATTGGACTCATGTTCGCGCA,0,1177014
fldAp,0.3333333333333333,2,2,ATTGCCGCATTATTGTTAAA,0,1168548
fldAp,0.3333333333333333,2,2,ATTGACTGGTCCTGATATCA,0,1158879
fldAp,0.3333333333333333,2,2,ATTGACTCCTCCCTAAGGAT,0,1175417
fldAp,0.3333333333333333,2,2,ATTCTAGGCGCTGCTGACGA,0,1161571
fldAp,0.3333333333333333,2,2,ATTCTACCCGGAAAACTCGT,0,1084031
fldAp,0.3333333333333333,2,2,ATTCTACATCGTCAATGATA,0,1088546
fldAp,0.3333333333333333,2,2,ATTCGTGATATTGAGGGATG,0,1078823
fldAp,0.3333333333333333,2,2,ATTCGGCTCATACCCCGTGA,0,1144100
fldAp,0.3333333333333333,2,2,ATTCGGATGATCACGATCAA,0,1141630
fldAp,0.3333333333333333,2,2,ATTCCTTTAGATTGGATCTC,0,1168777
fldAp,0.3333333333333333,2,2,ATTCCTCATCCATCTAATAC,0,1097801
fldAp,0.3333333333333333,2,2,ATTCCGAATTATACATAATT,0,1171617
fldAp,0.3333333333333333,2,2,ATTCCCTAGGCGGTAATCGT,0,1136665
fldAp,0.3333333333333333,2,2,ATTCCCCGCGAGTCGCTCCT,0,1178481
fldAp,0.3333333333333333,2,2,ATTCAATTTCCTTCATAAGG,0,1160492
fldAp,0.3333333333333333,2,2,ATTCAAATTCGTGTATCGGA,0,1082149
fldAp,0.3333333333333333,2,2,ATTATTTTGGGCGGGATATT,0,1075886
fldAp,0.3333333333333333,2,2,ATTATGTGATATGGGAGATA,0,1151036
fldAp,0.3333333333333333,2,2,ATTATGAGCACCCGAAAAAT,0,1082582
fldAp,0.3333333333333333,2,2,ATTATGAACATTGATCCGGA,0,1089669
fldAp,0.3333333333333333,2,2,ATTATCAGTTATGGGCTTCC,0,1096829
fldAp,0.3333333333333333,2,2,ATTATAAGACAACTCCCAGG,0,1162948
fldAp,0.3333333333333333,2,2,ATTAGTATGGTTGCATACAG,0,1073899
fldAp,0.3333333333333333,2,2,ATTAGGGCATGAGCACAAAC,0,1098926
fldAp,0.3333333333333333,2,2,ATTAGGAGGTTGAATCAATT,0,1146581
fldAp,0.3333333333333333,2,2,ATTAGATTGTGCACAGCAAA,0,1148796
fldAp,0.3333333333333333,2,2,ATTAGACCGAGACATTGGAC,0,1149550
fldAp,0.3333333333333333,2,2,ATTACGGTGTTGTTTGTGAC,0,1072165
fldAp,0.3333333333333333,2,2,ATTACGCGCAATCGTTCGCA,0,1173563
fldAp,0.3333333333333333,2,2,ATTACGCAACCTGAAACAAA,0,1150802
fldAp,0.3333333333333333,2,2,ATTACCGGCAAAAGGACCGT,0,1161421
fldAp,0.3333333333333333,2,2,ATTACAAACGTCGAACCCGA,0,1178587
fldAp,0.3333333333333333,2,2,ATTAAGGATCCAACTTACCT,0,1107835
fldAp,0.3333333333333333,2,2,ATTAAGAGGCGTCCAGGTGG,0,1114825
fldAp,0.3333333333333333,2,2,ATTAACGTCCATTCCCGGAT,0,1172036
fldAp,0.3333333333333333,2,2,ATTAACGCCTTGAATCGTCA,0,1085291
fldAp,0.3333333333333333,2,2,ATTAAACGCCGGCCTCTTTG,0,1070153
fldAp,0.3333333333333333,2,2,ATGTTTATTTGGAAATGAAA,0,1130038
fldAp,0.3333333333333333,2,2,ATGTTGGCTAACCGTCTGGG,0,1104882
fldAp,0.3333333333333333,2,2,ATGTTACATCTATTACTATA,0,1176022
fldAp,0.3333333333333333,2,2,ATGTGGACCGATTGATACAT,0,1092810
fldAp,0.3333333333333333,2,2,ATGTGATATTCCATCAGCCA,0,1072305
fldAp,0.3333333333333333,2,2,ATGTGAGTGGCTCCATTAGC,0,1123376
fldAp,0.3333333333333333,2,2,ATGTCTGGCTTGATCTCACC,0,1087607
fldAp,0.3333333333333333,2,2,ATGTCGCTGGATGCCCCTGC,0,1154691
fldAp,0.3333333333333333,2,2,ATGTCGCTCGAAATGCATCT,0,1182011
fldAp,0.3333333333333333,2,2,ATGTCAGCAGTTATACAATC,0,1104725
fldAp,0.3333333333333333,2,2,ATGTATTGCAACTCCCTTTG,0,1176347
fldAp,0.3333333333333333,2,2,ATGTATAGCATTAATAGCGT,0,1135933
fldAp,0.3333333333333333,2,2,ATGTAGTCAGATGTATCGCT,0,1076354
fldAp,0.3333333333333333,2,2,ATGTACAAACCACTACCAGG,0,1105075
fldAp,0.3333333333333333,2,2,ATGGTTCAGCGCTTAAAATT,0,1115539
fldAp,0.3333333333333333,2,2,ATGGTGGCGCGACACAGGAG,0,1182547
fldAp,0.3333333333333333,2,2,ATGGTGGAGATCAACAGGCT,0,1065736
fldAp,0.3333333333333333,2,2,ATGGTCCCATTGTAGGGTAG,0,1116565
fldAp,0.3333333333333333,2,2,ATGGGTTGCTGTGTCCGACA,0,1181502
fldAp,0.3333333333333333,2,2,ATGGGTGTGTTAAAGAACTG,0,1127597
fldAp,0.3333333333333333,2,2,ATGGGTACAGTTTATTAGTC,0,1166193
fldAp,0.3333333333333333,2,2,ATGGCTCCCAATTGTGTTGA,0,1104719
fldAp,0.3333333333333333,2,2,ATGGCTAGGCGTCCACACGA,0,1134910
fldAp,0.3333333333333333,2,2,ATGGCCGAATCCAAGCATTT,0,1105736
fldAp,0.3333333333333333,2,2,ATGGCCCAAGCCACACCGGA,0,1115715
fldAp,0.3333333333333333,2,2,ATGGCACTTTGAAGGGAATC,0,1089445
fldAp,0.3333333333333333,2,2,ATGGCACCAGACGGCATTCG,0,1167692
fldAp,0.3333333333333333,2,2,ATGGATTTCGTCTACTCTAG,0,1072399
fldAp,0.3333333333333333,2,2,ATGGACGGGCGTATTCTATC,0,1150478
fldAp,0.3333333333333333,2,2,ATGCTTCAATTCTATCACGA,0,1166901
fldAp,0.3333333333333333,2,2,ATGCTGCATGCGTCGTGGCG,0,1142381
fldAp,0.3333333333333333,2,2,ATGCTGCACCAGTGCGTGAT,0,1185610
fldAp,0.3333333333333333,2,2,ATGCTCTGAAGGATTATAGT,0,1101691
fldAp,0.3333333333333333,2,2,ATGCTCGGTTTACATCCAGC,0,1064720
fldAp,0.3333333333333333,2,2,ATGCTCCGAGCATCCAATCG,0,1128231
fldAp,0.3333333333333333,2,2,ATGCTCCAGGCTTCGTATAG,0,1102216
fldAp,0.3333333333333333,2,2,ATGCTAATTTGGGGGACACA,0,1080394
fldAp,0.3333333333333333,2,2,ATGCGTGACCTTGGCTTAGC,0,1097763
fldAp,0.3333333333333333,2,2,ATGCGGGTTACTCATGGGAA,0,1174229
fldAp,0.3333333333333333,2,2,ATGCGCAGGCCGACCTCGGG,0,1148074
fldAp,0.3333333333333333,2,2,ATGCGCAAGTGCTAGCAGCC,0,1064303
fldAp,0.3333333333333333,2,2,ATGCGAAGAACTACTGGTCC,0,1177451
fldAp,0.3333333333333333,2,2,ATGCCTGTTTACTCCGAAAC,0,1086196
fldAp,0.3333333333333333,2,2,ATGCCGCGGATGCGGTATAT,0,1118184
fldAp,0.3333333333333333,2,2,ATGCCCTGGGTGGCCTGACG,0,1103017
fldAp,0.3333333333333333,2,2,ATGCCCGGCGACAGCTACAA,0,1154776
fldAp,0.3333333333333333,2,2,ATGCAGTAGGAGCGGATTAC,0,1149017
fldAp,0.3333333333333333,2,2,ATGCACACGGTGACTCACTG,0,1157973
fldAp,0.3333333333333333,2,2,ATGCAAATGGCTCCAGCTTA,0,1148744
fldAp,0.3333333333333333,2,2,ATGATTCTCATGTCGATGGT,0,1160318
fldAp,0.3333333333333333,2,2,ATGATGTCTAGGTCTTTCAC,0,1063010
fldAp,0.3333333333333333,2,2,ATGATGTCGTATTTAAACAG,0,1066100
fldAp,0.3333333333333333,2,2,ATGATCCCTCCCTCAGCTGA,0,1170551
fldAp,0.3333333333333333,2,2,ATGATAAAGTTTAACGCTCT,0,1100587
fldAp,0.3333333333333333,2,2,ATGAGACTATAGAATACGTG,0,1092294
fldAp,0.3333333333333333,2,2,ATGACCGAGGCTTCATTCGC,0,1180445
fldAp,0.3333333333333333,2,2,ATGAAGTAGGCTGACGGGCT,0,1150664
fldAp,0.3333333333333333,2,2,ATGAAGGTGGTTCCGAACGA,0,1154300
fldAp,0.3333333333333333,2,2,ATGAAAATGTGTTACACCAT,0,1149755
fldAp,0.3333333333333333,2,2,ATGAAAAATGATACTTTAAT,0,1144570
fldAp,0.3333333333333333,2,2,ATCTTCTATGCTCGGGGGTT,0,1181743
fldAp,0.3333333333333333,2,2,ATCTTAATACGCGAACTGGT,0,1184550
fldAp,0.3333333333333333,2,2,ATCTTAAGGGGGTCAGGCAT,0,1146771
fldAp,0.3333333333333333,2,2,ATCTGTTATGATTTGTTTCA,0,1095028
fldAp,0.3333333333333333,2,2,ATCTGCAGATGTGATTACAA,0,1155782
fldAp,0.3333333333333333,2,2,ATCTGACGCGGCATAACACA,0,1118697
fldAp,0.3333333333333333,2,2,ATCTCTTTTTTGTATCAATT,0,1089058
fldAp,0.3333333333333333,2,2,ATCTCGGTCACAGGATTGTA,0,1152012
fldAp,0.3333333333333333,2,2,ATCTCGCACGCTTATCAACG,0,1109627
fldAp,0.3333333333333333,2,2,ATCTCGAGAGCCCGAGAAGT,0,1097943
fldAp,0.3333333333333333,2,2,ATCTCGAATATTTTCTAGGC,0,1144941
fldAp,0.3333333333333333,2,2,ATCTCCTTCACTTCCCTTTG,0,1096455
fldAp,0.3333333333333333,2,2,ATCTCCCCGCAGCTGAAAAA,0,1086381
fldAp,0.3333333333333333,2,2,ATCTCCATGACGCGGTATCT,0,1121765
fldAp,0.3333333333333333,2,2,ATCTCATGTAGTTCATTTAT,0,1069334
fldAp,0.3333333333333333,2,2,ATCTCACCTGGCATAGCTTG,0,1162823
fldAp,0.3333333333333333,2,2,ATCTATTCACATATTTACCA,0,1182058
fldAp,0.3333333333333333,2,2,ATCTAGAACCTGCCGTTTTT,0,1160556
fldAp,0.3333333333333333,2,2,ATCTAAGCTAAACGTTACAC,0,1104705
fldAp,0.3333333333333333,2,2,ATCGTAATTGTCCACCGGTT,0,1085905
fldAp,0.3333333333333333,2,2,ATCGGTTCTTTCGGTTGTCA,0,1119320
fldAp,0.3333333333333333,2,2,ATCGGTCCTATACCGCTAGG,0,1163207
fldAp,0.3333333333333333,2,2,ATCGGCCCATTTGTGGATGT,0,1155997
fldAp,0.3333333333333333,2,2,ATCGGAACATGGTAAAGCGT,0,1114040
fldAp,0.3333333333333333,2,2,ATCGCTCTGTGATTGCTAAA,0,1152158
fldAp,0.3333333333333333,2,2,ATCGCGGAACGCGGCAGCGA,0,1072335
fldAp,0.3333333333333333,2,2,ATCGCCGGGGGAGCTGACTT,0,1063893
fldAp,0.3333333333333333,2,2,ATCGCCACAAAGGTCCGTCT,0,1088998
fldAp,0.3333333333333333,2,2,ATCGCAGCCCCGAGGTTAAC,0,1115904
fldAp,0.3333333333333333,2,2,ATCGATTGACTGACAGCGAG,0,1167813
fldAp,0.3333333333333333,2,2,ATCGACGAGTCCGCACGAGA,0,1067899
fldAp,0.3333333333333333,2,2,ATCGAATGGATGCGTCACCT,0,1184033
fldAp,0.3333333333333333,2,2,ATCCTCGGGAGTGTTAAGGG,0,1144200
fldAp,0.3333333333333333,2,2,ATCCGTGCTAAGGTCGCATA,0,1185302
fldAp,0.3333333333333333,2,2,ATCCGGGTAACGTGAGGATC,0,1154616
fldAp,0.3333333333333333,2,2,ATCCGATATCCGTTTCTGCC,0,1073914
fldAp,0.3333333333333333,2,2,ATCCCGGGACTGCAAGGGCT,0,1166486
fldAp,0.3333333333333333,2,2,ATCCAGCAGTCTGCCGCCGA,0,1094300
fldAp,0.3333333333333333,2,2,ATCCACGCAACGTAATAAGG,0,1161493
fldAp,0.3333333333333333,2,2,ATCCACCGAGTGATTTTCGT,0,1081191
fldAp,0.3333333333333333,2,2,ATCCACACGGCACTGGACGG,0,1158413
fldAp,0.3333333333333333,2,2,ATCCAACTTCTTACGTATGA,0,1155454
fldAp,0.3333333333333333,2,2,ATCATTTATCCCGCACGGCA,0,1183308
fldAp,0.3333333333333333,2,2,ATCATATCATAAACAGCCGT,0,1132143
fldAp,0.3333333333333333,2,2,ATCATAGGGATCAGCTTGAT,0,1150934
fldAp,0.3333333333333333,2,2,ATCAGTGTAGGCGTATGCTG,0,1069215
fldAp,0.3333333333333333,2,2,ATCAGGTCTTTCCAGTACCG,0,1066275
fldAp,0.3333333333333333,2,2,ATCAGCGTGTCCTGGCGCAA,0,1074334
fldAp,0.3333333333333333,2,2,ATCAGCCTTAAGGATTATCG,0,1097690
fldAp,0.3333333333333333,2,2,ATCAGCCAGACTCGAGATAT,0,1074527
fldAp,0.3333333333333333,2,2,ATCACATACTTACTTTCGGC,0,1164248
fldAp,0.3333333333333333,2,2,ATCACAGTATCCGGTGGAAG,0,1133653
fldAp,0.3333333333333333,2,2,ATCAAGTTTCCAACCTACAA,0,1079641
fldAp,0.3333333333333333,2,2,ATCAACGACGTATAACATTT,0,1132653
fldAp,0.3333333333333333,2,2,ATCAAAGCTCACATGAGGAC,0,1165049
fldAp,0.3333333333333333,2,2,ATCAAACTGCAGGGGGTTTT,0,1066767
fldAp,0.3333333333333333,2,2,ATATTTCGGACCCGGAGTCT,0,1111594
fldAp,0.3333333333333333,2,2,ATATGTAAGCGATTCCAGGC,0,1143561
fldAp,0.3333333333333333,2,2,ATATGGCCTGGGCCAACATT,0,1129559
fldAp,0.3333333333333333,2,2,ATATCGACCGAATGCCTTCA,0,1179377
fldAp,0.3333333333333333,2,2,ATATCCCGTTACCTTGGGTT,0,1090705
fldAp,0.3333333333333333,2,2,ATATCATATAGTGGCGAGAA,0,1106612
fldAp,0.3333333333333333,2,2,ATATCAGTTAGGAACACGGA,0,1071995
fldAp,0.3333333333333333,2,2,ATATCAGATGACGGCTTGCG,0,1105984
fldAp,0.3333333333333333,2,2,ATATAGCACATGCACTATAG,0,1168751
fldAp,0.3333333333333333,2,2,ATATACGACCCAGTTCAGGC,0,1147784
fldAp,0.3333333333333333,2,2,ATATAAAAGTCAAGCCACTT,0,1180879
fldAp,0.3333333333333333,2,2,ATAGTGGTGTCCAAAAATTC,0,1136362
fldAp,0.3333333333333333,2,2,ATAGTACTCTACGTCACAAG,0,1164437
fldAp,0.3333333333333333,2,2,ATAGGTCAGTCACGGTACAG,0,1141922
fldAp,0.3333333333333333,2,2,ATAGCTTCAGTGAATGGTAA,0,1086477
fldAp,0.3333333333333333,2,2,ATAGCAACGCTGGACAACTT,0,1107220
fldAp,0.3333333333333333,2,2,ATAGCAAATATATTCTGCAG,0,1123124
fldAp,0.3333333333333333,2,2,ATAGATTACCTTGGGCAGGT,0,1170155
fldAp,0.3333333333333333,2,2,ATAGAGGTCGTTCGTGTAAT,0,1184323
fldAp,0.3333333333333333,2,2,ATAGAGGGGGGACAGACAAA,0,1154735
fldAp,0.3333333333333333,2,2,ATAGACTCTGGAGGGGCGTA,0,1111290
fldAp,0.3333333333333333,2,2,ATAGACGTGTAAGTTCGTGG,0,1160650
fldAp,0.3333333333333333,2,2,ATAGACAGGAGGCATTTCGT,0,1141428
fldAp,0.3333333333333333,2,2,ATACTTTCATCCTCGTACTA,0,1096263
fldAp,0.3333333333333333,2,2,ATACTTCCGCGTGAGAATGA,0,1173205
fldAp,0.3333333333333333,2,2,ATACTGGAGTGCACCCGCCT,0,1174931
fldAp,0.3333333333333333,2,2,ATACTCATACTTTGCTCCTG,0,1184489
fldAp,0.3333333333333333,2,2,ATACTCAGGCGAACCGATGC,0,1183653
fldAp,0.3333333333333333,2,2,ATACGTACGTACGTATAAAT,0,1180378
fldAp,0.3333333333333333,2,2,ATACGGTTTGAACACCAATG,0,1145383
fldAp,0.3333333333333333,2,2,ATACGATTGCGGGTTTGGGT,0,1111748
fldAp,0.3333333333333333,2,2,ATACGAGGGGTGGTAGCCTA,0,1103280
fldAp,0.3333333333333333,2,2,ATACGAGACCAGCCGCAAAG,0,1158673
fldAp,0.3333333333333333,2,2,ATACCATGCGTAACCTTTTG,0,1147886
fldAp,0.3333333333333333,2,2,ATACATAATCAGTGCGGACT,0,1146167
fldAp,0.3333333333333333,2,2,ATAATCACTGGCATCTTGGT,0,1154071
fldAp,0.3333333333333333,2,2,ATAATAAGCCAAAAGGTACG,0,1128790
fldAp,0.3333333333333333,2,2,ATAATAAACCGCTAGGACTC,0,1119389
fldAp,0.3333333333333333,2,2,ATAAGTTGTTATGGCAATTA,0,1090853
fldAp,0.3333333333333333,2,2,ATAAGGGGATATGCGAACAT,0,1087540
fldAp,0.3333333333333333,2,2,ATAAGATTTGTACTATCGGT,0,1168621
fldAp,0.3333333333333333,2,2,ATAAGAGTCAATCATCGCGA,0,1185055
fldAp,0.3333333333333333,2,2,ATAACGGATACACTTACTAT,0,1103853
fldAp,0.3333333333333333,2,2,ATAACGATCCTGGTTAAATA,0,1181981
fldAp,0.3333333333333333,2,2,ATAACGAATGGAGGGGCTAT,0,1162107
fldAp,0.3333333333333333,2,2,ATAACCGTGTACAACTTCTT,0,1137321
fldAp,0.3333333333333333,2,2,ATAACATTGATATGTTCAAC,0,1116993
fldAp,0.3333333333333333,2,2,ATAAATTGGCTAATCCCTAT,0,1066093
fldAp,0.3333333333333333,2,2,ATAAAGTGTATGGCGTATTG,0,1114054
fldAp,0.3333333333333333,2,2,ATAAAACGCTATGGTCATCA,0,1068845
fldAp,0.3333333333333333,2,2,AGTTTTGATACGTGTCCTTA,0,1185928
fldAp,0.3333333333333333,2,2,AGTTTTCGATGGACAGGAGT,0,1158972
fldAp,0.3333333333333333,2,2,AGTTTTACGGATTTAATACG,0,1077925
fldAp,0.3333333333333333,2,2,AGTTTCGCCGCTGTATTGGG,0,1173636
fldAp,0.3333333333333333,2,2,AGTTTCCCAATAGAGGCCAT,0,1094728
fldAp,0.3333333333333333,2,2,AGTTGGTGACGCGGTTTCAG,0,1152424
fldAp,0.3333333333333333,2,2,AGTTGACTATCTAGAATGCT,0,1143924
fldAp,0.3333333333333333,2,2,AGTTCTGCCCCAAGAGTCTT,0,1108435
fldAp,0.3333333333333333,2,2,AGTTCTCGGAGCGCGCTTAG,0,1086979
fldAp,0.3333333333333333,2,2,AGTTCGGACAACTTTGACAC,0,1131722
fldAp,0.3333333333333333,2,2,AGTTCGGAATATGGTTAAAG,0,1090613
fldAp,0.3333333333333333,2,2,AGTTCCTCCTGGTCAGCACG,0,1073816
fldAp,0.3333333333333333,2,2,AGTTCCCTTTCCTGGGCTCT,0,1074217
fldAp,0.3333333333333333,2,2,AGTTATGCAGAGTAGGAGTA,0,1122785
fldAp,0.3333333333333333,2,2,AGTTAGATGCGTTTTAATGT,0,1063495
fldAp,0.3333333333333333,2,2,AGTTAAGAAATTATCCGTCA,0,1064965
fldAp,0.3333333333333333,2,2,AGTGTTTCCCGGGACTGTAG,0,1159276
fldAp,0.3333333333333333,2,2,AGTGTCCTACGCATCAGCCG,0,1075637
fldAp,0.3333333333333333,2,2,AGTGTACGGTGGCAATGCGT,0,1089238
fldAp,0.3333333333333333,2,2,AGTGGTTCGGCCACGAATCG,0,1178739
fldAp,0.3333333333333333,2,2,AGTGGGGACGTTTGGAGTTC,0,1109847
fldAp,0.3333333333333333,2,2,AGTGGGAAAACAGATTGTGT,0,1073260
fldAp,0.3333333333333333,2,2,AGTGCTTCCTTCGCTCCGAC,0,1120366
fldAp,0.3333333333333333,2,2,AGTGCTAATACTGGGCGGAT,0,1122710
fldAp,0.3333333333333333,2,2,AGTGCGAAAGCCCTAAGCTT,0,1100363
fldAp,0.3333333333333333,2,2,AGTGCCTAGTAAGGGTAGTC,0,1173152
fldAp,0.3333333333333333,2,2,AGTGCCCTTCCGTTACACAA,0,1164952
fldAp,0.3333333333333333,2,2,AGTGATGTCGTGGCCTGAGG,0,1086759
fldAp,0.3333333333333333,2,2,AGTGATCGCGTGAGGTAACT,0,1154141
fldAp,0.3333333333333333,2,2,AGTGAGTAGACCTCGAGCGC,0,1142874
fldAp,0.3333333333333333,2,2,AGTGAGGAAGATCCCAGTGA,0,1077610
fldAp,0.3333333333333333,2,2,AGTGAGCGGTCACAGTAAAT,0,1153589
fldAp,0.3333333333333333,2,2,AGTGACCTGACGCACAGGAT,0,1129972
fldAp,0.3333333333333333,2,2,AGTGACCATCGAATTTTGCC,0,1106909
fldAp,0.3333333333333333,2,2,AGTGAAGTTACTCACGATAA,0,1092027
fldAp,0.3333333333333333,2,2,AGTCTTTACCAGCACGGACG,0,1136435
fldAp,0.3333333333333333,2,2,AGTCTTGTCTTTGGTTCGGG,0,1126106
fldAp,0.3333333333333333,2,2,AGTCTCCGGTGCTCGCGCTA,0,1170993
fldAp,0.3333333333333333,2,2,AGTCGCGCATTGTGGGGCCT,0,1112116
fldAp,0.3333333333333333,2,2,AGTCGCGCACTCGGGACGTA,0,1102520
fldAp,0.3333333333333333,2,2,AGTCGCAGGTTCCGGACGCT,0,1081379
fldAp,0.3333333333333333,2,2,AGTCGATCATTTAACGTATG,0,1176461
fldAp,0.3333333333333333,2,2,AGTCCTATGAACATGGAAAT,0,1131605
fldAp,0.3333333333333333,2,2,AGTCCTAGTGTCGGCGCCTC,0,1102110
fldAp,0.3333333333333333,2,2,AGTCCAGGGGGGCCTAGAGA,0,1139059
fldAp,0.3333333333333333,2,2,AGTCATGGATAGTCTCCGGA,0,1126458
fldAp,0.3333333333333333,2,2,AGTCATCCCGCAGTGCGATT,0,1183678
fldAp,0.3333333333333333,2,2,AGTCAGCAGGTGATGGTGGT,0,1063449
fldAp,0.3333333333333333,2,2,AGTCAACTTGCTAATGTACA,0,1096271
fldAp,0.3333333333333333,2,2,AGTATTGCTGCAAGATTGGG,0,1080583
fldAp,0.3333333333333333,2,2,AGTATGACTACTTCGTTACA,0,1129239
fldAp,0.3333333333333333,2,2,AGTATCTTCGAGGTCGGTCA,0,1122074
fldAp,0.3333333333333333,2,2,AGTATCTAATTAATCGCAGA,0,1175270
fldAp,0.3333333333333333,2,2,AGTATCATTTAGGGTGATGA,0,1148821
fldAp,0.3333333333333333,2,2,AGTAGTGGATAGACTACTAA,0,1148897
fldAp,0.3333333333333333,2,2,AGTAGTATTGAGACAGGGTC,0,1085901
fldAp,0.3333333333333333,2,2,AGTAGTAAGTATACCGTATT,0,1081117
fldAp,0.3333333333333333,2,2,AGTAGCGTATAGGGAACGCC,0,1146633
fldAp,0.3333333333333333,2,2,AGTAGCGCCATTGGAAATAA,0,1129745
fldAp,0.3333333333333333,2,2,AGTAGAGAGCAATCGGAAAC,0,1145985
fldAp,0.3333333333333333,2,2,AGTACTAAGAGTTGGGCGCC,0,1168396
fldAp,0.3333333333333333,2,2,AGTAAGAACAAGGGAGGGAC,0,1151388
fldAp,0.3333333333333333,2,2,AGTAACCCTGGCGACAAAAA,0,1102321
fldAp,0.3333333333333333,2,2,AGGTTTCATCCCATTTCGCA,0,1149030
fldAp,0.3333333333333333,2,2,AGGTTCGTCAGAACTCTCAT,0,1169313
fldAp,0.3333333333333333,2,2,AGGTGGTGGTATCTATGGGT,0,1182121
fldAp,0.3333333333333333,2,2,AGGTGGGATCCGTATAAGAG,0,1160093
fldAp,0.3333333333333333,2,2,AGGTGGCGGCGGAAGCCTGC,0,1099638
fldAp,0.3333333333333333,2,2,AGGTGAGAAACATAAGACTA,0,1148195
fldAp,0.3333333333333333,2,2,AGGTGACCCGTAGTCTCAAC,0,1094516
fldAp,0.3333333333333333,2,2,AGGTCTGAGTGGTTAGTTAT,0,1090850
fldAp,0.3333333333333333,2,2,AGGTCGTGTTTCTAGTCAGA,0,1068432
fldAp,0.3333333333333333,2,2,AGGTCGTAGAATTATCTGTG,0,1069229
fldAp,0.3333333333333333,2,2,AGGTCATACCCGTGGAGTAC,0,1116407
fldAp,0.3333333333333333,2,2,AGGTATTTACTGTAAAGCTC,0,1148658
fldAp,0.3333333333333333,2,2,AGGTAGGCTTTTAGGAGTGG,0,1139073
fldAp,0.3333333333333333,2,2,AGGTACGATGTCATCCAAAG,0,1065807
fldAp,0.3333333333333333,2,2,AGGTACCTGGTCTCGAGACA,0,1147622
fldAp,0.3333333333333333,2,2,AGGTAACTTCTAGATCAAAA,0,1165297
fldAp,0.3333333333333333,2,2,AGGGTTATTATTAAATCTCT,0,1132782
fldAp,0.3333333333333333,2,2,AGGGTCTTCACGATCCCACC,0,1154875
fldAp,0.3333333333333333,2,2,AGGGTCGTCTGCGTTGGTGT,0,1170424
fldAp,0.3333333333333333,2,2,AGGGTCCTATAATTTGTTAG,0,1139898
fldAp,0.3333333333333333,2,2,AGGGGACTGTTGTAACTCCG,0,1106863
fldAp,0.3333333333333333,2,2,AGGGGACTCGTTTTCTGGAC,0,1135545
fldAp,0.3333333333333333,2,2,AGGGCTTTGGCTGTCACACT,0,1132869
fldAp,0.3333333333333333,2,2,AGGGCTTGAAGACTATGAGT,0,1123888
fldAp,0.3333333333333333,2,2,AGGGCTAACAAGGTAGGTAG,0,1166279
fldAp,0.3333333333333333,2,2,AGGGCGGGCACGTGGGCCTG,0,1086782
fldAp,0.3333333333333333,2,2,AGGGCACATGATTCCGTTGC,0,1161360
fldAp,0.3333333333333333,2,2,AGGGACCGTGACAATGGTTT,0,1127672
fldAp,0.3333333333333333,2,2,AGGGAAGAAAGCTGCACCAG,0,1173299
fldAp,0.3333333333333333,2,2,AGGGAACACATAGCTGTATT,0,1101735
fldAp,0.3333333333333333,2,2,AGGCTTCGATTCGAGCTCGT,0,1160180
fldAp,0.3333333333333333,2,2,AGGCTGAGTTCTCAGTACAG,0,1141828
fldAp,0.3333333333333333,2,2,AGGCTCATAAAACAGTCCGC,0,1124693
fldAp,0.3333333333333333,2,2,AGGCTAATATGGCACGTATG,0,1076063
fldAp,0.3333333333333333,2,2,AGGCTAAGACCGCGCTTCGG,0,1158355
fldAp,0.3333333333333333,2,2,AGGCGTAGGGACGGTATACA,0,1112105
fldAp,0.3333333333333333,2,2,AGGCGGTTCCTCCCTCGCCA,0,1090336
fldAp,0.3333333333333333,2,2,AGGCGCAATTCAGCTGAGAC,0,1102347
fldAp,0.3333333333333333,2,2,AGGCGAGAGCCGCGTCCCGA,0,1148583
fldAp,0.3333333333333333,2,2,AGGCGACCTACTATAAGATT,0,1085891
fldAp,0.3333333333333333,2,2,AGGCCTACTAAGCCAGCTCT,0,1068753
fldAp,0.3333333333333333,2,2,AGGCCGACAGTTAGCCCTGT,0,1126655
fldAp,0.3333333333333333,2,2,AGGCCCTACGGCGGCGTGTT,0,1085271
fldAp,0.3333333333333333,2,2,AGGCCCGGTATGAGAGTGAC,0,1181221
fldAp,0.3333333333333333,2,2,AGGCCATGTAACGATTGGTA,0,1155709
fldAp,0.3333333333333333,2,2,AGGCATTACGGCTGTCCCCC,0,1169889
fldAp,0.3333333333333333,2,2,AGGCAAAGATGTCAGAGAGT,0,1182303
fldAp,0.3333333333333333,2,2,AGGATGATCGTTGGGTTCAG,0,1097346
fldAp,0.3333333333333333,2,2,AGGATCCCAGCGTAGATGGG,0,1114489
fldAp,0.3333333333333333,2,2,AGGATCATAACCCGGCATCT,0,1098995
fldAp,0.3333333333333333,2,2,AGGAGGAAGGTAACGTGTTA,0,1134443
fldAp,0.3333333333333333,2,2,AGGAGCCCCTTTTCATCAGT,0,1086510
fldAp,0.3333333333333333,2,2,AGGAGCATTCCAATGGGTGC,0,1138417
fldAp,0.3333333333333333,2,2,AGGAGCATTCAGAGGCCTGC,0,1163233
fldAp,0.3333333333333333,2,2,AGGAGATTGACATCTACCAA,0,1073786
fldAp,0.3333333333333333,2,2,AGGACAGCATTGTGCATTCA,0,1073453
fldAp,0.3333333333333333,2,2,AGGACAATGCAAAAAACTGA,0,1098417
fldAp,0.3333333333333333,2,2,AGGAATTTAACTTCCGCACA,0,1074762
fldAp,0.3333333333333333,2,2,AGGAAGAGAGCTTAGAGTCG,0,1166561
fldAp,0.3333333333333333,2,2,AGCTTGTGTGGGTGAGAGAA,0,1142672
fldAp,0.3333333333333333,2,2,AGCTTGACGCGGACTCTGTA,0,1098152
fldAp,0.3333333333333333,2,2,AGCTTCTCGATTACATACTG,0,1081314
fldAp,0.3333333333333333,2,2,AGCTTCGCACTTATACATGA,0,1117449
fldAp,0.3333333333333333,2,2,AGCTGTGTCAATATTCGGAA,0,1078386
fldAp,0.3333333333333333,2,2,AGCTGTAGAGGGACCAGTAT,0,1186618
fldAp,0.3333333333333333,2,2,AGCTGGGTGGGCGGACGTTA,0,1161821
fldAp,0.3333333333333333,2,2,AGCTGGAAGGAGCGCACGTG,0,1161494
fldAp,0.3333333333333333,2,2,AGCTGCACCAAGAACCGTCA,0,1168442
fldAp,0.3333333333333333,2,2,AGCTCTTGTGCACGGATTTG,0,1148877
fldAp,0.3333333333333333,2,2,AGCTCTGTAAGCACTTGCAA,0,1142800
fldAp,0.3333333333333333,2,2,AGCTCCTGCTGAGACCGATA,0,1171125
fldAp,0.3333333333333333,2,2,AGCTATCGGGCAGAGTAATT,0,1138054
fldAp,0.3333333333333333,2,2,AGCTAAGTGGCTCGGACGCC,0,1173783
fldAp,0.3333333333333333,2,2,AGCTAAGGTGCAACGACTAA,0,1181069
fldAp,0.3333333333333333,2,2,AGCTAAGGGGGCACGGTGCA,0,1182026
fldAp,0.3333333333333333,2,2,AGCTAAGGCATGATAGGACG,0,1127146
fldAp,0.3333333333333333,2,2,AGCGTCACTGCCCAGGGCCT,0,1185748
fldAp,0.3333333333333333,2,2,AGCGTATGTTTTATATTGGC,0,1095882
fldAp,0.3333333333333333,2,2,AGCGTAGCATATTTTCGCAA,0,1121699
fldAp,0.3333333333333333,2,2,AGCGGTTGTATAGCAAAAGT,0,1084700
fldAp,0.3333333333333333,2,2,AGCGGTTCCATGCACTGTCT,0,1137193
fldAp,0.3333333333333333,2,2,AGCGGGGGACGGGCAGGTCA,0,1072838
fldAp,0.3333333333333333,2,2,AGCGGGGCGTAAACAATCGT,0,1124206
fldAp,0.3333333333333333,2,2,AGCGGCTTCCAGAGGGAGAG,0,1144898
fldAp,0.3333333333333333,2,2,AGCGGCCGAGTTCAGTGCAT,0,1129170
fldAp,0.3333333333333333,2,2,AGCGCTCAGTTAAACGCTCT,0,1091064
fldAp,0.3333333333333333,2,2,AGCGCGAATTACTGTAAAAT,0,1144075
fldAp,0.3333333333333333,2,2,AGCGCCTCCGAACTGGTTAA,0,1125320
fldAp,0.3333333333333333,2,2,AGCGCCATAATTTAACCACT,0,1096553
fldAp,0.3333333333333333,2,2,AGCGAGGCGTCGGGGTGCGA,0,1076184
fldAp,0.3333333333333333,2,2,AGCGAGAATCGGGTCATGTT,0,1175434
fldAp,0.3333333333333333,2,2,AGCCTTAGTGACACGATGTA,0,1080645
fldAp,0.3333333333333333,2,2,AGCCGGGGTAGTCCGACCAG,0,1161608
fldAp,0.3333333333333333,2,2,AGCCGGCCTATCGGGGAATT,0,1081451
fldAp,0.3333333333333333,2,2,AGCCGCTGTACCTACGTGAT,0,1086025
fldAp,0.3333333333333333,2,2,AGCCGCGGCGCAGGTCAATT,0,1170594
fldAp,0.3333333333333333,2,2,AGCCCATGCGGACCTTCGGT,0,1113077
fldAp,0.3333333333333333,2,2,AGCCATAATCGTAACAGCGG,0,1126825
fldAp,0.3333333333333333,2,2,AGCCAGGTTACCCCACACCG,0,1098859
fldAp,0.3333333333333333,2,2,AGCCACTCAATACATCCGGT,0,1095379
fldAp,0.3333333333333333,2,2,AGCCAAGTCCGATGAGGTGG,0,1096127
fldAp,0.3333333333333333,2,2,AGCCAAGGGGGCTTTTTCTT,0,1176000
fldAp,0.3333333333333333,2,2,AGCATGCTTTAGCTTATGGG,0,1153083
fldAp,0.3333333333333333,2,2,AGCATGCATTAAAGACCCGT,0,1118506
fldAp,0.3333333333333333,2,2,AGCATCAGGTTTACAATTAC,0,1088004
fldAp,0.3333333333333333,2,2,AGCATCAATTCTGATCAAGA,0,1144533
fldAp,0.3333333333333333,2,2,AGCAGTCCAGTTCGCCGTCA,0,1077007
fldAp,0.3333333333333333,2,2,AGCAGGGAGTTACGCCAACG,0,1155387
fldAp,0.3333333333333333,2,2,AGCACTGGGGGTATAAGAGT,0,1155567
fldAp,0.3333333333333333,2,2,AGCACATATTAATTCTGTTA,0,1080897
fldAp,0.3333333333333333,2,2,AGCAATTTCTTGTTGTTACC,0,1143025
fldAp,0.3333333333333333,2,2,AGCAACCAAAGTACGCTCGA,0,1123260
fldAp,0.3333333333333333,2,2,AGATTTTGCCCTCCCGTACT,0,1164525
fldAp,0.3333333333333333,2,2,AGATTCCCCTAGATTATTCA,0,1126420
fldAp,0.3333333333333333,2,2,AGATTCACAAGGGCCGGCTT,0,1075485
fldAp,0.3333333333333333,2,2,AGATGTTTGGTTTTTCACGA,0,1150257
fldAp,0.3333333333333333,2,2,AGATGTGGTTTTGAGAATGT,0,1096611
fldAp,0.3333333333333333,2,2,AGATGGTCAATAGTCCGTGC,0,1083526
fldAp,0.3333333333333333,2,2,AGATGGTACCGGAAGTTAGA,0,1160939
fldAp,0.3333333333333333,2,2,AGATGGGGACGGCTTACCCT,0,1080432
fldAp,0.3333333333333333,2,2,AGATGGAAATGAACAATGGA,0,1184792
fldAp,0.3333333333333333,2,2,AGATGAACGCTACGCCCCGT,0,1086211
fldAp,0.3333333333333333,2,2,AGATATAATACTTCCTGTAT,0,1069204
fldAp,0.3333333333333333,2,2,AGATAGGTTTTTGCTTTAGA,0,1145539
fldAp,0.3333333333333333,2,2,AGATAACGTCAGAAGTTACA,0,1152173
fldAp,0.3333333333333333,2,2,AGAGTTCAAGCGTAGTTTAG,0,1104610
fldAp,0.3333333333333333,2,2,AGAGTGGGGCCAGTGTCCAT,0,1084824
fldAp,0.3333333333333333,2,2,AGAGTCTCACGAAACTCTGG,0,1166000
fldAp,0.3333333333333333,2,2,AGAGGTAGGTAAAAGCACAT,0,1109306
fldAp,0.3333333333333333,2,2,AGAGGTACCAAGTGTCAAAG,0,1120354
fldAp,0.3333333333333333,2,2,AGAGGCTGGTAGCACATGAA,0,1082941
fldAp,0.3333333333333333,2,2,AGAGGCCGACCGTCCTGCAG,0,1137231
fldAp,0.3333333333333333,2,2,AGAGCTTCACTTTTCTCGGG,0,1149081
fldAp,0.3333333333333333,2,2,AGAGCGTTGCCCAACAAGGT,0,1108338
fldAp,0.3333333333333333,2,2,AGAGCAGTCACATCCCAAGA,0,1144834
fldAp,0.3333333333333333,2,2,AGAGCACCGACTTCAAGATA,0,1131314
fldAp,0.3333333333333333,2,2,AGAGATTCAAGTCTTTGTTT,0,1138516
fldAp,0.3333333333333333,2,2,AGAGAGTTCCCTTATGAGAC,0,1155491
fldAp,0.3333333333333333,2,2,AGAGACCCTGGACAACTACC,0,1076835
fldAp,0.3333333333333333,2,2,AGACTTTGTCGATTATTATA,0,1132391
fldAp,0.3333333333333333,2,2,AGACTCCGCCATAAACGGTC,0,1073194
fldAp,0.3333333333333333,2,2,AGACTAGGGGCACTGCAATG,0,1065504
fldAp,0.3333333333333333,2,2,AGACGTGAATTTGTTTAATC,0,1185137
fldAp,0.3333333333333333,2,2,AGACGGGCGAAGGCGGAGTA,0,1145607
fldAp,0.3333333333333333,2,2,AGACGAGGCGCGCCAATAGG,0,1066555
fldAp,0.3333333333333333,2,2,AGACCCTTTACATGTGAGCT,0,1171347
fldAp,0.3333333333333333,2,2,AGACACTCGTTAAATGAAAC,0,1156111
fldAp,0.3333333333333333,2,2,AGACACCTCAATTCACCCAC,0,1117797
fldAp,0.3333333333333333,2,2,AGACAATGATACCATTCTGT,0,1147016
fldAp,0.3333333333333333,2,2,AGACAACTCTTAGTTGTGCC,0,1118428
fldAp,0.3333333333333333,2,2,AGAATTCAAGGTCCGGCAAC,0,1064143
fldAp,0.3333333333333333,2,2,AGAATGAAATAGAGTGGCTC,0,1142149
fldAp,0.3333333333333333,2,2,AGAATACAAATTCATGTGCC,0,1063774
fldAp,0.3333333333333333,2,2,AGAAGGCGACAGAACCCACG,0,1167599
fldAp,0.3333333333333333,2,2,AGAAGCCCACTTCCAGAAGT,0,1150222
fldAp,0.3333333333333333,2,2,AGAACTAGATATAAGTGCTG,0,1171461
fldAp,0.3333333333333333,2,2,AGAACTAACCCATGATTAGA,0,1112189
fldAp,0.3333333333333333,2,2,AGAACGGGAAGCCCTACAAC,0,1144435
fldAp,0.3333333333333333,2,2,AGAACCTAAACGGTCACAGT,0,1089569
fldAp,0.3333333333333333,2,2,AGAACAGCGGACAAGGCCCG,0,1147342
fldAp,0.3333333333333333,2,2,AGAAAGTTCCGACTGCGCTG,0,1148717
fldAp,0.3333333333333333,2,2,AGAAAACGCTTGCGTGGACA,0,1083097
fldAp,0.3333333333333333,2,2,ACTTTTGTATACCGTAAACA,0,1103103
fldAp,0.3333333333333333,2,2,ACTTTTAAAAGTAGTAGTGA,0,1158183
fldAp,0.3333333333333333,2,2,ACTTTGCAGCTTTTGGCATT,0,1155973
fldAp,0.3333333333333333,2,2,ACTTTAAAAGGTAGAAATTC,0,1158654
fldAp,0.3333333333333333,2,2,ACTTGGACGGTGGTTACAGG,0,1169697
fldAp,0.3333333333333333,2,2,ACTTGAGAGCTAAACGGTTC,0,1178096
fldAp,0.3333333333333333,2,2,ACTTGAGAAGCCAAAACAAG,0,1087100
fldAp,0.3333333333333333,2,2,ACTTCTAGCCACGGTCGTTC,0,1087289
fldAp,0.3333333333333333,2,2,ACTTCGCCCCGTGATCTAGG,0,1129524
fldAp,0.3333333333333333,2,2,ACTTCCCGCCAGCTTGATCC,0,1152355
fldAp,0.3333333333333333,2,2,ACTTCATGGCGGGGATATGT,0,1096569
fldAp,0.3333333333333333,2,2,ACTTACCACTAGGGCCACTA,0,1064488
fldAp,0.3333333333333333,2,2,ACTGGTTTCTACGAACAATA,0,1105948
fldAp,0.3333333333333333,2,2,ACTGGAGTTACGCCTGGATC,0,1150409
fldAp,0.3333333333333333,2,2,ACTGCAAGTTACACTGTAAC,0,1122273
fldAp,0.3333333333333333,2,2,ACTGATAACCACCCTCTATT,0,1182768
fldAp,0.3333333333333333,2,2,ACTGACGTGCCGGGGCATAG,0,1076545
fldAp,0.3333333333333333,2,2,ACTGACGTCTACCGAACAAA,0,1069827
fldAp,0.3333333333333333,2,2,ACTGAAGGTTGACTCTGAGA,0,1118515
fldAp,0.3333333333333333,2,2,ACTCTGGCTAACGTCGTGTA,0,1146747
fldAp,0.3333333333333333,2,2,ACTCTGCTGAGAGACCTGCC,0,1147717
fldAp,0.3333333333333333,2,2,ACTCGCAGAAGCGTACTAGG,0,1065226
fldAp,0.3333333333333333,2,2,ACTCCTGAACTCTCGACTCA,0,1131861
fldAp,0.3333333333333333,2,2,ACTCCGGACCCACTGTGATG,0,1159318
fldAp,0.3333333333333333,2,2,ACTCCGAAGCTCTTTAAGCA,0,1083149
fldAp,0.3333333333333333,2,2,ACTCCATTGGAATCGCCCAC,0,1076079
fldAp,0.3333333333333333,2,2,ACTCCAGTCCCTTGGTTCAT,0,1085142
fldAp,0.3333333333333333,2,2,ACTCATCGAGGTAAAAATTC,0,1137713
fldAp,0.3333333333333333,2,2,ACTCACGCACTGCGGACCGC,0,1119714
fldAp,0.3333333333333333,2,2,ACTCAAGAGAACAGTGCGCT,0,1067232
fldAp,0.3333333333333333,2,2,ACTATTAACCCACTGTGATC,0,1124173
fldAp,0.3333333333333333,2,2,ACTATGTTATATTCGAAGAG,0,1134149
fldAp,0.3333333333333333,2,2,ACTAGGTTCTGTTCGCAATA,0,1086758
fldAp,0.3333333333333333,2,2,ACTAGGGTAGGTTAATTCAA,0,1126764
fldAp,0.3333333333333333,2,2,ACTAGACGTTCCGGCCAAGG,0,1089301
fldAp,0.3333333333333333,2,2,ACTACGTTGCGGTAATGTCT,0,1100065
fldAp,0.3333333333333333,2,2,ACTAAGTAACCCACCGTGCG,0,1072066
fldAp,0.3333333333333333,2,2,ACTAAGCGGAGCTGGAACAG,0,1159222
fldAp,0.3333333333333333,2,2,ACTAAGAACAACGGCGCGGC,0,1102808
fldAp,0.3333333333333333,2,2,ACTAAATAGCGACTGTGCCA,0,1086481
fldAp,0.3333333333333333,2,2,ACTAAAGGCTGAGCGACTTT,0,1092647
fldAp,0.3333333333333333,2,2,ACGTTTTGGGTGGGTCACTT,0,1153211
fldAp,0.3333333333333333,2,2,ACGTTTTATGATCTGCAGCT,0,1102521
fldAp,0.3333333333333333,2,2,ACGTTTCCCACGCGCGGCAA,0,1165887
fldAp,0.3333333333333333,2,2,ACGTTTATCATTCCGTCTTC,0,1117829
fldAp,0.3333333333333333,2,2,ACGTTCTTTCAAGGTTCGGA,0,1126986
fldAp,0.3333333333333333,2,2,ACGTTCGACAGTGGGAAACT,0,1100190
fldAp,0.3333333333333333,2,2,ACGTTACGTGTCCTTGTTTT,0,1146263
fldAp,0.3333333333333333,2,2,ACGTTAAGTCGGATAACGCC,0,1148901
fldAp,0.3333333333333333,2,2,ACGTGTTGCGCGGATATGAG,0,1122516
fldAp,0.3333333333333333,2,2,ACGTGTGTATGAATCGCCAG,0,1131987
fldAp,0.3333333333333333,2,2,ACGTGTGCAGAGCTGTAAAG,0,1169520
fldAp,0.3333333333333333,2,2,ACGTGTCGAGATGTGTTGTA,0,1148769
fldAp,0.3333333333333333,2,2,ACGTGTAGCGAGGATAACGG,0,1149759
fldAp,0.3333333333333333,2,2,ACGTGGCTGCGCCTCCTGTA,0,1068466
fldAp,0.3333333333333333,2,2,ACGTGCGGGACCATCGCAAA,0,1137394
fldAp,0.3333333333333333,2,2,ACGTGATCATCTAGGAAGCT,0,1141413
fldAp,0.3333333333333333,2,2,ACGTCTAAGGCGGGTTCTGG,0,1159655
fldAp,0.3333333333333333,2,2,ACGTCAAGCGAGCTCCCACT,0,1162274
fldAp,0.3333333333333333,2,2,ACGTACTGCTATCGACCGGT,0,1124125
fldAp,0.3333333333333333,2,2,ACGGTGTTTAGTACGGAAAC,0,1160558
fldAp,0.3333333333333333,2,2,ACGGTGGTAAGCCTGTTCTT,0,1087429
fldAp,0.3333333333333333,2,2,ACGGTCTCCTTTGTCGGATG,0,1134653
fldAp,0.3333333333333333,2,2,ACGGTCCCGAGGGGAGTACT,0,1088435
fldAp,0.3333333333333333,2,2,ACGGTAACGGGAAGCCTGCC,0,1136868
fldAp,0.3333333333333333,2,2,ACGGGTCTAGGTATGATTAT,0,1083268
fldAp,0.3333333333333333,2,2,ACGGGAGGATCGCTGCGTGT,0,1185518
fldAp,0.3333333333333333,2,2,ACGGCGGCGGATTTCTCCGG,0,1133097
fldAp,0.3333333333333333,2,2,ACGGCCTTGTCGCGAATTAG,0,1120716
fldAp,0.3333333333333333,2,2,ACGGCCCTTACATCGTGCCC,0,1106610
fldAp,0.3333333333333333,2,2,ACGGCCAGTCAACGTGCCAA,0,1081470
fldAp,0.3333333333333333,2,2,ACGGCAGGAGGGATCAATCT,0,1063069
fldAp,0.3333333333333333,2,2,ACGGCAATTCTCCCTTGCGT,0,1184853
fldAp,0.3333333333333333,2,2,ACGGATGAGCTAGACAATGA,0,1176444
fldAp,0.3333333333333333,2,2,ACGGAGATATCGCCTGGTAG,0,1119810
fldAp,0.3333333333333333,2,2,ACGGAATCATGGAGTTGTAG,0,1142106
fldAp,0.3333333333333333,2,2,ACGCTTCGAGTAACCGTTAG,0,1178185
fldAp,0.3333333333333333,2,2,ACGCTGAGACCGGGGTACGC,0,1152647
fldAp,0.3333333333333333,2,2,ACGCTATGCAAACCCGAGGC,0,1150196
fldAp,0.3333333333333333,2,2,ACGCTAGGAAATTGGACAGT,0,1172965
fldAp,0.3333333333333333,2,2,ACGCTACCGTTGTCAATGAT,0,1086120
fldAp,0.3333333333333333,2,2,ACGCGGCTCCAGTCATCACC,0,1075149
fldAp,0.3333333333333333,2,2,ACGCGGATATGGGGAACGAT,0,1155917
fldAp,0.3333333333333333,2,2,ACGCGATACGGGCGCCTGAG,0,1126288
fldAp,0.3333333333333333,2,2,ACGCCCTGTGGCTAGAATTA,0,1139020
fldAp,0.3333333333333333,2,2,ACGCCATAGTGAGTGCCCGT,0,1167601
fldAp,0.3333333333333333,2,2,ACGCAGCCGGACGGCATAAT,0,1119210
fldAp,0.3333333333333333,2,2,ACGCAAGGCCGAATGCGTAG,0,1105781
fldAp,0.3333333333333333,2,2,ACGCAACCTGGCCTCGACGA,0,1120421
fldAp,0.3333333333333333,2,2,ACGATTTGAGCACCAGGGGT,0,1080806
fldAp,0.3333333333333333,2,2,ACGATTGTTCTGGTAGTCTC,0,1087947
fldAp,0.3333333333333333,2,2,ACGATTGGGTTACCGTTGAT,0,1148837
fldAp,0.3333333333333333,2,2,ACGAGTGCCTAAGTACGCAA,0,1103409
fldAp,0.3333333333333333,2,2,ACGAGAGTACGAAATCTCCA,0,1097787
fldAp,0.3333333333333333,2,2,ACGACTGTAAGCCCAGTTTA,0,1152241
fldAp,0.3333333333333333,2,2,ACGACTGAGACATTTCATGT,0,1090599
fldAp,0.3333333333333333,2,2,ACGACGGCCCTGTTGAATAA,0,1127567
fldAp,0.3333333333333333,2,2,ACGACCTGAAAGGGATTCTC,0,1155124
fldAp,0.3333333333333333,2,2,ACGAAGCTGAGTGATACGTC,0,1072241
fldAp,0.3333333333333333,2,2,ACGAACGTCTGTATGAGTGG,0,1152534
fldAp,0.3333333333333333,2,2,ACGAACGACCAACCCCTCTT,0,1120383
fldAp,0.3333333333333333,2,2,ACGAAATAAAGTCTGCTTTA,0,1089350
fldAp,0.3333333333333333,2,2,ACGAAAGCGAATATTAATGT,0,1130843
fldAp,0.3333333333333333,2,2,ACGAAACAACTGCCTACAAG,0,1077649
fldAp,0.3333333333333333,2,2,ACCTTCTCCATCCTCTTGAT,0,1107494
fldAp,0.3333333333333333,2,2,ACCTTACCGTGTTACTGAAG,0,1089330
fldAp,0.3333333333333333,2,2,ACCTTAAGTGTTTCGTGATT,0,1102215
fldAp,0.3333333333333333,2,2,ACCTGTAGGTAACCTCGACG,0,1172446
fldAp,0.3333333333333333,2,2,ACCTGGGTACGACTAGCCCT,0,1129449
fldAp,0.3333333333333333,2,2,ACCTCCTGGTCATGAGGAGT,0,1150758
fldAp,0.3333333333333333,2,2,ACCTCCGAGCCACACGTCAC,0,1064221
fldAp,0.3333333333333333,2,2,ACCTCCCGACTAGCTTCAAT,0,1070536
fldAp,0.3333333333333333,2,2,ACCTAGCTTATTCGGGAAGG,0,1174982
fldAp,0.3333333333333333,2,2,ACCTACCAAATGGTTGAGTT,0,1075020
fldAp,0.3333333333333333,2,2,ACCTAATTGCTCGACTATTT,0,1119235
fldAp,0.3333333333333333,2,2,ACCGTGGCATCTGAAAGGCC,0,1135131
fldAp,0.3333333333333333,2,2,ACCGTAACGCGTGCGCACGC,0,1152848
fldAp,0.3333333333333333,2,2,ACCGGCGACACGCATCCCCA,0,1086743
fldAp,0.3333333333333333,2,2,ACCGGAGGTGTGTGTGTAGT,0,1141667
fldAp,0.3333333333333333,2,2,ACCGCGTATAGTAACGGCTT,0,1158854
fldAp,0.3333333333333333,2,2,ACCGCGTAGGTGGCCTCAAG,0,1165483
fldAp,0.3333333333333333,2,2,ACCGCGGAACTCCAACATGG,0,1121464
fldAp,0.3333333333333333,2,2,ACCGCCAACAGTGATGAGGC,0,1064938
fldAp,0.3333333333333333,2,2,ACCGATGGTCGTACCACTAC,0,1143817
fldAp,0.3333333333333333,2,2,ACCGAGTGTAAACGATCCTA,0,1105699
fldAp,0.3333333333333333,2,2,ACCGACGGGTGGTTTCTTAC,0,1139284
fldAp,0.3333333333333333,2,2,ACCGACATAATCATCAGGGT,0,1063417
fldAp,0.3333333333333333,2,2,ACCGAACAGGGCGAGAGATT,0,1183950
fldAp,0.3333333333333333,2,2,ACCGAAACTCTCTACCCTGA,0,1119296
fldAp,0.3333333333333333,2,2,ACCCGGCGCCGCGTGGAAAA,0,1134228
fldAp,0.3333333333333333,2,2,ACCCGGAATCATCGTCACAA,0,1078194
fldAp,0.3333333333333333,2,2,ACCCCGTTCAGTAAGGGTTA,0,1134444
fldAp,0.3333333333333333,2,2,ACCCACGTACACAGACTAGA,0,1185534
fldAp,0.3333333333333333,2,2,ACCCACGGCGTGACCACACC,0,1071962
fldAp,0.3333333333333333,2,2,ACCATTGCCTGTGGTCGCGT,0,1169514
fldAp,0.3333333333333333,2,2,ACCATGCGCCGGTGCGTTCA,0,1122918
fldAp,0.3333333333333333,2,2,ACCATCTCTCACTCCGGGGG,0,1170981
fldAp,0.3333333333333333,2,2,ACCAGTTCTCTGACAGTGGT,0,1134526
fldAp,0.3333333333333333,2,2,ACCAGTCTGGCGAGAGTAAA,0,1154298
fldAp,0.3333333333333333,2,2,ACCAGGTCGCTCTAGCCTGG,0,1075246
fldAp,0.3333333333333333,2,2,ACCAGGACAGTCCCAGATCT,0,1126228
fldAp,0.3333333333333333,2,2,ACCAGCTTTAGTTCCGTAGT,0,1160220
fldAp,0.3333333333333333,2,2,ACCAGCTAACAACACTTTGG,0,1085321
fldAp,0.3333333333333333,2,2,ACCAGCAAAAGGTTGGGATA,0,1112864
fldAp,0.3333333333333333,2,2,ACCACTGTGGTTGCCATAGC,0,1070851
fldAp,0.3333333333333333,2,2,ACCACGAATCATATTCAAGG,0,1090725
fldAp,0.3333333333333333,2,2,ACCAAGGTGCAAGCCCAAGT,0,1172655
fldAp,0.3333333333333333,2,2,ACCAAAAGCAACTCGAAAAT,0,1113262
fldAp,0.3333333333333333,2,2,ACATTGAATCCGACTTGCGT,0,1124262
fldAp,0.3333333333333333,2,2,ACATGTATACTGGATTAGAA,0,1102671
fldAp,0.3333333333333333,2,2,ACATGTACAGTCGAGGTTGG,0,1180436
fldAp,0.3333333333333333,2,2,ACATGGGTATGTCAACGCCT,0,1119462
fldAp,0.3333333333333333,2,2,ACATGGATCCTGCACCAGAT,0,1111297
fldAp,0.3333333333333333,2,2,ACATGACGGATGGGCCGGAT,0,1118532
fldAp,0.3333333333333333,2,2,ACATCGATAGTGTGGTAGTC,0,1112182
fldAp,0.3333333333333333,2,2,ACATATTTGGTATGACAACT,0,1065895
fldAp,0.3333333333333333,2,2,ACATAGGATCATCGAGAAGC,0,1180357
fldAp,0.3333333333333333,2,2,ACATACGATTCCCGGAAATT,0,1170548
fldAp,0.3333333333333333,2,2,ACATACAGTACGAGCGTCAA,0,1135320
fldAp,0.3333333333333333,2,2,ACAGTTATCGTTCGACAGTG,0,1085054
fldAp,0.3333333333333333,2,2,ACAGTGTCACGTCTCCAAAG,0,1091586
fldAp,0.3333333333333333,2,2,ACAGTCATGGCTATGTATTG,0,1142578
fldAp,0.3333333333333333,2,2,ACAGTATATTGTCCGACGCT,0,1111358
fldAp,0.3333333333333333,2,2,ACAGGGCATGGAACGGGACA,0,1171265
fldAp,0.3333333333333333,2,2,ACAGGCTTGAACGCGTATTT,0,1136299
fldAp,0.3333333333333333,2,2,ACAGCTTGGCTCAGAATGGC,0,1079103
fldAp,0.3333333333333333,2,2,ACAGAGCGCCCTTGCCTCTC,0,1143649
fldAp,0.3333333333333333,2,2,ACAGACGCTGTTTTAGGATT,0,1090199
fldAp,0.3333333333333333,2,2,ACAGACCCGAGCTTAAACGA,0,1063794
fldAp,0.3333333333333333,2,2,ACAGAAGCAGATTGCAAACG,0,1094297
fldAp,0.3333333333333333,2,2,ACAGAAAGGGTATTTGTAGG,0,1161802
fldAp,0.3333333333333333,2,2,ACAGAAAACGAGATTGAGAT,0,1089588
fldAp,0.3333333333333333,2,2,ACACTTCACGCCGACCTTAG,0,1129020
fldAp,0.3333333333333333,2,2,ACACTGTTGCCGCTATTGAA,0,1070407
fldAp,0.3333333333333333,2,2,ACACTGTGGTCGCAGACCTC,0,1084866
fldAp,0.3333333333333333,2,2,ACACTGCGGTGTATATGTTA,0,1080854
fldAp,0.3333333333333333,2,2,ACACTCACGCGATCAATGAC,0,1082121
fldAp,0.3333333333333333,2,2,ACACGGTTGGTAGGCGCCCT,0,1111053
fldAp,0.3333333333333333,2,2,ACACGCAGCGTGTAGTGTAT,0,1155772
fldAp,0.3333333333333333,2,2,ACACCTTTTGTAAGTTTGAA,0,1179949
fldAp,0.3333333333333333,2,2,ACACCCGTTAACTAATTAGT,0,1063394
fldAp,0.3333333333333333,2,2,ACACCAGGGGTCTCCTTTTA,0,1124245
fldAp,0.3333333333333333,2,2,ACACCAAGCTTTGGGTGTAT,0,1134595
fldAp,0.3333333333333333,2,2,ACACATTCCTAAACGAAAAC,0,1128368
fldAp,0.3333333333333333,2,2,ACACATCCGAGGCTCGGCGA,0,1075268
fldAp,0.3333333333333333,2,2,ACACAATTATACAGTCCAGG,0,1131658
fldAp,0.3333333333333333,2,2,ACAATTGTAGTCAACCAGTA,0,1185907
fldAp,0.3333333333333333,2,2,ACAATCTCTGCGTGTCATAG,0,1074461
fldAp,0.3333333333333333,2,2,ACAATCGCCTAGGTAAGCTA,0,1147548
fldAp,0.3333333333333333,2,2,ACAATAGAGGTCAACCTTAA,0,1132795
fldAp,0.3333333333333333,2,2,ACAAGATGTGATACATAGTA,0,1106016
fldAp,0.3333333333333333,2,2,ACAACGTCTTCTCATGATAC,0,1099265
fldAp,0.3333333333333333,2,2,ACAACCTGTTAAAGGGACAT,0,1143390
fldAp,0.3333333333333333,2,2,ACAAACGGCCTACGCCTCGC,0,1179000
fldAp,0.3333333333333333,2,2,ACAAACATTCTAATAGATAT,0,1068929
fldAp,0.3333333333333333,2,2,ACAAAAAAGCAGCTCCGGAA,0,1115902
fldAp,0.3333333333333333,2,2,AATTTTCTATTGCGCTTTGT,0,1067693
fldAp,0.3333333333333333,2,2,AATTTGACTGCAAGGCGGGA,0,1154904
fldAp,0.3333333333333333,2,2,AATTTAGACTGTGATCCTAC,0,1084838
fldAp,0.3333333333333333,2,2,AATTGTATAATGCTCAGTAA,0,1092899
fldAp,0.3333333333333333,2,2,AATTGGCACCCAACTATCGT,0,1072986
fldAp,0.3333333333333333,2,2,AATTCTCATCCAGTGAGGGT,0,1180434
fldAp,0.3333333333333333,2,2,AATTCGAAACTCATATAGTC,0,1122898
fldAp,0.3333333333333333,2,2,AATTCCTGAACGACGGCAGA,0,1113282
fldAp,0.3333333333333333,2,2,AATTCCGCAAGGCCTTCAGA,0,1078298
fldAp,0.3333333333333333,2,2,AATTCCCAGTCTCGGTCCCA,0,1071419
fldAp,0.3333333333333333,2,2,AATTCCATACGAACTAGAGA,0,1176990
fldAp,0.3333333333333333,2,2,AATTCCACGTATTACAGTAG,0,1095242
fldAp,0.3333333333333333,2,2,AATTCCAAAGACAACTGTCT,0,1145689
fldAp,0.3333333333333333,2,2,AATTCATTGTGTGCACGTCA,0,1139785
fldAp,0.3333333333333333,2,2,AATTATCCACTTCGTGCACT,0,1174521
fldAp,0.3333333333333333,2,2,AATTATAGAGAGCTGGTCCG,0,1163515
fldAp,0.3333333333333333,2,2,AATTAGTGGATTTAGATTGT,0,1116505
fldAp,0.3333333333333333,2,2,AATTAAGGAAGAGAGGCAAC,0,1129676
fldAp,0.3333333333333333,2,2,AATGTTAAAGCTCGAGAGGT,0,1095037
fldAp,0.3333333333333333,2,2,AATGGGTGCCCGAGAGCCGT,0,1063989
fldAp,0.3333333333333333,2,2,AATGGGGTAAAAAGGGTTCC,0,1146852
fldAp,0.3333333333333333,2,2,AATGCGTCGGCTTCGGTTGA,0,1168664
fldAp,0.3333333333333333,2,2,AATGAGAGTGCTGTGACCTT,0,1131991
fldAp,0.3333333333333333,2,2,AATGAATTCACGAAGGAACT,0,1153978
fldAp,0.3333333333333333,2,2,AATCTTGATGGTCCCTGTCT,0,1121469
fldAp,0.3333333333333333,2,2,AATCTGATCCTTGGAAATGC,0,1181431
fldAp,0.3333333333333333,2,2,AATCTACGACGCGGAGTAGC,0,1139786
fldAp,0.3333333333333333,2,2,AATCTAACGTGCGTACCATA,0,1116557
fldAp,0.3333333333333333,2,2,AATCGTTGTTCCTCACCCGT,0,1147651
fldAp,0.3333333333333333,2,2,AATCGTGAAAGGTTCTGGTA,0,1081570
fldAp,0.3333333333333333,2,2,AATCGGCGTCCAGGCAGCAA,0,1075638
fldAp,0.3333333333333333,2,2,AATCGGCGTATGTGCCTGTT,0,1070143
fldAp,0.3333333333333333,2,2,AATCCTGATGCTTTCGGCGG,0,1134015
fldAp,0.3333333333333333,2,2,AATCCTCCGGGCTTACAAGT,0,1166342
fldAp,0.3333333333333333,2,2,AATCCGAACGCGGCAACTTT,0,1146325
fldAp,0.3333333333333333,2,2,AATCCAGAGTGTCGAACGGG,0,1142797
fldAp,0.3333333333333333,2,2,AATCAGTTCACAGCCACTGG,0,1164057
fldAp,0.3333333333333333,2,2,AATCACAGACACAATTTCAC,0,1066459
fldAp,0.3333333333333333,2,2,AATCAACGTCACAGTGATCC,0,1146696
fldAp,0.3333333333333333,2,2,AATATTGACATTTTTACCTC,0,1133137
fldAp,0.3333333333333333,2,2,AATATTCCAGCCCAAACGGA,0,1133224
fldAp,0.3333333333333333,2,2,AATATACTTTATCTATAATG,0,1151303
fldAp,0.3333333333333333,2,2,AATAGTGTACGGATGCAACT,0,1186270
fldAp,0.3333333333333333,2,2,AATAGTGGTACATATCGCGA,0,1074167
fldAp,0.3333333333333333,2,2,AATAGTCGAGTATCTAGGGA,0,1123813
fldAp,0.3333333333333333,2,2,AATAGGAGGTTTTACTAGCA,0,1182960
fldAp,0.3333333333333333,2,2,AATACGCTCCCCGTCTCGTT,0,1177120
fldAp,0.3333333333333333,2,2,AATACGCAAAATTCCCGGAA,0,1168759
fldAp,0.3333333333333333,2,2,AATACCTTCACCGGCGTTTC,0,1120780
fldAp,0.3333333333333333,2,2,AATAAGTACAGCGGGGAAGT,0,1172516
fldAp,0.3333333333333333,2,2,AATAACAATGCGGGCTTTCA,0,1158275
fldAp,0.3333333333333333,2,2,AATAAATCTCTGTATCCCGT,0,1103677
fldAp,0.3333333333333333,2,2,AATAAAACCTCAACTTCAGG,0,1123315
fldAp,0.3333333333333333,2,2,AAGTTTGGACTCTCCACGGT,0,1117117
fldAp,0.3333333333333333,2,2,AAGTTGTCCAGTTTCAAGTG,0,1124660
fldAp,0.3333333333333333,2,2,AAGTTCTATGCCATCACTAT,0,1113496
fldAp,0.3333333333333333,2,2,AAGTTATAAGAATGTGGAGA,0,1088013
fldAp,0.3333333333333333,2,2,AAGTGTACGCTAGCCTTACC,0,1149085
fldAp,0.3333333333333333,2,2,AAGTGTACCCCCTGGGTCCT,0,1152297
fldAp,0.3333333333333333,2,2,AAGTGGGGCGGACGCGCGAA,0,1184222
fldAp,0.3333333333333333,2,2,AAGTGGCAGCTGCTTCTCGG,0,1120268
fldAp,0.3333333333333333,2,2,AAGTGCCTAAGGTCGTTAAA,0,1095801
fldAp,0.3333333333333333,2,2,AAGTCTTGAACTCTCTACTC,0,1172005
fldAp,0.3333333333333333,2,2,AAGTCCTTTATGGCCCGGCC,0,1095575
fldAp,0.3333333333333333,2,2,AAGTCCTCTACTAATGCCGG,0,1148341
fldAp,0.3333333333333333,2,2,AAGTCAGGTAAAGGAGAAGT,0,1128356
fldAp,0.3333333333333333,2,2,AAGTAGATGAGTCGTACTTT,0,1099135
fldAp,0.3333333333333333,2,2,AAGTAGAGTCTCTGTGAATT,0,1105739
fldAp,0.3333333333333333,2,2,AAGTACGTCAGGTCTACGTC,0,1065710
fldAp,0.3333333333333333,2,2,AAGTACACTTACCAGCGTCA,0,1092367
fldAp,0.3333333333333333,2,2,AAGTAATAGGTTCGCTATTG,0,1163610
fldAp,0.3333333333333333,2,2,AAGGTTGCCCGAAGTGAGCT,0,1172261
fldAp,0.3333333333333333,2,2,AAGGTAAAGTTCGTTAAAGT,0,1150830
fldAp,0.3333333333333333,2,2,AAGGGTTCCTCAGAACTACC,0,1162630
fldAp,0.3333333333333333,2,2,AAGGGTAGATCGCTTCATAG,0,1139654
fldAp,0.3333333333333333,2,2,AAGGGGGCAAAGCAAAGTTT,0,1102980
fldAp,0.3333333333333333,2,2,AAGGGGCCGCTCCGTAGTTA,0,1166700
fldAp,0.3333333333333333,2,2,AAGGGGACGCCCGCCAAACT,0,1063475
fldAp,0.3333333333333333,2,2,AAGGGAGGACTTCCCACATA,0,1145351
fldAp,0.3333333333333333,2,2,AAGGGACTCTAAACCATAAG,0,1172869
fldAp,0.3333333333333333,2,2,AAGGCTCAAGACAAGACTAT,0,1069689
fldAp,0.3333333333333333,2,2,AAGGCGGGCAAGACGAAGAC,0,1069291
fldAp,0.3333333333333333,2,2,AAGGCAATTCCAATAGGACA,0,1121798
fldAp,0.3333333333333333,2,2,AAGGAGGGGACAATGTCGCA,0,1084312
fldAp,0.3333333333333333,2,2,AAGGACTAAGTCGGCCATGC,0,1150791
fldAp,0.3333333333333333,2,2,AAGCTGCCACTCTAAAAGTC,0,1069111
fldAp,0.3333333333333333,2,2,AAGCGTTCTGTAAAGACGCC,0,1122617
fldAp,0.3333333333333333,2,2,AAGCGACTAAATTCATTAGC,0,1128508
fldAp,0.3333333333333333,2,2,AAGCGACATGTATAGCCGGG,0,1111948
fldAp,0.3333333333333333,2,2,AAGCCTGGTTTTGTCGTAAC,0,1143549
fldAp,0.3333333333333333,2,2,AAGCCAAACCAAAAAGTGTT,0,1069651
fldAp,0.3333333333333333,2,2,AAGCATGTGTTCGTCAGTTA,0,1064214
fldAp,0.3333333333333333,2,2,AAGCAGGCGTGTCCAAGCCC,0,1063964
fldAp,0.3333333333333333,2,2,AAGCACGCGACTTACTCAGT,0,1084293
fldAp,0.3333333333333333,2,2,AAGCAATGCGTACGCGGCAT,0,1167999
fldAp,0.3333333333333333,2,2,AAGCAATCTACTTTTTATGG,0,1084324
fldAp,0.3333333333333333,2,2,AAGATTATAGAAATTAAAAA,0,1145518
fldAp,0.3333333333333333,2,2,AAGATATAATTCGTTCCTGG,0,1174905
fldAp,0.3333333333333333,2,2,AAGAGTGAAAATCACTACAG,0,1117715
fldAp,0.3333333333333333,2,2,AAGAGCACCGTTCTCGTTCT,0,1136221
fldAp,0.3333333333333333,2,2,AAGACCGGCAGCGGAGAACT,0,1088419
fldAp,0.3333333333333333,2,2,AAGAAGTCTTACGGGCAGCA,0,1150508
fldAp,0.3333333333333333,2,2,AAGAACCGGCGGAGCCGCTC,0,1112351
fldAp,0.3333333333333333,2,2,AAGAAATGCTTGGTAGTCTA,0,1108862
fldAp,0.3333333333333333,2,2,AACTTTTTCGCTCAAGTTCA,0,1101378
fldAp,0.3333333333333333,2,2,AACTTTAAGGGAGTCCACGC,0,1088923
fldAp,0.3333333333333333,2,2,AACTTGGTAGTGACGTAAGA,0,1152448
fldAp,0.3333333333333333,2,2,AACTTCGGAAGATTTGGCCA,0,1075527
fldAp,0.3333333333333333,2,2,AACTTCAAGTCTCATCGGCG,0,1161403
fldAp,0.3333333333333333,2,2,AACTTAGCGGCTTTAATTAC,0,1118784
fldAp,0.3333333333333333,2,2,AACTTAAGTCTAAGGTCTTG,0,1083325
fldAp,0.3333333333333333,2,2,AACTGTCAAAACTAGAGCAG,0,1086937
fldAp,0.3333333333333333,2,2,AACTGGAAACTTGTCCACTT,0,1150234
fldAp,0.3333333333333333,2,2,AACTCCCGTTCCCAACACTT,0,1159687
fldAp,0.3333333333333333,2,2,AACTCCAGTCGCGCAGCAGA,0,1129658
fldAp,0.3333333333333333,2,2,AACTCACATAGAGAGTCTAA,0,1182604
fldAp,0.3333333333333333,2,2,AACTCAAATAGTGCACTGAA,0,1090431
fldAp,0.3333333333333333,2,2,AACTAGGTAACCAGCTACAC,0,1107367
fldAp,0.3333333333333333,2,2,AACGTTTGGACTTAAGATTG,0,1179259
fldAp,0.3333333333333333,2,2,AACGTTGCTGTGTATGGTGA,0,1181804
fldAp,0.3333333333333333,2,2,AACGTGAGGTCAAGCAGAAC,0,1068336
fldAp,0.3333333333333333,2,2,AACGTCACTTACCCCTGGAG,0,1129224
fldAp,0.3333333333333333,2,2,AACGTACGCTGGGTGCGTCT,0,1165273
fldAp,0.3333333333333333,2,2,AACGGTGGACTGCATGGCTA,0,1156853
fldAp,0.3333333333333333,2,2,AACGGAGTTTAACATGGACC,0,1144215
fldAp,0.3333333333333333,2,2,AACGGAGGACACCTGATTGC,0,1071171
fldAp,0.3333333333333333,2,2,AACGGAATTACTCTGGAATT,0,1128600
fldAp,0.3333333333333333,2,2,AACGCTCGCACTCATATTCC,0,1106802
fldAp,0.3333333333333333,2,2,AACGCGGGCTGGACGCACCG,0,1155805
fldAp,0.3333333333333333,2,2,AACGCGGAATGTATGGTTGT,0,1107348
fldAp,0.3333333333333333,2,2,AACGCCAACAGACGATAGTC,0,1119361
fldAp,0.3333333333333333,2,2,AACGATAGGCTGTATATGGG,0,1078739
fldAp,0.3333333333333333,2,2,AACGAGTCCGTAACGATTTG,0,1139275
fldAp,0.3333333333333333,2,2,AACCTTGATGCGGCCTCACG,0,1138589
fldAp,0.3333333333333333,2,2,AACCTGACACTCACTGCGAT,0,1095392
fldAp,0.3333333333333333,2,2,AACCTACTGACAACACAGAT,0,1158835
fldAp,0.3333333333333333,2,2,AACCTAAAGGGAAAAGTTAA,0,1136797
fldAp,0.3333333333333333,2,2,AACCGATCGGGTGACATGGA,0,1092230
fldAp,0.3333333333333333,2,2,AACCGAGTATCGTTTCCTTT,0,1074010
fldAp,0.3333333333333333,2,2,AACCGAAGCCGAAGCCTATT,0,1157311
fldAp,0.3333333333333333,2,2,AACCCTATCATCGTTTATAT,0,1149181
fldAp,0.3333333333333333,2,2,AACATTTGATGAATTGGGCA,0,1160310
fldAp,0.3333333333333333,2,2,AACATGCTCAACGATGCGGG,0,1081571
fldAp,0.3333333333333333,2,2,AACATCCTATCATCTCGCTG,0,1117331
fldAp,0.3333333333333333,2,2,AACAGGAGAGCCCCCTGCAT,0,1079254
fldAp,0.3333333333333333,2,2,AACAGCGGTTCAAGAATGGA,0,1168702
fldAp,0.3333333333333333,2,2,AACACTTCCAGAAATGCGCC,0,1073509
fldAp,0.3333333333333333,2,2,AACACTCTCACTCATGCGAT,0,1065762
fldAp,0.3333333333333333,2,2,AACACTCCGAAGACCTCAGC,0,1152641
fldAp,0.3333333333333333,2,2,AACACGATTCGACCTCTCAG,0,1148555
fldAp,0.3333333333333333,2,2,AACACGAAAAGACATGCTAC,0,1070680
fldAp,0.3333333333333333,2,2,AACAATATCATTCTACGTTA,0,1069083
fldAp,0.3333333333333333,2,2,AACAAGTGTTCTAACACTAT,0,1152579
fldAp,0.3333333333333333,2,2,AACAACACTAAAAGACGGGT,0,1169525
fldAp,0.3333333333333333,2,2,AACAACACCTGACGTTCGCT,0,1140604
fldAp,0.3333333333333333,2,2,AAATTGCGAGCGGTCATTCA,0,1179938
fldAp,0.3333333333333333,2,2,AAATGGGAGTTCTATAAACC,0,1126893
fldAp,0.3333333333333333,2,2,AAATGGGACCTGTGATCAGG,0,1087381
fldAp,0.3333333333333333,2,2,AAATCGTTCCTCGATGTATA,0,1087979
fldAp,0.3333333333333333,2,2,AAATCGTCGTGTTTCGGCCT,0,1081595
fldAp,0.3333333333333333,2,2,AAATCGGCGCCGGTTTAGGA,0,1079955
fldAp,0.3333333333333333,2,2,AAATCCGATTTTATCCGTGA,0,1119459
fldAp,0.3333333333333333,2,2,AAATCAGTGTCAGTGTGAGT,0,1141835
fldAp,0.3333333333333333,2,2,AAATATCCGGACGTGACATT,0,1091571
fldAp,0.3333333333333333,2,2,AAATACTCTCTCTCAACTGT,0,1143363
fldAp,0.3333333333333333,2,2,AAATACCGCTGACCGGGTAA,0,1123337
fldAp,0.3333333333333333,2,2,AAAGTTGCCCCCAGCCTGGT,0,1135015
fldAp,0.3333333333333333,2,2,AAAGTGCAAGGGAGATGGCA,0,1094372
fldAp,0.3333333333333333,2,2,AAAGTGATTATACAAGGTTA,0,1120353
fldAp,0.3333333333333333,2,2,AAAGGTGAATATTGTTTAGC,0,1084321
fldAp,0.3333333333333333,2,2,AAAGGTACAGGCGAGCCTCC,0,1140196
fldAp,0.3333333333333333,2,2,AAAGGCACGCTCTAAATTAA,0,1123522
fldAp,0.3333333333333333,2,2,AAAGGAGTTGTGGCGCCATG,0,1079199
fldAp,0.3333333333333333,2,2,AAAGGAGCTCGTCTAAGCCA,0,1151209
fldAp,0.3333333333333333,2,2,AAAGGACCAAGACTCCGATG,0,1108181
fldAp,0.3333333333333333,2,2,AAAGAGGTTGTATCCGCAGT,0,1108024
fldAp,0.3333333333333333,2,2,AAAGAAGGCACACCTACGCC,0,1127934
fldAp,0.3333333333333333,2,2,AAAGAAGATAGGGTAACACA,0,1067046
fldAp,0.3333333333333333,2,2,AAACTTATGCCAGCGTTGTG,0,1068922
fldAp,0.3333333333333333,2,2,AAACTCCCGCCCGAGTTTGT,0,1066495
fldAp,0.3333333333333333,2,2,AAACGGCGTTCTTCGGCGAC,0,1167289
fldAp,0.3333333333333333,2,2,AAACCTTCATAGTTATGGGA,0,1071245
fldAp,0.3333333333333333,2,2,AAACCCTTGCCCATTTACGT,0,1066851
fldAp,0.3333333333333333,2,2,AAACCCGTGGTTATAATCCC,0,1064772
fldAp,0.3333333333333333,2,2,AAACCAGGGTGTACGCAAGG,0,1090441
fldAp,0.3333333333333333,2,2,AAACATCGAACTGGCTGTAG,0,1087009
fldAp,0.3333333333333333,2,2,AAACAGGTTGGTAAGCGAAG,0,1107987
fldAp,0.3333333333333333,2,2,AAAATCGAGTCGCGAAACTC,0,1066096
fldAp,0.3333333333333333,2,2,AAAAGCCCAGGATGGGCACT,0,1094356
fldAp,0.3333333333333333,2,2,AAAAGCACGGTGCCTGTGTG,0,1159247
fldAp,0.3333333333333333,2,2,AAAACTGACGAACGAGCAAA,0,1101050
fldAp,0.3333333333333333,2,2,AAAACTCAGTACCCGTTAGA,0,1163473
fldAp,0.3333333333333333,2,2,AAAACGTTCGCTAGAGGGAG,0,1069177
fldAp,0.3333333333333333,2,2,AAAACGGACCGGCCACAGGG,0,1132997
fldAp,0.3333333333333333,2,2,AAAACAGTCCGTAGTTGTAT,0,1151263
fldAp,0.3333333333333333,2,2,AAAACACCGGCTCTGTTATC,0,1088051
fldAp,0.3333333333333333,2,2,AAAAATCTGGATGCACGAAA,0,1096058
fldAp,0.3333333333333333,2,2,AAAAACCCGTGAAAGCAAGC,0,1167042
fldAp,0.3333333333333333,2,2,AAAAACCATCCCCGCCTCTC,0,1091834
fldAp,0.3333333333333333,2,2,AAAAAACAAGTAACGGAACA,0,1134425
fldAp,0.5,1,1,TTTTTTTAACGGCGGCCATT,0,1088637
fldAp,0.5,1,1,TTTTTTAGGCGACGGCGAGT,0,1119587
fldAp,0.5,1,1,TTTTTCGTGGAGCGGGCCGC,0,1113220
fldAp,0.5,1,1,TTTTGTTTGGTTCGTATTCA,0,1079722
fldAp,0.5,1,1,TTTTGGGCGTAATCATAACA,0,1064046
fldAp,0.5,1,1,TTTTCTGTGCTGAAGATTCT,0,1174691
fldAp,0.5,1,1,TTTTCTCTCCTGAGATTGGG,0,1145212
fldAp,0.5,1,1,TTTTCGTCAGGGAGTGTACG,0,1122243
fldAp,0.5,1,1,TTTTCGAATCCAGTGGCGAC,0,1070221
fldAp,0.5,1,1,TTTTCCAGCATCAGGGCGGC,0,1112726
fldAp,0.5,1,1,TTTTCAACACACGGATTGTC,0,1100386
fldAp,0.5,1,1,TTTTATAAGCCAAGGTCTCA,0,1186199
fldAp,0.5,1,1,TTTTAGCCTATGCTTAAGTT,0,1166005
fldAp,0.5,1,1,TTTTACGTCCTTCCTGAAAT,0,1146499
fldAp,0.5,1,1,TTTTAATTCAGACCAGAGCC,0,1106198
fldAp,0.5,1,1,TTTTAAGGGACGTGAGGTAG,0,1173147
fldAp,0.5,1,1,TTTGTAAGGCCAGAGACAAT,0,1109372
fldAp,0.5,1,1,TTTGGTGAATTGGTTTCGCA,0,1177266
fldAp,0.5,1,1,TTTGGCGACTACCTTGGTCT,0,1070370
fldAp,0.5,1,1,TTTGGCCACGGTACCATCTT,0,1090997
fldAp,0.5,1,1,TTTGGCAAAATCATAGTGTA,0,1084151
fldAp,0.5,1,1,TTTGGAGGTATGTCAAATTA,0,1114122
fldAp,0.5,1,1,TTTGGACCCACGCCCTGCAG,0,1174389
fldAp,0.5,1,1,TTTGATATCGCTTTTTTAAG,0,1078058
fldAp,0.5,1,1,TTTGAGGTAGGGAGTATGGT,0,1073201
fldAp,0.5,1,1,TTTGACGGGCGGACCCGAGC,0,1122846
fldAp,0.5,1,1,TTTGACGCCCCGAGACAACG,0,1079529
fldAp,0.5,1,1,TTTGACGAGAGGTCGTGAGC,0,1119682
fldAp,0.5,1,1,TTTGACCCCAGATTAAAAAG,0,1150130
fldAp,0.5,1,1,TTTGACAGGTTAGTGCGGGT,0,1136722
fldAp,0.5,1,1,TTTCTTTTACGCCGGATGTG,0,1107355
fldAp,0.5,1,1,TTTCTCGGAGGTTCCGGCCT,0,1073014
fldAp,0.5,1,1,TTTCTCCCTCAGAGGGGAGG,0,1091345
fldAp,0.5,1,1,TTTCTAAAGAATGCAATCAT,0,1080168
fldAp,0.5,1,1,TTTCGTTTAGGCTGGGACGG,0,1136586
fldAp,0.5,1,1,TTTCGTGCTAGCGAGTACGG,0,1065245
fldAp,0.5,1,1,TTTCGGATTTTGTGTTTGAA,0,1185637
fldAp,0.5,1,1,TTTCGAAGAGGGTGCGGCGC,0,1101064
fldAp,0.5,1,1,TTTCCGTATGTTTGCCCCCT,0,1146081
fldAp,0.5,1,1,TTTCCGCGTATTACTGAGCT,0,1109821
fldAp,0.5,1,1,TTTCCGCAGTTTGGGCCTTT,0,1117943
fldAp,0.5,1,1,TTTCCAGTATGCGGTTATTA,0,1114842
fldAp,0.5,1,1,TTTCATGTACCGCCCCCGGG,0,1158128
fldAp,0.5,1,1,TTTCATAGGTGAGTTCGTCT,0,1087657
fldAp,0.5,1,1,TTTCATAGCCTTATACTTGA,0,1133454
fldAp,0.5,1,1,TTTCAGCCTATGCTCAGCCG,0,1090053
fldAp,0.5,1,1,TTTCAGCCCTTAAGTGGCAA,0,1114832
fldAp,0.5,1,1,TTTCACTACGGGAAAGACCC,0,1151386
fldAp,0.5,1,1,TTTATTATCAATTCTCTTCA,0,1087502
fldAp,0.5,1,1,TTTATGTTTGTATTCTCGGC,0,1172731
fldAp,0.5,1,1,TTTATCGCATACTGATAGTC,0,1150889
fldAp,0.5,1,1,TTTATCGAGGGTACTGCCAG,0,1063587
fldAp,0.5,1,1,TTTATCATCAGTCCCTCCCA,0,1066220
fldAp,0.5,1,1,TTTAGTGGAGGTGGGATGTT,0,1145216
fldAp,0.5,1,1,TTTAGGGGCGGACAATGATG,0,1111733
fldAp,0.5,1,1,TTTAGGACCAAAGACCAAGT,0,1128283
fldAp,0.5,1,1,TTTAGCCTTCCCAACCCATT,0,1072174
fldAp,0.5,1,1,TTTACCTGTCATTGGAGACC,0,1186271
fldAp,0.5,1,1,TTTACCTCAATCACAGCAAT,0,1086163
fldAp,0.5,1,1,TTTACAATGGACCTAACGTG,0,1144208
fldAp,0.5,1,1,TTTAAGACATCCCCATCGAG,0,1140782
fldAp,0.5,1,1,TTGTTTAAGTCCCGGGCGCC,0,1072565
fldAp,0.5,1,1,TTGTTGTGGAAGGAAACGAT,0,1164054
fldAp,0.5,1,1,TTGTTGGCCTACAGACTGGA,0,1116449
fldAp,0.5,1,1,TTGTGTTGGTGAAATTCCCT,0,1114380
fldAp,0.5,1,1,TTGTGTGTGGCGAGCGGCAT,0,1063813
fldAp,0.5,1,1,TTGTGGTGTACAATAGGTAC,0,1092883
fldAp,0.5,1,1,TTGTGCGCTTCGAGTCGATT,0,1115110
fldAp,0.5,1,1,TTGTGCCAGTGAATATTTTT,0,1105281
fldAp,0.5,1,1,TTGTGATTGGCCGACACGAA,0,1158880
fldAp,0.5,1,1,TTGTGAAGCGTATGAGAACT,0,1179996
fldAp,0.5,1,1,TTGTCGATCGTCTACTATAC,0,1071426
fldAp,0.5,1,1,TTGTCCGATGTTTCATCGAA,0,1169200
fldAp,0.5,1,1,TTGTCAGGTTTTAATCTGTA,0,1145457
fldAp,0.5,1,1,TTGTATTTTCGGAGTTGGCC,0,1172280
fldAp,0.5,1,1,TTGTATGTGTGCGCAGGATC,0,1130193
fldAp,0.5,1,1,TTGTAGAGAACTTTATGGTA,0,1173708
fldAp,0.5,1,1,TTGTAAACTTACTCTATAAA,0,1146575
fldAp,0.5,1,1,TTGGTTACAGTCGGTTTAGT,0,1161530
fldAp,0.5,1,1,TTGGTGCTCATATTCGTTGC,0,1142079
fldAp,0.5,1,1,TTGGTCACGTCCCCTCCATA,0,1163875
fldAp,0.5,1,1,TTGGGGGTAGCCATTGATTG,0,1096124
fldAp,0.5,1,1,TTGGGGGCTACCGATTTTTT,0,1106696
fldAp,0.5,1,1,TTGGGGCGGGTTTGGTTGCC,0,1161208
fldAp,0.5,1,1,TTGGGGCCTGAGAACGCGAG,0,1097478
fldAp,0.5,1,1,TTGGGGAGAGTGAAGGTCCC,0,1080190
fldAp,0.5,1,1,TTGGGGAACCCCTCTTCTTA,0,1067371
fldAp,0.5,1,1,TTGGGATTTAGGATTATGTA,0,1169404
fldAp,0.5,1,1,TTGGGACCAGGCTTAATCCC,0,1162156
fldAp,0.5,1,1,TTGGCTAGAAATCGAATCTG,0,1152893
fldAp,0.5,1,1,TTGGCGCTCTGGGACCCCTT,0,1070376
fldAp,0.5,1,1,TTGGCCCACAGCAGTGCGAG,0,1141744
fldAp,0.5,1,1,TTGGCAGGCGGATAAGTGGC,0,1103850
fldAp,0.5,1,1,TTGGAGGTATTACAATCATC,0,1159573
fldAp,0.5,1,1,TTGGAATATACATGGTCTAT,0,1072033
fldAp,0.5,1,1,TTGCTGAGTGGTTTAACAAT,0,1106021
fldAp,0.5,1,1,TTGCTCCGGGCTAAAGGATC,0,1112905
fldAp,0.5,1,1,TTGCGTGGCACGTTGTTGGC,0,1100175
fldAp,0.5,1,1,TTGCGTGCGGAGCCGCGACT,0,1089407
fldAp,0.5,1,1,TTGCGTCATAGATCAGCCGG,0,1172545
fldAp,0.5,1,1,TTGCGTAGTTGCATTCACGA,0,1066340
fldAp,0.5,1,1,TTGCGCATCTGCAAGTTCGA,0,1086291
fldAp,0.5,1,1,TTGCCTTAGCAGTGAGCAAC,0,1141169
fldAp,0.5,1,1,TTGCCTAACGCTCTGCACCT,0,1074222
fldAp,0.5,1,1,TTGCCGTTGTCGGGTGTTAT,0,1147164
fldAp,0.5,1,1,TTGCCGAAGACGCTACTATG,0,1147551
fldAp,0.5,1,1,TTGCCACCATTTCGCTGAGG,0,1074379
fldAp,0.5,1,1,TTGCCAAACGAGCGCCTGGC,0,1150992
fldAp,0.5,1,1,TTGCAGTAGAGTTAAAAGCC,0,1181350
fldAp,0.5,1,1,TTGCAGGAGGTCAACCGTAT,0,1137974
fldAp,0.5,1,1,TTGCAGCTGGGCAATCCCCA,0,1182306
fldAp,0.5,1,1,TTGCAGCAACTCTTCAGCTC,0,1087644
fldAp,0.5,1,1,TTGCAGATTTTTCCCAACTT,0,1121853
fldAp,0.5,1,1,TTGCAGATTTAGCGAGAACC,0,1066641
fldAp,0.5,1,1,TTGCAATTACTACTTAGTGC,0,1100715
fldAp,0.5,1,1,TTGCAATTAACAACCGACGT,0,1093173
fldAp,0.5,1,1,TTGCAATATTGCCCACAAAT,0,1180572
fldAp,0.5,1,1,TTGCAAAGTCTAACTTTCGG,0,1129531
fldAp,0.5,1,1,TTGCAAAGTCCTGGGGGATG,0,1117292
fldAp,0.5,1,1,TTGATTCGTGATTGTTGAGG,0,1122840
fldAp,0.5,1,1,TTGATGTCGCCATTGGCGGT,0,1072908
fldAp,0.5,1,1,TTGATCGGTATTAAAAGGAA,0,1098418
fldAp,0.5,1,1,TTGATCGAGCCCAAGTCACC,0,1115345
fldAp,0.5,1,1,TTGAGTCCATGGGGATATCC,0,1122925
fldAp,0.5,1,1,TTGAGGATACTGAAATCGTT,0,1115922
fldAp,0.5,1,1,TTGAGACTTATGTCGTTCCT,0,1093640
fldAp,0.5,1,1,TTGACTGCGTAACTTCCCTA,0,1100113
fldAp,0.5,1,1,TTGACTAGGATCCAGAATGG,0,1129429
fldAp,0.5,1,1,TTGACCCAGGTCTCTCACCT,0,1136790
fldAp,0.5,1,1,TTGACATGCGCGATTGATCA,0,1128617
fldAp,0.5,1,1,TTGACAGCATGGTTCGGAAG,0,1165380
fldAp,0.5,1,1,TTGAATGGCTAAGGCGTAAA,0,1155798
fldAp,0.5,1,1,TTGAACGTCAGAAGCTGGGC,0,1101890
fldAp,0.5,1,1,TTGAACGAAACAGTTTACCC,0,1148088
fldAp,0.5,1,1,TTGAACCCTACTGTGAGAGG,0,1090222
fldAp,0.5,1,1,TTGAAAGCCGTTCGGGAACC,0,1139969
fldAp,0.5,1,1,TTCTTTTCCACGGACTGAGG,0,1099853
fldAp,0.5,1,1,TTCTTTATATTGTTTATAGG,0,1075080
fldAp,0.5,1,1,TTCTTTACGACACTGTTTTC,0,1101222
fldAp,0.5,1,1,TTCTTGTCTCGCATTGTAGA,0,1184790
fldAp,0.5,1,1,TTCTGTGGTTCGTCAGCTTC,0,1145291
fldAp,0.5,1,1,TTCTGGCTGCCAGACACTCG,0,1103109
fldAp,0.5,1,1,TTCTGCTGTTTAGGGCCGGT,0,1110664
fldAp,0.5,1,1,TTCTGCGAGGCAACCAACGG,0,1186101
fldAp,0.5,1,1,TTCTGCCCTCTTTAGAAGGA,0,1073933
fldAp,0.5,1,1,TTCTCGCGCAAGGCGAGACC,0,1093770
fldAp,0.5,1,1,TTCTCACCGTTGACCAGCTT,0,1090610
fldAp,0.5,1,1,TTCTAGCGTACCACGAACTA,0,1090450
fldAp,0.5,1,1,TTCTACTACCAGGAGAAAAA,0,1102389
fldAp,0.5,1,1,TTCTACGCACTTCCGAGAGC,0,1137294
fldAp,0.5,1,1,TTCTACAGATCTGTCATAGT,0,1070058
fldAp,0.5,1,1,TTCTAATCTGAGACGTAAGC,0,1074660
fldAp,0.5,1,1,TTCGTTGAAGGAGCAATCTT,0,1090894
fldAp,0.5,1,1,TTCGTGGAAGGCGTGTAACG,0,1109844
fldAp,0.5,1,1,TTCGTCAGGATGCTACGGCT,0,1091170
fldAp,0.5,1,1,TTCGGGCGGTAGCCTCAGAT,0,1140392
fldAp,0.5,1,1,TTCGGGAAGGCGGCCTTCTG,0,1132360
fldAp,0.5,1,1,TTCGGCCTGGAAGAGTGAGG,0,1140553
fldAp,0.5,1,1,TTCGGAATACTATCATCCCC,0,1141346
fldAp,0.5,1,1,TTCGGAAACTAATATGTTGG,0,1143826
fldAp,0.5,1,1,TTCGCTCGGGCGCAGCGAGC,0,1133256
fldAp,0.5,1,1,TTCGCGGGTCGTTGGTAGAG,0,1174979
fldAp,0.5,1,1,TTCGATTTCAAGGCACGTCG,0,1143529
fldAp,0.5,1,1,TTCGATATCGGGTGTTGAAA,0,1095983
fldAp,0.5,1,1,TTCGACGGAGCACGCTACAA,0,1100215
fldAp,0.5,1,1,TTCGAATCAAACTTCCCATT,0,1186844
fldAp,0.5,1,1,TTCGAACGGGAGCACCCGGG,0,1128567
fldAp,0.5,1,1,TTCCTTATGGGCATAACGAA,0,1094302
fldAp,0.5,1,1,TTCCTCACGAAGAGTTTTGG,0,1095712
fldAp,0.5,1,1,TTCCGTGTTTAACGCATAAC,0,1146902
fldAp,0.5,1,1,TTCCGGGGCGGGTACATTCT,0,1182258
fldAp,0.5,1,1,TTCCGATCTGGTGAGCACGG,0,1160402
fldAp,0.5,1,1,TTCCCTATGAACTGGGACTA,0,1120689
fldAp,0.5,1,1,TTCCCCTAGGACGCACTCAG,0,1159316
fldAp,0.5,1,1,TTCCCCGTCCCAGTTATAGG,0,1165311
fldAp,0.5,1,1,TTCCCACTTTCATGAATGTA,0,1119615
fldAp,0.5,1,1,TTCCATACCAACGAGGCGAG,0,1094049
fldAp,0.5,1,1,TTCCAATCTAAGCTCAGCGA,0,1088022
fldAp,0.5,1,1,TTCATTAATGCGGCTAACCG,0,1153921
fldAp,0.5,1,1,TTCATGGACTCTTCAAATAT,0,1077577
fldAp,0.5,1,1,TTCATGACGAGCGCAGCGCC,0,1154016
fldAp,0.5,1,1,TTCATGAACACCATAGCGTT,0,1081481
fldAp,0.5,1,1,TTCATCTTAGATCTGGGTGG,0,1176148
fldAp,0.5,1,1,TTCATCTGCCTAGTATAGAT,0,1076065
fldAp,0.5,1,1,TTCATATTATTAACAAGCCA,0,1109978
fldAp,0.5,1,1,TTCATATCGCCTGGAATCTG,0,1070514
fldAp,0.5,1,1,TTCATAGAACTGAGAACACA,0,1118097
fldAp,0.5,1,1,TTCATAAAGATGGTTAAAAG,0,1113965
fldAp,0.5,1,1,TTCAGTCATTAGGCATCTAA,0,1088406
fldAp,0.5,1,1,TTCAGCTGCGGATCTCGCCG,0,1174219
fldAp,0.5,1,1,TTCAGCTAAATGTATGCCGT,0,1139614
fldAp,0.5,1,1,TTCAGACTTGTTTGCAGTGA,0,1151460
fldAp,0.5,1,1,TTCACCGCGTCTGCCAAACC,0,1078297
fldAp,0.5,1,1,TTCAAGTTCCACCCTGACCA,0,1180832
fldAp,0.5,1,1,TTCAAGCTTGCGCAGGTGCC,0,1108707
fldAp,0.5,1,1,TTCAAGCACTCACCGGGAGC,0,1103515
fldAp,0.5,1,1,TTCAACTAGGAGGTGTCAAA,0,1179422
fldAp,0.5,1,1,TTCAACCACGGTCTACAATA,0,1148823
fldAp,0.5,1,1,TTCAACATATTCAAATACTA,0,1181036
fldAp,0.5,1,1,TTATTGTCGGCATTTACCCT,0,1097407
fldAp,0.5,1,1,TTATTGGCTGGAAAAACTAT,0,1115361
fldAp,0.5,1,1,TTATTGGAGCGTGCAATTCG,0,1093445
fldAp,0.5,1,1,TTATTGATTTCTCGGGTTGC,0,1123227
fldAp,0.5,1,1,TTATTCGTGCAGACTAGGCA,0,1086512
fldAp,0.5,1,1,TTATTCCCGCGGCCCCGTGG,0,1133783
fldAp,0.5,1,1,TTATTATGTTGATAGCGCTC,0,1139245
fldAp,0.5,1,1,TTATTAGATAATAAAATTTA,0,1136687
fldAp,0.5,1,1,TTATGATTGCAGCAGCACCT,0,1134026
fldAp,0.5,1,1,TTATGAGCTCAAGAATGCGA,0,1124165
fldAp,0.5,1,1,TTATGACGAGTCACAAGGCC,0,1132883
fldAp,0.5,1,1,TTATCTGCACTCATAGTGGA,0,1121885
fldAp,0.5,1,1,TTATCACAAGTTGCACGGGC,0,1159173
fldAp,0.5,1,1,TTATATCGCCGGTTATGAGT,0,1176254
fldAp,0.5,1,1,TTATACGCTCCCGTCGAATG,0,1129129
fldAp,0.5,1,1,TTATACCCCTAGAGGCGCCG,0,1112347
fldAp,0.5,1,1,TTATAATGAGGCCCCAAATA,0,1070525
fldAp,0.5,1,1,TTAGTTACAGCTCGGTCCGG,0,1128654
fldAp,0.5,1,1,TTAGTAGGCTGTGATGCTTA,0,1114577
fldAp,0.5,1,1,TTAGTAGCGTTGATTCACGA,0,1153558
fldAp,0.5,1,1,TTAGTAATCGTTTAAAGGAT,0,1065229
fldAp,0.5,1,1,TTAGTAACTTGTAACAGTCA,0,1067847
fldAp,0.5,1,1,TTAGTAAATGTCTCGTTCCC,0,1115194
fldAp,0.5,1,1,TTAGGGAAGGGCAATCTGGG,0,1153684
fldAp,0.5,1,1,TTAGGAGCCGGGCGCTGCAG,0,1107981
fldAp,0.5,1,1,TTAGCGTTCCTTGTAGGTAT,0,1128627
fldAp,0.5,1,1,TTAGCGGATAAGTTCCAGTA,0,1180573
fldAp,0.5,1,1,TTAGATCAAGGAATAAATCA,0,1127862
fldAp,0.5,1,1,TTAGACCGATTAGCTCGCAA,0,1123012
fldAp,0.5,1,1,TTACTCGAGAGTTCCGTGGG,0,1124069
fldAp,0.5,1,1,TTACTACTGAGAAGACGGCC,0,1097992
fldAp,0.5,1,1,TTACGTGCGGACGTGCGCGT,0,1123172
fldAp,0.5,1,1,TTACGCTATCGCTGCAGCTA,0,1098055
fldAp,0.5,1,1,TTACGCGGCTCTGAGACAGA,0,1113512
fldAp,0.5,1,1,TTACGATTCCTGTTTTCTGC,0,1089718
fldAp,0.5,1,1,TTACGATGCAACTAATGATT,0,1141832
fldAp,0.5,1,1,TTACGACTCGTCTGCTGCCA,0,1075938
fldAp,0.5,1,1,TTACCTTTGTTCGGAACTCC,0,1085000
fldAp,0.5,1,1,TTACCGGTCCACACGTAGGT,0,1152574
fldAp,0.5,1,1,TTACCGCTTACATTGTAAGG,0,1104062
fldAp,0.5,1,1,TTACCCCATCGCCCAACGCA,0,1126452
fldAp,0.5,1,1,TTACCCACGTTTAGAGGGCA,0,1144887
fldAp,0.5,1,1,TTACCACGGATTCAGTATTA,0,1096669
fldAp,0.5,1,1,TTACATGAAGACCGTTTCGG,0,1099575
fldAp,0.5,1,1,TTACAGTTATGGGCGCGGTA,0,1069798
fldAp,0.5,1,1,TTACACTTTAGAGACCAGTA,0,1103437
fldAp,0.5,1,1,TTACACCTGTGCGATGCCGG,0,1170152
fldAp,0.5,1,1,TTACACATTGTGCTGGGTTA,0,1174016
fldAp,0.5,1,1,TTACAAGGGAAAACCGCTCC,0,1084386
fldAp,0.5,1,1,TTAATGATGCGCGAAGACCA,0,1123467
fldAp,0.5,1,1,TTAATATCGAGGGCGCTGTG,0,1186142
fldAp,0.5,1,1,TTAATAGGAGGATCCGCACA,0,1154998
fldAp,0.5,1,1,TTAAGTCACAAGATTAATGG,0,1074148
fldAp,0.5,1,1,TTAAGAACTGGCACGGTAGA,0,1179138
fldAp,0.5,1,1,TTAACTTGAGTAATTCCGTT,0,1135339
fldAp,0.5,1,1,TTAAATATCTTATGGACGGA,0,1113598
fldAp,0.5,1,1,TTAAATACTTCCGAAGGGAC,0,1133115
fldAp,0.5,1,1,TTAAAGTGTATGCGCTAAAG,0,1105178
fldAp,0.5,1,1,TTAAACCCGCCAAGCTCCCC,0,1071066
fldAp,0.5,1,1,TGTTTGTTCCGGATTAACGT,0,1076577
fldAp,0.5,1,1,TGTTTGGTCCCCAATTGGAG,0,1070637
fldAp,0.5,1,1,TGTTTCCTCTCAGAGCTGGT,0,1076366
fldAp,0.5,1,1,TGTTTCAGTTCGAGTTCGTC,0,1118542
fldAp,0.5,1,1,TGTTTAGGGCTCTAGACAAT,0,1143729
fldAp,0.5,1,1,TGTTGTACCACGCGACCCGA,0,1077026
fldAp,0.5,1,1,TGTTGGATGTAGAGTAGAAC,0,1144520
fldAp,0.5,1,1,TGTTGGATAATAACCCCTAA,0,1066323
fldAp,0.5,1,1,TGTTGCTTTATCAGAGAGGC,0,1170384
fldAp,0.5,1,1,TGTTGCGTCTCCGCGGTCCA,0,1069693
fldAp,0.5,1,1,TGTTGCGGTATCACAGTAAG,0,1163591
fldAp,0.5,1,1,TGTTGCCATAGGTCCGCGGA,0,1070087
fldAp,0.5,1,1,TGTTCTTTCTATGTATCGAG,0,1153992
fldAp,0.5,1,1,TGTTCCCTCATAAGCGTCTC,0,1119873
fldAp,0.5,1,1,TGTTCCACTTCCCCACGGTT,0,1082943
fldAp,0.5,1,1,TGTTCAGGGCGTCCACGATC,0,1144555
fldAp,0.5,1,1,TGTTCAAAACCCGTTCGTAT,0,1080077
fldAp,0.5,1,1,TGTTAGATACCTTGCGCAGG,0,1067320
fldAp,0.5,1,1,TGTTAAAGGTTGAGTAGAAC,0,1096178
fldAp,0.5,1,1,TGTGTTCGCGCGGTGCCTCT,0,1085155
fldAp,0.5,1,1,TGTGTGGATTTTCAAAAGGT,0,1076996
fldAp,0.5,1,1,TGTGTGGACCTTGATTCTCT,0,1130532
fldAp,0.5,1,1,TGTGTAAAGGAAAGGAGATT,0,1107557
fldAp,0.5,1,1,TGTGGTTTGATCGCTCTCAG,0,1083189
fldAp,0.5,1,1,TGTGGGTGAATCCCAGTGAG,0,1073904
fldAp,0.5,1,1,TGTGGGGGTAGGAACGGATC,0,1076753
fldAp,0.5,1,1,TGTGGGGATTCGTTTAATCT,0,1179927
fldAp,0.5,1,1,TGTGGATAGGCACAATGAGA,0,1150165
fldAp,0.5,1,1,TGTGCTTTGGCCACAGATGA,0,1169855
fldAp,0.5,1,1,TGTGCGCAGGATCGAGCTCA,0,1154003
fldAp,0.5,1,1,TGTGCGACGCTCCTTTTCAC,0,1088828
fldAp,0.5,1,1,TGTGCCACTCGTCCCGCAAG,0,1137183
fldAp,0.5,1,1,TGTGCCAATGAATAGTGCCG,0,1174544
fldAp,0.5,1,1,TGTCTTTCGTTTATCTGAAT,0,1141737
fldAp,0.5,1,1,TGTCTTATTATACCAGCCCC,0,1086380
fldAp,0.5,1,1,TGTCTGTGCGTACTTCTGAT,0,1119797
fldAp,0.5,1,1,TGTCTCGATACAGTAGTTTT,0,1128560
fldAp,0.5,1,1,TGTCTCACATTCAGGAACGC,0,1178049
fldAp,0.5,1,1,TGTCTATAGACACGTCGGTC,0,1078945
fldAp,0.5,1,1,TGTCGGTGGAGAGTCATCCA,0,1175289
fldAp,0.5,1,1,TGTCGGGGTTTGGTGACTAA,0,1097913
fldAp,0.5,1,1,TGTCGAGCTTTTACTCACCA,0,1084394
fldAp,0.5,1,1,TGTCCTGTGGACAGATGATT,0,1114243
fldAp,0.5,1,1,TGTCCGAGGAGGCCATAAGG,0,1160140
fldAp,0.5,1,1,TGTCCCCTATCCAGGGCCTA,0,1078330
fldAp,0.5,1,1,TGTCATCTTCTGCTGCTGGA,0,1063425
fldAp,0.5,1,1,TGTCACGACGCTCAACCCAC,0,1071657
fldAp,0.5,1,1,TGTCACAGACGGCGTAATCG,0,1131755
fldAp,0.5,1,1,TGTCAATTATGGGTGTCGTA,0,1092352
fldAp,0.5,1,1,TGTCAACCCCCCTTCTTATC,0,1113051
fldAp,0.5,1,1,TGTATCTTCATTGAGCAAAC,0,1130534
fldAp,0.5,1,1,TGTAGTCCGGGTCAATAATC,0,1150731
fldAp,0.5,1,1,TGTAGGAGTTCCCACTCAAA,0,1146030
fldAp,0.5,1,1,TGTAGCTGACGAAATGACAA,0,1071065
fldAp,0.5,1,1,TGTAGATAATTCCAGTAGGT,0,1114598
fldAp,0.5,1,1,TGTAGAAAAAGACTCCCTAT,0,1183244
fldAp,0.5,1,1,TGTACGGGGGACTGACCGGT,0,1070409
fldAp,0.5,1,1,TGTACCGGTTGAAGCATAGT,0,1087243
fldAp,0.5,1,1,TGTACATAATGGCTCGAACC,0,1127018
fldAp,0.5,1,1,TGTACACCTGTTGTAAGGGG,0,1115184
fldAp,0.5,1,1,TGTAATGCAGCCTACGACGG,0,1146732
fldAp,0.5,1,1,TGTAATAATAGTGATAACTC,0,1154997
fldAp,0.5,1,1,TGTAAGTGGTTGACGGCAAA,0,1116306
fldAp,0.5,1,1,TGTAAGGGGAAATGTCAAAT,0,1063016
fldAp,0.5,1,1,TGTAAATTTGTGAGCGCTTT,0,1158787
fldAp,0.5,1,1,TGTAAACTCCCGAATAGGAA,0,1093794
fldAp,0.5,1,1,TGGTTTAGAGAAGTGCAAAG,0,1122690
fldAp,0.5,1,1,TGGTTGCGCGGCATCCCGGT,0,1066477
fldAp,0.5,1,1,TGGTTCCAGGATGGTGGCTA,0,1144498
fldAp,0.5,1,1,TGGTGTTTGGATCTCCCAAT,0,1091517
fldAp,0.5,1,1,TGGTGGGCTTAGCATGGAGC,0,1179240
fldAp,0.5,1,1,TGGTGCACGATGACACCTAA,0,1150158
fldAp,0.5,1,1,TGGTGAATGGTCAACCCAGT,0,1084826
fldAp,0.5,1,1,TGGTCTTCAAATGTGCCGTT,0,1074001
fldAp,0.5,1,1,TGGTCTATCTATTTCTCGCT,0,1136801
fldAp,0.5,1,1,TGGTCCGACGGATGAGGGTA,0,1087949
fldAp,0.5,1,1,TGGTCATTCTGTGCGGCATA,0,1160596
fldAp,0.5,1,1,TGGTCATAGAGGTAAATGCA,0,1150667
fldAp,0.5,1,1,TGGTCAAGTCTTAAGGTGCG,0,1106846
fldAp,0.5,1,1,TGGTATTAGCAATTAGTTAA,0,1147774
fldAp,0.5,1,1,TGGTACGTAGTATATCTCTG,0,1169022
fldAp,0.5,1,1,TGGTACAATTCGGTGACACA,0,1179061
fldAp,0.5,1,1,TGGGTTGTAGGGCTTCCCAA,0,1139814
fldAp,0.5,1,1,TGGGTCTGGTTGCGTTTATG,0,1158682
fldAp,0.5,1,1,TGGGTAGAAGTGGTTCATAT,0,1087604
fldAp,0.5,1,1,TGGGTACTTCCTACGAGTTA,0,1065196
fldAp,0.5,1,1,TGGGGTACGCTGGGTTGTAG,0,1084328
fldAp,0.5,1,1,TGGGGCTCGGACCAAGGTGG,0,1165493
fldAp,0.5,1,1,TGGGGCGTATCCCGTTGTAA,0,1176270
fldAp,0.5,1,1,TGGGGCGCCAGCCCGCGCAG,0,1142913
fldAp,0.5,1,1,TGGGCAGGGAGAATTGGCTC,0,1119863
fldAp,0.5,1,1,TGGGCACCGAAGTTACTCGG,0,1126867
fldAp,0.5,1,1,TGGGATAGGGGGCCGGCGTC,0,1137517
fldAp,0.5,1,1,TGGGATAGCTTAGTCGCATG,0,1137988
fldAp,0.5,1,1,TGGGAGTACAGGTTTAAGTC,0,1063088
fldAp,0.5,1,1,TGGGACTTCCAGGGTTTCTA,0,1074206
fldAp,0.5,1,1,TGGGACGGCGATAGTATAAT,0,1079640
fldAp,0.5,1,1,TGGGAATTCCAGAGGGGGGC,0,1111930
fldAp,0.5,1,1,TGGGAAAGGATTATGCATAC,0,1110043
fldAp,0.5,1,1,TGGGAAACGCGCAGAGTCGC,0,1176087
fldAp,0.5,1,1,TGGCTTCGGTTAGACCCTCA,0,1150883
fldAp,0.5,1,1,TGGCTGTCAGGCGAGCACAG,0,1161440
fldAp,0.5,1,1,TGGCTGGAACGAAAGATGCA,0,1111887
fldAp,0.5,1,1,TGGCTCGCTGAAGGCTATAT,0,1170064
fldAp,0.5,1,1,TGGCTCCCACCGCTGGGCTA,0,1098746
fldAp,0.5,1,1,TGGCTATCAGGGGGATCGAC,0,1153157
fldAp,0.5,1,1,TGGCTACGTTACAAAACAAC,0,1120036
fldAp,0.5,1,1,TGGCGGTCATGTTCGAACCA,0,1160965
fldAp,0.5,1,1,TGGCGGGGGGTTGTTGACAG,0,1148838
fldAp,0.5,1,1,TGGCGGGCGTACCCAACCGT,0,1136779
fldAp,0.5,1,1,TGGCGCGAAACTTCCCTTCT,0,1141664
fldAp,0.5,1,1,TGGCGATGATAGACCTAATG,0,1100616
fldAp,0.5,1,1,TGGCCTCCGTGTTATTAAGG,0,1082279
fldAp,0.5,1,1,TGGCCGTAAATGGCTATAGA,0,1097749
fldAp,0.5,1,1,TGGCCGCGATCCCAATGAAA,0,1097237
fldAp,0.5,1,1,TGGCCCATTCATATTGCGCA,0,1184135
fldAp,0.5,1,1,TGGCCCAAGGCGAATTCGCT,0,1089576
fldAp,0.5,1,1,TGGCATGACAATTGCTGAGT,0,1168434
fldAp,0.5,1,1,TGGCATCAATTTTCGGCTCG,0,1085032
fldAp,0.5,1,1,TGGCATATCTCGGTTTTTGG,0,1143005
fldAp,0.5,1,1,TGGCAAGCGGGTAACGCATC,0,1138668
fldAp,0.5,1,1,TGGCAAAAAGAGGGAATGCA,0,1091010
fldAp,0.5,1,1,TGGATTGTAACGATGCGGCG,0,1109786
fldAp,0.5,1,1,TGGATCATTTTTGCGGGCGG,0,1104480
fldAp,0.5,1,1,TGGATATTTATGATGCGCAT,0,1098819
fldAp,0.5,1,1,TGGATAGCAACACATGTTTA,0,1141448
fldAp,0.5,1,1,TGGAGTGAGTGAGGCTGGGT,0,1123009
fldAp,0.5,1,1,TGGAGTACATCTGACCGGGA,0,1077323
fldAp,0.5,1,1,TGGAGGGGAGATGAATTTCT,0,1114583
fldAp,0.5,1,1,TGGAGCAATCCAGGTTAATA,0,1154575
fldAp,0.5,1,1,TGGACTTAGCTAAGTATTCA,0,1142088
fldAp,0.5,1,1,TGGACGTAGTATTTCATTAC,0,1082459
fldAp,0.5,1,1,TGGACGAGCGGTACGACTAG,0,1160427
fldAp,0.5,1,1,TGGACATCTAGAGCGCTTCA,0,1150502
fldAp,0.5,1,1,TGGAATTGCCCGCTACCACG,0,1158662
fldAp,0.5,1,1,TGGAATCGACGTAGAGTATG,0,1084704
fldAp,0.5,1,1,TGGAAGGTTACAAGGTTCTC,0,1067379
fldAp,0.5,1,1,TGGAACTAAGGCACGTCAAG,0,1143801
fldAp,0.5,1,1,TGGAACAGAGGCTAACATAT,0,1104527
fldAp,0.5,1,1,TGCTTTCCCGATTTCTTACA,0,1147768
fldAp,0.5,1,1,TGCTTGGAGCTTAATAGTGC,0,1115396
fldAp,0.5,1,1,TGCTTGAAACCGGGATCGGC,0,1074023
fldAp,0.5,1,1,TGCTTCTCAGTGCGACATCG,0,1152304
fldAp,0.5,1,1,TGCTTCAGGGAATAACATGG,0,1077746
fldAp,0.5,1,1,TGCTTCAAAATCATGGGTTA,0,1173744
fldAp,0.5,1,1,TGCTGTGTTGAATTTTGGTC,0,1101244
fldAp,0.5,1,1,TGCTGGATTCAGATTTGCTA,0,1186542
fldAp,0.5,1,1,TGCTCTGAGTTAGATCACGT,0,1094258
fldAp,0.5,1,1,TGCTAAACACTGGTGTAGTT,0,1122730
fldAp,0.5,1,1,TGCGTCGTCGCACCCCTCTG,0,1122859
fldAp,0.5,1,1,TGCGTCCAGGGACGCCACTT,0,1128935
fldAp,0.5,1,1,TGCGTAGACCTAAGTGTCGT,0,1163182
fldAp,0.5,1,1,TGCGTAAAGGGAACCCACTC,0,1185253
fldAp,0.5,1,1,TGCGGAATAAGGGACAACTC,0,1082990
fldAp,0.5,1,1,TGCGCTTCAGGGCAGGGCAT,0,1131162
fldAp,0.5,1,1,TGCGCTATCGTCCACTATTT,0,1073983
fldAp,0.5,1,1,TGCGCTAATGCCCCTCATCT,0,1130248
fldAp,0.5,1,1,TGCGCAGCAACTTGACTATT,0,1064385
fldAp,0.5,1,1,TGCGATTTGGGATCCACGCT,0,1104095
fldAp,0.5,1,1,TGCGATACAAAGGCCACAGA,0,1120781
fldAp,0.5,1,1,TGCGAGAGCAAAATCCAAAA,0,1070319
fldAp,0.5,1,1,TGCGAGAATCCCCGCTGATG,0,1107153
fldAp,0.5,1,1,TGCGAGAAAGCTATCTGGTG,0,1125200
fldAp,0.5,1,1,TGCGACGTTATTGATATAAA,0,1109249
fldAp,0.5,1,1,TGCGAACTATTGGATTAGTA,0,1095136
fldAp,0.5,1,1,TGCCTTAAACTCATAGGCTT,0,1127653
fldAp,0.5,1,1,TGCCTGTTACGCCTGAAAGT,0,1109650
fldAp,0.5,1,1,TGCCTGATCAGGTTGTTGGG,0,1087370
fldAp,0.5,1,1,TGCCTATGTTGTTTGGGTTG,0,1149212
fldAp,0.5,1,1,TGCCGCCGGTATGTTGACGT,0,1139994
fldAp,0.5,1,1,TGCCGCATACAACCTGCTAT,0,1160337
fldAp,0.5,1,1,TGCCCGGTCTTTTTGAAAGC,0,1156006
fldAp,0.5,1,1,TGCCCGGGTCCGGCGGAATT,0,1115511
fldAp,0.5,1,1,TGCCCGAGATTGTCTAGCTT,0,1182244
fldAp,0.5,1,1,TGCATTAGGTCATGAACTGT,0,1117884
fldAp,0.5,1,1,TGCATGATTTGATGCTACAA,0,1168601
fldAp,0.5,1,1,TGCATAATTGGGTGGCATGT,0,1185392
fldAp,0.5,1,1,TGCAGGCATTGAGGATTTGT,0,1077706
fldAp,0.5,1,1,TGCAGCAGCGCTGGTATTAG,0,1080309
fldAp,0.5,1,1,TGCAGATAGGCTGCCGCCCA,0,1104769
fldAp,0.5,1,1,TGCAGAGAATAAAGGGGTAA,0,1085329
fldAp,0.5,1,1,TGCACTGGTATCCCCGGTTT,0,1123671
fldAp,0.5,1,1,TGCAATACCACTGCATGTAT,0,1105563
fldAp,0.5,1,1,TGCAAAGAGCTTGATCCTAT,0,1083613
fldAp,0.5,1,1,TGCAAACGAGGCAACGGTAA,0,1132847
fldAp,0.5,1,1,TGATTGCGGGAACTTCGGCA,0,1157447
fldAp,0.5,1,1,TGATTCTCTCTGCTGAGACG,0,1140355
fldAp,0.5,1,1,TGATGGCGGGAGAGGCCTTC,0,1095703
fldAp,0.5,1,1,TGATGACGCAAATGTGCGGT,0,1181640
fldAp,0.5,1,1,TGATCTGTGGATCCAGTTCA,0,1081849
fldAp,0.5,1,1,TGATCTACTGTACGACGCAG,0,1152124
fldAp,0.5,1,1,TGATCGAGTGCGCGTTATGG,0,1140476
fldAp,0.5,1,1,TGATCCTATAGGCTGATACT,0,1114329
fldAp,0.5,1,1,TGATCCCCTTCTTGCATGAC,0,1072880
fldAp,0.5,1,1,TGATCATATGCAGAAGTTTG,0,1119239
fldAp,0.5,1,1,TGATCAGTCTCTGCCCGTAG,0,1184611
fldAp,0.5,1,1,TGATATGGGCGTAGAATTTA,0,1104568
fldAp,0.5,1,1,TGATATACACAGGTCAGAGT,0,1123549
fldAp,0.5,1,1,TGATAGAGTCAAGGAACCCC,0,1135133
fldAp,0.5,1,1,TGATACGGCTCTACGGGCAA,0,1084883
fldAp,0.5,1,1,TGATACCTGACAAAGGGACT,0,1108185
fldAp,0.5,1,1,TGAGTTCCCCCTAGTCACAT,0,1135594
fldAp,0.5,1,1,TGAGTTAGGTGAATTAGTAA,0,1115642
fldAp,0.5,1,1,TGAGTGGCCCACTTAACGGA,0,1064366
fldAp,0.5,1,1,TGAGTGAGGATAAGGCCAAA,0,1178429
fldAp,0.5,1,1,TGAGTCAATCAAAGGAGTCC,0,1169003
fldAp,0.5,1,1,TGAGTAGGGATTCGACCTGT,0,1124996
fldAp,0.5,1,1,TGAGTAGATGGTCGCACAAT,0,1128994
fldAp,0.5,1,1,TGAGTAGAAGCTTTGAGGGA,0,1149128
fldAp,0.5,1,1,TGAGGGATACAAAGATAAAG,0,1180157
fldAp,0.5,1,1,TGAGGGAACCACATAATCGA,0,1132227
fldAp,0.5,1,1,TGAGGCCCGGTAGACCCACA,0,1077841
fldAp,0.5,1,1,TGAGCGTCGGCATTGGGAAA,0,1132805
fldAp,0.5,1,1,TGAGCAACCAGAGGTCTCAA,0,1122110
fldAp,0.5,1,1,TGAGAAGGTACTTTGTTCCC,0,1077971
fldAp,0.5,1,1,TGAGAAACTAATAGCGGCAA,0,1121871
fldAp,0.5,1,1,TGACTTGGGTTACCGATGAT,0,1081358
fldAp,0.5,1,1,TGACTTCCGCGGACGCAAAG,0,1179313
fldAp,0.5,1,1,TGACTCGCGTGCAAGTCAAA,0,1178242
fldAp,0.5,1,1,TGACTATGGTCCCGGCAACA,0,1097158
fldAp,0.5,1,1,TGACGGTGCAGTATACATAT,0,1120152
fldAp,0.5,1,1,TGACGCACTACCTCCTACTA,0,1139714
fldAp,0.5,1,1,TGACCGAGCCGTGACAGCCC,0,1076152
fldAp,0.5,1,1,TGACCGAATCAGTATCTATC,0,1069363
fldAp,0.5,1,1,TGACCGAATATTCGTATTCT,0,1172151
fldAp,0.5,1,1,TGACCCAAGCCCAGTACAGG,0,1183341
fldAp,0.5,1,1,TGACCACCTTAAGAGCCTTT,0,1070965
fldAp,0.5,1,1,TGACATTCACATGGAGCGAC,0,1122798
fldAp,0.5,1,1,TGACAATAACAGGCCGAATA,0,1116117
fldAp,0.5,1,1,TGACAAGTGGGTATGATCTA,0,1110212
fldAp,0.5,1,1,TGACAAGCTGTTCTCGGCGT,0,1137493
fldAp,0.5,1,1,TGAATTCGTTGTGGCGACTC,0,1071439
fldAp,0.5,1,1,TGAATTCCTTGGCGTAGTGA,0,1131671
fldAp,0.5,1,1,TGAATGCGGGATGGCCTCTT,0,1082307
fldAp,0.5,1,1,TGAATGCGCTCATAGAAGGC,0,1123180
fldAp,0.5,1,1,TGAAGCGCGCGAGGGAGGAG,0,1078092
fldAp,0.5,1,1,TGAAGCATATGCGTTGGATG,0,1111689
fldAp,0.5,1,1,TGAACTGATTGGTGTGCAGG,0,1179997
fldAp,0.5,1,1,TGAACTACGGGAGGCCGATA,0,1110024
fldAp,0.5,1,1,TGAACGGTGGGGGCCGCTGA,0,1167626
fldAp,0.5,1,1,TGAAATTGACGCGGACCCGT,0,1182936
fldAp,0.5,1,1,TGAAAGTCAATGCGCCAGGC,0,1063063
fldAp,0.5,1,1,TGAAAGGGGTCCCAAATCCT,0,1120625
fldAp,0.5,1,1,TGAAACGATAGTATCGTGAA,0,1116787
fldAp,0.5,1,1,TGAAACCCTGCGTCAGCGAC,0,1107967
fldAp,0.5,1,1,TGAAAACCCCGGCACGGACA,0,1147557
fldAp,0.5,1,1,TCTTTGCGGGGAAGAAACCA,0,1113116
fldAp,0.5,1,1,TCTTTCAGCTCTCCACGCTC,0,1153296
fldAp,0.5,1,1,TCTTTATCATGCTAGGCAGT,0,1169338
fldAp,0.5,1,1,TCTTTAGTTGAAAGCACGCC,0,1114948
fldAp,0.5,1,1,TCTTGTCGCTTATTACTGAC,0,1079429
fldAp,0.5,1,1,TCTTGCGTACGTTTCATTGA,0,1186422
fldAp,0.5,1,1,TCTTGCGATAACGTTTTCTT,0,1139680
fldAp,0.5,1,1,TCTTGAGCAGCTCATTGCCT,0,1171806
fldAp,0.5,1,1,TCTTCTAGAGGCCCGAGTAG,0,1098298
fldAp,0.5,1,1,TCTTCGCCGTAAAAGACACA,0,1117985
fldAp,0.5,1,1,TCTTCAGCAGCGTTCCCCGT,0,1107242
fldAp,0.5,1,1,TCTTCAAAAATAACGAATCC,0,1179806
fldAp,0.5,1,1,TCTTATTTGAGCATTTCTAA,0,1171300
fldAp,0.5,1,1,TCTTAGGTGGTAACGGGGAT,0,1097921
fldAp,0.5,1,1,TCTTAGGATTTAGTAGGGTC,0,1146495
fldAp,0.5,1,1,TCTTAGCTTCGTGCTCGGAA,0,1092355
fldAp,0.5,1,1,TCTTAGCGAATGTGGTTATC,0,1126121
fldAp,0.5,1,1,TCTTACTTTTCCTTGGGAGA,0,1081003
fldAp,0.5,1,1,TCTTAACTTGTCTTTGTAGC,0,1078149
fldAp,0.5,1,1,TCTGTTTAGACAGAGGACAT,0,1157186
fldAp,0.5,1,1,TCTGTGTTTGGGGTAATGGG,0,1111284
fldAp,0.5,1,1,TCTGTGATCGACGGAACCTG,0,1130090
fldAp,0.5,1,1,TCTGTATTAAGCTCTAGCGT,0,1156598
fldAp,0.5,1,1,TCTGTAACTAAGGACTATTG,0,1185526
fldAp,0.5,1,1,TCTGGTTGTTGGCTCCCGCT,0,1163287
fldAp,0.5,1,1,TCTGGTACGGTGTATGTGCT,0,1163801
fldAp,0.5,1,1,TCTGGATTCCTGTAACACCA,0,1180976
fldAp,0.5,1,1,TCTGGAGACAAGACAATTGC,0,1127378
fldAp,0.5,1,1,TCTGGACTCTAAAAATATTT,0,1086715
fldAp,0.5,1,1,TCTGGAAGACTACAACGGGT,0,1122261
fldAp,0.5,1,1,TCTGCTGTCCAGGAAGACGC,0,1081885
fldAp,0.5,1,1,TCTGCTGGGTAGCATTTGAG,0,1173913
fldAp,0.5,1,1,TCTGCTACTGAGTGTAAGTC,0,1109779
fldAp,0.5,1,1,TCTGCGCCGCCTACCTCACC,0,1098393
fldAp,0.5,1,1,TCTGCCGAGAGCTAACGAAC,0,1144191
fldAp,0.5,1,1,TCTGATTAGGCTCGATGCAA,0,1096185
fldAp,0.5,1,1,TCTGATCTTGGCCGGTTGAC,0,1122435
fldAp,0.5,1,1,TCTGAGAAATGAAGCGATAC,0,1162051
fldAp,0.5,1,1,TCTCTCAACCTAGATAGGGC,0,1125957
fldAp,0.5,1,1,TCTCTAATTTCTCAGGCGAT,0,1088388
fldAp,0.5,1,1,TCTCGTTCTATGTCACAAAG,0,1146691
fldAp,0.5,1,1,TCTCGTTAGAACAAAGTAAG,0,1147265
fldAp,0.5,1,1,TCTCGGGTAGGAATGTCGAT,0,1071592
fldAp,0.5,1,1,TCTCGGGCGTTCGTTCTAAA,0,1152971
fldAp,0.5,1,1,TCTCGCTGTCCACGATTCGA,0,1107912
fldAp,0.5,1,1,TCTCGCGGCTTAGACGAGTC,0,1068137
fldAp,0.5,1,1,TCTCGCAGCTGAAGCCTAAA,0,1088509
fldAp,0.5,1,1,TCTCCGGGATCGTTTGCGGT,0,1144531
fldAp,0.5,1,1,TCTCCGATCAATGCAAGATT,0,1150148
fldAp,0.5,1,1,TCTCCCTCCCGAAAACCGAC,0,1070742
fldAp,0.5,1,1,TCTCCCAGGGTGATCCAGGA,0,1137881
fldAp,0.5,1,1,TCTCCAGGGTGCGGAGTAAT,0,1112990
fldAp,0.5,1,1,TCTCAGCAGTCCGATAACAT,0,1091444
fldAp,0.5,1,1,TCTCAGAACGTTTAAGCTAT,0,1163010
fldAp,0.5,1,1,TCTCAATTGTTACGCCGGTC,0,1122789
fldAp,0.5,1,1,TCTCAAGGGCGCACTCTAGT,0,1127412
fldAp,0.5,1,1,TCTATTACTGAGCGATTGAT,0,1121440
fldAp,0.5,1,1,TCTATGGGCACGTGTTTTGT,0,1147712
fldAp,0.5,1,1,TCTATGAAGGCTCGCAAACT,0,1079998
fldAp,0.5,1,1,TCTATCCCTGAGGAATCTTA,0,1114009
fldAp,0.5,1,1,TCTATATCCCGGCCACATAA,0,1157819
fldAp,0.5,1,1,TCTATAATGGCGTAGAGCGC,0,1066986
fldAp,0.5,1,1,TCTAGTTTGGGATGTTTAAC,0,1172664
fldAp,0.5,1,1,TCTAGTTTCGAAAACAATAT,0,1140394
fldAp,0.5,1,1,TCTAGTGGACTTCACTGGTC,0,1161834
fldAp,0.5,1,1,TCTAGGTGTTTGTGCTATAA,0,1113429
fldAp,0.5,1,1,TCTAGGGGAGTGGTCCCGAG,0,1125324
fldAp,0.5,1,1,TCTAGCTACCCAAATCCGAC,0,1121976
fldAp,0.5,1,1,TCTAGCGCACCGTTGGACCC,0,1080347
fldAp,0.5,1,1,TCTAGAGCCGAGTACTTTCT,0,1174513
fldAp,0.5,1,1,TCTACGTCTAGAGACTACAA,0,1084633
fldAp,0.5,1,1,TCTACGGTCAAGCGTGACGT,0,1078166
fldAp,0.5,1,1,TCTACCCTTGGAATAAAGAT,0,1115133
fldAp,0.5,1,1,TCTACAGGTATGTGTGTGTA,0,1154294
fldAp,0.5,1,1,TCTACAGCTAACGGACTAGC,0,1075492
fldAp,0.5,1,1,TCTAATTTTGCCCACGCACA,0,1094598
fldAp,0.5,1,1,TCTAATACATTTGGGTAGAA,0,1179565
fldAp,0.5,1,1,TCTAAGTCGCCTGATTCCTT,0,1073048
fldAp,0.5,1,1,TCTAAATTCGCGCTTCTTGT,0,1147654
fldAp,0.5,1,1,TCGTTTGCTGTAGGAACCCC,0,1121061
fldAp,0.5,1,1,TCGTTTCGTTGCTGTTAGGA,0,1145362
fldAp,0.5,1,1,TCGTTTCGCCGCTACTGGTC,0,1175442
fldAp,0.5,1,1,TCGTTGGTAGTGGTAGACGG,0,1145353
fldAp,0.5,1,1,TCGTTGCATCCTCACTCCCC,0,1097601
fldAp,0.5,1,1,TCGTTCGAGCCTAATTCCAG,0,1166028
fldAp,0.5,1,1,TCGTTAGTATATCCTTCCTA,0,1083858
fldAp,0.5,1,1,TCGTGAACGCCAGTCTGGCC,0,1121476
fldAp,0.5,1,1,TCGTCTATGAAGCTAGCAAA,0,1066314
fldAp,0.5,1,1,TCGTCGTGTACTATACGATT,0,1107212
fldAp,0.5,1,1,TCGTCATTCGCCCCAGTGAG,0,1069046
fldAp,0.5,1,1,TCGTCAGGGAAACTGTCGGG,0,1121598
fldAp,0.5,1,1,TCGTATTGTTAACCAGCCCG,0,1110724
fldAp,0.5,1,1,TCGTATCGTCTACGAACTTA,0,1178092
fldAp,0.5,1,1,TCGTATAGTATACAGCGGGC,0,1095701
fldAp,0.5,1,1,TCGTACCACCCTCTGCTCAC,0,1114879
fldAp,0.5,1,1,TCGGTGAGCGAAGTCCAAAG,0,1150672
fldAp,0.5,1,1,TCGGTCTATCCAGTTGGAGT,0,1106585
fldAp,0.5,1,1,TCGGTATTGTCTAGTGTCAC,0,1140571
fldAp,0.5,1,1,TCGGTACGGACCTATATTTG,0,1072895
fldAp,0.5,1,1,TCGGTACCCTGGGCATACAA,0,1147974
fldAp,0.5,1,1,TCGGGGTGGATCCGGGGGGG,0,1109511
fldAp,0.5,1,1,TCGGGGTCCGTGGTAATAAT,0,1141589
fldAp,0.5,1,1,TCGGGCTTAATCCCGCTGAT,0,1182077
fldAp,0.5,1,1,TCGGGCTGTTCGGCTGTAGA,0,1145523
fldAp,0.5,1,1,TCGGCTTCCGTGTGGTGCAT,0,1092900
fldAp,0.5,1,1,TCGGCTAGGCGAGACGACTC,0,1171376
fldAp,0.5,1,1,TCGGATCCATTGAAGGAGAC,0,1147835
fldAp,0.5,1,1,TCGGAATGGTTGCAAGCGAC,0,1095008
fldAp,0.5,1,1,TCGGAACTTTAAAATGCTGG,0,1180804
fldAp,0.5,1,1,TCGCTTTCCTCTTTCCCATT,0,1168762
fldAp,0.5,1,1,TCGCTTATTGGTATATTCCT,0,1073686
fldAp,0.5,1,1,TCGCTTATCGCGCCTCCGGT,0,1167907
fldAp,0.5,1,1,TCGCTGAGCTTAAGAAACAT,0,1086441
fldAp,0.5,1,1,TCGCGTCAAATAGTCGGGTA,0,1113446
fldAp,0.5,1,1,TCGCGGCCCAAATGTGTCGT,0,1129513
fldAp,0.5,1,1,TCGCGCGTCAGAATCAGAAT,0,1157861
fldAp,0.5,1,1,TCGCGCCTGGTGGGGCTATT,0,1131315
fldAp,0.5,1,1,TCGCGCCCCCGTAAGCAGGT,0,1072289
fldAp,0.5,1,1,TCGCGCCATTCATGAGCAGC,0,1123832
fldAp,0.5,1,1,TCGCCGGAGGGGCTCGGATG,0,1158826
fldAp,0.5,1,1,TCGCCCCGTTCCGCACACTA,0,1146175
fldAp,0.5,1,1,TCGCCCCATTAGACAAGACT,0,1079707
fldAp,0.5,1,1,TCGCCAGGGTGACCTGCTTT,0,1170112
fldAp,0.5,1,1,TCGCCACAGAAGTTTAGGCA,0,1147277
fldAp,0.5,1,1,TCGCATTATATTTGTTGTAT,0,1118455
fldAp,0.5,1,1,TCGCAGAGAAATTCATGGCC,0,1159964
fldAp,0.5,1,1,TCGATGGTTGTTTCGTCATG,0,1153422
fldAp,0.5,1,1,TCGATGCGGATGGTGTCTAA,0,1185097
fldAp,0.5,1,1,TCGATCGTTGCAAGGAAGTT,0,1157325
fldAp,0.5,1,1,TCGAGGTCATAATTCTCTTT,0,1184224
fldAp,0.5,1,1,TCGAGATGTGATTGGGTGTG,0,1122658
fldAp,0.5,1,1,TCGACGTCTCGGGACAGAAC,0,1168243
fldAp,0.5,1,1,TCGACCCACCCAATGATTGA,0,1110784
fldAp,0.5,1,1,TCGAATCGATTTCAGGATCC,0,1115318
fldAp,0.5,1,1,TCGAAGTATAAATGTTAGAC,0,1168828
fldAp,0.5,1,1,TCGAAAGTGCAAGGGTCCCG,0,1122802
fldAp,0.5,1,1,TCGAAAGGGAGCTGTGTACA,0,1107793
fldAp,0.5,1,1,TCGAAACGCTGCGGGGCGGT,0,1157122
fldAp,0.5,1,1,TCCTTGACCAGACGTCGCTA,0,1086668
fldAp,0.5,1,1,TCCTTATTCATTAAGCTACG,0,1112584
fldAp,0.5,1,1,TCCTGCGAGCTAGTGACGGT,0,1160495
fldAp,0.5,1,1,TCCTGCATGCAAGTGCACTA,0,1141845
fldAp,0.5,1,1,TCCTGAAGATAACAGTGCCG,0,1157207
fldAp,0.5,1,1,TCCTCTACCTCCCGTCAAGG,0,1111233
fldAp,0.5,1,1,TCCTCTAAGGGCAACCTCTA,0,1186379
fldAp,0.5,1,1,TCCTCGCCCCCCTGGTTCGT,0,1102076
fldAp,0.5,1,1,TCCTCCCCATGCGCTTGAGG,0,1072367
fldAp,0.5,1,1,TCCTATACCGCGGGAAGGTT,0,1077921
fldAp,0.5,1,1,TCCTATAAGCACGAAGCTTA,0,1099959
fldAp,0.5,1,1,TCCTAATATCACAGGTTAAA,0,1097063
fldAp,0.5,1,1,TCCGTTAGTGTATAGTTGGA,0,1118446
fldAp,0.5,1,1,TCCGTCCTAATGTGCAAGTG,0,1156311
fldAp,0.5,1,1,TCCGGGGCAGGTGTGAATGT,0,1169327
fldAp,0.5,1,1,TCCGCTACATCTCTATAGGA,0,1171563
fldAp,0.5,1,1,TCCGCACGCCCCGGGCTGTA,0,1126001
fldAp,0.5,1,1,TCCGAGTCTCCACGGTCACC,0,1095673
fldAp,0.5,1,1,TCCGAGTCACATTAAAGGGC,0,1097100
fldAp,0.5,1,1,TCCGAGAGGGTACAGAGGGT,0,1161357
fldAp,0.5,1,1,TCCGACTCGCACTCTATTGA,0,1138197
fldAp,0.5,1,1,TCCCTTAGTACATCGAGTTG,0,1163028
fldAp,0.5,1,1,TCCCTCGCCGGTCAGTATTC,0,1161293
fldAp,0.5,1,1,TCCCGTTAGGCTATCGTTAT,0,1162247
fldAp,0.5,1,1,TCCCGGGGATTCTTCCTCCT,0,1138588
fldAp,0.5,1,1,TCCCGGACAAACCATTTAGA,0,1154745
fldAp,0.5,1,1,TCCCGCAGGACAGCAGATTA,0,1101700
fldAp,0.5,1,1,TCCCGACATTTAGCGTGTAA,0,1177242
fldAp,0.5,1,1,TCCCGACAGGTCGGGTACTA,0,1066172
fldAp,0.5,1,1,TCCCCTTCGCTTCGTCCTCT,0,1090591
fldAp,0.5,1,1,TCCCCGCGGATGTAGAGCTG,0,1106247
fldAp,0.5,1,1,TCCCCAGTGTCCGTGTGGTG,0,1110288
fldAp,0.5,1,1,TCCCCACGTTCCGTGGCAAT,0,1134087
fldAp,0.5,1,1,TCCCATTTACGACCTTCTGT,0,1130338
fldAp,0.5,1,1,TCCCACAAAGGCGCTACGCT,0,1080605
fldAp,0.5,1,1,TCCATGTAACCGTTGACCCC,0,1082602
fldAp,0.5,1,1,TCCATGCAACTGACCGCCCA,0,1162633
fldAp,0.5,1,1,TCCATCGGGAAGTAAGTCTT,0,1084335
fldAp,0.5,1,1,TCCAGTCGTTTTATAGGTGA,0,1137260
fldAp,0.5,1,1,TCCAGTCCCTCGTTGTGGGA,0,1181284
fldAp,0.5,1,1,TCCAGTAGCGATTGGTCATT,0,1124681
fldAp,0.5,1,1,TCCAGGGGGCATCGGTACAA,0,1127964
fldAp,0.5,1,1,TCCAGCTGACTGGGTGGGTT,0,1066455
fldAp,0.5,1,1,TCCAGCGGCGCAGGCCTCTA,0,1080538
fldAp,0.5,1,1,TCCAGCGAGTTCGGGGTAAC,0,1139086
fldAp,0.5,1,1,TCCAGATAAGGACTGGGCCG,0,1068308
fldAp,0.5,1,1,TCCAGAATTTGTGAGCTCAC,0,1163743
fldAp,0.5,1,1,TCCACTTCCATACACTGTGC,0,1075049
fldAp,0.5,1,1,TCCACGCGGGGGAAAAGTGG,0,1101766
fldAp,0.5,1,1,TCCAAGCAAGGATTACAGAT,0,1120618
fldAp,0.5,1,1,TCCAACAGGCCGCGCGATGG,0,1112293
fldAp,0.5,1,1,TCATTTGAGGCTTTCGTTGC,0,1071873
fldAp,0.5,1,1,TCATTTATCCCGGGACTTCC,0,1066842
fldAp,0.5,1,1,TCATTCGCGCTCGAGTATTT,0,1133352
fldAp,0.5,1,1,TCATTCATGGGACCTGGGTT,0,1136678
fldAp,0.5,1,1,TCATGTGCCATTTACTTTAT,0,1068609
fldAp,0.5,1,1,TCATCTGATGGCACTGCTGA,0,1109353
fldAp,0.5,1,1,TCATCTCTATGCTGCCACTA,0,1069389
fldAp,0.5,1,1,TCATCGTATACTCAGAGGAT,0,1094355
fldAp,0.5,1,1,TCATCATCTGCCTCTCAGAC,0,1128622
fldAp,0.5,1,1,TCATATCAGTTCCTAGTCCC,0,1083116
fldAp,0.5,1,1,TCATATAAAGCTAGTAGAAC,0,1184211
fldAp,0.5,1,1,TCATACTTGACGCCACAGGT,0,1146056
fldAp,0.5,1,1,TCATACGACGCCAACGCCCT,0,1156124
fldAp,0.5,1,1,TCATACAAATTGCTTGTGCT,0,1103275
fldAp,0.5,1,1,TCATAAGGGAGTCATTGACT,0,1168298
fldAp,0.5,1,1,TCAGTAGAGCACGTATTGGT,0,1084885
fldAp,0.5,1,1,TCAGTAAACTTCTGTCAGAC,0,1155298
fldAp,0.5,1,1,TCAGGTTTCGTCTCTCGGGA,0,1183129
fldAp,0.5,1,1,TCAGGTGCGCCCACTTTCGG,0,1156445
fldAp,0.5,1,1,TCAGGGTTTGCGCACCAAGC,0,1160442
fldAp,0.5,1,1,TCAGGCTTTTCTATACACAT,0,1106236
fldAp,0.5,1,1,TCAGCTTTTTGCAGGAGACT,0,1117378
fldAp,0.5,1,1,TCAGCTTCACCTATCTGGGT,0,1087177
fldAp,0.5,1,1,TCAGCTGCCTCGGTATACAC,0,1137627
fldAp,0.5,1,1,TCAGCCGCGACGGTAGCTCG,0,1081484
fldAp,0.5,1,1,TCAGACGGTGGCCGTCTTAA,0,1177671
fldAp,0.5,1,1,TCAGACCTACAAGACGTTAT,0,1120512
fldAp,0.5,1,1,TCAGACCGCGGTTCCGACCC,0,1108736
fldAp,0.5,1,1,TCAGAATGATTAATAGAGAC,0,1150381
fldAp,0.5,1,1,TCACTGTAGTCAGACGAGGG,0,1171770
fldAp,0.5,1,1,TCACTAGCAGAATATTTTTG,0,1125982
fldAp,0.5,1,1,TCACGGCCGGCACGTTGTTC,0,1099860
fldAp,0.5,1,1,TCACGACCTAGTGGGTCATG,0,1135321
fldAp,0.5,1,1,TCACCTAAATCACGGCCACT,0,1069898
fldAp,0.5,1,1,TCACCGCGCATACTTGACCC,0,1110094
fldAp,0.5,1,1,TCACCGAAGAGTTTGTTAGT,0,1103169
fldAp,0.5,1,1,TCACCCACACGGTCCCATAA,0,1170690
fldAp,0.5,1,1,TCACCAAATGCATATGGTTT,0,1128608
fldAp,0.5,1,1,TCACCAAACCTTGAGTTCCA,0,1075677
fldAp,0.5,1,1,TCACATAACGGCTAACATCC,0,1120545
fldAp,0.5,1,1,TCACAAGCGTACTTGCCTAT,0,1073826
fldAp,0.5,1,1,TCAATTGGCGAGCACCGCAA,0,1149699
fldAp,0.5,1,1,TCAATGCGGCAGAACCAGCT,0,1147573
fldAp,0.5,1,1,TCAATCGAGCCTTGCAAGGG,0,1148179
fldAp,0.5,1,1,TCAATCCTTACTCATAATGT,0,1179160
fldAp,0.5,1,1,TCAATATATTGTCGCCTCTA,0,1181032
fldAp,0.5,1,1,TCAATAGTAGAAGTCCCCCA,0,1099706
fldAp,0.5,1,1,TCAATACCTAAGGTGAAGTA,0,1162764
fldAp,0.5,1,1,TCAAGTTCCTATTTAGTTCT,0,1150773
fldAp,0.5,1,1,TCAAGGGGATCAGAGTATAG,0,1103713
fldAp,0.5,1,1,TCAAGGAAATTTAGGACTTT,0,1069705
fldAp,0.5,1,1,TCAAGCTTCTCTACACACCT,0,1122993
fldAp,0.5,1,1,TCAAGCGGTCCCGAGAATTC,0,1118667
fldAp,0.5,1,1,TCAAGAAGGCAGGCCGGAGA,0,1137432
fldAp,0.5,1,1,TCAACGTTCTCATTATAGGC,0,1131748
fldAp,0.5,1,1,TCAACGATAGCTGAGAGTGT,0,1186198
fldAp,0.5,1,1,TCAACAGTATAGAGTAGAGA,0,1120311
fldAp,0.5,1,1,TCAAATGGCGCAGCGGGCGC,0,1180165
fldAp,0.5,1,1,TCAAATAATCTTGCTAGGCG,0,1175366
fldAp,0.5,1,1,TCAAAGGCCGATACCTAGTT,0,1125065
fldAp,0.5,1,1,TATTTTAGATACTATCCTAA,0,1123178
fldAp,0.5,1,1,TATTTGCCTATTGACGAGTA,0,1075380
fldAp,0.5,1,1,TATTTGCAGGCCATTCTAGA,0,1096759
fldAp,0.5,1,1,TATTTCGATAGAGATGCTCA,0,1089597
fldAp,0.5,1,1,TATTGTTGATAGGGAGGAGC,0,1170114
fldAp,0.5,1,1,TATTGTTCTGGCGACCTTAA,0,1079533
fldAp,0.5,1,1,TATTGTCGCCCAAAGTAGCT,0,1087640
fldAp,0.5,1,1,TATTGTAGAGTTGCACACAT,0,1168501
fldAp,0.5,1,1,TATTGGGGGTAAGGCCCGCC,0,1069368
fldAp,0.5,1,1,TATTGGCCAGTTGACGCAAG,0,1144988
fldAp,0.5,1,1,TATTGGACCCTTAAGCAGTA,0,1098106
fldAp,0.5,1,1,TATTCGGCGGCAAGTCATGG,0,1089308
fldAp,0.5,1,1,TATTCGAGCGCGGTGATGGA,0,1176313
fldAp,0.5,1,1,TATTCCGCTGGGCACGCAAG,0,1173769
fldAp,0.5,1,1,TATTCCGATGCTCGAACAGG,0,1181600
fldAp,0.5,1,1,TATTCACACGGCTCGGAGAG,0,1133053
fldAp,0.5,1,1,TATTATATATCGTGTGTGCT,0,1150677
fldAp,0.5,1,1,TATTATACTTGGAACAGGAA,0,1094035
fldAp,0.5,1,1,TATTAGTATTACGCGATGTT,0,1071293
fldAp,0.5,1,1,TATGTGGGGCCAGGTGGGAT,0,1146335
fldAp,0.5,1,1,TATGTGCGTTGTATGTATAC,0,1157806
fldAp,0.5,1,1,TATGTCGGTCTGTCATTCCT,0,1175556
fldAp,0.5,1,1,TATGTACCATTACAGATGTA,0,1116609
fldAp,0.5,1,1,TATGGTTCGTAAGCACATAA,0,1177701
fldAp,0.5,1,1,TATGGTGTGAATACTGAACC,0,1133764
fldAp,0.5,1,1,TATGGGCTTAAGAGAACGTT,0,1153408
fldAp,0.5,1,1,TATGGCTGGCAGGAAAACCT,0,1085532
fldAp,0.5,1,1,TATGGCTCTCATATCTGAGC,0,1069164
fldAp,0.5,1,1,TATGCTTCCACAGGTGGCGT,0,1102250
fldAp,0.5,1,1,TATGCTTATTATAAATCTAT,0,1102533
fldAp,0.5,1,1,TATGCGCCCTGTCCATCAAT,0,1109211
fldAp,0.5,1,1,TATGATCCCCGCCCTGACTT,0,1139953
fldAp,0.5,1,1,TATGAGACAAATCGGACTCT,0,1101897
fldAp,0.5,1,1,TATGACGGAGTAGCAGCGGA,0,1159816
fldAp,0.5,1,1,TATCTTAGGCCTGTAAATCC,0,1094164
fldAp,0.5,1,1,TATCTGTCACTGATATCCTG,0,1098999
fldAp,0.5,1,1,TATCTGGTCACTCATATCTG,0,1133736
fldAp,0.5,1,1,TATCTCTAATAACTCGTCAC,0,1068241
fldAp,0.5,1,1,TATCTCGGAGTTGGGACGAC,0,1079376
fldAp,0.5,1,1,TATCTAGTGGCGATCGTTAG,0,1067375
fldAp,0.5,1,1,TATCTAATGACACCACGCAT,0,1092406
fldAp,0.5,1,1,TATCGGTGCCTGGGGACGAT,0,1163020
fldAp,0.5,1,1,TATCGCCAATCCATGACCTA,0,1148704
fldAp,0.5,1,1,TATCGCATGTGAATCAGGTT,0,1162498
fldAp,0.5,1,1,TATCGAGGCATCTACCAAAT,0,1110188
fldAp,0.5,1,1,TATCCCCTTCTTACCGGGTC,0,1064946
fldAp,0.5,1,1,TATCCAGCTGTCATTAGGGT,0,1117768
fldAp,0.5,1,1,TATCCAATACGCACACCTCA,0,1084345
fldAp,0.5,1,1,TATCATTGCAAGGCGCATCA,0,1097510
fldAp,0.5,1,1,TATCACTGCATTTGACTTTT,0,1130005
fldAp,0.5,1,1,TATCACCTATCATCAACTGG,0,1134181
fldAp,0.5,1,1,TATATGACATCGTCTTTGTT,0,1093815
fldAp,0.5,1,1,TATATCCCCATGAATCTCCT,0,1074693
fldAp,0.5,1,1,TATATCAAATGCCAACTCAT,0,1160234
fldAp,0.5,1,1,TATATATCTAAGTTAGGGGA,0,1078943
fldAp,0.5,1,1,TATATATCCGGGACTGTGGT,0,1106075
fldAp,0.5,1,1,TATATACCGATGGTCGAGTA,0,1185331
fldAp,0.5,1,1,TATAGGTGTGATGATTAGCT,0,1125470
fldAp,0.5,1,1,TATAGCTTGCTTGGACGCAT,0,1075897
fldAp,0.5,1,1,TATAGCCCGAGGGCCTTTTA,0,1088902
fldAp,0.5,1,1,TATAGACAAGGAGACTCGTT,0,1163224
fldAp,0.5,1,1,TATACTCCGCGTCAGGGGAC,0,1084984
fldAp,0.5,1,1,TATACGACTTACTTCAGTAA,0,1090238
fldAp,0.5,1,1,TATACAGAACCTGTCACGGG,0,1141290
fldAp,0.5,1,1,TATACAAGACGCTCAAGAAA,0,1151053
fldAp,0.5,1,1,TATACAACTCATTTTTCAAA,0,1151126
fldAp,0.5,1,1,TATAATCCTCGGGACGAAGA,0,1186809
fldAp,0.5,1,1,TATAATAGGGTATATAGAGA,0,1097339
fldAp,0.5,1,1,TATAATAGCGCGGAATAGAG,0,1081513
fldAp,0.5,1,1,TATAATACAGATGCATCCTC,0,1141610
fldAp,0.5,1,1,TATAAGGCATACAATCTCGC,0,1100261
fldAp,0.5,1,1,TATAAGAGTCCCTCGTGGAG,0,1140074
fldAp,0.5,1,1,TAGTTCTCTCTTTGTTTAAC,0,1076717
fldAp,0.5,1,1,TAGTGATCATGATATGGCGG,0,1110997
fldAp,0.5,1,1,TAGTCGCGGGGAGCCTTGAT,0,1108539
fldAp,0.5,1,1,TAGGTTGCAAGAGTGTCCAC,0,1156788
fldAp,0.5,1,1,TAGGTTCGGCCGGGTCCGGT,0,1108717
fldAp,0.5,1,1,TAGGTTCACCATGTTCCGTA,0,1072271
fldAp,0.5,1,1,TAGGTGCAGAATGGTGGTTC,0,1100012
fldAp,0.5,1,1,TAGGTCGGGAATCTACCCTA,0,1125672
fldAp,0.5,1,1,TAGGTCAGAGGTGAATCTTT,0,1094454
fldAp,0.5,1,1,TAGGGGCCTGGTGACACAGC,0,1110859
fldAp,0.5,1,1,TAGGGATTCCGCCTGTGTGG,0,1151552
fldAp,0.5,1,1,TAGGGATGAAAGCGCGTTCA,0,1142403
fldAp,0.5,1,1,TAGGCTTAAAGAGCAATGAA,0,1124782
fldAp,0.5,1,1,TAGGCTGTCGCGCGATCGCC,0,1073667
fldAp,0.5,1,1,TAGGCTGTAATTGTCTACTA,0,1105571
fldAp,0.5,1,1,TAGGCTAATCCTCTTATATG,0,1152451
fldAp,0.5,1,1,TAGGCCGACGAATGGGTGGC,0,1081840
fldAp,0.5,1,1,TAGGCACTAAATGCTACCAA,0,1064943
fldAp,0.5,1,1,TAGGACCATTGAAGCTGAAA,0,1181432
fldAp,0.5,1,1,TAGCTTTGACGCGTGGTAAT,0,1149689
fldAp,0.5,1,1,TAGCTCCGATGAACCTCAGT,0,1124864
fldAp,0.5,1,1,TAGCTAATCAAAGCCGATAC,0,1100851
fldAp,0.5,1,1,TAGCGCGGATGGTCCGGGTA,0,1094444
fldAp,0.5,1,1,TAGCGCCCCCCACATCCCCA,0,1135422
fldAp,0.5,1,1,TAGCGAACGCAATGCGTTTA,0,1145534
fldAp,0.5,1,1,TAGCGAAACCACACAGATAC,0,1153870
fldAp,0.5,1,1,TAGCCTTATGCTTCCAGAGA,0,1092302
fldAp,0.5,1,1,TAGCCGATATTGAGTTGTAA,0,1151818
fldAp,0.5,1,1,TAGCCGACGGGCACTGAAGC,0,1157442
fldAp,0.5,1,1,TAGCCACTAATGACCGAACT,0,1068717
fldAp,0.5,1,1,TAGCAGCCTTTTTCCGTTGG,0,1080088
fldAp,0.5,1,1,TAGCACGCCTCTCATAAATT,0,1151026
fldAp,0.5,1,1,TAGCAATACGTCGTACAAAC,0,1165681
fldAp,0.5,1,1,TAGCAAAGGCCTCTGTGCAT,0,1094142
fldAp,0.5,1,1,TAGATTGCTTATTTTGGGCG,0,1117476
fldAp,0.5,1,1,TAGATTCTTGTGCGAGGCAG,0,1070249
fldAp,0.5,1,1,TAGATTCTCAATGTGCAGTA,0,1079725
fldAp,0.5,1,1,TAGATTAGGTGTTTGATCAT,0,1082583
fldAp,0.5,1,1,TAGATTACTCCTGCTTAGGA,0,1115411
fldAp,0.5,1,1,TAGATGTATCGCGGTTTATT,0,1074465
fldAp,0.5,1,1,TAGATCGAAGTGTGCTTCTC,0,1144350
fldAp,0.5,1,1,TAGAGTCCGGATGGTGACCA,0,1068164
fldAp,0.5,1,1,TAGAGTACTTTTCGTGGAGT,0,1122511
fldAp,0.5,1,1,TAGAGAATACATGGGTCGCA,0,1116485
fldAp,0.5,1,1,TAGACTTCCAACGCGTTGTG,0,1169424
fldAp,0.5,1,1,TAGACGGTATGCAGCGCTCC,0,1137103
fldAp,0.5,1,1,TAGACGGCGCGAAACAGGAC,0,1068253
fldAp,0.5,1,1,TAGACATACGGCACTGTCAT,0,1151664
fldAp,0.5,1,1,TAGAAATGTAAGATTCCTAA,0,1086257
fldAp,0.5,1,1,TAGAAAGATTCTGCGGCAGA,0,1175526
fldAp,0.5,1,1,TACTTTGACGCCCCTGGTCT,0,1183269
fldAp,0.5,1,1,TACTTCCCAACGCTTGTCCA,0,1079132
fldAp,0.5,1,1,TACTTCACTCGATCAGGTCG,0,1089685
fldAp,0.5,1,1,TACTTACCCTTTAGAATAGG,0,1172741
fldAp,0.5,1,1,TACTGTACACAAGTTGTGAT,0,1145292
fldAp,0.5,1,1,TACTGGTAGTGATCATGCTA,0,1092237
fldAp,0.5,1,1,TACTGGCCCATGCCTTGCGA,0,1131856
fldAp,0.5,1,1,TACTGATACGCGCGTGACGG,0,1073110
fldAp,0.5,1,1,TACTGAAAGCGGAAGCTCGT,0,1125303
fldAp,0.5,1,1,TACTCTGGGAAGTTTCCAAT,0,1161268
fldAp,0.5,1,1,TACTCTAACGCGCTACAGGT,0,1075763
fldAp,0.5,1,1,TACTCGAATGGGTGGCATAT,0,1181124
fldAp,0.5,1,1,TACTCCCGGAGTACTCTTGT,0,1089478
fldAp,0.5,1,1,TACTATATGACCTCGGTGTG,0,1068280
fldAp,0.5,1,1,TACTAATCTGCGGTGGAGGA,0,1135684
fldAp,0.5,1,1,TACTAATCGGTCTTCCTCGA,0,1181139
fldAp,0.5,1,1,TACGTTCAAACAGGGGTAAT,0,1157031
fldAp,0.5,1,1,TACGTGAGGACCAGGCGCTC,0,1178749
fldAp,0.5,1,1,TACGTCCCCAACCTCGTTTG,0,1125986
fldAp,0.5,1,1,TACGTACTGCCAAAAAGTTA,0,1172522
fldAp,0.5,1,1,TACGGGTCACGGGAAGCGGG,0,1084420
fldAp,0.5,1,1,TACGGGGGATTCATAGGAAA,0,1142916
fldAp,0.5,1,1,TACGGGCCGGCCGATCTGAC,0,1127425
fldAp,0.5,1,1,TACGGCCACACGGGTTAGAC,0,1148553
fldAp,0.5,1,1,TACGGATTAACTCAAGCGTA,0,1159049
fldAp,0.5,1,1,TACGGATCGGACAGTTCATA,0,1166968
fldAp,0.5,1,1,TACGCGAGATTGCAGGTTTT,0,1074052
fldAp,0.5,1,1,TACGCGAAGCCTAGTTAATT,0,1074856
fldAp,0.5,1,1,TACGAGTGCGGTTCTCGTAG,0,1180350
fldAp,0.5,1,1,TACGACGTTCCCCAGAAAGC,0,1121970
fldAp,0.5,1,1,TACGAAAGTAAATAAAGAAA,0,1158261
fldAp,0.5,1,1,TACCTATTTTCTAGTAGTCT,0,1157473
fldAp,0.5,1,1,TACCAGGCGTCTCTCACCGC,0,1093577
fldAp,0.5,1,1,TACCAGGATGAGTGTGCAAA,0,1082892
fldAp,0.5,1,1,TACCAGCGACCTTGATATCG,0,1114016
fldAp,0.5,1,1,TACCACGCATGGGCAGACAA,0,1075321
fldAp,0.5,1,1,TACCACCAATCACTCTGGAC,0,1175204
fldAp,0.5,1,1,TACCACAGATAGGCTGGGAT,0,1134833
fldAp,0.5,1,1,TACCACAAATGCGTGGGGTA,0,1071093
fldAp,0.5,1,1,TACATACATTACGAGTACGA,0,1078130
fldAp,0.5,1,1,TACAGTCGTAGTGGCAATGT,0,1154637
fldAp,0.5,1,1,TACAGCCCCGTTCCCAACGT,0,1173865
fldAp,0.5,1,1,TACAGAGCTAATGAGCGCCT,0,1162950
fldAp,0.5,1,1,TACACTTATACAATTACTGG,0,1118705
fldAp,0.5,1,1,TACACTACAGCACATGCTGT,0,1165768
fldAp,0.5,1,1,TACACGGGTACCAAACGCCC,0,1186553
fldAp,0.5,1,1,TACACATGCAATTAGCCAAC,0,1181619
fldAp,0.5,1,1,TACACAGTACGCCGTCCGCT,0,1087344
fldAp,0.5,1,1,TACACAGAAGCGGCGCGATG,0,1184190
fldAp,0.5,1,1,TACACAAACCGGCAGGTCAC,0,1182638
fldAp,0.5,1,1,TACAATTCTTACGTGTGAAC,0,1158900
fldAp,0.5,1,1,TACAATATCGGAGACGACGC,0,1083710
fldAp,0.5,1,1,TACAATAAGGGGTCAAGCTC,0,1129937
fldAp,0.5,1,1,TACAAGTTGTTTACACGTTC,0,1157289
fldAp,0.5,1,1,TACAAAGTCCATTGCTCTAG,0,1093641
fldAp,0.5,1,1,TAATTTGTTCCTCAACTTGT,0,1159982
fldAp,0.5,1,1,TAATTGGGTTATGGGGGGAC,0,1066158
fldAp,0.5,1,1,TAATTGCAGAACGGTTCATG,0,1091630
fldAp,0.5,1,1,TAATTCTCAACCTCCGGTTG,0,1127201
fldAp,0.5,1,1,TAATTATTGGCATGATTTAT,0,1102449
fldAp,0.5,1,1,TAATTAGTCCTGGTCCCGTA,0,1101660
fldAp,0.5,1,1,TAATTACTGCTACTCATGTT,0,1121977
fldAp,0.5,1,1,TAATGGGTCAGTAGCTAAGC,0,1139959
fldAp,0.5,1,1,TAATGCCCAAGGGCAACAGC,0,1093605
fldAp,0.5,1,1,TAATGCAATTGCGGAACTAT,0,1096269
fldAp,0.5,1,1,TAATCTAGTAACCACGCCGA,0,1147800
fldAp,0.5,1,1,TAATCATGGGGATAAGGTGT,0,1140688
fldAp,0.5,1,1,TAATCAGATTTGGCAAAGTC,0,1090211
fldAp,0.5,1,1,TAATATCCTCGGTGTTTGGT,0,1172102
fldAp,0.5,1,1,TAATAGCCGAGTGTACTCTA,0,1092199
fldAp,0.5,1,1,TAATACTTAACTCAGCACAA,0,1177081
fldAp,0.5,1,1,TAATACGTAATCGAAGCGTG,0,1141272
fldAp,0.5,1,1,TAATAATGTTTCTGGGCGTA,0,1069847
fldAp,0.5,1,1,TAATAAACGGTATTGGTACG,0,1181656
fldAp,0.5,1,1,TAAGTTCAGTTGTACTCAAT,0,1135508
fldAp,0.5,1,1,TAAGTGTTCCGTTAGGTTTT,0,1085404
fldAp,0.5,1,1,TAAGTCAACGGTTGCTGAAA,0,1072443
fldAp,0.5,1,1,TAAGGGGGGGAAAACGGGAC,0,1128586
fldAp,0.5,1,1,TAAGCTTTTTGCCCTGTATA,0,1125195
fldAp,0.5,1,1,TAAGCGTGGTTTGACTGGAG,0,1074362
fldAp,0.5,1,1,TAAGCCCATAAGGTAGCGCT,0,1096051
fldAp,0.5,1,1,TAAGCATCACCATTACGACG,0,1183248
fldAp,0.5,1,1,TAAGCAGGAATCCGCGTCAG,0,1127588
fldAp,0.5,1,1,TAAGATTCTTATTGCCTCAT,0,1152035
fldAp,0.5,1,1,TAAGATGCCCACTAGACGTA,0,1069015
fldAp,0.5,1,1,TAAGAGTCACCCGGAACACA,0,1086864
fldAp,0.5,1,1,TAAGACTAAATTGTTGAGCG,0,1100884
fldAp,0.5,1,1,TAAGAAACCAGGACCGACTA,0,1125866
fldAp,0.5,1,1,TAACTTCGTTACGAGCAGAG,0,1110534
fldAp,0.5,1,1,TAACTTCGTCTCCCGTATCC,0,1111641
fldAp,0.5,1,1,TAACTCCGTTGTAAGCGTGA,0,1148515
fldAp,0.5,1,1,TAACCTTCGTCGAAGGCGGG,0,1152884
fldAp,0.5,1,1,TAACCTGCTTTTCAACCCCC,0,1093975
fldAp,0.5,1,1,TAACCGCGGAAGGGAACGGA,0,1133492
fldAp,0.5,1,1,TAACCATCGATACAACCCGG,0,1176663
fldAp,0.5,1,1,TAACACAGATTCGCAGTTAG,0,1171421
fldAp,0.5,1,1,TAAATTGCAGTTATATACTA,0,1152135
fldAp,0.5,1,1,TAAATACAAATTACGTCGAT,0,1089574
fldAp,0.5,1,1,TAAAGGGGGGATTGATCAAT,0,1071403
fldAp,0.5,1,1,TAAAGCTAGACGCTTCATAC,0,1125022
fldAp,0.5,1,1,TAAAGCCATGTTCCACTTAC,0,1130182
fldAp,0.5,1,1,TAAAGAAGGGGCCAGATGAG,0,1161923
fldAp,0.5,1,1,TAAACGGTCTCCTACGTGCG,0,1148751
fldAp,0.5,1,1,TAAACCCCAAATAACTCTTG,0,1082872
fldAp,0.5,1,1,TAAAACCCCTGAGAGGATGT,0,1110350
fldAp,0.5,1,1,TAAAAAACACGATCATCTTA,0,1131461
fldAp,0.5,1,1,GTTTTGTGATTGCCTTTATA,0,1145126
fldAp,0.5,1,1,GTTTTGTAGGTATAACCGGA,0,1102078
fldAp,0.5,1,1,GTTTTCATGAGCGTGGAAAT,0,1102986
fldAp,0.5,1,1,GTTTTATACACTCCCGACCA,0,1166745
fldAp,0.5,1,1,GTTTTACTAACGTGCATTTA,0,1077383
fldAp,0.5,1,1,GTTTGTGTGCGCGCGTGTTA,0,1070253
fldAp,0.5,1,1,GTTTGTGGCCGATGACTACC,0,1079325
fldAp,0.5,1,1,GTTTGTAATTGAATAGTTCT,0,1072706
fldAp,0.5,1,1,GTTTGGTAAATCAAATAGCC,0,1107316
fldAp,0.5,1,1,GTTTGGGATCTCGCCAGTGA,0,1152026
fldAp,0.5,1,1,GTTTGGGAAAGCCCCCACGT,0,1106055
fldAp,0.5,1,1,GTTTGATCTAGGAGTGGACC,0,1075232
fldAp,0.5,1,1,GTTTGAGGCTGCTCCCGCGA,0,1106761
fldAp,0.5,1,1,GTTTGAATGCTATTTAGCTG,0,1130086
fldAp,0.5,1,1,GTTTCTCCGGCACTCGAAGT,0,1100243
fldAp,0.5,1,1,GTTTCTCACTGCAGGCTTTC,0,1100699
fldAp,0.5,1,1,GTTTCGTTGGTAGAGCAACC,0,1163820
fldAp,0.5,1,1,GTTTCCACAGCTGTTTCTAA,0,1102641
fldAp,0.5,1,1,GTTTCATAATAATCTCAGAC,0,1100123
fldAp,0.5,1,1,GTTTCAATATTCAGCAAATC,0,1063140
fldAp,0.5,1,1,GTTTATTTACGGCCGGGCCT,0,1133988
fldAp,0.5,1,1,GTTTATGTTCGTATTAGGTG,0,1108224
fldAp,0.5,1,1,GTTTAGTCCACAGGCCGACC,0,1177953
fldAp,0.5,1,1,GTTTAGTATGCATTGGGTTG,0,1117443
fldAp,0.5,1,1,GTTTAACGTCCGCAATGTGG,0,1121480
fldAp,0.5,1,1,GTTTAACAAGCGTGCAGAGA,0,1138138
fldAp,0.5,1,1,GTTGTTCAAATCCCGATCGA,0,1182296
fldAp,0.5,1,1,GTTGTGGGTTGGCCCCCCAC,0,1102121
fldAp,0.5,1,1,GTTGTCCGTGGAAAAATCGC,0,1149825
fldAp,0.5,1,1,GTTGTCCCGAGTGCTTCCAG,0,1159742
fldAp,0.5,1,1,GTTGTACGTAGTGCGAGGAC,0,1079085
fldAp,0.5,1,1,GTTGGTCTGTGAAGGAAGAC,0,1162892
fldAp,0.5,1,1,GTTGGTACGCGCCACGACAC,0,1100706
fldAp,0.5,1,1,GTTGGGCATCAACGGGCGTA,0,1166006
fldAp,0.5,1,1,GTTGGGAGTAGAGGGCGGCA,0,1134260
fldAp,0.5,1,1,GTTGGATTCGAGATCTGCAA,0,1156389
fldAp,0.5,1,1,GTTGGACTGCATATCTCGGG,0,1116352
fldAp,0.5,1,1,GTTGCGGGCGACCAGGTGGT,0,1175407
fldAp,0.5,1,1,GTTGCCCCTTACTTCACATC,0,1094459
fldAp,0.5,1,1,GTTGAGAACTCATGAGGTAT,0,1113392
fldAp,0.5,1,1,GTTGACTTCGGTTAGGTCAT,0,1183427
fldAp,0.5,1,1,GTTGAACAACATGGCTCCAT,0,1125599
fldAp,0.5,1,1,GTTCTGTTTGGGTGTTGCTG,0,1077501
fldAp,0.5,1,1,GTTCTAGTTCTGCTTCCTTC,0,1074775
fldAp,0.5,1,1,GTTCGTACGACGCGTTTAAT,0,1125794
fldAp,0.5,1,1,GTTCGGTTTCGGCAAAGGGT,0,1137202
fldAp,0.5,1,1,GTTCGGTTGATTTGGCACCG,0,1143088
fldAp,0.5,1,1,GTTCGGCGCTGCCCTGCCCA,0,1179225
fldAp,0.5,1,1,GTTCGGATTGGCTGAGAACG,0,1079000
fldAp,0.5,1,1,GTTCCTGTGTAGAGGGTAAG,0,1114533
fldAp,0.5,1,1,GTTCCGGGAAACCTAGTCTG,0,1106868
fldAp,0.5,1,1,GTTCCATAGTTTACGGTTGA,0,1097703
fldAp,0.5,1,1,GTTCAGTATTTACCACAGAA,0,1180777
fldAp,0.5,1,1,GTTCACTGCGTCTTCTAACA,0,1079537
fldAp,0.5,1,1,GTTCACGTCAGGATAGGCTC,0,1125896
fldAp,0.5,1,1,GTTCACCGGTCGCTCAAGGA,0,1161066
fldAp,0.5,1,1,GTTATGCGGCTGCTATATAT,0,1118495
fldAp,0.5,1,1,GTTATGATCACGCCACAAAG,0,1122295
fldAp,0.5,1,1,GTTATCATTACCTATGATGG,0,1135351
fldAp,0.5,1,1,GTTATAGGGTGTCTGATGAC,0,1144544
fldAp,0.5,1,1,GTTAGTTGAGGGGTTGGATG,0,1082147
fldAp,0.5,1,1,GTTAGGGAAGTAAAAATAAG,0,1141233
fldAp,0.5,1,1,GTTAGATAAGGGTGCCTTGA,0,1118075
fldAp,0.5,1,1,GTTACTTCTGGGGACTTCCG,0,1088576
fldAp,0.5,1,1,GTTACTCCCCAGTCTGGTAA,0,1091394
fldAp,0.5,1,1,GTTACAGATGAACTCACGCA,0,1118380
fldAp,0.5,1,1,GTTACACAGTCCCTCATGGG,0,1147965
fldAp,0.5,1,1,GTTACAAACCATAGGGACCA,0,1091660
fldAp,0.5,1,1,GTTAAGGCCTTCAATGCCAA,0,1072658
fldAp,0.5,1,1,GTTAACCAAAAAGGTGGCAT,0,1179493
fldAp,0.5,1,1,GTTAAAGTCTGGCGCGACTG,0,1179407
fldAp,0.5,1,1,GTTAAACAGAATCACGTAAT,0,1178744
fldAp,0.5,1,1,GTTAAAAGGGCTGTATGTTA,0,1101178
fldAp,0.5,1,1,GTGTTTGCTAGTCTCACTGT,0,1171549
fldAp,0.5,1,1,GTGTTGGATACAACCGCATC,0,1063379
fldAp,0.5,1,1,GTGTTGCAAGTGATTTCAAA,0,1186107
fldAp,0.5,1,1,GTGTTCAAATATTACACGCA,0,1106204
fldAp,0.5,1,1,GTGTTAGCGTGGTGCCCTTT,0,1171345
fldAp,0.5,1,1,GTGTTACACGCGCCGGGTAA,0,1073427
fldAp,0.5,1,1,GTGTTAAAGACAAGCAAACG,0,1082984
fldAp,0.5,1,1,GTGTGTGACGCGTTGAGTGG,0,1128464
fldAp,0.5,1,1,GTGTCTTGCCCTAACGCAGA,0,1068563
fldAp,0.5,1,1,GTGTCTGCACATGTGTCTTA,0,1151773
fldAp,0.5,1,1,GTGTCTGAGCTTGTGGGGAA,0,1161945
fldAp,0.5,1,1,GTGTCACTGTCTGACGTCGT,0,1138068
fldAp,0.5,1,1,GTGTATGGATCTGGTTTATA,0,1162113
fldAp,0.5,1,1,GTGTATGGACTCTAACCGAC,0,1122262
fldAp,0.5,1,1,GTGTATGAGGCGCTTGCTAT,0,1066090
fldAp,0.5,1,1,GTGTATAATAGTAACTAAGT,0,1168163
fldAp,0.5,1,1,GTGTAGGTCCCCTTTGAAGT,0,1174237
fldAp,0.5,1,1,GTGGTTTGCTTGTAGGTTAT,0,1140790
fldAp,0.5,1,1,GTGGTTCATACGCAATCGAA,0,1183243
fldAp,0.5,1,1,GTGGTTATACGTGATGTTTC,0,1079524
fldAp,0.5,1,1,GTGGTGGACGAGATGACCAC,0,1147555
fldAp,0.5,1,1,GTGGTCGCGAGGACGAGATG,0,1068055
fldAp,0.5,1,1,GTGGTCAGCTAGGAAAGGTG,0,1092897
fldAp,0.5,1,1,GTGGTATCCCTGGTAACAAA,0,1083643
fldAp,0.5,1,1,GTGGTAGTTCTTGGGCGTAC,0,1112229
fldAp,0.5,1,1,GTGGTAGCGGTAGGATCGCA,0,1184656
fldAp,0.5,1,1,GTGGGGTCACAACGCTCCCA,0,1105197
fldAp,0.5,1,1,GTGGGCGTATTGAATGCGCA,0,1173755
fldAp,0.5,1,1,GTGGGCGTATAGAATCTAGC,0,1125884
fldAp,0.5,1,1,GTGGGCGTACGACGGGCGCA,0,1090805
fldAp,0.5,1,1,GTGGGCATCTGCGGGCTAGA,0,1171142
fldAp,0.5,1,1,GTGGGATCTAACGGCTTCGA,0,1155516
fldAp,0.5,1,1,GTGGGAAGGAGCACCTTCCT,0,1066619
fldAp,0.5,1,1,GTGGCTTTGCAAAGTGTGGT,0,1084155
fldAp,0.5,1,1,GTGGCTTCAGATGCCTCACG,0,1154429
fldAp,0.5,1,1,GTGGCGTACACCAGGACTGC,0,1153514
fldAp,0.5,1,1,GTGGCGCGGAGGTTCCTCAT,0,1083334
fldAp,0.5,1,1,GTGGCCTTTTAGGCAGGTCA,0,1102769
fldAp,0.5,1,1,GTGGCCCCGCCTTCAATCTC,0,1152081
fldAp,0.5,1,1,GTGGAGCTCATACGCAGCCT,0,1108918
fldAp,0.5,1,1,GTGGACGCATAATAGACACG,0,1140976
fldAp,0.5,1,1,GTGGAACATGTCAAAGCGGA,0,1155569
fldAp,0.5,1,1,GTGCTCTCCCTGACATCACG,0,1155717
fldAp,0.5,1,1,GTGCTCGTACGGACCAGATT,0,1097129
fldAp,0.5,1,1,GTGCTCGCCTATTAGAGCAG,0,1125516
fldAp,0.5,1,1,GTGCTCCTCCATTATTGAGG,0,1166243
fldAp,0.5,1,1,GTGCGTGTTGAGCTCTCAGT,0,1147534
fldAp,0.5,1,1,GTGCGAAGTCCCGTGCTCGG,0,1142645
fldAp,0.5,1,1,GTGCCGGGACTAAGCGTTAA,0,1095430
fldAp,0.5,1,1,GTGCCGCATTAATTGGAGAT,0,1098166
fldAp,0.5,1,1,GTGCCCCGCCGGGCAAAAGA,0,1111088
fldAp,0.5,1,1,GTGCCCCCGGGACGTATCGT,0,1101772
fldAp,0.5,1,1,GTGCCATGCAGGCTTGAGCT,0,1091880
fldAp,0.5,1,1,GTGCATTCCAAACATAGTCC,0,1155712
fldAp,0.5,1,1,GTGCATGGCAGATGTGATTT,0,1119297
fldAp,0.5,1,1,GTGCAGCGTTCAACACTGGC,0,1172941
fldAp,0.5,1,1,GTGCAAGAGAATAATCAAGT,0,1090809
fldAp,0.5,1,1,GTGATTACGCCTCGATTTTG,0,1092135
fldAp,0.5,1,1,GTGATCGTTGGATACCGGGG,0,1171000
fldAp,0.5,1,1,GTGATATGTTTTTGCCTGCA,0,1120490
fldAp,0.5,1,1,GTGATATACGAACGTGCAAT,0,1156821
fldAp,0.5,1,1,GTGAGGGCTGCTGCTCGTAA,0,1070023
fldAp,0.5,1,1,GTGAGGAGTGAGACTGTAAA,0,1099775
fldAp,0.5,1,1,GTGAGGAGTAATTGCATCTT,0,1082490
fldAp,0.5,1,1,GTGAGCCTTATTATGAGTTA,0,1091445
fldAp,0.5,1,1,GTGAGAGTCCTGTACCCCAC,0,1168154
fldAp,0.5,1,1,GTGAGACAATCGTAAGTGGG,0,1122559
fldAp,0.5,1,1,GTGACTCATAAGCGGTGACT,0,1063500
fldAp,0.5,1,1,GTGACGGCCAAGTACGTTGG,0,1107771
fldAp,0.5,1,1,GTGACAGATCCAGACGCCGC,0,1079119
fldAp,0.5,1,1,GTGAAGGAGCCCTTTGAAAA,0,1117377
fldAp,0.5,1,1,GTGAAGACATGAGTTGCGGT,0,1081221
fldAp,0.5,1,1,GTGAAATAAGGACGAGCCAG,0,1073324
fldAp,0.5,1,1,GTCTTGTTGGCACATCTGTA,0,1166465
fldAp,0.5,1,1,GTCTTGCGTCACATCAACAA,0,1084163
fldAp,0.5,1,1,GTCTTGAACCGTATAATAAC,0,1070621
fldAp,0.5,1,1,GTCTTAGGCAATTCTATAGT,0,1185897
fldAp,0.5,1,1,GTCTTAATACCGAATATAGG,0,1141982
fldAp,0.5,1,1,GTCTTAAAGGGATGTTCAAA,0,1157109
fldAp,0.5,1,1,GTCTGTATTACAGCCTAGTA,0,1088684
fldAp,0.5,1,1,GTCTGTATCCGGCTCTTAGT,0,1122530
fldAp,0.5,1,1,GTCTGGGCTAGTGCATCTGG,0,1109420
fldAp,0.5,1,1,GTCTGCGCACATGCCTTAGT,0,1081251
fldAp,0.5,1,1,GTCTGAGGCTGATAATAGAC,0,1165320
fldAp,0.5,1,1,GTCTGAGCACCTGGCTTAAC,0,1126195
fldAp,0.5,1,1,GTCTCTGCAAAGGCCGCGAT,0,1171474
fldAp,0.5,1,1,GTCTCGGGAGAATAGATAGG,0,1139615
fldAp,0.5,1,1,GTCTCGGATTTCTCCTGCAT,0,1102366
fldAp,0.5,1,1,GTCTCGACCAATCCAATACG,0,1118244
fldAp,0.5,1,1,GTCTCATACTCGACGCGGGA,0,1158135
fldAp,0.5,1,1,GTCTCAGAGCCCTTTGTGGA,0,1168912
fldAp,0.5,1,1,GTCTCACCTCTGTGCCGTGG,0,1182182
fldAp,0.5,1,1,GTCTATCTAGCCTTGGATTA,0,1093015
fldAp,0.5,1,1,GTCTAGGACAGAATGGTTCG,0,1152632
fldAp,0.5,1,1,GTCTAGAAGGCCAGGGCTGT,0,1149123
fldAp,0.5,1,1,GTCTAGAAGAATACTGGGTA,0,1103665
fldAp,0.5,1,1,GTCTACTTGACCGCCATCTC,0,1122870
fldAp,0.5,1,1,GTCTAAGCGCACCTTGATGC,0,1141853
fldAp,0.5,1,1,GTCTAACCTCCACAACTCCA,0,1145304
fldAp,0.5,1,1,GTCGTTAGGTCCGTGGGCGC,0,1155143
fldAp,0.5,1,1,GTCGTTAGGAAGCGAGTCTT,0,1147781
fldAp,0.5,1,1,GTCGTCTCTACTAGGCTACG,0,1093307
fldAp,0.5,1,1,GTCGTAGATATAGTAAAGAG,0,1085120
fldAp,0.5,1,1,GTCGGTCGCCTTGTCCGTAT,0,1116134
fldAp,0.5,1,1,GTCGGGTAGACGGCTGTTTT,0,1094393
fldAp,0.5,1,1,GTCGGGCTGACTCCATGTAC,0,1161824
fldAp,0.5,1,1,GTCGGCGATGTCTCACGACG,0,1127273
fldAp,0.5,1,1,GTCGCTGGTAGGACTACAAT,0,1072010
fldAp,0.5,1,1,GTCGCATTACGGCAGCCCTA,0,1132943
fldAp,0.5,1,1,GTCGAATCGACCCTGAGTTA,0,1097707
fldAp,0.5,1,1,GTCGAACGAACGATGTTGGA,0,1112752
fldAp,0.5,1,1,GTCCTTATTTCCAAGCGGTT,0,1161607
fldAp,0.5,1,1,GTCCTGTAGCACTCAGCACA,0,1147390
fldAp,0.5,1,1,GTCCTATGCTCCGGGCGGAT,0,1151899
fldAp,0.5,1,1,GTCCGTCTTGACACAGCAGT,0,1156496
fldAp,0.5,1,1,GTCCGTCTGACAAGGGGCAA,0,1152592
fldAp,0.5,1,1,GTCCGCGCCGAAGCTAGGAG,0,1080299
fldAp,0.5,1,1,GTCCGCACAAGGGGGGGCAT,0,1090608
fldAp,0.5,1,1,GTCCCAGTCACGTTCTCCTC,0,1109126
fldAp,0.5,1,1,GTCCATCACAACACTTTTTC,0,1122117
fldAp,0.5,1,1,GTCCAGTCTGGAGTCGTTGT,0,1082699
fldAp,0.5,1,1,GTCCACAAAATGAGAACAAT,0,1133460
fldAp,0.5,1,1,GTCCAAATAGTAGAATCGCC,0,1077756
fldAp,0.5,1,1,GTCATGTCAACCGAAGCGAA,0,1145644
fldAp,0.5,1,1,GTCATGGTGAGCACCTCAGT,0,1136019
fldAp,0.5,1,1,GTCATCTAAGAATTTACTTA,0,1119120
fldAp,0.5,1,1,GTCAGTACTAATCCAGAGTT,0,1106823
fldAp,0.5,1,1,GTCAGGTGCGTCGTATGTAT,0,1102246
fldAp,0.5,1,1,GTCAGCGAAGTGCGCGACAT,0,1141827
fldAp,0.5,1,1,GTCAGCCTGATGTTACCCTA,0,1169472
fldAp,0.5,1,1,GTCAGCAGCGCACTGAGATA,0,1100183
fldAp,0.5,1,1,GTCACGAGTAGGGTGCTGTC,0,1063595
fldAp,0.5,1,1,GTCACCTATGTAGGTATTAC,0,1186881
fldAp,0.5,1,1,GTCACACGCACCATACCCTA,0,1181818
fldAp,0.5,1,1,GTCACACGATACTCCACGCC,0,1182379
fldAp,0.5,1,1,GTCACAAGAGGCCACCGAAC,0,1110643
fldAp,0.5,1,1,GTCAATCGGCACAAAGGAGG,0,1153758
fldAp,0.5,1,1,GTCAAATGGAGGGGAACTTT,0,1071234
fldAp,0.5,1,1,GTCAAATATTAGAGCTCCCT,0,1128827
fldAp,0.5,1,1,GTCAAAATCTTGGGGGGGTA,0,1100776
fldAp,0.5,1,1,GTATTTACGCATATCCTGCG,0,1170652
fldAp,0.5,1,1,GTATTGCGTCCCGACGAGCG,0,1177131
fldAp,0.5,1,1,GTATTCTTGAGAACGATCAA,0,1095949
fldAp,0.5,1,1,GTATTCGTTTGCATGATGGG,0,1122788
fldAp,0.5,1,1,GTATTCGCTTTCGCGAACTC,0,1147612
fldAp,0.5,1,1,GTATGGTCGAACCTACAGCT,0,1100951
fldAp,0.5,1,1,GTATGGAATTCCGTCGAGTT,0,1166255
fldAp,0.5,1,1,GTATGCTAGTCGCAGGTTAA,0,1078477
fldAp,0.5,1,1,GTATGCTACAGTAGTTGGAT,0,1076588
fldAp,0.5,1,1,GTATGCCCGTGGCCGGATCC,0,1152851
fldAp,0.5,1,1,GTATGACCCAAATCAGCGAC,0,1145372
fldAp,0.5,1,1,GTATCTTTTACCCCCGCACC,0,1151439
fldAp,0.5,1,1,GTATCGGCAGGGAGCGTTTG,0,1103988
fldAp,0.5,1,1,GTATCCCGCCATTGGCGTGT,0,1139172
fldAp,0.5,1,1,GTATCATGGCTAAACATGGT,0,1127843
fldAp,0.5,1,1,GTATCACTTATTAGAGGTTC,0,1112115
fldAp,0.5,1,1,GTATCACACGGCATGGAACG,0,1082479
fldAp,0.5,1,1,GTATAGGTGGGAAATGCCTG,0,1138820
fldAp,0.5,1,1,GTATACTGGGGGCGATGGGT,0,1091274
fldAp,0.5,1,1,GTATACACAAATCACCTTAC,0,1183883
fldAp,0.5,1,1,GTATAAGTCTACGGGCGATG,0,1085164
fldAp,0.5,1,1,GTATAACCCCTTAAGCAACA,0,1080704
fldAp,0.5,1,1,GTAGTTGATATGATGGCGAC,0,1106962
fldAp,0.5,1,1,GTAGTAGCTCGGGACACGGG,0,1147192
fldAp,0.5,1,1,GTAGTAAAGCATACACGTAT,0,1134150
fldAp,0.5,1,1,GTAGGTTTCTCTTGAGCGGC,0,1155786
fldAp,0.5,1,1,GTAGGGGCCATGCGAGTTAT,0,1100753
fldAp,0.5,1,1,GTAGGGCACAAGGGCTGCAG,0,1077860
fldAp,0.5,1,1,GTAGGACGCAGGCTCGGCCA,0,1181010
fldAp,0.5,1,1,GTAGGAAGAATCTAAAACGG,0,1177726
fldAp,0.5,1,1,GTAGCTTCCGGGAGACATCT,0,1186452
fldAp,0.5,1,1,GTAGCTCAGAAACGACTGGT,0,1168860
fldAp,0.5,1,1,GTAGCCACTCTTAGTCCTGA,0,1119588
fldAp,0.5,1,1,GTAGATCTGGCACCAAGACC,0,1096964
fldAp,0.5,1,1,GTAGAGCGGCGCTCCAACGA,0,1079543
fldAp,0.5,1,1,GTAGAGCGGAACGTTTTAGC,0,1162377
fldAp,0.5,1,1,GTAGACTGACGCGGTAGCTT,0,1102909
fldAp,0.5,1,1,GTACTTATGCAAATACGCCG,0,1119288
fldAp,0.5,1,1,GTACTCGAACACGATTTTTG,0,1144032
fldAp,0.5,1,1,GTACGTTTGTTAATGGCTAT,0,1123053
fldAp,0.5,1,1,GTACGTTGGTAAAGTTCGCG,0,1158260
fldAp,0.5,1,1,GTACGTTGCTTTCAGGTAAT,0,1070968
fldAp,0.5,1,1,GTACGGCAATGGAGGCCAGC,0,1075597
fldAp,0.5,1,1,GTACGCGATAGTCGTGACCA,0,1084805
fldAp,0.5,1,1,GTACGATTCGTACAGCTTCC,0,1174837
fldAp,0.5,1,1,GTACGACCCGTGATTGGATC,0,1172814
fldAp,0.5,1,1,GTACCTGTTTATAAACGGGT,0,1064624
fldAp,0.5,1,1,GTACCTCGCTCGACAGGTCT,0,1132068
fldAp,0.5,1,1,GTACCTACTTATACTCGTCT,0,1114503
fldAp,0.5,1,1,GTACCGCAGCCAGGGGCTGG,0,1142411
fldAp,0.5,1,1,GTACCATTAGAGCAGTTGTT,0,1095659
fldAp,0.5,1,1,GTACATTCTCCCTACCCTCA,0,1092986
fldAp,0.5,1,1,GTACAGGGTTTATCGTTGTA,0,1094606
fldAp,0.5,1,1,GTACAGGCCGAACATCAGAG,0,1071898
fldAp,0.5,1,1,GTACAGGCCAAATGCCTCCC,0,1177905
fldAp,0.5,1,1,GTACACTGACCCCTTGGGTC,0,1078261
fldAp,0.5,1,1,GTACACGGTGAATATCAACC,0,1064680
fldAp,0.5,1,1,GTACACCTAAATGGTGCCAA,0,1073687
fldAp,0.5,1,1,GTACACCGGCGGAATTCTTC,0,1145142
fldAp,0.5,1,1,GTACACCGATGCTGTGGTAT,0,1117237
fldAp,0.5,1,1,GTACACACCTTCCGCAGAAT,0,1109406
fldAp,0.5,1,1,GTAATTTGGCGCGGTGTTTG,0,1071922
fldAp,0.5,1,1,GTAATGTACGATCCTAGGTA,0,1069699
fldAp,0.5,1,1,GTAATCTATGCGGGGCGTGG,0,1157856
fldAp,0.5,1,1,GTAATACCACCCTCGGCAGA,0,1102993
fldAp,0.5,1,1,GTAAGGTGGACTGGCTCCCC,0,1069631
fldAp,0.5,1,1,GTAAGGGGGTAGGTAAACTA,0,1160083
fldAp,0.5,1,1,GTAAGGCAGTTGTACATCAC,0,1089939
fldAp,0.5,1,1,GTAAGAACCAACGGTATGGT,0,1186858
fldAp,0.5,1,1,GTAACCCATATTGCTTGTCA,0,1069122
fldAp,0.5,1,1,GTAAATTTTCCAGACCGTGA,0,1178678
fldAp,0.5,1,1,GTAAATCGATTCCGGCATTT,0,1093921
fldAp,0.5,1,1,GTAAAGACAGGATCCCCCCC,0,1092867
fldAp,0.5,1,1,GTAAAAAACGTCTCTCCTAT,0,1129344
fldAp,0.5,1,1,GGTTTTGAGGGAATTATCTT,0,1095471
fldAp,0.5,1,1,GGTTTTCAGGGGGGCAAATC,0,1086272
fldAp,0.5,1,1,GGTTTGTCGATGCCAGACGC,0,1084620
fldAp,0.5,1,1,GGTTGTCATAGTCTAACCCC,0,1066599
fldAp,0.5,1,1,GGTTGGGATAATTGGCGCTC,0,1081084
fldAp,0.5,1,1,GGTTGCTACGATTCAAGCTG,0,1131338
fldAp,0.5,1,1,GGTTGCGGGCCTAAACGGGG,0,1145461
fldAp,0.5,1,1,GGTTGAAGCGAAATTGTGTG,0,1168943
fldAp,0.5,1,1,GGTTCAAGAGGACAGTTCTC,0,1144293
fldAp,0.5,1,1,GGTTATTTTCGGTAAGGGAG,0,1117891
fldAp,0.5,1,1,GGTTATGTACTCTGAAGGGC,0,1106202
fldAp,0.5,1,1,GGTTATCATTGAGAGGTGAC,0,1138331
fldAp,0.5,1,1,GGTTATACCTGTCCCGCGCT,0,1085287
fldAp,0.5,1,1,GGTTAGCCGATGACAACTCT,0,1180478
fldAp,0.5,1,1,GGTTACGAACGTGTACGCCC,0,1090047
fldAp,0.5,1,1,GGTTACACTCGTCCTTTGTC,0,1148920
fldAp,0.5,1,1,GGTTAAGTAATCATTCTTGA,0,1154677
fldAp,0.5,1,1,GGTGTGCGGGTTGGGAACAG,0,1093796
fldAp,0.5,1,1,GGTGTCTACGCAACTTCTGA,0,1149959
fldAp,0.5,1,1,GGTGTAGGATAATTTGCTGT,0,1079448
fldAp,0.5,1,1,GGTGGTTAGCCAGCTTTGAG,0,1165565
fldAp,0.5,1,1,GGTGGTGTTCTCGTCACTTT,0,1063390
fldAp,0.5,1,1,GGTGGTGTGACCCGGAGACT,0,1126270
fldAp,0.5,1,1,GGTGGTATCTAGACGCAGGA,0,1135509
fldAp,0.5,1,1,GGTGGGTAGAGGTGATTACA,0,1151882
fldAp,0.5,1,1,GGTGGGCTAATGGGATCTAG,0,1122702
fldAp,0.5,1,1,GGTGGCGAGTGTTTGTCCCT,0,1089125
fldAp,0.5,1,1,GGTGGCCGGCTGCAGTCTCT,0,1097244
fldAp,0.5,1,1,GGTGGAATGATGCATGTTGT,0,1157089
fldAp,0.5,1,1,GGTGCGTGGGTACAGTTCGG,0,1106800
fldAp,0.5,1,1,GGTGCGCTGTGCTGGCCGGA,0,1113892
fldAp,0.5,1,1,GGTGCCTGAGTGTTCATGGT,0,1117921
fldAp,0.5,1,1,GGTGCCCGATCAGGTTTAGC,0,1132320
fldAp,0.5,1,1,GGTGCATTCCAGAGTAACGG,0,1156417
fldAp,0.5,1,1,GGTGCATTCAGCTGACCGTT,0,1086967
fldAp,0.5,1,1,GGTGCAGCAGTTTCGGAGCC,0,1183811
fldAp,0.5,1,1,GGTGCACTTGTTGCGAAGGC,0,1182597
fldAp,0.5,1,1,GGTGCACAGTCAATAATCAA,0,1073643
fldAp,0.5,1,1,GGTGCAAGGGGGGTCCATCA,0,1119992
fldAp,0.5,1,1,GGTGATTTGACGGGGGGAGC,0,1180482
fldAp,0.5,1,1,GGTGATCTTTCTCGGGCAAC,0,1169976
fldAp,0.5,1,1,GGTGACCGTCTGAAGCGTAA,0,1081995
fldAp,0.5,1,1,GGTGACCCCAGCTCCCTGGA,0,1176892
fldAp,0.5,1,1,GGTGAAAGCACTTCAGGCAA,0,1071758
fldAp,0.5,1,1,GGTCTGCTTGATAATGACAA,0,1092989
fldAp,0.5,1,1,GGTCTCGTATGGTAAAACCC,0,1104188
fldAp,0.5,1,1,GGTCTACTCCACTTGGGTAA,0,1112133
fldAp,0.5,1,1,GGTCGGTTTTCGCGAAGCTC,0,1135120
fldAp,0.5,1,1,GGTCGGTATCCACACGAAAG,0,1162218
fldAp,0.5,1,1,GGTCGCTTCGATAGTCACTG,0,1173585
fldAp,0.5,1,1,GGTCGCACCTTCCTTCCGCA,0,1109118
fldAp,0.5,1,1,GGTCGATCAAAGTGTTCGCG,0,1139503
fldAp,0.5,1,1,GGTCCTTCGCACGCGCAACA,0,1121010
fldAp,0.5,1,1,GGTCCTCAGCCATGTACCTA,0,1082428
fldAp,0.5,1,1,GGTCCCGGCAAAAGTTGTCG,0,1104799
fldAp,0.5,1,1,GGTCCCCAAGTTTTCCAACT,0,1163129
fldAp,0.5,1,1,GGTCATTTAGACTAACTTCG,0,1073362
fldAp,0.5,1,1,GGTCAGTCCAACGGCGACGT,0,1120794
fldAp,0.5,1,1,GGTCACATTAAGTCATTACG,0,1186408
fldAp,0.5,1,1,GGTCAATCGGATCAGATTCT,0,1104780
fldAp,0.5,1,1,GGTCAACCACGTCAATCTGT,0,1186861
fldAp,0.5,1,1,GGTATTCGTCTGTATGGTGG,0,1181045
fldAp,0.5,1,1,GGTATGCCAATCCCTAAATT,0,1125113
fldAp,0.5,1,1,GGTATGACAAACGAGGTAAC,0,1139099
fldAp,0.5,1,1,GGTATCGTATGTTTGGGCAA,0,1150958
fldAp,0.5,1,1,GGTATCAGTGTTTTGAACGT,0,1104401
fldAp,0.5,1,1,GGTAGTCAGTGTGTGGATTG,0,1084625
fldAp,0.5,1,1,GGTAGGGTTGCACCAACGTT,0,1091642
fldAp,0.5,1,1,GGTAGATAGATAAAACGCCC,0,1149672
fldAp,0.5,1,1,GGTACTTGCATCCAATAGTC,0,1156551
fldAp,0.5,1,1,GGTACCCTATTTCCTTCTCT,0,1133727
fldAp,0.5,1,1,GGTAATGAAGTAGCCCGGTC,0,1183012
fldAp,0.5,1,1,GGTAAGTTAGAGCGATAGAA,0,1154367
fldAp,0.5,1,1,GGTAAACGGATTGTCTTACA,0,1107488
fldAp,0.5,1,1,GGTAAACGCTTGAGAGCCCG,0,1083043
fldAp,0.5,1,1,GGGTTTGAGTAGATTGGGAG,0,1142273
fldAp,0.5,1,1,GGGTTGTGCGGCCTCGAGCA,0,1170638
fldAp,0.5,1,1,GGGTTGGCGCAGAATCTACA,0,1136003
fldAp,0.5,1,1,GGGTTGCACGGTCGGAGATC,0,1075899
fldAp,0.5,1,1,GGGTTGATACCAATACCGGT,0,1176847
fldAp,0.5,1,1,GGGTTCCGTGCAACCTCCGA,0,1090114
fldAp,0.5,1,1,GGGTTCCGCCATCCAAACTC,0,1156596
fldAp,0.5,1,1,GGGTTCCCTCACGAAATACA,0,1066597
fldAp,0.5,1,1,GGGTTCATCTTTAATGTTAT,0,1133817
fldAp,0.5,1,1,GGGTTATGTATGCTTTAGGC,0,1104247
fldAp,0.5,1,1,GGGTTATCACTTGACCACGC,0,1157820
fldAp,0.5,1,1,GGGTTAATCATTCTGCACAA,0,1138372
fldAp,0.5,1,1,GGGTGTGGTCAAGACACGGG,0,1066549
fldAp,0.5,1,1,GGGTGGCAGCCAATCCGCAG,0,1156026
fldAp,0.5,1,1,GGGTGATTAGTTATTGCAAG,0,1182737
fldAp,0.5,1,1,GGGTCTTTATATGAAATAGC,0,1163999
fldAp,0.5,1,1,GGGTCGGAGAAGCCTGTGAA,0,1166159
fldAp,0.5,1,1,GGGTCCGGCACCAGAATAGT,0,1090212
fldAp,0.5,1,1,GGGTCATTCAGTTTGATGCG,0,1084729
fldAp,0.5,1,1,GGGTCACAAGTCTTATGCAA,0,1149813
fldAp,0.5,1,1,GGGTATTTCGCACAGGATAT,0,1180428
fldAp,0.5,1,1,GGGTATTGTCTCATTGTTTA,0,1150346
fldAp,0.5,1,1,GGGTATGGATGCGGCGCGGA,0,1147964
fldAp,0.5,1,1,GGGTAGTGGTTAATTGCGCT,0,1126103
fldAp,0.5,1,1,GGGTACCTTAAGTGCAGTCT,0,1162889
fldAp,0.5,1,1,GGGTACCTTAAGCGTAACGG,0,1090698
fldAp,0.5,1,1,GGGTAATCCGGGGCTTTTGG,0,1184312
fldAp,0.5,1,1,GGGTAAGGCATCCAGGGCGA,0,1115278
fldAp,0.5,1,1,GGGTAAAGCTCACTACCGAA,0,1064052
fldAp,0.5,1,1,GGGGTTTTTGGGAGTACAGT,0,1115669
fldAp,0.5,1,1,GGGGTTGCTATAAGCTACAT,0,1176257
fldAp,0.5,1,1,GGGGTCCTTAATATTTGTAA,0,1136311
fldAp,0.5,1,1,GGGGTCCGTATTGTATGCCG,0,1063682
fldAp,0.5,1,1,GGGGTATACCATTTACAATG,0,1095548
fldAp,0.5,1,1,GGGGGTTAAACGGTGTCCTT,0,1123733
fldAp,0.5,1,1,GGGGGGGTCTTTAGACAGAC,0,1167217
fldAp,0.5,1,1,GGGGGCTACGCGGTTGCCTA,0,1159967
fldAp,0.5,1,1,GGGGGACAAGACAACATCAC,0,1128191
fldAp,0.5,1,1,GGGGCTTAAACATAACGAAA,0,1072903
fldAp,0.5,1,1,GGGGCGCCAGCTCGAACTCA,0,1122069
fldAp,0.5,1,1,GGGGCACCCGCTCGACTCCA,0,1074666
fldAp,0.5,1,1,GGGGCAACTACGGAGTAAGT,0,1114499
fldAp,0.5,1,1,GGGGCAACTAAAGACGTGGT,0,1116261
fldAp,0.5,1,1,GGGGCAAACACTGGTTAGTA,0,1110771
fldAp,0.5,1,1,GGGGAGTTAAATAAGCTGCC,0,1078377
fldAp,0.5,1,1,GGGGAGACTAAAAGAGAGCC,0,1100675
fldAp,0.5,1,1,GGGGACCAGGGGGAAGGCTG,0,1143531
fldAp,0.5,1,1,GGGCTTGCGCCCCCTGGATC,0,1079305
fldAp,0.5,1,1,GGGCTGGACCGCATTCGTCT,0,1137911
fldAp,0.5,1,1,GGGCTCTGGCTCAGGCCATT,0,1152098
fldAp,0.5,1,1,GGGCTATGTCCACATCGACC,0,1116408
fldAp,0.5,1,1,GGGCTATCTTCTCGTGCAGG,0,1139253
fldAp,0.5,1,1,GGGCTAACTCCGTGGGCCCA,0,1151890
fldAp,0.5,1,1,GGGCGGGTCTGTGGCTACGC,0,1142026
fldAp,0.5,1,1,GGGCGAGAAATGCATTTCTG,0,1111777
fldAp,0.5,1,1,GGGCGACCGGACTCGAGTCT,0,1068071
fldAp,0.5,1,1,GGGCCTTTTCTTCTGAAGCA,0,1080588
fldAp,0.5,1,1,GGGCCATTAGTTCGCTTTCA,0,1095725
fldAp,0.5,1,1,GGGCCAGGTAACTCGGCCTA,0,1157862
fldAp,0.5,1,1,GGGCATCGAGAGAATTCCGC,0,1161621
fldAp,0.5,1,1,GGGCATAGATTTGCGTCCAG,0,1127792
fldAp,0.5,1,1,GGGCAGGGGGACGAGCGCGT,0,1128840
fldAp,0.5,1,1,GGGCAGCTGGACCTGCTAAA,0,1173081
fldAp,0.5,1,1,GGGCAGCCAACATCAGGATG,0,1138769
fldAp,0.5,1,1,GGGCAACGCCAAGACGGGAG,0,1159364
fldAp,0.5,1,1,GGGATTAGACCCACACAAAT,0,1090710
fldAp,0.5,1,1,GGGATTACAATTAATGGCAG,0,1161180
fldAp,0.5,1,1,GGGATGTCTAATCCCGGAAA,0,1134312
fldAp,0.5,1,1,GGGATCTGATACGAGAAGCT,0,1088544
fldAp,0.5,1,1,GGGAGTGTAGGCGTGAAAAT,0,1153138
fldAp,0.5,1,1,GGGAGTCCGCCGACTGGAGA,0,1148175
fldAp,0.5,1,1,GGGAGGTGATTATGTACTGA,0,1104186
fldAp,0.5,1,1,GGGAGGGGTCGGTTCGTCAT,0,1171540
fldAp,0.5,1,1,GGGAGGCTTCTTACCGACAT,0,1146823
fldAp,0.5,1,1,GGGACTCTCCCCTAACGCTC,0,1069377
fldAp,0.5,1,1,GGGACGTGATGATAAGCGTG,0,1090265
fldAp,0.5,1,1,GGGACGCAAAAGACCTCTCA,0,1080709
fldAp,0.5,1,1,GGGACCATTGGCTACATGCA,0,1091848
fldAp,0.5,1,1,GGGACAGAGCATTTCGTTAC,0,1133981
fldAp,0.5,1,1,GGGAATGCACCTTCCCTCAC,0,1120617
fldAp,0.5,1,1,GGGAAGCGCCACAAGACTGT,0,1133432
fldAp,0.5,1,1,GGGAAAACACAACATACGTT,0,1154999
fldAp,0.5,1,1,GGCTTTGAGGCCGAAAACAG,0,1168695
fldAp,0.5,1,1,GGCTTGCGACACACTGTTTA,0,1154695
fldAp,0.5,1,1,GGCTTCGGATACGAGGAGGC,0,1120038
fldAp,0.5,1,1,GGCTTAGGTTGCATGGATTC,0,1168001
fldAp,0.5,1,1,GGCTTACTACCTGTTAGTGG,0,1165119
fldAp,0.5,1,1,GGCTTACATGTTGAAATCAA,0,1147567
fldAp,0.5,1,1,GGCTGTTTGTTGGGGTAGGA,0,1182639
fldAp,0.5,1,1,GGCTGTTCAAAGCAATCGAC,0,1114127
fldAp,0.5,1,1,GGCTGTACCAGGGCAAACGG,0,1115198
fldAp,0.5,1,1,GGCTGGAATCTAATACAAGC,0,1079821
fldAp,0.5,1,1,GGCTGCCCTTCACTTCCTGA,0,1134520
fldAp,0.5,1,1,GGCTGAGTGGCTTTTGATTA,0,1186855
fldAp,0.5,1,1,GGCTCTTGGGTAGCAAGGTG,0,1159021
fldAp,0.5,1,1,GGCTCCTTTGACCTGAACTC,0,1145021
fldAp,0.5,1,1,GGCTCCCTAGTATGTGGGTA,0,1141599
fldAp,0.5,1,1,GGCTCAAGCATATAACTAAA,0,1145466
fldAp,0.5,1,1,GGCTCAACATACGTATATCG,0,1089392
fldAp,0.5,1,1,GGCTACTGTGAGCGGTGCAA,0,1177983
fldAp,0.5,1,1,GGCTACTACGGCCGCCACGT,0,1081419
fldAp,0.5,1,1,GGCTAATACTGGGTGCGAAC,0,1178988
fldAp,0.5,1,1,GGCGTGTATATCCGTAGTTT,0,1104768
fldAp,0.5,1,1,GGCGTCTTTACCCGCCGCTA,0,1063606
fldAp,0.5,1,1,GGCGGGTCCTTTTTAGCGCG,0,1099365
fldAp,0.5,1,1,GGCGGGCTAGAGGTAGGAGG,0,1150678
fldAp,0.5,1,1,GGCGGGATTAGTTGTCGCAA,0,1177309
fldAp,0.5,1,1,GGCGGGAAGGAATTCAGTTC,0,1160425
fldAp,0.5,1,1,GGCGCGCTATCTTCAGGGAA,0,1077987
fldAp,0.5,1,1,GGCGCCGATATGTACGACAT,0,1163300
fldAp,0.5,1,1,GGCGCCCATATGGAATATCC,0,1111487
fldAp,0.5,1,1,GGCGCAGCAGCCTTACGGTG,0,1098898
fldAp,0.5,1,1,GGCGAGTCATTGTAGAGGCA,0,1162729
fldAp,0.5,1,1,GGCGACCCAGTTTCTATAGC,0,1097569
fldAp,0.5,1,1,GGCGAAGGTTTGGATGATTC,0,1143787
fldAp,0.5,1,1,GGCCTTGGGCTTATCGGCGC,0,1138004
fldAp,0.5,1,1,GGCCTTCCTTGGCTGTCATT,0,1156665
fldAp,0.5,1,1,GGCCTGGATAACCCGGTTCA,0,1184205
fldAp,0.5,1,1,GGCCTCCGGAAAAGTGGCGT,0,1103107
fldAp,0.5,1,1,GGCCTCATCCTTGCAGTCGT,0,1112355
fldAp,0.5,1,1,GGCCGTCCCTATAGCCTGTC,0,1185482
fldAp,0.5,1,1,GGCCGTACGGACAACGAAGA,0,1094969
fldAp,0.5,1,1,GGCCGTAATAGCGACAAATT,0,1184374
fldAp,0.5,1,1,GGCCGGTCATCAGGTTCGGA,0,1178977
fldAp,0.5,1,1,GGCCGCTTGTGGATCTGATC,0,1168175
fldAp,0.5,1,1,GGCCGCTGTTACAACAGAGG,0,1116623
fldAp,0.5,1,1,GGCCCTAAAGCGGTCGTCTG,0,1166553
fldAp,0.5,1,1,GGCCCGTTCGCCGGTCCTGA,0,1142484
fldAp,0.5,1,1,GGCCCGGTGGAATAGTGAGG,0,1126159
fldAp,0.5,1,1,GGCCCCTCAGCAAGACTACT,0,1137418
fldAp,0.5,1,1,GGCCCCGACAAGAATGGACA,0,1107405
fldAp,0.5,1,1,GGCCCATACAGACGGGAAGG,0,1112819
fldAp,0.5,1,1,GGCCCACGTTCTAAAACGTC,0,1085887
fldAp,0.5,1,1,GGCCCAACGCCCGTGACTTT,0,1105820
fldAp,0.5,1,1,GGCCACGTCTCCTTGCCTGG,0,1158998
fldAp,0.5,1,1,GGCCACCCTGTGTACTTCGG,0,1070738
fldAp,0.5,1,1,GGCATTAGACGGCCAGGGAA,0,1085622
fldAp,0.5,1,1,GGCATGTGGCCAACCTGGTG,0,1063368
fldAp,0.5,1,1,GGCATGGCTGATTGGGCACC,0,1163095
fldAp,0.5,1,1,GGCATCTTCGCCGGAACGAG,0,1133041
fldAp,0.5,1,1,GGCAGCTTCCACCCGTCGAT,0,1158535
fldAp,0.5,1,1,GGCAGCTACTACTACTATTA,0,1169158
fldAp,0.5,1,1,GGCAGCCCGGCACAAATATC,0,1182304
fldAp,0.5,1,1,GGCACGTCGCAATGATTGAT,0,1183335
fldAp,0.5,1,1,GGCACAGTGTTCCTTCAGCT,0,1087006
fldAp,0.5,1,1,GGCAATTACAGTTTTCGCAG,0,1117119
fldAp,0.5,1,1,GGCAAGCGGCTTACAAACAC,0,1136348
fldAp,0.5,1,1,GGCAAGCGCCATTAGCTTGT,0,1101429
fldAp,0.5,1,1,GGCAACCGATGCCCGGTATA,0,1079701
fldAp,0.5,1,1,GGCAAACCTCCCACTTGACT,0,1129130
fldAp,0.5,1,1,GGATTTGGCGCACAGACGAT,0,1117164
fldAp,0.5,1,1,GGATTGTTGTTCCAGAGCCT,0,1063962
fldAp,0.5,1,1,GGATTGCCATGACCACCTGT,0,1139966
fldAp,0.5,1,1,GGATTGCATTTGGCTTCCTA,0,1169875
fldAp,0.5,1,1,GGATTCGGGTCCCTCACTTA,0,1065730
fldAp,0.5,1,1,GGATGGTAGAACACTGCGGC,0,1080281
fldAp,0.5,1,1,GGATGCTGAGACTCTCAAAC,0,1113893
fldAp,0.5,1,1,GGATGCAGATTCAGAGCATC,0,1097316
fldAp,0.5,1,1,GGATGATAGAGCTTCGAAAT,0,1141174
fldAp,0.5,1,1,GGATCTGGAGTTAGGACTAG,0,1071618
fldAp,0.5,1,1,GGATCTCAGGTACGAGGTCC,0,1090060
fldAp,0.5,1,1,GGATCTATGTGGGAGCCATC,0,1068141
fldAp,0.5,1,1,GGATCGCGCTGCACACTAGA,0,1152380
fldAp,0.5,1,1,GGATCGATCAGTTACCTCTT,0,1170343
fldAp,0.5,1,1,GGATATGTCTATTAGGGACT,0,1155239
fldAp,0.5,1,1,GGATAACTTTTATGACCCGT,0,1078930
fldAp,0.5,1,1,GGAGTGGGCATGGCCCGCTT,0,1083819
fldAp,0.5,1,1,GGAGTGCGCTCAGAGAGAGC,0,1080501
fldAp,0.5,1,1,GGAGTCGCAGGAGGATGCGT,0,1103741
fldAp,0.5,1,1,GGAGTCAGTCTAAGCCGGCA,0,1085848
fldAp,0.5,1,1,GGAGGGAGGGAAGTATATGG,0,1082672
fldAp,0.5,1,1,GGAGGCTTGAGAGCGCTGGG,0,1103392
fldAp,0.5,1,1,GGAGGAAGAAGCATATCAGA,0,1102433
fldAp,0.5,1,1,GGAGCTGTCTGTTCGTTATT,0,1175395
fldAp,0.5,1,1,GGAGCACATAAGTCACGACT,0,1140787
fldAp,0.5,1,1,GGAGCAATTCGCAACCCTAA,0,1182436
fldAp,0.5,1,1,GGAGACGCAAATCCTGTGGG,0,1123986
fldAp,0.5,1,1,GGAGAATTGGCACGTCCAGC,0,1154512
fldAp,0.5,1,1,GGAGAATGACCAGGTAGCTT,0,1159814
fldAp,0.5,1,1,GGAGAATACCTGCGGAAGAG,0,1110801
fldAp,0.5,1,1,GGAGAAACACGCGACCAGAA,0,1146744
fldAp,0.5,1,1,GGACTTGTCTTATCTTCAGC,0,1130690
fldAp,0.5,1,1,GGACTTGGCGCTCTCGGACA,0,1088656
fldAp,0.5,1,1,GGACTTACCGGAGATTTGGT,0,1156793
fldAp,0.5,1,1,GGACTCCACTTTCGGGTAAT,0,1076670
fldAp,0.5,1,1,GGACTCAGACGAAGAACGGT,0,1124342
fldAp,0.5,1,1,GGACTAAAAATACAGAAGCA,0,1171566
fldAp,0.5,1,1,GGACGTCCAGGTCTAGCTCA,0,1148356
fldAp,0.5,1,1,GGACGTACATTTCCGGCCCG,0,1171824
fldAp,0.5,1,1,GGACGCTTCCAACTTCGAAA,0,1085236
fldAp,0.5,1,1,GGACGCCTAGGGTTGCATAC,0,1183400
fldAp,0.5,1,1,GGACGAGCGCCTATCTCCAT,0,1071466
fldAp,0.5,1,1,GGACCCGGATATACCATACC,0,1102264
fldAp,0.5,1,1,GGACCCATCCCGCTTAAAAT,0,1097073
fldAp,0.5,1,1,GGACCAGTTTGTGTGATAAC,0,1145295
fldAp,0.5,1,1,GGACCAGCATTTCCCTTGAC,0,1077721
fldAp,0.5,1,1,GGACCAAAGGCCTCAGTGCC,0,1179167
fldAp,0.5,1,1,GGACATCGTCACCGGTTCCT,0,1080858
fldAp,0.5,1,1,GGACATCATACGAGAAAGAG,0,1176123
fldAp,0.5,1,1,GGACATAATCTCACTCCTCT,0,1178175
fldAp,0.5,1,1,GGACAGTTGATGGCTCCCAA,0,1121144
fldAp,0.5,1,1,GGACAGTTCTGTTTACGGAT,0,1160589
fldAp,0.5,1,1,GGACAGCGTGAGTCATTGTT,0,1121425
fldAp,0.5,1,1,GGACACGGGAGTTGGCGATC,0,1172970
fldAp,0.5,1,1,GGACACACCGAGACTAGCTC,0,1123159
fldAp,0.5,1,1,GGAATTGAACACAACTAAGG,0,1102507
fldAp,0.5,1,1,GGAATGTTTAGGGGTATGTC,0,1095704
fldAp,0.5,1,1,GGAATGTGTCTGGTAGGTTA,0,1109722
fldAp,0.5,1,1,GGAATGGTGGTTTTGTCGAA,0,1151108
fldAp,0.5,1,1,GGAATCGGTTATCCGAGTTA,0,1150837
fldAp,0.5,1,1,GGAATCCTTATTTTCCTCAC,0,1098225
fldAp,0.5,1,1,GGAATAATCTGTGTTCTATT,0,1098060
fldAp,0.5,1,1,GGAAGATTGCGGCGCTTAAT,0,1087939
fldAp,0.5,1,1,GGAAGATACAACAAGCTTAA,0,1174738
fldAp,0.5,1,1,GGAACTGGAGTGATCAGTGA,0,1074767
fldAp,0.5,1,1,GGAACTCGGGTGTTGGGACA,0,1156207
fldAp,0.5,1,1,GGAACGGGGCTAAAACACGC,0,1149588
fldAp,0.5,1,1,GGAACGATACAGTGTTTTAT,0,1158065
fldAp,0.5,1,1,GGAACCTGGTTTGATGGATT,0,1181824
fldAp,0.5,1,1,GGAACCAGGCCTGCGATCAG,0,1081133
fldAp,0.5,1,1,GGAACATCGTCCAATCGTCT,0,1119205
fldAp,0.5,1,1,GGAAAGTCGTTAACTGAACA,0,1118513
fldAp,0.5,1,1,GGAAAAATCAGAGCAAGAGT,0,1110089
fldAp,0.5,1,1,GCTTTTGTCTTCTAGAGATC,0,1153416
fldAp,0.5,1,1,GCTTTCCTATGACTGGCCAC,0,1068658
fldAp,0.5,1,1,GCTTGTGGCAAGATCAAGAT,0,1140030
fldAp,0.5,1,1,GCTTGTGCAGCGATCGTATT,0,1100197
fldAp,0.5,1,1,GCTTGGGCAGGGTCGAGTCG,0,1064494
fldAp,0.5,1,1,GCTTGCTGATTATTGCGAGA,0,1108874
fldAp,0.5,1,1,GCTTGACGGGCGTCAGCGGT,0,1166821
fldAp,0.5,1,1,GCTTCTTCGCATAGCGGATT,0,1087174
fldAp,0.5,1,1,GCTTCTAAAGTTATAGTGGA,0,1171346
fldAp,0.5,1,1,GCTTCGATAAGACCAACACG,0,1107491
fldAp,0.5,1,1,GCTTCCCACTGTTCGATTGC,0,1174128
fldAp,0.5,1,1,GCTTCAGCTGATCACTAATT,0,1094218
fldAp,0.5,1,1,GCTTCAATGCGGGTGGGGTT,0,1068237
fldAp,0.5,1,1,GCTTATCTACCTCTTGGGGA,0,1063138
fldAp,0.5,1,1,GCTTAGGGGGGGACTCCATC,0,1141244
fldAp,0.5,1,1,GCTTACGAATTCGATCTAGG,0,1107530
fldAp,0.5,1,1,GCTTAATTTTGGACGATTCG,0,1155343
fldAp,0.5,1,1,GCTTAATCTTAGAGGAAAGC,0,1107454
fldAp,0.5,1,1,GCTGTGGTCTATAACGATGG,0,1158523
fldAp,0.5,1,1,GCTGTGGAAGCCAGCTTAAC,0,1073396
fldAp,0.5,1,1,GCTGTGCCAATTTCATAGCT,0,1155735
fldAp,0.5,1,1,GCTGTATTCGCAATCCATAG,0,1168750
fldAp,0.5,1,1,GCTGTAGGGTATCACACCGT,0,1132658
fldAp,0.5,1,1,GCTGTACTTTGGTAACGGTA,0,1063597
fldAp,0.5,1,1,GCTGGGCCGGCTAGCGAGAC,0,1086690
fldAp,0.5,1,1,GCTGGCTCCACGCGCGAAGG,0,1100383
fldAp,0.5,1,1,GCTGGCCTTACTTGTTGCTG,0,1162929
fldAp,0.5,1,1,GCTGGATTCGCATCTTTGGC,0,1077838
fldAp,0.5,1,1,GCTGGACGGTTCAGTTTATA,0,1071305
fldAp,0.5,1,1,GCTGGAATTAGTGAATTGGA,0,1136775
fldAp,0.5,1,1,GCTGCGTTAGAGTTGAGTGA,0,1112665
fldAp,0.5,1,1,GCTGCCGCGCGTTATCTTTA,0,1147002
fldAp,0.5,1,1,GCTGCATCGGCAGAAGGTTT,0,1075203
fldAp,0.5,1,1,GCTGCAGCTATCGTGTAAGT,0,1081486
fldAp,0.5,1,1,GCTGAGCACCTCGACGCACC,0,1085554
fldAp,0.5,1,1,GCTGACGTATCTACACTTGG,0,1146470
fldAp,0.5,1,1,GCTCTTTCTACGGTCGGATC,0,1091715
fldAp,0.5,1,1,GCTCTTGATCGGAGGGCTAG,0,1104896
fldAp,0.5,1,1,GCTCTGTGTGGGTACATTTT,0,1078611
fldAp,0.5,1,1,GCTCTACTAATGCTCATTAC,0,1078048
fldAp,0.5,1,1,GCTCGGTCGGGAAATTAAGC,0,1091260
fldAp,0.5,1,1,GCTCGGGGTTAGGCAATGTT,0,1111004
fldAp,0.5,1,1,GCTCGCCTTTAACGCTTGCA,0,1182610
fldAp,0.5,1,1,GCTCGATCGGTTTTAGATCT,0,1123297
fldAp,0.5,1,1,GCTCCATTTAATGGCCACAG,0,1095077
fldAp,0.5,1,1,GCTCAGCGCGAATGCTGTGA,0,1165143
fldAp,0.5,1,1,GCTATGGTATGCGCGCTGAT,0,1150572
fldAp,0.5,1,1,GCTATGCAGTATACTAGGTC,0,1181413
fldAp,0.5,1,1,GCTATCAGCTGATACTTAGC,0,1102883
fldAp,0.5,1,1,GCTATACACGCCCATGGGAA,0,1153813
fldAp,0.5,1,1,GCTAGGATGCTTCAGGACCA,0,1144431
fldAp,0.5,1,1,GCTAGCCCATATAGGATCGG,0,1103371
fldAp,0.5,1,1,GCTAGATGCCAATGGCGTTC,0,1165603
fldAp,0.5,1,1,GCTACGGTGCGAACAGGATA,0,1078416
fldAp,0.5,1,1,GCTACGGTCTCCCATACATC,0,1164411
fldAp,0.5,1,1,GCTACGGCGCGTGGTACCAT,0,1073004
fldAp,0.5,1,1,GCTACGACGACCACTATCCT,0,1091264
fldAp,0.5,1,1,GCTACGACACAACGTCACTT,0,1096024
fldAp,0.5,1,1,GCTACATCTTACGAGTATGG,0,1143792
fldAp,0.5,1,1,GCTACAAATCCGGTGATTTT,0,1155861
fldAp,0.5,1,1,GCTAATGCGTCTGGCGCGAT,0,1067425
fldAp,0.5,1,1,GCTAAGATAATAATGATCCT,0,1140493
fldAp,0.5,1,1,GCTAACCCACCTACCAATTC,0,1157592
fldAp,0.5,1,1,GCGTTTATCCTCTCGCAACC,0,1086170
fldAp,0.5,1,1,GCGTTAGATGAGGCACTCTA,0,1176453
fldAp,0.5,1,1,GCGTGTTAAGACGGACTGAG,0,1163897
fldAp,0.5,1,1,GCGTGTAGGGAAGCCTGCCG,0,1064833
fldAp,0.5,1,1,GCGTGGCGTGACCCTCTGGG,0,1075245
fldAp,0.5,1,1,GCGTGATGTGTGAATGACCT,0,1097997
fldAp,0.5,1,1,GCGTGACGCGGGCTACTTAC,0,1149877
fldAp,0.5,1,1,GCGTGAATAAACCAATCCCA,0,1168286
fldAp,0.5,1,1,GCGTCGTGTGTGCGTGGGAT,0,1117986
fldAp,0.5,1,1,GCGTCCGTTCCCACCTACAA,0,1170456
fldAp,0.5,1,1,GCGTCCGGTCCATGTCTACA,0,1183198
fldAp,0.5,1,1,GCGTCACGGTGCGAGAGCAA,0,1153386
fldAp,0.5,1,1,GCGTCAAGGGCTGGTAGTAG,0,1131324
fldAp,0.5,1,1,GCGTATTGAGACTTCCCGCT,0,1091375
fldAp,0.5,1,1,GCGTATTGACGTTTCCTCGT,0,1159649
fldAp,0.5,1,1,GCGTATAAGACTCAGACCCC,0,1071088
fldAp,0.5,1,1,GCGTACTAGAAAGCAAAGCC,0,1114296
fldAp,0.5,1,1,GCGTAACGTGACAAGGATAA,0,1165970
fldAp,0.5,1,1,GCGTAAACGCGGTTTAGCGA,0,1183000
fldAp,0.5,1,1,GCGGTTACGCGCGTTCAACT,0,1071387
fldAp,0.5,1,1,GCGGTCCGCTCGCATCCTTT,0,1134225
fldAp,0.5,1,1,GCGGTCATGGCATCCTGTTA,0,1083849
fldAp,0.5,1,1,GCGGGTAATTGTGACGCTAC,0,1116882
fldAp,0.5,1,1,GCGGGGTTACCTCTTAGACT,0,1112214
fldAp,0.5,1,1,GCGGGGGACCAATCCTACGC,0,1135882
fldAp,0.5,1,1,GCGGGGATGTATTAGAAATT,0,1159525
fldAp,0.5,1,1,GCGGGCGTAACAAGATCAGG,0,1184824
fldAp,0.5,1,1,GCGGGCAGTTAAACAACCTT,0,1108727
fldAp,0.5,1,1,GCGGGAGGGGGACTTTGGGT,0,1064976
fldAp,0.5,1,1,GCGGGAGGATCTAGCCGCAA,0,1105177
fldAp,0.5,1,1,GCGGGACTGCACTTTTTGCA,0,1110956
fldAp,0.5,1,1,GCGGCTGGGAGCTGCGGCCA,0,1144942
fldAp,0.5,1,1,GCGGCTGATCTGGTGCGCTG,0,1160715
fldAp,0.5,1,1,GCGGCGGTAACATAAGGACC,0,1106819
fldAp,0.5,1,1,GCGGCCTCACGGATGTAGTG,0,1071394
fldAp,0.5,1,1,GCGGCCGTGCAGGCCTGCTC,0,1118350
fldAp,0.5,1,1,GCGGCCCATTGCGTTCCCTC,0,1065126
fldAp,0.5,1,1,GCGGAGTCAATCAAAGTCTT,0,1186537
fldAp,0.5,1,1,GCGCTTTGCGGTACTACTGA,0,1087357
fldAp,0.5,1,1,GCGCTCTCGTTAGGCCGGAC,0,1172051
fldAp,0.5,1,1,GCGCTCGTGTCCACCTTTCA,0,1108642
fldAp,0.5,1,1,GCGCTCGAATGAACATACCC,0,1107830
fldAp,0.5,1,1,GCGCGTTGGAGGTATCGGTG,0,1165290
fldAp,0.5,1,1,GCGCGTGCGGGCTTTGGTTT,0,1075596
fldAp,0.5,1,1,GCGCGCGGCATCAACTTTCC,0,1160172
fldAp,0.5,1,1,GCGCCGCGTCTCGGTGGGGG,0,1136635
fldAp,0.5,1,1,GCGCCGCAAGGGACCTTAGT,0,1114611
fldAp,0.5,1,1,GCGCCATTTCTATATACGGT,0,1066558
fldAp,0.5,1,1,GCGCCAGGTTCTGCGCATGT,0,1085915
fldAp,0.5,1,1,GCGCAGGGGAACGGGGAACG,0,1068996
fldAp,0.5,1,1,GCGCAGGAAAAGGAAGCATT,0,1107553
fldAp,0.5,1,1,GCGCACCTTCACATCCATCC,0,1183584
fldAp,0.5,1,1,GCGCACAGTCCCGGAAAATT,0,1152862
fldAp,0.5,1,1,GCGCACAAGTAACGATTAAC,0,1181616
fldAp,0.5,1,1,GCGCAACACTTACGCCTGAA,0,1156456
fldAp,0.5,1,1,GCGATTCGCACCCGGCGTAC,0,1088803
fldAp,0.5,1,1,GCGATCGCGCAGCTTTGTTA,0,1171927
fldAp,0.5,1,1,GCGAGTGGTACTTAATGGGA,0,1157395
fldAp,0.5,1,1,GCGAGTAAAGGCCGTTGGGG,0,1158425
fldAp,0.5,1,1,GCGAGTAAAATATTCCTAAA,0,1107292
fldAp,0.5,1,1,GCGAGGATATCTGTCGATGT,0,1064198
fldAp,0.5,1,1,GCGACTTGGGACTCATGATT,0,1178898
fldAp,0.5,1,1,GCGAACCCGTTTTTTCGTAA,0,1083346
fldAp,0.5,1,1,GCGAACAATTATTGATGTTC,0,1084120
fldAp,0.5,1,1,GCGAAAAGAACTCGGAGAAG,0,1117945
fldAp,0.5,1,1,GCCTTGGAATGGATATGTGC,0,1089930
fldAp,0.5,1,1,GCCTTCCCCCGGACATGGGT,0,1137229
fldAp,0.5,1,1,GCCTTATTGCATCATATTTC,0,1121841
fldAp,0.5,1,1,GCCTTACCGTGCTCGTATGC,0,1094225
fldAp,0.5,1,1,GCCTGTGTGAAAGAACTGTA,0,1090433
fldAp,0.5,1,1,GCCTGGTCATCGAACCAGTA,0,1071745
fldAp,0.5,1,1,GCCTGGATGGTCACGTATAC,0,1080102
fldAp,0.5,1,1,GCCTGAGGCATTATTTGAGT,0,1063865
fldAp,0.5,1,1,GCCTGACTATATGAAACCGT,0,1161612
fldAp,0.5,1,1,GCCTCTTACATTAGGCCCTA,0,1141637
fldAp,0.5,1,1,GCCTCACCAGAGGAATTGCT,0,1081371
fldAp,0.5,1,1,GCCTAGTGAGGAGAAAACTT,0,1115996
fldAp,0.5,1,1,GCCTAATGTCGCACGTAAAA,0,1071180
fldAp,0.5,1,1,GCCGTTTTGTCTAAGGTGCG,0,1176003
fldAp,0.5,1,1,GCCGTTGACATAGCCGCGCC,0,1151764
fldAp,0.5,1,1,GCCGTGCGGCTTTAGGCTGC,0,1110377
fldAp,0.5,1,1,GCCGTGCGAGGCCTCCTCTA,0,1133749
fldAp,0.5,1,1,GCCGTCGCCGAAGGTCCGAC,0,1156957
fldAp,0.5,1,1,GCCGTAGCTGCACAAGGACA,0,1182341
fldAp,0.5,1,1,GCCGTACACTGGGGAGGCAA,0,1101183
fldAp,0.5,1,1,GCCGGTGTCTAGGCACACAG,0,1169553
fldAp,0.5,1,1,GCCGGTGCAAACACGATTAC,0,1156453
fldAp,0.5,1,1,GCCGGTGATTTACGTGATAT,0,1080021
fldAp,0.5,1,1,GCCGGTATCTTGGGTCTAAC,0,1160785
fldAp,0.5,1,1,GCCGGTAATACGCTAAACAG,0,1136693
fldAp,0.5,1,1,GCCGGCACCTTCGCGCCCCC,0,1128054
fldAp,0.5,1,1,GCCGCGAGATCCGTACAGTC,0,1119290
fldAp,0.5,1,1,GCCGCATTGAAGTGCGGTGC,0,1154126
fldAp,0.5,1,1,GCCGCAAGCAACGCCACCCA,0,1103591
fldAp,0.5,1,1,GCCGATCGCTTGCCGGAGCG,0,1100655
fldAp,0.5,1,1,GCCGATAGGCAAAATTTCTA,0,1145941
fldAp,0.5,1,1,GCCGAGCTGTTCCAAGGTCA,0,1151211
fldAp,0.5,1,1,GCCCTTGATTCGCAACCAAG,0,1064289
fldAp,0.5,1,1,GCCCTGTGAACTACTCACGC,0,1066137
fldAp,0.5,1,1,GCCCGCGGTCCTGACTGGTT,0,1136413
fldAp,0.5,1,1,GCCCCTTATTTTGCAGGGAC,0,1180849
fldAp,0.5,1,1,GCCCCTTAGTAAAGGTTCAC,0,1067486
fldAp,0.5,1,1,GCCCCTGGGTCGTGCTGCTC,0,1088834
fldAp,0.5,1,1,GCCCCTAAGCATGTCTATCT,0,1122625
fldAp,0.5,1,1,GCCCCGTGGATCGGTCAGGG,0,1117278
fldAp,0.5,1,1,GCCCCGTGATGCTACCTCCT,0,1071328
fldAp,0.5,1,1,GCCCCGGCCAGAAGCCCAGG,0,1148115
fldAp,0.5,1,1,GCCCCCACGAGATTAGATTC,0,1142321
fldAp,0.5,1,1,GCCCATGAGAAGCTAGCGTC,0,1176557
fldAp,0.5,1,1,GCCCATGACCGGGAAGTGCT,0,1147159
fldAp,0.5,1,1,GCCCATAGCGCCCGCGTAAG,0,1124218
fldAp,0.5,1,1,GCCCACGTCAGGAGTCAAGT,0,1110930
fldAp,0.5,1,1,GCCCACGCACGTCGCTCACC,0,1135923
fldAp,0.5,1,1,GCCATTCGGTTCATCACGGG,0,1119315
fldAp,0.5,1,1,GCCATTATCTTATGGTGAAC,0,1084338
fldAp,0.5,1,1,GCCATGTAACAATGCTGTAG,0,1110863
fldAp,0.5,1,1,GCCATGACGGGGAAATTCAG,0,1137700
fldAp,0.5,1,1,GCCATCAATCTTGAACCTGA,0,1172083
fldAp,0.5,1,1,GCCATAGGACAGATCACTCT,0,1123954
fldAp,0.5,1,1,GCCAGTGACTTGACTTCCGG,0,1146510
fldAp,0.5,1,1,GCCAGGGGCGTCCATAGCGT,0,1152946
fldAp,0.5,1,1,GCCAGGAACGCCTGCCTCCC,0,1128905
fldAp,0.5,1,1,GCCAGCCAGTCAGCTGGGCA,0,1151884
fldAp,0.5,1,1,GCCAGAGGTACAGCTTCGGA,0,1145040
fldAp,0.5,1,1,GCCAGACTCTAATCGCGATG,0,1091898
fldAp,0.5,1,1,GCCAGAAGAATGGTCAATCC,0,1096463
fldAp,0.5,1,1,GCCACGGAGGAAACTCCCGC,0,1164110
fldAp,0.5,1,1,GCCACAGGGTAAACAGCGCA,0,1133947
fldAp,0.5,1,1,GCCACAATCTGCATCGACAT,0,1104342
fldAp,0.5,1,1,GCCACAACTTTATGGTCGGA,0,1172982
fldAp,0.5,1,1,GCCAATTTTTCCAATAAAAC,0,1155584
fldAp,0.5,1,1,GCCAAAGTGGACGAAATCGG,0,1082255
fldAp,0.5,1,1,GCATTTCATTAGCAAGGGAT,0,1131966
fldAp,0.5,1,1,GCATTACGCGCTGAGTGACC,0,1090376
fldAp,0.5,1,1,GCATTACCCCTGGACTACTA,0,1149072
fldAp,0.5,1,1,GCATGGAGATAACAGTAAAA,0,1085840
fldAp,0.5,1,1,GCATGAAGCACGAACTACGG,0,1081772
fldAp,0.5,1,1,GCATCGCTAGTCTGCCGAGG,0,1133217
fldAp,0.5,1,1,GCATCCGCATTTGCAGTCTC,0,1115202
fldAp,0.5,1,1,GCATATCTCCTAACTAATAT,0,1120846
fldAp,0.5,1,1,GCATACGGGGAGAAGGCTAG,0,1153975
fldAp,0.5,1,1,GCATACAACGAATCGTACCA,0,1136918
fldAp,0.5,1,1,GCATAAGACGCGAAGCACCA,0,1120702
fldAp,0.5,1,1,GCAGTTGCGCCCCCACTTTC,0,1147620
fldAp,0.5,1,1,GCAGTGATCATGCCGCGCCT,0,1180603
fldAp,0.5,1,1,GCAGTCGCCAATACCGTACC,0,1159498
fldAp,0.5,1,1,GCAGGTCACGTCCAGCTGGG,0,1145425
fldAp,0.5,1,1,GCAGGTAACGGGATAGCAGA,0,1094862
fldAp,0.5,1,1,GCAGCGGGTTCCCCGATGGG,0,1144358
fldAp,0.5,1,1,GCAGCCTGTGGGGGGGTTTA,0,1132587
fldAp,0.5,1,1,GCAGCATTAACTCCCACATT,0,1145821
fldAp,0.5,1,1,GCAGCAGGTCTCCGTGAGGG,0,1086286
fldAp,0.5,1,1,GCAGATAAGTTTGGGTCTCG,0,1108276
fldAp,0.5,1,1,GCAGATAAGAGACGTGGTAA,0,1179961
fldAp,0.5,1,1,GCAGAGTCTCCGGCTCAGAG,0,1169051
fldAp,0.5,1,1,GCAGAGTCCTAATCTCACCC,0,1098889
fldAp,0.5,1,1,GCAGAGGGAACTATACTAGA,0,1081125
fldAp,0.5,1,1,GCACTTTGCTGTGGTCTAAG,0,1123212
fldAp,0.5,1,1,GCACTTAATAGCACCCTCTG,0,1064936
fldAp,0.5,1,1,GCACTGCCCGGACCCCGTTT,0,1130069
fldAp,0.5,1,1,GCACTCGGGCTGCCCAGTAG,0,1127243
fldAp,0.5,1,1,GCACTCATGACGCGCGCGAC,0,1108293
fldAp,0.5,1,1,GCACTAACCCCTGTACCACA,0,1121190
fldAp,0.5,1,1,GCACGTGCCCAGCATCGCGA,0,1119215
fldAp,0.5,1,1,GCACGCGTTGTTCGAAACCT,0,1152390
fldAp,0.5,1,1,GCACGATGGTTCCCCATACT,0,1175411
fldAp,0.5,1,1,GCACGAGGTTGTCTGGAGGG,0,1177604
fldAp,0.5,1,1,GCACCTCGGGCGCCGCCCAA,0,1150541
fldAp,0.5,1,1,GCACCGAATCTTCTGGCAGA,0,1092411
fldAp,0.5,1,1,GCACCAAGCTTCGCTAATGC,0,1158652
fldAp,0.5,1,1,GCACATTTGCTTCCCATCAT,0,1158540
fldAp,0.5,1,1,GCACATTCAAACTCCGAAGA,0,1174557
fldAp,0.5,1,1,GCACAGAGGTCGCCACGACT,0,1070757
fldAp,0.5,1,1,GCACACGTTGGGGCAGGGTT,0,1090687
fldAp,0.5,1,1,GCACACGCCGGGAGGCTAGA,0,1176332
fldAp,0.5,1,1,GCAATGACGCAGTTGAGGTA,0,1117753
fldAp,0.5,1,1,GCAATCTGGAGAAAATAGGA,0,1155018
fldAp,0.5,1,1,GCAATCCTTATAGACAGGGC,0,1104605
fldAp,0.5,1,1,GCAATATAGCCCCACTTTAA,0,1132709
fldAp,0.5,1,1,GCAAGGGAACCTTCCTGTAC,0,1135745
fldAp,0.5,1,1,GCAAGATTTCTGGTTGCAAT,0,1168351
fldAp,0.5,1,1,GCAAGACGAACAGGGAGACT,0,1165000
fldAp,0.5,1,1,GCAAGACACGAGGCCATCGT,0,1180761
fldAp,0.5,1,1,GCAACGCCACCAGGCCGAAT,0,1183635
fldAp,0.5,1,1,GCAACGAACAAGAGCTACTA,0,1155377
fldAp,0.5,1,1,GCAACATGACTTAATATCAC,0,1132134
fldAp,0.5,1,1,GCAACAAGTCACATAGGCGG,0,1156432
fldAp,0.5,1,1,GCAAATCCCGCACATAGGTT,0,1156616
fldAp,0.5,1,1,GCAAACGTCGGGCAGAATAC,0,1088799
fldAp,0.5,1,1,GCAAACGCAAAATTTCATTC,0,1168703
fldAp,0.5,1,1,GCAAACCAGCGATGTGAGTG,0,1156046
fldAp,0.5,1,1,GCAAACATGGCAGAACAGGC,0,1160190
fldAp,0.5,1,1,GCAAAATACAGTTCCAGTTC,0,1107217
fldAp,0.5,1,1,GATTTGCAGCACCAGGGTGG,0,1159178
fldAp,0.5,1,1,GATTTGCAAGTGCTTACTCA,0,1133471
fldAp,0.5,1,1,GATTTATCGTGAGCTACCGA,0,1084291
fldAp,0.5,1,1,GATTGTAGTCTGTTACGACT,0,1093635
fldAp,0.5,1,1,GATTGGGCAAAGGGACCGTC,0,1063363
fldAp,0.5,1,1,GATTGGACCATCAATTGGCG,0,1079004
fldAp,0.5,1,1,GATTGCTTGGCTGGGTCTGG,0,1162400
fldAp,0.5,1,1,GATTGCGTTTAGTGTCGTAT,0,1081754
fldAp,0.5,1,1,GATTCTTAGCCTTTGGTGAG,0,1157752
fldAp,0.5,1,1,GATTCTCACCGAAGTGTCTG,0,1174948
fldAp,0.5,1,1,GATTCCGAAGTGCACTCCTA,0,1177448
fldAp,0.5,1,1,GATTCAGAGCTCACCAATCA,0,1183431
fldAp,0.5,1,1,GATTCACGGGGCTGGCAATC,0,1178564
fldAp,0.5,1,1,GATTCACATACCCGACGATT,0,1175424
fldAp,0.5,1,1,GATTAACATTTTGCATGTAC,0,1088012
fldAp,0.5,1,1,GATTAAAGTGGAGCGGTTAA,0,1084066
fldAp,0.5,1,1,GATGTTTCGATGGTGCGGGG,0,1161832
fldAp,0.5,1,1,GATGTTCTAAGACGTTCATT,0,1153008
fldAp,0.5,1,1,GATGTGCGGGATACCTATCT,0,1153194
fldAp,0.5,1,1,GATGTAGTTGCCATGCCGTT,0,1081805
fldAp,0.5,1,1,GATGGCCGCAGACCAGCCAT,0,1124922
fldAp,0.5,1,1,GATGGATGAGGTCCGTTTTT,0,1090923
fldAp,0.5,1,1,GATGGAGTTTCGAAATGGAG,0,1117583
fldAp,0.5,1,1,GATGGACGAGTCGGAAACTA,0,1090980
fldAp,0.5,1,1,GATGCTCATCCCACCACCGG,0,1097617
fldAp,0.5,1,1,GATGCGAACTGGGGGTAGCA,0,1082890
fldAp,0.5,1,1,GATGCCAAATACGATACATT,0,1164532
fldAp,0.5,1,1,GATGCAGGGCAGCGCTATAG,0,1071424
fldAp,0.5,1,1,GATGCAAATCGACAGTATCG,0,1104818
fldAp,0.5,1,1,GATGAATGCGACAAAATGGC,0,1161300
fldAp,0.5,1,1,GATGAAATTTCAGAAAGGAG,0,1160144
fldAp,0.5,1,1,GATCTTGTGGGAGTCAATGG,0,1150738
fldAp,0.5,1,1,GATCTGCGGTCGGAGTCACG,0,1090797
fldAp,0.5,1,1,GATCTAGGGGCCGATGACTG,0,1105065
fldAp,0.5,1,1,GATCTACGTGTTGCTCGTCG,0,1154168
fldAp,0.5,1,1,GATCGTCCATCCGAGACCGA,0,1098309
fldAp,0.5,1,1,GATCGGTTCAGATCCTCACT,0,1076020
fldAp,0.5,1,1,GATCGAGGGCCGACTAGGTG,0,1121310
fldAp,0.5,1,1,GATCGAATGTGTCCCTTCTG,0,1114838
fldAp,0.5,1,1,GATCCCTTCATGAGTTTAGA,0,1093001
fldAp,0.5,1,1,GATCCCTCGCCAGACCAACA,0,1141372
fldAp,0.5,1,1,GATCCATCGTAATCATGTGT,0,1124339
fldAp,0.5,1,1,GATCATATATATTCGACAAT,0,1109830
fldAp,0.5,1,1,GATATTTATGGAATCCTTTA,0,1091368
fldAp,0.5,1,1,GATATGGCCCGCGTAAGCGT,0,1146604
fldAp,0.5,1,1,GATATCCTCGTCCCGTATAC,0,1140480
fldAp,0.5,1,1,GATATCCAGTCGATGTAGCA,0,1146321
fldAp,0.5,1,1,GATAGCTGGTGGCGTACCGC,0,1110388
fldAp,0.5,1,1,GATAGCAACTCTGTTCCGCA,0,1148663
fldAp,0.5,1,1,GATACTTGAACAAGAACCCT,0,1166773
fldAp,0.5,1,1,GATACTGGTCTTCAGCTGGC,0,1130318
fldAp,0.5,1,1,GATACCCCCTAACACGTGCA,0,1170177
fldAp,0.5,1,1,GATAATCACGTTCGGACGGT,0,1120141
fldAp,0.5,1,1,GATAAGTTATGTATGTGTAA,0,1146317
fldAp,0.5,1,1,GATAAGGTGTAATACGTCTA,0,1161893
fldAp,0.5,1,1,GATAAGGCTTCTCACACCGC,0,1160004
fldAp,0.5,1,1,GAGTTTAGCATGGGTAATCA,0,1138521
fldAp,0.5,1,1,GAGTTGCACCGTACAAAATA,0,1084207
fldAp,0.5,1,1,GAGTTATACCAGGGGTCGAT,0,1185780
fldAp,0.5,1,1,GAGTTAGATGGCTGACCCAC,0,1130910
fldAp,0.5,1,1,GAGTGTATAGGTGGCATTGG,0,1166170
fldAp,0.5,1,1,GAGTGGGCAAATGGATCTAC,0,1178737
fldAp,0.5,1,1,GAGTGCTCTCGGACCTGCAA,0,1145915
fldAp,0.5,1,1,GAGTCTGGCCGGCTCCTTAG,0,1184341
fldAp,0.5,1,1,GAGTCTCGTTACGCATGCAT,0,1085248
fldAp,0.5,1,1,GAGTCTCCAGCGACCTATGA,0,1096199
fldAp,0.5,1,1,GAGTCGTTAAAACGGGGCCT,0,1092041
fldAp,0.5,1,1,GAGTCGACCAAGTTAGCGGG,0,1101669
fldAp,0.5,1,1,GAGTCCCGCACGTGTTCAAT,0,1084753
fldAp,0.5,1,1,GAGTCCCCGTATGTTGTGGG,0,1079320
fldAp,0.5,1,1,GAGTCCATACCGGACTGGAG,0,1171906
fldAp,0.5,1,1,GAGTCAATTACCATCAAGTG,0,1112062
fldAp,0.5,1,1,GAGTCAATGGGGCGCAGAGG,0,1140412
fldAp,0.5,1,1,GAGTATTGCGGATATCCCCA,0,1160466
fldAp,0.5,1,1,GAGTACGCCGGGTAATAAAG,0,1161354
fldAp,0.5,1,1,GAGGTTTACCTTCCGGAACT,0,1121963
fldAp,0.5,1,1,GAGGTTGGCTCCCCCCTGTT,0,1159172
fldAp,0.5,1,1,GAGGTTGCTGAAAACTAGGA,0,1181596
fldAp,0.5,1,1,GAGGTGTCTAGTGTCTCGGT,0,1114949
fldAp,0.5,1,1,GAGGTCCGTGCGCGGTTTAA,0,1156293
fldAp,0.5,1,1,GAGGTATTTTAGCCTGTTCT,0,1142554
fldAp,0.5,1,1,GAGGTATAATAAAGCAGCAT,0,1160971
fldAp,0.5,1,1,GAGGTAGGCAATGCAGGCTA,0,1100405
fldAp,0.5,1,1,GAGGTACACTTTGCAACGTC,0,1171573
fldAp,0.5,1,1,GAGGGTCAATAGTCCGAGGA,0,1131598
fldAp,0.5,1,1,GAGGGGGGTACAGATCAGCC,0,1103797
fldAp,0.5,1,1,GAGGGCATGGAACCTCCCTC,0,1142059
fldAp,0.5,1,1,GAGGGAATTAGTGATGAATC,0,1072962
fldAp,0.5,1,1,GAGGCGATTCAGCATCCAGA,0,1155286
fldAp,0.5,1,1,GAGGCCAGAAGTCGAGTATC,0,1069694
fldAp,0.5,1,1,GAGGCATCCACCTTCAGACG,0,1184526
fldAp,0.5,1,1,GAGGATGGTCCGTACCAGCG,0,1175377
fldAp,0.5,1,1,GAGGATATAATGGACCAGCG,0,1085534
fldAp,0.5,1,1,GAGGAGACACCGTGTCGAGG,0,1179063
fldAp,0.5,1,1,GAGGAGACAACTGTTCAAAA,0,1091164
fldAp,0.5,1,1,GAGCTTATCGCTTTACAACT,0,1113568
fldAp,0.5,1,1,GAGCTGGGACGACCTTGACA,0,1106148
fldAp,0.5,1,1,GAGCTCGTGGCGGTCATGGT,0,1117294
fldAp,0.5,1,1,GAGCTACCAGTTCCTCCAAT,0,1100093
fldAp,0.5,1,1,GAGCGCGTATGTGTTCCTAG,0,1163369
fldAp,0.5,1,1,GAGCGCGACCGACGAGTAAA,0,1186436
fldAp,0.5,1,1,GAGCGAGGGATTCAGTTGGT,0,1136938
fldAp,0.5,1,1,GAGCCGCGATATGCTGGGTT,0,1128375
fldAp,0.5,1,1,GAGCCGATAAGCCCATTCAA,0,1183218
fldAp,0.5,1,1,GAGCCCGGCCTCAAATATGT,0,1086160
fldAp,0.5,1,1,GAGCCCCTGTGACAGGGATC,0,1069490
fldAp,0.5,1,1,GAGCCACTATCAAAGGGATC,0,1186908
fldAp,0.5,1,1,GAGCATGGATATTGATCTCA,0,1178241
fldAp,0.5,1,1,GAGCAGTTGTGGCACTTAAA,0,1067400
fldAp,0.5,1,1,GAGCAGTTGAGCCCTCCCTT,0,1096105
fldAp,0.5,1,1,GAGCAGTCGTAAACTACAGA,0,1096967
fldAp,0.5,1,1,GAGCACTCTGTATTGCAGGT,0,1063883
fldAp,0.5,1,1,GAGCAATCAGTAAAAGTGAG,0,1122591
fldAp,0.5,1,1,GAGATGCTTAGAGTTTCTCA,0,1114857
fldAp,0.5,1,1,GAGATGCCAATCCCATCACA,0,1123836
fldAp,0.5,1,1,GAGATATTAAGCAGTGTAGT,0,1167492
fldAp,0.5,1,1,GAGATAAAAGCATTTTCGTC,0,1149947
fldAp,0.5,1,1,GAGAGTCTCATCGAGTAGAC,0,1088407
fldAp,0.5,1,1,GAGAGGGGATAATCTCCAAT,0,1146746
fldAp,0.5,1,1,GAGAGGCATTCCCTGGCATT,0,1068954
fldAp,0.5,1,1,GAGAGCCCGCAGGACATGAC,0,1126547
fldAp,0.5,1,1,GAGACTTCGCAATGGGCTTT,0,1072620
fldAp,0.5,1,1,GAGACGGGTCAACTTCCCTT,0,1153032
fldAp,0.5,1,1,GAGACGCTAGCAGATTAGGG,0,1083817
fldAp,0.5,1,1,GAGACCTCGTATTTAGGTCT,0,1099285
fldAp,0.5,1,1,GAGACCCCTTAGAAGACCCT,0,1112117
fldAp,0.5,1,1,GAGACAGAGTACAGTATAAA,0,1184497
fldAp,0.5,1,1,GAGAAGATCGGCATGCCTGT,0,1083079
fldAp,0.5,1,1,GACTTAGGCTCAGAACACCG,0,1153227
fldAp,0.5,1,1,GACTGGGACATAATTATCCC,0,1177655
fldAp,0.5,1,1,GACTGGCCCCAGAGTTGACT,0,1080268
fldAp,0.5,1,1,GACTGCGGTATGCCTAGTCG,0,1152744
fldAp,0.5,1,1,GACTCGCGCCTCGAAGTTCA,0,1127870
fldAp,0.5,1,1,GACTCCTCGTGAGAAATTAA,0,1151630
fldAp,0.5,1,1,GACTCCGGTACGTCAGCTCC,0,1141382
fldAp,0.5,1,1,GACTCATGGCACAGGAAAGT,0,1175918
fldAp,0.5,1,1,GACTCAAATGGGCAGGACCT,0,1185723
fldAp,0.5,1,1,GACTAACTGAGGACATGAAC,0,1124301
fldAp,0.5,1,1,GACGGTGTCACCCAGGGTAC,0,1154849
fldAp,0.5,1,1,GACGGTGCTAGCACACAGGG,0,1071690
fldAp,0.5,1,1,GACGGGTGGGTGACTCCCAA,0,1185768
fldAp,0.5,1,1,GACGGGGGCGTCGTAGGTCG,0,1077467
fldAp,0.5,1,1,GACGGCTTAGGACGTATGCA,0,1093651
fldAp,0.5,1,1,GACGGCTGTGGTGAAAATCA,0,1142961
fldAp,0.5,1,1,GACGGCGTCAGGGGGGCGGA,0,1162365
fldAp,0.5,1,1,GACGGCAAGCCGGGAGGGAC,0,1103878
fldAp,0.5,1,1,GACGGATGTACCGGGGTATT,0,1168282
fldAp,0.5,1,1,GACGGAGTCTGTCGCGGCTT,0,1112999
fldAp,0.5,1,1,GACGCGTTAGCGTGTCTGGT,0,1123459
fldAp,0.5,1,1,GACGCACAAAAGGCGTGGCG,0,1148476
fldAp,0.5,1,1,GACGATCAGGAAGGTAACAG,0,1128104
fldAp,0.5,1,1,GACGAGCATGCACCATATCT,0,1150935
fldAp,0.5,1,1,GACCTGTGCTTGTGACGGGT,0,1154174
fldAp,0.5,1,1,GACCTGGCCGTGGGTCGAGC,0,1113305
fldAp,0.5,1,1,GACCTGACATCAATTAAATT,0,1107502
fldAp,0.5,1,1,GACCTCCTCCGAATCTATCC,0,1100938
fldAp,0.5,1,1,GACCTAATCGCCCCCTAGCT,0,1096117
fldAp,0.5,1,1,GACCGTTGTTCCTGACTGCA,0,1102872
fldAp,0.5,1,1,GACCGGTCGTCGATGTTAGT,0,1123544
fldAp,0.5,1,1,GACCCGCCTAGGTTCTTACC,0,1146838
fldAp,0.5,1,1,GACCATTTCAAGACGCCGCC,0,1170003
fldAp,0.5,1,1,GACCACCCTGTTCTTTTCAG,0,1172343
fldAp,0.5,1,1,GACCAATGTCTACCAGTGAA,0,1081538
fldAp,0.5,1,1,GACATTGGCTCATATTTTTG,0,1072589
fldAp,0.5,1,1,GACATGTGCTGCTCGATTAT,0,1131217
fldAp,0.5,1,1,GACATCGCCTCCTCAGAGTC,0,1149907
fldAp,0.5,1,1,GACAGGGAACCGGCCGATGC,0,1120408
fldAp,0.5,1,1,GACAGATAGGAGTCCTTCTC,0,1083282
fldAp,0.5,1,1,GACACTTTATGGATCGGGAT,0,1094496
fldAp,0.5,1,1,GACACGATCATTTTGCTATA,0,1101543
fldAp,0.5,1,1,GACACCCGGACCTTATCTAC,0,1113848
fldAp,0.5,1,1,GACACCCGCCCCTCATTGCG,0,1171623
fldAp,0.5,1,1,GACACATACTCAGTTAGCTA,0,1177479
fldAp,0.5,1,1,GACACAGCCCGATCAGTCAG,0,1111783
fldAp,0.5,1,1,GAATTGGTCCTGCTATACAT,0,1169165
fldAp,0.5,1,1,GAATTCGGTTTACGCGGACC,0,1100800
fldAp,0.5,1,1,GAATTCGGGAAAAGCTTGCA,0,1180836
fldAp,0.5,1,1,GAATGTGACGGCACTTTAGT,0,1073737
fldAp,0.5,1,1,GAATGTATGCCAGCGGCAAG,0,1069908
fldAp,0.5,1,1,GAATGTATATCCGCTCGCCA,0,1131912
fldAp,0.5,1,1,GAATGGTTTGTTAGCTCTCG,0,1186950
fldAp,0.5,1,1,GAATGGAATACGCCCGTGTC,0,1134920
fldAp,0.5,1,1,GAATGCCGGCCGTAATCTTA,0,1101022
fldAp,0.5,1,1,GAATGATGAAGCGATCCACG,0,1186515
fldAp,0.5,1,1,GAATCTACACGAAATAATTA,0,1107775
fldAp,0.5,1,1,GAATCGACCCGCGCCGGTAT,0,1139827
fldAp,0.5,1,1,GAATCACACGCAATAAAATA,0,1110382
fldAp,0.5,1,1,GAATCAAAAGACCGAATAAC,0,1075012
fldAp,0.5,1,1,GAATAGATTCAAAATGATTG,0,1153797
fldAp,0.5,1,1,GAAGTCGTGGGGTCCTTTCT,0,1094214
fldAp,0.5,1,1,GAAGGTAGGAGGCCAAGTAT,0,1172445
fldAp,0.5,1,1,GAAGGTAACAAACTAGAATA,0,1074706
fldAp,0.5,1,1,GAAGGGCATCCCTATGCTGT,0,1107422
fldAp,0.5,1,1,GAAGCTTGGCCTCCGTAACC,0,1114667
fldAp,0.5,1,1,GAAGCTGTAGAATAAGGGGG,0,1183863
fldAp,0.5,1,1,GAAGCGCCGCTCGTATAATC,0,1134863
fldAp,0.5,1,1,GAAGCCGCCCTGGTGGTGTG,0,1159560
fldAp,0.5,1,1,GAAGAGTATTACTGAGCTGA,0,1142605
fldAp,0.5,1,1,GAAGAGGCGCAAGTACCCGT,0,1169377
fldAp,0.5,1,1,GAACTTTTGGGCAGCGATTT,0,1085015
fldAp,0.5,1,1,GAACTGGTTAGAGGCATTAT,0,1088353
fldAp,0.5,1,1,GAACTAAATTGAGAATATGA,0,1154681
fldAp,0.5,1,1,GAACGTACGATTAAGGTTTG,0,1090111
fldAp,0.5,1,1,GAACGCCTGTTGTGATCGAA,0,1118432
fldAp,0.5,1,1,GAACGCCAGAACGGTTCAGA,0,1131944
fldAp,0.5,1,1,GAACCGGAATAAGGGCAGCA,0,1151501
fldAp,0.5,1,1,GAACCGCATTCGTGTATTAC,0,1172790
fldAp,0.5,1,1,GAACCGAGGCAGCTCAGGAA,0,1157420
fldAp,0.5,1,1,GAACCCGAGAAGAGTCTCGC,0,1114393
fldAp,0.5,1,1,GAACAGTCTTCCGTGAACAG,0,1093160
fldAp,0.5,1,1,GAACAGTCACAGCTGAATGT,0,1140818
fldAp,0.5,1,1,GAACAGGCGCATTATTGTTC,0,1074363
fldAp,0.5,1,1,GAAATTCAAGCACAACGCGG,0,1152342
fldAp,0.5,1,1,GAAATGAATAAGGTAGCTAG,0,1084626
fldAp,0.5,1,1,GAAATGAAGCTCCGCCATAG,0,1121036
fldAp,0.5,1,1,GAAAGGATAACAGAGCATTA,0,1158661
fldAp,0.5,1,1,GAAAGCGAACCGCATTACGA,0,1080682
fldAp,0.5,1,1,GAAAGATGGAGCAGCCCACC,0,1186960
fldAp,0.5,1,1,GAAAGAGCCAATACAATCGG,0,1081107
fldAp,0.5,1,1,GAAACTTGGCTGCTTCGCTG,0,1106352
fldAp,0.5,1,1,GAAACTTCAATCAGTCGGCT,0,1162370
fldAp,0.5,1,1,GAAACTTAGGTCACGCCGGC,0,1182618
fldAp,0.5,1,1,GAAACCGGCCATAGAATATC,0,1112985
fldAp,0.5,1,1,GAAACCATGGAGACAAGTCA,0,1142650
fldAp,0.5,1,1,GAAACATAGATATACGAAGG,0,1118006
fldAp,0.5,1,1,GAAACAGCTCGCTTTGTCGC,0,1108169
fldAp,0.5,1,1,GAAAATTACTTTTTGGGGTA,0,1159193
fldAp,0.5,1,1,GAAAATGAAGATCGACACGG,0,1124525
fldAp,0.5,1,1,GAAAACTACCTCGGAATCTC,0,1091785
fldAp,0.5,1,1,GAAAACGTGCGGAGAAATGC,0,1081841
fldAp,0.5,1,1,GAAAACCACTAGAACGCCGG,0,1154518
fldAp,0.5,1,1,GAAAACAAAGATATAATCCC,0,1175108
fldAp,0.5,1,1,GAAAAAACCATGTGCCCAAT,0,1067292
fldAp,0.5,1,1,CTTTTTGCGTTCGACCTATA,0,1176342
fldAp,0.5,1,1,CTTTTGTTTGGCACCGCGTC,0,1107982
fldAp,0.5,1,1,CTTTTCTTATAAAGCTCCCG,0,1152219
fldAp,0.5,1,1,CTTTTCGAAAGGACTCCTGT,0,1151013
fldAp,0.5,1,1,CTTTTCCCCACTTGAGGGGT,0,1079005
fldAp,0.5,1,1,CTTTTAGATTACTGGGTTAA,0,1180226
fldAp,0.5,1,1,CTTTTAAAAGATGATAGCAA,0,1108799
fldAp,0.5,1,1,CTTTGGTCTTTGCATTCGCG,0,1169754
fldAp,0.5,1,1,CTTTGGGTTCGGGCATGAAG,0,1154547
fldAp,0.5,1,1,CTTTGCCTCTCCGATACCAA,0,1172328
fldAp,0.5,1,1,CTTTGATACTGGAACCTGAT,0,1180446
fldAp,0.5,1,1,CTTTGATAAAGACATGACAG,0,1095358
fldAp,0.5,1,1,CTTTGAGGGACGCACTCGGA,0,1089337
fldAp,0.5,1,1,CTTTGACCAGGAGGGTGCGA,0,1127623
fldAp,0.5,1,1,CTTTCTGGCCCTGTCATTCT,0,1125726
fldAp,0.5,1,1,CTTTCTGACTACTTGGCCAC,0,1106315
fldAp,0.5,1,1,CTTTCTCTTGGTTTTTTTGC,0,1161969
fldAp,0.5,1,1,CTTTCCACTGTGTTCGCTAT,0,1128813
fldAp,0.5,1,1,CTTTCACGGCTCAGGGCCAA,0,1156679
fldAp,0.5,1,1,CTTTATCCGAACTGGAAGCA,0,1113545
fldAp,0.5,1,1,CTTTATCAGGCCCGTAAGGT,0,1112646
fldAp,0.5,1,1,CTTTAGATACCACGAGGGTA,0,1077866
fldAp,0.5,1,1,CTTTACGGTATATGATCACT,0,1150927
fldAp,0.5,1,1,CTTTAACAGTAGAGGTTCGA,0,1185060
fldAp,0.5,1,1,CTTGTGGTCGGGAAATTCGC,0,1145257
fldAp,0.5,1,1,CTTGTGCTATTTCCGCGGTC,0,1108768
fldAp,0.5,1,1,CTTGTATGACGACGCAGAAC,0,1163391
fldAp,0.5,1,1,CTTGTAGCCCTCCGCGATAG,0,1084869
fldAp,0.5,1,1,CTTGTAGCATCGTTCCATAT,0,1098686
fldAp,0.5,1,1,CTTGTAGACTTACGGGGGTT,0,1161295
fldAp,0.5,1,1,CTTGGTCTGATTGGCACGAC,0,1164185
fldAp,0.5,1,1,CTTGGGGAGAGCGGAGAGCA,0,1184379
fldAp,0.5,1,1,CTTGGCTGAACTCAACATCG,0,1119874
fldAp,0.5,1,1,CTTGGATGAACGTCTTTGGA,0,1098175
fldAp,0.5,1,1,CTTGATGTATTGCTGCTCCG,0,1127866
fldAp,0.5,1,1,CTTGATCACGTGCTAAACCG,0,1118080
fldAp,0.5,1,1,CTTGAGTAAAGAGTATCAGT,0,1129335
fldAp,0.5,1,1,CTTGACCGACCCGGTTTCAC,0,1126638
fldAp,0.5,1,1,CTTGACATGTCCAGACTGCG,0,1138622
fldAp,0.5,1,1,CTTGAACGAGCGCGGAATGG,0,1167602
fldAp,0.5,1,1,CTTGAAAGGGCGTAACCCAA,0,1081195
fldAp,0.5,1,1,CTTCTCGTTCTACTTAAATG,0,1184314
fldAp,0.5,1,1,CTTCTATGCCTTGAGGCTTC,0,1133770
fldAp,0.5,1,1,CTTCGTTCATATTAGCAGAC,0,1105983
fldAp,0.5,1,1,CTTCGGTGATCCAATGAGGA,0,1112048
fldAp,0.5,1,1,CTTCGGGCTCCCGGCCCAAT,0,1096702
fldAp,0.5,1,1,CTTCGCGCGTTAGCAAAGGC,0,1084638
fldAp,0.5,1,1,CTTCGCATGGTGTTGATTTC,0,1170962
fldAp,0.5,1,1,CTTCGACGAGAACATTTTAG,0,1186532
fldAp,0.5,1,1,CTTCGAATGACCGAGAACAA,0,1118185
fldAp,0.5,1,1,CTTCGAACGACACGGCAGCA,0,1123740
fldAp,0.5,1,1,CTTCCGGAATCATTTATTGT,0,1100439
fldAp,0.5,1,1,CTTCCACGTATGTACGCCAA,0,1145453
fldAp,0.5,1,1,CTTCATGTGTACAAAAGATA,0,1168237
fldAp,0.5,1,1,CTTCATGTATTGGACAGAGT,0,1148332
fldAp,0.5,1,1,CTTCATGGCGCGTCCCAGCT,0,1071399
fldAp,0.5,1,1,CTTCATACCTGACCAAAACC,0,1174058
fldAp,0.5,1,1,CTTCAGGAGATGTCACAAAA,0,1074305
fldAp,0.5,1,1,CTTCACGTGCATCGTCGTGC,0,1159198
fldAp,0.5,1,1,CTTCACGTCTTCCCGTCTCC,0,1096464
fldAp,0.5,1,1,CTTCACGGAGATCTTAAGGC,0,1100051
fldAp,0.5,1,1,CTTATTGCCTTTAGCAGAGG,0,1172629
fldAp,0.5,1,1,CTTATCCATGAGTATCAGAA,0,1165687
fldAp,0.5,1,1,CTTATAAACGCGGACGTATG,0,1125384
fldAp,0.5,1,1,CTTAGTGCCGCTACGTATAG,0,1140310
fldAp,0.5,1,1,CTTAGTATCACGCACGGGAA,0,1115132
fldAp,0.5,1,1,CTTAGTACAGGGGATGCAAT,0,1180818
fldAp,0.5,1,1,CTTAGCGTACGGGTCGCTTA,0,1092778
fldAp,0.5,1,1,CTTAGCAGTGTTAACTCGTG,0,1124112
fldAp,0.5,1,1,CTTAGAGTGAGCATTTGTGG,0,1078989
fldAp,0.5,1,1,CTTAGAGACTGATGAGGGGC,0,1118703
fldAp,0.5,1,1,CTTACTACGGCTACGTTGCC,0,1105992
fldAp,0.5,1,1,CTTACGTGTAATTATGTGCG,0,1141768
fldAp,0.5,1,1,CTTACGGGCCGTAGCTATCT,0,1100933
fldAp,0.5,1,1,CTTACCAAGGCTACAACTAT,0,1171377
fldAp,0.5,1,1,CTTACAGTATTTATAGCGAA,0,1125414
fldAp,0.5,1,1,CTTACAATCGGACGGGAATG,0,1072907
fldAp,0.5,1,1,CTTAATTGACTTGTATAGCC,0,1122369
fldAp,0.5,1,1,CTTAATTACTCTAGTGTTAA,0,1086480
fldAp,0.5,1,1,CTTAACTGTCGTTAAACACA,0,1120161
fldAp,0.5,1,1,CTTAACGGGTACAGGTAGGA,0,1156373
fldAp,0.5,1,1,CTTAACGGGGCGCCAGAACT,0,1099937
fldAp,0.5,1,1,CTTAAATTAGGCTCCGCAGG,0,1066768
fldAp,0.5,1,1,CTTAAAAGGCTAATCTTAGC,0,1169093
fldAp,0.5,1,1,CTGTTTTGGTAGTTTCGGCT,0,1147027
fldAp,0.5,1,1,CTGTTTGCGTTATGCTTAAC,0,1089404
fldAp,0.5,1,1,CTGTGTTACCATACAGTTTC,0,1069570
fldAp,0.5,1,1,CTGTGGCGAGCGACAGCCGT,0,1183691
fldAp,0.5,1,1,CTGTGGAAAGAGGAGTTTCT,0,1164188
fldAp,0.5,1,1,CTGTGCTAGGTAAGCTTAGG,0,1175684
fldAp,0.5,1,1,CTGTCGGTTTAATGTGAAAT,0,1150885
fldAp,0.5,1,1,CTGTCCCAGTGGACAAATCC,0,1158064
fldAp,0.5,1,1,CTGTCACCAAAAGCCCTACC,0,1075606
fldAp,0.5,1,1,CTGTATTGCGCGTCGGGGTC,0,1065707
fldAp,0.5,1,1,CTGTATATAAAGGTCCGCAA,0,1134814
fldAp,0.5,1,1,CTGTACTAACCACCCGGGTT,0,1080697
fldAp,0.5,1,1,CTGGTTGTAGTAGAATGGAA,0,1069132
fldAp,0.5,1,1,CTGGTTGGCACCAGTTGGCT,0,1092710
fldAp,0.5,1,1,CTGGTCCCCTGAAGTATCAT,0,1167860
fldAp,0.5,1,1,CTGGTACTAGACGGGTCATG,0,1150231
fldAp,0.5,1,1,CTGGGTCCATGATAGAGTAT,0,1124702
fldAp,0.5,1,1,CTGGGGTTGCACGGATCCCT,0,1084435
fldAp,0.5,1,1,CTGGGCCAACACAAGGTGAG,0,1096811
fldAp,0.5,1,1,CTGGGATGACCAGCGTTAGG,0,1183594
fldAp,0.5,1,1,CTGGCGACCTGCGTTTAGAT,0,1128338
fldAp,0.5,1,1,CTGGCGAAGAGACTCGATCA,0,1108432
fldAp,0.5,1,1,CTGGCATGCATGTGCGTCGT,0,1097205
fldAp,0.5,1,1,CTGGCACACTATGTTGTTTG,0,1142003
fldAp,0.5,1,1,CTGGATTCCGACTATGCCAA,0,1074644
fldAp,0.5,1,1,CTGGAGTTTTGCAGCATTGC,0,1097530
fldAp,0.5,1,1,CTGGAGAACGGGTCATTCGT,0,1154765
fldAp,0.5,1,1,CTGGACGCCGGGTTAGTGTA,0,1161377
fldAp,0.5,1,1,CTGGAAAGGAGAACATGGAT,0,1113960
fldAp,0.5,1,1,CTGCTAGCGGTCGCCGATTG,0,1115487
fldAp,0.5,1,1,CTGCTACATAAGCAGCGTAA,0,1130125
fldAp,0.5,1,1,CTGCCTTCCGAAGGAGCTCA,0,1106270
fldAp,0.5,1,1,CTGCCTGTCCCATCCATATA,0,1185888
fldAp,0.5,1,1,CTGCCGGCCACTGATTGTCA,0,1093904
fldAp,0.5,1,1,CTGCCATATACAAAAGAGCC,0,1067639
fldAp,0.5,1,1,CTGCCAATGACCCGCTGGAT,0,1182982
fldAp,0.5,1,1,CTGCCAAGTTGGCCATAATA,0,1081561
fldAp,0.5,1,1,CTGCACTGAGATGACTGCTA,0,1064360
fldAp,0.5,1,1,CTGCACGACGGCCCAATCTC,0,1142346
fldAp,0.5,1,1,CTGCACATCTATGAGGGCCA,0,1077852
fldAp,0.5,1,1,CTGATTAAAATCTAGCGTAG,0,1084454
fldAp,0.5,1,1,CTGATCTTCCTAGGACCCAT,0,1119302
fldAp,0.5,1,1,CTGAGTTGACCGTAATATGA,0,1170001
fldAp,0.5,1,1,CTGAGATGTTAAGCCTCGCG,0,1141336
fldAp,0.5,1,1,CTGAGAGGGAAGACGCTGTA,0,1135883
fldAp,0.5,1,1,CTGACGCACTATCAAGCAGG,0,1137051
fldAp,0.5,1,1,CTGACAAGGTCTGTATTCGA,0,1095535
fldAp,0.5,1,1,CTGAAGCCTGACACGGTTAT,0,1151791
fldAp,0.5,1,1,CTGAACTCAATCGTGACATA,0,1157033
fldAp,0.5,1,1,CTGAACACTGCAGAAAGTAT,0,1174151
fldAp,0.5,1,1,CTGAAAGGTTTCTTATTAAG,0,1087469
fldAp,0.5,1,1,CTGAAACGGCCTACGCTTTG,0,1149365
fldAp,0.5,1,1,CTCTTGTGCTGACGCCAAAA,0,1093507
fldAp,0.5,1,1,CTCTTGCCAGGCCAGAACAA,0,1144631
fldAp,0.5,1,1,CTCTTCTTGGGTGACTAAAT,0,1135344
fldAp,0.5,1,1,CTCTTCTGTTTAAATCAAGC,0,1179758
fldAp,0.5,1,1,CTCTTATGCACTTCAGAAGT,0,1152001
fldAp,0.5,1,1,CTCTTAATTCTCATCAGACA,0,1169999
fldAp,0.5,1,1,CTCTGTGCAAGTGCCTTTCG,0,1129342
fldAp,0.5,1,1,CTCTGTCCGAAGTAATTCGG,0,1071993
fldAp,0.5,1,1,CTCTGCCTGCAGCCAAGGTA,0,1122630
fldAp,0.5,1,1,CTCTGCCAACTACGTGAGTG,0,1124724
fldAp,0.5,1,1,CTCTCTTACCGGTGCGCCCC,0,1064603
fldAp,0.5,1,1,CTCTCTAACAGCGGTCGGAT,0,1079192
fldAp,0.5,1,1,CTCTCGTTCAGTTGGAGGTC,0,1171564
fldAp,0.5,1,1,CTCTCGTCCCGTCATTAATC,0,1160089
fldAp,0.5,1,1,CTCTCGGGAGCCGTCAGGCG,0,1160794
fldAp,0.5,1,1,CTCTCGGGACCACGCCTAGT,0,1094715
fldAp,0.5,1,1,CTCTCGGAGTACCATAACCA,0,1177076
fldAp,0.5,1,1,CTCTCCGTCATTAGTCGATT,0,1130268
fldAp,0.5,1,1,CTCTCCGCACTGTTTGTTTT,0,1139892
fldAp,0.5,1,1,CTCTCAGATTAAGACTCTGA,0,1064681
fldAp,0.5,1,1,CTCTCACTCCCGGGTAGAAG,0,1147362
fldAp,0.5,1,1,CTCTATGCCTAGTCTAAAGT,0,1072878
fldAp,0.5,1,1,CTCTACTTTGGAAACGCTCG,0,1127750
fldAp,0.5,1,1,CTCTACCCCTCCATATTCAC,0,1163264
fldAp,0.5,1,1,CTCGTTGGCTCCGACTATCA,0,1078851
fldAp,0.5,1,1,CTCGTGAAAAGAGATGATTG,0,1105712
fldAp,0.5,1,1,CTCGTCCCATATTTGTCTTC,0,1113323
fldAp,0.5,1,1,CTCGGGTTACCTACTTATAG,0,1128185
fldAp,0.5,1,1,CTCGGGCAATAAAGGTATTT,0,1096191
fldAp,0.5,1,1,CTCGGCTTGCTTCACGCAGG,0,1130661
fldAp,0.5,1,1,CTCGGAGGTGAACACGCGCT,0,1138864
fldAp,0.5,1,1,CTCGCTGGATCGCATGTAAT,0,1170580
fldAp,0.5,1,1,CTCGCGACAGTACATTCAAA,0,1074139
fldAp,0.5,1,1,CTCGCCAATGTTTGCACGTA,0,1101907
fldAp,0.5,1,1,CTCGCATAATCTATATATTC,0,1121006
fldAp,0.5,1,1,CTCGCAGAGTGTGTGATTAT,0,1152179
fldAp,0.5,1,1,CTCGATCAGGCAAGGAGTTC,0,1139268
fldAp,0.5,1,1,CTCGAGGATAGCAAGCGGCG,0,1160956
fldAp,0.5,1,1,CTCGACTGCGGGCACACCCC,0,1168986
fldAp,0.5,1,1,CTCGACGGTATTGTAGCCTT,0,1142084
fldAp,0.5,1,1,CTCGAATGTCATGTGCAATC,0,1142412
fldAp,0.5,1,1,CTCCTTGGATTGGACGCTGT,0,1095893
fldAp,0.5,1,1,CTCCTTCATGACGAGTTGCA,0,1070084
fldAp,0.5,1,1,CTCCTGAAGCCCCAGGACAA,0,1127892
fldAp,0.5,1,1,CTCCTCTCCTGATATCTATA,0,1120163
fldAp,0.5,1,1,CTCCGTTACTGAATCACCGG,0,1102328
fldAp,0.5,1,1,CTCCGGAAAGACAGACCGTT,0,1099052
fldAp,0.5,1,1,CTCCGCCCATGAGAACCGGA,0,1123301
fldAp,0.5,1,1,CTCCGACGGTGTATCACTCC,0,1157642
fldAp,0.5,1,1,CTCCCTCAGGGCTGGGCACT,0,1103125
fldAp,0.5,1,1,CTCCATTTGGTTTTTATTAT,0,1178153
fldAp,0.5,1,1,CTCCAATAAGCATACCCACG,0,1181462
fldAp,0.5,1,1,CTCATTTCTGCGCAACCATA,0,1110397
fldAp,0.5,1,1,CTCATGCAAGGGACATACGT,0,1121475
fldAp,0.5,1,1,CTCATCCCAGCGTAAGTTGA,0,1156144
fldAp,0.5,1,1,CTCATATCCCCGTCGTGTGG,0,1116430
fldAp,0.5,1,1,CTCATACGTACGTATTTCGT,0,1086770
fldAp,0.5,1,1,CTCAGTTATTCCTGCATTCT,0,1167737
fldAp,0.5,1,1,CTCAGTCGCAGCAGAGTCTA,0,1087865
fldAp,0.5,1,1,CTCAGCTGGGGCTCTTCAAT,0,1135078
fldAp,0.5,1,1,CTCAGCTGCTTCACAGGATC,0,1171426
fldAp,0.5,1,1,CTCAGCGCCAGTGTCATAAC,0,1096907
fldAp,0.5,1,1,CTCAGCGAGGGTTGCGAGGA,0,1182331
fldAp,0.5,1,1,CTCAGCAAAAGTGCCAAGAG,0,1113566
fldAp,0.5,1,1,CTCACTCCTTTATACGAACT,0,1158691
fldAp,0.5,1,1,CTCACGGGGGGATACGCATA,0,1104524
fldAp,0.5,1,1,CTCACGCGAAAGGCGCGGCC,0,1088731
fldAp,0.5,1,1,CTCAATTGTATAGTCCGCCG,0,1122388
fldAp,0.5,1,1,CTCAATATGATCCGTTTCCT,0,1127155
fldAp,0.5,1,1,CTCAAGCCCCGAGCTTTAAA,0,1148397
fldAp,0.5,1,1,CTCAACCCAGAGCTTAATCA,0,1152334
fldAp,0.5,1,1,CTATTTCACCTAGATCTCGT,0,1117145
fldAp,0.5,1,1,CTATTGAGATAGGGGTAGAA,0,1148703
fldAp,0.5,1,1,CTATTCATAGACCAGAACCC,0,1098121
fldAp,0.5,1,1,CTATTCAAAACCAGACTCGC,0,1099061
fldAp,0.5,1,1,CTATGTTACTCCTTGCAATT,0,1185689
fldAp,0.5,1,1,CTATGCGCTAGGATTCCAGT,0,1137676
fldAp,0.5,1,1,CTATGACGAGGGCTGGCTCT,0,1161894
fldAp,0.5,1,1,CTATCTTGACTGGATGCAAG,0,1124697
fldAp,0.5,1,1,CTATCGTGGCTTGATCTAAA,0,1078426
fldAp,0.5,1,1,CTATCCTCTCTTCCGGGAGG,0,1137081
fldAp,0.5,1,1,CTATCCTACTGTGTCAAATC,0,1114901
fldAp,0.5,1,1,CTATCAGTAATATCAGGTAC,0,1129349
fldAp,0.5,1,1,CTATCAGAAAGTTAGATAGA,0,1063127
fldAp,0.5,1,1,CTATACTTGAATTAGAGCCC,0,1155550
fldAp,0.5,1,1,CTATACCAGCATATCCTGTG,0,1065181
fldAp,0.5,1,1,CTATAAGACATGAGATCTTA,0,1063608
fldAp,0.5,1,1,CTAGTTCGAAGTGCAGCAGG,0,1139813
fldAp,0.5,1,1,CTAGTGACAGAGAGTATGGT,0,1105748
fldAp,0.5,1,1,CTAGTCGTGCATGTCGGCCT,0,1165663
fldAp,0.5,1,1,CTAGGGGAACGGGTCAATAT,0,1175543
fldAp,0.5,1,1,CTAGGCTTGTCTAGAATCTT,0,1103616
fldAp,0.5,1,1,CTAGGATTGCTATGAATTGA,0,1157342
fldAp,0.5,1,1,CTAGCTTAGCCAACCCCCGC,0,1087775
fldAp,0.5,1,1,CTAGCGTGGCAAAAATCTTC,0,1113214
fldAp,0.5,1,1,CTAGCCCAGGTATCCCAGGT,0,1163387
fldAp,0.5,1,1,CTAGCCAAGTTCAAATCTAT,0,1063777
fldAp,0.5,1,1,CTAGCAAAGGCTTTATGCCA,0,1075683
fldAp,0.5,1,1,CTAGAGGTGCCGGAGACAAC,0,1135396
fldAp,0.5,1,1,CTAGAGATAGCACGTCCCCA,0,1130747
fldAp,0.5,1,1,CTACTTCTGGGCATTGAAGG,0,1120402
fldAp,0.5,1,1,CTACTTAGTAGTTGTCTTAT,0,1174519
fldAp,0.5,1,1,CTACTGCCCGCTCAATGAAA,0,1099835
fldAp,0.5,1,1,CTACTCTTCAACACTGCTCG,0,1108097
fldAp,0.5,1,1,CTACTATCAAGTCATCAAGT,0,1098334
fldAp,0.5,1,1,CTACGTTTATTCTGGCGAAC,0,1131891
fldAp,0.5,1,1,CTACGTCCGCTTAGAGTTAA,0,1174216
fldAp,0.5,1,1,CTACGGCTGCTCGAACGCGA,0,1101149
fldAp,0.5,1,1,CTACGGCCCATTCACGCCTA,0,1132630
fldAp,0.5,1,1,CTACCGAGGCGGGCCTTTGT,0,1123231
fldAp,0.5,1,1,CTACACGGCTGAGGTGGACA,0,1162804
fldAp,0.5,1,1,CTACAAAGTCCTTGCCGGGG,0,1099049
fldAp,0.5,1,1,CTAATTATGCCACAGAGTCA,0,1092381
fldAp,0.5,1,1,CTAATGTGGATCGTCATCAA,0,1070813
fldAp,0.5,1,1,CTAATCCGGTGGCCTCGTGC,0,1092066
fldAp,0.5,1,1,CTAAGTAGTAAGCTGGGACC,0,1122504
fldAp,0.5,1,1,CTAAGGTCGTCGATAAAGCG,0,1086754
fldAp,0.5,1,1,CTAAGGGGCGCCTGGCAGCT,0,1132022
fldAp,0.5,1,1,CTAAGGCGCTTCTTTGTGTT,0,1072904
fldAp,0.5,1,1,CTAAGCTAAACGAGCGACAG,0,1094120
fldAp,0.5,1,1,CTAACTTCCGGGGATTTTAA,0,1118427
fldAp,0.5,1,1,CTAACTCGGGTCCGAACAGG,0,1094873
fldAp,0.5,1,1,CTAACAGCTCCATAAAACCA,0,1115565
fldAp,0.5,1,1,CTAACACTATAGACTGCGGT,0,1124522
fldAp,0.5,1,1,CTAAATGCCTGAACCCAGTC,0,1168297
fldAp,0.5,1,1,CTAAATCACTGCTGACCGCA,0,1172203
fldAp,0.5,1,1,CTAAATCACCCGGTGTCTCC,0,1074895
fldAp,0.5,1,1,CTAAACATATGCGACTTCAG,0,1109029
fldAp,0.5,1,1,CTAAAATGGACCTCGGTTCT,0,1140073
fldAp,0.5,1,1,CGTTTTTGTGGCGGCGTTAA,0,1165666
fldAp,0.5,1,1,CGTTTTTCGGGTCGTGGGCT,0,1139418
fldAp,0.5,1,1,CGTTTTTAGCGGCCTCAGAC,0,1086278
fldAp,0.5,1,1,CGTTTTCAGCAATCTCATTT,0,1111204
fldAp,0.5,1,1,CGTTTGGCAGTACCGAGTGT,0,1147486
fldAp,0.5,1,1,CGTTTGCGCTCAAGGTCGCT,0,1097057
fldAp,0.5,1,1,CGTTTGCGAGACAGAATACT,0,1179076
fldAp,0.5,1,1,CGTTTGCACGTAGTGAGTCT,0,1140981
fldAp,0.5,1,1,CGTTTAAATAATAGTTCGTT,0,1130976
fldAp,0.5,1,1,CGTTGTTTCAATATGCTTTG,0,1176839
fldAp,0.5,1,1,CGTTGTTCGCCCCAAACATC,0,1075985
fldAp,0.5,1,1,CGTTGTCTGCCTTCAAACTA,0,1106008
fldAp,0.5,1,1,CGTTGTCCGGGTGTAGGGAA,0,1178374
fldAp,0.5,1,1,CGTTGTCAAATCCATTGGTA,0,1072868
fldAp,0.5,1,1,CGTTGGTGGGCGGGGTTTGC,0,1137310
fldAp,0.5,1,1,CGTTGAAATAGGGAGTTCGA,0,1177363
fldAp,0.5,1,1,CGTTCATCGCGCGCGCAATA,0,1186240
fldAp,0.5,1,1,CGTTATGGACTGAATTAATT,0,1133554
fldAp,0.5,1,1,CGTTATGCCGACGCCCAAGG,0,1073994
fldAp,0.5,1,1,CGTTAGATATTAACGATAAG,0,1113432
fldAp,0.5,1,1,CGTTAACAAAGTTACTCCCT,0,1067141
fldAp,0.5,1,1,CGTGTTCTTTGGCACAGCTT,0,1179082
fldAp,0.5,1,1,CGTGTTACAAGAGTATGCAT,0,1131897
fldAp,0.5,1,1,CGTGTGGAATAGGGTCTTGT,0,1115911
fldAp,0.5,1,1,CGTGTACGAGTTTCCGTGTC,0,1150360
fldAp,0.5,1,1,CGTGTAAGATGGACCCTGAC,0,1173216
fldAp,0.5,1,1,CGTGGAAGGCGTATAGGGGC,0,1063161
fldAp,0.5,1,1,CGTGCTGGAGCCAGCGGGAG,0,1129416
fldAp,0.5,1,1,CGTGCGGGGACGATAAGTGT,0,1086301
fldAp,0.5,1,1,CGTGCGGATTGAGTACATAA,0,1131540
fldAp,0.5,1,1,CGTGCCGGCTTTATCATGCA,0,1171272
fldAp,0.5,1,1,CGTGCCGCTTCGATTGGACT,0,1104770
fldAp,0.5,1,1,CGTGCCCTCTTGTTCATTCC,0,1179810
fldAp,0.5,1,1,CGTGCACAGGAACATCGTCG,0,1120143
fldAp,0.5,1,1,CGTGCAAATTCGCGACCAGT,0,1091925
fldAp,0.5,1,1,CGTGATCGAGTTAGTTAGTT,0,1103876
fldAp,0.5,1,1,CGTGACCCACAACCGTAGGA,0,1078344
fldAp,0.5,1,1,CGTGAAATGTATGCAGCCAA,0,1161037
fldAp,0.5,1,1,CGTCTGGACTGCGTACTGTT,0,1132989
fldAp,0.5,1,1,CGTCTCTTACAGCCGTACTT,0,1148112
fldAp,0.5,1,1,CGTCTCGTAAGACCATTGTC,0,1147889
fldAp,0.5,1,1,CGTCTCCCGTTTTGTCATGC,0,1073906
fldAp,0.5,1,1,CGTCTAGAGTGTGCTTACAT,0,1157561
fldAp,0.5,1,1,CGTCTACCCCAACATCTTCA,0,1064922
fldAp,0.5,1,1,CGTCTACAAGGAGTATCGTA,0,1120288
fldAp,0.5,1,1,CGTCGTGTCGCCACTGATTC,0,1164957
fldAp,0.5,1,1,CGTCGATTTGAAGAGCCAGA,0,1167265
fldAp,0.5,1,1,CGTCGATAGAAGCCACTAAC,0,1140506
fldAp,0.5,1,1,CGTCCGTTAGCTGTGCCATG,0,1118217
fldAp,0.5,1,1,CGTCATGGCGGGGTGGCTCG,0,1094818
fldAp,0.5,1,1,CGTCAGCACGGAGTGGCATA,0,1069514
fldAp,0.5,1,1,CGTCACTTTTCGGCTTAAAG,0,1067509
fldAp,0.5,1,1,CGTCACGTTGCAATAATCCT,0,1087081
fldAp,0.5,1,1,CGTCACAGGTGTAATTGTTC,0,1130003
fldAp,0.5,1,1,CGTCAAGTCGGTCTGGTACG,0,1140099
fldAp,0.5,1,1,CGTATTGCTGCACATCACAC,0,1077348
fldAp,0.5,1,1,CGTATTCCATCTGAAAATGT,0,1126104
fldAp,0.5,1,1,CGTATTAGCCGCTATGGAGG,0,1140316
fldAp,0.5,1,1,CGTATGTTAGGACCGTTTTC,0,1152330
fldAp,0.5,1,1,CGTATGTATCGATTCGGGGG,0,1179788
fldAp,0.5,1,1,CGTATATATTGGGTAGGGCT,0,1163675
fldAp,0.5,1,1,CGTATAGTTCGGACTCACTT,0,1084311
fldAp,0.5,1,1,CGTATACGATTTGACTTGAA,0,1131230
fldAp,0.5,1,1,CGTAGGTACACCGCGAGCAG,0,1078266
fldAp,0.5,1,1,CGTAGGGATACGGATACGCG,0,1096401
fldAp,0.5,1,1,CGTAGGACTTTCCATACAAC,0,1142933
fldAp,0.5,1,1,CGTAGCAGGCGCTTATAGCA,0,1158048
fldAp,0.5,1,1,CGTAGACATAGAGCCAGGAA,0,1164846
fldAp,0.5,1,1,CGTACTTCTGGCATCGGCAT,0,1121254
fldAp,0.5,1,1,CGTACTGTAATATCACTTCC,0,1177594
fldAp,0.5,1,1,CGTACCAAAGGTTACGTCTT,0,1175610
fldAp,0.5,1,1,CGTAATGGTGGGGACGGTGA,0,1145129
fldAp,0.5,1,1,CGTAAGGCAACGTATGTCTA,0,1087361
fldAp,0.5,1,1,CGTAACCGAGCGCCCGCAAC,0,1173075
fldAp,0.5,1,1,CGTAAAAGCCATGTGGTCGC,0,1083244
fldAp,0.5,1,1,CGGTTTTGTCCCGGCACCAA,0,1146005
fldAp,0.5,1,1,CGGTTTGCAAACATCAGTAG,0,1167258
fldAp,0.5,1,1,CGGTTTCACGGAGTTCCTTG,0,1080590
fldAp,0.5,1,1,CGGTTGTCCGTTGAACCCTC,0,1177087
fldAp,0.5,1,1,CGGTTGGTCTTGCGTTTTAA,0,1114120
fldAp,0.5,1,1,CGGTTCTTAATGGCCTACGA,0,1103323
fldAp,0.5,1,1,CGGTTCTCACTTAATGATCT,0,1103660
fldAp,0.5,1,1,CGGTTCGCCGAAATGGTGTT,0,1081260
fldAp,0.5,1,1,CGGTTCGAGTACTTAAACGC,0,1090584
fldAp,0.5,1,1,CGGTTAGATGCGCACGCCGG,0,1171063
fldAp,0.5,1,1,CGGTTAAGACCGGCGTGTAT,0,1150236
fldAp,0.5,1,1,CGGTTAAAGTGCGCTCGAGC,0,1130009
fldAp,0.5,1,1,CGGTGTCTCCAGTAGACATC,0,1072295
fldAp,0.5,1,1,CGGTGTCGTTTTTCGTCCGA,0,1081569
fldAp,0.5,1,1,CGGTGGCGGCCCTTTCTCGA,0,1156430
fldAp,0.5,1,1,CGGTGGCGCAGGAATACGTT,0,1174241
fldAp,0.5,1,1,CGGTGCAGCAATGGGAGGTA,0,1150753
fldAp,0.5,1,1,CGGTGAGGGTTCCGATGGCT,0,1126182
fldAp,0.5,1,1,CGGTCAAGTTTGAGAGGCGT,0,1128160
fldAp,0.5,1,1,CGGTCAACGCGGCTACGCAT,0,1158151
fldAp,0.5,1,1,CGGTAGGATTTCACGACAGT,0,1148628
fldAp,0.5,1,1,CGGTAGATTAGGGAATAAAA,0,1132735
fldAp,0.5,1,1,CGGTACTGCAAGACTTAGTA,0,1127189
fldAp,0.5,1,1,CGGTACAGTATTGCGCGGAC,0,1084836
fldAp,0.5,1,1,CGGTACACGGCACACTGTAT,0,1174079
fldAp,0.5,1,1,CGGGTGGCGGCACGACAAAT,0,1141135
fldAp,0.5,1,1,CGGGTGAATGTTACGACCCA,0,1092572
fldAp,0.5,1,1,CGGGTCTATTTACAGACTAG,0,1064093
fldAp,0.5,1,1,CGGGTCGGGTCTACTCGCAC,0,1128806
fldAp,0.5,1,1,CGGGTCCAAATACAACACAT,0,1171740
fldAp,0.5,1,1,CGGGTACCAACCATAGTCAT,0,1067532
fldAp,0.5,1,1,CGGGGGTAGCTTCGGTATAT,0,1146911
fldAp,0.5,1,1,CGGGGCACGTGGCGTTCGGT,0,1162016
fldAp,0.5,1,1,CGGGCTTTGAAGGTACAGCT,0,1095005
fldAp,0.5,1,1,CGGGCTCCGTCGTGCATGTC,0,1095732
fldAp,0.5,1,1,CGGGCCATACGATCTACTCC,0,1080433
fldAp,0.5,1,1,CGGGCATTAGGCGTGGCTCG,0,1085469
fldAp,0.5,1,1,CGGGATCTCGTATGTCAGGG,0,1092762
fldAp,0.5,1,1,CGGGACAGTGACAGGTTATT,0,1170691
fldAp,0.5,1,1,CGGGAATTCACTGTCACGAC,0,1088947
fldAp,0.5,1,1,CGGGAATCATGCTCCACTCC,0,1165161
fldAp,0.5,1,1,CGGGAAGAGTGATGGCTGGG,0,1159039
fldAp,0.5,1,1,CGGGAACAAACAATCGGCCC,0,1075431
fldAp,0.5,1,1,CGGCTTGTTTCCTCTCGGCA,0,1106517
fldAp,0.5,1,1,CGGCTGGGCGGCGGTAAGGT,0,1085707
fldAp,0.5,1,1,CGGCTGCATGGTAGGCGTTC,0,1137199
fldAp,0.5,1,1,CGGCTGACACGGTGCTCTAC,0,1091171
fldAp,0.5,1,1,CGGCTCACAGCTCAAGGTGT,0,1177680
fldAp,0.5,1,1,CGGCTAGCCAAGACCTCAAA,0,1152692
fldAp,0.5,1,1,CGGCGTTGCGCAGGTTGCCA,0,1146657
fldAp,0.5,1,1,CGGCGTCGGATATTTTCTGC,0,1186862
fldAp,0.5,1,1,CGGCGTACGGAAGAATATCA,0,1146926
fldAp,0.5,1,1,CGGCGGGATGTCGTGGTATA,0,1068315
fldAp,0.5,1,1,CGGCCGGAAATTCGGCGGAC,0,1066131
fldAp,0.5,1,1,CGGCCATCGTGGGCTCCCTC,0,1101335
fldAp,0.5,1,1,CGGCCACGCGGATTGCCGCT,0,1162583
fldAp,0.5,1,1,CGGCATTGTACCTCTAAGTG,0,1164617
fldAp,0.5,1,1,CGGCAGTTCCATAGTCGGCA,0,1174664
fldAp,0.5,1,1,CGGCACTTGTCTGGGCACAC,0,1066636
fldAp,0.5,1,1,CGGCACTCGACCCTAAAGAG,0,1063529
fldAp,0.5,1,1,CGGCACTAACGGACGTATAC,0,1114115
fldAp,0.5,1,1,CGGCACGATCTAGGAAGCAT,0,1185834
fldAp,0.5,1,1,CGGCACCTAGTGTAGTTAGC,0,1106955
fldAp,0.5,1,1,CGGCACACTCTTGCCTAGGT,0,1110182
fldAp,0.5,1,1,CGGATTCATGGCGTTGGACT,0,1095250
fldAp,0.5,1,1,CGGATGTTTCGGTGGTACTA,0,1158839
fldAp,0.5,1,1,CGGATGTGAGATTACAGGCG,0,1105495
fldAp,0.5,1,1,CGGATGGTACTATTTGCACG,0,1119204
fldAp,0.5,1,1,CGGATGCCTGGGCAATCATA,0,1180194
fldAp,0.5,1,1,CGGATACGTTTTAGGAACGG,0,1143279
fldAp,0.5,1,1,CGGAGTTCCGGAAGCGCTCT,0,1176335
fldAp,0.5,1,1,CGGAGTGGCAAGCGGACATT,0,1072296
fldAp,0.5,1,1,CGGAGGGTCTTATAAAGCGA,0,1164428
fldAp,0.5,1,1,CGGAGCGTGCCTCGCAATGA,0,1106441
fldAp,0.5,1,1,CGGAGCATAGTCCGATTCGG,0,1160406
fldAp,0.5,1,1,CGGACCGGTTGCGTTGCTTC,0,1072148
fldAp,0.5,1,1,CGGACCACGCAGGTCGTTTC,0,1122527
fldAp,0.5,1,1,CGGAATTTGAAAGCGTTAAT,0,1091049
fldAp,0.5,1,1,CGGAATGCCCACGCGAGCTT,0,1069094
fldAp,0.5,1,1,CGGAATCTTTTACTGGACGT,0,1156875
fldAp,0.5,1,1,CGGAAGGTCGGACAAGGGGA,0,1156738
fldAp,0.5,1,1,CGGAAGATTGTTTCCGTAGG,0,1129474
fldAp,0.5,1,1,CGGAAGATAGATTTATCGTC,0,1117109
fldAp,0.5,1,1,CGGAACGTCATAACACGAAC,0,1165232
fldAp,0.5,1,1,CGGAAACAGCTGCCCATCCT,0,1131261
fldAp,0.5,1,1,CGCTTTTATTTTGTGTCAGC,0,1131835
fldAp,0.5,1,1,CGCTTTCGAGGAGAACATAA,0,1098582
fldAp,0.5,1,1,CGCTTGCGTATACCAACGAG,0,1092870
fldAp,0.5,1,1,CGCTTGAAATAGGTTTCTGG,0,1180087
fldAp,0.5,1,1,CGCTGCATTGAATACGTAGT,0,1129058
fldAp,0.5,1,1,CGCTGAGCCCAAATATTGTC,0,1077064
fldAp,0.5,1,1,CGCTGAAACCCACGTGTACT,0,1068970
fldAp,0.5,1,1,CGCTCTTAATTTCCGGCCGC,0,1176331
fldAp,0.5,1,1,CGCTCCCTCAATCGAGTGGG,0,1105284
fldAp,0.5,1,1,CGCTACCTCGTGATTCCTCC,0,1152320
fldAp,0.5,1,1,CGCTAAGGGGGTGACGTGAT,0,1145657
fldAp,0.5,1,1,CGCGTTGTTTGGCGGAAATG,0,1077753
fldAp,0.5,1,1,CGCGTTGTATGATGCATTCC,0,1138785
fldAp,0.5,1,1,CGCGTTGTACACACGTATCA,0,1154748
fldAp,0.5,1,1,CGCGTTGCACGGTACGAAAA,0,1088385
fldAp,0.5,1,1,CGCGTTCTACTGAAATCCGC,0,1144014
fldAp,0.5,1,1,CGCGTGTTACTTTGTCATAA,0,1165651
fldAp,0.5,1,1,CGCGGTTCAAGCAGTGTGAG,0,1133768
fldAp,0.5,1,1,CGCGGTAGGTAAGTTACTGT,0,1108482
fldAp,0.5,1,1,CGCGGGTCGGGCGGGACGCA,0,1095551
fldAp,0.5,1,1,CGCGGCGATTGAGTGCGTTC,0,1078168
fldAp,0.5,1,1,CGCGGAATACTGTATCCGGA,0,1150577
fldAp,0.5,1,1,CGCGCGGCTAAAAAGATGCA,0,1087307
fldAp,0.5,1,1,CGCGCATGTCTCGCGAACAA,0,1151155
fldAp,0.5,1,1,CGCGCATACGTATGCCCCAT,0,1181029
fldAp,0.5,1,1,CGCGCACCGGGCTTGCGTGT,0,1133973
fldAp,0.5,1,1,CGCGCAATTGGATGGCCCTG,0,1127798
fldAp,0.5,1,1,CGCGAGTAGCTGATCATCTG,0,1130184
fldAp,0.5,1,1,CGCGACGCACTCCCAGTTCC,0,1170009
fldAp,0.5,1,1,CGCGACAATGATCGCTGTGG,0,1084502
fldAp,0.5,1,1,CGCCTGATTTATGTTTTGCG,0,1101601
fldAp,0.5,1,1,CGCCTCATGCTACACACCGT,0,1157439
fldAp,0.5,1,1,CGCCGGTCCTCGCCGCGTCC,0,1095084
fldAp,0.5,1,1,CGCCGGCCCCCTGAATGATA,0,1186784
fldAp,0.5,1,1,CGCCGCGAGAATTTCTACAA,0,1122387
fldAp,0.5,1,1,CGCCGCCCCAATTCGTGGTC,0,1145426
fldAp,0.5,1,1,CGCCCTATAGGTAGCAGAAT,0,1091749
fldAp,0.5,1,1,CGCCCGGTAACAAAGTCGTA,0,1161449
fldAp,0.5,1,1,CGCCCGCTGGTGCAAGCTAT,0,1132149
fldAp,0.5,1,1,CGCCCGCGAACCCCACAAGA,0,1116195
fldAp,0.5,1,1,CGCCCGACTCCTATACTAAT,0,1063412
fldAp,0.5,1,1,CGCCCGAACATTATATATAG,0,1065164
fldAp,0.5,1,1,CGCCCAGCTGTTACTCGCAA,0,1167153
fldAp,0.5,1,1,CGCCCAAGGATTATCATAAA,0,1137550
fldAp,0.5,1,1,CGCCAGTCCTCTCTTCGCTG,0,1123649
fldAp,0.5,1,1,CGCCAGAGGTGGAATGCGCG,0,1156881
fldAp,0.5,1,1,CGCCACTTGGATGTATAGCG,0,1115231
fldAp,0.5,1,1,CGCCACTCTATTCTAACTAC,0,1153088
fldAp,0.5,1,1,CGCCAAACAGTACAAAAGCC,0,1110270
fldAp,0.5,1,1,CGCATTTGTTGTGGGAATTT,0,1157388
fldAp,0.5,1,1,CGCATGCTTCGGTGGTATAA,0,1119688
fldAp,0.5,1,1,CGCAGTCGGGTACGGGTATC,0,1087899
fldAp,0.5,1,1,CGCAGGGCCACCGTTAGTTC,0,1110921
fldAp,0.5,1,1,CGCAGGAGTCGCCACGGACT,0,1104712
fldAp,0.5,1,1,CGCAGCACTGATACAACTCG,0,1181526
fldAp,0.5,1,1,CGCAGATGAATGCCTGGGCC,0,1164340
fldAp,0.5,1,1,CGCACTCTCGGGCACCTTAT,0,1185762
fldAp,0.5,1,1,CGCACGCTCGGAAATGACAC,0,1167679
fldAp,0.5,1,1,CGCACCTGCATACGTCCACT,0,1129905
fldAp,0.5,1,1,CGCACCAGTAGACTACCGTA,0,1099782
fldAp,0.5,1,1,CGCAATCGATCGTTGTAACG,0,1180978
fldAp,0.5,1,1,CGCAAGATGCAAACGCTAGT,0,1086884
fldAp,0.5,1,1,CGCAAGACTGCCTCCACTCC,0,1174813
fldAp,0.5,1,1,CGCAACTGAGACCGTATCGG,0,1096756
fldAp,0.5,1,1,CGCAAATGCCTCGTAGAGAG,0,1100225
fldAp,0.5,1,1,CGCAAACGAGGACAGGGACT,0,1078889
fldAp,0.5,1,1,CGCAAAATTCAACGTAAACA,0,1067199
fldAp,0.5,1,1,CGATTTGGTTTACTTAACTC,0,1148587
fldAp,0.5,1,1,CGATTTAGAGTCGGGGAAGG,0,1156463
fldAp,0.5,1,1,CGATTGTTGCCTTTCGGAGT,0,1077379
fldAp,0.5,1,1,CGATTGCTTATTGATCAATC,0,1159025
fldAp,0.5,1,1,CGATTGAACCAATGGACCCC,0,1157299
fldAp,0.5,1,1,CGATGTTCGCCCGGTCCTGT,0,1120005
fldAp,0.5,1,1,CGATGGGAATATCGGCCTCG,0,1068773
fldAp,0.5,1,1,CGATGCCATACGACACACTT,0,1123758
fldAp,0.5,1,1,CGATGCATCATCCAAAACGG,0,1150574
fldAp,0.5,1,1,CGATCTCATTAGCCTCAACA,0,1175375
fldAp,0.5,1,1,CGATCCTGTTCGCTGCGGCT,0,1092923
fldAp,0.5,1,1,CGATCAAGCTGGGACACTGT,0,1092193
fldAp,0.5,1,1,CGATATCACCATTGTTCGCG,0,1186305
fldAp,0.5,1,1,CGATAGCGTCGGACACAGCA,0,1118262
fldAp,0.5,1,1,CGAGTTGGCCGATTCGTAAT,0,1107369
fldAp,0.5,1,1,CGAGTGCACTCGCATCGAGT,0,1182184
fldAp,0.5,1,1,CGAGTCGCAGGACGAAAAGG,0,1116300
fldAp,0.5,1,1,CGAGTCCTCTGAACCCGATT,0,1157723
fldAp,0.5,1,1,CGAGTAGTGTTGAAATCGAA,0,1078934
fldAp,0.5,1,1,CGAGTACTGTAACAGCTACG,0,1122593
fldAp,0.5,1,1,CGAGGTCCGCATTTACAGCG,0,1080165
fldAp,0.5,1,1,CGAGGGGCGTGTTAATCATC,0,1166550
fldAp,0.5,1,1,CGAGGCTCCGGTCCTCACTG,0,1180763
fldAp,0.5,1,1,CGAGGCACTCGCGAAGCGCG,0,1125285
fldAp,0.5,1,1,CGAGGAGAGATTATAAGGCA,0,1151398
fldAp,0.5,1,1,CGAGCTTGGTGTATTGCTTC,0,1183307
fldAp,0.5,1,1,CGAGCTATGCGCGGATCCAA,0,1123007
fldAp,0.5,1,1,CGAGCGTCGGGACGTGAGAG,0,1181784
fldAp,0.5,1,1,CGAGCGATTTAGCTATCGCC,0,1102455
fldAp,0.5,1,1,CGAGCCGCGGCGCCAGTCCC,0,1135946
fldAp,0.5,1,1,CGAGCATAAGGCGCGTGAAG,0,1093945
fldAp,0.5,1,1,CGAGCAAATGGGATTCACTA,0,1099035
fldAp,0.5,1,1,CGAGATTTATGGTGGGGAGT,0,1105675
fldAp,0.5,1,1,CGAGATCGGAGGTTTCCATA,0,1124692
fldAp,0.5,1,1,CGAGAGGTACAGGTATCATA,0,1078205
fldAp,0.5,1,1,CGAGACGCTGTTTGATAGGC,0,1153019
fldAp,0.5,1,1,CGAGACGCATTGGGGGAAGC,0,1170466
fldAp,0.5,1,1,CGACTTTCATGCAGTAATCT,0,1153552
fldAp,0.5,1,1,CGACTTGGTTAATTTGTTAG,0,1078050
fldAp,0.5,1,1,CGACTTGGGCCGCTGCGGGG,0,1093489
fldAp,0.5,1,1,CGACTGGGCTTTACTTTGTC,0,1165152
fldAp,0.5,1,1,CGACTCTACTCGCCCGGGAC,0,1143287
fldAp,0.5,1,1,CGACTCCTGAACTACGCTTT,0,1172303
fldAp,0.5,1,1,CGACTCATATCCAAAGTCTT,0,1169227
fldAp,0.5,1,1,CGACTAACAGCTTATTCTTT,0,1121481
fldAp,0.5,1,1,CGACGTATCAATAATGCCGT,0,1160787
fldAp,0.5,1,1,CGACGATCTTAAATGCAACT,0,1102354
fldAp,0.5,1,1,CGACGAGCACCCCGTCGAAG,0,1089690
fldAp,0.5,1,1,CGACGACACGGGTAGAGCCT,0,1096300
fldAp,0.5,1,1,CGACCAGGTACGCATCTCTA,0,1105078
fldAp,0.5,1,1,CGACACTGTACAGAAGAGCT,0,1170095
fldAp,0.5,1,1,CGACACCGTCAATCAAGGAC,0,1082531
fldAp,0.5,1,1,CGAATTGGTAATCATACTCC,0,1066879
fldAp,0.5,1,1,CGAATTCGCCTCTCAGGAAT,0,1165670
fldAp,0.5,1,1,CGAATTAGGGTCCAAAAATA,0,1095903
fldAp,0.5,1,1,CGAATCTGAGTTAAGCCTTC,0,1182164
fldAp,0.5,1,1,CGAATCAGTATCGGGTATGA,0,1071400
fldAp,0.5,1,1,CGAAGTCCACCGGAAATGGA,0,1113403
fldAp,0.5,1,1,CGAAGGCAACTATGGGGGAT,0,1121876
fldAp,0.5,1,1,CGAAGCGCTTGCGCTATATG,0,1076062
fldAp,0.5,1,1,CGAACTCAATGTTGTAAAAG,0,1111850
fldAp,0.5,1,1,CGAACGGTTCTAACACAATT,0,1100387
fldAp,0.5,1,1,CGAACGGCCACAAGCTACAC,0,1099731
fldAp,0.5,1,1,CGAACGGCCAATCCGCTGGC,0,1179473
fldAp,0.5,1,1,CGAACCTTAAATTTTCTGAG,0,1144936
fldAp,0.5,1,1,CGAACCCTGCTAGGTGGAAA,0,1104221
fldAp,0.5,1,1,CGAACCATCTTTTGCATGGA,0,1154517
fldAp,0.5,1,1,CGAACATACCCGTTTGGGAG,0,1095534
fldAp,0.5,1,1,CGAAATTACTTTAGATATCG,0,1157833
fldAp,0.5,1,1,CGAAATTAATGTTGGGGGTG,0,1182993
fldAp,0.5,1,1,CGAAAGTGTCCGTGCAGCTA,0,1149806
fldAp,0.5,1,1,CGAAAGCGTTCATGTGGACC,0,1177753
fldAp,0.5,1,1,CCTTTTTCCAGATCGACATC,0,1085799
fldAp,0.5,1,1,CCTTTGTAGCTTGCCCTCCT,0,1139333
fldAp,0.5,1,1,CCTTTGGATAGGCGGGATAG,0,1166178
fldAp,0.5,1,1,CCTTTAAGACTCCGTCTAAA,0,1161413
fldAp,0.5,1,1,CCTTGTCACTATAACGCGGA,0,1106271
fldAp,0.5,1,1,CCTTGGCGGTGGTCCACGGT,0,1184541
fldAp,0.5,1,1,CCTTGGCCATCCGTGCGCCC,0,1090076
fldAp,0.5,1,1,CCTTGCTAGTATTTAAAGTG,0,1069924
fldAp,0.5,1,1,CCTTCTGGAGAGAAGGGAAC,0,1181408
fldAp,0.5,1,1,CCTTCTATGTGAACGCGTTA,0,1168375
fldAp,0.5,1,1,CCTTCCGCTGAGGTAGGTTC,0,1069148
fldAp,0.5,1,1,CCTTCCACATGGGTGCTTTT,0,1130230
fldAp,0.5,1,1,CCTTCACATCTATCTTATAG,0,1076083
fldAp,0.5,1,1,CCTTATGGTAGGGGGATGTC,0,1103193
fldAp,0.5,1,1,CCTTAAGCAGGATAGCTGAA,0,1138936
fldAp,0.5,1,1,CCTGTTTCCGTCTACGTTAG,0,1097912
fldAp,0.5,1,1,CCTGGTGGCGCCGCATGGTA,0,1122252
fldAp,0.5,1,1,CCTGGGCAAACTAATGGCTC,0,1171636
fldAp,0.5,1,1,CCTGGAGCTCCGGTGTTCAG,0,1109750
fldAp,0.5,1,1,CCTGCGTCATCGAGCCCTGA,0,1112793
fldAp,0.5,1,1,CCTGCGATGGTGTAGCCCCC,0,1111959
fldAp,0.5,1,1,CCTGCCTTAACTGGGGTTTC,0,1159680
fldAp,0.5,1,1,CCTGCAGCAGTTTTGGCTCA,0,1112479
fldAp,0.5,1,1,CCTGAAAGGCACGATGCGGC,0,1068943
fldAp,0.5,1,1,CCTCTTCATCTGAACCTCTC,0,1076728
fldAp,0.5,1,1,CCTCGGTTTGTTCAGTTGAT,0,1095899
fldAp,0.5,1,1,CCTCGGGACCCCCGACATCT,0,1171914
fldAp,0.5,1,1,CCTCCGGCTCAAGGTAGTAC,0,1075639
fldAp,0.5,1,1,CCTCCCTATCAGCCGGCCCA,0,1156876
fldAp,0.5,1,1,CCTCATGGTACATAGCCAAC,0,1088428
fldAp,0.5,1,1,CCTCAGAGAATACAGGCGTA,0,1158311
fldAp,0.5,1,1,CCTCACGTTTATAGCGATGT,0,1105594
fldAp,0.5,1,1,CCTCACCCTGCACTACTGTA,0,1167449
fldAp,0.5,1,1,CCTCAAGCTAATCGGGATAA,0,1144794
fldAp,0.5,1,1,CCTATGTCCGCAATCTTGCT,0,1140956
fldAp,0.5,1,1,CCTATGGGTAATACAAGAAA,0,1077006
fldAp,0.5,1,1,CCTATGATTCGCAGCAATCA,0,1085095
fldAp,0.5,1,1,CCTATCGAAAGCCCGAACCT,0,1142426
fldAp,0.5,1,1,CCTATATGCCTCACCCGTAC,0,1169410
fldAp,0.5,1,1,CCTAGGCCGCCCTACTAGCA,0,1166487
fldAp,0.5,1,1,CCTACTCGCATGTATCCGGC,0,1114108
fldAp,0.5,1,1,CCTACGGGGCCTAGGATGGA,0,1167330
fldAp,0.5,1,1,CCTACCTTCTCCATCAGCGG,0,1064653
fldAp,0.5,1,1,CCTACCCGTCAGTAAAGCCC,0,1082484
fldAp,0.5,1,1,CCTAAGCATCGTGCATGGAG,0,1164176
fldAp,0.5,1,1,CCTAACGTATAATGACCAAC,0,1167773
fldAp,0.5,1,1,CCTAAAGAATTGAAACTCAC,0,1101214
fldAp,0.5,1,1,CCGTTTGGTAATGTACCGTT,0,1164698
fldAp,0.5,1,1,CCGTTTGCGCTTTATTGATC,0,1142983
fldAp,0.5,1,1,CCGTTGGAAGTAACGCACCA,0,1125810
fldAp,0.5,1,1,CCGTTAGGACTGGGCGGGCG,0,1105691
fldAp,0.5,1,1,CCGTGCGGCAGGAAATCGGT,0,1185191
fldAp,0.5,1,1,CCGTGCATATATACATGCGA,0,1172284
fldAp,0.5,1,1,CCGTGAGGTCAGGCTCCGTC,0,1077368
fldAp,0.5,1,1,CCGTGAGACCGAGGTTTTGA,0,1134433
fldAp,0.5,1,1,CCGTGACCATGGTCATAATT,0,1065117
fldAp,0.5,1,1,CCGTCGGCACCTCTGCTATT,0,1146324
fldAp,0.5,1,1,CCGTCCCCCGGCACTCACTC,0,1121836
fldAp,0.5,1,1,CCGTCCAGAAACTGGTGTTT,0,1116082
fldAp,0.5,1,1,CCGTCACGGGTCTCGTGTAT,0,1134674
fldAp,0.5,1,1,CCGTCACGCGCTGGAAAAGC,0,1105437
fldAp,0.5,1,1,CCGTATAAAGCGATCAGTAG,0,1176043
fldAp,0.5,1,1,CCGTAGGCTTCTACATTCCT,0,1116774
fldAp,0.5,1,1,CCGTAATGTATGTCGCTGAT,0,1087132
fldAp,0.5,1,1,CCGTAACTAATCACATTGAT,0,1063770
fldAp,0.5,1,1,CCGTAAACACCAGCAGGACA,0,1088619
fldAp,0.5,1,1,CCGGTGAGCCAATTACATGC,0,1099669
fldAp,0.5,1,1,CCGGTCTTAACAGCCTAACA,0,1135930
fldAp,0.5,1,1,CCGGTCTACTAACCTATTCT,0,1116425
fldAp,0.5,1,1,CCGGTATACTCTTTCTTTAT,0,1120500
fldAp,0.5,1,1,CCGGGTCTCTGTGCTCGGGC,0,1093753
fldAp,0.5,1,1,CCGGGGGACCAACAATGACA,0,1079333
fldAp,0.5,1,1,CCGGGGAGTCCGAGGCAGTG,0,1147245
fldAp,0.5,1,1,CCGGCCTGTCAAGTCAACTT,0,1156192
fldAp,0.5,1,1,CCGGCCCCTCGTTGCCTCAC,0,1158218
fldAp,0.5,1,1,CCGGAGCCTGGATTAGATCT,0,1092727
fldAp,0.5,1,1,CCGGAGATTAGAAGTAATGG,0,1066215
fldAp,0.5,1,1,CCGGACGCTGGGCCGGCCTC,0,1157114
fldAp,0.5,1,1,CCGGACGCCTTCAACAGATT,0,1170676
fldAp,0.5,1,1,CCGCTTAAGCACTCTTAAGT,0,1110937
fldAp,0.5,1,1,CCGCTATCTAAAGTGCAATT,0,1065791
fldAp,0.5,1,1,CCGCTAACACGTTCGCTCCT,0,1181855
fldAp,0.5,1,1,CCGCGTGGGTACAGACCTTA,0,1115111
fldAp,0.5,1,1,CCGCGTCTGACACGCTGACG,0,1080597
fldAp,0.5,1,1,CCGCGTAGACCGAACGAGCT,0,1156990
fldAp,0.5,1,1,CCGCGGTGCACTATAGTTCG,0,1102365
fldAp,0.5,1,1,CCGCGCTGGGATGATAGATC,0,1186432
fldAp,0.5,1,1,CCGCGCAGCCTGCATCTTAA,0,1072207
fldAp,0.5,1,1,CCGCGATCTTGTTACGTCAT,0,1086513
fldAp,0.5,1,1,CCGCCGGCTTACAGGAGACT,0,1165989
fldAp,0.5,1,1,CCGCCCGCTTCAGCATTGCT,0,1156375
fldAp,0.5,1,1,CCGCCAATTTACTGCCGCTG,0,1087259
fldAp,0.5,1,1,CCGCATGTCTCGCCGGAATT,0,1170910
fldAp,0.5,1,1,CCGCATGATTTATCTACTTA,0,1146886
fldAp,0.5,1,1,CCGCACAGGCGTCATCACGT,0,1078213
fldAp,0.5,1,1,CCGCAAAAGTTTAATGTCCC,0,1105366
fldAp,0.5,1,1,CCGATGTTTGCGAAACCAGA,0,1166291
fldAp,0.5,1,1,CCGATGTAACTAATATGCAG,0,1148521
fldAp,0.5,1,1,CCGATGCCTTTTTGGGCCTC,0,1098145
fldAp,0.5,1,1,CCGATCTATCACGTGACAGC,0,1114473
fldAp,0.5,1,1,CCGATCCTGGCACTCTGGAT,0,1093234
fldAp,0.5,1,1,CCGATAGATATCCGCTTCCC,0,1103880
fldAp,0.5,1,1,CCGAGTGTAGCCTCCGGCAT,0,1159671
fldAp,0.5,1,1,CCGAGTGCCAGTCCCACCCT,0,1146449
fldAp,0.5,1,1,CCGAGTGAATTTACTAAGTG,0,1172575
fldAp,0.5,1,1,CCGAGGTCATTGGAGCTAAG,0,1063757
fldAp,0.5,1,1,CCGAGCGCGTATTCTTTGCG,0,1091767
fldAp,0.5,1,1,CCGAGCCTAAAATTGAACGA,0,1097474
fldAp,0.5,1,1,CCGACGTGAACCAGGAGTGA,0,1163226
fldAp,0.5,1,1,CCGACCCAAACCAGGTCGGG,0,1087754
fldAp,0.5,1,1,CCGAATAGATTATGCAGATA,0,1138162
fldAp,0.5,1,1,CCGAACGCGTCCTGAAGGGG,0,1166546
fldAp,0.5,1,1,CCGAACGAGGAATCGCCTTA,0,1065103
fldAp,0.5,1,1,CCGAAAACGTGCTGATGTGC,0,1159727
fldAp,0.5,1,1,CCCTTTTTAGACGCGTCAAA,0,1171684
fldAp,0.5,1,1,CCCTTTCTTTTTGGTATACC,0,1130053
fldAp,0.5,1,1,CCCTTGATGTTGGTTCGATC,0,1168930
fldAp,0.5,1,1,CCCTTCTGCAGCTCAGCTAC,0,1092714
fldAp,0.5,1,1,CCCTTCTCCAGGCTCGTGGT,0,1065647
fldAp,0.5,1,1,CCCTGTTTATCGCACTGGAA,0,1156805
fldAp,0.5,1,1,CCCTGTACAATGTTTCAGGC,0,1109602
fldAp,0.5,1,1,CCCTGGGTTGACGCACTGAG,0,1176653
fldAp,0.5,1,1,CCCTGCACTTTTTTAAATCC,0,1160390
fldAp,0.5,1,1,CCCTGAAGCTTCGTACGTAA,0,1125596
fldAp,0.5,1,1,CCCTGAAACACGTAGAGTAA,0,1137893
fldAp,0.5,1,1,CCCTCTTCGCAAGCCGGAAA,0,1087247
fldAp,0.5,1,1,CCCTCTCCAGTTTACGAGAG,0,1155755
fldAp,0.5,1,1,CCCTCGGACTAGGGCGGTTA,0,1098669
fldAp,0.5,1,1,CCCTCGAGGCTTATTCCTAC,0,1084735
fldAp,0.5,1,1,CCCTCCATCCGTTGCGGCAT,0,1094359
fldAp,0.5,1,1,CCCTCCAGTGCACTTATTTC,0,1068762
fldAp,0.5,1,1,CCCTAGGAGGGCTGTGTAAT,0,1079432
fldAp,0.5,1,1,CCCGTGGATTGACATAAAGT,0,1158955
fldAp,0.5,1,1,CCCGTGATATCGTCCGAGTC,0,1116912
fldAp,0.5,1,1,CCCGTCCTGGACTCCGTGAT,0,1170267
fldAp,0.5,1,1,CCCGTACAGTATGTTCTGCT,0,1086271
fldAp,0.5,1,1,CCCGGGGATCCCACTGTGCC,0,1153381
fldAp,0.5,1,1,CCCGGGAAAAACTGCGCATT,0,1153109
fldAp,0.5,1,1,CCCGGCTAAGCACACAATCA,0,1154620
fldAp,0.5,1,1,CCCGGAAAAATAAGTTGGGT,0,1073696
fldAp,0.5,1,1,CCCGAGCTCTACTACATAAA,0,1086482
fldAp,0.5,1,1,CCCGAAGTTAGAGCTCAATG,0,1149684
fldAp,0.5,1,1,CCCCTTTCCACAGGCGTGTC,0,1176987
fldAp,0.5,1,1,CCCCTTGCAGCTAAATTACA,0,1107219
fldAp,0.5,1,1,CCCCTTAGAGTTCTCGCTCA,0,1065823
fldAp,0.5,1,1,CCCCTGCGCACCCTGGTCGG,0,1173217
fldAp,0.5,1,1,CCCCTATGTGCTACGATGGC,0,1065232
fldAp,0.5,1,1,CCCCGTTGGGTTAAGATTGA,0,1107539
fldAp,0.5,1,1,CCCCGTCGCGACGGGGATCA,0,1179409
fldAp,0.5,1,1,CCCCGGGTTCGCCGCGATGT,0,1102103
fldAp,0.5,1,1,CCCCGGATTTCTTCAGCAAG,0,1077912
fldAp,0.5,1,1,CCCCCTCAATACCACACTTG,0,1157544
fldAp,0.5,1,1,CCCCCGCCCTGTCACAGCCG,0,1181326
fldAp,0.5,1,1,CCCCCGAATACCCTTTAAGA,0,1082958
fldAp,0.5,1,1,CCCCCCGACTGGGAAGATAT,0,1144738
fldAp,0.5,1,1,CCCCCCAAGCATTACGGTAG,0,1126920
fldAp,0.5,1,1,CCCCATTCCCTTGGCCTGGA,0,1122201
fldAp,0.5,1,1,CCCCAGAGTTGAACTTCACC,0,1123186
fldAp,0.5,1,1,CCCCACTAACCTCGTGTTAA,0,1092112
fldAp,0.5,1,1,CCCATGTTCTGACAGTAGGA,0,1144518
fldAp,0.5,1,1,CCCATGGTCCCGGGAGTCCT,0,1136675
fldAp,0.5,1,1,CCCAGGTACTTACGCCGCTT,0,1147831
fldAp,0.5,1,1,CCCAGGCAAGACCCTTACGC,0,1134498
fldAp,0.5,1,1,CCCAGGATCATTAAGCCAGA,0,1123395
fldAp,0.5,1,1,CCCAGCTATGCTATCAAACA,0,1095036
fldAp,0.5,1,1,CCCAGAGCTGTCGGGCTTGT,0,1111683
fldAp,0.5,1,1,CCCAGAAAGGTCATACCCTT,0,1171823
fldAp,0.5,1,1,CCCACCTGCGGGATTGATCG,0,1139899
fldAp,0.5,1,1,CCCAATCTGCGCAGCGGATT,0,1105342
fldAp,0.5,1,1,CCCAATAGGACATCGTATGG,0,1163991
fldAp,0.5,1,1,CCCAAGGGCGATTTTCTGCT,0,1184430
fldAp,0.5,1,1,CCCAAAGCTTATCATCAGAA,0,1152353
fldAp,0.5,1,1,CCCAAACCTGTGACGTTCAG,0,1098773
fldAp,0.5,1,1,CCATTTTCTCTGCTGAGGAG,0,1163599
fldAp,0.5,1,1,CCATTTGATCACGTATCTTT,0,1101953
fldAp,0.5,1,1,CCATTGTGGGGGGGTATTGG,0,1159219
fldAp,0.5,1,1,CCATTGCCCCATCATACTGT,0,1176147
fldAp,0.5,1,1,CCATTGACAGCGAAAACTCC,0,1149361
fldAp,0.5,1,1,CCATTCTTAAGGAACCTTAG,0,1063308
fldAp,0.5,1,1,CCATTACGTTGGCGCGGGAG,0,1162316
fldAp,0.5,1,1,CCATGTTTAGAAGTCTTAGA,0,1150751
fldAp,0.5,1,1,CCATGTGGTGTAGTCGGAAA,0,1150777
fldAp,0.5,1,1,CCATGGTCAAAGAGTGTACT,0,1144700
fldAp,0.5,1,1,CCATGGGGATTGCATCTGTC,0,1131503
fldAp,0.5,1,1,CCATGCCCGAGTAATCGAGC,0,1085328
fldAp,0.5,1,1,CCATGATGTCTCCCCACTAA,0,1127594
fldAp,0.5,1,1,CCATCTTGACGTTAGAGGTC,0,1137074
fldAp,0.5,1,1,CCATCTAGCGCAGCTTTCAA,0,1174964
fldAp,0.5,1,1,CCATCATTGAAACATTCTGG,0,1162876
fldAp,0.5,1,1,CCATCACACCGCCCTGAAAC,0,1147333
fldAp,0.5,1,1,CCATAGTCATCCCAACGTAC,0,1168108
fldAp,0.5,1,1,CCATAGAGAAGTCTCTTGAT,0,1120705
fldAp,0.5,1,1,CCATACAGCATCTTTCACGA,0,1104929
fldAp,0.5,1,1,CCATAATGTAGTTGCGCTAA,0,1088300
fldAp,0.5,1,1,CCATAACGGTAAACACTCGT,0,1064398
fldAp,0.5,1,1,CCAGGTGATAGTCTTAAATC,0,1142148
fldAp,0.5,1,1,CCAGGTCCAGCACCCTTGGC,0,1176133
fldAp,0.5,1,1,CCAGGGCGAGATACGTCTCT,0,1103460
fldAp,0.5,1,1,CCAGGATTAGCGTTTAAATT,0,1128894
fldAp,0.5,1,1,CCAGCTACCCGACTGCTCGT,0,1116355
fldAp,0.5,1,1,CCAGCGGTACGCAGTTGAAT,0,1079799
fldAp,0.5,1,1,CCAGCATGCGAGACTCATCA,0,1107197
fldAp,0.5,1,1,CCAGAGGGAGGCAGCCAGCC,0,1149756
fldAp,0.5,1,1,CCAGAATCCTTGTTTCCCGG,0,1176271
fldAp,0.5,1,1,CCACTGCCCCAATCCCCATG,0,1066543
fldAp,0.5,1,1,CCACTAAAAACTCTAGCGTA,0,1064134
fldAp,0.5,1,1,CCACGGTCGCTACCTAGACA,0,1128164
fldAp,0.5,1,1,CCACGGGACGGTTGGCGATT,0,1170820
fldAp,0.5,1,1,CCACGCGGCAGCCTTTCATG,0,1076208
fldAp,0.5,1,1,CCACGCACACTTCGAGTGTA,0,1170738
fldAp,0.5,1,1,CCACGATGATACTGAGGAAA,0,1151766
fldAp,0.5,1,1,CCACCTGGGGAATGAAGGTG,0,1180549
fldAp,0.5,1,1,CCACCATTTTCCACAGGTGA,0,1065332
fldAp,0.5,1,1,CCACATCTGTTAGTGGCCAT,0,1066301
fldAp,0.5,1,1,CCACAGTAGCGAATAGCACA,0,1139753
fldAp,0.5,1,1,CCACAGCCAGAGGTATGCAA,0,1076334
fldAp,0.5,1,1,CCACAAGTGTGGACAAATTG,0,1105080
fldAp,0.5,1,1,CCAATGTCCGCTGACGTACT,0,1119789
fldAp,0.5,1,1,CCAATGCCCGGATGAAAAAG,0,1146544
fldAp,0.5,1,1,CCAATATGAACTTTTTCCTT,0,1076056
fldAp,0.5,1,1,CCAATATATCTCGGACTGAA,0,1077100
fldAp,0.5,1,1,CCAATATACAACATAGTGAT,0,1154938
fldAp,0.5,1,1,CCAATAGGCAGATGAATCAT,0,1139040
fldAp,0.5,1,1,CCAAGTTTAAAGGCGTGAGT,0,1124247
fldAp,0.5,1,1,CCAAGTGGATTGCTTTCTAA,0,1085479
fldAp,0.5,1,1,CCAAGGTGTCTCCTTCGGGG,0,1134152
fldAp,0.5,1,1,CCAAGGTCGCTAGCATGAAG,0,1160883
fldAp,0.5,1,1,CCAAGGTCCAACACGCCAGG,0,1115455
fldAp,0.5,1,1,CCAAGGATGTAAAACGTTCG,0,1164647
fldAp,0.5,1,1,CCAAGGAAGAACAGACACAA,0,1148748
fldAp,0.5,1,1,CCAACGCGACGGATAATTTG,0,1131807
fldAp,0.5,1,1,CCAACGAAGGCACAGTCTTT,0,1095251
fldAp,0.5,1,1,CCAAATGATTGAGGCAGAAG,0,1069730
fldAp,0.5,1,1,CCAAATAGTTGGGCTATCGG,0,1112577
fldAp,0.5,1,1,CCAAAGTTCCTGGTTATATA,0,1148702
fldAp,0.5,1,1,CCAAACACCAGAGAGTAATC,0,1086851
fldAp,0.5,1,1,CATTTTTAGCTGGGTCGATC,0,1165356
fldAp,0.5,1,1,CATTTGCTGCCCAAAGCATC,0,1170718
fldAp,0.5,1,1,CATTTCGCGGGTATTCGGCC,0,1163447
fldAp,0.5,1,1,CATTTCATGAGCTGTCGCGG,0,1117448
fldAp,0.5,1,1,CATTTAGGGACCGATCCGAC,0,1068769
fldAp,0.5,1,1,CATTGGACGAGTGCAAAACG,0,1177458
fldAp,0.5,1,1,CATTGCAAACAGGATCAGAT,0,1176731
fldAp,0.5,1,1,CATTCTTTTCTTGGGCAGAT,0,1097149
fldAp,0.5,1,1,CATTCTCAGTGGGAAATCCT,0,1177515
fldAp,0.5,1,1,CATTCTACAATCGTTCGACG,0,1125504
fldAp,0.5,1,1,CATTCGCAGGGCAAGGGCGT,0,1102729
fldAp,0.5,1,1,CATTCAGGCAACACGAGGCC,0,1127532
fldAp,0.5,1,1,CATTCAGAAATAGGCACCGC,0,1178573
fldAp,0.5,1,1,CATTCAATAAGCAACCTGCG,0,1166575
fldAp,0.5,1,1,CATTCAAGAAACACGCAAGT,0,1168307
fldAp,0.5,1,1,CATTATTTGGGGGTCTATCG,0,1156452
fldAp,0.5,1,1,CATTATTTGCTGTGCTCACT,0,1138278
fldAp,0.5,1,1,CATTATGTGCCACGGGGATA,0,1136511
fldAp,0.5,1,1,CATTATCAGGTCAAACAGCC,0,1134918
fldAp,0.5,1,1,CATTATACTGAAATCGCTCA,0,1152051
fldAp,0.5,1,1,CATTACTGTGGACGCAAGCC,0,1086849
fldAp,0.5,1,1,CATGTTTCCCGAGAACTTTT,0,1083263
fldAp,0.5,1,1,CATGTATGAAGTCCTAAGTC,0,1063430
fldAp,0.5,1,1,CATGTAACGTATGAGAGTCA,0,1126746
fldAp,0.5,1,1,CATGGGGCCGCACTATGTTT,0,1178632
fldAp,0.5,1,1,CATGGCTTCAGCTGAGTATT,0,1124912
fldAp,0.5,1,1,CATGCGAGTACGCTGTTCGA,0,1171738
fldAp,0.5,1,1,CATGCCGGAAAATACGGTGG,0,1080991
fldAp,0.5,1,1,CATGCCCGTCCGACAGAAAT,0,1111064
fldAp,0.5,1,1,CATGATTTTATATCGCATTA,0,1173281
fldAp,0.5,1,1,CATGATTCAATATCCAGGCT,0,1169376
fldAp,0.5,1,1,CATGAGGAAGTAACGTGCGT,0,1112131
fldAp,0.5,1,1,CATGAGCCTCGTGCCTCGCA,0,1175696
fldAp,0.5,1,1,CATGAGAGTCGGAGCTCGCT,0,1101113
fldAp,0.5,1,1,CATGACAATGCGCACCATCC,0,1073668
fldAp,0.5,1,1,CATGAATAGCCCCGCATTAT,0,1098432
fldAp,0.5,1,1,CATCTGATCACAGGATCCGC,0,1063998
fldAp,0.5,1,1,CATCGTTTCCGGCATACAGT,0,1065344
fldAp,0.5,1,1,CATCGTGGCCCGTGGGTACA,0,1180088
fldAp,0.5,1,1,CATCGTACTATTCGCTGTAG,0,1110856
fldAp,0.5,1,1,CATCGCGTAAGTGGGATGCT,0,1177612
fldAp,0.5,1,1,CATCCTATGCCGCTGCGACA,0,1087172
fldAp,0.5,1,1,CATCCATCTTGGGACCCAGG,0,1070509
fldAp,0.5,1,1,CATCCAACGCTCCTTGTTCC,0,1063809
fldAp,0.5,1,1,CATCATGCAGCTGGCACAAC,0,1075884
fldAp,0.5,1,1,CATCAGTCGGCTAAGCAATT,0,1160741
fldAp,0.5,1,1,CATCAGAATGGTTCAGTTAT,0,1113975
fldAp,0.5,1,1,CATCACGCGTTCCACCCCGG,0,1171176
fldAp,0.5,1,1,CATCACCGCACACAGTTATG,0,1146593
fldAp,0.5,1,1,CATCACCACTCTGTCGCAGC,0,1103625
fldAp,0.5,1,1,CATCACAAGCACTCGTGGGT,0,1142942
fldAp,0.5,1,1,CATCAAGTCGGTGTCGCGCT,0,1117904
fldAp,0.5,1,1,CATCAAGCTAGTGACCAATG,0,1098771
fldAp,0.5,1,1,CATCAAAGACTAGGTGTGCA,0,1172161
fldAp,0.5,1,1,CATAGTTGATTGAATGTGAA,0,1134263
fldAp,0.5,1,1,CATAGTGCCGATGTCCTTAG,0,1072299
fldAp,0.5,1,1,CATAGTCACCAGTTCCCAGT,0,1125529
fldAp,0.5,1,1,CATAGGTGACAAATCTAATA,0,1094582
fldAp,0.5,1,1,CATAGGTATAGGATTGGTAA,0,1134588
fldAp,0.5,1,1,CATAGATTACCGAGCACTTG,0,1083469
fldAp,0.5,1,1,CATAGAGAAGTCCTAAAAAC,0,1130832
fldAp,0.5,1,1,CATAGAAATCTTTCGTGAAA,0,1128949
fldAp,0.5,1,1,CATACTGCCCTGTATCCCCA,0,1170880
fldAp,0.5,1,1,CATACTCCGGAGCCGGCCGT,0,1146628
fldAp,0.5,1,1,CATACATCACCGCCTAGAGA,0,1160159
fldAp,0.5,1,1,CATACAGACACCTTTCCGCA,0,1068463
fldAp,0.5,1,1,CATAATTAAAAGCAAGACAT,0,1186683
fldAp,0.5,1,1,CATAAAGCTCTCAACCATCT,0,1109836
fldAp,0.5,1,1,CAGTTCGGACTTCTTGCGGT,0,1084485
fldAp,0.5,1,1,CAGTTCCATAACTTCCGGTC,0,1082586
fldAp,0.5,1,1,CAGTTAGACTGACACTCTAG,0,1156112
fldAp,0.5,1,1,CAGTGTTTCCCCCGGCGTGA,0,1185279
fldAp,0.5,1,1,CAGTGTGACCTCCTAGGATG,0,1164386
fldAp,0.5,1,1,CAGTGCGGATGTCATCTGGT,0,1100504
fldAp,0.5,1,1,CAGTGATCGGTCCACTCAGG,0,1120365
fldAp,0.5,1,1,CAGTCTCCGCGCCTGGTCTT,0,1085815
fldAp,0.5,1,1,CAGTCTACTCACCGCAGGGA,0,1095584
fldAp,0.5,1,1,CAGTCGGGGAGGTCTCTGCA,0,1152156
fldAp,0.5,1,1,CAGTCGGCTTCACATCGGAT,0,1141956
fldAp,0.5,1,1,CAGTCCTTTTAATCTGCTCG,0,1180690
fldAp,0.5,1,1,CAGTCATTCATAAAGGGGCA,0,1171268
fldAp,0.5,1,1,CAGTCACGGGACTATCTATT,0,1115207
fldAp,0.5,1,1,CAGTATAGAAAGGAACATTA,0,1116566
fldAp,0.5,1,1,CAGTAAGCTGCGAATGCATA,0,1083706
fldAp,0.5,1,1,CAGTAAACTTACCGGCAAAT,0,1089799
fldAp,0.5,1,1,CAGGTGAATGTTCGTCTGCA,0,1068887
fldAp,0.5,1,1,CAGGTCGGTTCATAATGACA,0,1117723
fldAp,0.5,1,1,CAGGTATGCACGACAGAGAC,0,1109996
fldAp,0.5,1,1,CAGGTAAAAGACCTCTCGTG,0,1122942
fldAp,0.5,1,1,CAGGGCAGTCTGTTATTAGG,0,1169989
fldAp,0.5,1,1,CAGGGCAGAATCCGTTCCTA,0,1121103
fldAp,0.5,1,1,CAGGCTGGAGAGGCTGATAC,0,1143277
fldAp,0.5,1,1,CAGGCGTGCGGTCCTATATT,0,1166957
fldAp,0.5,1,1,CAGGCCGCCGTAATTGCCAT,0,1129472
fldAp,0.5,1,1,CAGGCCCCGAGTGCGTGGCG,0,1141159
fldAp,0.5,1,1,CAGGAGAGGTTTTAATTATG,0,1089122
fldAp,0.5,1,1,CAGGAGAAGTTATCTTACAG,0,1068169
fldAp,0.5,1,1,CAGGAAGAGTTGTAAAACGT,0,1086877
fldAp,0.5,1,1,CAGCTGGGGGTTGGAGCGGT,0,1064902
fldAp,0.5,1,1,CAGCTGAACCATTTGTTGGT,0,1099297
fldAp,0.5,1,1,CAGCTGAAATGGGAAGCGTG,0,1173537
fldAp,0.5,1,1,CAGCTAGTCTCACGGCAACA,0,1145841
fldAp,0.5,1,1,CAGCTAGATTGTGTGTCTCA,0,1147503
fldAp,0.5,1,1,CAGCGTGCAACTCTAACTGA,0,1097263
fldAp,0.5,1,1,CAGCGTGAGATACGCGGGAT,0,1115504
fldAp,0.5,1,1,CAGCGAGCGGCAAGCGCTGA,0,1178182
fldAp,0.5,1,1,CAGCCTTCCTGACTGCATCG,0,1131273
fldAp,0.5,1,1,CAGCCTGGTGGTACGGGAAG,0,1074118
fldAp,0.5,1,1,CAGCCTGGCCAGGCCACTAA,0,1173807
fldAp,0.5,1,1,CAGCCGCTATGTTCTAATCG,0,1178176
fldAp,0.5,1,1,CAGCCCATTCCCAACGTTGG,0,1157438
fldAp,0.5,1,1,CAGCACTGAAGGTATTCGCG,0,1103833
fldAp,0.5,1,1,CAGCACCACAACACGACGAG,0,1161780
fldAp,0.5,1,1,CAGCAATTCCACGCAGTAAG,0,1097786
fldAp,0.5,1,1,CAGATGGAGCGCTAGTCAAA,0,1078631
fldAp,0.5,1,1,CAGATCCTATCCATTGCTGG,0,1184418
fldAp,0.5,1,1,CAGATCATAGGTAGGAAGTA,0,1155374
fldAp,0.5,1,1,CAGAGGTTCAAGCCAAGAAC,0,1122038
fldAp,0.5,1,1,CAGAGGGTATTGCACCCTAA,0,1175459
fldAp,0.5,1,1,CAGAGGCACTGAGGAGCTGT,0,1084776
fldAp,0.5,1,1,CAGAGCGCCTAATGCTTCAC,0,1166314
fldAp,0.5,1,1,CAGAGAGTGTCAGAAATCAC,0,1133276
fldAp,0.5,1,1,CAGACGGGTGAGTTGATCAA,0,1123508
fldAp,0.5,1,1,CAGACGAAAACTGAACTTGT,0,1085777
fldAp,0.5,1,1,CAGACATCTCCCGATTCAAT,0,1130103
fldAp,0.5,1,1,CAGAATTTAGGGTCCTGTTT,0,1115564
fldAp,0.5,1,1,CAGAATCCTTTCACGGGGGC,0,1066394
fldAp,0.5,1,1,CAGAATCCGACTTCGTGGGT,0,1088202
fldAp,0.5,1,1,CAGAATAATCTGAGGTACAT,0,1071830
fldAp,0.5,1,1,CAGAACGGAAGTCCATCAGT,0,1107489
fldAp,0.5,1,1,CAGAACAATCGGCGGCGTTT,0,1115423
fldAp,0.5,1,1,CAGAAAGCCTACTCGCTATT,0,1126251
fldAp,0.5,1,1,CACTTTAAATTTAATGTTGT,0,1065546
fldAp,0.5,1,1,CACTTCGGCCGTTTGACGCA,0,1107856
fldAp,0.5,1,1,CACTGGTGTTTTTACTTAGC,0,1149084
fldAp,0.5,1,1,CACTGGTAGCGCGCTTTATG,0,1138268
fldAp,0.5,1,1,CACTGGGTTCAAACGCGATC,0,1141800
fldAp,0.5,1,1,CACTGATTTCTAGCTCTCTC,0,1120548
fldAp,0.5,1,1,CACTGATCGGGTCCGAAGCT,0,1169863
fldAp,0.5,1,1,CACTGAGGGTGTAGTTCCGA,0,1111198
fldAp,0.5,1,1,CACTGAGCAGAGTTGAATCT,0,1167514
fldAp,0.5,1,1,CACTCCTGATATATCTAGTT,0,1125670
fldAp,0.5,1,1,CACTAGCGACTGCTAGGTGA,0,1128423
fldAp,0.5,1,1,CACTACCTTGGACTCCGCGT,0,1123447
fldAp,0.5,1,1,CACTACCAGAAACGGGTGGA,0,1155534
fldAp,0.5,1,1,CACTAATGAAAGATAAGGTG,0,1185960
fldAp,0.5,1,1,CACGTGTCATTCGCGGGACA,0,1115012
fldAp,0.5,1,1,CACGTGAGTCCCTACCCAAA,0,1092871
fldAp,0.5,1,1,CACGTATTGGCGCTGTCACT,0,1133891
fldAp,0.5,1,1,CACGGTACACATGTGGTCTG,0,1068296
fldAp,0.5,1,1,CACGGCAGACAACTATGCGC,0,1126241
fldAp,0.5,1,1,CACGGAGCGCAGATGCCCAT,0,1173727
fldAp,0.5,1,1,CACGCTTGACTAAGCGTGCT,0,1160986
fldAp,0.5,1,1,CACGCTGCTTGGGGTGAGGG,0,1113508
fldAp,0.5,1,1,CACGCTCCGAGAAAATTACG,0,1123796
fldAp,0.5,1,1,CACGCTAATAACAGTAACAG,0,1145977
fldAp,0.5,1,1,CACGCGGTGGAGGCCTTGTT,0,1154659
fldAp,0.5,1,1,CACGCGATCGTTTGAAATTT,0,1080896
fldAp,0.5,1,1,CACGCGAGTTTCCAAATCAA,0,1105278
fldAp,0.5,1,1,CACGCCTTATATAGTTATTG,0,1119077
fldAp,0.5,1,1,CACGCCCCACAACCACATGC,0,1181951
fldAp,0.5,1,1,CACGAGCGACGTGCTGGTCG,0,1110331
fldAp,0.5,1,1,CACGAGCACCGATGCCGTCG,0,1171327
fldAp,0.5,1,1,CACGAACAGGTGCGCCCGCG,0,1122524
fldAp,0.5,1,1,CACGAAAGGGCACGGTAAAT,0,1162239
fldAp,0.5,1,1,CACGAAACGCAGGGGATCGG,0,1181826
fldAp,0.5,1,1,CACCTTGGGTTGCTTACGTA,0,1146668
fldAp,0.5,1,1,CACCTCTTTCGAGGTCGCGC,0,1133669
fldAp,0.5,1,1,CACCTCGAGGGCGCTGGTGT,0,1107785
fldAp,0.5,1,1,CACCGTCTACGCTACCTCCT,0,1175531
fldAp,0.5,1,1,CACCGGTCCCTCGTATAGGA,0,1064485
fldAp,0.5,1,1,CACCGGGAAAAAGGGTTCGT,0,1134185
fldAp,0.5,1,1,CACCGGATGCCCAGAGTCAC,0,1071078
fldAp,0.5,1,1,CACCGATTAGCGTACAAACT,0,1156208
fldAp,0.5,1,1,CACCCTTAATTTACGCCGAG,0,1175535
fldAp,0.5,1,1,CACCCGGCTGCTCCCCATAG,0,1122620
fldAp,0.5,1,1,CACCCGCTCATCGCGTAGAT,0,1156241
fldAp,0.5,1,1,CACCCCTCATGCCGCTAGTT,0,1127394
fldAp,0.5,1,1,CACCATGCAATATCACAGGA,0,1080593
fldAp,0.5,1,1,CACCAGAGCAAAAGTTACGA,0,1166559
fldAp,0.5,1,1,CACCACTGCGGGCCAGCCTT,0,1079555
fldAp,0.5,1,1,CACCACCTTAGTATCTCACC,0,1072555
fldAp,0.5,1,1,CACCACACCCTTCGGGTCGG,0,1081875
fldAp,0.5,1,1,CACATTAACGTAGAGTACGG,0,1159022
fldAp,0.5,1,1,CACATCTGTGGATGAAAGTA,0,1085028
fldAp,0.5,1,1,CACATCGGGAAGTGGAGAAT,0,1134957
fldAp,0.5,1,1,CACATCGCTGAAAGTTAAAC,0,1162999
fldAp,0.5,1,1,CACATATCATCAGCTCCCCT,0,1152961
fldAp,0.5,1,1,CACATAGAGAGCGATGTTGG,0,1072675
fldAp,0.5,1,1,CACAGTATGTTTTCCTTTGT,0,1075405
fldAp,0.5,1,1,CACAGCGTTTACCCAGTTCA,0,1138073
fldAp,0.5,1,1,CACAGCGGGAACGCGAATAA,0,1071261
fldAp,0.5,1,1,CACAGAACTTACCGGCAGGA,0,1186469
fldAp,0.5,1,1,CACACGTTTCTCCACTCGCC,0,1069155
fldAp,0.5,1,1,CACACGGGGGCATGTAATGT,0,1116641
fldAp,0.5,1,1,CACACCTCCCCAGGAATTCT,0,1070586
fldAp,0.5,1,1,CACACCATCGTCTAATGCTT,0,1171135
fldAp,0.5,1,1,CACACCAATTCCTAAACAAT,0,1170721
fldAp,0.5,1,1,CACACATTCTCATCTGTCGC,0,1080062
fldAp,0.5,1,1,CACACATATGGTGTAAAAAA,0,1175578
fldAp,0.5,1,1,CACAATATTACCTAATAAAA,0,1089801
fldAp,0.5,1,1,CACAACTAGGCGCAATCAAA,0,1136835
fldAp,0.5,1,1,CACAAATCCTACGAGCCATA,0,1139668
fldAp,0.5,1,1,CACAAAGCATATAGGAGGGG,0,1139296
fldAp,0.5,1,1,CAATTGGTGAGTCGGACCTC,0,1180329
fldAp,0.5,1,1,CAATGTTTTCCATTGATGTG,0,1078894
fldAp,0.5,1,1,CAATGTTCTCGAGGTGACTT,0,1081591
fldAp,0.5,1,1,CAATGTCAAGGAAGGAAAAG,0,1179922
fldAp,0.5,1,1,CAATGCGATCTGGTGCTGAA,0,1096618
fldAp,0.5,1,1,CAATGAGATAAAGAAGAGAA,0,1116813
fldAp,0.5,1,1,CAATCTTCCGTGGCTGATAA,0,1158637
fldAp,0.5,1,1,CAATCGCCGGCCCGCAAGAG,0,1130670
fldAp,0.5,1,1,CAATCGAGGATATTTGTTAT,0,1112987
fldAp,0.5,1,1,CAATATGTCCTTCATTTTAG,0,1132013
fldAp,0.5,1,1,CAATAGGGAGCGATTCGATC,0,1161388
fldAp,0.5,1,1,CAATAAGGTAGGATAACGAG,0,1171339
fldAp,0.5,1,1,CAATAACCTGGTGGTGGACA,0,1089116
fldAp,0.5,1,1,CAAGTCAACTCAGTTCACAT,0,1143047
fldAp,0.5,1,1,CAAGTATTGCCTCCCCACCC,0,1119581
fldAp,0.5,1,1,CAAGTATGCGCCTACGCACA,0,1160655
fldAp,0.5,1,1,CAAGGTTACTGTTTCACCTT,0,1116473
fldAp,0.5,1,1,CAAGGTGACTAGCCGGCGGG,0,1116298
fldAp,0.5,1,1,CAAGGTCGCACTTAGATTCA,0,1156748
fldAp,0.5,1,1,CAAGGCTGTTTAGGCAGCGG,0,1097908
fldAp,0.5,1,1,CAAGGATAGGGCTTAAGGCA,0,1138476
fldAp,0.5,1,1,CAAGGAGGCTACTCTGCAAA,0,1165543
fldAp,0.5,1,1,CAAGCTTCCTTTAGCATAAA,0,1147046
fldAp,0.5,1,1,CAAGCGTTAGCCCGGTTATG,0,1175098
fldAp,0.5,1,1,CAAGCGCTTTACTTATACTG,0,1105445
fldAp,0.5,1,1,CAAGCACGGTTGTAAATTCG,0,1080786
fldAp,0.5,1,1,CAAGATCAGATCAACTTGAT,0,1077012
fldAp,0.5,1,1,CAAGAGCCAAAGAACCGCCT,0,1129107
fldAp,0.5,1,1,CAAGAGCACGCGTAATGGTG,0,1092150
fldAp,0.5,1,1,CAAGACTAAAACTTCCTGGC,0,1161774
fldAp,0.5,1,1,CAAGAAGTTCCATCGAATAG,0,1134698
fldAp,0.5,1,1,CAAGAAGAGAGGGTCCAATT,0,1080419
fldAp,0.5,1,1,CAACTGATTCGACATCGTCT,0,1166380
fldAp,0.5,1,1,CAACTGACATTCAGAGTTTG,0,1076798
fldAp,0.5,1,1,CAACTCTAATTGGCACACAT,0,1103885
fldAp,0.5,1,1,CAACTAGGGGGAAGTTTCGG,0,1170306
fldAp,0.5,1,1,CAACTAAAGTGGAGGTCGTT,0,1078049
fldAp,0.5,1,1,CAACGGTTCTACTGGCGAGT,0,1069140
fldAp,0.5,1,1,CAACGGATAGCCGGTCGGTC,0,1125169
fldAp,0.5,1,1,CAACGCGGCCACCTCGAATC,0,1109140
fldAp,0.5,1,1,CAACGACCCCAAAGCCGGGT,0,1063965
fldAp,0.5,1,1,CAACCTGCTGTCCGGGCTTA,0,1167622
fldAp,0.5,1,1,CAACCATTGGGGTGATTTGA,0,1108246
fldAp,0.5,1,1,CAACACATTTGTCGTTATTA,0,1169335
fldAp,0.5,1,1,CAAATATCATTGTCCATATT,0,1138359
fldAp,0.5,1,1,CAAAGGTGCTCTTATAACAA,0,1094004
fldAp,0.5,1,1,CAAAGGAGAAAAGAAACGAC,0,1092569
fldAp,0.5,1,1,CAAAGCTTTTTTGAACCAAA,0,1088570
fldAp,0.5,1,1,CAAAGAAGTATGTGAACCAA,0,1146103
fldAp,0.5,1,1,CAAACCTATCTCCGAAGATT,0,1156857
fldAp,0.5,1,1,CAAACCGACGGGGGTCCTTT,0,1069369
fldAp,0.5,1,1,CAAACACCCTTCGCGATTAC,0,1142832
fldAp,0.5,1,1,CAAACACAAGCATGGGGAGA,0,1100952
fldAp,0.5,1,1,CAAAACGACTAGGAAGAACC,0,1153007
fldAp,0.5,1,1,CAAAAAATGATCCCGCATGG,0,1072427
fldAp,0.5,1,1,ATTTTTATTGGTGTAGTGGA,0,1091480
fldAp,0.5,1,1,ATTTTTAGCTCTTCTCGGAC,0,1127140
fldAp,0.5,1,1,ATTTTGGAGTGAAGTGGTCC,0,1073540
fldAp,0.5,1,1,ATTTTCAGGACCCAAACATG,0,1161281
fldAp,0.5,1,1,ATTTTACCGAGTGTTCATCT,0,1092048
fldAp,0.5,1,1,ATTTTAATGCAATATAAGTC,0,1144888
fldAp,0.5,1,1,ATTTGTGCCCTCGATAGAGA,0,1117648
fldAp,0.5,1,1,ATTTGTCCGAACGCATGTTA,0,1111497
fldAp,0.5,1,1,ATTTGGTATCCTGCTCGTTG,0,1129596
fldAp,0.5,1,1,ATTTGATGGAGGGATGAACC,0,1137851
fldAp,0.5,1,1,ATTTGACTCCTGGCTCGAAG,0,1109066
fldAp,0.5,1,1,ATTTGAATACCCGCCCGTCG,0,1139364
fldAp,0.5,1,1,ATTTCTGGCATCCGCAGAGG,0,1102016
fldAp,0.5,1,1,ATTTCTACACTCAGTCTCCT,0,1132788
fldAp,0.5,1,1,ATTTCTAACCTCGCAAGCTG,0,1091614
fldAp,0.5,1,1,ATTTCCTATGTTCGGCAAGA,0,1075942
fldAp,0.5,1,1,ATTTCCTATCCACGCCATTT,0,1165582
fldAp,0.5,1,1,ATTTCAGACGCAGAAGACTT,0,1153367
fldAp,0.5,1,1,ATTTCACGCCGGTGGTGTCT,0,1138765
fldAp,0.5,1,1,ATTTATGGCACAGGAGTGGC,0,1109674
fldAp,0.5,1,1,ATTTATCCGCGAGGGTTAAC,0,1103715
fldAp,0.5,1,1,ATTTATAGTCAGGTTAAAAA,0,1100230
fldAp,0.5,1,1,ATTTAGTTACAGCACAGTTC,0,1163180
fldAp,0.5,1,1,ATTTAGACCGGCTCCATGAA,0,1136617
fldAp,0.5,1,1,ATTTACGGCCCGCACATCTG,0,1144778
fldAp,0.5,1,1,ATTTACATTGTCGTACGGAA,0,1156614
fldAp,0.5,1,1,ATTGTTTGGGCGTTTGAGTT,0,1178088
fldAp,0.5,1,1,ATTGTGTCCACGCCGTCACC,0,1150457
fldAp,0.5,1,1,ATTGTATAGCTGCCATAGGC,0,1108335
fldAp,0.5,1,1,ATTGTACCACTGTCCACACC,0,1163053
fldAp,0.5,1,1,ATTGGTTACACTTATTCCTG,0,1080729
fldAp,0.5,1,1,ATTGGTCTCATAGCCGGACC,0,1080617
fldAp,0.5,1,1,ATTGGGACAGGCCACAGTAC,0,1144232
fldAp,0.5,1,1,ATTGGCTGAAGGGGTGCCCT,0,1139470
fldAp,0.5,1,1,ATTGGCGCTACGGGTGCGTC,0,1066264
fldAp,0.5,1,1,ATTGCGATCGGATAACAACA,0,1156213
fldAp,0.5,1,1,ATTGCCTCCGGACCGGCCAA,0,1103836
fldAp,0.5,1,1,ATTGCAGTAAGCGAAAACCC,0,1128731
fldAp,0.5,1,1,ATTGCAATTTAGTACCGTCC,0,1112465
fldAp,0.5,1,1,ATTGCAAATTAGCAATAAAA,0,1107988
fldAp,0.5,1,1,ATTGATGAACTCGCCGGTCC,0,1115843
fldAp,0.5,1,1,ATTGATACCAATTCCCACCG,0,1119065
fldAp,0.5,1,1,ATTGATACAACTGGAGATAG,0,1143291
fldAp,0.5,1,1,ATTGAGTGTAAATTTATTCC,0,1109310
fldAp,0.5,1,1,ATTGAGGCACTCAGGCTAAC,0,1144477
fldAp,0.5,1,1,ATTGAGCACAACGAGTGTGC,0,1129993
fldAp,0.5,1,1,ATTGACTTTGGACCTATAGG,0,1122982
fldAp,0.5,1,1,ATTGAATACATGTTGGACGC,0,1119665
fldAp,0.5,1,1,ATTGAAAACAGGGAGAGGAC,0,1154905
fldAp,0.5,1,1,ATTCTTATTGAATTCAGATT,0,1178033
fldAp,0.5,1,1,ATTCTGGCATTCGGCAACCC,0,1102868
fldAp,0.5,1,1,ATTCGTGCACACACTACATA,0,1161486
fldAp,0.5,1,1,ATTCGCGTCGGTTTGGATTT,0,1186562
fldAp,0.5,1,1,ATTCGCCGACATAGCAATCA,0,1093697
fldAp,0.5,1,1,ATTCCGCTGCCGATCATATC,0,1178687
fldAp,0.5,1,1,ATTCCCTAGGGAGACTTACC,0,1097794
fldAp,0.5,1,1,ATTCCCGTGACCGTCCCTTT,0,1127467
fldAp,0.5,1,1,ATTCCCCGTTAATTGTCTCA,0,1098135
fldAp,0.5,1,1,ATTCCCCGAGTTCTAAAACG,0,1094312
fldAp,0.5,1,1,ATTCCCAAGCCGCTCATCGC,0,1122979
fldAp,0.5,1,1,ATTCCATAATGAGTTAGTAG,0,1068273
fldAp,0.5,1,1,ATTCCAGGTCCGTAACAGGT,0,1083825
fldAp,0.5,1,1,ATTCCAAGCTATAGTCTTAC,0,1185138
fldAp,0.5,1,1,ATTCATGGGTTAAGTCATGC,0,1068751
fldAp,0.5,1,1,ATTCATCCGAGGGCTGACGA,0,1177879
fldAp,0.5,1,1,ATTCATCCATACGTGCGGAA,0,1070078
fldAp,0.5,1,1,ATTCAAAAGTAGTTTGTCAC,0,1137780
fldAp,0.5,1,1,ATTATGTTTCCAGCGGCCAT,0,1168350
fldAp,0.5,1,1,ATTATCTAGACTCAGAATCA,0,1114445
fldAp,0.5,1,1,ATTATAGGGATTGTTAACAG,0,1152702
fldAp,0.5,1,1,ATTAGTGGATTTGAACCAAT,0,1087104
fldAp,0.5,1,1,ATTAGGGCGGCGAGCAGTCT,0,1090918
fldAp,0.5,1,1,ATTAGCGAGAGGTGAGTAAG,0,1125407
fldAp,0.5,1,1,ATTAGACCGGCGGTGTATCT,0,1159652
fldAp,0.5,1,1,ATTACGGCTTTCATTCTCGG,0,1128920
fldAp,0.5,1,1,ATTACGCTGCACGCACTCCG,0,1162185
fldAp,0.5,1,1,ATTACCTGGTGGCTTGCCTT,0,1149179
fldAp,0.5,1,1,ATTACATTTAAAGCGAACCT,0,1171841
fldAp,0.5,1,1,ATTAAGACCGGAAAGAGTGA,0,1160309
fldAp,0.5,1,1,ATTAACACATTCGGGAATAC,0,1088927
fldAp,0.5,1,1,ATTAAATAGCCCACAGTTCC,0,1089790
fldAp,0.5,1,1,ATGTTTGGATCTCACGACTA,0,1178581
fldAp,0.5,1,1,ATGTTTCATACGAGGACAAC,0,1165704
fldAp,0.5,1,1,ATGTTATCCATCAACGCCCC,0,1078244
fldAp,0.5,1,1,ATGTGTGTTTGTTTCATAAA,0,1090724
fldAp,0.5,1,1,ATGTGGGTCTAGCGATTGGG,0,1086250
fldAp,0.5,1,1,ATGTGGCTAAGCTATGGACG,0,1147334
fldAp,0.5,1,1,ATGTGGCCGTGAACATAACA,0,1172204
fldAp,0.5,1,1,ATGTGACGGTCGGACAACTT,0,1162314
fldAp,0.5,1,1,ATGTGACGCCCGCCGTTTAA,0,1157236
fldAp,0.5,1,1,ATGTGACAATCAAACATTGA,0,1116869
fldAp,0.5,1,1,ATGTCTTCCGCTTTTTCCCT,0,1143921
fldAp,0.5,1,1,ATGTCTCTTTTGCTCGTCCT,0,1093493
fldAp,0.5,1,1,ATGTCTCAAATACGTAGACC,0,1115373
fldAp,0.5,1,1,ATGTCGTGCGGAGTGCAATA,0,1095011
fldAp,0.5,1,1,ATGTCGATACGCGTCGGCCC,0,1115173
fldAp,0.5,1,1,ATGTCGAGTCATCACGTTTT,0,1130104
fldAp,0.5,1,1,ATGTCCTGTGCCACAGGGTT,0,1081649
fldAp,0.5,1,1,ATGTCAGCGTGGGGTACTTC,0,1084299
fldAp,0.5,1,1,ATGTATGTTTTCGCGAACTC,0,1127468
fldAp,0.5,1,1,ATGTATCTACGGGGGCAAAC,0,1114305
fldAp,0.5,1,1,ATGTATATATGTCACTCTTA,0,1071654
fldAp,0.5,1,1,ATGTAGCGTCTTAACTTCCC,0,1128016
fldAp,0.5,1,1,ATGGTTCCATCTATCCGAAA,0,1079558
fldAp,0.5,1,1,ATGGTAAGAACGCACACCAC,0,1118554
fldAp,0.5,1,1,ATGGGATATGTATACCCCGC,0,1179825
fldAp,0.5,1,1,ATGGGAATCTATGCGCAATG,0,1098791
fldAp,0.5,1,1,ATGGCTCGTCGAACGCTTTG,0,1080181
fldAp,0.5,1,1,ATGGCGGAAAGCTATTTGCT,0,1137142
fldAp,0.5,1,1,ATGGCGAGGGCCAGCTCCGG,0,1156977
fldAp,0.5,1,1,ATGGCCTACCTTGGAAGCAA,0,1123385
fldAp,0.5,1,1,ATGGCATGTGAAAGCGAGGG,0,1170492
fldAp,0.5,1,1,ATGGACTCCATAAGGTTAAC,0,1175147
fldAp,0.5,1,1,ATGGACCGCGTTTAAGGTGG,0,1095540
fldAp,0.5,1,1,ATGGAATAGGAACCGCCGCA,0,1107483
fldAp,0.5,1,1,ATGGAAGAGACTCAGAGTAC,0,1113347
fldAp,0.5,1,1,ATGCTTGCTCATACATGATG,0,1144367
fldAp,0.5,1,1,ATGCTTCAGCACAGTGTATG,0,1155021
fldAp,0.5,1,1,ATGCTGTGGCCAAAAACTTA,0,1185350
fldAp,0.5,1,1,ATGCTGCCATGAGATCAAAA,0,1116454
fldAp,0.5,1,1,ATGCTCCGTACCTCGCCGTT,0,1163772
fldAp,0.5,1,1,ATGCTAGCTTTGTTCCATTT,0,1100761
fldAp,0.5,1,1,ATGCGTGGTAACCCTCCATG,0,1096150
fldAp,0.5,1,1,ATGCGTGCGCTGTGTACATA,0,1141750
fldAp,0.5,1,1,ATGCGTGATCATCGGCTGCG,0,1125297
fldAp,0.5,1,1,ATGCGGCTTCTCAGAGAATA,0,1185741
fldAp,0.5,1,1,ATGCGATTGTGGAATTAGTC,0,1166345
fldAp,0.5,1,1,ATGCCTTCTTTCACATTTCC,0,1082781
fldAp,0.5,1,1,ATGCCTTCGGATTGGCAACG,0,1101209
fldAp,0.5,1,1,ATGCCTCACATCACATTTAA,0,1141733
fldAp,0.5,1,1,ATGCCCGCCCGGGACGATCC,0,1159296
fldAp,0.5,1,1,ATGCCCCAGATAATACTACA,0,1153328
fldAp,0.5,1,1,ATGCCATTGAGAGACCACTT,0,1172354
fldAp,0.5,1,1,ATGCATTAAATGTTTCAGAC,0,1114791
fldAp,0.5,1,1,ATGCATCGGTTTAGGTTGAA,0,1084616
fldAp,0.5,1,1,ATGCAGAATATTGGGGAGGG,0,1114121
fldAp,0.5,1,1,ATGCACTTAGTTGACAGGGA,0,1132597
fldAp,0.5,1,1,ATGCACTGCCGTTGACCTCC,0,1139694
fldAp,0.5,1,1,ATGCACGAGGCGGGGAATAT,0,1084703
fldAp,0.5,1,1,ATGATTAGACGTGGTGTATG,0,1148433
fldAp,0.5,1,1,ATGATGCCACCGACGGCTTA,0,1167271
fldAp,0.5,1,1,ATGATATTAAAAGCCCAAGC,0,1095641
fldAp,0.5,1,1,ATGAGTTACAGAACAAGGAT,0,1136135
fldAp,0.5,1,1,ATGAGTCTTGTTTGCGGACG,0,1099078
fldAp,0.5,1,1,ATGACAGATTCAAGATAGTA,0,1144153
fldAp,0.5,1,1,ATGACACGAATTGTGCCGCA,0,1112760
fldAp,0.5,1,1,ATGACAATGGGTAAACCGCT,0,1066216
fldAp,0.5,1,1,ATGAATGCTTGTCCCGTCAA,0,1096527
fldAp,0.5,1,1,ATGAATCTATGATTACGATT,0,1140777
fldAp,0.5,1,1,ATGAAGACCACTAGATCGGA,0,1121234
fldAp,0.5,1,1,ATGAACTCGACGCAGAGACT,0,1117309
fldAp,0.5,1,1,ATGAACATGCCCAGCTAGGG,0,1131518
fldAp,0.5,1,1,ATGAAATCTTGCTATCCGAA,0,1150771
fldAp,0.5,1,1,ATCTTTTGTAGCATGGTAAC,0,1114684
fldAp,0.5,1,1,ATCTTTGGCTTCCGGCAAGT,0,1154352
fldAp,0.5,1,1,ATCTTACGAGTCGAGTGTCC,0,1108703
fldAp,0.5,1,1,ATCTTAAAGGTCTATAGTCA,0,1186535
fldAp,0.5,1,1,ATCTGTCTTATGGCATACCA,0,1066691
fldAp,0.5,1,1,ATCTGCCTCGATATTAAGGC,0,1079819
fldAp,0.5,1,1,ATCTGCAACCCGCATGGGGG,0,1095406
fldAp,0.5,1,1,ATCTCTTAGACAATCCTGCC,0,1129420
fldAp,0.5,1,1,ATCTCTGTAAACCTCCGGTG,0,1083150
fldAp,0.5,1,1,ATCTCTAAAGATTGGTGGCT,0,1138552
fldAp,0.5,1,1,ATCTCAGCGGGCACAGTGTA,0,1142329
fldAp,0.5,1,1,ATCTATTGCAACAAAAGCGT,0,1094533
fldAp,0.5,1,1,ATCTACGGTAACTCGATGGG,0,1141379
fldAp,0.5,1,1,ATCTACCCCGTAAAATCTCT,0,1179840
fldAp,0.5,1,1,ATCGTGTGCATGTGAGGGAA,0,1143288
fldAp,0.5,1,1,ATCGTGTATATAAGTTGCTT,0,1133975
fldAp,0.5,1,1,ATCGTGCTCCCCCCGCTGAC,0,1133870
fldAp,0.5,1,1,ATCGTGCCCACACGTCGGTA,0,1076863
fldAp,0.5,1,1,ATCGTCGCTGCGGACCCTTT,0,1136280
fldAp,0.5,1,1,ATCGTCCCCTTCTTCTAGTA,0,1127967
fldAp,0.5,1,1,ATCGTACATCATCCTACTGT,0,1069973
fldAp,0.5,1,1,ATCGGTGTCCGTTGACACCG,0,1091438
fldAp,0.5,1,1,ATCGGTCCGGAATATAAGGC,0,1164892
fldAp,0.5,1,1,ATCGGGCAGAGTAGACAAGG,0,1127730
fldAp,0.5,1,1,ATCGCTTTGATTGCGCGCGA,0,1144913
fldAp,0.5,1,1,ATCGCCCTAATGACCAGGAG,0,1111130
fldAp,0.5,1,1,ATCGCAAGGTCTGAATACTA,0,1097464
fldAp,0.5,1,1,ATCGAGGGAATAATCGAGTC,0,1138146
fldAp,0.5,1,1,ATCGACGCTCGCTAAGGGCG,0,1067941
fldAp,0.5,1,1,ATCGAATAGGTATGATTCTA,0,1117623
fldAp,0.5,1,1,ATCGAACCGACTGCCAGCGC,0,1083191
fldAp,0.5,1,1,ATCCTGTTGAGTTTCATGTA,0,1105064
fldAp,0.5,1,1,ATCCTCTTATCTGTGTCGGA,0,1146875
fldAp,0.5,1,1,ATCCTCGCAGCACTCGCTGG,0,1125571
fldAp,0.5,1,1,ATCCGTCCGGTATTGGTCGT,0,1164623
fldAp,0.5,1,1,ATCCGGGCTCCACAACTGTC,0,1169436
fldAp,0.5,1,1,ATCCATCCATCGCCGTACAG,0,1078043
fldAp,0.5,1,1,ATCCACGCCGTCGTCCGATA,0,1172166
fldAp,0.5,1,1,ATCATTCACATAACGGAGTA,0,1119507
fldAp,0.5,1,1,ATCATGTATCTGTATGCCTG,0,1117805
fldAp,0.5,1,1,ATCATGCTACGCCACCAGCT,0,1179707
fldAp,0.5,1,1,ATCATGAATAGAATCGTACG,0,1145481
fldAp,0.5,1,1,ATCAGTCAAGAGATTCCATT,0,1126993
fldAp,0.5,1,1,ATCAGTAATAGATGGTTGTT,0,1104266
fldAp,0.5,1,1,ATCAGGAATGTTGGGGTTTC,0,1171656
fldAp,0.5,1,1,ATCAGCGTAAATCGAGTGGT,0,1165063
fldAp,0.5,1,1,ATCAGAGAGGAAGTGGTGTG,0,1140298
fldAp,0.5,1,1,ATCAGAATTTCGACTTGTTA,0,1143317
fldAp,0.5,1,1,ATCACTTATTCCTGGAGACA,0,1070139
fldAp,0.5,1,1,ATCACTTAGAGTAAGGATGT,0,1156160
fldAp,0.5,1,1,ATCACTGCCCGGTGCAGGAG,0,1165882
fldAp,0.5,1,1,ATCACGTGTGGTCGAGAGAT,0,1160166
fldAp,0.5,1,1,ATCACGTCCACCGTCGTAAG,0,1107534
fldAp,0.5,1,1,ATCACATTAAAGCCAAGGGG,0,1142959
fldAp,0.5,1,1,ATCAACCCTACATCCTGGCC,0,1110954
fldAp,0.5,1,1,ATCAAATAGGCCTGTGGATC,0,1111270
fldAp,0.5,1,1,ATCAAAAGTTGTTGGTAGTA,0,1185523
fldAp,0.5,1,1,ATATTGGGGGCGAATAAGAG,0,1171453
fldAp,0.5,1,1,ATATTGCAAAGCGTGCATTG,0,1141343
fldAp,0.5,1,1,ATATTCAGGTAGTCCGGGGT,0,1066513
fldAp,0.5,1,1,ATATTATTTCACCTGCGCGC,0,1120527
fldAp,0.5,1,1,ATATTATTCAAGTACCTAGG,0,1090213
fldAp,0.5,1,1,ATATTAGGAGCGGAGAGACC,0,1124901
fldAp,0.5,1,1,ATATGGCCGTATCGCTATGG,0,1108245
fldAp,0.5,1,1,ATATGCGTTTTCTAGGATCA,0,1124796
fldAp,0.5,1,1,ATATCTGGCCGGTCAATAGC,0,1125718
fldAp,0.5,1,1,ATATCTACGGTGGTGTTAAA,0,1102446
fldAp,0.5,1,1,ATATCGATTTGGTACAGGCT,0,1075966
fldAp,0.5,1,1,ATATATTGGTTTGGGGTAGG,0,1118180
fldAp,0.5,1,1,ATATACTTTTCGGGCACGCA,0,1168402
fldAp,0.5,1,1,ATATACTTTCGCGATGGGTT,0,1158906
fldAp,0.5,1,1,ATAGTTGTTAAGAACGAGTA,0,1133741
fldAp,0.5,1,1,ATAGTTGTCTAGCCAACGTG,0,1079909
fldAp,0.5,1,1,ATAGTTCTGGCGCTAGGGTG,0,1133248
fldAp,0.5,1,1,ATAGTTCGCGACGGTTAAGA,0,1116716
fldAp,0.5,1,1,ATAGTGGCCTCCCCCCTGTT,0,1151420
fldAp,0.5,1,1,ATAGTACCGATCGGCATGTA,0,1142812
fldAp,0.5,1,1,ATAGGGTCCGGTAGTCCATT,0,1131444
fldAp,0.5,1,1,ATAGGCATATAATGTGCTTG,0,1131855
fldAp,0.5,1,1,ATAGCTTTAGTGTTGCTCTA,0,1143885
fldAp,0.5,1,1,ATAGCTCGTCACGGTAATTT,0,1112716
fldAp,0.5,1,1,ATAGCGTTTTGATAGTTACA,0,1096806
fldAp,0.5,1,1,ATAGCGCGCAACTAGACTCT,0,1072160
fldAp,0.5,1,1,ATAGCAGCTGGAGGCGGTGG,0,1112170
fldAp,0.5,1,1,ATAGCACATTCTGTCACTTC,0,1144864
fldAp,0.5,1,1,ATAGCAAAGAACTCTGGTGC,0,1126124
fldAp,0.5,1,1,ATAGATCTGTTAGGTGTCCA,0,1185847
fldAp,0.5,1,1,ATAGATATCTTTGAGCTTAT,0,1171553
fldAp,0.5,1,1,ATAGATAACCTATTAGGGAG,0,1069473
fldAp,0.5,1,1,ATAGACCGTAAGCCCTTAGG,0,1068321
fldAp,0.5,1,1,ATAGAATCATCGTGGTTATA,0,1173640
fldAp,0.5,1,1,ATACTTTGACTGTACTGATA,0,1169382
fldAp,0.5,1,1,ATACTTCACTGCTCGGTTAT,0,1078065
fldAp,0.5,1,1,ATACTGGCACACACCAGACT,0,1134932
fldAp,0.5,1,1,ATACTAATTGGTGGACGAAC,0,1174450
fldAp,0.5,1,1,ATACTAATGCGGGCTCCACT,0,1176907
fldAp,0.5,1,1,ATACGTGATCGCCATTGAGA,0,1121720
fldAp,0.5,1,1,ATACGAGCTGAGTGCCCTTC,0,1085992
fldAp,0.5,1,1,ATACGACTTATAGGGTGATA,0,1132033
fldAp,0.5,1,1,ATACCTTGGGCCGCACTCAT,0,1142805
fldAp,0.5,1,1,ATACCTGAGTTTGCCTCACC,0,1142361
fldAp,0.5,1,1,ATACCGTCCAAGCGTGACAT,0,1106602
fldAp,0.5,1,1,ATACAGGCGTTCCTTTGGGC,0,1134823
fldAp,0.5,1,1,ATACACCCGGGGAAAAGCTA,0,1115871
fldAp,0.5,1,1,ATACACCAGTTGACTCTAAC,0,1143268
fldAp,0.5,1,1,ATAATTCGAAATCCTTGTAA,0,1094585
fldAp,0.5,1,1,ATAATCCTGCATTCATATCG,0,1144284
fldAp,0.5,1,1,ATAACGTCTAAAAGGTAAGA,0,1181829
fldAp,0.5,1,1,ATAACGCTTGTTCACAAAGT,0,1163120
fldAp,0.5,1,1,ATAACGCCTGTGGGCGGGTA,0,1101650
fldAp,0.5,1,1,ATAACCCCCCAATCGTTAAG,0,1118538
fldAp,0.5,1,1,ATAAACGCGATGAGTTTGTG,0,1181321
fldAp,0.5,1,1,ATAAACAGCGGGAGCCTGTA,0,1094828
fldAp,0.5,1,1,ATAAAAGCGTATTGAGACGA,0,1064693
fldAp,0.5,1,1,AGTTTTTATCGACTGATTCT,0,1163240
fldAp,0.5,1,1,AGTTTGGGAGGAGTCCGTTG,0,1186552
fldAp,0.5,1,1,AGTTTGCTATGAGCCGGGGC,0,1153959
fldAp,0.5,1,1,AGTTTCGACGTTATAGATCG,0,1158741
fldAp,0.5,1,1,AGTTTCCTCCAGAGATCTGT,0,1136296
fldAp,0.5,1,1,AGTTGGTGATCGAGACCTAA,0,1083231
fldAp,0.5,1,1,AGTTGCCTGGCTCCACGGGT,0,1119250
fldAp,0.5,1,1,AGTTGATTGCGCTCACTTAA,0,1070747
fldAp,0.5,1,1,AGTTCGTCAGCAGTTCCATA,0,1095372
fldAp,0.5,1,1,AGTTAGCTCCGCGGAGTGTT,0,1073305
fldAp,0.5,1,1,AGTTAGCGTAGATTAGCAAG,0,1139454
fldAp,0.5,1,1,AGTTAATGCGCGAGCGTAAA,0,1085152
fldAp,0.5,1,1,AGTGTTGGGCAGATTCTACT,0,1182364
fldAp,0.5,1,1,AGTGTCTACATCGAGCCATA,0,1185480
fldAp,0.5,1,1,AGTGTATGCGCCATTTATAC,0,1127327
fldAp,0.5,1,1,AGTGGTTGGGCAATTTGAAA,0,1124739
fldAp,0.5,1,1,AGTGGTTGACTGTTATATGG,0,1110325
fldAp,0.5,1,1,AGTGGTTATGAGCAACTCCC,0,1105441
fldAp,0.5,1,1,AGTGGTATCAGTGATAAGAT,0,1098539
fldAp,0.5,1,1,AGTGGGCGGTTCCTGCGAGG,0,1179303
fldAp,0.5,1,1,AGTGCTCTGCCTCCGAGTCC,0,1164547
fldAp,0.5,1,1,AGTGCGTATATCAGTTACAT,0,1077995
fldAp,0.5,1,1,AGTGCCCAGGTTACCCTCTT,0,1070298
fldAp,0.5,1,1,AGTGCACACCACATGGAGTT,0,1162605
fldAp,0.5,1,1,AGTGATGGATCGGTCTGCTT,0,1120180
fldAp,0.5,1,1,AGTGATCTGAGTTTTTTATG,0,1080537
fldAp,0.5,1,1,AGTGATCCGTGCGTTCTCCT,0,1069143
fldAp,0.5,1,1,AGTGACAGAAGATGATCGCC,0,1119858
fldAp,0.5,1,1,AGTCTGTCGGGGATTTAAAG,0,1185418
fldAp,0.5,1,1,AGTCTGTCGGGCCACTCCTT,0,1133071
fldAp,0.5,1,1,AGTCTGGTGCCCTGTCCGAA,0,1079229
fldAp,0.5,1,1,AGTCGTTTCCACCAACTTTT,0,1067154
fldAp,0.5,1,1,AGTCGGTATAATCATCCTCA,0,1131231
fldAp,0.5,1,1,AGTCGGGCAAGTGGCAATCC,0,1149546
fldAp,0.5,1,1,AGTCGCCAGGAACACACCTA,0,1102826
fldAp,0.5,1,1,AGTCCTCTCGGCCGCTACGG,0,1179122
fldAp,0.5,1,1,AGTCCTCCGGCCTCGCAGGC,0,1141232
fldAp,0.5,1,1,AGTCCGTTCGGATCACGGCT,0,1130752
fldAp,0.5,1,1,AGTCCGTACGCTTAGTGCCC,0,1144849
fldAp,0.5,1,1,AGTCCGACCTTAGTAGAGAA,0,1168836
fldAp,0.5,1,1,AGTCCGAAAGTTAAGACCGC,0,1108162
fldAp,0.5,1,1,AGTCATTCACGTGATCATAT,0,1162554
fldAp,0.5,1,1,AGTCAGCTAGCTAGGAAAAC,0,1152750
fldAp,0.5,1,1,AGTCACGAGCAAGCGGCAGT,0,1094497
fldAp,0.5,1,1,AGTCAATGCCGGATTCGCTC,0,1070594
fldAp,0.5,1,1,AGTATGTTCCAAGCCGATGT,0,1093877
fldAp,0.5,1,1,AGTATGATTTTCAATCCGCA,0,1071996
fldAp,0.5,1,1,AGTATAATTCGTTCGCAGGA,0,1102221
fldAp,0.5,1,1,AGTATAATAGAAACAAGCGA,0,1067234
fldAp,0.5,1,1,AGTAGTGTATATGTTGGTAT,0,1174546
fldAp,0.5,1,1,AGTAGACAACTACCTTACAA,0,1107976
fldAp,0.5,1,1,AGTACTTGCCCGGTGCTCAA,0,1147634
fldAp,0.5,1,1,AGTACGATCGCTTCTCAGTA,0,1097959
fldAp,0.5,1,1,AGTACATCAGCACCTTGGCG,0,1168622
fldAp,0.5,1,1,AGTAATCCCAGAACACTATA,0,1080511
fldAp,0.5,1,1,AGTAAGGAGCGTAGATAATC,0,1166883
fldAp,0.5,1,1,AGTAAGAAAACAGTCCGGTA,0,1069384
fldAp,0.5,1,1,AGTAACAGGTGAGCTCTGTG,0,1123724
fldAp,0.5,1,1,AGTAACAGGTCCCGCGCTCA,0,1157804
fldAp,0.5,1,1,AGGTTTGTGCATTTTAGTGT,0,1080169
fldAp,0.5,1,1,AGGTTTAGCTACGCCCTGTC,0,1067353
fldAp,0.5,1,1,AGGTTGTGAAGCCCCCCGTA,0,1131747
fldAp,0.5,1,1,AGGTTGGTGATAATGTGGCT,0,1150852
fldAp,0.5,1,1,AGGTTCAAACTTGCACTCGC,0,1095115
fldAp,0.5,1,1,AGGTGTGGTCGGAGATGAGC,0,1097313
fldAp,0.5,1,1,AGGTGCATGGCGGGCGGTAC,0,1156306
fldAp,0.5,1,1,AGGTGAGTTGAATCATGCGG,0,1151790
fldAp,0.5,1,1,AGGTGAGTATAGGGTTCTAG,0,1112334
fldAp,0.5,1,1,AGGTGACTAATAGGACATGG,0,1063364
fldAp,0.5,1,1,AGGTCTGACTAATAGTGGGG,0,1102422
fldAp,0.5,1,1,AGGTCGCCGGAAAGTAGTGG,0,1148646
fldAp,0.5,1,1,AGGTCCTGCGCCTGTAAGTT,0,1073138
fldAp,0.5,1,1,AGGTCCCGTCACGTCCCCAT,0,1085861
fldAp,0.5,1,1,AGGTCACGGGAATGGAGATA,0,1069731
fldAp,0.5,1,1,AGGTATTGAAGGTGTCCACT,0,1181884
fldAp,0.5,1,1,AGGTATCTGTTTCGTCGGAG,0,1129920
fldAp,0.5,1,1,AGGTAGTGTCGCAATGAATT,0,1182924
fldAp,0.5,1,1,AGGTAGTGACCAGTCATAAA,0,1103977
fldAp,0.5,1,1,AGGTAGCGGGTCGCATACAC,0,1085390
fldAp,0.5,1,1,AGGTAGAGGCCAGGTGACCC,0,1141533
fldAp,0.5,1,1,AGGTAAGGTATGGCTCAGAG,0,1099347
fldAp,0.5,1,1,AGGGTTAATGAACTCTCTCA,0,1178352
fldAp,0.5,1,1,AGGGTGGTTCTAGATAAGGT,0,1100322
fldAp,0.5,1,1,AGGGTAGTCCAGTGATACGG,0,1115457
fldAp,0.5,1,1,AGGGTAGCGGGTGAAAGATA,0,1155578
fldAp,0.5,1,1,AGGGTAAGACTTCCCACATC,0,1099854
fldAp,0.5,1,1,AGGGGTTGCTGGAACACATA,0,1108250
fldAp,0.5,1,1,AGGGGTGGGTACTAAGGTAT,0,1120024
fldAp,0.5,1,1,AGGGGAACCACCCAGCGGAT,0,1070344
fldAp,0.5,1,1,AGGGCTGGTGTAAATCTCAT,0,1106893
fldAp,0.5,1,1,AGGGCTGGAAGTTACTGAGA,0,1126888
fldAp,0.5,1,1,AGGGCACTTATCCGGCCCTC,0,1065883
fldAp,0.5,1,1,AGGGATGCAGCCCTAATAGG,0,1082323
fldAp,0.5,1,1,AGGGATAACACTACAGGTTC,0,1100374
fldAp,0.5,1,1,AGGGAGTGTATACCACGAGA,0,1092589
fldAp,0.5,1,1,AGGGAGCAAATGCTATAAGG,0,1068184
fldAp,0.5,1,1,AGGGAATGTGTAAAAAAACC,0,1128932
fldAp,0.5,1,1,AGGGAAACACTCGAGTCGTA,0,1142636
fldAp,0.5,1,1,AGGGAAACAAAGGCATCCAT,0,1095071
fldAp,0.5,1,1,AGGCTTGGGTTGCACTCAAC,0,1145213
fldAp,0.5,1,1,AGGCTTACGACGAGACTTGC,0,1152211
fldAp,0.5,1,1,AGGCTCTGTCGAAACGTGAA,0,1096231
fldAp,0.5,1,1,AGGCTACTATTACCCAAAGA,0,1086240
fldAp,0.5,1,1,AGGCGGTCCAGATTGGTGTA,0,1181442
fldAp,0.5,1,1,AGGCGGCATGGGATCTAGTG,0,1129288
fldAp,0.5,1,1,AGGCGCACGCTGTCAAGGTA,0,1134676
fldAp,0.5,1,1,AGGCGCAAATGGTCTCCCTG,0,1069644
fldAp,0.5,1,1,AGGCGACTCCCGACGTTTAG,0,1081331
fldAp,0.5,1,1,AGGCGACTAAGCATACGGGC,0,1118160
fldAp,0.5,1,1,AGGCCTTGCAACTCCCCTCG,0,1075285
fldAp,0.5,1,1,AGGCCTCGGATGCCGCGACA,0,1114541
fldAp,0.5,1,1,AGGCCGTCGTCGGGCAAGCA,0,1067716
fldAp,0.5,1,1,AGGCCCCGCGCCGCGTTAGC,0,1143914
fldAp,0.5,1,1,AGGCATCCGGAAAAATTCGA,0,1116009
fldAp,0.5,1,1,AGGCAACGTATAGGTGCGTA,0,1147761
fldAp,0.5,1,1,AGGATTCTAGGGATTTACGA,0,1079011
fldAp,0.5,1,1,AGGATTCCCTAGTGCTTGTA,0,1064843
fldAp,0.5,1,1,AGGATTCCATTGGCCGCTCC,0,1071229
fldAp,0.5,1,1,AGGATTCACACTAAGTCGGC,0,1079991
fldAp,0.5,1,1,AGGATCTTCGGGGATAGTTA,0,1079635
fldAp,0.5,1,1,AGGATCGAGCACTGGTAGTC,0,1165038
fldAp,0.5,1,1,AGGAGGATAAACTCGGTGAT,0,1099492
fldAp,0.5,1,1,AGGAGCTAGTCCCTAATTAG,0,1109170
fldAp,0.5,1,1,AGGACTCTATATTTCACATT,0,1123458
fldAp,0.5,1,1,AGGACGCTTGCGACTCCTCG,0,1127639
fldAp,0.5,1,1,AGGACCCTGTGTGGTAACGC,0,1115183
fldAp,0.5,1,1,AGGACCAGTCGGGTAACGCG,0,1170393
fldAp,0.5,1,1,AGGACCAGAAAAGTCGTTAG,0,1145638
fldAp,0.5,1,1,AGGAATGTGTCCCACACTGA,0,1163248
fldAp,0.5,1,1,AGGAAGAGACTGGCGCACAT,0,1133293
fldAp,0.5,1,1,AGGAACTTTGTCCGAAACTT,0,1112830
fldAp,0.5,1,1,AGGAACCTACCTCCACAGTA,0,1133087
fldAp,0.5,1,1,AGCTTCGTAACACTAAATAC,0,1081943
fldAp,0.5,1,1,AGCTTACAAATTTAGAGACT,0,1174667
fldAp,0.5,1,1,AGCTGGTGTCTGGGGTTCCA,0,1095907
fldAp,0.5,1,1,AGCTGCGATCAACTGGGCCA,0,1127236
fldAp,0.5,1,1,AGCTCTTCTCGTTAAGACTT,0,1155001
fldAp,0.5,1,1,AGCTCTCCTCCGTAAGTGTC,0,1131506
fldAp,0.5,1,1,AGCTCTCCAGACACTTCGGG,0,1063915
fldAp,0.5,1,1,AGCTAGATGTTTGCCTTGGT,0,1185190
fldAp,0.5,1,1,AGCGTGTCTACCCTTAGAGA,0,1115833
fldAp,0.5,1,1,AGCGTGGTGCCGTTAGAATC,0,1108869
fldAp,0.5,1,1,AGCGTGCAGGTTTAGCCGAG,0,1140772
fldAp,0.5,1,1,AGCGTATTCGCTGGTAGGCG,0,1175071
fldAp,0.5,1,1,AGCGTAGGGACCCACGTGGC,0,1063698
fldAp,0.5,1,1,AGCGGGTATTAGCTCGAGAG,0,1181953
fldAp,0.5,1,1,AGCGGGCGAAGGGGGTCCTC,0,1084932
fldAp,0.5,1,1,AGCGGATCGCGTCTGAACGG,0,1064227
fldAp,0.5,1,1,AGCGCGGGATGCCAACGTTT,0,1084714
fldAp,0.5,1,1,AGCGCGGAACCCTTTACTAC,0,1152533
fldAp,0.5,1,1,AGCGCGCTCATCATCAGGTC,0,1146307
fldAp,0.5,1,1,AGCGCCTTAAATCGCGCCGC,0,1175954
fldAp,0.5,1,1,AGCGCACTGCCTCTGTCATA,0,1158446
fldAp,0.5,1,1,AGCGACGTTTCAGAAAATTA,0,1134079
fldAp,0.5,1,1,AGCGACATTCCCTCTTTAGC,0,1109201
fldAp,0.5,1,1,AGCGAATGCTATCTCTCGAA,0,1142538
fldAp,0.5,1,1,AGCCTTGGTCGGTTGGAGCT,0,1068078
fldAp,0.5,1,1,AGCCTGTCCACCCTACCCTC,0,1102705
fldAp,0.5,1,1,AGCCTATGTTGATCGTTGAA,0,1080506
fldAp,0.5,1,1,AGCCTAAGGACTTCTCCCTT,0,1111149
fldAp,0.5,1,1,AGCCGTATAGTGGTTTGGGT,0,1178950
fldAp,0.5,1,1,AGCCGCGCAGCAAGAACTAC,0,1132402
fldAp,0.5,1,1,AGCCCTCACTAATACCTTTT,0,1068724
fldAp,0.5,1,1,AGCCCCCTTAAGGGACACTC,0,1180863
fldAp,0.5,1,1,AGCCCAAACATTCCCCTATC,0,1094996
fldAp,0.5,1,1,AGCCATTAGGTAAACAAGAC,0,1178091
fldAp,0.5,1,1,AGCCATGTTCGTTAGTCCAG,0,1113319
fldAp,0.5,1,1,AGCCAGAGCCAAGGGAGGCT,0,1098945
fldAp,0.5,1,1,AGCCACACATTTCGGATTCA,0,1136485
fldAp,0.5,1,1,AGCCAAATAGACGCAGGTAT,0,1102628
fldAp,0.5,1,1,AGCATTTTGGAACTTGCCCT,0,1101147
fldAp,0.5,1,1,AGCATTACCTTAATAATCGT,0,1081554
fldAp,0.5,1,1,AGCAGCGTAGCCTATCGGTC,0,1181117
fldAp,0.5,1,1,AGCAGAGAGCCCTTTATATA,0,1183378
fldAp,0.5,1,1,AGCACTCTCGTTTTGACTCG,0,1138455
fldAp,0.5,1,1,AGCAATCGGATTTTCCGGAC,0,1134687
fldAp,0.5,1,1,AGCAAGGGTGCGGAGAGCAA,0,1132285
fldAp,0.5,1,1,AGCAACAGCAGTGACGAGGA,0,1146497
fldAp,0.5,1,1,AGCAAAGTTTTGAAGTCGCA,0,1077901
fldAp,0.5,1,1,AGATTTTCATCGGCCAAGTG,0,1127582
fldAp,0.5,1,1,AGATTTAGCGTGATACTAGT,0,1089435
fldAp,0.5,1,1,AGATTGGATGTGGTGTTGAT,0,1125560
fldAp,0.5,1,1,AGATTAGGGTGTACCGTCTC,0,1163775
fldAp,0.5,1,1,AGATGGAGACACCGCAGCCT,0,1090777
fldAp,0.5,1,1,AGATGCGAACCAAGGTGTGC,0,1130727
fldAp,0.5,1,1,AGATGAGCGTAAGGGACCCG,0,1085942
fldAp,0.5,1,1,AGATCTTTACACTTGGTGTT,0,1107105
fldAp,0.5,1,1,AGATCGCTGGCACGTCATCC,0,1081452
fldAp,0.5,1,1,AGATCCAAACACGATTCTCT,0,1150626
fldAp,0.5,1,1,AGATACCATGTAGTACACGT,0,1136621
fldAp,0.5,1,1,AGATAATGATCAACTGCACT,0,1155365
fldAp,0.5,1,1,AGAGTGTTAACCAGGGACGA,0,1078801
fldAp,0.5,1,1,AGAGTGCTTTCGACAAAAGT,0,1149045
fldAp,0.5,1,1,AGAGTGCCGTAGCTAGCCTT,0,1186071
fldAp,0.5,1,1,AGAGTCGAATCACCCTGAAG,0,1116731
fldAp,0.5,1,1,AGAGTCCGTGCCCCAAAGGA,0,1149488
fldAp,0.5,1,1,AGAGGTGCCCTAGGATCGCT,0,1140390
fldAp,0.5,1,1,AGAGGTAGTATCTCTTGTTA,0,1138050
fldAp,0.5,1,1,AGAGGTACTGTGAACAGAAG,0,1066824
fldAp,0.5,1,1,AGAGGAAGGCGCGGGTTGAT,0,1165373
fldAp,0.5,1,1,AGAGCTCTGATATGCGAAAA,0,1160906
fldAp,0.5,1,1,AGAGCCCTGCGCATGTACGA,0,1125694
fldAp,0.5,1,1,AGAGCACGAGATTCCCCCGA,0,1146748
fldAp,0.5,1,1,AGAGATGGGAGCGGAAGCAC,0,1135317
fldAp,0.5,1,1,AGAGATGGCTACTATTGGCA,0,1113095
fldAp,0.5,1,1,AGAGATCGATCGCTTGTACT,0,1133212
fldAp,0.5,1,1,AGAGAGGGACACAAGGGTAT,0,1088962
fldAp,0.5,1,1,AGAGAACGGACTTTCATGCG,0,1159556
fldAp,0.5,1,1,AGACTTTGTATACAGAATTT,0,1089222
fldAp,0.5,1,1,AGACTGTGATCACAACAAAT,0,1069233
fldAp,0.5,1,1,AGACTGAGTGGGTAGTAGAG,0,1149899
fldAp,0.5,1,1,AGACTCTATATGCTCTTCCT,0,1172991
fldAp,0.5,1,1,AGACGTACATCAGTATGCGA,0,1166649
fldAp,0.5,1,1,AGACGGGGCTACCGTCAAGA,0,1089252
fldAp,0.5,1,1,AGACGGGAAGAATACCGGGG,0,1147330
fldAp,0.5,1,1,AGACGCCCAGAGTCGGGTCA,0,1069721
fldAp,0.5,1,1,AGACGAAGCATCTAATGGTC,0,1092936
fldAp,0.5,1,1,AGACCTTGACAGATTTCGCT,0,1081954
fldAp,0.5,1,1,AGACCTGGCCGAGAGACCCA,0,1077768
fldAp,0.5,1,1,AGACCGTAATATAACAAATG,0,1184880
fldAp,0.5,1,1,AGACCGCTTGTAGCGTTAAG,0,1109232
fldAp,0.5,1,1,AGACCCTCTCAAAGTGGCGT,0,1183278
fldAp,0.5,1,1,AGACCAGTCCGACTACCAGT,0,1141312
fldAp,0.5,1,1,AGACCACACCCAGAACTTGT,0,1072696
fldAp,0.5,1,1,AGACATACCAATAGAGTCTG,0,1176088
fldAp,0.5,1,1,AGACAGTCTAGGATGCATGC,0,1162171
fldAp,0.5,1,1,AGACAGAGTGAGCGAACGGG,0,1179663
fldAp,0.5,1,1,AGACAGAGTCTTTATGCGAG,0,1171072
fldAp,0.5,1,1,AGACACTACATCAACTTAAC,0,1165911
fldAp,0.5,1,1,AGACACCAGAACGGTCGGCA,0,1138736
fldAp,0.5,1,1,AGACAAGAGCGTTTTCCGTT,0,1183068
fldAp,0.5,1,1,AGAATGCATTGGTATTTCTA,0,1179150
fldAp,0.5,1,1,AGAATACCGCCGAAACGATC,0,1121618
fldAp,0.5,1,1,AGAAGTGGCCGAATCCTCTT,0,1182241
fldAp,0.5,1,1,AGAAGTCCGGTGGGGTAGTA,0,1151375
fldAp,0.5,1,1,AGAAGCCGATGGCTTGTGTT,0,1156135
fldAp,0.5,1,1,AGAAGCATAAGTTTACATCT,0,1158076
fldAp,0.5,1,1,AGAACTGACTTCACGGCCAC,0,1152472
fldAp,0.5,1,1,AGAACTAGCTACGGCACCAG,0,1090782
fldAp,0.5,1,1,AGAACGGTTCCGCGGAGTCA,0,1101303
fldAp,0.5,1,1,AGAACGATGTGACGATTGTA,0,1133984
fldAp,0.5,1,1,AGAAATCCTCTCTGCGAAAT,0,1102326
fldAp,0.5,1,1,AGAAAGTTGTGCGAGAGTGT,0,1127198
fldAp,0.5,1,1,AGAAAGGAGTGGGTAGATGA,0,1085836
fldAp,0.5,1,1,AGAAAATAGTCGTTCCTATT,0,1145684
fldAp,0.5,1,1,AGAAAAGGACTGCATCCGGT,0,1150754
fldAp,0.5,1,1,AGAAAAGCTCTTGACTGCAG,0,1154248
fldAp,0.5,1,1,AGAAAAGACACCAGAACCAC,0,1114372
fldAp,0.5,1,1,ACTTTGGCCGATTCTACGCT,0,1126641
fldAp,0.5,1,1,ACTTTCGACTGGGACAGGCG,0,1101798
fldAp,0.5,1,1,ACTTTCCGAAGCCACTTCGT,0,1132838
fldAp,0.5,1,1,ACTTTATTCATATTTTCCAC,0,1126315
fldAp,0.5,1,1,ACTTGTGCACCAACGCTAAA,0,1186519
fldAp,0.5,1,1,ACTTGTGAGAGACGGAGAGG,0,1185485
fldAp,0.5,1,1,ACTTGAGGTACGCTTATAAA,0,1178295
fldAp,0.5,1,1,ACTTGAAAAAGGAGCTAGGC,0,1180037
fldAp,0.5,1,1,ACTTCTTGCTTCTTTCGGGG,0,1096938
fldAp,0.5,1,1,ACTTCTGGGAGTGCATACCT,0,1069803
fldAp,0.5,1,1,ACTTCTGCCTCGCTTAAGCT,0,1136575
fldAp,0.5,1,1,ACTTCTAGCGACCCTGTTTC,0,1176433
fldAp,0.5,1,1,ACTTCGTTGTCGTACCATCC,0,1067705
fldAp,0.5,1,1,ACTTCGGAGACGGGCGATAC,0,1110973
fldAp,0.5,1,1,ACTTCCTACGGTGCCAGCGC,0,1162136
fldAp,0.5,1,1,ACTTCCGTGCTAAAGCCAGG,0,1093644
fldAp,0.5,1,1,ACTTCCCCAGCGACATCACT,0,1082528
fldAp,0.5,1,1,ACTTCAAGGTCATAAATAGT,0,1095926
fldAp,0.5,1,1,ACTTATTTGAGGCTTGGAGT,0,1079881
fldAp,0.5,1,1,ACTTAGCGTGGCCGCACTTC,0,1098079
fldAp,0.5,1,1,ACTTACTCTTCATATGGTCC,0,1130997
fldAp,0.5,1,1,ACTTAATACCTAAAAGGCCC,0,1166341
fldAp,0.5,1,1,ACTGTTTTTCGGGCCACGAA,0,1127439
fldAp,0.5,1,1,ACTGTGCGAACTGGGATGTA,0,1120051
fldAp,0.5,1,1,ACTGTCAGTCGGGGAAGATG,0,1155257
fldAp,0.5,1,1,ACTGGTACGTGCTTCATCAG,0,1108820
fldAp,0.5,1,1,ACTGGGTGTAGTAGATCGGA,0,1159077
fldAp,0.5,1,1,ACTGGCATGCCGGGCGCCTT,0,1167972
fldAp,0.5,1,1,ACTGCTTGGGGAGGCAGTTG,0,1083446
fldAp,0.5,1,1,ACTGCTCTTAATGTAATGGG,0,1072488
fldAp,0.5,1,1,ACTGCTCTGATCTGGGGTAT,0,1156464
fldAp,0.5,1,1,ACTGCGGGTGTTACTAGGGC,0,1100033
fldAp,0.5,1,1,ACTGCGGGTGGCGGTAGGCC,0,1136009
fldAp,0.5,1,1,ACTGCCTTCACTCTCGACCA,0,1127873
fldAp,0.5,1,1,ACTGATACGCTAGAGATGGG,0,1123829
fldAp,0.5,1,1,ACTGAGCTGGATGCCGCGAT,0,1103610
fldAp,0.5,1,1,ACTCTTCTCATATATGGAAA,0,1100422
fldAp,0.5,1,1,ACTCTGTGGATTTTTCCAGT,0,1070000
fldAp,0.5,1,1,ACTCTAAAGCTATTTGTTAT,0,1144648
fldAp,0.5,1,1,ACTCGTCCGGCCATGCCTCG,0,1171040
fldAp,0.5,1,1,ACTCGGTAACGTCCTATAGT,0,1088153
fldAp,0.5,1,1,ACTCGGGGGCCTCAGGGGAG,0,1105582
fldAp,0.5,1,1,ACTCGGCTGTGTCAGATGGA,0,1099446
fldAp,0.5,1,1,ACTCCTCCACGGTAACCGTA,0,1134331
fldAp,0.5,1,1,ACTCCATCCAATATTTCCGG,0,1177134
fldAp,0.5,1,1,ACTCATTCAGGATGGCCGAG,0,1164395
fldAp,0.5,1,1,ACTCAGCGTCCTCAACGAAA,0,1087360
fldAp,0.5,1,1,ACTCAAAGACTCGCCACACT,0,1111646
fldAp,0.5,1,1,ACTATGGTCGTCATGACTAA,0,1185595
fldAp,0.5,1,1,ACTATATTAACGTCTTCTGC,0,1115216
fldAp,0.5,1,1,ACTAGCATCGGCACGCTCCC,0,1170092
fldAp,0.5,1,1,ACTAGCATCCCATCGCCTAT,0,1128868
fldAp,0.5,1,1,ACTACGGGCCGAGCTAGCCT,0,1073300
fldAp,0.5,1,1,ACTACGACCCTGACCAAGAG,0,1134846
fldAp,0.5,1,1,ACTACCTGGCTTGCAAGCGA,0,1095855
fldAp,0.5,1,1,ACTAACGGGCTGACGGATTA,0,1104233
fldAp,0.5,1,1,ACTAACGCAACTAATAGACA,0,1153679
fldAp,0.5,1,1,ACTAAATGAATACCGATGTT,0,1155277
fldAp,0.5,1,1,ACGTTTCTAGCTGCCCATTA,0,1080594
fldAp,0.5,1,1,ACGTTCTTCGGCAATATCCT,0,1113805
fldAp,0.5,1,1,ACGTTCAGGTATGAGGAGCA,0,1108295
fldAp,0.5,1,1,ACGTGTGGGACTGGTGATTA,0,1162644
fldAp,0.5,1,1,ACGTGGGGGAAGATTTTTCA,0,1148771
fldAp,0.5,1,1,ACGTGCGCCGCCATTAGAGC,0,1179818
fldAp,0.5,1,1,ACGTGAGGTGCTGCGCAAGA,0,1157604
fldAp,0.5,1,1,ACGTGAGAAGATAGAGATAC,0,1178822
fldAp,0.5,1,1,ACGTCCTTGGCAAGGGCGGA,0,1085710
fldAp,0.5,1,1,ACGTCCAGGGACTAATTTGT,0,1125737
fldAp,0.5,1,1,ACGTAGTCAGGTAAAGATCC,0,1119613
fldAp,0.5,1,1,ACGTACAGATTTTCTACAAT,0,1099391
fldAp,0.5,1,1,ACGTAACCAGGAAAGAAAAC,0,1094436
fldAp,0.5,1,1,ACGGTTCCGCCAGCACGCTC,0,1154925
fldAp,0.5,1,1,ACGGTTCAGTAATAGCCTCC,0,1107275
fldAp,0.5,1,1,ACGGTGTGCCACGCCCAGCT,0,1135308
fldAp,0.5,1,1,ACGGTGTCGCTGGGGCCATA,0,1094816
fldAp,0.5,1,1,ACGGTGTCAACGTTTGTCGC,0,1100990
fldAp,0.5,1,1,ACGGTACGTTACCGCCACAG,0,1072599
fldAp,0.5,1,1,ACGGGTTGGTTCTTCTACAT,0,1104612
fldAp,0.5,1,1,ACGGGTCCGAATCGGCCGAG,0,1119594
fldAp,0.5,1,1,ACGGGTCATATAGCAATCCC,0,1169183
fldAp,0.5,1,1,ACGGGGGGGTCATCGACGCA,0,1076432
fldAp,0.5,1,1,ACGGGCTGCGGAGGGGGAGT,0,1066298
fldAp,0.5,1,1,ACGGGCTATTAAGGCTCCTT,0,1094522
fldAp,0.5,1,1,ACGGGCACTGCTTACAGAGG,0,1163744
fldAp,0.5,1,1,ACGGCTCGCCCATGTAGTCG,0,1138392
fldAp,0.5,1,1,ACGGCCCGGGGTTTCCACGC,0,1158088
fldAp,0.5,1,1,ACGGCCCATCCGACAATAGG,0,1140256
fldAp,0.5,1,1,ACGGATCAGATCTCCTATTG,0,1181244
fldAp,0.5,1,1,ACGGATCAACTTCCGGGCAT,0,1154719
fldAp,0.5,1,1,ACGGAGACCGAGCCGCGCCC,0,1164630
fldAp,0.5,1,1,ACGGACACCACACGACATAT,0,1135365
fldAp,0.5,1,1,ACGCTTCTTTCATCACAGGC,0,1140419
fldAp,0.5,1,1,ACGCTGTTTTTCCCGTAAGT,0,1124454
fldAp,0.5,1,1,ACGCGTGCAGTTTTTGCTTG,0,1118010
fldAp,0.5,1,1,ACGCGTCGTGACGCATTCGG,0,1090935
fldAp,0.5,1,1,ACGCGTAGTGGACGCTCGGG,0,1146727
fldAp,0.5,1,1,ACGCGGTGTCGGCAACGACC,0,1079437
fldAp,0.5,1,1,ACGCGGTGACTCTGACACTG,0,1176119
fldAp,0.5,1,1,ACGCGGACGTCAAGCGTTAC,0,1161659
fldAp,0.5,1,1,ACGCGCCTACAACACCTATT,0,1119867
fldAp,0.5,1,1,ACGCCTGAAAAGGGTTCAGA,0,1164865
fldAp,0.5,1,1,ACGCCCGTTCTCTCGGGCTG,0,1070779
fldAp,0.5,1,1,ACGCCATCCGCTGTTTGATC,0,1132128
fldAp,0.5,1,1,ACGCCACCCCGGTGTGCGTG,0,1139708
fldAp,0.5,1,1,ACGCAGCCCGAAGTGAGTAG,0,1116913
fldAp,0.5,1,1,ACGCACTCACTTATTGGTCA,0,1175244
fldAp,0.5,1,1,ACGATTGCGGCGCATCGTCG,0,1177283
fldAp,0.5,1,1,ACGATTCATCGAACGGAATT,0,1098937
fldAp,0.5,1,1,ACGATCGGTCTTAGTTCGGC,0,1176463
fldAp,0.5,1,1,ACGATCCTGGCAGATGGAAC,0,1128687
fldAp,0.5,1,1,ACGATCCCGTTTGGGGATAT,0,1080793
fldAp,0.5,1,1,ACGAGTTTATTACGATATGC,0,1102489
fldAp,0.5,1,1,ACGAGTAGCGACTTGACAAG,0,1108196
fldAp,0.5,1,1,ACGACTTTACAAATCCAGGA,0,1076213
fldAp,0.5,1,1,ACGACTCCTGTGCACCTCTG,0,1157986
fldAp,0.5,1,1,ACGACGCTACAACGGAATTG,0,1109159
fldAp,0.5,1,1,ACGACCGGAGGCGATCTATC,0,1164266
fldAp,0.5,1,1,ACGAATACAGTCATTACGAC,0,1140974
fldAp,0.5,1,1,ACGAACAGACGCGCGTCTGG,0,1132703
fldAp,0.5,1,1,ACCTTTGACTGTTGGGTGGC,0,1184322
fldAp,0.5,1,1,ACCTTTATGATAACGGCGCC,0,1133899
fldAp,0.5,1,1,ACCTTGTTGGGATCAAAGGG,0,1067078
fldAp,0.5,1,1,ACCTTCCGCGTATAGACTCT,0,1074094
fldAp,0.5,1,1,ACCTTCATGGCGGCCATGGA,0,1164749
fldAp,0.5,1,1,ACCTGTTTACCAAGAAAATA,0,1163731
fldAp,0.5,1,1,ACCTGTTCTGGGGTCCGCGG,0,1158891
fldAp,0.5,1,1,ACCTGGGATGTTGACCGAGC,0,1085809
fldAp,0.5,1,1,ACCTGGCGAATGCTCAAGTT,0,1178865
fldAp,0.5,1,1,ACCTGGCCGGAGCATTTGGT,0,1107569
fldAp,0.5,1,1,ACCTGATCGTAGGACCATGC,0,1067510
fldAp,0.5,1,1,ACCTCGCTTGTTACTTGGCG,0,1125981
fldAp,0.5,1,1,ACCTCGCATAATGCCTCCTT,0,1122204
fldAp,0.5,1,1,ACCTCAGGGTCTGCAATCTG,0,1086256
fldAp,0.5,1,1,ACCTCAGAGGCTACTAACGG,0,1133613
fldAp,0.5,1,1,ACCTATGTAACAGAAATTAT,0,1125691
fldAp,0.5,1,1,ACCTATATTCAGAGCGATTG,0,1123768
fldAp,0.5,1,1,ACCTAGTGGTCGAGTTGGCC,0,1131252
fldAp,0.5,1,1,ACCTAGTACCTCCTAGTGGA,0,1153327
fldAp,0.5,1,1,ACCTACCCGACGCGCTTGCG,0,1095082
fldAp,0.5,1,1,ACCTAATATAAGTTCGATCT,0,1069304
fldAp,0.5,1,1,ACCTAATACCTAGGGTAGGC,0,1083581
fldAp,0.5,1,1,ACCTAACGATAGCTCCGCCA,0,1137388
fldAp,0.5,1,1,ACCGTTCTAACGGGGCAGCC,0,1138823
fldAp,0.5,1,1,ACCGTCATAGGCTACGAATT,0,1163658
fldAp,0.5,1,1,ACCGTAATTGAGCTCATTCA,0,1082138
fldAp,0.5,1,1,ACCGGTTACAGGCGAGGAGT,0,1097738
fldAp,0.5,1,1,ACCGGTATACTTGATGATAC,0,1148165
fldAp,0.5,1,1,ACCGGTAATAGGTGAATTAT,0,1107281
fldAp,0.5,1,1,ACCGGGTAAGAGCGGGGCTC,0,1157707
fldAp,0.5,1,1,ACCGGCGTAATTTATAAGAC,0,1132594
fldAp,0.5,1,1,ACCGGCGACGCTCCGTCTAT,0,1155860
fldAp,0.5,1,1,ACCGGATAGTAGTGGTAACG,0,1149150
fldAp,0.5,1,1,ACCGCTGTTCTCTCCCCTAA,0,1154845
fldAp,0.5,1,1,ACCGCTCAGAATCCTTTTCC,0,1083239
fldAp,0.5,1,1,ACCGCCTTTTCGGCGCCTAT,0,1071307
fldAp,0.5,1,1,ACCGCCCTAATTTGGTCCCT,0,1064199
fldAp,0.5,1,1,ACCGCCATTATGCTGTGTAA,0,1067455
fldAp,0.5,1,1,ACCGCCAATCATGTGCAAAC,0,1173422
fldAp,0.5,1,1,ACCGAGTTCGGCTCCATATG,0,1106483
fldAp,0.5,1,1,ACCGAGGAATGACGTTGGTG,0,1082730
fldAp,0.5,1,1,ACCGAGATCCACGGAAGACG,0,1075293
fldAp,0.5,1,1,ACCGACGTAGGTAATGTTCA,0,1107998
fldAp,0.5,1,1,ACCGACCAAGGCCTATCTTC,0,1119893
fldAp,0.5,1,1,ACCGAATGCGAATCTTTGAC,0,1093003
fldAp,0.5,1,1,ACCGAAGGGCTGGCGACTGT,0,1120096
fldAp,0.5,1,1,ACCCTTGACGCGGTAACTGT,0,1088303
fldAp,0.5,1,1,ACCCTGTGGCATTGCATTGG,0,1084287
fldAp,0.5,1,1,ACCCTGGGATCTTCAGAGAT,0,1133650
fldAp,0.5,1,1,ACCCTCTCATTTAAAAGCGG,0,1161149
fldAp,0.5,1,1,ACCCTCCTGCGCCGCCGTTT,0,1154941
fldAp,0.5,1,1,ACCCTCCGCCTTAGAAGAGG,0,1166769
fldAp,0.5,1,1,ACCCTATCTCCGCATGGGGT,0,1175163
fldAp,0.5,1,1,ACCCGTCAACAGAATGAAGT,0,1075244
fldAp,0.5,1,1,ACCCGGTCTTCGGACACTGT,0,1152677
fldAp,0.5,1,1,ACCCGGGTTTAATAATGCAA,0,1074494
fldAp,0.5,1,1,ACCCGGGCGCTTGTGGGTTA,0,1170717
fldAp,0.5,1,1,ACCCGGCGCCTTTGTAGCTG,0,1104790
fldAp,0.5,1,1,ACCCGATTATTTTTCAATCG,0,1163280
fldAp,0.5,1,1,ACCCCTTACGGATCCCCATG,0,1098498
fldAp,0.5,1,1,ACCCCTGCACAGCACGCTGT,0,1117131
fldAp,0.5,1,1,ACCCCCTCATCCCGGGGATG,0,1072498
fldAp,0.5,1,1,ACCCCAGGCTTCATATTGAT,0,1153223
fldAp,0.5,1,1,ACCCCAGCTGGATACACTCA,0,1178533
fldAp,0.5,1,1,ACCCATGGTTATATTTGAGA,0,1136122
fldAp,0.5,1,1,ACCCATGAAGTCCAATGTAA,0,1063298
fldAp,0.5,1,1,ACCCATCCCGACTGGAATGG,0,1105534
fldAp,0.5,1,1,ACCCAATAACCTTCATCCAG,0,1130640
fldAp,0.5,1,1,ACCATTTCATGGAGACTATG,0,1143462
fldAp,0.5,1,1,ACCATTCCCGAGAAAAAAAA,0,1118060
fldAp,0.5,1,1,ACCATGCCTTAAAATTTTAT,0,1138599
fldAp,0.5,1,1,ACCATGCAAGGTCCTGCGCA,0,1069451
fldAp,0.5,1,1,ACCATAGATCCCGGCGTCTG,0,1071861
fldAp,0.5,1,1,ACCAGTAAGCAGCATTTAAT,0,1137438
fldAp,0.5,1,1,ACCAGCGCGGAGGTGTTAAT,0,1081957
fldAp,0.5,1,1,ACCACGTAGTACATAGAACT,0,1063753
fldAp,0.5,1,1,ACCACGGTTGAGGTTCAGGC,0,1168607
fldAp,0.5,1,1,ACCACCGCCCCGGGGAAGTT,0,1156568
fldAp,0.5,1,1,ACCACCATACAGCCAGCCTG,0,1180340
fldAp,0.5,1,1,ACCACACGGCAGGGGCAGCT,0,1100692
fldAp,0.5,1,1,ACCACAATCCATGGTAAACA,0,1099487
fldAp,0.5,1,1,ACCACAAATGCGCCTCCAAA,0,1093942
fldAp,0.5,1,1,ACCAAGGCAAATAGATAGGA,0,1150068
fldAp,0.5,1,1,ACCAAGATGGTCTAAAAATT,0,1167150
fldAp,0.5,1,1,ACCAAGACCAACGAACTCTT,0,1159792
fldAp,0.5,1,1,ACCAACGGCCGGCACAATCT,0,1110604
fldAp,0.5,1,1,ACCAACAAACGCTAATTGAA,0,1103177
fldAp,0.5,1,1,ACCAAAGCGCTGAATTACTG,0,1119344
fldAp,0.5,1,1,ACCAAAGAGTGTCTGAAGGC,0,1131370
fldAp,0.5,1,1,ACATTGGGACCCAAAAGATG,0,1155227
fldAp,0.5,1,1,ACATTATTCTTTCAAAAGGG,0,1089881
fldAp,0.5,1,1,ACATGCTCAGCCTAGGAAAC,0,1151732
fldAp,0.5,1,1,ACATGACGTAGCGCTTCATG,0,1165187
fldAp,0.5,1,1,ACATGAAGTAACCAACTCGA,0,1178402
fldAp,0.5,1,1,ACATCTTATGCCTCGTGGCA,0,1099946
fldAp,0.5,1,1,ACATCTGGGCTTTAATGGGA,0,1092055
fldAp,0.5,1,1,ACATCTCCCCACCTTAAACA,0,1123372
fldAp,0.5,1,1,ACATCTACGGTTGAGCCATG,0,1085238
fldAp,0.5,1,1,ACATCTACATGTGAGGAAAC,0,1165327
fldAp,0.5,1,1,ACATCACTTTACGCTACAGC,0,1140540
fldAp,0.5,1,1,ACATAACGTATCGCACAGTG,0,1096547
fldAp,0.5,1,1,ACAGTTAGCCATCAACAAAG,0,1094408
fldAp,0.5,1,1,ACAGTTACCTGAATCAGACT,0,1106879
fldAp,0.5,1,1,ACAGTCTAACGACGGGTATA,0,1123839
fldAp,0.5,1,1,ACAGTCCTGTAACAGGGAGG,0,1140713
fldAp,0.5,1,1,ACAGTATGATGCTGGAACTA,0,1083651
fldAp,0.5,1,1,ACAGGTGCATTACGCCCACG,0,1079073
fldAp,0.5,1,1,ACAGGTGATCAACCGCGGCA,0,1081935
fldAp,0.5,1,1,ACAGGTCCCACCTGATTAGA,0,1109203
fldAp,0.5,1,1,ACAGGGGGACCTCCCCTTGC,0,1129985
fldAp,0.5,1,1,ACAGGCGTCCTGTGCAAGTA,0,1118903
fldAp,0.5,1,1,ACAGGCCTCATTTTTGGGGG,0,1095146
fldAp,0.5,1,1,ACAGGATAAAAAATAAGCCT,0,1073900
fldAp,0.5,1,1,ACAGGAAACGTTGTATAGCA,0,1087928
fldAp,0.5,1,1,ACAGCTATAGGAGTTTTGAT,0,1086555
fldAp,0.5,1,1,ACAGCGGTACCACTGATGTC,0,1165806
fldAp,0.5,1,1,ACAGCGGGGGGTTCGGCCAT,0,1152104
fldAp,0.5,1,1,ACAGCCTCGGGTATCCAACG,0,1064451
fldAp,0.5,1,1,ACAGCATATCGATCCTGCGT,0,1144285
fldAp,0.5,1,1,ACAGATGTATGTGCTGTCCA,0,1149645
fldAp,0.5,1,1,ACAGACGGTAGTAGTTCCCA,0,1143790
fldAp,0.5,1,1,ACAGACGCTGGAGGCGTGCT,0,1181611
fldAp,0.5,1,1,ACAGAAGCAGATGGCAGGCA,0,1130743
fldAp,0.5,1,1,ACACTGTAACCAGGACTCTT,0,1099413
fldAp,0.5,1,1,ACACGGTTCTTGTATCTTGT,0,1127383
fldAp,0.5,1,1,ACACGGCCCTGAATTGCGAT,0,1133524
fldAp,0.5,1,1,ACACGAGGAGCGCTCCCTCC,0,1160599
fldAp,0.5,1,1,ACACCTTCTGGTACTGTTAA,0,1064945
fldAp,0.5,1,1,ACACCGGTCACGCGTAGTCG,0,1130945
fldAp,0.5,1,1,ACAATTGATGATACTTTAAT,0,1150560
fldAp,0.5,1,1,ACAATTCGCTGGTACACGGT,0,1066287
fldAp,0.5,1,1,ACAATTAACGCCAGTTAATT,0,1154572
fldAp,0.5,1,1,ACAATGGAAAACAGTGCGTC,0,1163392
fldAp,0.5,1,1,ACAATCGTGCGCCTTAATAG,0,1104469
fldAp,0.5,1,1,ACAAGGGTAGGAGTGGCTTT,0,1077035
fldAp,0.5,1,1,ACAAGGCCAGTATGGTGTTA,0,1112850
fldAp,0.5,1,1,ACAAGATGTAATTAGTCCGG,0,1106523
fldAp,0.5,1,1,ACAACTGTCCGATTTGCTCA,0,1182311
fldAp,0.5,1,1,ACAACTAGAATCACTCCAAC,0,1170615
fldAp,0.5,1,1,ACAACGGGATGACCTTTCAA,0,1161676
fldAp,0.5,1,1,ACAACGCGCCGCGGCGGCCC,0,1088377
fldAp,0.5,1,1,ACAACGACCAATAAATAGAT,0,1090991
fldAp,0.5,1,1,ACAACCACAGTGGCTCGAAC,0,1103331
fldAp,0.5,1,1,ACAACCAATCTTGCTCTGTC,0,1125288
fldAp,0.5,1,1,ACAACATCGGACTCTCCTCA,0,1160158
fldAp,0.5,1,1,ACAACATACGTACGCTGTAG,0,1153475
fldAp,0.5,1,1,ACAACAGGTTTGAACAGGCA,0,1072694
fldAp,0.5,1,1,ACAACACGTGTACACTTGAC,0,1141327
fldAp,0.5,1,1,ACAACAATTGACGGTACCAG,0,1112010
fldAp,0.5,1,1,ACAAATTGGGTGCACAACTT,0,1066835
fldAp,0.5,1,1,ACAAATGTCGTTGGATTTAT,0,1120558
fldAp,0.5,1,1,ACAAAGGATCTTTATAACGC,0,1096634
fldAp,0.5,1,1,ACAAAGGACACCTAACCCTG,0,1158473
fldAp,0.5,1,1,ACAAACTTAGTCCAACCCAC,0,1136573
fldAp,0.5,1,1,ACAAACTGGAAATGCACCTA,0,1067286
fldAp,0.5,1,1,ACAAAACTCATAAGCATAAT,0,1178902
fldAp,0.5,1,1,ACAAAACGTGTATCTTGCTA,0,1117875
fldAp,0.5,1,1,AATTTCTATTAAGTTGTAAG,0,1186977
fldAp,0.5,1,1,AATTTCGAGCAGGAGCGTCA,0,1139985
fldAp,0.5,1,1,AATTGTTAGCGAAGTAAATC,0,1178309
fldAp,0.5,1,1,AATTGTCCTGTTAACACTCA,0,1116845
fldAp,0.5,1,1,AATTGGTTGTACAGGATGAA,0,1089139
fldAp,0.5,1,1,AATTGGCTAACCCCGACTGT,0,1169560
fldAp,0.5,1,1,AATTGCGTGCCCTTGGATGA,0,1184659
fldAp,0.5,1,1,AATTGCATCCAATGTTCGTC,0,1152878
fldAp,0.5,1,1,AATTGAATAATGACATTCCG,0,1080730
fldAp,0.5,1,1,AATTCGTCTGCGTCCTGCAG,0,1087566
fldAp,0.5,1,1,AATTCAGTTAGAGACTCGTT,0,1110330
fldAp,0.5,1,1,AATTCAGCAACTCGGGCACT,0,1074708
fldAp,0.5,1,1,AATTAGGCCACGAGACTTGG,0,1132045
fldAp,0.5,1,1,AATTAGACAGTTGGCTGTTA,0,1136522
fldAp,0.5,1,1,AATTACCCCCATGGCGACTG,0,1163054
fldAp,0.5,1,1,AATTAAGCGTCATTTTTACG,0,1181123
fldAp,0.5,1,1,AATTAAAAAATGTCCTCCAA,0,1104211
fldAp,0.5,1,1,AATGTTTGGACGAGATCGCT,0,1063303
fldAp,0.5,1,1,AATGTTCTTCTAATGAGACA,0,1114050
fldAp,0.5,1,1,AATGTCGAGTAGCCGTCATA,0,1150886
fldAp,0.5,1,1,AATGGAGAGGGCGAAGGCTT,0,1077392
fldAp,0.5,1,1,AATGGACGTAGGGCATGCCT,0,1122460
fldAp,0.5,1,1,AATGCTTCATGGACTAACTT,0,1175467
fldAp,0.5,1,1,AATGCTGCTCCTCCAGTAAC,0,1146538
fldAp,0.5,1,1,AATGCGAACGCGATCCCAAG,0,1076988
fldAp,0.5,1,1,AATGCCTTAATCAATGGGCA,0,1109824
fldAp,0.5,1,1,AATGCAAGCCTATGCATGAT,0,1121204
fldAp,0.5,1,1,AATGATTGGCTGTCGATGTG,0,1157573
fldAp,0.5,1,1,AATGATGGCTAAACGGATCC,0,1139469
fldAp,0.5,1,1,AATGAGTTAAGAGGATCGGC,0,1144517
fldAp,0.5,1,1,AATGAGGCGCCCGTTAAGAG,0,1181158
fldAp,0.5,1,1,AATGACGATTCCGGAAGTTA,0,1073729
fldAp,0.5,1,1,AATCTTGTGTGATCGGCTCA,0,1112762
fldAp,0.5,1,1,AATCTTAACCCGTTTTAACC,0,1148833
fldAp,0.5,1,1,AATCTCGACGGCAAGACGGT,0,1092985
fldAp,0.5,1,1,AATCTACAGGGCCATCTACT,0,1115179
fldAp,0.5,1,1,AATCGTTTATTTGCGCAAGG,0,1072969
fldAp,0.5,1,1,AATCGTCCCTCTCTAGATAA,0,1071880
fldAp,0.5,1,1,AATCGGTTCCCCTAAACGCA,0,1108265
fldAp,0.5,1,1,AATCGGTTATTACCATGCAC,0,1081660
fldAp,0.5,1,1,AATCGGTGCGAAATCCCTAG,0,1158486
fldAp,0.5,1,1,AATCGGACGCTCAAGCTGAA,0,1164324
fldAp,0.5,1,1,AATCGCCCCTAGAGCAGTAT,0,1098753
fldAp,0.5,1,1,AATCGAACGGTTCGACGATT,0,1082624
fldAp,0.5,1,1,AATCGAACGGCTATTAGACT,0,1172316
fldAp,0.5,1,1,AATCCTGCAATAGCACTGGG,0,1134328
fldAp,0.5,1,1,AATCCTAAATGGTTTAGGGG,0,1137717
fldAp,0.5,1,1,AATCCGAAACAACTCAACGA,0,1171032
fldAp,0.5,1,1,AATCCCAGCGGGCCGGTTAA,0,1177613
fldAp,0.5,1,1,AATCCACCCTATAGACTACT,0,1176071
fldAp,0.5,1,1,AATCATATGTTCCCGTTGTT,0,1071257
fldAp,0.5,1,1,AATCATAGGGTTGGCAGACA,0,1135936
fldAp,0.5,1,1,AATCAGGGTTCTTAAATTCG,0,1097247
fldAp,0.5,1,1,AATCAATTGGAGGACATCAT,0,1117666
fldAp,0.5,1,1,AATATACCCGCCGTCTCATC,0,1121060
fldAp,0.5,1,1,AATAGTGTCATGGCTCTGTA,0,1117758
fldAp,0.5,1,1,AATAGTACGTAGTGTACGCA,0,1063477
fldAp,0.5,1,1,AATAGGTAGTGGGATTAGTT,0,1064840
fldAp,0.5,1,1,AATAGGTAACCCCACTCTAC,0,1168688
fldAp,0.5,1,1,AATAGGGACCATACCGTGCC,0,1064148
fldAp,0.5,1,1,AATAGCGAACCACCTCAATC,0,1072431
fldAp,0.5,1,1,AATAGAGGGCCGCTTGGTAC,0,1126736
fldAp,0.5,1,1,AATACCCTAGGTTGTCGGGA,0,1080297
fldAp,0.5,1,1,AATACAGTGATGCACCCGGC,0,1178401
fldAp,0.5,1,1,AATACAACCCCTGCGCCCCC,0,1183259
fldAp,0.5,1,1,AATAATGCTAGATCTGAGGT,0,1103378
fldAp,0.5,1,1,AATAACCTCAATTGCGTGAC,0,1101048
fldAp,0.5,1,1,AATAACATGCAGGTGTATAC,0,1136634
fldAp,0.5,1,1,AAGTTTTACCTTCGAACTCA,0,1119490
fldAp,0.5,1,1,AAGTTTGCCAGCGGCAACCC,0,1081392
fldAp,0.5,1,1,AAGTTTCAAGGTAGGAAGGT,0,1167473
fldAp,0.5,1,1,AAGTTTACACACCTCCCCAG,0,1104885
fldAp,0.5,1,1,AAGTTGGAGTCAGAGGTCAT,0,1169400
fldAp,0.5,1,1,AAGTTGAGACGACATTCGGT,0,1100868
fldAp,0.5,1,1,AAGTTCCAAAATATCAAGGT,0,1127494
fldAp,0.5,1,1,AAGTTAAGGCTGGTGTATTG,0,1142809
fldAp,0.5,1,1,AAGTGTTGGTATGTTACCAT,0,1153635
fldAp,0.5,1,1,AAGTGTTCACTTGAAAGTCC,0,1068551
fldAp,0.5,1,1,AAGTGTTAGTCTTCTAGGGC,0,1179561
fldAp,0.5,1,1,AAGTGTGTTAGAGAACTGCA,0,1113094
fldAp,0.5,1,1,AAGTGTCACAAGTATAATCA,0,1158815
fldAp,0.5,1,1,AAGTGGCTCTTGACTTGGGG,0,1176536
fldAp,0.5,1,1,AAGTGGATTAACCATTTAAG,0,1095828
fldAp,0.5,1,1,AAGTGATCTGGAAGGCCTTT,0,1092030
fldAp,0.5,1,1,AAGTGAAGCTACTTTACTCT,0,1102903
fldAp,0.5,1,1,AAGTCTGTGTGCGCGCGTAT,0,1125436
fldAp,0.5,1,1,AAGTCTCAGCACAAAATAGT,0,1144055
fldAp,0.5,1,1,AAGTCATTGCGGCTCGATAT,0,1119700
fldAp,0.5,1,1,AAGTCAGTACGGGCAGGTCA,0,1113644
fldAp,0.5,1,1,AAGTCAATAGACTTTGGACG,0,1132129
fldAp,0.5,1,1,AAGTATGGCGTCCTCGCTCA,0,1063081
fldAp,0.5,1,1,AAGTAATCGGGGTTAATATT,0,1129768
fldAp,0.5,1,1,AAGGTGTTGTACATTGCCTA,0,1093154
fldAp,0.5,1,1,AAGGTCCCAGATTGTTTCGA,0,1184728
fldAp,0.5,1,1,AAGGGCTGGTTAGCATTGAC,0,1152576
fldAp,0.5,1,1,AAGGGCGTTGAGCAGTAGTG,0,1170324
fldAp,0.5,1,1,AAGGGCGTCCTAATCCGTTG,0,1134301
fldAp,0.5,1,1,AAGGGCCTTACTACTTTGCA,0,1178479
fldAp,0.5,1,1,AAGGGCAGTGCTAGAATTCC,0,1086544
fldAp,0.5,1,1,AAGGGATATTATTGCGAGGC,0,1160007
fldAp,0.5,1,1,AAGGCGGGCTTAAGGGCGTC,0,1077760
fldAp,0.5,1,1,AAGGCGAGTAATCTTGGTAG,0,1167908
fldAp,0.5,1,1,AAGGCGAACGTCCAGACACA,0,1065030
fldAp,0.5,1,1,AAGGCCTTCAATTAATTGCT,0,1088254
fldAp,0.5,1,1,AAGGCCGGCGGTGAAGATTA,0,1165862
fldAp,0.5,1,1,AAGGCATTGGAATGGTCCGA,0,1177391
fldAp,0.5,1,1,AAGGCAAAGCCCGGCGCGTC,0,1081296
fldAp,0.5,1,1,AAGGATCGGCATTCTGGAGC,0,1114807
fldAp,0.5,1,1,AAGGAGAGTATCGGTACCCG,0,1101382
fldAp,0.5,1,1,AAGGAGAATCTAACTAAAGA,0,1186811
fldAp,0.5,1,1,AAGGACGCAAATCCATCAAG,0,1071441
fldAp,0.5,1,1,AAGGAATAACCGGCCGTGCC,0,1174239
fldAp,0.5,1,1,AAGGAAACTTCCGCATCCAA,0,1186234
fldAp,0.5,1,1,AAGCTGTCCGAACCGAGGAA,0,1170657
fldAp,0.5,1,1,AAGCTGGGAAGACCAATTGA,0,1097166
fldAp,0.5,1,1,AAGCTCGCCGGGGTACTCAA,0,1170096
fldAp,0.5,1,1,AAGCTCCATATCTAGTTTAG,0,1180098
fldAp,0.5,1,1,AAGCTCAGTCTTTCGAATAG,0,1133079
fldAp,0.5,1,1,AAGCGGTTGTCCGAAACAAC,0,1166464
fldAp,0.5,1,1,AAGCGCGGCGGAGCCGTGTG,0,1159940
fldAp,0.5,1,1,AAGCGCCAGCGCTCGCAAGA,0,1083861
fldAp,0.5,1,1,AAGCCGCCCGCGGTGAGGAT,0,1141362
fldAp,0.5,1,1,AAGCCCAGCTCCCGGTCCTC,0,1125975
fldAp,0.5,1,1,AAGCCAGTAAAGCGGGGATT,0,1107890
fldAp,0.5,1,1,AAGCATGCCGGACTCGAATT,0,1162596
fldAp,0.5,1,1,AAGCATCAGTAGGCAGTGGT,0,1125329
fldAp,0.5,1,1,AAGCAGCCATTCTGTGCAAG,0,1124615
fldAp,0.5,1,1,AAGCACTTGTAGGGGTCGTC,0,1092122
fldAp,0.5,1,1,AAGATTAACCGAGAGGAGGC,0,1089273
fldAp,0.5,1,1,AAGATCGGGGAGTGGGTTAG,0,1156296
fldAp,0.5,1,1,AAGATCCAGGGTTACAAGAA,0,1097988
fldAp,0.5,1,1,AAGATAGGTTCCTAAGATTG,0,1113630
fldAp,0.5,1,1,AAGAGTGAGGAAGTAATGCC,0,1159395
fldAp,0.5,1,1,AAGAGTCTTTCTGCTGAGAT,0,1116109
fldAp,0.5,1,1,AAGAGGCGACTTAGAAACAA,0,1114872
fldAp,0.5,1,1,AAGAGGACATTAAGGGAGAG,0,1146797
fldAp,0.5,1,1,AAGAGCCTCTCATTTGTAAG,0,1081577
fldAp,0.5,1,1,AAGAGCCTAACTGGGGTCTT,0,1144647
fldAp,0.5,1,1,AAGAGCATACGCATCGTTTT,0,1117161
fldAp,0.5,1,1,AAGAGCATAACTATTGATTT,0,1136854
fldAp,0.5,1,1,AAGACGGGTCGTAGAGGGTT,0,1088755
fldAp,0.5,1,1,AAGAATCATGTTCTCTAGTT,0,1087119
fldAp,0.5,1,1,AAGAAGTTCGCGGTGTACTG,0,1070182
fldAp,0.5,1,1,AAGAAGCGTAGCATATGCGG,0,1166290
fldAp,0.5,1,1,AACTTTAACCCAACTGGGAG,0,1083993
fldAp,0.5,1,1,AACTTGTCCAAGAGCCCCTC,0,1124461
fldAp,0.5,1,1,AACTTGATGAGGACCGAATA,0,1077865
fldAp,0.5,1,1,AACTGGTCGCCGCGACCGAC,0,1081963
fldAp,0.5,1,1,AACTGGTAGGAGAGGGTGAA,0,1115509
fldAp,0.5,1,1,AACTGCCGCTGAAATGGATC,0,1169879
fldAp,0.5,1,1,AACTGCCAAAATCGTTATGT,0,1070067
fldAp,0.5,1,1,AACTGATGGAAATTGCCTCG,0,1087256
fldAp,0.5,1,1,AACTGAACTGACGACAGGTG,0,1173593
fldAp,0.5,1,1,AACTGAACTACGTGAGTCCG,0,1099550
fldAp,0.5,1,1,AACTCTTGTCACGAAATCGA,0,1064728
fldAp,0.5,1,1,AACTCTAGTGCGGTAATAAA,0,1169872
fldAp,0.5,1,1,AACTCGTGCGTGTTTCTCAC,0,1174517
fldAp,0.5,1,1,AACTCGGGTTTAGTGGACGC,0,1066769
fldAp,0.5,1,1,AACTCCTTCTATCACAAATT,0,1071662
fldAp,0.5,1,1,AACTATTAATCAATATATCT,0,1172816
fldAp,0.5,1,1,AACTATGCCCATCTTAACTG,0,1123862
fldAp,0.5,1,1,AACTATATCTGCAAATAGTA,0,1153736
fldAp,0.5,1,1,AACTATAGGCCTGCCTTTAG,0,1149673
fldAp,0.5,1,1,AACTATAAGCCCCTCTACGT,0,1082156
fldAp,0.5,1,1,AACTAGAACCCATCCCCTAA,0,1077415
fldAp,0.5,1,1,AACTACTTGTGCAGACCCTT,0,1147266
fldAp,0.5,1,1,AACTAAGAACGGTCTCGTAA,0,1100442
fldAp,0.5,1,1,AACGTGACAATAGATTGCTT,0,1158740
fldAp,0.5,1,1,AACGTAGTTCTGCGGGAAAG,0,1146302
fldAp,0.5,1,1,AACGGGTTACGGACCTGCCT,0,1102987
fldAp,0.5,1,1,AACGGAGTAGGGGATGGAAA,0,1176339
fldAp,0.5,1,1,AACGCTTATCCAACTTTGAC,0,1070326
fldAp,0.5,1,1,AACGCTGTATAAACGTAGTG,0,1172297
fldAp,0.5,1,1,AACGCCTAACATAATCTCGG,0,1170187
fldAp,0.5,1,1,AACGCAAGTAGCACAATAAA,0,1186944
fldAp,0.5,1,1,AACGATCGCGGAGTGTCCGG,0,1151049
fldAp,0.5,1,1,AACGACCGGCGACGTGACCC,0,1098581
fldAp,0.5,1,1,AACGAAGCGTGTAAGCGCGA,0,1073462
fldAp,0.5,1,1,AACCTGGTTTGATCCAGCAC,0,1105168
fldAp,0.5,1,1,AACCTGAGCGACCATGGGTG,0,1150047
fldAp,0.5,1,1,AACCGGCGTGGCGAGGCACG,0,1094719
fldAp,0.5,1,1,AACCGGATGATAAGGGAAAA,0,1173877
fldAp,0.5,1,1,AACCGCATTGGGATGCTAAC,0,1072861
fldAp,0.5,1,1,AACCCCTCCGAAGTTTCAAC,0,1119087
fldAp,0.5,1,1,AACCAGGTAGAGGCTCCAAT,0,1182859
fldAp,0.5,1,1,AACCAGAGGCACCTCCAGTT,0,1110589
fldAp,0.5,1,1,AACCAAGACAGATTTCATTA,0,1113335
fldAp,0.5,1,1,AACATTGGGGGAACGTTGGT,0,1150716
fldAp,0.5,1,1,AACATGTTGAATACGTCGTG,0,1093690
fldAp,0.5,1,1,AACATGACAGTGTTAGTGGA,0,1184851
fldAp,0.5,1,1,AACAGTTCCGGTGCCGGATG,0,1147945
fldAp,0.5,1,1,AACAGTAGCCTACCTGACAA,0,1089008
fldAp,0.5,1,1,AACAGCGTACCATACCTCAC,0,1132811
fldAp,0.5,1,1,AACACTTCCACTCGGAATCC,0,1172272
fldAp,0.5,1,1,AACAAGGAAAGGAACAACAG,0,1086104
fldAp,0.5,1,1,AACAACCGCACCATCACTGA,0,1179197
fldAp,0.5,1,1,AAATTTTTAGCGTATCTTCA,0,1077891
fldAp,0.5,1,1,AAATTTAGATTCACGTTCGG,0,1137958
fldAp,0.5,1,1,AAATTGTCTCGCGTGGCCAG,0,1153331
fldAp,0.5,1,1,AAATTGTCCGCTGTTACGTA,0,1141061
fldAp,0.5,1,1,AAATTGCTTTAGCATCTTCC,0,1186634
fldAp,0.5,1,1,AAATTGCAAGTGAAAAATGT,0,1066528
fldAp,0.5,1,1,AAATGTTGCAGCTGTACTGT,0,1100073
fldAp,0.5,1,1,AAATGCTGGACAGAACTCTT,0,1080942
fldAp,0.5,1,1,AAATCGCCAGATGGTGTAGA,0,1128535
fldAp,0.5,1,1,AAATCAAGTCATTGATTTGA,0,1111902
fldAp,0.5,1,1,AAATATTGTTGGGTGGGATA,0,1079318
fldAp,0.5,1,1,AAATATACTGTACGGGTGAC,0,1102217
fldAp,0.5,1,1,AAATAAAATTAATCCCCGGC,0,1063128
fldAp,0.5,1,1,AAAGTTGGCGTCACTGCCAG,0,1078673
fldAp,0.5,1,1,AAAGTGTGGGGTAGCGATTG,0,1148980
fldAp,0.5,1,1,AAAGGTTAAAGCGTTGTTAG,0,1150343
fldAp,0.5,1,1,AAAGGGGCCTCCGCTAAGGC,0,1163680
fldAp,0.5,1,1,AAAGGGCGGGACTGTTGTAC,0,1118493
fldAp,0.5,1,1,AAAGGGCACACTTTTATGTT,0,1074241
fldAp,0.5,1,1,AAAGGCTCGCGGATGGGTAA,0,1157925
fldAp,0.5,1,1,AAAGGCGGACTATAATAATA,0,1081060
fldAp,0.5,1,1,AAAGGATAGGTGGGCGGTTA,0,1140202
fldAp,0.5,1,1,AAAGGACTGATAGCTGTGCA,0,1160494
fldAp,0.5,1,1,AAAGCTCTAGAATGAATTTC,0,1149375
fldAp,0.5,1,1,AAAGCCTGTCCTCATTGGCT,0,1163666
fldAp,0.5,1,1,AAAGCCATACTAGAGTCGGG,0,1080195
fldAp,0.5,1,1,AAAGATAGCTCCTCAATAAA,0,1093982
fldAp,0.5,1,1,AAAGATACTCGTAAAATAGA,0,1068583
fldAp,0.5,1,1,AAAGAGCTCGCTAATTTCGG,0,1131988
fldAp,0.5,1,1,AAAGAGACCATTTCACAACC,0,1082482
fldAp,0.5,1,1,AAAGACCTCTATAAGTTTCT,0,1165025
fldAp,0.5,1,1,AAACGGTACCTGGCGGGACA,0,1136574
fldAp,0.5,1,1,AAACGGGTCCGAACGATTTT,0,1144526
fldAp,0.5,1,1,AAACGGCAGCATGCTGCCGG,0,1111013
fldAp,0.5,1,1,AAACGCGAATGTGAATAATG,0,1071075
fldAp,0.5,1,1,AAACGACATGGACCTTCTAA,0,1126624
fldAp,0.5,1,1,AAACCTAATTGCGGGACTCC,0,1183981
fldAp,0.5,1,1,AAACCCCATATTCCGATCGG,0,1153682
fldAp,0.5,1,1,AAACAGCGGAGGATGCGTAA,0,1077124
fldAp,0.5,1,1,AAACACCGGTCGCTCCACTA,0,1064326
fldAp,0.5,1,1,AAACAAGTCGCCCTTGGGTT,0,1178221
fldAp,0.5,1,1,AAACAAAAAGGATCGTGGGG,0,1133186
fldAp,0.5,1,1,AAAATGAGAGGTTAACTAGA,0,1178448
fldAp,0.5,1,1,AAAAGTAGCGTAGGACTGGA,0,1168421
fldAp,0.5,1,1,AAAAGTAAAATCAACCCCCT,0,1081708
fldAp,0.5,1,1,AAAAGGTCCAGCCGGTGGCG,0,1100929
fldAp,0.5,1,1,AAAAGGTAAGGCGGGCGTGG,0,1073610
fldAp,0.5,1,1,AAAAGCCAATCCGTAAGCGG,0,1127409
fldAp,0.5,1,1,AAAAGCAGGGAGGGGAGGCT,0,1078400
fldAp,0.5,1,1,AAAACGCGTATCCTTCTGTC,0,1181598
fldAp,0.5,1,1,AAAACGAACTGTAAGGATCT,0,1166077
fldAp,0.5,1,1,AAAACCCTAAATGAGCGTAC,0,1122635
fldAp,0.5,1,1,AAAAAGTCCTATTGCGAGGA,0,1086935
fldAp,0.5,1,1,AAAAAGGGAACTTCGTCTGT,0,1084621
fldAp,139.0,138,0,CTAGTGTGCGCCTTCGTAAT,138,1186656
fldAp,114.0,113,0,AAGCGGTTCGCCTAATTTCA,113,1114238
fldAp,113.0,112,0,TGCAGTACGTCGGCAGTGAC,112,1066618
fldAp,110.0,109,0,CCTAAATCTGTATCAGATCC,109,1095941
fldAp,105.0,104,0,GGGCTCGGGTAAAGGAGAAC,104,1107678
fldAp,104.0,103,0,GGGCCCAGTCTACGAGCGGG,103,1103999
fldAp,99.0,98,0,CCGGATTCAGAACGAGATAC,98,1148616
fldAp,95.0,94,0,ACCCGTGTTTTCCCCTGGAA,94,1118333
fldAp,92.0,91,0,TTTCCGTTGTACTCCTTGTG,91,1114259
fldAp,90.0,89,0,TGACAATAGGGCACTATAGT,89,1063637
fldAp,90.0,89,0,GTATGGGTGGTTCAGCACGA,89,1114246
fldAp,89.0,88,0,TCTTACATAGTATGAAGTTA,88,1178645
fldAp,88.0,87,0,TTTTTCTGGGTGATCAGGGC,87,1066005
fldAp,87.0,86,0,AGTCGTGGTAGAGACTGGGC,86,1147691
fldAp,85.0,84,0,CGGCAATGAAGAGCTGGGTG,84,1107716
fldAp,85.0,84,0,ATCTTGGAACGCCGGCGGTC,84,1126568
fldAp,84.0,83,0,TTTCGTTAATTTGCTCCATG,83,1063532
fldAp,84.0,83,0,GGTTCCGTCCGTCGGGCGCT,83,1063643
fldAp,83.0,82,0,CTTAAGCTCTTCATGATGTA,82,1107691
fldAp,81.0,80,0,GGTATGTATTGCGGATAGGA,80,1066792
fldAp,80.0,79,0,TGCGGTCCATCATTTCAGCT,79,1114244
fldAp,80.0,79,0,ATCGAGACACGCGAGCTAAC,79,1118395
fldAp,78.0,77,0,ATTTCGCGGTACAAGCACTC,77,1096820
fldAp,77.0,76,0,AGCATAAAGATGAATACTTT,76,1073008
fldAp,76.0,75,0,TAGCCTGTTTTTTGACCGAT,75,1159934
fldAp,76.0,75,0,GAGGCCGTATTATAGTGTGC,75,1107688
fldAp,76.0,75,0,ACGAAACTAAAACCCCCGTA,75,1143606
fldAp,75.0,74,0,TCGCAATGCGTATAGTGAAA,74,1164780
fldAp,75.0,74,0,GGCTCCATGGCCTACGAGTG,74,1083891
fldAp,75.0,74,0,AGAACGGGATCCTAGCGGTC,74,1159891
fldAp,71.0,70,0,GTGCCTCAAGCTTGATAACT,70,1151900
fldAp,71.0,70,0,CGAGCTCCTACACAATGCGC,70,1120767
fldAp,71.0,70,0,ATGAGGAAAGGCACAGACCA,70,1115956
fldAp,70.0,69,0,AGTGGTGATTCTGGATGGCA,69,1160839
fldAp,68.0,67,0,AAACTATCCTAGTCGTCGTT,67,1074577
fldAp,65.0,64,0,AGCACCAGCGTGGCCGACAT,64,1112395
fldAp,64.0,63,0,CGACTGATCACGGTGCGATT,63,1088220
fldAp,63.0,62,0,TCAGTAATTAACTTGACCCC,62,1073381
fldAp,63.0,62,0,GTCCAGGTGCTCGAAGGTCC,62,1103211
fldAp,63.0,62,0,GGCGGGAAGCCAGCTGCCAC,62,1174613
fldAp,62.0,61,0,TTGCAAACCCAGCCACGGAA,61,1186646
fldAp,62.0,61,0,GGTCGTATAGGCGACTCTTA,61,1063667
fldAp,61.0,60,0,CGCTCCGTGTGGGGTGGTTT,60,1127719
fldAp,61.0,60,0,CGCCAGTCTGACTTCTCGCA,60,1124067
fldAp,61.0,60,0,CCCCGACGATACTCTGTTCA,60,1070271
fldAp,61.0,60,0,CAAGAACCGCTTGGTGGTAG,60,1178667
fldAp,60.0,59,0,TGGTGGTACTTGTGCGACAA,59,1063644
fldAp,60.0,59,0,CTGTGTAGTTACGGTTAACT,59,1144851
fldAp,60.0,59,0,AAGCGGGCTGTAAATAAATG,59,1143527
fldAp,60.0,59,0,AAACACCCCTGAGCGAGGTG,59,1181897
fldAp,59.0,58,0,TGTGCAATAATACAGTTGCT,58,1154107
fldAp,59.0,58,0,CTGAGTCAGCTTACACCTAT,58,1119169
fldAp,59.0,58,0,CGCACACTGCGTTGTTGGTT,58,1086156
fldAp,58.0,57,0,TGTCCATGCCTAGGATATCG,57,1118348
fldAp,58.0,57,0,GGTGCAAAAGGGCCTACTCG,57,1142838
fldAp,58.0,57,0,GGACTATGCTTATAGATACA,57,1064569
fldAp,58.0,57,0,CAGTAGGCTAAACTGAAGGG,57,1073352
fldAp,58.0,57,0,CACGCTCCCATGAAGAGAGA,57,1176950
fldAp,58.0,57,0,ACCACTAGCTTCGCCTCAAC,57,1174608
fldAp,57.0,56,0,TTCACATCTTCATCCATCGG,56,1163100
fldAp,57.0,56,0,TGTCCCACCACAATTGCGCC,56,1113254
fldAp,57.0,56,0,GAGAGAGGGTGTATCCACGA,56,1073333
fldAp,56.0,55,0,CTCTGTTATTTCGCCTGAGC,55,1095061
fldAp,55.0,54,0,TTATCGATGACGGCTAATAA,54,1135701
fldAp,55.0,54,0,TATCTCTCGCGCCGGCTTGA,54,1099040
fldAp,54.0,53,0,TTGTGACGCGACGGACTGAG,53,1126571
fldAp,54.0,53,0,TGAACGAGCCCTACGCTTGT,53,1126607
fldAp,54.0,53,0,GATTCAATGTTGGCATTATG,53,1117383
fldAp,53.0,52,0,ACCATGACGGTCAACGAGGA,52,1137054
fldAp,52.0,51,0,GAGAAACAGACGGGTCGATT,51,1066023
fldAp,52.0,51,0,GACACCCTAATAGGTAGTTA,51,1106293
fldAp,51.0,50,0,GGCGGATTGTAGCATTCACC,50,1166698
fldAp,51.0,50,0,CCGCCACGGATGCAGAGTCC,50,1100723
fldAp,51.0,50,0,CCAAAAAGTCGCATTCGGGA,50,1143519
fldAp,50.0,49,0,CTATGCCGACCTTATAGTAT,49,1135066
fldAp,49.0,48,0,TTCTATAGGTTCTACAATTC,48,1143118
fldAp,49.0,48,0,CTCGTTTGCCACCAGGCGAC,48,1068603
fldAp,49.0,48,0,CGTTGATGACTTCCAGAAGT,48,1184852
fldAp,49.0,48,0,CGGCCCTCTGGCGGAGGTCC,48,1107560
fldAp,49.0,48,0,AGTTCCTGATCGGAGGAGAG,48,1170012
fldAp,48.0,47,0,CTAGTCTAGCCTTCAACTTG,47,1137796
fldAp,48.0,47,0,CATCCATTCGTACTGCGGCC,47,1137561
fldAp,47.0,46,0,TGTAGTCTGATACTGAAGTG,46,1066037
fldAp,47.0,46,0,ATCAGCGGAGGCACATAAGC,46,1103981
fldAp,46.0,45,0,CTTGCGGCAGGTGTCTGACT,45,1140212
fldAp,46.0,45,0,AGAAAAGATCACGTAGATAC,45,1159633
fldAp,46.0,45,0,AAACGCTCTAAATGTATTGA,45,1124039
fldAp,45.0,44,0,TTCTCACGTACACATGCTAG,44,1090887
fldAp,45.0,44,0,CGCAGACCTAGTAACAGCGA,44,1118782
fldAp,45.0,44,0,AGCCTTAATTTACCATGCGT,44,1179334
fldAp,44.0,43,0,TTTTGCGCCATTCTGCACCA,43,1103452
fldAp,44.0,43,0,TCTCCTTAGTTTTCAAGACT,43,1153082
fldAp,44.0,43,0,GCTTTTGTCGGGTTAGCCTA,43,1157995
fldAp,44.0,43,0,CGGTGGTTGTGTATTCTAAA,43,1149974
fldAp,44.0,43,0,AGACGTCCCAAGGATATGAC,43,1087269
fldAp,43.0,42,0,TTCTCGTAGTGACGTGTTAT,42,1126570
fldAp,43.0,42,0,TTATGCTACGCACTATTGCT,42,1170565
fldAp,43.0,42,0,TGCAGCTAACTGAGAATCTA,42,1073374
fldAp,43.0,42,0,TGACTCCCGTACGGAAGACA,42,1149154
fldAp,43.0,42,0,TCCTTGAAGGGGCGAAGGAT,42,1170671
fldAp,43.0,42,0,TAGCCTACTTCCTCACCCTA,42,1178718
fldAp,43.0,42,0,GCCTTGGCGTCACACGCCTA,42,1107689
fldAp,43.0,42,0,CAGACGAAAACACAACCTTG,42,1186672
fldAp,43.0,42,0,CAAGTGCTCTAGCATCCCAT,42,1101990
fldAp,43.0,42,0,ACAGTGACCCCGGTACACGC,42,1094033
fldAp,43.0,42,0,ACAAGGGTCATTTCAGCGCA,42,1126430
fldAp,42.0,41,0,GTGCAATGGCAGTTATATGA,41,1101355
fldAp,42.0,41,0,CTAGCATGCATAGCTTAGCT,41,1073351
fldAp,42.0,41,0,CGACTTTCTGCCGCTCGCTC,41,1068934
fldAp,42.0,41,0,ATCCGTGGGCACTAGGTGCA,41,1176952
fldAp,42.0,41,0,ACAGTCCGAACTTCGGATAC,41,1124856
fldAp,41.0,40,0,GGGCGTATCAAGCTATCTAC,40,1108873
fldAp,41.0,40,0,AGTCTCCCCGCGTATGGGTC,40,1159668
fldAp,41.0,40,0,AGAAGTTCGCTTTCCATGAA,40,1174590
fldAp,41.0,40,0,AAAATGTGTGATCCGAATTA,40,1112499
fldAp,40.0,39,0,TTCTATAAGGCGATCTGGGA,39,1093364
fldAp,40.0,39,0,GTTGGGGGGGTGGTGGCGGG,39,1119637
fldAp,40.0,39,0,GCAGATCGCAAGCTGTGCTA,39,1112427
fldAp,40.0,39,0,CTCCCAGCGAGATTAGCACG,39,1063563
fldAp,40.0,39,0,CCTGCATAAATTTGAGCGCC,39,1126534
fldAp,40.0,39,0,CAGCACGCGTTGGACAGAAA,39,1072004
fldAp,40.0,39,0,ATACTACATCGTCATAACGA,39,1137640
fldAp,40.0,39,0,AGGGCCTCGTATTAATATTA,39,1156283
fldAp,40.0,39,0,AGCTAACAGGCGGGCCACAT,39,1141986
fldAp,40.0,39,0,ACTCTAAAACGTCGCAGCCA,39,1066922
fldAp,39.0,38,0,TACCGTCCGTGACGTTATCT,38,1109713
fldAp,39.0,38,0,GCAGACACGCAATGGCGGCA,38,1099205
fldAp,39.0,38,0,CTGCGTGCCCTATTCAAGTC,38,1106840
fldAp,39.0,38,0,AGCGGACGGGTAAGCCGCAC,38,1115013
fldAp,38.0,37,0,TTATTCCCTACTTGCTGAAG,37,1147338
fldAp,38.0,37,0,TCATTTCAAAGTATGGCGCG,37,1108113
fldAp,38.0,37,0,TAAACACAAGTTTTGTAACC,37,1083616
fldAp,38.0,37,0,GGAAAACGAGCTATACTAGC,37,1109048
fldAp,38.0,37,0,GACATCCTCTGCATCTGTGC,37,1082065
fldAp,38.0,37,0,GACACGGGGTAAAAACGGCC,37,1177702
fldAp,38.0,37,0,ATAGGTATGCCGTTCTAGCT,37,1157828
fldAp,38.0,37,0,AGCAGTCTCGTGCCGCTGAC,37,1114298
fldAp,38.0,37,0,AAGCACGTTAACGGGCCATA,37,1089399
fldAp,37.0,36,0,TGAGGGAAAGACACTCCAAA,36,1127971
fldAp,37.0,36,0,TCTTTTGCCTCCAATCTACT,36,1082744
fldAp,37.0,36,0,TCTGAACGTGGTAAAGTGTA,36,1080724
fldAp,37.0,36,0,GGGGAGCCCCCCCTCTTGAT,36,1185264
fldAp,37.0,36,0,GCCTTCGGTTGGTCCTTGAC,36,1186643
fldAp,37.0,36,0,CTATGCCTTTGTTCACCTAT,36,1144325
fldAp,37.0,36,0,CACCTGAGACTCTGATTGAG,36,1157711
fldAp,37.0,36,0,ACTCTTCTCCATTCCTTTTG,36,1174064
fldAp,36.0,35,0,TTTAGTATGTGTAAGGGGCT,35,1122234
fldAp,36.0,35,0,TGACAAGATCGAACGGATTG,35,1166355
fldAp,36.0,35,0,TCCGTAGGGTCGAAGTGACC,35,1159242
fldAp,36.0,35,0,TCACTAACAGACGTCAGTTA,35,1065956
fldAp,36.0,35,0,GGCTCTAATGCGAGAGGCTC,35,1151204
fldAp,36.0,35,0,GCTGCCCCGGTTACGTCTCG,35,1138804
fldAp,36.0,35,0,GCGAGCGTGCGCCAGATGAC,35,1092490
fldAp,36.0,35,0,CGGTAGTGTGACCTGGTGAT,35,1099754
fldAp,36.0,35,0,CGGAGTAAAAGAAGGTGAAG,35,1067520
fldAp,36.0,35,0,CCGTGAAAATAATTTTTCGA,35,1070149
fldAp,36.0,35,0,CATCTAGCGCCCCAATTGCA,35,1091661
fldAp,36.0,35,0,CAGGGCACTTGTCTGGTAAG,35,1179666
fldAp,36.0,35,0,AGTTCGACAGAGCATATGCG,35,1165021
fldAp,36.0,35,0,ACCGATCATCGCTGTGAGCT,35,1081594
fldAp,36.0,35,0,AAATATGGCGTGGGACCGCG,35,1143949
fldAp,35.0,34,0,TCATTTAAGCTTCTGAATGC,34,1174228
fldAp,35.0,34,0,TAGGACACTGTGTTTCTCGA,34,1141071
fldAp,35.0,34,0,GAGGGTTGCATTTCGTCAAC,34,1135852
fldAp,35.0,34,0,CTTGTCTCGATGAACATCCT,34,1109682
fldAp,35.0,34,0,CTCTTCCGCGCCACGATCGG,34,1112385
fldAp,35.0,34,0,CCCTTGAAAATCCCCGCATT,34,1076558
fldAp,35.0,34,0,CCAGTTAAATTAAATTGGAA,34,1097716
fldAp,35.0,34,0,CCACGTCGCGTCGAGTGCTG,34,1103429
fldAp,35.0,34,0,CACGAAGAAAAAGAAAGCTC,34,1141479
fldAp,35.0,34,0,ACATGTAATGGTATCGCTGA,34,1105502
fldAp,34.0,33,0,TTCCGTGATCGAGCGAACAC,33,1132681
fldAp,34.0,33,0,TCTGCAAAAAAACACCTAGC,33,1132206
fldAp,34.0,33,0,TCAAAGACAGAGTGGCATGG,33,1134760
fldAp,34.0,33,0,TAAGTCTAACGTAGGCCCTT,33,1077197
fldAp,34.0,33,0,GGCTATGGACAGCACCAGCG,33,1168002
fldAp,34.0,33,0,GCAGGCGGGCTACTCGGCAC,33,1148405
fldAp,34.0,33,0,CTGCAGCTAAGTGAGACTCG,33,1082611
fldAp,34.0,33,0,CCGTGAAGCCTGACTGCACT,33,1145313
fldAp,34.0,33,0,CCCGGTAAAGAACTCTGCTC,33,1166681
fldAp,34.0,33,0,CATGTTGCGTTGCCCACATG,33,1080469
fldAp,34.0,33,0,ATAAGTTGGAAACGTGACCA,33,1063607
fldAp,33.0,32,0,TTTGCATTCGATTTAACCAA,32,1148677
fldAp,33.0,32,0,TTCCCGCCTCCGCGTTCAAT,32,1093212
fldAp,33.0,32,0,TTACGGGAGATCGCGTTTGA,32,1088203
fldAp,33.0,32,0,TGGACATCTGTTGGGTGAAA,32,1183474
fldAp,33.0,32,0,TAGCGCCGCCTGGGCTGCTC,32,1173863
fldAp,33.0,32,0,TACCTGGCAAACACGGGATC,32,1109633
fldAp,33.0,32,0,GTCCAACCGAACGCGGCACG,32,1146185
fldAp,33.0,32,0,GTCAGACCACTAATGTGTAG,32,1170232
fldAp,33.0,32,0,GTAGGATAGCCACGGTCTAC,32,1065876
fldAp,33.0,32,0,GGCGGCGACTCGCCTGTGTA,32,1148812
fldAp,33.0,32,0,GCGGAATATCATTTGTGATA,32,1116801
fldAp,33.0,32,0,GCGCGGTTGTGTCCGGATGA,32,1174755
fldAp,33.0,32,0,CTGTGCAATCCACAGTGGAC,32,1063657
fldAp,33.0,32,0,CTGGATAGGGTCGCCTCAGC,32,1178404
fldAp,33.0,32,0,CCTCTAACTTGGCGCAACGT,32,1089977
fldAp,33.0,32,0,CCGCGCGTCTGGGATGCTCT,32,1146686
fldAp,33.0,32,0,CATTTAGAGATTTGCTCCAC,32,1147100
fldAp,33.0,32,0,CAAAATAAGCCCGTATAACC,32,1163114
fldAp,33.0,32,0,ATGTGGTTATGCGCAGTAGA,32,1149371
fldAp,33.0,32,0,ATAAGGTTCCACATCTAGAC,32,1063584
fldAp,33.0,32,0,ATAACTCCCGCGAGTAGGCA,32,1169720
fldAp,33.0,32,0,AGCAGTATACTTGGACACAA,32,1107135
fldAp,33.0,32,0,ACATTTCCGTCTTTAAGGAC,32,1063613
fldAp,32.0,31,0,TTTGCGACGGGTGAGCGGTA,31,1159320
fldAp,32.0,31,0,TTTAAGCTTATTACACCGGG,31,1111426
fldAp,32.0,31,0,TTCTTAGTTCTATTGCCAAC,31,1140574
fldAp,32.0,31,0,TTAACAAGCAGGCCTGGGAT,31,1105918
fldAp,32.0,31,0,TCGCCAATATCGCACATACA,31,1120486
fldAp,32.0,31,0,TCAAAACGATCACTTCGTGC,31,1186429
fldAp,32.0,31,0,TATAAATTTTAAGTCTTCCC,31,1181170
fldAp,32.0,31,0,GTTATACCAGATTCAATGCA,31,1111441
fldAp,32.0,31,0,GTGTAATTACTGTTGAACAC,31,1075433
fldAp,32.0,31,0,GGGCATGGCGTGACGTCACT,31,1087531
fldAp,32.0,31,0,GGCGCGAACTGCATACCTTA,31,1146235
fldAp,32.0,31,0,GAAAGGGGAAGGCGGAATAA,31,1182554
fldAp,32.0,31,0,CTATTGCCGATGTGATTGAG,31,1153345
fldAp,32.0,31,0,CGTCAACCAAAAGCCGGCAG,31,1095510
fldAp,32.0,31,0,CCAGGTTACGAAGGGATTGG,31,1087245
fldAp,32.0,31,0,CAATGCTCCTCTGTTGGTGT,31,1105857
fldAp,32.0,31,0,AGTAAGCATCATACACCAGT,31,1105490
fldAp,32.0,31,0,AGCGCCAATACTGCACATCA,31,1135332
fldAp,31.0,30,0,TTAGGGGTTTATATAGTGAC,30,1143943
fldAp,31.0,30,0,TCAGGCCTGTAAGACGCAGC,30,1137645
fldAp,31.0,30,0,GTAATTTGGGGAATCAGCAG,30,1143653
fldAp,31.0,30,0,GGCACGCCAATCGTATTACC,30,1175278
fldAp,31.0,30,0,GAGCCCAAAAGCCCTAAGTT,30,1111599
fldAp,31.0,30,0,CTGTGCCGAGTACGTGAATG,30,1177271
fldAp,31.0,30,0,CGAGCTCCGCCTGCCGTGTA,30,1144264
fldAp,31.0,30,0,CACAACACGACCACTCAACA,30,1153825
fldAp,31.0,30,0,ATAACCTAGTTTAGCCATTT,30,1067392
fldAp,31.0,30,0,ACTGCAAGCGTAGGCACAAC,30,1132999
fldAp,31.0,30,0,ACTCCGGGCTGGGGATCTGC,30,1159733
fldAp,31.0,30,0,AATTAGGTCACAACTCTGTG,30,1177220
fldAp,30.0,29,0,TTGCCGTAACTAATAACATA,29,1082924
fldAp,30.0,29,0,TTGAAGCTAGGAGGCCGAAT,29,1073341
fldAp,30.0,29,0,TTAGTCGGCGGTTAATTCGG,29,1119730
fldAp,30.0,29,0,TGTAGCGGGTCTCTAGTCCA,29,1184738
fldAp,30.0,29,0,TCATCTGTCGTGACTCTCAT,29,1130680
fldAp,30.0,29,0,TAAAGCGTGAACGTCTAATA,29,1105917
fldAp,30.0,29,0,GGACTACTAGCGGCCGGTAA,29,1097377
fldAp,30.0,29,0,GCGATAGCGACTGTGGGTGG,29,1176958
fldAp,30.0,29,0,CGCTATCAGGTCGTTGGTTC,29,1114605
fldAp,30.0,29,0,CACAAAAGTGGAGCACACTC,29,1160519
fldAp,30.0,29,0,ATTCTGTAGGAAGTTCCGAC,29,1166685
fldAp,30.0,29,0,ATCTGCAAAGAGTTGAGGGG,29,1109311
fldAp,30.0,29,0,AATCACCATAATCAGGACTA,29,1082290
fldAp,29.0,28,0,TTGAGTCCAGGCATATTTAC,28,1078594
fldAp,29.0,28,0,TGAAGCGAGTAAAGGTTCCT,28,1096609
fldAp,29.0,28,0,GGGGGCTTAAACAATAACTA,28,1115045
fldAp,29.0,28,0,GGGGCCGTTAACAGGGTGGC,28,1178656
fldAp,29.0,28,0,GCTTTTAGGTGAAGGTCGCA,28,1069425
fldAp,29.0,28,0,GATTAAGGGACGCCACCGAA,28,1119869
fldAp,29.0,28,0,CGTCGCGCAGTTCGGAAGTA,28,1069147
fldAp,28.0,27,0,TTTTAAGTGTCGTAATATGC,27,1135578
fldAp,28.0,27,0,TGATACACCAGCACAGTTTT,27,1094597
fldAp,28.0,27,0,TGAATTCTTGCCTTGACCGA,27,1180343
fldAp,28.0,27,0,TCAGTGAGTAGGGGATCGCA,27,1166241
fldAp,28.0,27,0,TAGCTTTCCGACACTACTTG,27,1170545
fldAp,28.0,27,0,GTGGAGAAGGGCTATACAAT,27,1123847
fldAp,28.0,27,0,GGTCTACGGAATGGCGAGAG,27,1166751
fldAp,28.0,27,0,GCATTGCGTTCCACGGGCTG,27,1086505
fldAp,28.0,27,0,CTCTCCAAGCTTTATATGTA,27,1134582
fldAp,28.0,27,0,CTCATGCCGGCCTGAAACTA,27,1063679
fldAp,28.0,27,0,CTAAGGAAATTTTTCTCTAG,27,1172443
fldAp,28.0,27,0,CCTCCGTGGAGACACTAATC,27,1162756
fldAp,28.0,27,0,CCTCCATGAAAATCTAAGTC,27,1098707
fldAp,28.0,27,0,CCGATGACCAGTCGCGATCG,27,1166951
fldAp,28.0,27,0,CAATTGGCGCTGCTAACGCT,27,1088180
fldAp,28.0,27,0,ATCAGAAGCCGTGCGGGTTA,27,1082655
fldAp,28.0,27,0,AGTTCTCTAAGTTGGCTAAG,27,1142569
fldAp,28.0,27,0,AATCTGCGAAACGGTAAGAC,27,1091561
fldAp,28.0,27,0,AACGGTATTAGCAATATCCC,27,1099762
fldAp,27.0,26,0,TTTGAGCTCTAGTAAACTTC,26,1096741
fldAp,27.0,26,0,TTGCTCACGATACAACACTG,26,1109071
fldAp,27.0,26,0,TTCCTTCATGTGCTACTCTT,26,1139618
fldAp,27.0,26,0,TCGCGTTAAATTCCCCGGGT,26,1083115
fldAp,27.0,26,0,TATAGCAGTGTTAGAATTCA,26,1146230
fldAp,27.0,26,0,GGGCAAGAGGTCAATGGGAA,26,1131451
fldAp,27.0,26,0,GCGGAGTCCGATTTAATAAA,26,1149701
fldAp,27.0,26,0,GCGCGTACCGGCGTTCGGCT,26,1127466
fldAp,27.0,26,0,GCCAACTGTCGGTCCACGTG,26,1077095
fldAp,27.0,26,0,GCATTTTAATTGGGTCAGGG,26,1173587
fldAp,27.0,26,0,GAGGTACAAAATCCAGTTTA,26,1155710
fldAp,27.0,26,0,GACGTTACTGGACGTCAAAC,26,1171648
fldAp,27.0,26,0,CTTACGGAAGCGACGCGGAC,26,1063861
fldAp,27.0,26,0,CTACGAGAGCTTACCCTCTG,26,1134584
fldAp,27.0,26,0,CCTTCAGAGGATGCTGTCCT,26,1076122
fldAp,27.0,26,0,CATGTTGATGAACATTCTGT,26,1063697
fldAp,27.0,26,0,CAGGGTCTAGTCTAATAAAT,26,1108460
fldAp,27.0,26,0,AGCTGAGTCCTCAACTGAGT,26,1068000
fldAp,27.0,26,0,ACTCAGCGCCCTAGAAAGGC,26,1182991
fldAp,27.0,26,0,ACCTTAGTGAAGCGCTTAGT,26,1108078
fldAp,27.0,26,0,AATTTTACATCTCTGGCGTG,26,1073735
fldAp,27.0,26,0,AACTGCGGGTCACCTTTCCA,26,1179982
fldAp,26.0,25,0,TTTAACATGGTGACACGTTT,25,1108343
fldAp,26.0,25,0,TTGGTTGCATATCGTAATGT,25,1178652
fldAp,26.0,25,0,TTGACCGACTATGCTAGTTC,25,1090395
fldAp,26.0,25,0,TGCTGTGTAAAGATAGGCTT,25,1149590
fldAp,26.0,25,0,TCGGGCGGTATAGAAATGAA,25,1183028
fldAp,26.0,25,0,TCCGACGGCAGGGGAACATA,25,1111475
fldAp,26.0,25,0,GGGTTTTGGCCGTAAGAATT,25,1089954
fldAp,26.0,25,0,GGACTATGACCTAAAAGTAT,25,1127323
fldAp,26.0,25,0,GGACCAATTAATAACTCTTC,25,1099793
fldAp,26.0,25,0,GCTATGATGCAGCGAGTGTG,25,1066031
fldAp,26.0,25,0,CTTTAGTGGCCAGTGGGCGA,25,1138525
fldAp,26.0,25,0,CTAGGAGCAAGCGCATACAG,25,1154689
fldAp,26.0,25,0,CGTTGCTAAAGTTTCAACTC,25,1102262
fldAp,26.0,25,0,CGCATGGTTTCTCCATGTTA,25,1118636
fldAp,26.0,25,0,CAGGGTTTAGGCGACCACCA,25,1157941
fldAp,26.0,25,0,CACCGGCGTCCATGGGATAG,25,1136754
fldAp,26.0,25,0,ATTAAGCCACTGGGGTCTAA,25,1171276
fldAp,26.0,25,0,ATGGCATAGATCTTATTACT,25,1084649
fldAp,26.0,25,0,ATCCTTATTAAATCTCAGGG,25,1186510
fldAp,26.0,25,0,ATACTCCGGGTGCGTGATCA,25,1179364
fldAp,26.0,25,0,ACTTCTAATTAACGACCGAG,25,1094108
fldAp,26.0,25,0,ACCTCAACTTAGCACGGTGG,25,1087287
fldAp,26.0,25,0,AACGACCTATCTGGAACCGA,25,1151302
fldAp,25.0,24,0,TTTTATAGAACAGACCAGTC,24,1112210
fldAp,25.0,24,0,TTTAGTAAGGTTGCACAAGT,24,1118079
fldAp,25.0,24,0,TTATGTACGCTACTGCCACT,24,1084463
fldAp,25.0,24,0,TTACCGCCAAGATTAATAGC,24,1105220
fldAp,25.0,24,0,TGGATTGGATGACATGCCTC,24,1157969
fldAp,25.0,24,0,TGGAATGCATTAGCATACTA,24,1072034
fldAp,25.0,24,0,TGCGACGAAAAGAAGCAAAT,24,1108493
fldAp,25.0,24,0,TGCCATAGACGAGTGCAAAA,24,1076510
fldAp,25.0,24,0,TGAATGGAGTCACCCAAAAC,24,1066059
fldAp,25.0,24,0,TCGAGGCCCAGCTAGCATAT,24,1145086
fldAp,25.0,24,0,TATGTCGGCTTTGCGCGCAG,24,1186116
fldAp,25.0,24,0,TACCTAACCGCGACTGCCAC,24,1124063
fldAp,25.0,24,0,TAAGCCTGATATCGTTAACG,24,1140767
fldAp,25.0,24,0,GTTGTCTCCGGACGTAGGCG,24,1146164
fldAp,25.0,24,0,GTCTCTACATAGCCTCGTCC,24,1088092
fldAp,25.0,24,0,GGGCCGCGCGGTATCTCCGT,24,1063651
fldAp,25.0,24,0,CCCCGAAACGTGCTGGTTCT,24,1065395
fldAp,25.0,24,0,CCAAGCTCGTCGGATCAATG,24,1114591
fldAp,25.0,24,0,CATGGTCTTGGACATCATCT,24,1137816
fldAp,25.0,24,0,CATACCGACGATATGAAAAG,24,1169932
fldAp,25.0,24,0,ATTTCACAGGCGGGGACCGC,24,1151700
fldAp,25.0,24,0,ATGCTAGGACGCGGCATCCT,24,1177884
fldAp,25.0,24,0,AGTCAAAACGGCAAAGTTTA,24,1113306
fldAp,25.0,24,0,AGGCATCTCATCTGAATTAC,24,1118101
fldAp,25.0,24,0,ACGGAGAGGATCCATACCGT,24,1156229
fldAp,25.0,24,0,AAGTTCTAGCGTATGCTAAG,24,1093322
fldAp,24.0,23,0,TTTACCTTTACCCAGTGCTC,23,1120790
fldAp,24.0,23,0,TTGGCGGCCTCGGCTCAATC,23,1107836
fldAp,24.0,23,0,TTCGGCTCGCCGTCCCGTTT,23,1072081
fldAp,24.0,23,0,TCTCCGTTACACAGTGACCG,23,1111757
fldAp,24.0,23,0,GTAGTGTGGTCCCAACGGTA,23,1083807
fldAp,24.0,23,0,GGTGAGAACGGGCGCTTTGT,23,1176945
fldAp,24.0,23,0,CTGATTCGAGATGAACGGGC,23,1095537
fldAp,24.0,23,0,CTCGCGCAATCGGTTGTTCC,23,1185141
fldAp,24.0,23,0,CACTGAGGAATCGGATTCGA,23,1182178
fldAp,24.0,23,0,ATCTTAAACATAAAGGTGGC,23,1110321
fldAp,24.0,23,0,AGTCAGCGAAACTGGTTCTC,23,1124083
fldAp,24.0,23,0,ACCCACCTAAAGGTCATAAA,23,1100535
fldAp,24.0,23,0,ACAGGTCGCCGCGACCGGAA,23,1073546
fldAp,24.0,23,0,AATCTGTCGGATCATTCGCC,23,1077070
fldAp,24.0,23,0,AAAAATTTGTGTCTCCGTAA,23,1142025
fldAp,23.0,22,0,TTTTACGAAATCTGGGACGT,22,1150694
fldAp,23.0,22,0,TTCCCCGGTCATACCATGCA,22,1064068
fldAp,23.0,22,0,TGTGCTCCTTTCCCCACACT,22,1097739
fldAp,23.0,22,0,TGGCCTAAATTTGGGATATA,22,1156132
fldAp,23.0,22,0,TATGTCGGAGAACTGAGGTA,22,1175428
fldAp,23.0,22,0,TAGAAAACACGGCTGTGTGT,22,1182078
fldAp,23.0,22,0,GTTAGACTGATGCTTGTAAC,22,1069113
fldAp,23.0,22,0,CTCGTGCTTGGTACCGCAAG,22,1144263
fldAp,23.0,22,0,CTCACGCCTCCCCGGCATTG,22,1091688
fldAp,23.0,22,0,CTAAGTCCGGGGTGAGACAC,22,1084174
fldAp,23.0,22,0,CGTTGCAGCAAGAGGGAGTC,22,1148941
fldAp,23.0,22,0,CGTGCATCTCCCAGCAAAGC,22,1076145
fldAp,23.0,22,0,CCTTGTTGGATGCCAGGTGA,22,1082796
fldAp,23.0,22,0,CCTACGCGTCTGTAATATTG,22,1185208
fldAp,23.0,22,0,ATAAGTAAGGACATTGGTGA,22,1078155
fldAp,23.0,22,0,AGTGCCGAGTTGGCGAACTC,22,1105529
fldAp,23.0,22,0,AGGCTATCTGGTAAACTTCT,22,1147237
fldAp,23.0,22,0,AGACCGAGACGTCGCTAACT,22,1111343
fldAp,23.0,22,0,AGACATTCCCACCAGTTTGG,22,1147583
fldAp,23.0,22,0,ACTGTTACAACTACGAGACT,22,1162803
fldAp,23.0,22,0,ACTGGACTTACCTCAGGGCG,22,1124337
fldAp,23.0,22,0,ACCATTTGAACTGCTCCTGA,22,1147709
fldAp,23.0,22,0,AATGTTGCATTGTCCCCCTC,22,1166814
fldAp,23.0,22,0,AAGCAATACAAACTCTCTTT,22,1111230
fldAp,23.0,22,0,AAAACGCATATGTTCTCACA,22,1157035
fldAp,22.0,21,0,TTCCGCTATTCCGACTGTCC,21,1125997
fldAp,22.0,21,0,TAGATTCCGTCTCCCCTACT,21,1110177
fldAp,22.0,21,0,GTTGTCCTTATACGTCGCTC,21,1136976
fldAp,22.0,21,0,GTGGTGTGTACTGGGAGGTC,21,1113562
fldAp,22.0,21,0,GGGGCGGTCCCATTTCGCAG,21,1066028
fldAp,22.0,21,0,GCACGACACGGGTGGGCACG,21,1156285
fldAp,22.0,21,0,GCAATGCTGCGCGTCGCTGC,21,1151212
fldAp,22.0,21,0,GACCACAAAGATACTTATAA,21,1122290
fldAp,22.0,21,0,GAATTACTTTGGTACGATAA,21,1092505
fldAp,22.0,21,0,CTGCCAGATAGACGCATACT,21,1162828
fldAp,22.0,21,0,CATAATCTTCTGTCCTCATA,21,1096082
fldAp,22.0,21,0,CAGTATCCGGGGCTTCCAAG,21,1102538
fldAp,22.0,21,0,CAGAGTAAGGTTTGTCTTGA,21,1102156
fldAp,22.0,21,0,CACTCGGCCCAGACACTCAA,21,1129973
fldAp,22.0,21,0,ATGTTACGCATTATGTCAGA,21,1157074
fldAp,22.0,21,0,AGGCTAGAATGCTATGGGAC,21,1082378
fldAp,22.0,21,0,ACTCTCGAAGTTCGTCCTCC,21,1063519
fldAp,22.0,21,0,ACCTTTTGCTCACAGCTTTT,21,1065702
fldAp,22.0,21,0,ACAAGCGGGAACCGATGTAT,21,1119163
fldAp,22.0,21,0,AAGCAGTCCAGACGCCCTTC,21,1180425
fldAp,21.0,20,0,TCCTCCGCCATTTTTACTCC,20,1169088
fldAp,21.0,20,0,TCCCCACTGCCGGGTACTTC,20,1132684
fldAp,21.0,20,0,TATACAAACAATACGTCACG,20,1159315
fldAp,21.0,20,0,TACGCCATGCCTTACAAGCA,20,1172162
fldAp,21.0,20,0,GGCTAGAATGCGTCTTGAGT,20,1158024
fldAp,21.0,20,0,GAGCTAGACTTATAGGGCCT,20,1160496
fldAp,21.0,20,0,GACATGGAGGTTCGACAATT,20,1178717
fldAp,21.0,20,0,CTGTGCGAACGTTGATTATG,20,1176948
fldAp,21.0,20,0,CCTGTGTTGGAACGCGCGTT,20,1106792
fldAp,21.0,20,0,CATGAGTAGCTGATTGTATG,20,1128194
fldAp,21.0,20,0,CACTTCAAACACGATGATCT,20,1181645
fldAp,21.0,20,0,CACCATCCACGTTTGATTTC,20,1111927
fldAp,21.0,20,0,CACAGTTAGTGACATAATGT,20,1094716
fldAp,21.0,20,0,ATTAGCAAGGATCGGTGCCG,20,1126637
fldAp,21.0,20,0,ATAGAGGTCATACGGGATAA,20,1082278
fldAp,21.0,20,0,AGAAACGACTTGTTTGGGTG,20,1132878
fldAp,21.0,20,0,ACCAAATGAACCAGGGGCTG,20,1136161
fldAp,21.0,20,0,AACACAAGCACAAGCTCGAC,20,1136324
fldAp,20.0,19,0,TTGTATTCTAGTTTAGCACT,19,1095748
fldAp,20.0,19,0,TTGGACTCCGAAGGGGAAAC,19,1167406
fldAp,20.0,19,0,TTATAGTTCTGCGTTATACT,19,1177790
fldAp,20.0,19,0,GTGCTCGGGGTCTTTTGCGA,19,1087208
fldAp,20.0,19,0,GGGTTCTCCCTAGACCAGAG,19,1151317
fldAp,20.0,19,0,GGGTACCTTGATAAAATCCG,19,1145848
fldAp,20.0,19,0,GGAAGACGGTTATCTATCAA,19,1065943
fldAp,20.0,19,0,GCTCGATCACATCTCGGTTC,19,1089383
fldAp,20.0,19,0,GAGGGGTAACACCGCGGAAT,19,1123418
fldAp,20.0,19,0,GAACACACAGGACTTTTCTA,19,1153847
fldAp,20.0,19,0,CTGCTCGTCTGAATGGGGGG,19,1101226
fldAp,20.0,19,0,CCAAGTCCTCCAGGGAACGT,19,1104308
fldAp,20.0,19,0,CAGCCGAAAACAGGTATTTT,19,1140163
fldAp,20.0,19,0,ATTGTTCACTGGTTCACACT,19,1144180
fldAp,20.0,19,0,ATTGCAGTATTTAAACCAAC,19,1157956
fldAp,20.0,19,0,ACCGATCTTCATGTTGGCCC,19,1166337
fldAp,20.0,19,0,AATTACCATTAGTCCCTTTC,19,1119154
fldAp,19.0,18,0,TTAAGCGCCCCGGGGGAATG,18,1115655
fldAp,19.0,18,0,TGGTAAGAATGAGCCACTCT,18,1114847
fldAp,19.0,18,0,TAAGAGTGAATGCTATCAAA,18,1073926
fldAp,19.0,18,0,GGCGGCGCAAGATAAAGTAC,18,1083022
fldAp,19.0,18,0,GGCACATGCGAGTCGTACTT,18,1143944
fldAp,19.0,18,0,CTTCCCTCTATTTGTGGAAG,18,1075265
fldAp,19.0,18,0,CTACCGGGCATTATATTAAG,18,1125239
fldAp,19.0,18,0,CGTTTTTACTTGATGCGTGC,18,1169919
fldAp,19.0,18,0,CCGGTAGAACCTGGTTGAAG,18,1157498
fldAp,19.0,18,0,CCATGGGTTTTATTTACTTC,18,1117263
fldAp,19.0,18,0,CAGAGTGGACCATACCTCTT,18,1086651
fldAp,19.0,18,0,ATCTGAGTGAGAAGAGGTCA,18,1166671
fldAp,19.0,18,0,AGCGGATCAAGGACGCAGGG,18,1167640
fldAp,19.0,18,0,ACCGAGGTATCCTAGCTAGT,18,1104546
fldAp,19.0,18,0,AATCATAGTAAAGTAGACAC,18,1179742
fldAp,19.0,18,0,AATATTCAGCCTGCCGACTC,18,1135504
fldAp,18.0,17,0,TGCTGCCCTACCGTATCAAT,17,1064954
fldAp,18.0,17,0,TATAGGTAGCTATATAAAAT,17,1158530
fldAp,18.0,17,0,TAGAACTTATCATAAATAGC,17,1157083
fldAp,18.0,17,0,TACGAACGGCCATTCACGGT,17,1093228
fldAp,18.0,17,0,GGTCCAGCTGGCGCGATAGT,17,1109849
fldAp,18.0,17,0,GCCTGAAGGGAGTAGACGCG,17,1135447
fldAp,18.0,17,0,CTTTGCCTGGGTCGGGGACC,17,1084446
fldAp,18.0,17,0,CTCCGGGTTAATCACAATAT,17,1107389
fldAp,18.0,17,0,CTCAGAACGCTATCCTGAAT,17,1104596
fldAp,18.0,17,0,CGTGTTGGAGAGGCTTGCCA,17,1121259
fldAp,18.0,17,0,CGGCTAAAGGGCGGTTGTAT,17,1137527
fldAp,18.0,17,0,CAAGGAAAACTCCTGACTCG,17,1083889
fldAp,18.0,17,0,ACTCTAGGAAAATAGTCCTG,17,1126202
fldAp,17.0,16,0,TCATAAGTTTGCATGCGTCA,16,1149101
fldAp,17.0,16,0,TCAGAACAGCAATTGCAGGA,16,1165467
fldAp,17.0,16,0,GGATTGGTCGCGGTTTCAAA,16,1086100
fldAp,17.0,16,0,GGACCACGGTGATCTACTTA,16,1127872
fldAp,17.0,16,0,GACTGCCACCAGTTCGCTTG,16,1161214
fldAp,17.0,16,0,GACGGCAAGTTAAAAACAAC,16,1181728
fldAp,17.0,16,0,CTTACAGTCTAACATCGACA,16,1100956
fldAp,17.0,16,0,CTCCTGGGGAAAACGGTCCC,16,1086058
fldAp,17.0,16,0,CTCCCCATCGTACGAACTCC,16,1092921
fldAp,17.0,16,0,CGTCTGAGAGCCTCGCGTTG,16,1114996
fldAp,17.0,16,0,AGGGTTAATGTGGTATCGAG,16,1124603
fldAp,17.0,16,0,AGAGTTAGGTCGCAGCATTA,16,1109305
fldAp,16.0,15,0,TGTCGTAAAGCGCCGGGTCG,15,1095374
fldAp,16.0,15,0,TGGAGTTGTGACCTCTTGGC,15,1138398
fldAp,16.0,15,0,TCTAGTTTTGGTGTATGGAC,15,1106499
fldAp,16.0,15,0,TCCAACCGAACGTATCGCCT,15,1096717
fldAp,16.0,15,0,GTGGCTGCCGTCGCATCCTT,15,1090267
fldAp,16.0,15,0,GTCCATACGTTCATGTCCGT,15,1172164
fldAp,16.0,15,0,GCTTGCTTGGCGGCACCACG,15,1085611
fldAp,16.0,15,0,GCTGGCCCTTTATGTACTCT,15,1137649
fldAp,16.0,15,0,GCGCCGCAGCTACTTGATTC,15,1097396
fldAp,16.0,15,0,GCATAAGCATACTCGCGGTG,15,1101750
fldAp,16.0,15,0,GAAGGGAACTCAAGTGATGT,15,1105581
fldAp,16.0,15,0,CGGCCAGGCGTGAAGGATGA,15,1107713
fldAp,16.0,15,0,CCTAGTGGTTTGACTAGCAT,15,1085755
fldAp,16.0,15,0,CATGGGATACGGTTCGAGGG,15,1076142
fldAp,16.0,15,0,CATACCCTCTGTACAATAAA,15,1113418
fldAp,16.0,15,0,AGCGTAGCCTAAAGGTCACC,15,1156774
fldAp,15.0,14,0,TGTGAACGGGATTCAACTGG,14,1151299
fldAp,15.0,14,0,TCCGTCTGGGCTACTTCACC,14,1086479
fldAp,15.0,14,0,TCAGCTGGCTGGGCCGTGGT,14,1146211
fldAp,15.0,14,0,TAGCTGGTTCATTGTGGAGG,14,1094134
fldAp,15.0,14,0,GTTCATTAGGCGTGCCTCCG,14,1119897
fldAp,15.0,14,0,GTCCAAGAGTAGTAAAGGGC,14,1066639
fldAp,15.0,14,0,GTCACCCAACTTGCGGATAA,14,1150730
fldAp,15.0,14,0,GTAACAACTTTCAGATTCCT,14,1169153
fldAp,15.0,14,0,GGGGCCATGGCTATTGTTGA,14,1107667
fldAp,15.0,14,0,GCGCTGGGAACTAACTAATC,14,1143669
fldAp,15.0,14,0,CTCCTACGCCCGTTGTACTT,14,1147982
fldAp,15.0,14,0,CGGCACTTAATATAGGTGTT,14,1093544
fldAp,15.0,14,0,CGGAGGAACTACGAGCGAGT,14,1072118
fldAp,15.0,14,0,CGCGCAGATCAGAAATCTTA,14,1151131
fldAp,15.0,14,0,CATAAGCACAGCCTGTCGAA,14,1179360
fldAp,15.0,14,0,ATATTCCTCCGTGTGAACTG,14,1143276
fldAp,15.0,14,0,AGCCCGCTTGAGGGTCTCGA,14,1094798
fldAp,15.0,14,0,AATTCACACCTACGCACCAT,14,1110165
fldAp,15.0,14,0,AACCTACGTCATTGATCCCA,14,1125420
fldAp,14.0,13,0,TTTTAAAGTAGTGTACGGGG,13,1064573
fldAp,14.0,13,0,TTACACACCAGTGGACACCC,13,1145029
fldAp,14.0,13,0,TGGGTGGGTAGTTGAGGACA,13,1069101
fldAp,14.0,13,0,TAAATTCCGCCGTCTCGTTT,13,1123756
fldAp,14.0,13,0,GGTTATTAGCAGACGCGGCG,13,1172487
fldAp,14.0,13,0,GCGATAATTAGGCAGAAGCT,13,1170792
fldAp,14.0,13,0,GAAAATCACACTATACAAGG,13,1134660
fldAp,14.0,13,0,CCGCATTTGTCCCTCTACAA,13,1109724
fldAp,14.0,13,0,CACCTTTTGTAGTAGCAAAA,13,1135845
fldAp,14.0,13,0,CACCGATGGTCTTATGACCG,13,1170835
fldAp,14.0,13,0,CACCCGGGCCGTATCACTAA,13,1123826
fldAp,14.0,13,0,ATACTGTAGGAAAACATCTT,13,1088724
fldAp,14.0,13,0,AGCGGCTTGGCATGGGTTGT,13,1105941
fldAp,14.0,13,0,AACAGGGACACGAACGCATC,13,1128542
fldAp,13.0,12,0,TGGGATACTCTTAGTTGGCA,12,1077571
fldAp,13.0,12,0,TGCGGAGTACTGCTCACAGC,12,1113823
fldAp,13.0,12,0,TGCAATATATTTTGGAGGGA,12,1148620
fldAp,13.0,12,0,TGATTACTCCCAACTGGTTA,12,1083319
fldAp,13.0,12,0,TGAACACCAATGCCATATGA,12,1139095
fldAp,13.0,12,0,TCACGAGCTGGTCAGCCACA,12,1089196
fldAp,13.0,12,0,TAGATCGGTTTAAATTCGAT,12,1064857
fldAp,13.0,12,0,TACATTCGCTCTTTCTATAG,12,1134421
fldAp,13.0,12,0,GTTTGCATCATATCGCTTTG,12,1120471
fldAp,13.0,12,0,GGATTGCAGGGAAAAAGCTG,12,1150956
fldAp,13.0,12,0,GAGGGTTTTTCGTCCACACC,12,1177216
fldAp,13.0,12,0,GAAACGTTAGGTTCCCTGTA,12,1072212
fldAp,13.0,12,0,CTTTCGAATCGTTCACCGCT,12,1121111
fldAp,13.0,12,0,CTTATTCCGCCTCGTGGGGC,12,1172202
fldAp,13.0,12,0,AGTGTGTAGTACAGTTATTC,12,1160774
fldAp,13.0,12,0,AGGAACGCACAAATTTTTAT,12,1085288
fldAp,13.0,12,0,AGCGTGCCCCGAACTTAGAC,12,1157598
fldAp,13.0,12,0,AGCAGATACTTCCAATCTAC,12,1114989
fldAp,13.0,12,0,AGACCACCGCGTAGGCAGCG,12,1167198
fldAp,13.0,12,0,ACAGAGCCTGCCTCGTTGAC,12,1071194
fldAp,13.0,12,0,AAAGTAGTTATTGATCTCAG,12,1089840
fldAp,12.0,11,0,TGAAAGTGTCAATATCAGGG,11,1066651
fldAp,12.0,11,0,TCACGAGGGTCGAGACCACC,11,1163136
fldAp,12.0,11,0,TATGGGAGTTTACCTATGTG,11,1133348
fldAp,12.0,11,0,GCGACTATACACTTGGATCA,11,1142670
fldAp,12.0,11,0,CTCTGTGGGGAATATGAAGT,11,1129142
fldAp,12.0,11,0,CACCGCTCCAAACGTGTATG,11,1076168
fldAp,12.0,11,0,ATATGCAACAGAGCACAGCG,11,1122266
fldAp,12.0,11,0,AGCGTATAAAAGCGTCCAGG,11,1186638
fldAp,11.0,10,0,TTCAGACCTCGTAACGCACA,10,1146382
fldAp,11.0,10,0,TGTAAAAGGTCCCATTGCAT,10,1090337
fldAp,11.0,10,0,TCCGCAACAGATAAGGGGTG,10,1162710
fldAp,11.0,10,0,TATCACACGAACCACCACGT,10,1145229
fldAp,11.0,10,0,TACCGGGTTCTTTATGCGGT,10,1161146
fldAp,11.0,10,0,CTTGCAAAATTCCGCCGAGC,10,1146245
fldAp,11.0,10,0,CGAATGGTGCAACAACCTAG,10,1065797
fldAp,11.0,10,0,CCGTCGCCCTCAGCATAGAT,10,1077627
fldAp,11.0,10,0,CCCTGTCAGAGACTTGTTGG,10,1099566
fldAp,11.0,10,0,ATCGAGCGTGACGTTGGCGT,10,1156585
fldAp,11.0,10,0,ATATGACGCATCCACGACGC,10,1075339
fldAp,11.0,10,0,ACTGGGTCTAAGGGATAATA,10,1132627
fldAp,11.0,10,0,ACACAAGCCCTCTTACAAGA,10,1145936
fldAp,11.0,10,0,AATTTTAGTCAGGGTAGATG,10,1137813
fldAp,10.0,9,0,GCGTGTAAGGTTACTATCGT,9,1136782
fldAp,10.0,9,0,CTAACCCAGTGCTATCACCT,9,1085773
fldAp,10.0,9,0,CCTACTGACCGGTCAGAACA,9,1126886
fldAp,10.0,9,0,CAGGACCGGACGGTCTTGCT,9,1162546
fldAp,10.0,9,0,AGTGGGACTGTGTCGTCATA,9,1077052
fldAp,10.0,9,0,AGTCGCCATCGTCCAGTTCG,9,1177721
fldAp,10.0,9,0,AGACCGCATGGGATGTCATG,9,1082032
fldAp,9.0,8,0,TGTGGCGAGCTTAGGCCATG,8,1151332
fldAp,9.0,8,0,TCCTAGGGGCTCTACCGCCT,8,1178716
fldAp,9.0,8,0,GATCTAAGTCGGTCTAGCAT,8,1066057
fldAp,9.0,8,0,CTACAAGTTTATCAGGGGGG,8,1108421
fldAp,9.0,8,0,CGGTCCGTATCTGCATCCTA,8,1120793
fldAp,9.0,8,0,CGCTGTAGGCCAACCAAGAA,8,1177366
fldAp,9.0,8,0,CGCGATGACGGGCGGGGTTC,8,1112798
fldAp,9.0,8,0,CCTTGGGGCTCAGTTTGTTG,8,1095057
fldAp,9.0,8,0,CCTCAAGGAGGAATACCGGT,8,1180297
fldAp,9.0,8,0,ATTTTGTCGCATAGCGCAAA,8,1108499
fldAp,9.0,8,0,AGCGACATTCCCTTCTCATT,8,1069556
fldAp,8.0,7,0,TGGGGTGGCTGGGGGATAAA,7,1128509
fldAp,8.0,7,0,CTGTCGCAACCCAGAGTCAC,7,1072116
fldAp,8.0,7,0,CCGGGGGCCATGTCGAGTGT,7,1148687
fldAp,8.0,7,0,ATTCCGGGCTTCTCAAACTA,7,1094771
fldAp,8.0,7,0,AGGGGGGAGAACATTGGGTA,7,1133685
fldAp,8.0,7,0,AGGGGAAGTGTGCGCATCCA,7,1090021
fldAp,8.0,7,0,AGAGGCATGAATAGCCGTAG,7,1077086
fldAp,8.0,7,0,AAGACAACCCATTCACATTT,7,1170800
fldAp,7.0,6,0,TTGTAGGTTGTTCTCGGAGA,6,1161418
fldAp,7.0,6,0,TTGCTCCAACAAGTACTTTG,6,1158945
fldAp,7.0,6,0,TTGACCTGACCTAGCACGAA,6,1101285
fldAp,7.0,6,0,GTCGCTTGCCACAAGTGGTA,6,1184445
fldAp,7.0,6,0,CTTCCTAGGACGTTCAGCGA,6,1165138
fldAp,7.0,6,0,CGAACCATGGTACTGCGGTC,6,1115785
fldAp,7.0,6,0,CAGAATTTCTTATAACGAAG,6,1082743
fldAp,7.0,6,0,ATGCGACAATTGGGGTCGGA,6,1103002
fldAp,7.0,6,0,AAAGGGACAAACCCTCCCTT,6,1131212
fldAp,6.0,5,0,TTTTCGGGCGGGGATAGGCT,5,1107671
fldAp,6.0,5,0,TGCAGTCTAACGAAGGGGAT,5,1075287
fldAp,6.0,5,0,GTCCTATATAATTATTCTGG,5,1142585
fldAp,6.0,5,0,GGTAGGTCATCCGCAGCCTC,5,1111114
fldAp,6.0,5,0,GAAATGTCAGTCACTCCATA,5,1127398
fldAp,6.0,5,0,CCGAGCCTATAGACAACTAG,5,1170700
fldAp,6.0,5,0,ATGGACAGTAAAGAGTCTTG,5,1065527
fldAp,5.0,4,0,TGGTGGATGAAAGGTGCGTG,4,1151307
fldAp,5.0,4,0,GATGATCAAGGCAGCCGTTC,4,1112995
fldAp,5.0,4,0,CGTGGATTTTGCTTCCCTGT,4,1181068
fldAp,5.0,4,0,CCCAGGTTGCGTGGAGCCAT,4,1171147
fldAp,5.0,4,0,CAAGGTGCCATCAGTTTGCG,4,1180273
fldAp,5.0,4,0,ATTCGGAAGTTAACGCGGAT,4,1143605
fldAp,4.0,3,0,TTCGTGTACAGTTCCACGAT,3,1087423
fldAp,4.0,3,0,TGTCTCGGAGGAACACATCT,3,1131034
fldAp,4.0,3,0,TCTGTCAGTCTGGTAGCTGC,3,1165705
fldAp,4.0,3,0,TCCTGGGTCTCGTTACGCTT,3,1102556
fldAp,4.0,3,0,TATTTTGCTCAACCGTATGG,3,1108617
fldAp,4.0,3,0,GTCGTAACTGATTCGGGTAC,3,1104939
fldAp,4.0,3,0,GTCCGCGACATCGTCACCCA,3,1125026
fldAp,4.0,3,0,ATACTACACATAGACTATGG,3,1064658
fldAp,4.0,3,0,AGGGGGTTGCTTCCATCCTC,3,1106866
fldAp,4.0,3,0,AGATGCTGGCGATTCCTCCT,3,1098640
fldAp,4.0,3,0,AACCTCAAAGCGCGGACGAG,3,1070703
fldAp,3.0,2,0,TTCGTATGCTCACTGGGTGA,2,1113034
fldAp,3.0,2,0,TCACTTAGCCCGCCATAGAC,2,1134316
fldAp,3.0,2,0,TACACCAGTAAGACTTCGTA,2,1136439
fldAp,3.0,2,0,GGTGCGGAAATCTCTCATTT,2,1121264
fldAp,3.0,2,0,GAGCTCGTGGAGCTTGACAG,2,1185234
fldAp,3.0,2,0,CTGCGCGCAACACTGTCACT,2,1133286
fldAp,3.0,2,0,CTCCCAATCTTTCGCACAGT,2,1172856
fldAp,3.0,2,0,CGGCAACTAACGGTACTGTA,2,1180271
fldAp,3.0,2,0,CCTGGGTCAGGTAAAGCCCT,2,1182002
fldAp,3.0,2,0,CCCTAGCATGGGCCGGTCTT,2,1141310
fldAp,3.0,2,0,CAGTCCCAGCCACCTCTCCT,2,1070280
fldAp,3.0,2,0,ATGGCAGATTTCGGCGGCTT,2,1135000
fldAp,3.0,2,0,ATCAAGAATTCAATTTGCGA,2,1150456
fldAp,3.0,2,0,AGCTTGAACCCGGCTGTCGC,2,1067648
fldAp,3.0,2,0,AGCTTCAAACCCAACGTATT,2,1158690
fldAp,3.0,2,0,ACAACAAAGGATTAACCTCA,2,1161628
fldAp,3.0,2,0,AAGGCAGCTCCGGAATTGCT,2,1163973
fldAp,3.0,2,0,AAAGGGTTACAGCCCAAGCA,2,1085286
fldAp,2.0,1,0,TTTTACCGCAAAGAGTTGAC,1,1065941
fldAp,2.0,1,0,TTTGTGTTTGGTATCCCCGG,1,1167058
fldAp,2.0,1,0,TTTCGTCGATATAGTCTGCA,1,1186100
fldAp,2.0,1,0,TTGACACTATGTCCATGCTC,1,1104249
fldAp,2.0,1,0,TTCGCCAAACAATGCAGCCT,1,1112326
fldAp,2.0,1,0,TTCCTGCAAGCGCTTAAGGT,1,1074129
fldAp,2.0,1,0,TTCAGTCAAGGCCTTATACC,1,1114269
fldAp,2.0,1,0,TTAGCGCGGAGTGACTTAGT,1,1156119
fldAp,2.0,1,0,TTAGAATTGGATTCTCATGT,1,1146184
fldAp,2.0,1,0,TGTGGTAATTATCGTTTATG,1,1118977
fldAp,2.0,1,0,TGTATCAGGCCGCGCTTATT,1,1106348
fldAp,2.0,1,0,TGTACGGACGGATCGAACGT,1,1123030
fldAp,2.0,1,0,TGGTGTTACAGAAGGGAAGA,1,1161699
fldAp,2.0,1,0,TGGTATTTGAGACTCAGCTC,1,1087848
fldAp,2.0,1,0,TGGCGTCGGATAGTCCGGGA,1,1166623
fldAp,2.0,1,0,TGCTCATGGGTTACAGGATT,1,1109837
fldAp,2.0,1,0,TGATTCGACGCCGTACTAGA,1,1140904
fldAp,2.0,1,0,TGAGTCCCTGGTTATCTTAG,1,1135248
fldAp,2.0,1,0,TGAGCTAGATCGGAGATACT,1,1065464
fldAp,2.0,1,0,TCTCCCGCTGGTCCTTATCT,1,1092217
fldAp,2.0,1,0,TCGTACTCTGGAGATCATGT,1,1112371
fldAp,2.0,1,0,TCGGCAACGCGTGTTATATC,1,1103028
fldAp,2.0,1,0,TCAGTGGTCATCGGTTGCAT,1,1070165
fldAp,2.0,1,0,TCACGGAAAGCTAATCGGAA,1,1124871
fldAp,2.0,1,0,TCACGACGTTTGCACCGTAG,1,1126552
fldAp,2.0,1,0,TCAATCTCATCCAAACTTGC,1,1166266
fldAp,2.0,1,0,TCAATACGCCTCATGCCCTC,1,1184094
fldAp,2.0,1,0,TATGTATTTACTCAGAAATG,1,1164336
fldAp,2.0,1,0,TATGGATCCTTCCCGAAACC,1,1107924
fldAp,2.0,1,0,TAGGCACGTTGCTTGGGCTC,1,1138232
fldAp,2.0,1,0,TAGAATACTTGCGCGAGATT,1,1091015
fldAp,2.0,1,0,TACTGTACGCATTACGGTTT,1,1136581
fldAp,2.0,1,0,TACACACTAGCATCAAACAT,1,1153712
fldAp,2.0,1,0,TAATTCTTCCAGGGGAGGAA,1,1065413
fldAp,2.0,1,0,TAATCAATTCTACGTGGTCT,1,1109740
fldAp,2.0,1,0,TAAGATACAGTTATCGAGTA,1,1067305
fldAp,2.0,1,0,TAAAGAAGACCGGTTCGGAA,1,1067636
fldAp,2.0,1,0,GTGTCAAAAACGACGCGGGC,1,1152957
fldAp,2.0,1,0,GTGCAAGAGCAAAATACTCG,1,1137554
fldAp,2.0,1,0,GTGAGGCCAGCTTCCCTGCA,1,1097152
fldAp,2.0,1,0,GTCGGTTTCAAGGAGGCGAT,1,1158963
fldAp,2.0,1,0,GTCCATGTTCCGAACTTCAT,1,1169926
fldAp,2.0,1,0,GTCAGGTTTAGTCAGAGATC,1,1096801
fldAp,2.0,1,0,GTATATAGCTTTACTCGACT,1,1073030
fldAp,2.0,1,0,GGTGGTCGCGCTTGTCCCTG,1,1113603
fldAp,2.0,1,0,GGTCGGTGGCCATATGATTA,1,1147198
fldAp,2.0,1,0,GGTCGCTTTCCTCTTTGCGG,1,1106133
fldAp,2.0,1,0,GGTAGCATTATGCCCTCCCT,1,1158842
fldAp,2.0,1,0,GGTACAGGGTCAACGGCCGT,1,1126898
fldAp,2.0,1,0,GGGCCATACATATGGAGCAT,1,1132009
fldAp,2.0,1,0,GGGATGCAATGAACTCGCTA,1,1082854
fldAp,2.0,1,0,GGCTCCAAATCTAATGGACG,1,1128599
fldAp,2.0,1,0,GGCAAGTAGTGTTTTCAATA,1,1184648
fldAp,2.0,1,0,GCTGTAGCCGCATTGGAACG,1,1147450
fldAp,2.0,1,0,GCGTTGTCCGGCTCGTTGAA,1,1158462
fldAp,2.0,1,0,GCGTAAAGACGGCAAACCCT,1,1085243
fldAp,2.0,1,0,GCGGCGGCTCGCTGACATCT,1,1117440
fldAp,2.0,1,0,GCACACCACAGGTCACCCTC,1,1068038
fldAp,2.0,1,0,GATTGAAAATTATCGAGATC,1,1114344
fldAp,2.0,1,0,GATTAACATATGTAACTGAA,1,1133968
fldAp,2.0,1,0,GATGATGGGGTCTAAAAGAA,1,1126646
fldAp,2.0,1,0,GATAACTAGAGGTTGTGTAA,1,1115896
fldAp,2.0,1,0,GAGCATCGTTTGCGGCTTCT,1,1131695
fldAp,2.0,1,0,GACTGACGCTACTTCGATTA,1,1134139
fldAp,2.0,1,0,GACGCGTTGCTTGACGGAAG,1,1125379
fldAp,2.0,1,0,GACCCCGGTGCAAGTACCGG,1,1115181
fldAp,2.0,1,0,GACAGCAAGGATCCTAGCTA,1,1108477
fldAp,2.0,1,0,GACACATAGGCATCGGGCAA,1,1117217
fldAp,2.0,1,0,GAATGAAGATAAGTAAGAGG,1,1153486
fldAp,2.0,1,0,GAATATTCGGACAGGGGTAC,1,1063731
fldAp,2.0,1,0,CTTTCCGACATTTACAATCG,1,1142703
fldAp,2.0,1,0,CTGCGATTACCGTCAAATCA,1,1141414
fldAp,2.0,1,0,CTGATCGCTGAGGCGTATTG,1,1153815
fldAp,2.0,1,0,CTCCACATACTTGGTATACT,1,1108140
fldAp,2.0,1,0,CTAGCGTATTGTGCTCAGGT,1,1144069
fldAp,2.0,1,0,CGTTCTAGCTCTGGCAAACC,1,1108255
fldAp,2.0,1,0,CGTACGGATTTGGGGTCCTG,1,1109387
fldAp,2.0,1,0,CGCTCTCATCTGCCGGGTTC,1,1172624
fldAp,2.0,1,0,CGCGGCTGATCACGTTAACA,1,1159040
fldAp,2.0,1,0,CGCGAGTTTAAGATGGGGAA,1,1162846
fldAp,2.0,1,0,CGCCTTGAGGCTTCACCACG,1,1106369
fldAp,2.0,1,0,CGCCCTTACATTGCCAGATT,1,1138245
fldAp,2.0,1,0,CGAGCCAGAAAAGTGCTAAA,1,1137683
fldAp,2.0,1,0,CGACACATTATGATCACGCC,1,1182996
fldAp,2.0,1,0,CCTACTCGACCAGGTGGGAA,1,1185538
fldAp,2.0,1,0,CCGTATATTACTTTAAGGAA,1,1094205
fldAp,2.0,1,0,CCCGTCGTTACTCGTACTCT,1,1156133
fldAp,2.0,1,0,CCCATACTGACAAGCGCAGA,1,1123014
fldAp,2.0,1,0,CCACCGGGGAGTCCTCATAG,1,1105343
fldAp,2.0,1,0,CCAATATCAGTACTCCACGG,1,1064099
fldAp,2.0,1,0,CATAAAGTGCAAACGGTCAT,1,1138973
fldAp,2.0,1,0,CAGTGTACAAGCTACCGCCT,1,1115384
fldAp,2.0,1,0,CAGAGCGAATACTTAGTGCA,1,1146703
fldAp,2.0,1,0,CACCCTGCTGACGCGCGTCA,1,1129526
fldAp,2.0,1,0,CACCAGAGGTATTTTCACCG,1,1089211
fldAp,2.0,1,0,CACCACAATATTTTTACAAT,1,1114914
fldAp,2.0,1,0,CACACATTTTGGCTAAATAG,1,1096177
fldAp,2.0,1,0,CAAGCTGCCATCTTGGCTTG,1,1077389
fldAp,2.0,1,0,CAAAGCAATGTGGGCTCCCG,1,1107544
fldAp,2.0,1,0,CAAACATGCGGATTGCTATC,1,1095306
fldAp,2.0,1,0,ATTTAAATCTTTGTGTGGAG,1,1141903
fldAp,2.0,1,0,ATTCCTGAGCTCGGCTGGTC,1,1072496
fldAp,2.0,1,0,ATGGCTGTTTAGTTCGTCCT,1,1179568
fldAp,2.0,1,0,ATGCCTATTTCCGACTCGGC,1,1101725
fldAp,2.0,1,0,ATCCAACAGGACACCGGGCT,1,1063268
fldAp,2.0,1,0,ATCAGTGATACAAACGATCC,1,1176260
fldAp,2.0,1,0,ATCAGTCCCGTACCAGTCGA,1,1149141
fldAp,2.0,1,0,ATCACTGCTCACCCAGAAGC,1,1127232
fldAp,2.0,1,0,ATACTATGAGGTCTTTAAGG,1,1086288
fldAp,2.0,1,0,AGTTGGCACTAACTTTCGAC,1,1079228
fldAp,2.0,1,0,AGTATGGAACCCCGGTTGCA,1,1135163
fldAp,2.0,1,0,AGGTTGGCAGCCACAAGTTA,1,1144499
fldAp,2.0,1,0,AGGCCCAGTCTCTGAACTCT,1,1154147
fldAp,2.0,1,0,AGGATCAGCATTGCTGGCGG,1,1108450
fldAp,2.0,1,0,AGCGTTTTACATCGTTATTG,1,1135672
fldAp,2.0,1,0,AGCAACCCGGGTATCCCCAA,1,1144740
fldAp,2.0,1,0,AGACTTTATGTGGGAACACA,1,1099437
fldAp,2.0,1,0,ACTGGGAGAAGGCGGATCTA,1,1118027
fldAp,2.0,1,0,ACTGCGGCCACCGATAGCTG,1,1136307
fldAp,2.0,1,0,ACTACCGAGTCAGGGAGATC,1,1121669
fldAp,2.0,1,0,ACGGCGCTGTGAAGAGCCAA,1,1128528
fldAp,2.0,1,0,ACGCGATTATTGTCCTGCGC,1,1169667
fldAp,2.0,1,0,ACGACATAGGGGTTGTTGCT,1,1136112
fldAp,2.0,1,0,ACGAACATTCAGCTATAGCC,1,1172889
fldAp,2.0,1,0,ACCTATACTTTTGGTGAGTA,1,1132638
fldAp,2.0,1,0,ACCGTCTCAGGGCCTGTCCT,1,1064846
fldAp,2.0,1,0,AATTCTTGATTGTAACTCGC,1,1136796
fldAp,2.0,1,0,AATGTTCATCGGCGGGACCA,1,1109080
fldAp,2.0,1,0,AAGGTTATGAGGCGACGGCG,1,1125305
fldAp,2.0,1,0,AAGGTTAGCATAGCCTATAC,1,1174485
fldAp,2.0,1,0,AAGGGATAGGCTGTAAATCA,1,1108325
fldAp,2.0,1,0,AAGCGGCCACATCAGCGAGA,1,1138656
fldAp,2.0,1,0,AACTGCCTGTGACGTGCAGT,1,1118805
fldAp,2.0,1,0,AACTACGCTACGGACGCTTC,1,1146158
fldAp,2.0,1,0,AACACGGAATTTAGCTAACC,1,1135730
fldAp,2.0,1,0,AAAGGTACCGTGCTTCCGTG,1,1076153
fldAp,2.0,1,0,AAAGCGCATCAAGTCGGGAT,1,1158091
fldAp,2.0,1,0,AAACATCCGTACCGGCCAGG,1,1070423
fldAp,2.0,1,0,AAACAGCTACTAAATAAGTA,1,1130386
