name,relative_counts,ct,ct_0,barcode,ct_1,barcode_ind
yjbJ_predicted,0.5942028985507246,218,137,GGCCAGCAGACAGCACACGC,81,5004440
yjbJ_predicted,1.5076923076923077,324,129,GACCCTGCGTCAAAGAGAAC,195,4994876
yjbJ_predicted,0.023255813953488372,130,128,CTTCGCGAACCTTTCTGCCA,2,4994764
yjbJ_predicted,0.6953125,215,127,TCGTACCTAAACTCGCGAAG,88,5009661
yjbJ_predicted,0.5242718446601942,155,102,TTTAAGTGCTAAGGGACTGT,53,4995928
yjbJ_predicted,0.35714285714285715,131,97,ATGGCTGGAGTGTCTGACAT,34,4995155
yjbJ_predicted,0.6382978723404256,152,93,GCAAGCTCTCAATCCCTTTA,59,5020863
yjbJ_predicted,0.02197802197802198,91,90,ATGGTGCTAGGTCGCAAAAG,1,5002458
yjbJ_predicted,1.7222222222222223,243,89,AACTTTTTCGGTCTAACATA,154,4995740
yjbJ_predicted,0.4823529411764706,124,84,GGACATGCGTTGTTTAGTCT,40,4998727
yjbJ_predicted,1.1647058823529413,182,84,GCAAGGAAGCACTGGTTCCC,98,4996153
yjbJ_predicted,1.5903614457831325,213,82,GCCACTATGGAGCTGGTCCT,131,5009065
yjbJ_predicted,2.3048780487804876,269,81,AATAATGCGCAGGACGTCCT,188,5028664
yjbJ_predicted,3.1358024691358026,333,80,TATGATTATTCTCATGCCGA,253,4996921
yjbJ_predicted,1.8051948051948052,214,76,TTGCCGCGATCTGTCGGTCT,138,5008259
yjbJ_predicted,0.5584415584415584,118,76,GGTACCTCGGACGCGGCTAC,42,4996327
yjbJ_predicted,0.8026315789473685,135,75,GGGGATGTCGTTGAGCGGTC,60,5000031
yjbJ_predicted,0.7571428571428571,121,69,GCCGACCTCAGTATTTACCT,52,4996542
yjbJ_predicted,1.6666666666666667,182,68,AGCGTTATCAAAGCAGAATG,114,5019126
yjbJ_predicted,0.5147058823529411,101,67,TTAACCCTACAGGTTTGCAA,34,4995635
yjbJ_predicted,0.029411764705882353,68,67,CCCTCTCCACTGAAAAAGTG,1,4995168
yjbJ_predicted,0.3582089552238806,89,66,TGATCGGGCAGTCCTTATTA,23,4995422
yjbJ_predicted,0.582089552238806,104,66,GCACCCGACCTAAATCGAAT,38,4997154
yjbJ_predicted,0.48484848484848486,96,65,CCGTGAGATCGTGGGGTACA,31,4999316
yjbJ_predicted,0.859375,117,63,CCTGAAAAGCATTGTGAGCA,54,4994992
yjbJ_predicted,0.2698412698412698,78,62,TGGGGATGCGGAATCGTTTT,16,4998827
yjbJ_predicted,1.3709677419354838,145,61,TCAGTACATATCAGAAGGAA,84,5030633
yjbJ_predicted,0.5806451612903226,96,61,GGTAACTGGTTGTACCCCCA,35,5004867
yjbJ_predicted,0.3709677419354839,83,61,GCGCGCACACATCCACTATG,22,4995101
yjbJ_predicted,0.532258064516129,93,61,ACGAAGTAGTACAGCATGGA,32,4996772
yjbJ_predicted,0.03278688524590164,61,60,CTGCATGCGTGCGTGGGATG,1,4996707
yjbJ_predicted,1.3278688524590163,140,60,ACGAAGGGGTTAACAGGTAT,80,5026416
yjbJ_predicted,2.3,196,59,TGGGAATTCCGGCGGAGCTT,137,4998808
yjbJ_predicted,0.6833333333333333,99,59,CACTCACGCCGCTTATTTCT,40,5005084
yjbJ_predicted,0.6271186440677966,94,58,TATAATTTTCTCTCCGCAGG,36,5024253
yjbJ_predicted,0.423728813559322,82,58,CCGGCTTACAGCCGTCATGT,24,5013453
yjbJ_predicted,0.6779661016949152,97,58,ACAAGCGTGGGTTTCTCATG,39,5001796
yjbJ_predicted,2.4310344827586206,197,57,GTCACATCACACGTACAATG,140,5012009
yjbJ_predicted,0.7068965517241379,97,57,GGGAACCGAAATCTCAGAAC,40,5024606
yjbJ_predicted,0.034482758620689655,58,57,GAATTCCCCGCTGTACCGGA,1,4996506
yjbJ_predicted,1.912280701754386,164,56,TGAATTTATAACGACTGGCG,108,4997113
yjbJ_predicted,0.8596491228070176,104,56,CTAATGCTCCCCACCGTCGT,48,4994729
yjbJ_predicted,0.03508771929824561,57,56,CCAAAATGGAGGACATTGGT,1,4997570
yjbJ_predicted,1.1754385964912282,122,56,ACTTATATTTCGGAGTGCCT,66,4995296
yjbJ_predicted,0.7719298245614035,99,56,AATCAGAAACACAGGCCCAT,43,5019745
yjbJ_predicted,0.48214285714285715,81,55,TGTTCTCGTGTCATCGGTAT,26,4999109
yjbJ_predicted,1.5535714285714286,141,55,GTCGTTACACCTCGTCGGAC,86,4995823
yjbJ_predicted,1.1607142857142858,119,55,GAGGTGCATGATTTTATATT,64,5005118
yjbJ_predicted,0.9821428571428571,109,55,CTAGATTATACTTGGCAACA,54,5003630
yjbJ_predicted,0.6363636363636364,88,54,TTTGTTTGAGCTTGTATTGA,34,5008033
yjbJ_predicted,0.03636363636363636,55,54,ATGGCGGCCAGCTGCAGATG,1,5022725
yjbJ_predicted,0.10909090909090909,59,54,ACGAAACCAAATGGAAGATG,5,5019617
yjbJ_predicted,0.6296296296296297,86,53,GGCGGCATCGAAGTCACTTC,33,4994929
yjbJ_predicted,1.1666666666666667,115,53,AGCTCGTCCCGAAACTGTAT,62,5002507
yjbJ_predicted,0.8490566037735849,96,52,TAGCCTATTGAAGATATTCG,44,5002280
yjbJ_predicted,1.0188679245283019,105,52,GTAGTTTGTTGTAGGTAAAA,53,5001474
yjbJ_predicted,0.16981132075471697,60,52,GACACCTGGCTGAAGCCATG,8,4995701
yjbJ_predicted,1.5769230769230769,132,51,TGACGTGTCAAAATGCGAAT,81,5006967
yjbJ_predicted,0.9807692307692307,101,51,GGTGCGCGGGCACGTTTAGA,50,5026506
yjbJ_predicted,0.038461538461538464,52,51,CTCGCACTGATTGCGTGACG,1,5004443
yjbJ_predicted,0.8269230769230769,93,51,CGGAAGGCGCGTTGTTCGAA,42,4998271
yjbJ_predicted,0.038461538461538464,52,51,CGCATCGATACATTTGGGCA,1,4997585
yjbJ_predicted,0.5576923076923077,79,51,ATCAGAATCGACACATAGGT,28,4998085
yjbJ_predicted,1.5098039215686274,126,50,TGTAACGAGTATAAAAACAT,76,4996239
yjbJ_predicted,0.803921568627451,90,50,CTGGTATTCGGAGATAAGGA,40,5018459
yjbJ_predicted,1.6666666666666667,134,50,ATGTTAACACGCCGGTTGGT,84,5006574
yjbJ_predicted,1.0,100,50,AACAGCGATGTTCATCACAT,50,5009727
yjbJ_predicted,2.76,186,49,TATTATGGCCTGTCAGCAAG,137,5026779
yjbJ_predicted,0.66,81,49,GGTAGTGTTTGTTGTTAAAG,32,4995890
yjbJ_predicted,0.62,79,49,CTACTTATGAAGTGAGTTTG,30,4995068
yjbJ_predicted,0.5102040816326531,72,48,CACGACGGCTTACGAGTCTT,24,5008501
yjbJ_predicted,1.2040816326530612,106,48,CACATTTGTAATACTTCATA,58,5025315
yjbJ_predicted,0.5833333333333334,74,47,TCAGTTAGGTTAAATCGAGG,27,5016126
yjbJ_predicted,0.875,88,47,TATAAGATTAACTCTGATAG,41,5007448
yjbJ_predicted,0.7916666666666666,84,47,GGGATTTCGCTGAGAGAATT,37,5013982
yjbJ_predicted,0.7916666666666666,84,47,CGAGGTGAATCAGTCAGTAA,37,5020407
yjbJ_predicted,0.041666666666666664,48,47,CCGCTCTAATGGAGCATGGA,1,5000815
yjbJ_predicted,2.6875,175,47,AGATGCGTCACAGCTACGAG,128,5028196
yjbJ_predicted,1.6808510638297873,124,46,TAGGTCGGACAGGCAGTCGT,78,5025977
yjbJ_predicted,1.0212765957446808,93,46,GCAAATGTGGTTACTGTGGT,47,5006906
yjbJ_predicted,1.0638297872340425,95,46,ATAATGGAATGTAACGGCAA,49,5016485
yjbJ_predicted,0.9787234042553191,91,46,ACTAGGTGTCAACTAACCTT,45,4994949
yjbJ_predicted,2.765957446808511,175,46,AATCGTGGGTCGTTAAGTGT,129,4995376
yjbJ_predicted,0.043478260869565216,46,45,TGCAATAGTCGGTGTATACA,1,4995662
yjbJ_predicted,0.043478260869565216,46,45,TCCGCCAAGGGCCAGGTTTT,1,4996622
yjbJ_predicted,0.13043478260869565,50,45,TCCGACATGGCGGTATCTCG,5,5009935
yjbJ_predicted,1.3043478260869565,104,45,GCTGACCGAACTCTGCTGCT,59,5004463
yjbJ_predicted,3.0217391304347827,183,45,ATCTCCTGTGACGTATCAAG,138,5006468
yjbJ_predicted,1.2391304347826086,101,45,ACTAGAGAGTGGTCCGCTAA,56,5010040
yjbJ_predicted,0.6086956521739131,72,45,ACCGTGTTTCCACCTTATCA,27,5023165
yjbJ_predicted,0.9777777777777777,87,44,TGGGCGAGTGATTAGGCTAA,43,5022294
yjbJ_predicted,0.5777777777777777,69,44,TAACCACGAATCTGTTCTTG,25,5003029
yjbJ_predicted,1.3555555555555556,104,44,GTAAGTAAAGCTTGCTACTC,60,4995670
yjbJ_predicted,1.9333333333333333,130,44,GGTCCGGGTAGGATTGTTTG,86,5007795
yjbJ_predicted,0.9333333333333333,85,44,CGATTTCACTACAGGATATT,41,5019470
yjbJ_predicted,4.111111111111111,228,44,CCCTTAAACGGTCTTGCACC,184,4996649
yjbJ_predicted,0.044444444444444446,45,44,CATCCGTTCCAACGGCCGAC,1,4999635
yjbJ_predicted,1.288888888888889,101,44,ACAAGAGCAGCTTCTCTGGT,57,5025506
yjbJ_predicted,2.4318181818181817,149,43,GCGTGCATGTGCGGAAACTT,106,5013048
yjbJ_predicted,1.8636363636363635,124,43,GCGGGCGTGTGTGCACAGGA,81,5021901
yjbJ_predicted,1.1363636363636365,92,43,GCGGAAACGGACCCCGGATC,49,5009664
yjbJ_predicted,0.9318181818181818,83,43,CGATCGATATATGAATGGAT,40,5009881
yjbJ_predicted,2.840909090909091,167,43,CCATGGGCTCTCGACTGAAT,124,4999923
yjbJ_predicted,0.8181818181818182,78,43,ATGGCGCCCAGTAGCATTTT,35,5004570
yjbJ_predicted,0.045454545454545456,44,43,AGTGCCATGTCGGGCCAACT,1,5005488
yjbJ_predicted,0.046511627906976744,43,42,TGGAATGTCCCCGCTGCCCT,1,5008451
yjbJ_predicted,1.3255813953488371,98,42,TCTGCAGAGAATGTCAGTGT,56,4998108
yjbJ_predicted,1.1162790697674418,89,42,TAACAGGATCAAATCATACA,47,5006816
yjbJ_predicted,0.6046511627906976,67,42,CTCGGATACTAACTAGGGAT,25,5002947
yjbJ_predicted,0.5813953488372093,66,42,AGCCAACAGTCTGCACCATC,24,5015673
yjbJ_predicted,0.38095238095238093,56,41,TTTTCTCTCAGTGTTTACGT,15,4995996
yjbJ_predicted,2.0,124,41,TTAGGCCCGTGATTTGCCTG,83,5008761
yjbJ_predicted,0.9285714285714286,79,41,TCGTTTACGATGTTTCGAGT,38,5010914
yjbJ_predicted,1.380952380952381,98,41,TCCTTGGAGCCCACCCGCTT,57,5010892
yjbJ_predicted,0.047619047619047616,42,41,TCCGTAAATAATTCAATTCA,1,4994904
yjbJ_predicted,0.7142857142857143,70,41,TCAGGTACAATTCACGTCAC,29,5029460
yjbJ_predicted,0.047619047619047616,42,41,GTAAATGGAATGCTGTCTAT,1,5001013
yjbJ_predicted,2.619047619047619,150,41,GCTATGTTTCAGAACGGAAT,109,4997691
yjbJ_predicted,0.07142857142857142,43,41,GCGTAAGGAACTCCTCTCTA,2,5006797
yjbJ_predicted,2.4285714285714284,142,41,GACTGTGATCTCTCGAACGA,101,5024511
yjbJ_predicted,0.8095238095238095,74,41,CATGACTCCTTCCATAGGCA,33,4997713
yjbJ_predicted,0.5121951219512195,60,40,TTCACCATAGCTAGGCTAGC,20,5010026
yjbJ_predicted,1.5365853658536586,102,40,TCGCATCTGTTTGTTTATGT,62,5018151
yjbJ_predicted,0.8536585365853658,74,40,TATCCCGCTACCGCTCGAGA,34,5026870
yjbJ_predicted,3.097560975609756,166,40,GTAAAAGGCTCTTCACCAAT,126,5006164
yjbJ_predicted,0.7804878048780488,71,40,GCGTCCTAGGTCAAATCGCT,31,5017354
yjbJ_predicted,3.2195121951219514,171,40,ATCCGCGCTCCTTCTCGCCC,131,5017094
yjbJ_predicted,1.3414634146341464,94,40,ATAACGACTGGCACTGCCGT,54,4999298
yjbJ_predicted,2.024390243902439,122,40,AGCTTCGGGAATGCTTGCGT,82,5019494
yjbJ_predicted,0.04878048780487805,41,40,AGCCCGCGGCGTTATATCTA,1,4997223
yjbJ_predicted,1.2926829268292683,92,40,ACATTCACAATATACCCTTG,52,5017558
yjbJ_predicted,0.275,49,39,TTGGCCTTAATAGCCAAGTC,10,5025777
yjbJ_predicted,0.85,72,39,TGATAACTCGGCCCATTTAG,33,4997860
yjbJ_predicted,1.25,88,39,GGCGCCACCAGAGAAAGAAG,49,5031136
yjbJ_predicted,1.55,100,39,GCTCAAAAATCAGTGGCCGA,61,4994708
yjbJ_predicted,0.05,40,39,CTTCGAGGGTACTAGGAAAT,1,5001975
yjbJ_predicted,1.9,114,39,CGGAACTAAGGTCCGGAAAA,75,4995169
yjbJ_predicted,1.475,97,39,CCGTGGGCACGTGCACCGGC,58,4998690
yjbJ_predicted,0.725,67,39,CACCAGCGCATGGGCTTGGA,28,5007506
yjbJ_predicted,0.825,71,39,AAACAATTTTAAATTCGCCA,32,4997738
yjbJ_predicted,1.0256410256410255,77,38,TTAACGACAAGCGTCATCGA,39,4998817
yjbJ_predicted,0.05128205128205128,39,38,TGTGGATCAACAGCGTGTTT,1,5016127
yjbJ_predicted,0.9230769230769231,73,38,TGGATCACCAGGATAGACAG,35,4995745
yjbJ_predicted,0.8461538461538461,70,38,TATGGCGCAATCGGATGGTT,32,5015147
yjbJ_predicted,1.4615384615384615,94,38,GTAGGTATCGTGCTGAACGA,56,4999355
yjbJ_predicted,0.9230769230769231,73,38,GGGTCGGGAGACTCACAGTC,35,5020519
yjbJ_predicted,0.9743589743589743,75,38,GCGCCCCCTAGTTTAACTGT,37,4994683
yjbJ_predicted,1.1538461538461537,82,38,GAGGAGCCCTGCATACACAC,44,5011385
yjbJ_predicted,1.1282051282051282,81,38,ACTCAGAATGAACATCTGCA,43,5024640
yjbJ_predicted,1.8205128205128205,108,38,ACGGCAGTAGAGATTTAGAC,70,5004078
yjbJ_predicted,1.631578947368421,98,37,TATGAGTTATCTTTCACCAA,61,5000841
yjbJ_predicted,3.263157894736842,160,37,TAGGCAAAGTCTCTGTTAGT,123,4995330
yjbJ_predicted,1.9736842105263157,111,37,GTCACACTTGGGCTGGACCT,74,5001319
yjbJ_predicted,0.868421052631579,69,37,GGGCGGGGATGGCGTTAGAA,32,5011893
yjbJ_predicted,1.105263157894737,78,37,GGAGGCCTTAGCCTCCACTA,41,4999402
yjbJ_predicted,1.3157894736842106,86,37,GCAATACAGTAACGGCAATT,49,5004597
yjbJ_predicted,4.2105263157894735,196,37,CGGACTTAACGGGTCCATAA,159,5010948
yjbJ_predicted,2.789473684210526,142,37,CGCATTGCAAGGCCTCGTTG,105,5004604
yjbJ_predicted,0.10526315789473684,40,37,CCCGCCTACGATCGCTATTA,3,5007558
yjbJ_predicted,2.1052631578947367,116,37,CCCGAACGGCTCACAACCTC,79,4998555
yjbJ_predicted,1.4210526315789473,90,37,ACCAGGGCCTCTGTGGGCGT,53,5030973
yjbJ_predicted,2.263157894736842,122,37,ACATTATCACATCTTCCAAA,85,5007853
yjbJ_predicted,0.43243243243243246,51,36,TGAGATCTGAGCCGACGGGA,15,5023719
yjbJ_predicted,1.1891891891891893,79,36,TCGATCAGCGCATTACTTCT,43,5022989
yjbJ_predicted,1.9189189189189189,106,36,TCCCTACGCGCCGCAGAGCT,70,4996652
yjbJ_predicted,2.0,109,36,TAGATCAACCATACCTCGTA,73,4996509
yjbJ_predicted,1.5675675675675675,93,36,TACATTCGTCGGGGGGTTAA,57,4997546
yjbJ_predicted,0.7027027027027027,61,36,GGCGCGCAGTCTGGAACTAC,25,4996455
yjbJ_predicted,1.2432432432432432,81,36,GGATAGCATAATGGGTTACG,45,5005540
yjbJ_predicted,1.4594594594594594,89,36,CCTTCGTCAATCTTTGAAAT,53,5002235
yjbJ_predicted,0.05405405405405406,37,36,CACCGACTCTCGCATACCGA,1,5011023
yjbJ_predicted,1.0810810810810811,75,36,AGCGTGTGGGTCGAGACCTA,39,4998203
yjbJ_predicted,0.05555555555555555,36,35,TTCCATATAGCAACTGGTGA,1,5004191
yjbJ_predicted,0.05555555555555555,36,35,GTCAGCGCAAACCACGTCAC,1,5009068
yjbJ_predicted,1.7777777777777777,98,35,GGGTCCGGCGGGGTTCGTAT,63,5014784
yjbJ_predicted,0.6944444444444444,59,35,GGGACAGGCCCATGATCCTC,24,5011171
yjbJ_predicted,3.1666666666666665,148,35,ATCAATCCCGACAATACACC,113,4996582
yjbJ_predicted,0.1111111111111111,38,35,ATAATTAAGCCTATTCAGGT,3,5000277
yjbJ_predicted,1.2222222222222223,78,35,AGCAGAGCTTGTCCGGTCCA,43,5022918
yjbJ_predicted,0.8,61,34,TGGCGGCTCACGAGAAACAA,27,5013675
yjbJ_predicted,1.457142857142857,84,34,TCCGTCAACGGGTACGACAT,50,4999110
yjbJ_predicted,0.05714285714285714,35,34,TAATCGGCGAGTGCCGGGCG,1,4999348
yjbJ_predicted,0.14285714285714285,38,34,GCGCTATGGTTGGGCAAACT,4,5030513
yjbJ_predicted,1.9142857142857144,100,34,GCATTTTGGGTTGCTAATGA,66,5026111
yjbJ_predicted,3.4857142857142858,155,34,GAGCGACCCGTAGCGCTAAG,121,5014249
yjbJ_predicted,0.05714285714285714,35,34,GACTATGACAACAAGGGCAA,1,5014085
yjbJ_predicted,2.6857142857142855,127,34,CGGTAATCGACGCGTTTGGA,93,5007243
yjbJ_predicted,0.8285714285714286,62,34,CCTTGAATCAATCGGGTCTT,28,4996243
yjbJ_predicted,0.8285714285714286,62,34,CCTCTGTCTGGGGTAAAGCC,28,4995307
yjbJ_predicted,1.2857142857142858,78,34,CCGTCTGATCTCAATATGCT,44,5000579
yjbJ_predicted,0.05714285714285714,35,34,CCAACGAACTGAGTGGCTCG,1,4999297
yjbJ_predicted,1.2571428571428571,77,34,CAGCTGTTTGTGTGAGCGCT,43,5016986
yjbJ_predicted,1.1714285714285715,74,34,CAAGCAGGGTGCGTTCGTGA,40,5018246
yjbJ_predicted,0.9142857142857143,65,34,ATCGTCTGCCTGCGAATCGA,31,5003146
yjbJ_predicted,0.05714285714285714,35,34,AGCGCCTGTGAGTCAGAAAC,1,5018202
yjbJ_predicted,1.2857142857142858,78,34,AATCGTAGCCTTATAGGAAT,44,5015337
yjbJ_predicted,1.1142857142857143,72,34,AACCTCTTAGACCTGACCAT,38,5011722
yjbJ_predicted,4.0285714285714285,174,34,AAATGCCGGCAAAACCCCGG,140,4995605
yjbJ_predicted,1.3823529411764706,79,33,TTCACTGACAATCATACGTT,46,5024089
yjbJ_predicted,0.4117647058823529,46,33,TTAATAGTTCAGAAAGGAAA,13,4999581
yjbJ_predicted,1.1764705882352942,72,33,TGTGAGACGTTAATTGAGGA,39,5001250
yjbJ_predicted,3.588235294117647,154,33,TATTGAACCTCCATGGAGTA,121,5028622
yjbJ_predicted,1.1764705882352942,72,33,GTCGATAATGATACTTGAGT,39,5015625
yjbJ_predicted,0.058823529411764705,34,33,GGGTGCACTATGCATTCATT,1,5007425
yjbJ_predicted,2.264705882352941,109,33,GGCAGCCTTAGAATGTAGCT,76,4997992
yjbJ_predicted,1.5,83,33,GGATGGGGTCCGTACAATAG,50,5019837
yjbJ_predicted,1.411764705882353,80,33,GCGTATAATCCTGTCGAGAG,47,5006540
yjbJ_predicted,1.2647058823529411,75,33,GCCACATCGTACCTAGCTTT,42,4995365
yjbJ_predicted,1.3235294117647058,77,33,GAGTATGTTACGTACCTCTG,44,5030638
yjbJ_predicted,1.6176470588235294,87,33,CTGGATTCTGTAAAGAGAAC,54,5026660
yjbJ_predicted,0.058823529411764705,34,33,CGACGTGATGTGGAGAATGA,1,5007495
yjbJ_predicted,0.058823529411764705,34,33,CCTAACTTCTACCAGGATAA,1,5015926
yjbJ_predicted,0.9117647058823529,63,33,CACCGTCCTGTGTCAAGTAG,30,5006698
yjbJ_predicted,0.9705882352941176,65,33,ATCAACATGCAAGGCTTTAA,32,5007115
yjbJ_predicted,0.08823529411764706,35,33,ACACGTAACATACATGGTTG,2,4997094
yjbJ_predicted,1.696969696969697,87,32,TGTTGTGGCTTGGTTTAACT,55,5009520
yjbJ_predicted,0.06060606060606061,33,32,GTTCATTCGTATGAAACATT,1,5012001
yjbJ_predicted,1.0,64,32,GGTGCTAATGGTACCAAGAA,32,4999723
yjbJ_predicted,0.15151515151515152,36,32,GCGAGCCACGGATCACTCTG,4,5019648
yjbJ_predicted,0.06060606060606061,33,32,GCATCCCTTCTCTGCTACGA,1,4997037
yjbJ_predicted,0.12121212121212122,35,32,GCAAAGTGGGATCAGAGACG,3,5010463
yjbJ_predicted,3.0606060606060606,132,32,CTGTCCGGCCATTAAGCCCT,100,5012363
yjbJ_predicted,1.121212121212121,68,32,CGTATCCCGATGTGCTGACA,36,5012843
yjbJ_predicted,0.7272727272727273,55,32,CGGTTGCGTGCTGTCCCTTG,23,5001627
yjbJ_predicted,1.8181818181818181,91,32,CGCTTCCGGTAAGGGATGTG,59,4996195
yjbJ_predicted,0.06060606060606061,33,32,CGCATCCCTCGCGACACCCC,1,4999721
yjbJ_predicted,0.06060606060606061,33,32,CATATGCGCAGGCCGATGCT,1,5000658
yjbJ_predicted,1.0909090909090908,67,32,CACGGCCAGTGACCCGCAAA,35,5026847
yjbJ_predicted,0.06060606060606061,33,32,ACTTTATAATCACTTTAAAG,1,5017147
yjbJ_predicted,0.5151515151515151,48,32,AAATGCCTTATCAACCCCTC,16,4995665
yjbJ_predicted,0.0625,32,31,TTGCACAGGCAGATTAGAAT,1,5021958
yjbJ_predicted,2.5,110,31,TGACATCCACCGTTGGATCC,79,5008461
yjbJ_predicted,0.09375,33,31,GGTTCAGCACAGGTCGGCAT,2,5005014
yjbJ_predicted,1.25,70,31,GCAGCTCAATCCTGATTCGT,39,5023530
yjbJ_predicted,0.0625,32,31,GCAGAGTCCAGTAAATGAGT,1,5015579
yjbJ_predicted,0.9375,60,31,GATCAACCCCCGATCGAGAA,29,5003544
yjbJ_predicted,3.03125,127,31,CTCATCTGTATTTTACGCAG,96,5014474
yjbJ_predicted,0.0625,32,31,CTAGGGTTTGCTTCGATAGC,1,5016874
yjbJ_predicted,0.0625,32,31,CGGATGAATCTGGTTACGTC,1,5002783
yjbJ_predicted,1.625,82,31,CGCTCCGTGTACACGGCATC,51,5010899
yjbJ_predicted,0.0625,32,31,ATTCGTGGCTCGAGGCGTCG,1,5017465
yjbJ_predicted,2.71875,117,31,ATTAATACAGGGGCAACCTG,86,5013146
yjbJ_predicted,1.09375,65,31,AGTGAGAACCGGGCGGAAGG,34,5007213
yjbJ_predicted,0.0625,32,31,AGAACCTCCTTTAAAGGGTT,1,5020173
yjbJ_predicted,0.40625,43,31,AACTTCCGAATCATCATGTT,12,5023121
yjbJ_predicted,0.0967741935483871,32,30,TTGCTGTAACCGCTGATTGA,2,5003734
yjbJ_predicted,0.06451612903225806,31,30,TTATAGGTGTAAATGACCTG,1,5005495
yjbJ_predicted,0.16129032258064516,34,30,TGTAGTGGTAAAAGGAGCCC,4,5002084
yjbJ_predicted,1.3548387096774193,71,30,TGAGTGATTAATCCTCGCGA,41,5010382
yjbJ_predicted,0.0967741935483871,32,30,TCTCTCGAGAGTGATAAGTT,2,4998850
yjbJ_predicted,0.06451612903225806,31,30,TAGGGGAGCCGGAGTTGCGT,1,5007072
yjbJ_predicted,2.870967741935484,118,30,TACCTATGTGACTCAGATCA,88,5001225
yjbJ_predicted,2.2903225806451615,100,30,TAACGCATCTGACACCTTGG,70,5010534
yjbJ_predicted,0.06451612903225806,31,30,GTGCTTCCTTGACTGAATTT,1,5011654
yjbJ_predicted,0.06451612903225806,31,30,GTGCCCCAGCAATAGTAAGC,1,5007534
yjbJ_predicted,0.45161290322580644,43,30,GGTCAGCCCTATCGATGTGC,13,5011677
yjbJ_predicted,4.096774193548387,156,30,CGTCCGCCTCGTAAAACCTA,126,5010594
yjbJ_predicted,0.967741935483871,59,30,CGTCCAAGACATATGCTGTA,29,5026231
yjbJ_predicted,2.193548387096774,97,30,CGACGTCAGTATGGACCTCT,67,5012705
yjbJ_predicted,0.06451612903225806,31,30,CATTAGTGGGTTAATTATTC,1,5019628
yjbJ_predicted,1.3870967741935485,72,30,CACAGGACTCTAAAGGAAGT,42,4997274
yjbJ_predicted,1.6451612903225807,80,30,CAACGATCTTTGGAGATATA,50,5027785
yjbJ_predicted,1.8387096774193548,86,30,ATGGGCTCGGATTGGTTGTA,56,5016690
yjbJ_predicted,0.06451612903225806,31,30,AGGTTTCCACGCTTTAAATA,1,5006355
yjbJ_predicted,0.06451612903225806,31,30,ACATACGCTCACAGACTTGT,1,4995575
yjbJ_predicted,1.6129032258064515,79,30,ACACTCTTGCGTAACTCTCA,49,5000761
yjbJ_predicted,2.0,88,29,TTCCGCGGGGTGGTTAACGT,59,5018120
yjbJ_predicted,0.3333333333333333,38,29,TCAGGTCAAAAGGAACGTAC,9,4995483
yjbJ_predicted,0.8,52,29,TCACCTACTCGATCTACACT,23,5002200
yjbJ_predicted,1.5,73,29,TAAAAAGACCTATGGGGAAT,44,5008455
yjbJ_predicted,0.06666666666666667,30,29,GTGCGCTATCCTTAACGAGG,1,4996887
yjbJ_predicted,0.1,31,29,GGTAGAGGGCGAAGCCGATA,2,5028820
yjbJ_predicted,0.6,46,29,GGCTCTTGACTAATCTACTC,17,5003260
yjbJ_predicted,1.0666666666666667,60,29,GCTACTTAGTAAAGACGTAT,31,5008911
yjbJ_predicted,1.0333333333333334,59,29,GCGCATTCGAACAATCAAAA,30,5005866
yjbJ_predicted,1.2666666666666666,66,29,CTGGGTTAGCTACCGACGCA,37,4997945
yjbJ_predicted,0.1,31,29,CTCAAAGCGGTACTGTCAAG,2,5004868
yjbJ_predicted,0.9666666666666667,57,29,CTAGTTCCCCCCAACTCGTG,28,5013145
yjbJ_predicted,0.06666666666666667,30,29,CGGGCCGCAGGCGGTTCACG,1,5014870
yjbJ_predicted,2.566666666666667,105,29,CCCACGGACATCTGTGATTC,76,4997822
yjbJ_predicted,1.9,85,29,CAAACAAGTCTCTGAAAGGA,56,5010183
yjbJ_predicted,0.9666666666666667,57,29,ATTAATGGAATATTCGTGCT,28,5005576
yjbJ_predicted,0.7333333333333333,50,29,AGGGAATTCGTCAATGCCTT,21,4999696
yjbJ_predicted,1.3,67,29,AGCGGAATGGCGCGGATGAT,38,5015081
yjbJ_predicted,0.06666666666666667,30,29,ACTCCAGTCAGGGTCAAGAG,1,5008825
yjbJ_predicted,1.0666666666666667,60,29,ACCACGTTCGCATCAAGGTA,31,5027133
yjbJ_predicted,0.5,43,29,ACCAAGTCAAGACGTCCAGA,14,5003168
yjbJ_predicted,1.2,64,29,AATTGGTTCAAATGCTCACC,35,4995167
yjbJ_predicted,0.06666666666666667,30,29,AAGCAACAATGAAGTTTCGT,1,5010997
yjbJ_predicted,1.8,82,29,AAGAGTGGTCTAGACCGCCT,53,5005309
yjbJ_predicted,0.8666666666666667,54,29,AACAACTGATCATAGCCCTT,25,5021608
yjbJ_predicted,1.5517241379310345,72,28,TTTGGAAATTTGTTCCAGGA,44,5023019
yjbJ_predicted,2.6551724137931036,104,28,TGTTTCCATGCAGGCCCCCT,76,5015529
yjbJ_predicted,1.2758620689655173,64,28,TGTTCGCTCCTGGCAGAGTC,36,5000739
yjbJ_predicted,0.06896551724137931,29,28,TGTCGTAGGCCGAGGGAGCT,1,4998156
yjbJ_predicted,1.5172413793103448,71,28,TGGATATGCTTCGGTACCGA,43,5001162
yjbJ_predicted,0.06896551724137931,29,28,TATAGGGAACTGTTGAGAGA,1,5004889
yjbJ_predicted,1.6896551724137931,76,28,TAATTGCAAGGGAGAGCCGT,48,5000719
yjbJ_predicted,0.06896551724137931,29,28,GTATGGAGCGTCCACGGTAA,1,5008199
yjbJ_predicted,1.206896551724138,62,28,GGAGGGTATCCCTCACCAGG,34,5020377
yjbJ_predicted,1.9310344827586208,83,28,GCTATACTGCATTTTGAAAT,55,5012729
yjbJ_predicted,0.10344827586206896,30,28,GAGTGCAACGAGAGCGGGAC,2,5027552
yjbJ_predicted,1.3103448275862069,65,28,CATTACTGATTGGGGTGTGA,37,5018977
yjbJ_predicted,1.5172413793103448,71,28,CATCGCTGAGTGGCATAGTA,43,5000740
yjbJ_predicted,0.9310344827586207,54,28,CAGCGATACGTCACCTTATA,26,5028233
yjbJ_predicted,1.6896551724137931,76,28,ATTCAAGCTTCAGCATACTC,48,5029976
yjbJ_predicted,1.4482758620689655,69,28,ATCGTTACCTAGGTCAGGTA,41,5030751
yjbJ_predicted,0.06896551724137931,29,28,ATCAGAATTCACGAACTGGA,1,5002988
yjbJ_predicted,5.620689655172414,190,28,AGGGTCTTGAGATTGTGCAG,162,5020533
yjbJ_predicted,2.206896551724138,91,28,AGCCGATCATATTACACAGT,63,4996135
yjbJ_predicted,1.3448275862068966,66,28,AGAAAAGAGGATTTCCCCGT,38,5009516
yjbJ_predicted,1.896551724137931,82,28,AACCGGGTCTTCAGCAGGAG,54,5022514
yjbJ_predicted,0.07142857142857142,28,27,TGTCCGGCGAGGCTATCCAT,1,5019847
yjbJ_predicted,1.9285714285714286,80,27,TGAGGACGAGAGCGCCATTA,53,5005747
yjbJ_predicted,0.07142857142857142,28,27,TATACAAGAGACCGGCGATG,1,5007823
yjbJ_predicted,1.0357142857142858,55,27,TAGACTGTTTCAGTGACGCA,28,5020232
yjbJ_predicted,0.75,47,27,GTCTTAGGTTCCTGTCGGGA,20,5021197
yjbJ_predicted,0.07142857142857142,28,27,GTACGCTTGCGGCACGAGGC,1,4998144
yjbJ_predicted,2.0,82,27,GCGGACTCTTCTATGATACT,55,5007451
yjbJ_predicted,3.0357142857142856,111,27,GATGCTAGGTGATTTCTCCT,84,5010732
yjbJ_predicted,0.07142857142857142,28,27,CTTATGCGGTCCAATTATGC,1,5024670
yjbJ_predicted,5.285714285714286,174,27,CTGCTCGGGTGGCAACGGTA,147,5000339
yjbJ_predicted,1.2857142857142858,62,27,CGAACACCAGAGGTGTTCGT,35,5024258
yjbJ_predicted,1.9642857142857142,81,27,CATACCCGAGGTATTTCTTT,54,5003882
yjbJ_predicted,1.0357142857142858,55,27,CATAATCCGTAGAGACACGA,28,5001317
yjbJ_predicted,1.2857142857142858,62,27,CAGAATCCGCGCCCCCACAG,35,5002399
yjbJ_predicted,1.6428571428571428,72,27,ATCAAGATGGCCCAGGGTCT,45,5000201
yjbJ_predicted,4.714285714285714,158,27,AGTGTCCCGACATGCTCAGA,131,5020454
yjbJ_predicted,1.6071428571428572,71,27,AGGGGAGTGCATTTGTGGGC,44,5002096
yjbJ_predicted,1.7142857142857142,74,27,ACACGTATCCGTTAATGGAT,47,5007070
yjbJ_predicted,1.3214285714285714,63,27,ACAAGCGTAGGCGGTAACCA,36,5005591
yjbJ_predicted,3.2142857142857144,116,27,AATGAGAGCGACAAATAATA,89,5015434
yjbJ_predicted,0.39285714285714285,37,27,AAGTGGTTAAATACTTTAAC,10,5002353
yjbJ_predicted,1.1851851851851851,57,26,TTGCCAGGCTTGAAAGGCGC,31,5016997
yjbJ_predicted,1.7037037037037037,71,26,TTATGTATATCCACTTTTTA,45,5016949
yjbJ_predicted,2.074074074074074,81,26,TGGGGCACTCGCACACACTA,55,5018989
yjbJ_predicted,1.5185185185185186,66,26,TGCCCCTCTCACATACTGCC,40,4997770
yjbJ_predicted,0.07407407407407407,27,26,TGCACGCCAAACTCACATAT,1,5016809
yjbJ_predicted,1.2592592592592593,59,26,TGAATTCGGAAGGTGCGATG,33,5027432
yjbJ_predicted,1.1481481481481481,56,26,TCTATCTGTGGTCCAGCCAG,30,5004992
yjbJ_predicted,1.037037037037037,53,26,GTGAAAGGCTTGTGACTAGA,27,5007530
yjbJ_predicted,2.111111111111111,82,26,GTCCCATTAGAACGTTTCCA,56,5001100
yjbJ_predicted,1.1481481481481481,56,26,GTAATCAGGACGCTGCGAGC,30,5006379
yjbJ_predicted,1.5185185185185186,66,26,GTAAAGCTAAACTCTATTCA,40,5010726
yjbJ_predicted,2.5555555555555554,94,26,GGGAGCATCCTCAAATCGAC,68,4994965
yjbJ_predicted,0.07407407407407407,27,26,GGCTATGTAAAGTGCCGCCA,1,5004321
yjbJ_predicted,0.1111111111111111,28,26,GCGCGTCGTGTACACACTCA,2,5011290
yjbJ_predicted,2.925925925925926,104,26,GATTCATTGCGGCGTTACGC,78,5022324
yjbJ_predicted,2.037037037037037,80,26,GAAACCGACCGGATAGAGCA,54,5025862
yjbJ_predicted,2.5925925925925926,95,26,CTCAGGTTTACCTTAACTAT,69,4995381
yjbJ_predicted,0.4444444444444444,37,26,CGGTGTACTTGTAGGATAGA,11,5011275
yjbJ_predicted,0.7777777777777778,46,26,CCCATCGAAGGGATACCTCT,20,5013370
yjbJ_predicted,1.7777777777777777,73,26,CCACGCGAGTTTGCTGTCCA,47,5023814
yjbJ_predicted,0.07407407407407407,27,26,CATCCTTGCAAAGAGAACAC,1,5021264
yjbJ_predicted,3.8518518518518516,129,26,CAGTCCATAGTGGAAGTCAT,103,5005583
yjbJ_predicted,3.7777777777777777,127,26,CAGCCCGAGTTCTCCCTGCT,101,5000325
yjbJ_predicted,0.07407407407407407,27,26,CACAGGCCCCTTTCAAATCA,1,4998460
yjbJ_predicted,0.8518518518518519,48,26,ATCTATTAGGCATGACCCTT,22,5001086
yjbJ_predicted,0.14814814814814814,29,26,ATATAACCGAAATAGCGTGT,3,5024965
yjbJ_predicted,2.074074074074074,81,26,AGCTCTACACTGGTACCACA,55,5012434
yjbJ_predicted,1.6296296296296295,69,26,AGCATGGCTGGATGTTTTAG,43,5010182
yjbJ_predicted,0.07407407407407407,27,26,AGAAAACATGCTGCGCGTGT,1,5025330
yjbJ_predicted,0.14814814814814814,29,26,ACTCGAGTAATGGGGAGAGA,3,4998590
yjbJ_predicted,2.1481481481481484,83,26,ACCTTGTGCTCAACCGACCT,57,5028798
yjbJ_predicted,1.8148148148148149,74,26,ACCTGATGTGGTTGTCCACT,48,5005837
yjbJ_predicted,1.9259259259259258,77,26,ACCGCCCCTCCACCCTATAA,51,5023315
yjbJ_predicted,1.5185185185185186,66,26,ACATTCTTCTTTCTAGGAGA,40,5023054
yjbJ_predicted,0.07407407407407407,27,26,ACAGAGGCTCCCGCCCATTG,1,5010883
yjbJ_predicted,1.6666666666666667,70,26,AATCGGACCAGGGTTCCCCA,44,5008943
yjbJ_predicted,1.9230769230769231,74,25,TTTTGGTTCATTCAGCATAT,49,4997114
yjbJ_predicted,1.7307692307692308,69,25,TTCGAGCGGACACTCTATTA,44,4995115
yjbJ_predicted,0.07692307692307693,26,25,TGTCGGAGCATCTGCGGCAG,1,5018032
yjbJ_predicted,0.07692307692307693,26,25,TGGCCTAACAGTATATACAG,1,5010706
yjbJ_predicted,1.1923076923076923,55,25,TGGAATGTAGATCATTGACC,30,5014132
yjbJ_predicted,2.0384615384615383,77,25,TCTTCATCTCGCAGTTGCGA,52,5013941
yjbJ_predicted,2.1153846153846154,79,25,TCGGACCACTTAGCGAACAT,54,5005347
yjbJ_predicted,1.5,63,25,TCGCGGATGGACGACCAGGA,38,5020080
yjbJ_predicted,2.0384615384615383,77,25,TATGTCTCCCTATCCGGTAA,52,5009202
yjbJ_predicted,1.3461538461538463,59,25,GGTGCCCGCGTGGCCAACCT,34,5016420
yjbJ_predicted,1.7692307692307692,70,25,GGACCTGGTGGGCATTTAAT,45,5001689
yjbJ_predicted,1.6153846153846154,66,25,GCCGATATGACCCGCCATTC,41,5011483
yjbJ_predicted,0.07692307692307693,26,25,GAGCAGGGCAGACCGAACTG,1,5008323
yjbJ_predicted,2.0,76,25,CGTTACAGAGGCTTGTGTAG,51,5024030
yjbJ_predicted,2.0,76,25,CGATGGTAGCCCGGACCTGG,51,5004611
yjbJ_predicted,1.0384615384615385,51,25,CGAGGGGTATTAAGAGGCAG,26,5026027
yjbJ_predicted,0.07692307692307693,26,25,CCTGTTAACGACGCCACTCT,1,5000559
yjbJ_predicted,0.7692307692307693,44,25,CCGCTGCCTCGTGTACGTCA,19,4998482
yjbJ_predicted,0.6923076923076923,42,25,CCCGCTAGGGTGTCCGGGTA,17,5001660
yjbJ_predicted,1.2307692307692308,56,25,CATCGGACCACTGAACCCGT,31,5009329
yjbJ_predicted,0.07692307692307693,26,25,CACGCGTTGACTGCACTCCT,1,5001290
yjbJ_predicted,0.11538461538461539,27,25,ATTTGTGGACTTTCGACGTA,2,5011637
yjbJ_predicted,1.8076923076923077,71,25,ATTCTGGTAGTAGATAATGA,46,5006905
yjbJ_predicted,1.4230769230769231,61,25,ATTATAGATGTATCTCTAAT,36,5019712
yjbJ_predicted,0.46153846153846156,36,25,ATTACCCATATTTCGCGCCT,11,5007076
yjbJ_predicted,0.07692307692307693,26,25,AGGTGACGTCATATTTTAAC,1,5003367
yjbJ_predicted,3.1923076923076925,107,25,AGACTCAGGCTGGCCTACTA,82,4994881
yjbJ_predicted,4.6923076923076925,146,25,ACCTTACAACAGGATGAGAA,121,5026723
yjbJ_predicted,0.07692307692307693,26,25,ACATACGATAAGAGCCTGTA,1,5004799
yjbJ_predicted,0.07692307692307693,26,25,AAGGCTACCACTAAGGACTT,1,5017214
yjbJ_predicted,0.9230769230769231,48,25,AAACAACGGTGCGACTCCAA,23,5015757
yjbJ_predicted,1.8,68,24,TTTCATCTTCCTTCTGGCGT,44,4997589
yjbJ_predicted,2.0,73,24,TTGAAAGCCGTAATGGCGCA,49,4996867
yjbJ_predicted,0.88,45,24,TTAGGATCCGCAGGCATATA,21,4996081
yjbJ_predicted,2.4,83,24,TGTCAGGAGGGGTCGGCCTC,59,5018687
yjbJ_predicted,1.2,53,24,TGTCAACATGCGTCAACCGG,29,5026312
yjbJ_predicted,0.08,25,24,TGTAACGATTGTTAGTCGCT,1,5018818
yjbJ_predicted,0.08,25,24,TGGTGAGCTACGCAATTCTA,1,4995636
yjbJ_predicted,0.12,26,24,TCTGAACTGCTTTGTCTCTG,2,5027055
yjbJ_predicted,1.0,48,24,TACTATATCCCATTAATAGT,24,4998574
yjbJ_predicted,2.04,74,24,TACACGGGGCCGGGTCATAC,50,5012460
yjbJ_predicted,2.88,95,24,TAAGCTTAGAGCGTACTGAA,71,5015277
yjbJ_predicted,0.08,25,24,GGCAGCCAGGCTTATGTCTT,1,5018753
yjbJ_predicted,1.44,59,24,GGATCGTATGATAGAACTCT,35,5023020
yjbJ_predicted,1.32,56,24,GGAGGTAAGGGCATAGAGTC,32,5014239
yjbJ_predicted,2.68,90,24,GGAGCCCGCAAGACGCGAAA,66,5011890
yjbJ_predicted,1.24,54,24,GCGCTTAGCACTGAGTTAAA,30,4996288
yjbJ_predicted,1.84,69,24,GCAATAGCTTATGTCCTAGA,45,5023508
yjbJ_predicted,0.96,47,24,GAGCACTTGGCCGGCAGTCA,23,4997844
yjbJ_predicted,2.32,81,24,CTCCTTCGGGGCCAGACATT,57,5000318
yjbJ_predicted,2.04,74,24,CTATGGGCATATCGTGAGCT,50,5031042
yjbJ_predicted,0.2,28,24,CTATATAGCATATGCCGGAG,4,5017895
yjbJ_predicted,0.8,43,24,CGTATTGTGCATGTGTCGCC,19,4996943
yjbJ_predicted,0.08,25,24,CGATACTCTTAGGTAACTTA,1,5011488
yjbJ_predicted,0.08,25,24,CGACGCAATAGCTGCAGAAG,1,5027633
yjbJ_predicted,0.4,33,24,CATATTGTCTACCTTAACTC,9,5017517
yjbJ_predicted,0.08,25,24,CAACGCACATTCAGAATGGT,1,5010790
yjbJ_predicted,1.36,57,24,ATTTCGGTCTTACTGAGCTT,33,5009427
yjbJ_predicted,0.08,25,24,ATGGACAATGGAAAAGGTTT,1,5030314
yjbJ_predicted,0.08,25,24,ATAGGCTTACTCTAACTTAT,1,5011044
yjbJ_predicted,0.08,25,24,AGGGGCATGTTAACATTGGT,1,4997718
yjbJ_predicted,5.56,162,24,AGAGACCTAGCGCGACTTGA,138,4997515
yjbJ_predicted,2.24,79,24,ACCACCGCGCAGGGCGACCT,55,4997244
yjbJ_predicted,0.08,25,24,AATTACTTTGACACTTCTAT,1,5004039
yjbJ_predicted,0.08,25,24,AACTTTAATAAAAGCCCAAA,1,5005122
yjbJ_predicted,1.0416666666666667,47,23,TTGCATTGACTTCGATGTTC,24,4994687
yjbJ_predicted,1.2916666666666667,53,23,TTAAAGATTTGTCGCCCTAA,30,4997182
yjbJ_predicted,3.6666666666666665,110,23,TGTTCCACATCGGGCCAACA,87,4996112
yjbJ_predicted,1.9166666666666667,68,23,TGTGACTACGTAAAATCGGT,45,4998572
yjbJ_predicted,1.8333333333333333,66,23,TGCGCTGATGTAGGTATAAT,43,4998399
yjbJ_predicted,1.9583333333333333,69,23,TACAGCTCCAGTTTTGCTCC,46,5009180
yjbJ_predicted,2.0416666666666665,71,23,TAACGAATGATTTGCGTGCC,48,4999762
yjbJ_predicted,2.2083333333333335,75,23,GTGCCAAGTTTGGAAACTTT,52,5004106
yjbJ_predicted,2.0,70,23,GGAGTTTCGGACCAGGGTTT,47,5004341
yjbJ_predicted,2.4166666666666665,80,23,GGAGAGAATTGCGGGGATGA,57,5023546
yjbJ_predicted,2.4583333333333335,81,23,GCCCGTACCTACGTTTCTAA,58,5002682
yjbJ_predicted,2.0416666666666665,71,23,GCACCCGGAATCGCGTGGAT,48,5016024
yjbJ_predicted,1.0833333333333333,48,23,GAGCAACACGAGCCAGTCCG,25,5005222
yjbJ_predicted,5.208333333333333,147,23,GAATCCCGCATATGCTCCAT,124,5010910
yjbJ_predicted,0.20833333333333334,27,23,GAACATGGGCGCTCTGATTC,4,5012850
yjbJ_predicted,2.5833333333333335,84,23,CTACAATGTTTCATCGCCTC,61,5021842
yjbJ_predicted,2.25,76,23,CGGGTTTCATACCGGGGGAT,53,5010364
yjbJ_predicted,1.7916666666666667,65,23,CAAGGCTTGGCTAAAATGAG,42,5005468
yjbJ_predicted,1.8333333333333333,66,23,CAAGGCCGAGCCTTCGACGC,43,4998063
yjbJ_predicted,1.6666666666666667,62,23,ATTGGGCTCCCAGCTCTCGA,39,5002972
yjbJ_predicted,0.08333333333333333,24,23,AGTTAAAAGATAGTGGACCA,1,5020254
yjbJ_predicted,2.2083333333333335,75,23,AGGGTTTCCAGACAGCGCTA,52,5017401
yjbJ_predicted,0.6666666666666666,38,23,AGCGATGAACCGTGGCGGGA,15,5003234
yjbJ_predicted,3.7083333333333335,111,23,AGCCACTTGAGGGCTAAGGA,88,5011126
yjbJ_predicted,0.08333333333333333,24,23,ACTATACCGAGAGCACCGCG,1,5007749
yjbJ_predicted,0.08333333333333333,24,23,ACCCCCCGTGTCCGGGATAA,1,4995119
yjbJ_predicted,0.625,37,23,ACCACCATAAGATCGTAAAT,14,5006018
yjbJ_predicted,0.08695652173913043,23,22,TTGCTGGCCTCTCACGACGT,1,5008595
yjbJ_predicted,1.4782608695652173,55,22,TGTTCTCCCGCATGAAAGGC,33,5001541
yjbJ_predicted,0.08695652173913043,23,22,TGCCTTGCGGCTTCATCTAA,1,5011497
yjbJ_predicted,1.173913043478261,48,22,TATCAGGTACGTTTTGGTTC,26,5014013
yjbJ_predicted,0.43478260869565216,31,22,GTGACTAGACCTCTACAGTT,9,5002053
yjbJ_predicted,0.08695652173913043,23,22,GTAACGCCGATTGGCGTATA,1,5022379
yjbJ_predicted,0.08695652173913043,23,22,GGTTAGGAGGAGGAGGACTA,1,5013757
yjbJ_predicted,0.08695652173913043,23,22,GGATCGCTCCGTAAATGGCT,1,5019525
yjbJ_predicted,1.9130434782608696,65,22,GCAAACAGCGTACATTCCTC,43,5014712
yjbJ_predicted,1.826086956521739,63,22,GACGTCATTTCATTGAATCT,41,5017698
yjbJ_predicted,1.6521739130434783,59,22,CTACGGTCCTGGGACACTAT,37,4996240
yjbJ_predicted,6.782608695652174,177,22,CCTTGACTAGCGCTGGGACT,155,5010913
yjbJ_predicted,1.3478260869565217,52,22,CCGTTCGACACCGGTCTCCT,30,5030433
yjbJ_predicted,1.3478260869565217,52,22,CCGGCTTCGTTGATTGGCAT,30,5007573
yjbJ_predicted,2.3043478260869565,74,22,CCGCCGTAAGCCCATACTAA,52,5013997
yjbJ_predicted,0.2608695652173913,27,22,CCCATTGTACGCAGTGACAC,5,5000782
yjbJ_predicted,2.391304347826087,76,22,CCCAGTGCGATTAAGGAATT,54,5005491
yjbJ_predicted,1.0869565217391304,46,22,CATGGTTGTGTCCAATGTGA,24,5006764
yjbJ_predicted,0.6956521739130435,37,22,ATTTCTGCCGTGACGCAGAA,15,5013487
yjbJ_predicted,4.608695652173913,127,22,ATGGTAAGCAAATCTTCCCG,105,5000431
yjbJ_predicted,3.0434782608695654,91,22,AGTGGAGGTCGCGGATGGTT,69,5009533
yjbJ_predicted,1.391304347826087,53,22,AGTACTGACTGCGCGTGTAT,31,4999555
yjbJ_predicted,1.6521739130434783,59,22,AGATTGAGCGGGTATCAGAG,37,5005812
yjbJ_predicted,2.217391304347826,72,22,AGACGCAGTAAGAATTGTAC,50,5020759
yjbJ_predicted,2.5217391304347827,79,22,AGACATGACCGTAGCCTTGA,57,5005834
yjbJ_predicted,1.9565217391304348,66,22,ACTCCATCGACGATTAATTG,44,5015626
yjbJ_predicted,1.2173913043478262,49,22,ACTAAGTCATGTTCTCGTGA,27,5005648
yjbJ_predicted,0.34782608695652173,29,22,ACAAGTCGTTTGATCGGGAT,7,5004646
yjbJ_predicted,2.3043478260869565,74,22,AATGATGAGCTTTAAAAGCT,52,4996970
yjbJ_predicted,0.17391304347826086,25,22,AAAGAGCAGCGCAGTGGGCC,3,5010624
yjbJ_predicted,8.636363636363637,210,21,TTCCTGCGGCAGGAGAGCAG,189,5025334
yjbJ_predicted,9.272727272727273,224,21,TTACATAAGCGGTGATCATT,203,5001062
yjbJ_predicted,2.409090909090909,73,21,TGTGGTACCGAAATTGTGAG,52,4995611
yjbJ_predicted,0.09090909090909091,22,21,TGTACGGAAAAGTGACTCTA,1,5014233
yjbJ_predicted,4.409090909090909,117,21,TGGGTGTATCTGGATGTCTG,96,5023240
yjbJ_predicted,0.8636363636363636,39,21,TGGACACACGATATCGACGT,18,5021718
yjbJ_predicted,5.409090909090909,139,21,TGCCAAATAGTCTCCTAAAC,118,5028667
yjbJ_predicted,2.0454545454545454,65,21,TGCAAAGTCATACCAGGCCC,44,5028930
yjbJ_predicted,0.9090909090909091,40,21,TGAAACAACTGACGCGTCGG,19,5009247
yjbJ_predicted,0.09090909090909091,22,21,TCGCATTAAGCAGGTTAGCG,1,5001495
yjbJ_predicted,0.4090909090909091,29,21,TCCACATGTCCGATACTACC,8,5024656
yjbJ_predicted,1.6363636363636365,56,21,TAATCAACAGGAGTGAAAGG,35,5012182
yjbJ_predicted,2.272727272727273,70,21,GTGAGTCCGTTCTGACTCCT,49,5019394
yjbJ_predicted,1.6363636363636365,56,21,GGGGCCATCCACGCGTCCGG,35,5017506
yjbJ_predicted,1.8181818181818181,60,21,GGGACCCCTGTCCCCCGTGT,39,4999841
yjbJ_predicted,0.5909090909090909,33,21,GGAGGTTGTGCCAATACAGC,12,5014250
yjbJ_predicted,2.5454545454545454,76,21,GGACTACACCGCAAGGTGCA,55,5004727
yjbJ_predicted,1.0909090909090908,44,21,GGACATTCGTAAGCTTCGTT,23,5030413
yjbJ_predicted,1.2272727272727273,47,21,GCCTGTGTCAACTTCCTAGG,26,5011137
yjbJ_predicted,1.0454545454545454,43,21,GATGGGTGTGTCTATATAGC,22,5002949
yjbJ_predicted,4.636363636363637,122,21,GATATATCGCCGATTTCCAA,101,5011496
yjbJ_predicted,2.590909090909091,77,21,GACTCCTCCGGTAATCGGAA,56,5015471
yjbJ_predicted,2.5,75,21,GAATACTCGGTGGCGATGTT,54,5012378
yjbJ_predicted,2.909090909090909,84,21,GAAGGTCTGAAAAGGCCTTG,63,5009778
yjbJ_predicted,3.727272727272727,102,21,CTTTATTGTCCGCGAGACCT,81,4999276
yjbJ_predicted,2.3181818181818183,71,21,CTTCACACAGCAGCTGCCAG,50,5018522
yjbJ_predicted,2.6818181818181817,79,21,CTCGAGGATGCTTCCAAGCA,58,5000454
yjbJ_predicted,0.13636363636363635,23,21,CTCCCTACCCAGTCGTCTAA,2,5012476
yjbJ_predicted,6.090909090909091,154,21,CTCCCCCAAAGGTCCTGCGT,133,5007147
yjbJ_predicted,0.9545454545454546,41,21,CTAAAACAGTGGTGGGCCAG,20,5000233
yjbJ_predicted,2.5454545454545454,76,21,CGGGGAATTTGCAGCTCACA,55,5002807
yjbJ_predicted,0.36363636363636365,28,21,CGCTACCGACGTGAATTAGG,7,5005397
yjbJ_predicted,6.863636363636363,171,21,CGCCTCGTCGCGAGACACAT,150,5023865
yjbJ_predicted,2.090909090909091,66,21,CCTAAAAACCAGGTAAGTGT,45,5009747
yjbJ_predicted,2.227272727272727,69,21,CCGAGATATGTGCGAAGAAA,48,5013259
yjbJ_predicted,0.36363636363636365,28,21,CATTGGAGGCTAACCGCAGC,7,5000365
yjbJ_predicted,1.7272727272727273,58,21,ATTACGGTATTCGGGTTAAC,37,5001692
yjbJ_predicted,0.09090909090909091,22,21,ATGAGACGTGGAGTATTCGA,1,5025625
yjbJ_predicted,1.3636363636363635,50,21,AGGTTTTCTTTAACCCAGTT,29,5019429
yjbJ_predicted,1.7727272727272727,59,21,AGCTACCTAGTGATGCTCTA,38,4999199
yjbJ_predicted,1.7727272727272727,59,21,AGACCATTTCGTTTCTTACG,38,5025279
yjbJ_predicted,2.8181818181818183,82,21,ACGCGTGGCCGCCTGGGATG,61,5029188
yjbJ_predicted,4.681818181818182,123,21,ACGCATGAAACTTATCCGTT,102,5009307
yjbJ_predicted,1.1363636363636365,45,21,ACCGGAAGGAAGCCGAAGTA,24,4995046
yjbJ_predicted,1.5,53,21,ACATCCACAGAACTAGCTGG,32,5014720
yjbJ_predicted,2.0454545454545454,65,21,AAGACACAGTTGATGCACCA,44,5000037
yjbJ_predicted,1.7272727272727273,58,21,AAATCTATTTGCCATAAGCA,37,5024772
yjbJ_predicted,2.3181818181818183,71,21,AAATAGTATTTTACCCGTCA,50,4997521
yjbJ_predicted,4.523809523809524,114,20,TGCGGGTTTGATACTCTTAG,94,5025644
yjbJ_predicted,0.09523809523809523,21,20,TGACCCGACGTGCCATATAG,1,5014925
yjbJ_predicted,1.8095238095238095,57,20,TCTTGGTAGGTCGATGCCGT,37,5019688
yjbJ_predicted,0.09523809523809523,21,20,TCTACCCGCAGGATGAATTC,1,5023223
yjbJ_predicted,1.8571428571428572,58,20,TCGCGAGTTAGGCTCTATGC,38,5007012
yjbJ_predicted,1.5238095238095237,51,20,TCACTCAACGGTCGTCGTGA,31,5002832
yjbJ_predicted,1.4761904761904763,50,20,TATTTCGCTTAGGAAGTTTC,30,5027103
yjbJ_predicted,2.4285714285714284,70,20,TAGGATAGCCCTTCGCCGAA,50,5017407
yjbJ_predicted,1.9047619047619047,59,20,TACGCTGCATTCGGGTCGAA,39,5007662
yjbJ_predicted,0.09523809523809523,21,20,TACAGTGTTGTACAGATTGT,1,5001053
yjbJ_predicted,2.4761904761904763,71,20,TAATGTACCTCTGGTCGGGC,51,4994964
yjbJ_predicted,0.09523809523809523,21,20,TAATACCCTGCGGAGATTAA,1,5028637
yjbJ_predicted,0.14285714285714285,22,20,TAAGACTGTGCGGTCCTGTC,2,5030343
yjbJ_predicted,0.09523809523809523,21,20,GTCTCAAACGTTGAGGACTA,1,5013584
yjbJ_predicted,3.4285714285714284,91,20,GGTGATGTCGTGGTCTGATT,71,5028258
yjbJ_predicted,1.7142857142857142,55,20,GGGTATGGAGTGTCTACGTA,35,4996084
yjbJ_predicted,0.09523809523809523,21,20,GGGGGGCACGGCCTGGCGCA,1,5014283
yjbJ_predicted,2.7142857142857144,76,20,GGGATAAGAGTGGGCCGCAA,56,5007808
yjbJ_predicted,2.9047619047619047,80,20,GGCATACTCCACGATTGCGT,60,5003609
yjbJ_predicted,0.14285714285714285,22,20,GAGATGCGTAGAGGGCCTAT,2,5001918
yjbJ_predicted,0.09523809523809523,21,20,GACAAAGGCTTGGATAACTT,1,4994711
yjbJ_predicted,1.1428571428571428,43,20,GAAAGGAGGTAAGCCGCAAG,23,5016060
yjbJ_predicted,2.619047619047619,74,20,CTTCTCAATGAGTGTGCTTG,54,5004596
yjbJ_predicted,1.7142857142857142,55,20,CTGGTTATGGGACGTCGGCA,35,4996987
yjbJ_predicted,3.6666666666666665,96,20,CTACCGTTATGTTGCGCGAG,76,5016792
yjbJ_predicted,0.19047619047619047,23,20,CTACCCACGGAATTTCTGAA,3,5028889
yjbJ_predicted,1.1428571428571428,43,20,CGTAGTGTAACTCCCGGCTT,23,5003610
yjbJ_predicted,1.5714285714285714,52,20,CGGCTAATTTACCAATCTCG,32,5013582
yjbJ_predicted,1.7619047619047619,56,20,CGGCCTACAGTTCAATAAAA,36,5013986
yjbJ_predicted,2.9047619047619047,80,20,CGATCTGAGCCAAACTGGCC,60,4998706
yjbJ_predicted,0.9523809523809523,39,20,CGAGACAAAACCGTACGGTT,19,5013826
yjbJ_predicted,0.14285714285714285,22,20,CCTGTACAATAGAACCGAAT,2,5008339
yjbJ_predicted,1.5714285714285714,52,20,CCGGTATAGCCTACATCATA,32,5010532
yjbJ_predicted,0.09523809523809523,21,20,CCACCCGAGGCACTCGTCTA,1,5027502
yjbJ_predicted,1.1428571428571428,43,20,CATCGGTCTCCCTTCAAGCA,23,4996847
yjbJ_predicted,3.1904761904761907,86,20,CATCAGTGAGGGGTATGATC,66,5002895
yjbJ_predicted,1.4285714285714286,49,20,CAGCAGTCGGCATCTCCTAG,29,5027960
yjbJ_predicted,1.619047619047619,53,20,CAGATAGGGATAGTCAGGGT,33,4997353
yjbJ_predicted,0.09523809523809523,21,20,CACACAGTATCTCTCCTGCA,1,5002325
yjbJ_predicted,4.619047619047619,116,20,CAATGCTTGGGCTTAAGCTA,96,5002047
yjbJ_predicted,5.714285714285714,139,20,ATTGGCCAGCTTTCGCCAGT,119,4995639
yjbJ_predicted,1.4761904761904763,50,20,ATTCGATATTATCGTATTAG,30,5028916
yjbJ_predicted,3.142857142857143,85,20,ATGACCGCATGCGAGATTAT,65,5011484
yjbJ_predicted,2.1904761904761907,65,20,ATCGGGCAAGAAATACCATG,45,5019011
yjbJ_predicted,0.09523809523809523,21,20,ATCAGGGTTGGCCTACCTCA,1,4997890
yjbJ_predicted,2.1904761904761907,65,20,ATATCTCGAAACACGAGGTC,45,5018383
yjbJ_predicted,3.238095238095238,87,20,ATATCCTCGGGTTAAGACCA,67,5026730
yjbJ_predicted,0.19047619047619047,23,20,ATAGGGTGATCATCGGGATG,3,5001308
yjbJ_predicted,0.09523809523809523,21,20,AGATAGACAAAATCCATTCA,1,5023344
yjbJ_predicted,0.5714285714285714,31,20,ACGATTAAGACGAGAGGGCT,11,5011104
yjbJ_predicted,2.4761904761904763,71,20,AATTACCTACATGATGTGAT,51,5007468
yjbJ_predicted,0.09523809523809523,21,20,AAGGTAATTTTACAATTGTG,1,5017423
yjbJ_predicted,0.09523809523809523,21,20,AAATCAAGGCCATTCGCCAC,1,5021157
yjbJ_predicted,0.09523809523809523,21,20,AAAGTTGCTATGTCCGGCTT,1,4997054
yjbJ_predicted,2.0952380952380953,63,20,AAAGGGTTACAACACACCAG,43,5023535
yjbJ_predicted,2.8,74,19,TTTTTATTCCCCCCCATATA,55,5012703
yjbJ_predicted,4.0,98,19,TTCCGTTTCACGCTGGGCCT,79,5027239
yjbJ_predicted,0.7,32,19,TTAGCATCTGGATATTCTGG,13,5001068
yjbJ_predicted,1.6,50,19,TTAACAGTCGGGGAGACCTA,31,5017163
yjbJ_predicted,0.1,20,19,TGCGAACCGCCCGGACGGCG,1,5028264
yjbJ_predicted,0.15,21,19,TCTTAGCACCGCGACTGGGT,2,5015099
yjbJ_predicted,0.1,20,19,TCCTGTAAGGTGGGCTAAGA,1,5021942
yjbJ_predicted,0.65,31,19,TCCAGGGTGGATCAAAGTGA,12,4998972
yjbJ_predicted,1.75,53,19,TCAGCCCGTTTGATGAATAG,34,5014358
yjbJ_predicted,0.1,20,19,TACTGTTCTGGGTTGGTTTT,1,5009765
yjbJ_predicted,1.95,57,19,TACGTGCGCATGTTATTCGT,38,4995764
yjbJ_predicted,3.2,82,19,GGTATTTCTGCTGGGCTCAC,63,5013422
yjbJ_predicted,2.65,71,19,GGGAAGAAAGGTGGAGTTGT,52,5015983
yjbJ_predicted,0.15,21,19,GGCTTTTAAAGATGGAAATG,2,4997551
yjbJ_predicted,0.1,20,19,GGAGATACAGACTCAACTCG,1,5004005
yjbJ_predicted,1.2,42,19,GCCCCATTCTAACAGCCTTG,23,5028888
yjbJ_predicted,3.7,92,19,GAGTGGCTGAGCTACCTGAC,73,5017522
yjbJ_predicted,2.2,62,19,CTGGGACCAGGACCTTCCTC,43,4995021
yjbJ_predicted,2.8,74,19,CTAACAGCCCGCAGTCGTTT,55,5007807
yjbJ_predicted,0.1,20,19,CGTGCATATGGCACGACCAC,1,4994695
yjbJ_predicted,0.15,21,19,CGGCGAGGTAGATAATCCTA,2,5014180
yjbJ_predicted,2.2,62,19,CGCTCTTAGGAACCCTCGGA,43,5007069
yjbJ_predicted,1.25,43,19,CGAGATACAGCACGGGTCGC,24,5017653
yjbJ_predicted,1.3,44,19,CCAAAGTGTTTACAGGAGAT,25,5005865
yjbJ_predicted,0.1,20,19,CCAAAAGTTTGCATTACGTT,1,4994878
yjbJ_predicted,0.1,20,19,CAGACGGTACATCTCGACCC,1,5008892
yjbJ_predicted,2.1,60,19,CACGTTAACTCGGCACATAG,41,5022176
yjbJ_predicted,3.35,85,19,CACCGTTGATCCAACACATC,66,5013101
yjbJ_predicted,1.25,43,19,CAATACAATGCGGTTATGTA,24,5008205
yjbJ_predicted,4.85,115,19,AGCACGCGAACAATCAGTCT,96,5014286
yjbJ_predicted,2.0,58,19,AGCACCACGTTTTACTTTAC,39,5030198
yjbJ_predicted,2.75,73,19,ACTCCGCTTCTCGCTAGATT,54,5023415
yjbJ_predicted,2.55,69,19,ACTAGGGACATTTCGTTCCG,50,4998110
yjbJ_predicted,2.05,59,19,ACGGGAGGTCTGTGAATTCT,40,4997523
yjbJ_predicted,6.1,140,19,AATCCCTGGACAGCCGGTGA,121,5002355
yjbJ_predicted,1.55,49,19,AATATATCTAGGCACAGGTA,30,5000949
yjbJ_predicted,0.3,24,19,AAGCACGGACTTGTAACAAA,5,5027855
yjbJ_predicted,1.85,55,19,AACCTACTCTCGGGATCGCG,36,4998462
yjbJ_predicted,0.1,20,19,AACCAGACGGTCCCCCAGCA,1,5002601
yjbJ_predicted,1.3,44,19,AACATTAAAAGCTAGATATG,25,5015892
yjbJ_predicted,0.1,20,19,AAACTCAATACTAAAGGTAG,1,5013373
yjbJ_predicted,1.35,45,19,AAAAGATTGCCGTCGTTATT,26,4995497
yjbJ_predicted,2.5789473684210527,66,18,TTTACCTTTCGCTCAATGGC,48,4995547
yjbJ_predicted,0.10526315789473684,19,18,TTGGTTACCGCCGATGATTT,1,5006796
yjbJ_predicted,1.263157894736842,41,18,TTGAACGACGAAATTAAAAT,23,4999883
yjbJ_predicted,5.157894736842105,115,18,TGGCCATTGGTTACTTGAGG,97,5000034
yjbJ_predicted,2.8421052631578947,71,18,TCTAAAGACTCTCGAGGTCA,53,5019684
yjbJ_predicted,0.3684210526315789,24,18,TCGTGAACCCCGTATGAGAT,6,5008230
yjbJ_predicted,2.1578947368421053,58,18,TCGGACCGAGACTATCCGAC,40,5017447
yjbJ_predicted,2.8421052631578947,71,18,TCGCTACAATAGTTTGACCC,53,5007212
yjbJ_predicted,0.10526315789473684,19,18,TCAGTGAGTCCAGCGATAGT,1,5005543
yjbJ_predicted,0.10526315789473684,19,18,TATGTTCGTTGCATCATTAG,1,4996057
yjbJ_predicted,0.10526315789473684,19,18,TATGCTTGTTGCTGTCAAAG,1,5015371
yjbJ_predicted,3.8947368421052633,91,18,TAGCTCCGAGTGTAACAGGA,73,5016248
yjbJ_predicted,0.7894736842105263,32,18,GTAGGGCTAAGGTGCTAGGT,14,5001585
yjbJ_predicted,2.3157894736842106,61,18,GGGGCAAATCCTGTGCGGGG,43,5030480
yjbJ_predicted,3.8421052631578947,90,18,GGCCTTTGTATAAAAATTTA,72,5013120
yjbJ_predicted,0.10526315789473684,19,18,GCGGCGCATTGTAATCGGTA,1,5010342
yjbJ_predicted,0.8947368421052632,34,18,GCAAAATAGAGAAGCAGGCC,16,5007141
yjbJ_predicted,0.10526315789473684,19,18,GATCAGCGCATTGGTGTTCT,1,5000070
yjbJ_predicted,1.6842105263157894,49,18,GAATCAATCAAGTTTTTTCA,31,5010433
yjbJ_predicted,1.4736842105263157,45,18,GAAGGGCCAGGCCGGGGCGT,27,5007153
yjbJ_predicted,1.4210526315789473,44,18,GAAAACACTCGTTTTACCCA,26,5014022
yjbJ_predicted,1.6842105263157894,49,18,CTTGAATTTTTTGAAATAGT,31,4995893
yjbJ_predicted,1.7894736842105263,51,18,CTTCATGTTTGGTGATAGTT,33,4999954
yjbJ_predicted,11.263157894736842,231,18,CTCGCAAGCTCACCGGCACT,213,5009956
yjbJ_predicted,0.15789473684210525,20,18,CGTGCGATCGCCATCTCCTC,2,5000763
yjbJ_predicted,4.105263157894737,95,18,CGTATCGAGAGGCACCCGAT,77,5013710
yjbJ_predicted,1.3157894736842106,42,18,CGCCCGCTGATCAATAGAAA,24,5005913
yjbJ_predicted,1.8421052631578947,52,18,CCTTCACGTAGCCCATGCTT,34,4999924
yjbJ_predicted,2.526315789473684,65,18,CCGTAACCAATGAGTCCCTG,47,4999350
yjbJ_predicted,0.9473684210526315,35,18,CCACGGAATTACCTGTAGTC,17,4995175
yjbJ_predicted,1.5263157894736843,46,18,CATAGGCTGGCTCAACCATT,28,5003449
yjbJ_predicted,1.5789473684210527,47,18,CAGGCCGTAGGCAGCTCATC,29,5020599
yjbJ_predicted,1.7894736842105263,51,18,CACGGTAGACCTGAACAGCA,33,5004360
yjbJ_predicted,0.21052631578947367,21,18,ATCCTCGACAATATCTGGGG,3,5030184
yjbJ_predicted,0.10526315789473684,19,18,ATAGGCCGTCCGCACATTAA,1,5004847
yjbJ_predicted,1.368421052631579,43,18,ATAGATCTATAGGTCGGGCA,25,5013357
yjbJ_predicted,0.10526315789473684,19,18,AGGTTAGTGCTGGCGGCATG,1,5028183
yjbJ_predicted,4.105263157894737,95,18,AGGTTAGTGCACCGCTAAGA,77,4995158
yjbJ_predicted,1.9473684210526316,54,18,AGGGTGTTTAGTGGATTTAA,36,5004538
yjbJ_predicted,3.6315789473684212,86,18,AGGGCCGAGGTGTACAATCA,68,5025203
yjbJ_predicted,5.2631578947368425,117,18,AGCGCTTGAAAGCACCAGGC,99,5009563
yjbJ_predicted,2.210526315789474,59,18,ACTGAGGTGAAAGATGTAAG,41,5018596
yjbJ_predicted,2.0,55,18,ACGTCATGACTGACGTATTA,37,5017664
yjbJ_predicted,3.526315789473684,84,18,ACATGAGTTGTGCTGATGCA,66,5003087
yjbJ_predicted,1.8421052631578947,52,18,AACCGTTAGGACCGAACATT,34,5027053
yjbJ_predicted,2.1666666666666665,55,17,TTTGCGTGCTGGTATAGTCT,38,5026354
yjbJ_predicted,0.1111111111111111,18,17,TTTCGCGTGGGCATATGATC,1,5025638
yjbJ_predicted,2.888888888888889,68,17,TTGTGTTGATGCACCTAAAG,51,5018183
yjbJ_predicted,0.3333333333333333,22,17,TGTGGCGGTTCGCCAGTCAA,5,5020877
yjbJ_predicted,0.5555555555555556,26,17,TGGCCGTCGCTCAAATAGTA,9,5002789
yjbJ_predicted,0.1111111111111111,18,17,TGGATTCTAGTTTGAGTCAG,1,5028928
yjbJ_predicted,2.0555555555555554,53,17,TGAATAGCGACCTGAATATT,36,5024798
yjbJ_predicted,3.5555555555555554,80,17,TCCGAGCTCACAGGTATGTG,63,5012550
yjbJ_predicted,0.16666666666666666,19,17,TCAGTAGTAAATACGTGCTA,2,5023342
yjbJ_predicted,1.4444444444444444,42,17,TATCTCACGACAAAGCGCAA,25,4999582
yjbJ_predicted,2.388888888888889,59,17,TACCCAAGTACTCAACTATC,42,5007399
yjbJ_predicted,1.1666666666666667,37,17,TAAATGCTAGGAAAATTGAT,20,5005401
yjbJ_predicted,0.1111111111111111,18,17,GTTAAAATCCACAACCCGTT,1,4996105
yjbJ_predicted,0.16666666666666666,19,17,GTGGGGGGTAGCGTCAGCTC,2,4995047
yjbJ_predicted,0.1111111111111111,18,17,GTGGCTGAATGAAATCAACT,1,5009692
yjbJ_predicted,0.1111111111111111,18,17,GTAGCTGGTGATTCCAGTGA,1,5028487
yjbJ_predicted,0.1111111111111111,18,17,GTAACCCACACGCAGATGGG,1,4997050
yjbJ_predicted,2.8333333333333335,67,17,GGACCGCAGGGTGTCCGCTT,50,4997823
yjbJ_predicted,3.2777777777777777,75,17,GCGTGTGACTCAAAGACATA,58,5007561
yjbJ_predicted,1.3888888888888888,41,17,GCAAACTCGGCCATACCGAT,24,5010609
yjbJ_predicted,2.0,52,17,GAGACTTGTCTGTTGATCAT,35,5017086
yjbJ_predicted,2.5,61,17,GAGACGTCGTTCACTGTTAA,44,5019897
yjbJ_predicted,6.444444444444445,132,17,GACGGACGGTTTCTATTCCT,115,5019242
yjbJ_predicted,0.1111111111111111,18,17,CTTTTTGGTCTTGGAGACGC,1,5022797
yjbJ_predicted,0.16666666666666666,19,17,CTTTGGATAAAAGGATCCAC,2,5018122
yjbJ_predicted,0.2777777777777778,21,17,CTCAGATTGAATATATTGCC,4,5019474
yjbJ_predicted,1.7777777777777777,48,17,CTAATCTATTCTCTCCAATG,31,5009905
yjbJ_predicted,0.2222222222222222,20,17,CCTTTATCTTCCGTAGTCTT,3,4999724
yjbJ_predicted,7.166666666666667,145,17,CCTTGAAGGAGGTACGCGTA,128,5011406
yjbJ_predicted,1.0555555555555556,35,17,CCCCACCGAGAGGCGCAGGG,18,5014469
yjbJ_predicted,0.1111111111111111,18,17,CCACTCTATGATGCTGCATC,1,5013660
yjbJ_predicted,0.1111111111111111,18,17,CCAAAGTGGATATGAACGTG,1,5001477
yjbJ_predicted,2.5555555555555554,62,17,CAGGGGAGAAGGTATGGGCA,45,5023179
yjbJ_predicted,0.1111111111111111,18,17,CAGAGCGGACCACCTCGAGT,1,5015428
yjbJ_predicted,2.888888888888889,68,17,CAATCTCATGTAGGTGCCTT,51,5024509
yjbJ_predicted,1.5555555555555556,44,17,ATTTGCGCGGCAGTAGAACT,27,5018991
yjbJ_predicted,3.8333333333333335,85,17,ATACTACAAACTGAGGCTGG,68,5024799
yjbJ_predicted,5.222222222222222,110,17,AGTTGACATGCGCCTGGTTG,93,5010584
yjbJ_predicted,1.8333333333333333,49,17,AGGTTGAACATGGGACCCAT,32,4995170
yjbJ_predicted,1.9444444444444444,51,17,AGGTGCCGGCTATCCCTTAT,34,5019939
yjbJ_predicted,3.5555555555555554,80,17,ACGTTTTGTTTCGAGAGACA,63,5024707
yjbJ_predicted,0.1111111111111111,18,17,ACGGCGAACCCCGGCTTGCC,1,5025679
yjbJ_predicted,1.8888888888888888,50,17,ACCGGGGGCGGTCACAAGAA,33,5028901
yjbJ_predicted,2.6666666666666665,64,17,AATCGCCTATTGTTGTTCTA,47,5019209
yjbJ_predicted,0.2222222222222222,20,17,AAGTGGCTCTGGCTGCATCA,3,5004515
yjbJ_predicted,2.7058823529411766,61,16,TTTTATCAGAATATTTTGCT,45,5017140
yjbJ_predicted,2.176470588235294,52,16,TTTGACACCGTCAGCGAAGG,36,5021835
yjbJ_predicted,0.7647058823529411,28,16,TTTAGATTCGGCGGAGTGCG,12,5029624
yjbJ_predicted,3.7058823529411766,78,16,TTGGGTACCTTTCACCGATG,62,5011144
yjbJ_predicted,1.411764705882353,39,16,TTGAATGCAAGCGGTAAGCT,23,5005780
yjbJ_predicted,2.1176470588235294,51,16,TGTCCTTTTAACTGGGTTAG,35,5024877
yjbJ_predicted,1.588235294117647,42,16,TGGGCGCACAACCCCTCAAT,26,5007202
yjbJ_predicted,0.8235294117647058,29,16,TGGGATATCACCCTTATTAA,13,5017310
yjbJ_predicted,1.588235294117647,42,16,TCTCGCCTGGCCAGATCTCG,26,5000414
yjbJ_predicted,0.17647058823529413,18,16,TCTCATCAGCAACCCAAAGC,2,5027301
yjbJ_predicted,2.4705882352941178,57,16,TCGCAAACTGCCAGTATAAA,41,5027945
yjbJ_predicted,0.11764705882352941,17,16,TCCGTGATGCAAAAGCATAT,1,4996208
yjbJ_predicted,0.11764705882352941,17,16,TATGCCGAGAGGGCGCCGTA,1,4996420
yjbJ_predicted,3.2941176470588234,71,16,TACGGTAATCGGTTATCGCG,55,5009434
yjbJ_predicted,1.8235294117647058,46,16,TAATTTAGAGCGCCTCTGAA,30,5003230
yjbJ_predicted,3.411764705882353,73,16,GTTTGAAGACATCGCACTTT,57,5025353
yjbJ_predicted,0.11764705882352941,17,16,GTGGAAAAGGGCTTTCGCTA,1,5003799
yjbJ_predicted,0.11764705882352941,17,16,GTCCGATTGCCTTGCACGGT,1,4997626
yjbJ_predicted,1.6470588235294117,43,16,GGTCGGGTGAGAAAAATCAG,27,4997990
yjbJ_predicted,0.17647058823529413,18,16,GGTCAGAGCGGAGTTACACG,2,4998181
yjbJ_predicted,2.5294117647058822,58,16,GGGGTTCAGGGATGCCGGTA,42,5005346
yjbJ_predicted,0.17647058823529413,18,16,GCATTATGTATACTCAACGT,2,5010527
yjbJ_predicted,1.6470588235294117,43,16,GAGCCCGTTCGTCGGAAAAG,27,5011717
yjbJ_predicted,2.235294117647059,53,16,GAGAGCCCTTAAGATAAGAT,37,5013330
yjbJ_predicted,0.11764705882352941,17,16,GACTGAAAACGAGACCATTA,1,5009754
yjbJ_predicted,0.11764705882352941,17,16,GAATCGATGCCTAGCCATTT,1,4999649
yjbJ_predicted,0.11764705882352941,17,16,GAAACGGATGACGGTGAGCG,1,5003167
yjbJ_predicted,0.11764705882352941,17,16,CTGTAAGAGATCTAGGTATA,1,5023409
yjbJ_predicted,0.7058823529411765,27,16,CTCATAAGGATTTCTAAAAT,11,4998313
yjbJ_predicted,9.823529411764707,182,16,CTCAAGTAGCCGTATGGTGT,166,4997454
yjbJ_predicted,1.588235294117647,42,16,CTACGGATCCCCGTGAGGGT,26,4996170
yjbJ_predicted,2.2941176470588234,54,16,CGGCGGAAATCTCGTCTATA,38,5004537
yjbJ_predicted,4.470588235294118,91,16,CCTCGGCGACATACAGGTGT,75,5002147
yjbJ_predicted,2.5294117647058822,58,16,CCTCGATGTCATCCCTGAAG,42,5026176
yjbJ_predicted,2.764705882352941,62,16,CCGGTGAATAGTTGAACTGC,46,5023366
yjbJ_predicted,4.588235294117647,93,16,CCAACAAGACGCAGGGATAT,77,5013674
yjbJ_predicted,0.11764705882352941,17,16,CATTGCCGCTCTCTTAGATC,1,4997384
yjbJ_predicted,0.23529411764705882,19,16,CACAGTTTTTTATGGATGAT,3,5020351
yjbJ_predicted,1.7058823529411764,44,16,CAAATAAAGAGTCATCCAAC,28,5006244
yjbJ_predicted,2.8823529411764706,64,16,ATTACGCTGACGCTATATGC,48,4995229
yjbJ_predicted,2.235294117647059,53,16,ATGCTGGCTAATTACCCCCT,37,5020804
yjbJ_predicted,2.5294117647058822,58,16,ATCGTTGTTGCCTTTTAGAT,42,5015624
yjbJ_predicted,0.11764705882352941,17,16,ATCCTGGGAAAGGGCTGACC,1,5005894
yjbJ_predicted,3.235294117647059,70,16,ATAGGAGGAGTTAGATAATA,54,5029564
yjbJ_predicted,2.823529411764706,63,16,AGTTGTCATCGATCCCAGAA,47,5026351
yjbJ_predicted,0.11764705882352941,17,16,AGTTCCGTGCTCGCTCGTTG,1,5001902
yjbJ_predicted,3.0,66,16,AGGACGCCCGTATTCTTGTG,50,5000819
yjbJ_predicted,0.11764705882352941,17,16,AGCCGGTTATATATGCCAAT,1,5004107
yjbJ_predicted,0.8235294117647058,29,16,AGCATTTAGGGTTGTCTAAA,13,5018268
yjbJ_predicted,0.17647058823529413,18,16,AGATTACCGCGAAAACTACG,2,5016075
yjbJ_predicted,2.9411764705882355,65,16,ACTCAACTTTTACTCGTATC,49,4997358
yjbJ_predicted,0.11764705882352941,17,16,ACGGGTAGGTTACTATGCTG,1,5026633
yjbJ_predicted,2.823529411764706,63,16,ACGGGCCGGTGGAACGCTTA,47,4995424
yjbJ_predicted,5.235294117647059,104,16,ACGATTATATTACCCTCGCT,88,4995948
yjbJ_predicted,3.176470588235294,69,16,ACCGGTAACTGGACGGGACA,53,5030111
yjbJ_predicted,0.11764705882352941,17,16,ACCCCCAGTGCGCAGGCCGT,1,5013458
yjbJ_predicted,2.8823529411764706,64,16,ACAGTTGCACTAGAGCTCAA,48,5015247
yjbJ_predicted,9.235294117647058,172,16,AAGTGATAATAGCCCTCAGA,156,4998300
yjbJ_predicted,1.7058823529411764,44,16,AAGGATTCCTTGGTTATATT,28,5010250
yjbJ_predicted,0.4117647058823529,22,16,AACTCCTGGGTAGTATGTCT,6,5012366
yjbJ_predicted,2.176470588235294,52,16,AACGGGTAAATCAGGCTTTA,36,5017508
yjbJ_predicted,1.8823529411764706,47,16,AAAACATGAACGTCCCGCTT,31,5005911
yjbJ_predicted,1.25,34,15,TTTGATAGAACGATCATCTC,19,5028481
yjbJ_predicted,0.125,16,15,TTTCGGGCGGCGTTCAGCCT,1,4998107
yjbJ_predicted,0.125,16,15,TTCATTTTATACCCTGTCCC,1,5013053
yjbJ_predicted,4.3125,83,15,TTATCCATCTTACATGTATA,68,5004087
yjbJ_predicted,3.3125,67,15,TTAGGTAATGCGCTTGTTAA,52,5008696
yjbJ_predicted,1.75,42,15,TGTAACCGGTTCTGGTTAAA,27,5003647
yjbJ_predicted,0.25,18,15,TGCTGGCCAGGCGGCACGCA,3,4997247
yjbJ_predicted,2.25,50,15,TGCATCGACTGATACTAGAC,35,5029876
yjbJ_predicted,2.0625,47,15,TGACCCCTCACACCGTGAAT,32,5025966
yjbJ_predicted,0.1875,17,15,TCGTCGCTTTATAAGGTGTC,2,5004912
yjbJ_predicted,2.875,60,15,TCGGCAACTAAGGCATGAGT,45,5018160
yjbJ_predicted,1.375,36,15,TCGGAACTACCCCGGTAGAC,21,4997692
yjbJ_predicted,3.0,62,15,TCGCTGACGTAGTTCGCTCC,47,5024281
yjbJ_predicted,2.6875,57,15,TCAACGTTCACGTGGGTTTA,42,5017942
yjbJ_predicted,8.75,154,15,TAGTGTCAGATGGAACGTTT,139,5010338
yjbJ_predicted,2.875,60,15,TAGGAGAAATGATTTGACTG,45,5017782
yjbJ_predicted,0.125,16,15,TAAGTAAGCCGCATATACCG,1,5022074
yjbJ_predicted,2.1875,49,15,TAAAGATGGCCTCTTCAACG,34,5000765
yjbJ_predicted,2.75,58,15,TAAAATGGATCTTGCTCCTC,43,5017018
yjbJ_predicted,0.875,28,15,GTCCTTGGTCTAGCAATAAT,13,5026291
yjbJ_predicted,0.125,16,15,GTCCTAAATCGACTAATCGA,1,5014344
yjbJ_predicted,3.0,62,15,GTCCAAGGTACGATTCTCGT,47,5023317
yjbJ_predicted,3.6875,73,15,GTAGTCCCCAACGGGTTGAG,58,5018707
yjbJ_predicted,2.6875,57,15,GTAATTCGTGCCGTCAATGT,42,5020465
yjbJ_predicted,2.25,50,15,GGTTTCATTGGGTTTCCCGT,35,5010080
yjbJ_predicted,2.9375,61,15,GGGTTCGCGCCGGGTGGTGA,46,4998179
yjbJ_predicted,3.125,64,15,GGGGGGTGTATATACGATGA,49,4999957
yjbJ_predicted,2.25,50,15,GGGGGAGTGCGGACAAAGAG,35,4998952
yjbJ_predicted,0.125,16,15,GGGCGCATCTGCGAATTCCT,1,5021769
yjbJ_predicted,3.3125,67,15,GGGCCTTCGTGGTATCTGAC,52,4995768
yjbJ_predicted,0.125,16,15,GGGCAACCGATCCACTGCGC,1,5014074
yjbJ_predicted,0.125,16,15,GGAGCAGGGCGTTGAAACAT,1,5007111
yjbJ_predicted,0.125,16,15,GGACCGTAGATGAGATAATA,1,5028412
yjbJ_predicted,2.5625,55,15,GCGGTTGAACCCTTAGGCAT,40,4995514
yjbJ_predicted,1.5625,39,15,GCAACGTCAGGGACGCAAAT,24,5012107
yjbJ_predicted,2.0625,47,15,GCAAATGGTACTTGGGAACT,32,5002680
yjbJ_predicted,0.5625,23,15,GATCTTCGTTAGGCCAGAAC,8,5016637
yjbJ_predicted,3.25,66,15,GATACTCTTGCTATCGCAGT,51,5001266
yjbJ_predicted,2.1875,49,15,GAGTTGCGCATTTTTGCACT,34,5004387
yjbJ_predicted,0.1875,17,15,GAGCCGGATGGTAGATGACT,2,4995855
yjbJ_predicted,1.875,44,15,CTTGATCCCGGTATCCAAGA,29,5001923
yjbJ_predicted,4.5,86,15,CTGGAACTATATGGATTTTA,71,5009861
yjbJ_predicted,2.9375,61,15,CTGCAGAACGACTGTTAGGT,46,5020896
yjbJ_predicted,0.125,16,15,CTGAGCATCCTGGGCTTAGA,1,5012200
yjbJ_predicted,2.75,58,15,CGTTGGTATTGAGAGTCTAA,43,5004835
yjbJ_predicted,1.6875,41,15,CGCGACCTCGGAGCTCTAAA,26,5023043
yjbJ_predicted,7.625,136,15,CGCAACTAAAATTGATTCGT,121,5003193
yjbJ_predicted,1.5,38,15,CGATTGTTTCGGACGGTATG,23,5009231
yjbJ_predicted,2.3125,51,15,CCCAGTTGTTCAACGGCAAC,36,5028567
yjbJ_predicted,2.375,52,15,CCACATTGGTCGCTATTGCT,37,4998592
yjbJ_predicted,4.5625,87,15,CATGTGTATAACCGCTATCT,72,5028913
yjbJ_predicted,1.0625,31,15,CAGTGAGTCGGAATACTGTC,16,5005327
yjbJ_predicted,0.125,16,15,CAGCGGGCGTGCAGTACGCG,1,5001521
yjbJ_predicted,0.125,16,15,CAATCGTGGCGCCTAGCGAA,1,5012569
yjbJ_predicted,0.125,16,15,ATGAAGAGCAGTACGAGACA,1,5007844
yjbJ_predicted,4.1875,81,15,ATCGTTCCTTGGGGAAATCG,66,5002170
yjbJ_predicted,0.125,16,15,ATCGGGACCTATAAGCACCT,1,5000644
yjbJ_predicted,4.9375,93,15,ATCGGAACCTCATGTCCTAA,78,5025833
yjbJ_predicted,0.1875,17,15,ATCACCATTTGAACGTTGAT,2,5019021
yjbJ_predicted,3.375,68,15,ATCAAGACCCTCTGGTAAAG,53,4999831
yjbJ_predicted,1.875,44,15,ATAATAGGGATAAACCACTC,29,4997517
yjbJ_predicted,1.8125,43,15,AGGGGGGGCCGTAAGGCGAT,28,5016851
yjbJ_predicted,4.3125,83,15,AGCCCCTCTCCATTCCGGTA,68,5009915
yjbJ_predicted,0.125,16,15,AGAAAGTCTGGTTGGTTATT,1,5019803
yjbJ_predicted,4.625,88,15,ACGGCTTAGGCGCCGGACCG,73,5010809
yjbJ_predicted,1.5,38,15,ACGACCGGCTGTCTTTAAAC,23,5004044
yjbJ_predicted,3.125,64,15,ACATGCAATATGCGGTTGCA,49,4998348
yjbJ_predicted,1.75,42,15,ACAGGTCCCGGGAGGAACAA,27,5015974
yjbJ_predicted,0.125,16,15,AATTGAGCGTATGGCCAAGG,1,5005171
yjbJ_predicted,4.625,88,15,AAGTTGCTTATGGGACCACT,73,5001170
yjbJ_predicted,3.3125,67,15,AAGATGGACCTCGTTATAAC,52,5012318
yjbJ_predicted,2.8125,59,15,AAGAGAATGATAGTCAAGTT,44,5008275
yjbJ_predicted,0.125,16,15,AACCATGGCTTTTAATCAAT,1,5011974
yjbJ_predicted,2.5,54,15,AAAGTTATAGTACGTCACCA,39,5024524
yjbJ_predicted,1.0,30,15,AAAGGTCCCCTCGAAGATAC,15,5005371
yjbJ_predicted,3.7333333333333334,69,14,TTGGAAGTCCGTGGGGTGTT,55,5016933
yjbJ_predicted,1.6,37,14,TTGCTTCCCCAAGTCTCTAG,23,5021253
yjbJ_predicted,0.13333333333333333,15,14,TTCTGCATTCACATAGGGAA,1,5010108
yjbJ_predicted,3.2666666666666666,62,14,TTACAGTTTTTATTCCACTC,48,5023963
yjbJ_predicted,0.8666666666666667,26,14,TGTTAATCGGCTAAAGACGG,12,5008874
yjbJ_predicted,7.266666666666667,122,14,TGGCAATTATCCCGCTCTAT,108,4998950
yjbJ_predicted,0.2,16,14,TGAATGGACCTTGTATTTAT,2,5005986
yjbJ_predicted,0.13333333333333333,15,14,TGAATGGACCTTACATGAAA,1,5022911
yjbJ_predicted,2.8666666666666667,56,14,TCTGACCAATGTTCAGGTCG,42,5026504
yjbJ_predicted,6.6,112,14,TCCTAAATATTAAACGCTAA,98,5018449
yjbJ_predicted,9.266666666666667,152,14,TCCCATCGGATAAAGTGATA,138,5006714
yjbJ_predicted,3.533333333333333,66,14,TACCGGGCGGAGCAAGAGCA,52,5014392
yjbJ_predicted,3.1333333333333333,60,14,GTTGTGGCACTAAATGGGCA,46,5020939
yjbJ_predicted,2.7333333333333334,54,14,GTGGGTCGAATCATGTATGG,40,5004724
yjbJ_predicted,3.3333333333333335,63,14,GTGGACGTAGGTCTTACTAT,49,5029878
yjbJ_predicted,0.13333333333333333,15,14,GGTACGGTATCATTGCAACC,1,5002610
yjbJ_predicted,2.4,49,14,GGTAACACGATCGCTGTTTG,35,5008079
yjbJ_predicted,0.13333333333333333,15,14,GGGGGGGTGCGATCCGGGGT,1,5024921
yjbJ_predicted,6.0,103,14,GGCGCTCCGGACTAAAAGTT,89,4997711
yjbJ_predicted,1.4666666666666666,35,14,GGCGCGTTAGTCAGTAACGT,21,5024225
yjbJ_predicted,3.8666666666666667,71,14,GGCCCTCGCTCAGACCTAGG,57,4999634
yjbJ_predicted,2.466666666666667,50,14,GGATACACTATTTCACTCGT,36,5010727
yjbJ_predicted,5.133333333333334,90,14,GCTGTAAGGTTACCTGTCAG,76,5030778
yjbJ_predicted,3.466666666666667,65,14,GCATCTAGGTATAAAAAAGT,51,5004004
yjbJ_predicted,0.13333333333333333,15,14,GCAGGACCCTGCGACGGATG,1,5001559
yjbJ_predicted,2.1333333333333333,45,14,GCACATAGGGGTCTACGGCG,31,5012087
yjbJ_predicted,0.13333333333333333,15,14,GAGCACATCAGAGCGGTCAA,1,5020754
yjbJ_predicted,2.6,52,14,CTGGAACTCCGTTCATCGGA,38,5016151
yjbJ_predicted,0.8666666666666667,26,14,CTCCGTATTCGCGGAATTGT,12,5014538
yjbJ_predicted,0.13333333333333333,15,14,CGTCGTCAGCAGGTTTAATG,1,5023098
yjbJ_predicted,0.13333333333333333,15,14,CGTAGCAGTATATCCTCGGG,1,5001437
yjbJ_predicted,3.6666666666666665,68,14,CGGGATCTGTGCGGAGGCTC,54,5025784
yjbJ_predicted,2.933333333333333,57,14,CGGAGACAGTCTCAGCTGCA,43,5018200
yjbJ_predicted,1.5333333333333334,36,14,CCACCTAGAGGTAACTCGAA,22,5009386
yjbJ_predicted,1.2,31,14,CATACTATATCGCATCAAAT,17,5018227
yjbJ_predicted,2.0,43,14,CAGGACCCATGTGATGCTAT,29,5017377
yjbJ_predicted,2.8666666666666667,56,14,CAGATTCATTTTTTGTATGC,42,4999065
yjbJ_predicted,0.3333333333333333,18,14,CAATACACCTAGGGAACGAG,4,4999919
yjbJ_predicted,2.0,43,14,CAACAGGTTGTTTTATGGTT,29,5014081
yjbJ_predicted,2.0,43,14,ATTCTAACGGTGGGGATTCA,29,5003359
yjbJ_predicted,2.466666666666667,50,14,ATTCAGGAAAGTCCCGCCTT,36,5029830
yjbJ_predicted,0.13333333333333333,15,14,ATGGAATATAAAACACATCT,1,5019892
yjbJ_predicted,0.2,16,14,ATGAAACGTGATTTTTTGCA,2,5018086
yjbJ_predicted,4.0,73,14,AGTATATTGAGATACCGGGA,59,5013916
yjbJ_predicted,0.13333333333333333,15,14,AGGCGGACTGCGTGCCCCGG,1,5027419
yjbJ_predicted,0.4666666666666667,20,14,AGATTGATAGGGCGCCCCTC,6,5005778
yjbJ_predicted,13.133333333333333,210,14,AGATCGAGGCAGCGTCACGT,196,5003492
yjbJ_predicted,0.13333333333333333,15,14,AGAACGTTTGTGATCAGTGC,1,5014937
yjbJ_predicted,1.8,40,14,ACGCAAATGGGTTTGCCCGT,26,5019014
yjbJ_predicted,2.466666666666667,50,14,ACCGAGATATGCGCCCTAGC,36,5000481
yjbJ_predicted,2.4,49,14,AATTTACTCGGTACCACAGT,35,4999275
yjbJ_predicted,1.8,40,14,AAGCTCAAAGGCAACCCTTT,26,5007941
yjbJ_predicted,3.8666666666666667,71,14,AAGCGTTTTGCATTAACATG,57,5021090
yjbJ_predicted,3.2,61,14,AACTCGTCAGTCCGCCTGAA,47,5025177
yjbJ_predicted,3.0714285714285716,55,13,TTTTGCGTTGTCATTCATCG,42,5023318
yjbJ_predicted,0.14285714285714285,14,13,TTGTGTCAAGACAATTTGTC,1,5004723
yjbJ_predicted,0.7857142857142857,23,13,TTGCCTTTCAAACCTTGTCA,10,5017973
yjbJ_predicted,2.2142857142857144,43,13,TTCTCACCCAGAGCGCTTGC,30,4995048
yjbJ_predicted,2.7857142857142856,51,13,TTCGGATAAGATAGGGAATT,38,5004135
yjbJ_predicted,0.2857142857142857,16,13,TTCAACGCAGTACTCTCATG,3,5006583
yjbJ_predicted,0.14285714285714285,14,13,TTATAACCCTGTCTAAGCGT,1,5004398
yjbJ_predicted,0.9285714285714286,25,13,TTAATGGGAGATTCGCGCAG,12,5004762
yjbJ_predicted,4.785714285714286,79,13,TGTTGCGACTCGTCCGCAGC,66,5006031
yjbJ_predicted,1.0,26,13,TGGTTAAAGCGTAGCTCCCT,13,4998655
yjbJ_predicted,3.2857142857142856,58,13,TGGCTATATTCCTTGGATTA,45,5022431
yjbJ_predicted,0.8571428571428571,24,13,TGCTCCGGCGTCAATTACCC,11,5027337
yjbJ_predicted,3.9285714285714284,67,13,TGCCGTGTCGATCATAAGAG,54,5004986
yjbJ_predicted,0.35714285714285715,17,13,TGCAAGCCCAGCACTGGGCT,4,5010102
yjbJ_predicted,3.5714285714285716,62,13,TCCGGTTCCGGCACCTTGGT,49,5026136
yjbJ_predicted,4.071428571428571,69,13,TCACGCAAGCGAACGTACTT,56,5011057
yjbJ_predicted,0.14285714285714285,14,13,TAGATCACGTGCGGAACAGA,1,5003745
yjbJ_predicted,1.5714285714285714,34,13,TAATTTACTTTAATGCGTTC,21,5007888
yjbJ_predicted,3.142857142857143,56,13,TAATGTGGAGCGGTAGGGCG,43,5008589
yjbJ_predicted,2.9285714285714284,53,13,TAAAGATATCCACTACGAGA,40,5019690
yjbJ_predicted,3.642857142857143,63,13,GTCGGGTCGCGTTATTTGTA,50,5016532
yjbJ_predicted,3.5714285714285716,62,13,GTAAGGAGGATAAGAGAGAT,49,5022296
yjbJ_predicted,4.571428571428571,76,13,GGTAGGTTAGCGCGACCACA,63,5022621
yjbJ_predicted,1.5714285714285714,34,13,GGGCCAGGAGCCGCGTTCAT,21,4999469
yjbJ_predicted,0.14285714285714285,14,13,GGCGAGGAATTTACTGACTG,1,5030151
yjbJ_predicted,3.0,54,13,GGCCGCTCTTTCTACGAGGT,41,5010761
yjbJ_predicted,3.7857142857142856,65,13,GCTTTTATAAGGGGGCACAA,52,5019259
yjbJ_predicted,1.5714285714285714,34,13,GCTCAGCTAGTATTATTCGG,21,4996038
yjbJ_predicted,1.9285714285714286,39,13,GCCGCAAATTTTCCTACCGC,26,5016458
yjbJ_predicted,0.14285714285714285,14,13,GCCCCGGGCTAAAGCCGCGC,1,5022462
yjbJ_predicted,3.9285714285714284,67,13,GCATTCAACGTCAACGTTGC,54,5020175
yjbJ_predicted,4.285714285714286,72,13,GATGGCAATGATATTAATAT,59,5018570
yjbJ_predicted,6.714285714285714,106,13,GATGAATCAATGGCTCCCCC,93,4995172
yjbJ_predicted,0.2857142857142857,16,13,GAGGTGTAGAGTCCCGTTTC,3,5008228
yjbJ_predicted,10.642857142857142,161,13,GACCTAGAACTTCCATACGC,148,5025449
yjbJ_predicted,0.14285714285714285,14,13,GAAGTCACATGGTCCTGATG,1,4997742
yjbJ_predicted,4.0,68,13,CTTGTATATAAAGAGAGGGG,55,5026433
yjbJ_predicted,3.142857142857143,56,13,CTGCACGTTAGATTCCATAA,43,5000946
yjbJ_predicted,0.21428571428571427,15,13,CTCTAAAACAGTGCTCGACC,2,5012827
yjbJ_predicted,5.071428571428571,83,13,CTAATGCTGAGTTGCGCCAC,70,5003547
yjbJ_predicted,1.6428571428571428,35,13,CGGTCTAGTCTACACTGGAG,22,5016856
yjbJ_predicted,0.14285714285714285,14,13,CGCTGACAGGTAACAAATGA,1,5020731
yjbJ_predicted,0.14285714285714285,14,13,CCAAGATTAGTGTGCTCGGT,1,5005251
yjbJ_predicted,3.5,61,13,CAAACAAACAGCTTCTTGCA,48,5013635
yjbJ_predicted,3.357142857142857,59,13,ATGGACAGTGCGGCTGGGTA,46,5025932
yjbJ_predicted,3.0,54,13,ATAGTTGAATGGTGCCAAGG,41,5024611
yjbJ_predicted,1.8571428571428572,38,13,ATACGTATAACTAATGGTAT,25,5011764
yjbJ_predicted,3.357142857142857,59,13,AGTTGTGGAAACGGAAAATT,46,5012416
yjbJ_predicted,7.285714285714286,114,13,AGTGTGGAGCTCATGCTGGT,101,5003140
yjbJ_predicted,4.071428571428571,69,13,AGTCTTTGGGCTTCAACGTT,56,5009596
yjbJ_predicted,0.14285714285714285,14,13,AGATTTACGGAACGACTACA,1,5021349
yjbJ_predicted,4.071428571428571,69,13,AGATGTCGATTACATGAGTC,56,5007018
yjbJ_predicted,3.2142857142857144,57,13,AGAAGTAAGACAATGTTATT,44,5003363
yjbJ_predicted,0.21428571428571427,15,13,ACGGGTCGTGTACTTGCAGA,2,5029482
yjbJ_predicted,0.14285714285714285,14,13,ACGCGCAGCACGAGCTCAAG,1,5026993
yjbJ_predicted,3.5,61,13,ACAGGTCGAGGGAAGCAGTG,48,5004302
yjbJ_predicted,0.14285714285714285,14,13,AATTTAGGGTCGTTTCGCAT,1,5028170
yjbJ_predicted,0.14285714285714285,14,13,AATCTCCTCTACAATAAGAT,1,5010079
yjbJ_predicted,1.9285714285714286,39,13,AATAGATCCCTAGCAGTCCA,26,5013119
yjbJ_predicted,2.642857142857143,49,13,AAGTATGAGGATAAACGGGA,36,5004662
yjbJ_predicted,0.21428571428571427,15,13,AAGGGACGGGACCTAAGTTT,2,5030923
yjbJ_predicted,1.7142857142857142,36,13,AACGGTGGTAACCGCACTGG,23,4996504
yjbJ_predicted,2.3846153846153846,42,12,TTTAAGGTGGCTGGGGAGTG,30,5026541
yjbJ_predicted,0.15384615384615385,13,12,TTGGTTATATCTGTTCGGTG,1,5019630
yjbJ_predicted,8.076923076923077,116,12,TTGGCAGTTATCCGGATTAA,104,5018429
yjbJ_predicted,2.1538461538461537,39,12,TTGAACCGACAAAAATATCA,27,5024613
yjbJ_predicted,2.8461538461538463,48,12,TTCTATTCGCCGGTAAAAGT,36,5029035
yjbJ_predicted,0.15384615384615385,13,12,TTAATGTTTGTTGGTCATTG,1,5026589
yjbJ_predicted,0.23076923076923078,14,12,TGTCGGCTAACTTTTCCATG,2,5006585
yjbJ_predicted,8.307692307692308,119,12,TGTACCGGACCGTTCCACTT,107,5025023
yjbJ_predicted,2.6153846153846154,45,12,TGGGCAAGAATTTGGCTCAT,33,5007140
yjbJ_predicted,4.0,63,12,TGAGTTTCGTCTGAGAAGTG,51,5016571
yjbJ_predicted,2.5384615384615383,44,12,TGACCAGAAGGCGCCGATGG,32,5014223
yjbJ_predicted,4.153846153846154,65,12,TGAATCTTAACAAACACTTG,53,5016354
yjbJ_predicted,5.615384615384615,84,12,TGAATACCTCCTTACTGTCT,72,5027817
yjbJ_predicted,0.23076923076923078,14,12,TCTTCCGGATGTTGGACCGG,2,5011298
yjbJ_predicted,0.15384615384615385,13,12,TCTTAGAATAGAGCCGGCGT,1,5008047
yjbJ_predicted,1.5384615384615385,31,12,TCTGGGTCTTTGTGCCCAAT,19,5015998
yjbJ_predicted,3.076923076923077,51,12,TCTAAAGTTAAGAAGTTTAT,39,5010918
yjbJ_predicted,0.15384615384615385,13,12,TCCGGCCAAGCTATGGCGTG,1,5025085
yjbJ_predicted,2.769230769230769,47,12,TCCATCGGGGAAACATATGA,35,5021272
yjbJ_predicted,0.15384615384615385,13,12,TCACACGCTGAATCCTCCAG,1,4998443
yjbJ_predicted,0.15384615384615385,13,12,TATTTTCAGCACCTATTCTA,1,5008725
yjbJ_predicted,1.3846153846153846,29,12,TATGCACCGCATGCCAGAAA,17,5001694
yjbJ_predicted,3.3846153846153846,55,12,TAGGTATTTGTAAGCGAGAA,43,5000695
yjbJ_predicted,0.15384615384615385,13,12,TAGGATTAACCCCTGCAAAG,1,5018599
yjbJ_predicted,4.461538461538462,69,12,TAGAGGGCCGGGTCCTGCTG,57,5014747
yjbJ_predicted,0.15384615384615385,13,12,TACCCCTGCGGCAGTTTAAC,1,5006778
yjbJ_predicted,3.769230769230769,60,12,TACATTATACTCTCGTCTGC,48,4997385
yjbJ_predicted,2.5384615384615383,44,12,TAAAAGCTTCACCGCGACGT,32,5024417
yjbJ_predicted,8.538461538461538,122,12,GTGGATTGAGAAGCGAGATT,110,5008143
yjbJ_predicted,9.615384615384615,136,12,GTCCTGGTCCCCAAAGATTC,124,5019284
yjbJ_predicted,0.3076923076923077,15,12,GTATTCAGGGACCACTCAAA,3,4995198
yjbJ_predicted,0.15384615384615385,13,12,GTATATTACGCGTGTTTACT,1,5016719
yjbJ_predicted,3.4615384615384617,56,12,GTAGGGACGGGCGTATTTAG,44,5012920
yjbJ_predicted,7.461538461538462,108,12,GGTCTGTAAAGCCGTTTGCA,96,4997004
yjbJ_predicted,4.153846153846154,65,12,GGTAAAAGCGCATCTAAGTG,53,4996713
yjbJ_predicted,0.15384615384615385,13,12,GGGGCCTCCATTTGCGTGTA,1,5006481
yjbJ_predicted,2.6153846153846154,45,12,GGGCACCGTGACTCATGCGT,33,5027762
yjbJ_predicted,4.0,63,12,GGAATAGGGTCAAAATGGAT,51,5014385
yjbJ_predicted,3.0,50,12,GCTTGTGTATTCCCAACCGA,38,5007893
yjbJ_predicted,0.15384615384615385,13,12,GCTGACACTCAAGGGTGCGA,1,4996623
yjbJ_predicted,1.0,24,12,GCCGTTGTCAGTGGGCAAAT,12,5019680
yjbJ_predicted,2.076923076923077,38,12,GAGCTGTGCGAGTGAACTAT,26,5027698
yjbJ_predicted,12.076923076923077,168,12,GAGCCGCGGCTAGTGTGCAA,156,5005252
yjbJ_predicted,0.15384615384615385,13,12,GAGCACGTTGGACGTTGCCA,1,5003717
yjbJ_predicted,2.0,37,12,GAATCGCAGACTTAGGACCG,25,5008454
yjbJ_predicted,0.23076923076923078,14,12,GAAAATACGGTACTGGAATG,2,5019036
yjbJ_predicted,1.5384615384615385,31,12,CTTGGCCTGGTCGCTAGTTC,19,5002398
yjbJ_predicted,0.15384615384615385,13,12,CTGATTAGGGGGTTTTCACA,1,5008720
yjbJ_predicted,3.3076923076923075,54,12,CTCGCCGGCACGGCTATAGC,42,5019107
yjbJ_predicted,3.0,50,12,CTAGGGTTAACACGAACGGT,38,5002127
yjbJ_predicted,3.5384615384615383,57,12,CTAGATCCAGTAAGATTTAT,45,5004216
yjbJ_predicted,0.15384615384615385,13,12,CTAGAGAGAGGAAACAAATT,1,4995848
yjbJ_predicted,3.4615384615384617,56,12,CGGGTCGCGATCGATGCTAA,44,5009353
yjbJ_predicted,2.076923076923077,38,12,CGGGGTTGTGGGTGATATGC,26,5026927
yjbJ_predicted,1.8461538461538463,35,12,CGGGGTAAGGGGCATACTAT,23,5013954
yjbJ_predicted,3.923076923076923,62,12,CGGGGGGTTACGTGGGATAC,50,5021873
yjbJ_predicted,0.15384615384615385,13,12,CGGATGACCGTCTGCACTAT,1,5020340
yjbJ_predicted,3.6153846153846154,58,12,CGCGTGTGTATCCTATATCT,46,5006513
yjbJ_predicted,4.538461538461538,70,12,CGACATCCTGGCAATTCCTT,58,5022252
yjbJ_predicted,0.15384615384615385,13,12,CGAAGAACGGAACGACGTTA,1,5028963
yjbJ_predicted,3.3076923076923075,54,12,CGAACTAACTCAGTGATGTG,42,4995873
yjbJ_predicted,8.0,115,12,CCTCTAGAGCCCTACATAAG,103,5013394
yjbJ_predicted,0.15384615384615385,13,12,CCTCGGACTTACCAGTATTT,1,5010949
yjbJ_predicted,0.15384615384615385,13,12,CCTATTGACGCAACGGCGCC,1,5000125
yjbJ_predicted,4.230769230769231,66,12,CCTATGACTGCTCGCTTTCA,54,5011546
yjbJ_predicted,0.15384615384615385,13,12,CCGGGAATGGGGTTCAATAA,1,5010005
yjbJ_predicted,3.0,50,12,CCGAGCGCTGGATATCTCCC,38,5015993
yjbJ_predicted,5.0,76,12,CCCGTAAATAGACCGCTAGA,64,5012240
yjbJ_predicted,3.3076923076923075,54,12,CATAGGGTTTTAACCCTACT,42,5018359
yjbJ_predicted,1.9230769230769231,36,12,CATACCATCGATACAACCCC,24,5016748
yjbJ_predicted,3.1538461538461537,52,12,CAATTTGTAGGGTGTACCCC,40,5004623
yjbJ_predicted,0.38461538461538464,16,12,ATTGTCTCAATCGGTGGTGT,4,5014817
yjbJ_predicted,2.6923076923076925,46,12,ATTCGTAGCTAGTCGCGGTT,34,4995200
yjbJ_predicted,1.1538461538461537,26,12,ATGACAAGTCGAGATCCGTA,14,5011455
yjbJ_predicted,4.461538461538462,69,12,ATCTACGATTCAACCGGGGT,57,4997518
yjbJ_predicted,2.230769230769231,40,12,AGTTGCCATGCTTTGTCATA,28,5012329
yjbJ_predicted,1.8461538461538463,35,12,AGGTGACCTCCATCAATCAC,23,5025539
yjbJ_predicted,4.3076923076923075,67,12,AGGCATCTCTGGACGTTAGA,55,5012617
yjbJ_predicted,0.15384615384615385,13,12,AGCGAACCTTACAGTGGGGT,1,5002404
yjbJ_predicted,7.153846153846154,104,12,AGCAAGGTAACTGCATAGTC,92,5015996
yjbJ_predicted,0.23076923076923078,14,12,AGATTGCGTGGCAACAGAGC,2,5000970
yjbJ_predicted,0.15384615384615385,13,12,AGAATCGGCTCGCAAGAGGC,1,4996380
yjbJ_predicted,0.15384615384615385,13,12,ACTGTATCGTAGAAGGTAGC,1,5028853
yjbJ_predicted,2.6153846153846154,45,12,ACTAGGTGCTTACGTTGGAT,33,5007995
yjbJ_predicted,2.6923076923076925,46,12,ACGGTGAGGAGAACTGTGGC,34,4997479
yjbJ_predicted,0.15384615384615385,13,12,ACGGCACCGAAGTTCTTCGG,1,5006282
yjbJ_predicted,3.5384615384615383,57,12,ACGCTGATTCTGCATATTCA,45,5004592
yjbJ_predicted,7.384615384615385,107,12,ACCTGATTACGTCTCAGATT,95,5006170
yjbJ_predicted,3.230769230769231,53,12,ACATGGTTCTAGAAAAGAAG,41,5030635
yjbJ_predicted,2.5384615384615383,44,12,ACAGGAGACTTACTAACTTA,32,4998823
yjbJ_predicted,2.3846153846153846,42,12,ACAACGCTATCTCATAATGC,30,5002019
yjbJ_predicted,1.1538461538461537,26,12,ACAAAAGGCCGAGTCGCACT,14,4995277
yjbJ_predicted,3.0,50,12,AATTAAGTCACATTGCGTAC,38,4996723
yjbJ_predicted,4.153846153846154,65,12,AAGACTAAGCACTTTGACTA,53,5008565
yjbJ_predicted,2.4615384615384617,43,12,AACTTTCTGGCTGAGGATTG,31,4999556
yjbJ_predicted,5.076923076923077,77,12,AACTGAACGTATAGCAGCCT,65,5006456
yjbJ_predicted,0.15384615384615385,13,12,AACCGACGCCCTCAAGGGGC,1,5010757
yjbJ_predicted,4.076923076923077,64,12,AACCACGGCAGGGAGGGGCA,52,5000684
yjbJ_predicted,4.666666666666667,66,11,TTTGGTCCCTTCCCGAGACT,55,4998405
yjbJ_predicted,0.25,13,11,TTTCCATGGCCGCTTTCCCT,2,5007370
yjbJ_predicted,3.75,55,11,TTTCCAAAGTTGTTGTCTTA,44,5026713
yjbJ_predicted,4.583333333333333,65,11,TTCTAAATATTGGGAATGGT,54,5020764
yjbJ_predicted,2.1666666666666665,36,11,TTATGCCAACCTCAAGACCT,25,5027783
yjbJ_predicted,2.5833333333333335,41,11,TGTAGCCATTGTCCCCTAAG,30,5015811
yjbJ_predicted,3.4166666666666665,51,11,TGGTTGAGATGGTGTTCCTC,40,5010551
yjbJ_predicted,3.0833333333333335,47,11,TCTGCTTGGGTGTCCGGATG,36,4995462
yjbJ_predicted,1.0,22,11,TCTGCGTGCAAATACGCTGA,11,5017255
yjbJ_predicted,3.5,52,11,TCTCTTTGACAGTTTTGGCA,41,5020472
yjbJ_predicted,2.5,40,11,TCTATATTCCTATACACGTT,29,5017501
yjbJ_predicted,1.0,22,11,TCGTTGGGTTGTAGGGAAAG,11,4999513
yjbJ_predicted,1.6666666666666667,30,11,TCGATGGAATCTGTAGAATA,19,5023590
yjbJ_predicted,0.6666666666666666,18,11,TCGAGGTTTTCGCCGTCCTA,7,5005022
yjbJ_predicted,6.666666666666667,90,11,TCGACTCCCGACCCAAATAA,79,5017652
yjbJ_predicted,0.16666666666666666,12,11,TCGACGGTACGCAGGACAGG,1,5007196
yjbJ_predicted,4.416666666666667,63,11,TCATCGGCGCCAATGGTGCA,52,5010484
yjbJ_predicted,4.25,61,11,TATTGTGGCCCTGATTATGT,50,5024047
yjbJ_predicted,4.583333333333333,65,11,TAGGGTTATGCATACTAGAA,54,5020093
yjbJ_predicted,4.833333333333333,68,11,TAGGGCGCTTGTGTCTCCAA,57,5006442
yjbJ_predicted,3.3333333333333335,50,11,TACAATTCGAACGTGCGCTA,39,5017590
yjbJ_predicted,0.16666666666666666,12,11,GTGAAGCACGTAGAGAGAGG,1,4999434
yjbJ_predicted,3.0,46,11,GTCCGTCGCCCTAAGGGCCA,35,4995539
yjbJ_predicted,2.6666666666666665,42,11,GTCATTTGGCCTAGAATTCT,31,5013920
yjbJ_predicted,2.5833333333333335,41,11,GTCAAACACGTCGGTCAGAA,30,5019488
yjbJ_predicted,3.5833333333333335,53,11,GGTTGGCATTACTGCGTATT,42,5019208
yjbJ_predicted,3.5,52,11,GGCGCCTTCCATCTGAATGC,41,5012727
yjbJ_predicted,3.3333333333333335,50,11,GGCATGCGGGTAGGGTGTTA,39,5023463
yjbJ_predicted,0.16666666666666666,12,11,GCCAGTTGATTAAAATCTAT,1,4995929
yjbJ_predicted,4.583333333333333,65,11,GCAGTGTGATGGGTTACCTC,54,5031117
yjbJ_predicted,3.9166666666666665,57,11,GCAGGGGCGGATCCAACGTT,46,5014635
yjbJ_predicted,0.16666666666666666,12,11,GCAGATAACCCTAAAGCTTC,1,5021332
yjbJ_predicted,5.916666666666667,81,11,GATGCTTAGGAGCACATCTA,70,5002397
yjbJ_predicted,0.3333333333333333,14,11,GAGAGGGCGGCAAGGAAGCC,3,4995522
yjbJ_predicted,0.16666666666666666,12,11,GAGAATTGGATCTTGTCCTA,1,5008504
yjbJ_predicted,3.25,49,11,GACGATAGTCCCTGAGTGGA,38,5014728
yjbJ_predicted,0.25,13,11,GAAGTCATTCCAGGAGTATT,2,5030168
yjbJ_predicted,0.16666666666666666,12,11,GAAATGCTTACATTTACCTA,1,5010885
yjbJ_predicted,2.5,40,11,GAAACCGTACTCCCGTACTT,29,5031267
yjbJ_predicted,4.833333333333333,68,11,GAAAATGGGTGTCAACATCT,57,4998317
yjbJ_predicted,0.16666666666666666,12,11,CTTACCGCCATTGGTAGGGG,1,5028993
yjbJ_predicted,3.75,55,11,CTCTGTTTACCACTCAGTCC,44,4995722
yjbJ_predicted,0.16666666666666666,12,11,CTCCGTCTCACAAATAATGA,1,5029945
yjbJ_predicted,4.166666666666667,60,11,CTCAAGACAGAGCAGTTTGT,49,5017448
yjbJ_predicted,0.8333333333333334,20,11,CTAACAGACACGACTGCATG,9,5016247
yjbJ_predicted,0.16666666666666666,12,11,CGGTGGGACGCTGGTATATG,1,5005574
yjbJ_predicted,0.16666666666666666,12,11,CGGGCTAAACCGTGTTCTAG,1,5015234
yjbJ_predicted,4.083333333333333,59,11,CGGGCGCAGGTACCCGAGAA,48,5014783
yjbJ_predicted,0.16666666666666666,12,11,CGGCAATTACGTAGTCGAGA,1,4997778
yjbJ_predicted,0.16666666666666666,12,11,CGCCGGGACCTGACGTTCGA,1,5012719
yjbJ_predicted,1.25,25,11,CGCCCGATCGGATCGCTTTA,14,5001085
yjbJ_predicted,3.5,52,11,CGCAAGGCCAACTTGCCTCT,41,4999878
yjbJ_predicted,4.166666666666667,60,11,CGATAAGGAATCGTCGTTAA,49,5001774
yjbJ_predicted,2.3333333333333335,38,11,CCGGCCGGTACAGGTTCACT,27,5019433
yjbJ_predicted,5.083333333333333,71,11,CCGCTAACAGAGCGTAAATG,60,4995374
yjbJ_predicted,0.75,19,11,CCGACGGGCTATACGGCAAA,8,5015674
yjbJ_predicted,0.16666666666666666,12,11,CCCATCTCAATCGGTATTCT,1,5010781
yjbJ_predicted,3.8333333333333335,56,11,CCCAATGATGTCGAGTACAT,45,5011091
yjbJ_predicted,2.3333333333333335,38,11,CCCAACTTGATGTAGCAGGA,27,5009571
yjbJ_predicted,0.16666666666666666,12,11,CAGGAGTGCGTGACTTGTGC,1,4997224
yjbJ_predicted,4.166666666666667,60,11,CAGCGGGCCTTTACTATTAC,49,5011770
yjbJ_predicted,0.25,13,11,CACGAGGAAACTCCGGACCA,2,5005169
yjbJ_predicted,0.16666666666666666,12,11,CAATTGTACTTTTCAGTATT,1,5005799
yjbJ_predicted,0.16666666666666666,12,11,ATTATTTAGCTTTCTGTTAA,1,5014463
yjbJ_predicted,0.16666666666666666,12,11,ATTACTTTCGGCACTGCACT,1,5029810
yjbJ_predicted,2.8333333333333335,44,11,ATGGGCACTCAGAGCTCGCG,33,5010252
yjbJ_predicted,0.16666666666666666,12,11,ATCTTCGGGTGGTACGCCTC,1,5028148
yjbJ_predicted,3.1666666666666665,48,11,ATCCATGTATGTATGATGGG,37,5020467
yjbJ_predicted,0.16666666666666666,12,11,ATACGAGTCAAGGCCGTACT,1,5020024
yjbJ_predicted,3.1666666666666665,48,11,ATAATACCGACTTGGCCTTC,37,5023166
yjbJ_predicted,0.16666666666666666,12,11,AGGTCACGCAACCGAGAGTA,1,5028064
yjbJ_predicted,3.1666666666666665,48,11,AGGAGTACGAAGCGGGAAGT,37,5014884
yjbJ_predicted,3.8333333333333335,56,11,AGGAGCCATAGTAATGTTTG,45,5022306
yjbJ_predicted,8.666666666666666,114,11,AGGACAAGTTAGCGCGACGT,103,5015273
yjbJ_predicted,3.6666666666666665,54,11,AGCAGACACAGACTCCAGAC,43,5021798
yjbJ_predicted,4.083333333333333,59,11,ACGTCTTTGTGTGTTGGGAA,48,5030897
yjbJ_predicted,6.75,91,11,ACGGTGATAGAGAGTATGTT,80,5024259
yjbJ_predicted,0.5,16,11,ACGGCGCACCCAAACAGTCT,5,5007688
yjbJ_predicted,2.25,37,11,ACCTCGGTGCATTGAGGGAT,26,4999583
yjbJ_predicted,3.5833333333333335,53,11,AAGGCTCATTGTTGTAACTG,42,5009220
yjbJ_predicted,0.16666666666666666,12,11,AACCACAATTCGGGAATAGC,1,5030669
yjbJ_predicted,2.0,34,11,AAAGGCTTTTCTCTCGGATA,23,5020897
yjbJ_predicted,10.916666666666666,141,11,AAACCATTACAGTCCCAAAA,130,5000202
yjbJ_predicted,4.583333333333333,65,11,AAAAGTCCAGAGGTTCCGTT,54,5023076
yjbJ_predicted,4.545454545454546,59,10,TTTTGTGAATGCCGTATCTT,49,5003663
yjbJ_predicted,3.4545454545454546,47,10,TTTGGAGGGGTCTCTGCCCC,37,5030118
yjbJ_predicted,3.3636363636363638,46,10,TTGGTCCATATCAATCGGCT,36,5002521
yjbJ_predicted,3.8181818181818183,51,10,TTGCGCCATTAGCAATTTAC,41,5009227
yjbJ_predicted,3.0,42,10,TTCAAGTCCACAGCGTCATG,32,5009471
yjbJ_predicted,2.8181818181818183,40,10,TTACTATCACCGTTCAAATT,30,4998407
yjbJ_predicted,0.18181818181818182,11,10,TGTCAGCTGGACGTTGTCGT,1,5014539
yjbJ_predicted,0.18181818181818182,11,10,TGGTGTAGAGGGCGCAAGAC,1,5015611
yjbJ_predicted,0.18181818181818182,11,10,TGGTCACGATGCGCCCTGAG,1,5025031
yjbJ_predicted,4.909090909090909,63,10,TGGGAGCATCTGGCAGTTGA,53,5004968
yjbJ_predicted,4.909090909090909,63,10,TGGAAGATTTGGTTCCTACC,53,5016177
yjbJ_predicted,4.090909090909091,54,10,TGCTAAAAGTCTACCCGGAT,44,5020899
yjbJ_predicted,7.181818181818182,88,10,TGCGATCAAGACCTAGGGCT,78,5026699
yjbJ_predicted,3.272727272727273,45,10,TGAAATCAGTTCTCCACTGT,35,5001092
yjbJ_predicted,6.363636363636363,79,10,TCTAGATTTGTTAATGTACT,69,5007460
yjbJ_predicted,3.6363636363636362,49,10,TCAGTGCAGTTCGTTTGGAC,39,4998713
yjbJ_predicted,4.636363636363637,60,10,TAGTAAAAAGGGGTATACGT,50,5021198
yjbJ_predicted,0.18181818181818182,11,10,TAGCTACCCTGTTTACGTGG,1,5022727
yjbJ_predicted,4.181818181818182,55,10,TAAACAACTCCAGTCCGGGT,45,5026731
yjbJ_predicted,2.4545454545454546,36,10,GTGCGGTTATCAAGCAAGTA,26,5019124
yjbJ_predicted,0.18181818181818182,11,10,GTGAGGAGATACGGTCGATA,1,5015231
yjbJ_predicted,2.727272727272727,39,10,GTCATCGGTACGTCAGGAAC,29,5005455
yjbJ_predicted,3.909090909090909,52,10,GTAACGTTGAGGCCACTGTG,42,5015534
yjbJ_predicted,4.181818181818182,55,10,GGTATGTACGAGGTCCATAC,45,5019313
yjbJ_predicted,0.18181818181818182,11,10,GGGGGGGTTCGGGGTTGCTG,1,5014843
yjbJ_predicted,9.909090909090908,118,10,GGCTGGGCATTCTCTATAGA,108,5027946
yjbJ_predicted,5.181818181818182,66,10,GGCCGGCCAAGACTGCGGTC,56,5009062
yjbJ_predicted,0.18181818181818182,11,10,GGCATATATGCCGATTCCGT,1,5011905
yjbJ_predicted,1.4545454545454546,25,10,GGCACTCTTGTTGTTATCCC,15,5030246
yjbJ_predicted,3.3636363636363638,46,10,GCTCTCTGCAGGAAGGGTGA,36,5030263
yjbJ_predicted,1.1818181818181819,22,10,GCGGTTTAATTGGGGGCGTA,12,5026561
yjbJ_predicted,0.18181818181818182,11,10,GCGATGTCGGGGCACGCCTA,1,5012031
yjbJ_predicted,7.545454545454546,92,10,GCGAAAATCTTAGAGTGACC,82,4998406
yjbJ_predicted,1.2727272727272727,23,10,GCCGTCTACCTACATGACGT,13,5000348
yjbJ_predicted,1.3636363636363635,24,10,GCCGGCGGTCCTTCATAGTG,14,4997712
yjbJ_predicted,8.909090909090908,107,10,GCCCTTATCGTCTCAGTGTT,97,5019686
yjbJ_predicted,0.18181818181818182,11,10,GCATTTGCATTAGGTGCCAT,1,5028975
yjbJ_predicted,0.18181818181818182,11,10,GCAGTCTAAACGCGAGCGAG,1,5008182
yjbJ_predicted,4.0,53,10,GATACTGTTGCGTAAATTTT,43,5002516
yjbJ_predicted,4.818181818181818,62,10,GAGTAGCGCCGGAACAAGGT,52,5007121
yjbJ_predicted,4.636363636363637,60,10,GAGGGATCCAGCGTGGGTAT,50,5000823
yjbJ_predicted,9.090909090909092,109,10,GAATGCCAAACACCACCTAT,99,4998958
yjbJ_predicted,4.090909090909091,54,10,GAAGCTTATTTTAATAGGCG,44,5001145
yjbJ_predicted,8.454545454545455,102,10,CTTTATTGACAATCCTTCTT,92,5019089
yjbJ_predicted,3.6363636363636362,49,10,CTTGTGAAGGTATAGACGCT,39,5000664
yjbJ_predicted,3.8181818181818183,51,10,CTGTCCCCTAAAAGACCGCT,41,5012429
yjbJ_predicted,3.1818181818181817,44,10,CTGCGCGCGGGTCAAAAAAT,34,5007597
yjbJ_predicted,4.7272727272727275,61,10,CTCGAGGAATGACTTCGTAC,51,5015787
yjbJ_predicted,7.090909090909091,87,10,CTCATCCAACAACTGAATCA,77,5021604
yjbJ_predicted,2.6363636363636362,38,10,CTATACTCAGTCATGTCCCT,28,5007333
yjbJ_predicted,0.18181818181818182,11,10,CTAGCATCCTTGTCAGGGCT,1,5023511
yjbJ_predicted,3.0,42,10,CTAAACAACTATTCGATGTA,32,5014311
yjbJ_predicted,0.2727272727272727,12,10,CGTATATGCAAAGCGGAGCA,2,5014010
yjbJ_predicted,0.18181818181818182,11,10,CGGTTGAAAGTCTCAGACGA,1,5008987
yjbJ_predicted,3.272727272727273,45,10,CGCTTACATACGCGTTCGAG,35,5030309
yjbJ_predicted,2.5454545454545454,37,10,CGCGCAAATGAGAGGTTATC,27,5028353
yjbJ_predicted,4.090909090909091,54,10,CGCAGCTGCTACACGTAGTT,44,4998196
yjbJ_predicted,2.727272727272727,39,10,CCGTTCATGTCGGGATTATG,29,4999929
yjbJ_predicted,3.909090909090909,52,10,CCGGCCAATGGTGGCGAGCA,42,5004169
yjbJ_predicted,0.18181818181818182,11,10,CCGCCGTACGGAGCATGCAG,1,5029091
yjbJ_predicted,4.090909090909091,54,10,CCACTACTACCACGGTCAGC,44,4999615
yjbJ_predicted,4.2727272727272725,56,10,CATTTAGATTGTCGCGCCCC,46,5002987
yjbJ_predicted,2.909090909090909,41,10,CACATGCGGATACAAGGACA,31,5010254
yjbJ_predicted,0.18181818181818182,11,10,CAATTCTGAATTTGAATATA,1,5013684
yjbJ_predicted,3.909090909090909,52,10,CAATTACGAGTGTACTAGTT,42,4999137
yjbJ_predicted,6.181818181818182,77,10,ATTGCAACCTTCGCAACCTA,67,5001624
yjbJ_predicted,7.0,86,10,ATTGATTTCAAATATTACTC,76,4996962
yjbJ_predicted,2.272727272727273,34,10,ATGGACCCCGTGCAGTTATG,24,5020803
yjbJ_predicted,4.2727272727272725,56,10,ATCTAAGCAGGCTCGCTGGT,46,5015423
yjbJ_predicted,1.3636363636363635,24,10,AGTGCCCGCTAAAGGGCATT,14,5030707
yjbJ_predicted,4.090909090909091,54,10,AGTCCTTGCCTAGTGATCCA,44,5008591
yjbJ_predicted,3.6363636363636362,49,10,AGGCCATGTCGGAACCGGCA,39,5008420
yjbJ_predicted,2.1818181818181817,33,10,AGGCAATCAGTTGCCAAAAA,23,5009330
yjbJ_predicted,0.18181818181818182,11,10,AGGACGTTTCTAGGATAGAA,1,5008372
yjbJ_predicted,0.18181818181818182,11,10,AGAACGGACCTACAGCGCCT,1,5004217
yjbJ_predicted,0.18181818181818182,11,10,ACTGGGGAGCACCCTAGGGC,1,5020003
yjbJ_predicted,4.0,53,10,ACGGGTTCGTCCGGAACATT,43,5007651
yjbJ_predicted,6.0,75,10,ACGGGGCTGACTCGTATTAC,65,5018543
yjbJ_predicted,4.909090909090909,63,10,ACGGGCCTTTTACGTACGTA,53,5009773
yjbJ_predicted,1.3636363636363635,24,10,ACGCATATCACCAGAGCAAC,14,4998400
yjbJ_predicted,4.2727272727272725,56,10,ACGAGGCTACTATACTATCT,46,5003279
yjbJ_predicted,12.727272727272727,149,10,ACCCATTGGCCGGTTAAAAG,139,5023411
yjbJ_predicted,8.636363636363637,104,10,ACAGAGTCGGTGGCCATTCT,94,5020384
yjbJ_predicted,0.2727272727272727,12,10,AAGTCTGCACCCTTTTGTCA,2,5002758
yjbJ_predicted,0.18181818181818182,11,10,AACAGGATGCAAAGGGACTA,1,5012235
yjbJ_predicted,3.5454545454545454,48,10,AAATACCACATGGGTAGGTA,38,5015930
yjbJ_predicted,0.18181818181818182,11,10,AAAGTTTCCCTGCCTACCCT,1,5026396
yjbJ_predicted,4.7,55,9,TTGGCATCCTCCTTTCAGGA,46,5026630
yjbJ_predicted,4.9,57,9,TTGAACCCACCGCCACTCCT,48,4997138
yjbJ_predicted,4.9,57,9,TTCTCCGCCGAGACATTAAG,48,5006647
yjbJ_predicted,4.6,54,9,TGCTGCATAGCTTCTTGTAA,45,5010395
yjbJ_predicted,0.2,10,9,TGCGCCAGGAGTGGTACCAA,1,5008644
yjbJ_predicted,0.2,10,9,TCTCAAACGAGGGGTTGGAG,1,5025467
yjbJ_predicted,2.3,31,9,TCTACTACCCGCGTCTGTGC,22,5018278
yjbJ_predicted,2.8,36,9,TCGTGAAGCAGTAGGAACAG,27,4996316
yjbJ_predicted,0.2,10,9,TCGTCAGCACGGTGCGTAAC,1,5028359
yjbJ_predicted,0.2,10,9,TCGGAGTTCGCCTGATCAGA,1,5016468
yjbJ_predicted,5.0,58,9,TCCTGGCATATAACGTCTGG,49,5006990
yjbJ_predicted,0.2,10,9,TCCTATGCGTAATCGTACGC,1,5002782
yjbJ_predicted,0.2,10,9,TCCGATGTATGCGTCGTGGT,1,4997485
yjbJ_predicted,0.2,10,9,TCAAAGCTAAACTCTAATCT,1,5022402
yjbJ_predicted,8.2,90,9,TATCTTTTGTGCTTGGTGCC,81,5017421
yjbJ_predicted,6.2,70,9,TATACGCTATGGGTACCTAA,61,4997760
yjbJ_predicted,4.6,54,9,TACAAGTATATAGCACCGGT,45,5004418
yjbJ_predicted,4.8,56,9,GTGCTAAACCACCCGGGAGT,47,5018453
yjbJ_predicted,3.1,39,9,GTCTCATGGGCCTCTCTCAA,30,5000260
yjbJ_predicted,0.2,10,9,GTCAAACCCGCTCGATGATT,1,5012959
yjbJ_predicted,9.5,103,9,GTAGCTCTGGACCTTACAGC,94,5026374
yjbJ_predicted,3.3,41,9,GGTTCATGCCTTGGTGGGTC,32,5010545
yjbJ_predicted,0.2,10,9,GGGTCTACTCGATAGCTCAC,1,5011139
yjbJ_predicted,3.3,41,9,GGGGTATCATGAAACACCAG,32,5029513
yjbJ_predicted,2.0,28,9,GGGAAAGCAATGGACTCCGA,19,5008209
yjbJ_predicted,3.4,42,9,GGCGTCACTTAAGGAGATAT,33,5024776
yjbJ_predicted,1.4,22,9,GGCGGAAACGTGACCAGGAC,13,4997231
yjbJ_predicted,0.2,10,9,GGCAGGCTAGGCATTGGGAC,1,5008146
yjbJ_predicted,0.2,10,9,GGATTGTCCTAAAAGTAAAC,1,5012585
yjbJ_predicted,0.2,10,9,GGATAATGCATAAAAATCCC,1,5022597
yjbJ_predicted,0.2,10,9,GGAATCAAAGAAGCGGGGTA,1,5026144
yjbJ_predicted,4.8,56,9,GCTGTTTCCCGCGACGCGGA,47,5000109
yjbJ_predicted,2.5,33,9,GCTGTGTCTTCAGTGGTCAT,24,5003131
yjbJ_predicted,3.9,47,9,GCTCATTAGGGCGCCGGTGA,38,5024443
yjbJ_predicted,0.2,10,9,GCTAGAGAGCGGTAGTAGCC,1,5000827
yjbJ_predicted,0.2,10,9,GATTGGAATGTTGCTGCAGT,1,4999260
yjbJ_predicted,3.2,40,9,GATCTTTCCGATAAGCGCGT,31,4995074
yjbJ_predicted,4.6,54,9,GAGCGCCGAGGTCTTGTCGT,45,5027357
yjbJ_predicted,3.6,44,9,GACTTGCCAGTCGTTAGATG,35,5005777
yjbJ_predicted,1.9,27,9,GAAAGAGGAGGAGTAGTTTC,18,5022501
yjbJ_predicted,4.9,57,9,CTTTGCCTTGTAGTGCCGCA,48,5022591
yjbJ_predicted,0.3,11,9,CTTCGTCCCGTAATCGCCGT,2,5012599
yjbJ_predicted,0.2,10,9,CTGTCGTTGCTCATTTAGAT,1,5022765
yjbJ_predicted,2.7,35,9,CTGCAACGGACAGTTAGCTG,26,5008855
yjbJ_predicted,9.6,104,9,CTCCGTCTATAAGAATTATT,95,5004086
yjbJ_predicted,6.7,75,9,CTAATAAACTCTGGATTCAT,66,5023273
yjbJ_predicted,0.2,10,9,CTAACTCCGATATCACATGA,1,4994969
yjbJ_predicted,0.2,10,9,CGTACTTGTTAAGAGAAATC,1,5026315
yjbJ_predicted,0.2,10,9,CGGGGTAGAGGGTTCTGCGT,1,5013540
yjbJ_predicted,7.5,83,9,CGGCTTTCGGGGTTATTCCG,74,5007590
yjbJ_predicted,1.9,27,9,CGGATACCGGCCTGAGAGGC,18,5002234
yjbJ_predicted,0.3,11,9,CGCTGTATCGGTGTCAAGGT,2,4995804
yjbJ_predicted,0.9,17,9,CGCGTATGCTTCTCAGTTTA,8,4997985
yjbJ_predicted,4.5,53,9,CGCACGACCCGGTACTGATC,44,5009166
yjbJ_predicted,4.6,54,9,CGAAGGTGTTGCCCCAATTG,45,5024231
yjbJ_predicted,0.7,15,9,CCTGAAAACCATGGCGGTAA,6,4998606
yjbJ_predicted,2.0,28,9,CCCGAAGCACATAAAAAGGT,19,5017420
yjbJ_predicted,0.2,10,9,CCCCACGCCGGTCGAAACTC,1,4996308
yjbJ_predicted,1.6,24,9,CCATGATTTTAGATCAAACG,15,5008015
yjbJ_predicted,3.2,40,9,CCATACGCCTTCGTCTCAGC,31,5008398
yjbJ_predicted,0.3,11,9,CCAGTGTTACGGTACAGCTT,2,5028647
yjbJ_predicted,3.8,46,9,CATGTGAGGACTCGCCAGTT,37,5014505
yjbJ_predicted,4.8,56,9,CAGTAGCGTTCACATGGTGC,47,4996562
yjbJ_predicted,4.6,54,9,CAGGAACAAGCTAGAGATGT,45,5023839
yjbJ_predicted,0.3,11,9,CACGGTCTGCGGCAGTAATC,2,5017760
yjbJ_predicted,4.2,50,9,CAATCCGGATTACGTGCAGG,41,5015929
yjbJ_predicted,4.0,48,9,CAAGTGCGGCGCATGATACA,39,4997183
yjbJ_predicted,6.3,71,9,CAAACCCTGCGGTACACGGA,62,5009957
yjbJ_predicted,4.9,57,9,ATTTATAGGCTTCAATAGGT,48,5029129
yjbJ_predicted,22.2,230,9,ATGCGCTAGACCTATCGTTG,221,4998951
yjbJ_predicted,3.1,39,9,ATGAGCGTCTATGCTCATCA,30,5008464
yjbJ_predicted,3.4,42,9,ATAGCGCTTTTTGGAGGAAA,33,4996220
yjbJ_predicted,3.0,38,9,ATACTTTAAGCGGTGGTTTT,29,4999507
yjbJ_predicted,0.2,10,9,ATACTGGAGGATTTGGTGCG,1,5010870
yjbJ_predicted,0.6,14,9,ATAACTGACTGATCCTTGTT,5,5015363
yjbJ_predicted,2.6,34,9,AGTTATGCCTAGTAATTCTA,25,5029428
yjbJ_predicted,5.1,59,9,AGTCTCCCGAGCCGATCAGA,50,5018465
yjbJ_predicted,1.9,27,9,AGGCAAAGGGGTAGTTTAAG,18,5021631
yjbJ_predicted,4.6,54,9,AGCATTGCTGCGCTCCCTAA,45,5007730
yjbJ_predicted,2.7,35,9,AGCACGTGTCGTATAACGCT,26,5022161
yjbJ_predicted,0.2,10,9,AGAAGCGAGTGTAGACAACG,1,5018215
yjbJ_predicted,1.3,21,9,ACGGTCATCTGCAGGACCAT,12,5006971
yjbJ_predicted,4.5,53,9,ACGGGTTATGCTCTGGGCAG,44,5020455
yjbJ_predicted,4.5,53,9,ACGAAGGTTCACCGAGACGA,44,4994830
yjbJ_predicted,0.9,17,9,ACCTCTGGTGGCCTCGGAGA,8,5011004
yjbJ_predicted,1.0,18,9,ACCACCTAAAATACGATGAC,9,5027274
yjbJ_predicted,0.4,12,9,ACACAGACGACTCTCGACGG,3,5022588
yjbJ_predicted,2.8,36,9,ACAACAAATGGAGCCGGTCA,27,5010337
yjbJ_predicted,0.3,11,9,AATTACGTAGGATGTGCGGG,2,5019445
yjbJ_predicted,2.2,30,9,AAGGTTCTCTCACAAGGCAT,21,5029337
yjbJ_predicted,7.111111111111111,71,8,TTTTTGCCGGCATGGGAGTA,63,5010863
yjbJ_predicted,0.2222222222222222,9,8,TTGTCTAGAGCCGCACGGTT,1,4995559
yjbJ_predicted,0.3333333333333333,10,8,TTCTCGATTGCTGTTTGCAT,2,5019888
yjbJ_predicted,4.555555555555555,48,8,TGTTGAAATTATTATTATAG,40,5012762
yjbJ_predicted,0.2222222222222222,9,8,TGTTCGAAACCACACTACTC,1,5028093
yjbJ_predicted,3.111111111111111,35,8,TGTGATTCTGATGCCAGTGT,27,4998887
yjbJ_predicted,0.4444444444444444,11,8,TGATTATGACTTGGCCACAA,3,5003486
yjbJ_predicted,2.4444444444444446,29,8,TGATGCGCTACCGTGCGAGC,21,5014751
yjbJ_predicted,0.2222222222222222,9,8,TGACAGTACGAAAAACTGAG,1,5021615
yjbJ_predicted,3.888888888888889,42,8,TCTTGCGTCTAAGACGCTCT,34,5018845
yjbJ_predicted,4.777777777777778,50,8,TCTAAGGCCAGCTTTGTTTC,42,5025263
yjbJ_predicted,4.333333333333333,46,8,TCGGCGATATCAGTCGATGT,38,5020460
yjbJ_predicted,3.4444444444444446,38,8,TCGCATGTACTAAGTATTGT,30,5017865
yjbJ_predicted,4.888888888888889,51,8,TCCTTACACACGCAGTCATC,43,4996512
yjbJ_predicted,4.111111111111111,44,8,TCCGGAACATGAAGCAAGTA,36,4996978
yjbJ_predicted,0.3333333333333333,10,8,TCATTTGTACACAGTCGAGA,2,5000005
yjbJ_predicted,5.333333333333333,55,8,TCAGGCTCAAGAGAATCGGC,47,5008837
yjbJ_predicted,0.2222222222222222,9,8,TCACTTGGCGCTTGCTCGGT,1,5028384
yjbJ_predicted,8.0,79,8,TCAAGGACCTGGTGCCCGAC,71,5024608
yjbJ_predicted,2.111111111111111,26,8,TAGAGAAGGCCCTAACCGAT,18,4999319
yjbJ_predicted,0.3333333333333333,10,8,TAGAATCCTGTCACAGTCAT,2,5006893
yjbJ_predicted,0.5555555555555556,12,8,TACGTATGAACGTGCAGAAG,4,4998974
yjbJ_predicted,2.111111111111111,26,8,TACGGCATGGTAGTCGGAAG,18,5008535
yjbJ_predicted,9.88888888888889,96,8,TACCCAAATTCCCAATGATT,88,5011211
yjbJ_predicted,5.888888888888889,60,8,TACACTTTGCATTTACAACG,52,5006880
yjbJ_predicted,0.3333333333333333,10,8,TACAATTCTGCCGGGTAAAG,2,5026557
yjbJ_predicted,0.7777777777777778,14,8,TAAAATATCGGACGGCCGCC,6,5016023
yjbJ_predicted,0.2222222222222222,9,8,GTTATTAAACATGGAGCAAG,1,5006246
yjbJ_predicted,11.0,106,8,GTGATAACAGAATGGACCTG,98,4996686
yjbJ_predicted,3.5555555555555554,39,8,GTGAACACGTCTCTCATACG,31,5008756
yjbJ_predicted,0.2222222222222222,9,8,GTCGTTAACTAGCGTTACAG,1,5024732
yjbJ_predicted,1.5555555555555556,21,8,GTCGTATTCGAGTTCACTCG,13,4999808
yjbJ_predicted,0.2222222222222222,9,8,GTCCTACCCCGGGTACTTGT,1,5004193
yjbJ_predicted,5.111111111111111,53,8,GTATAACAATTCAGCTTGGT,45,5004839
yjbJ_predicted,5.888888888888889,60,8,GTAGCAACCTTTACCAGAAG,52,4994934
yjbJ_predicted,9.88888888888889,96,8,GGTGTGTGGACTTGGAATGT,88,5011507
yjbJ_predicted,4.222222222222222,45,8,GGTCCAATACGGCCACCTGC,37,5020181
yjbJ_predicted,0.2222222222222222,9,8,GGTATAGGGATGCTTTCTGA,1,5008994
yjbJ_predicted,5.555555555555555,57,8,GGGGTGTGAGTTTGTATTTG,49,4997476
yjbJ_predicted,1.4444444444444444,20,8,GGGCCTACCCCACAGGAGAC,12,5025822
yjbJ_predicted,6.555555555555555,66,8,GGCCGCATGGCAATTGCTGT,58,5024105
yjbJ_predicted,6.333333333333333,64,8,GGAGGTTATGTGTCAGCTAG,56,5011481
yjbJ_predicted,3.0,34,8,GGACGCCTTTCCTCGGCGGC,26,5021829
yjbJ_predicted,1.5555555555555556,21,8,GGAATCATAAGCGGGACCAT,13,5011464
yjbJ_predicted,2.888888888888889,33,8,GCTCGTGCACCAGTCCACAC,25,5019175
yjbJ_predicted,5.111111111111111,53,8,GCGTTGTCGATCCTTCGTAT,45,5026353
yjbJ_predicted,3.5555555555555554,39,8,GCGACTTTGGTTTGGCATGT,31,5004289
yjbJ_predicted,5.111111111111111,53,8,GCAGCCCCCGTAACTTACAA,45,5010326
yjbJ_predicted,0.4444444444444444,11,8,GCAGCCACCACTTCTATTAT,3,5022703
yjbJ_predicted,3.7777777777777777,41,8,GAGGATTAGCTAGGACCTAA,33,5008413
yjbJ_predicted,6.555555555555555,66,8,GAGAGACTATTATCCGCCAC,58,5014012
yjbJ_predicted,3.0,34,8,GAGACTTAATGCGTGCTGTA,26,5030106
yjbJ_predicted,0.2222222222222222,9,8,GACGCGCATGTGTATCGGAA,1,5014103
yjbJ_predicted,2.4444444444444446,29,8,GACGATGTAGAGACTGATAT,21,5017728
yjbJ_predicted,0.2222222222222222,9,8,CTTGGCTGATTGATAGTAGT,1,5029890
yjbJ_predicted,3.6666666666666665,40,8,CTTAGAAGTGTAATGGATAG,32,5000932
yjbJ_predicted,0.2222222222222222,9,8,CTGTGCCTGCCAACGGTTTC,1,5020162
yjbJ_predicted,6.333333333333333,64,8,CTCGGTTAGCCAACTCACAA,56,5016980
yjbJ_predicted,1.8888888888888888,24,8,CTCCGGGACGCAATCAGTAA,16,5005546
yjbJ_predicted,3.5555555555555554,39,8,CTCATAGTCCGCATACCGAT,31,5024395
yjbJ_predicted,0.2222222222222222,9,8,CTCACAGCGCAATCAGCATT,1,5023513
yjbJ_predicted,4.888888888888889,51,8,CTATGCGTTGACGAGTAGGA,43,4995195
yjbJ_predicted,5.222222222222222,54,8,CGTCCTTTTCTTACTGTGAA,46,5012768
yjbJ_predicted,3.5555555555555554,39,8,CGTAATTTGGTTAAGTCCAG,31,5022815
yjbJ_predicted,4.0,43,8,CGGTTCGGCCGTACTGTGGA,35,5015183
yjbJ_predicted,4.555555555555555,48,8,CGGGGTAACCAGTGAATGTA,40,4997388
yjbJ_predicted,2.111111111111111,26,8,CGGGACAATTAGCCTCGATT,18,5009426
yjbJ_predicted,6.111111111111111,62,8,CGCTACCAGAAAATTCAAGA,54,4997786
yjbJ_predicted,8.333333333333334,82,8,CGCCCACTATTTCGCAGGTG,74,5007557
yjbJ_predicted,3.111111111111111,35,8,CGAGTCTACTAACATTGAGT,27,5002517
yjbJ_predicted,4.444444444444445,47,8,CCTTAAAGACATGTATGATG,39,5019053
yjbJ_predicted,0.2222222222222222,9,8,CCTCACTCAGCGTGTTGAGC,1,5006448
yjbJ_predicted,0.2222222222222222,9,8,CCGCCATTTTACAGGGATCT,1,5017283
yjbJ_predicted,3.4444444444444446,38,8,CCCTTTAAGGTCGTTAATAG,30,5029628
yjbJ_predicted,0.2222222222222222,9,8,CCCAACCGGGCACTAAACAT,1,5019108
yjbJ_predicted,0.3333333333333333,10,8,CCACGACGACTCCGCTTATA,2,5013693
yjbJ_predicted,0.2222222222222222,9,8,CAGGGAATACCGCCTATGCT,1,5002537
yjbJ_predicted,6.222222222222222,63,8,CACGGCCTGGAAGAAGAGAC,55,5025439
yjbJ_predicted,3.4444444444444446,38,8,CACCGATTGAGTTTCTAGTC,30,5011021
yjbJ_predicted,5.333333333333333,55,8,CACCACGGCAGCATAATCAA,47,5022362
yjbJ_predicted,0.2222222222222222,9,8,CAACCACGTAGTTATCTCCT,1,4997950
yjbJ_predicted,4.111111111111111,44,8,CAAATCCAATTGTTCAGTAA,36,5000341
yjbJ_predicted,3.6666666666666665,40,8,ATTCTGTATGGACTTACCGT,32,5001355
yjbJ_predicted,5.222222222222222,54,8,ATCTGGGTTTGCCGTGTAAA,46,5028149
yjbJ_predicted,3.888888888888889,42,8,ATCCCTTTCCTCTCGCAGAC,34,5012516
yjbJ_predicted,4.333333333333333,46,8,AGTTGTGATGGCATCACCAA,38,5025170
yjbJ_predicted,6.222222222222222,63,8,AGTAGTAGCGAAAAGGAGCA,55,5000242
yjbJ_predicted,5.0,52,8,AGGCCGCACCACGCTATTAC,44,5017024
yjbJ_predicted,6.333333333333333,64,8,AGGACCTGGCTCCGACAAAC,56,4996696
yjbJ_predicted,0.2222222222222222,9,8,AGCCGTCAGCCCCCTCGATT,1,5006066
yjbJ_predicted,0.2222222222222222,9,8,AGACAGCCGAGTGCACGCAT,1,5029991
yjbJ_predicted,4.222222222222222,45,8,AGAAATGTTGAAGGAGGCTC,37,5002879
yjbJ_predicted,12.444444444444445,119,8,ACTCTGCTCAGTCTTTCTCG,111,5005398
yjbJ_predicted,3.2222222222222223,36,8,ACTACTTATGTTCTCTCTTT,28,5010736
yjbJ_predicted,4.0,43,8,ACGTGTTGTACGAGTGCCTA,35,5006432
yjbJ_predicted,5.777777777777778,59,8,ACGCCGTGCGGTATTATTAT,51,5015249
yjbJ_predicted,4.888888888888889,51,8,ACGAGGTTCGTCAAAGGGAA,43,5030115
yjbJ_predicted,0.3333333333333333,10,8,ACGACCTAGCAGCCAGGGAA,2,5012944
yjbJ_predicted,4.888888888888889,51,8,ACCTGATTCGCAAAGAGGCT,43,5011054
yjbJ_predicted,5.111111111111111,53,8,ACAGTCTCCCCTTAAGGTGT,45,4995726
yjbJ_predicted,0.2222222222222222,9,8,AATTGTTCGACTGTCCTTGC,1,5003452
yjbJ_predicted,0.2222222222222222,9,8,AATGTTGTTTAGTGGCAAGA,1,5024849
yjbJ_predicted,6.222222222222222,63,8,AATAAGGCGGTATGATCAGA,55,5011206
yjbJ_predicted,2.6666666666666665,31,8,AAGTAGTTCGCTGATGATAT,23,5017906
yjbJ_predicted,0.2222222222222222,9,8,AAGACTAAGCACGGGACTGA,1,5004250
yjbJ_predicted,10.777777777777779,104,8,AAATTAGACGGCTTCCATCA,96,5004649
yjbJ_predicted,4.555555555555555,48,8,AAATGGCTGGCTTTACGAGT,40,5011801
yjbJ_predicted,0.2222222222222222,9,8,AAAGTCCCGACAACTCTCGC,1,5011795
yjbJ_predicted,5.875,53,7,TTGCGCTGAGTTTACGCCGA,46,5019283
yjbJ_predicted,8.0,70,7,TTAACTGGGATCTATCACCA,63,5004055
yjbJ_predicted,5.5,50,7,TTAACTATTGTGTCAACGTA,43,4995981
yjbJ_predicted,7.5,66,7,TGGGATTGTAAGATTGTCAC,59,5030370
yjbJ_predicted,4.0,38,7,TGACGTAGCATGACATCGGC,31,4998305
yjbJ_predicted,5.875,53,7,TGAATGCGCCTCACAGCTGT,46,5008991
yjbJ_predicted,8.0,70,7,TCTGTAGCTACAGGCTGCTA,63,5001549
yjbJ_predicted,1.75,20,7,TCTCTGGAGGAATTGCTTGA,13,5004008
yjbJ_predicted,0.25,8,7,TCTCATCGCCGTGATTCAAC,1,5012928
yjbJ_predicted,4.25,40,7,TCTATTTTACCGGTCAGATC,33,5006565
yjbJ_predicted,6.125,55,7,TCGTTAAGCATTGCGGCCTA,48,4997320
yjbJ_predicted,3.75,36,7,TCCGTCTTTCTATGTGCAGT,29,5021863
yjbJ_predicted,5.5,50,7,TCCGCATTTCATTGCAATCA,43,4997157
yjbJ_predicted,6.375,57,7,TCCCTGAGTTGAGCAATCCA,50,4995173
yjbJ_predicted,0.25,8,7,TATAGGGTAGCACGACTTGT,1,5007600
yjbJ_predicted,5.0,46,7,TATAGCCTCAGGATCATTGT,39,5023462
yjbJ_predicted,2.25,24,7,TAGCTTTGCCAAGCCGAAGA,17,5011925
yjbJ_predicted,6.125,55,7,TACGTCGGGAGACTAAGGTT,48,5024986
yjbJ_predicted,9.0,78,7,TACGGCAATGGGCATTATAA,71,5022250
yjbJ_predicted,4.875,45,7,TAAGATCAAGGGGCTTAATC,38,5005225
yjbJ_predicted,0.25,8,7,GTTGGGGTTTACGCCGAGCT,1,5010030
yjbJ_predicted,6.875,61,7,GTTCAAGAACAACGTGAACA,54,4995309
yjbJ_predicted,6.375,57,7,GTGCAAACCGCATTAACGAT,50,5007802
yjbJ_predicted,4.0,38,7,GTCCTGATATATAAACCATT,31,5019998
yjbJ_predicted,3.75,36,7,GTCAACCATAGTAGCGGAGC,29,5017023
yjbJ_predicted,4.75,44,7,GGTGGAGGCGACATCTAGAG,37,4995107
yjbJ_predicted,0.25,8,7,GGCGCGGCATAGTTGCAGGC,1,5001056
yjbJ_predicted,0.25,8,7,GGCATTACCCTCACCTCTGG,1,4998561
yjbJ_predicted,2.375,25,7,GGATGAACCTCGGCTACAGA,18,4998280
yjbJ_predicted,0.25,8,7,GCTTCTAAATAGATACACAA,1,5005489
yjbJ_predicted,0.25,8,7,GCTATTCGATTGTGGTATAC,1,4994862
yjbJ_predicted,6.125,55,7,GCTAGAGCTCTTGTTTCGAT,48,5012848
yjbJ_predicted,0.25,8,7,GCGCGCCGAACATGGATCAA,1,5013484
yjbJ_predicted,0.25,8,7,GCGCCCGTAGACAGCGCTTG,1,5022310
yjbJ_predicted,3.25,32,7,GCCTCTAATGCTGCATGTGC,25,4998404
yjbJ_predicted,0.25,8,7,GCCCCGGTTTCGGATAAATT,1,5006942
yjbJ_predicted,5.0,46,7,GCATGAAGAGAATCAGATAC,39,5011059
yjbJ_predicted,6.0,54,7,GATCGAGTTACGTGGGACCT,47,5002007
yjbJ_predicted,3.25,32,7,GAGTGATAACGAACACAACT,25,5013389
yjbJ_predicted,0.25,8,7,GAGGGGTTTCGCAGATTCGG,1,4999056
yjbJ_predicted,4.125,39,7,GAGCTTAGTAGGCGGTTTCA,32,5015799
yjbJ_predicted,3.75,36,7,GAGCGCACAGATTGTTTAAA,29,5016671
yjbJ_predicted,15.625,131,7,GAGAGGTACACGGGCCACTC,124,5004236
yjbJ_predicted,0.25,8,7,GACTTGGCGGATAGGAATTT,1,5012015
yjbJ_predicted,0.25,8,7,GACTCCAACGCGCCACGCGA,1,5018464
yjbJ_predicted,0.25,8,7,GACAAGCGGAATTTTTTGTT,1,5028758
yjbJ_predicted,4.375,41,7,GAATGTACGCCATTCACCCA,34,4997623
yjbJ_predicted,0.25,8,7,GAACGCAAGTCTAAACCCAT,1,5022515
yjbJ_predicted,0.375,9,7,CTTTTTGACTGTCCCTAGCT,2,5016117
yjbJ_predicted,13.125,111,7,CTTGGACCCACTTTATTCGG,104,5010184
yjbJ_predicted,0.375,9,7,CTTCCCTCAGACGCTAAGAC,2,5024865
yjbJ_predicted,0.875,13,7,CTGTACAATGCCCTGCTTAC,6,5009760
yjbJ_predicted,0.25,8,7,CTGCGGGAAACTTGGTGGAA,1,5013222
yjbJ_predicted,2.125,23,7,CTGCGGCCCGAAACCACATG,16,5012105
yjbJ_predicted,7.25,64,7,CTCGGACGAGGACCCTTGTT,57,5014313
yjbJ_predicted,2.75,28,7,CTACGGTCTATTAACAAAGG,21,5028124
yjbJ_predicted,1.625,19,7,CTACAACATAATCACCAGGC,12,4997699
yjbJ_predicted,3.5,34,7,CGTAAGGAGTACTGGTTAGC,27,5018575
yjbJ_predicted,7.125,63,7,CGGGACGCTCCTGTTGGTAA,56,5016419
yjbJ_predicted,9.75,84,7,CGGAACCCGGGGTGGGGCAG,77,5001699
yjbJ_predicted,0.25,8,7,CGCGGGGTCGAGCGGGACAG,1,4998658
yjbJ_predicted,3.75,36,7,CGCGCCCACGAGTCCACGTT,29,5013047
yjbJ_predicted,0.25,8,7,CGATCTCTTCTCCTTTCAGT,1,5027384
yjbJ_predicted,0.875,13,7,CGAGAGTTACCGTGGAAGGC,6,4999884
yjbJ_predicted,6.625,59,7,CGACGGTATAGTGATACGTA,52,5029927
yjbJ_predicted,4.125,39,7,CCTTTTCGGCTTTAGAAGGG,32,5021190
yjbJ_predicted,4.625,43,7,CCGTTCATAGGGATTATATT,36,5015758
yjbJ_predicted,0.25,8,7,CCGAGAGGCCAACTCGCTTA,1,5007458
yjbJ_predicted,10.75,92,7,CCCTCATGGTAAGTTTCAGC,85,4997526
yjbJ_predicted,0.25,8,7,CCCAATGAAGCGTATGGTAT,1,4998715
yjbJ_predicted,4.625,43,7,CCAAGAACGCTTCCGTTGCG,36,4997831
yjbJ_predicted,0.25,8,7,CATGGGGCTAGTCATTCAGA,1,4995897
yjbJ_predicted,5.625,51,7,CATGATCGGGTGCTAGGTTC,44,5008543
yjbJ_predicted,2.25,24,7,CATCGCCCACGAAGTCGTTT,17,5010189
yjbJ_predicted,3.375,33,7,CAGGAAGACCGCAGGCTTGT,26,5023883
yjbJ_predicted,3.375,33,7,CACAACTAAATAACCCCTGT,26,5031156
yjbJ_predicted,4.0,38,7,CAACAGTGTGGTTCTCATCC,31,5027328
yjbJ_predicted,3.0,30,7,CAACAACAAAAAATGTTACT,23,5021987
yjbJ_predicted,7.0,62,7,ATTTCGGTGCGGACGCTAGT,55,4999674
yjbJ_predicted,4.875,45,7,ATTCGGTCTCGTCTATTGTG,38,5028201
yjbJ_predicted,10.25,88,7,ATGCGCCAGCGCCATACTTC,81,5002131
yjbJ_predicted,0.25,8,7,ATCACGGACTGAATCGTGAC,1,5020760
yjbJ_predicted,10.0,86,7,ATCAAGGGCTTCAGGGCTTT,79,5018624
yjbJ_predicted,7.5,66,7,ATATACGGAGAAAGGTACCA,59,5001795
yjbJ_predicted,5.0,46,7,ATAAAGCGATCCAAAAATCA,39,4996920
yjbJ_predicted,4.25,40,7,AGTGTCAGGCACGTACGAAT,33,4997416
yjbJ_predicted,4.125,39,7,AGGTTGAGCCCTCGGGATAA,32,5012517
yjbJ_predicted,0.25,8,7,AGGGGAAAATCAATCCATAT,1,5027067
yjbJ_predicted,0.25,8,7,AGGATCTTGCTCATCAACGT,1,5024678
yjbJ_predicted,0.5,10,7,AGGAGTCCATTCATGCCTGA,3,5007856
yjbJ_predicted,4.125,39,7,AGGAATACCGCTCCTGCGAG,32,5000282
yjbJ_predicted,5.625,51,7,AGAGCACTATTGACAGTCTT,44,4998792
yjbJ_predicted,0.25,8,7,ACTCTGTCCTAGGTATTGCG,1,5004760
yjbJ_predicted,1.125,15,7,ACGGATCCACGACTTATTCT,8,4998895
yjbJ_predicted,0.25,8,7,ACGATGCGGTAATGTTACAA,1,5024323
yjbJ_predicted,5.75,52,7,ACCGTTAGCCCCGCGTTTAA,45,5025450
yjbJ_predicted,0.25,8,7,ACCAGCAACATCATCAAGCT,1,5016143
yjbJ_predicted,0.25,8,7,ACCACAGCTGACATCTTCCA,1,5010588
yjbJ_predicted,0.25,8,7,ACACGGCAGTGTAACCGTTG,1,5022019
yjbJ_predicted,4.75,44,7,ACAAAGGGAATTTGGGGAAT,37,5016118
yjbJ_predicted,1.75,20,7,AATATGTAGGCGGCACAGGA,13,5011403
yjbJ_predicted,0.25,8,7,AAGCCTGACCATCATAGTCC,1,5023778
yjbJ_predicted,0.25,8,7,AACGCGCGTAGAGGAAGAGC,1,5014273
yjbJ_predicted,0.25,8,7,AAAGATGCCGGGTTGTGTAA,1,5003197
yjbJ_predicted,0.75,12,7,AAAAGTCAAATACTTAATAA,5,5021551
yjbJ_predicted,0.42857142857142855,8,6,TTTTTAATAGATCCCGATAT,2,5015580
yjbJ_predicted,5.285714285714286,42,6,TTGGCCGCAGTGTAAGTTAA,36,5008474
yjbJ_predicted,1.0,12,6,TTCTAAAATACACACCGTCC,6,5029057
yjbJ_predicted,7.0,54,6,TTCGTCACATGGCCGTTGTC,48,5021725
yjbJ_predicted,0.2857142857142857,7,6,TTAGGATTTACGCGCTTCCG,1,5023779
yjbJ_predicted,6.142857142857143,48,6,TTAAATTTACGCTGGTCGAG,42,5010756
yjbJ_predicted,0.2857142857142857,7,6,TGTCAGGCAGGGTGAAAGTT,1,5014856
yjbJ_predicted,5.285714285714286,42,6,TGGGCTTCTTGGGTTGTCCA,36,4997812
yjbJ_predicted,1.5714285714285714,16,6,TGGCGAGTGAGGACCTCAAA,10,5023404
yjbJ_predicted,0.2857142857142857,7,6,TGGATCTTACGTCTTGTAAG,1,5018935
yjbJ_predicted,7.142857142857143,55,6,TGCGACCATGATCGGCTAGT,49,5005620
yjbJ_predicted,0.2857142857142857,7,6,TGCACTCCTAGGCTGTAAGA,1,5010874
yjbJ_predicted,6.571428571428571,51,6,TGCAAGCAGTGCGTTTCAGA,45,5002315
yjbJ_predicted,0.2857142857142857,7,6,TGACCCTACATTCTTAACTC,1,5025510
yjbJ_predicted,5.571428571428571,44,6,TGAAGCACTTGTTTTCGTTG,38,5001313
yjbJ_predicted,0.2857142857142857,7,6,TCGGACCCCCAGCCAAAGAA,1,4999245
yjbJ_predicted,5.0,40,6,TCGCATATTGCGGGTCTAAG,34,5009101
yjbJ_predicted,3.5714285714285716,30,6,TCGCAATAATGGTTCATATC,24,5006304
yjbJ_predicted,0.42857142857142855,8,6,TCATATTCGCCGACTCTAAG,2,4998022
yjbJ_predicted,1.5714285714285714,16,6,TCAGGGAAATTGGTACTGTT,10,5007144
yjbJ_predicted,7.285714285714286,56,6,TATCCTACTATTGGATATGG,50,5001163
yjbJ_predicted,3.0,26,6,TATCCACCAGCGTATTCGAC,20,5004081
yjbJ_predicted,16.285714285714285,119,6,TAGGCAAGCAGTCTTCTGCA,113,4999015
yjbJ_predicted,1.4285714285714286,15,6,TAGACTAGAGAGATTTGATG,9,5003276
yjbJ_predicted,8.571428571428571,65,6,TACTCGCAACTCATTCTTCG,59,5002890
yjbJ_predicted,0.2857142857142857,7,6,TACGTCCTCGCCGTCCGGCA,1,5021396
yjbJ_predicted,0.2857142857142857,7,6,TAACGAACATCCCGGAATGG,1,5004699
yjbJ_predicted,0.2857142857142857,7,6,GTTTTAGAACTCCTTTCCCG,1,5001321
yjbJ_predicted,8.571428571428571,65,6,GTTGTCTTAGCTCAATGGGT,59,5022394
yjbJ_predicted,0.42857142857142855,8,6,GTCGATTGGGAACTGGGTTA,2,5017262
yjbJ_predicted,0.2857142857142857,7,6,GTAGGGTCACGGTAGGCAAA,1,5005733
yjbJ_predicted,5.0,40,6,GGTTGACAAAAATTCCTAAC,34,5012453
yjbJ_predicted,9.0,68,6,GGTTATCATGCCTCAAGTCC,62,5021457
yjbJ_predicted,1.5714285714285714,16,6,GGTCGTGTGCTTTTTTTGGG,10,4996414
yjbJ_predicted,7.571428571428571,58,6,GGTATGATTATGGGCTCTGA,52,5023092
yjbJ_predicted,0.2857142857142857,7,6,GGTAAAAGCACCCGGCTCAC,1,5020449
yjbJ_predicted,9.428571428571429,71,6,GGGTAAACTCTATGAGTGTG,65,5030052
yjbJ_predicted,0.42857142857142855,8,6,GGCTATATCAGCCATGATCT,2,5004497
yjbJ_predicted,7.142857142857143,55,6,GGCGCGCATTAGTGGAGGTG,49,5014260
yjbJ_predicted,8.142857142857142,62,6,GGCCCAACACAGCCGCCTTT,56,5023045
yjbJ_predicted,0.5714285714285714,9,6,GGCATGACTAAAATTGTAGT,3,5017134
yjbJ_predicted,0.2857142857142857,7,6,GGAGTCCTACAGCGCTCGGC,1,5016492
yjbJ_predicted,1.2857142857142858,14,6,GCTCCGGCCCGCGTTTGTCC,8,5029217
yjbJ_predicted,0.2857142857142857,7,6,GCCTTTGGGAGATGAACGGA,1,5017010
yjbJ_predicted,0.5714285714285714,9,6,GCACGTCAAATGGGCCTAAT,3,5001948
yjbJ_predicted,0.2857142857142857,7,6,GCAATTCCACCCGAGTGAGC,1,5004144
yjbJ_predicted,5.428571428571429,43,6,GATTTATACACATATGCCCC,37,5020053
yjbJ_predicted,1.2857142857142858,14,6,GATTCACAGGGGTGGAAGTA,8,5018926
yjbJ_predicted,6.0,47,6,GAGTCGCAGGGGTGGCTAGA,41,5000038
yjbJ_predicted,4.428571428571429,36,6,GAGGTGCTGTTTCACGTTAT,30,5013046
yjbJ_predicted,0.2857142857142857,7,6,GACTCTCGGCCGGCCGTACT,1,5015191
yjbJ_predicted,4.285714285714286,35,6,GACGCCTAATTCCTGCTATG,29,5003275
yjbJ_predicted,5.285714285714286,42,6,GAAGGCTATCACGGAACTAG,36,5002841
yjbJ_predicted,12.285714285714286,91,6,CTGTTGTTGCTCTAGTAGCA,85,5027911
yjbJ_predicted,7.714285714285714,59,6,CTGGAGGTGACTACAATTGT,53,5023882
yjbJ_predicted,0.2857142857142857,7,6,CTGGACATCTACCTACAACT,1,5020953
yjbJ_predicted,3.857142857142857,32,6,CTCTGGGACTTAATCGTTCT,26,4996565
yjbJ_predicted,9.0,68,6,CTCTGAATACCCTTGCGAAT,62,5018917
yjbJ_predicted,7.571428571428571,58,6,CTCGGAAGCGAGGTCCTCCA,52,5009030
yjbJ_predicted,10.428571428571429,78,6,CTCCCGGGGGTCACCTCGAT,72,4996290
yjbJ_predicted,0.2857142857142857,7,6,CTCCACGCCAGAGCGGAGGC,1,5007588
yjbJ_predicted,11.571428571428571,86,6,CTCATGCCTATTGCATTCTG,80,5001584
yjbJ_predicted,8.714285714285714,66,6,CGTTATAGGTATCTATTATA,60,5016455
yjbJ_predicted,4.714285714285714,38,6,CGTCGTTAGGGTCTGGAAGG,32,4997646
yjbJ_predicted,0.2857142857142857,7,6,CGGGTCAGTAATTCTTCAAC,1,5005616
yjbJ_predicted,5.571428571428571,44,6,CGGCGCGCGGACACGTTACA,38,5002477
yjbJ_predicted,7.428571428571429,57,6,CGGCATAGTCATAGTGGGTA,51,5004785
yjbJ_predicted,5.857142857142857,46,6,CGGATCTGATGCGCATAAGA,40,4997002
yjbJ_predicted,0.2857142857142857,7,6,CGCTAGGAGCGGGTAAACGG,1,5013223
yjbJ_predicted,2.142857142857143,20,6,CGCGGCGGGTGGCCGATGTC,14,4994996
yjbJ_predicted,0.2857142857142857,7,6,CGCCGATAAGGGGCCAGTTG,1,5012688
yjbJ_predicted,5.857142857142857,46,6,CGACGGCTTCCTGCACAATG,40,5016028
yjbJ_predicted,6.857142857142857,53,6,CCGCGTCAACCCGGGGGCAA,47,5010440
yjbJ_predicted,11.428571428571429,85,6,CCGCAGCCTTTCCGGGGGTA,79,5019340
yjbJ_predicted,0.5714285714285714,9,6,CCGACACGCCTGGTTAATCC,3,5022054
yjbJ_predicted,5.714285714285714,45,6,CCCCCGTTCTGTTGAGGAAT,39,5013873
yjbJ_predicted,0.2857142857142857,7,6,CCCAGGAATCACCTTGTATT,1,5011122
yjbJ_predicted,7.857142857142857,60,6,CCCACATCAGCCTACACGAC,54,5022145
yjbJ_predicted,0.2857142857142857,7,6,CATTTATATTCTTACACGAG,1,4998353
yjbJ_predicted,9.142857142857142,69,6,CAGTTGCAGGAAGGGTACAA,63,4999391
yjbJ_predicted,0.2857142857142857,7,6,CAGGTTTGAAGTAGTCGGAT,1,5029519
yjbJ_predicted,2.2857142857142856,21,6,CACTGAGTGTGACCGGGCTT,15,5001476
yjbJ_predicted,5.0,40,6,CACGTTTAGGATAATCCAGT,34,4997982
yjbJ_predicted,6.285714285714286,49,6,CACGGTTATTAGGTAAAAGA,43,5012439
yjbJ_predicted,6.714285714285714,52,6,CACCTCCCTGCTTGGTCCAA,46,5023958
yjbJ_predicted,0.2857142857142857,7,6,CAATCCTTTCGAGTTCGTTG,1,5020769
yjbJ_predicted,5.285714285714286,42,6,ATTTCTTATATGTCGGCTTA,36,5012237
yjbJ_predicted,7.0,54,6,ATTACAGAGCGGAATGGTTC,48,5005285
yjbJ_predicted,0.2857142857142857,7,6,ATGCAACAAATTCAGCGAGT,1,5015375
yjbJ_predicted,3.7142857142857144,31,6,ATCGAGCACAGTGGCGGCCT,25,5013147
yjbJ_predicted,6.142857142857143,48,6,ATAGTGACGAGGTTGATGAA,42,5001647
yjbJ_predicted,0.2857142857142857,7,6,ATACACCTAATTAGGAATAT,1,5016910
yjbJ_predicted,2.142857142857143,20,6,ATAATAAGAGGATTAAACCT,14,5026760
yjbJ_predicted,6.714285714285714,52,6,ATAAGCTGCAATGCAGGGAT,46,5028322
yjbJ_predicted,12.428571428571429,92,6,AGTACCCGTTTAAGTGGCAG,86,5014343
yjbJ_predicted,0.2857142857142857,7,6,AGGTGACTCGGGTTGTCTTG,1,5013308
yjbJ_predicted,3.5714285714285716,30,6,AGCGTGGACGGTGGCGTTTC,24,4999401
yjbJ_predicted,4.285714285714286,35,6,AGCATGCTATTTTTAAAGAC,29,4999832
yjbJ_predicted,8.285714285714286,63,6,AGCAACTGGTACCTAGGGTT,57,5016290
yjbJ_predicted,7.285714285714286,56,6,AGAGGTATGGGCGTTACCCT,50,5017678
yjbJ_predicted,4.0,33,6,ACTTGCGGCCAAGACGGTCC,27,5016490
yjbJ_predicted,7.857142857142857,60,6,ACTTCCAACGAGAGAGTTGA,54,5025846
yjbJ_predicted,5.285714285714286,42,6,ACTGGCCCATGCGACGCGAG,36,5006699
yjbJ_predicted,0.2857142857142857,7,6,ACTCACGGTGCCCCGGGATG,1,5028115
yjbJ_predicted,7.428571428571429,57,6,ACGTCACAATATCGCGACAC,51,5023130
yjbJ_predicted,0.2857142857142857,7,6,ACGGTTAATAGGTCTAAGTC,1,5020148
yjbJ_predicted,7.571428571428571,58,6,ACGGTCATAATCGAATTGAT,52,5021235
yjbJ_predicted,6.285714285714286,49,6,ACGGCGAATCCTGTGCAAGG,43,5000808
yjbJ_predicted,0.2857142857142857,7,6,ACGCCTCGTGTTGGTATTGC,1,5006931
yjbJ_predicted,6.714285714285714,52,6,ACGACACGCGTGGTGTTTAC,46,5010028
yjbJ_predicted,0.42857142857142855,8,6,ACCGCTACGTCCCACTTGAT,2,5005331
yjbJ_predicted,5.857142857142857,46,6,ACAATGAGATCGGTCGGGGT,40,5003491
yjbJ_predicted,6.428571428571429,50,6,AAGTGTTTTCCTGGACGGGG,44,5000912
yjbJ_predicted,7.857142857142857,60,6,AAGTGGGTAGGATGGGTCCG,54,4998487
yjbJ_predicted,7.428571428571429,57,6,AAGGTGGCATCTACTTTCAC,51,5020284
yjbJ_predicted,2.5714285714285716,23,6,AACTGAGAATCCGATAGCGT,17,5020768
yjbJ_predicted,0.3333333333333333,6,5,TTTTTGAATTTTCCCGCCGT,1,5012905
yjbJ_predicted,0.3333333333333333,6,5,TTTTACATGGTTCTTAGGTT,1,5002787
yjbJ_predicted,9.166666666666666,59,5,TTTAATATGAACGTTCCAGT,54,5029857
yjbJ_predicted,3.3333333333333335,24,5,TTGACCAAAGACTCTCTTTT,19,5008722
yjbJ_predicted,0.6666666666666666,8,5,TTCTGTGTGTATACAGGTTC,3,5012497
yjbJ_predicted,11.5,73,5,TTCGAAGGTCCAAGTGGAAC,68,5019386
yjbJ_predicted,8.333333333333334,54,5,TTCGAAAGTGGGGTACGTTT,49,5023457
yjbJ_predicted,0.3333333333333333,6,5,TTCCTCCGGCTATTGTCCGT,1,4996203
yjbJ_predicted,0.3333333333333333,6,5,TTCCATGAAGCGATCATTCA,1,5005840
yjbJ_predicted,3.8333333333333335,27,5,TTAGAGTACTGAGATGCACA,22,5025757
yjbJ_predicted,5.5,37,5,TGTGGAGCAGTTCAGCAAAG,32,4999466
yjbJ_predicted,0.3333333333333333,6,5,TGTCGTGGCTTGCTGACAGA,1,5001865
yjbJ_predicted,8.666666666666666,56,5,TGGGGAGTGGAGTCAGCCCG,51,5018650
yjbJ_predicted,4.166666666666667,29,5,TGGCCGTCGCTGCGTTTAAT,24,4999337
yjbJ_predicted,0.3333333333333333,6,5,TCTCCGACAGTCCTGAGCAA,1,5022055
yjbJ_predicted,20.333333333333332,126,5,TCGGGCGCAATGCGTGTCCA,121,5003672
yjbJ_predicted,4.5,31,5,TCGAAGCGTCTTTCTCAGTT,26,5000276
yjbJ_predicted,6.666666666666667,44,5,TCCGTACAATCGTGACCGAA,39,5015013
yjbJ_predicted,4.166666666666667,29,5,TCCAAGCGAACAGTTGGCAA,24,5016906
yjbJ_predicted,8.5,55,5,TCATCGTTGCCTCGGCCCTA,50,5021778
yjbJ_predicted,7.166666666666667,47,5,TCAGAAGCTCCCCAGGCGAC,42,4997356
yjbJ_predicted,0.3333333333333333,6,5,TATACCACGGGATCACACAG,1,5015465
yjbJ_predicted,0.3333333333333333,6,5,TAGGCTCTCAAGGCCCACCG,1,4995752
yjbJ_predicted,6.333333333333333,42,5,TAGATGCAGGCGCCTAAGCA,37,5010323
yjbJ_predicted,9.0,58,5,TACCGTCACTCATCTTGAGC,53,5007145
yjbJ_predicted,5.5,37,5,GTTCTTATTTCAGTTGATTA,32,5025241
yjbJ_predicted,2.0,16,5,GTGAGGCCGAAGGTCGTGAT,11,5013821
yjbJ_predicted,0.5,7,5,GTCTTTGAGAAGTATATGTC,2,5001823
yjbJ_predicted,0.3333333333333333,6,5,GTCGATTTTGCAAAGTTTCG,1,5029363
yjbJ_predicted,7.833333333333333,51,5,GTCGATGCGACATTCCCAGG,46,5017532
yjbJ_predicted,0.3333333333333333,6,5,GTAGCAATTTGCAAACGCAG,1,5026628
yjbJ_predicted,6.333333333333333,42,5,GTAACTCTATGCCTCACCTT,37,4996630
yjbJ_predicted,1.8333333333333333,15,5,GGTCAAACGCCTAAACGTAT,10,4996336
yjbJ_predicted,0.3333333333333333,6,5,GGTACCCACAAACCCCCGTG,1,5020975
yjbJ_predicted,11.0,70,5,GGACGTTGACGTCATTGGGA,65,5024558
yjbJ_predicted,0.3333333333333333,6,5,GCTGATCTGAGCTTCTTTCC,1,5005959
yjbJ_predicted,5.666666666666667,38,5,GCTCGATAAGTATGTGTCGC,33,5027135
yjbJ_predicted,10.333333333333334,66,5,GCGTGAAGGATTACCAGGAG,61,5028560
yjbJ_predicted,0.5,7,5,GCGTGAAAAGTCCCCATATA,2,4998351
yjbJ_predicted,6.666666666666667,44,5,GCCCCACGCCCGTGCACTAC,39,5022680
yjbJ_predicted,8.0,52,5,GCCAAGCCCCACATCGCGCC,47,5006899
yjbJ_predicted,7.666666666666667,50,5,GCAATTCTCGCTAGGAGTGG,45,5017185
yjbJ_predicted,0.3333333333333333,6,5,GATTGATTCGCGCCGTCCCA,1,5021756
yjbJ_predicted,8.166666666666666,53,5,GATTAATCTGATACGTACTT,48,4995747
yjbJ_predicted,7.833333333333333,51,5,GATCGCCTATGTAGTACTCC,46,5022772
yjbJ_predicted,0.5,7,5,GATAAGATCCACTAATGCGG,2,5020147
yjbJ_predicted,6.833333333333333,45,5,GAGCCGCACAATCTGCTGCG,40,5000355
yjbJ_predicted,21.5,133,5,GACGAGTTTAGATAGTTCCT,128,5000482
yjbJ_predicted,0.3333333333333333,6,5,GAATCTGGATTGTTTAACTT,1,5005432
yjbJ_predicted,10.5,67,5,CTTTTCGTTGCAAGTAGTGC,62,5005358
yjbJ_predicted,2.0,16,5,CTTGAGATGCTGCAAGTGAA,11,4998794
yjbJ_predicted,0.3333333333333333,6,5,CTTCGGATCTGCTAGGCTCA,1,5005086
yjbJ_predicted,8.5,55,5,CTCCGAGATGTGGTGAACAA,50,5030043
yjbJ_predicted,8.666666666666666,56,5,CTCATTACAAGATAGTGGGT,51,5019411
yjbJ_predicted,0.3333333333333333,6,5,CTCAGTGTGTTCCGGTAGTA,1,5011776
yjbJ_predicted,7.5,49,5,CGTCCCCTCCATTATCTGAA,44,5020957
yjbJ_predicted,0.3333333333333333,6,5,CGGCAGATATGACACATTTG,1,5003068
yjbJ_predicted,14.833333333333334,93,5,CGCAAGCGGTCAAGCCCGCG,88,4995285
yjbJ_predicted,12.333333333333334,78,5,CGACCAAGACCACTCGAAGC,73,5024907
yjbJ_predicted,2.1666666666666665,17,5,CGACAGGCCAACCATTCATT,12,5001661
yjbJ_predicted,11.5,73,5,CGAATACAAGGCCCAAGTAG,68,5023806
yjbJ_predicted,0.3333333333333333,6,5,CGAACTCTACACGGTCTATA,1,5020734
yjbJ_predicted,11.333333333333334,72,5,CCTCGGATCCCGTCTTGTAG,67,5024301
yjbJ_predicted,7.333333333333333,48,5,CCGTCCGTACGTCAGCTGGG,43,4999704
yjbJ_predicted,8.0,52,5,CCCGGCAGTGTGCCCTCACA,47,4997116
yjbJ_predicted,20.166666666666668,125,5,CATGCCTGAAACTATAGCTC,120,5019757
yjbJ_predicted,1.0,10,5,CATCCTCTGTTGTTACGCTC,5,5023867
yjbJ_predicted,7.333333333333333,48,5,CATACCTAGTCGCGGATGCA,43,5022848
yjbJ_predicted,2.5,19,5,CACTCCCACATGGCTTAGGG,14,5004866
yjbJ_predicted,8.166666666666666,53,5,ATTTGGGACACAAAGGGTCG,48,5018542
yjbJ_predicted,5.666666666666667,38,5,ATGTTGCGTTTTGCGGTTAA,33,5012128
yjbJ_predicted,0.3333333333333333,6,5,ATGGGTGAACTGTATAGCGG,1,4995423
yjbJ_predicted,10.5,67,5,ATGGGGGTAAGTCTCTGCCC,62,5005013
yjbJ_predicted,3.3333333333333335,24,5,ATGCCATCGTGTGACTCCAT,19,5003899
yjbJ_predicted,0.3333333333333333,6,5,ATCCATGCTTCTTCTATAAA,1,5006207
yjbJ_predicted,2.1666666666666665,17,5,ATCATTTCGGTAATCGGCCC,12,4995429
yjbJ_predicted,3.3333333333333335,24,5,ATATCGCCGGGACTCTGCGA,19,5022020
yjbJ_predicted,6.666666666666667,44,5,ATAGCATTCCGAACTCAGGG,39,5024625
yjbJ_predicted,9.666666666666666,62,5,AGAAGGTGTGCGTAAACTTA,57,4996507
yjbJ_predicted,3.0,22,5,ACTCGGGGCCGTACAACCAT,17,5017724
yjbJ_predicted,6.5,43,5,ACTATGCTTGGGCATTGAGC,38,5017469
yjbJ_predicted,4.5,31,5,ACCGGGCTATAGGCGTATAC,26,5019271
yjbJ_predicted,5.333333333333333,36,5,ACCCTGTAGAGAAGTGTGGA,31,5005985
yjbJ_predicted,3.3333333333333335,24,5,ACATAGCACGTAGGCGAGGC,19,5017249
yjbJ_predicted,1.0,10,5,ACAGATGAAATTTGGAGATG,5,5005469
yjbJ_predicted,0.3333333333333333,6,5,ACAGACTCTGTTTTTCCGCT,1,5012058
yjbJ_predicted,6.5,43,5,ACACGCTGGGCGGCGTAGCC,38,5016279
yjbJ_predicted,0.3333333333333333,6,5,AATGTCACAGACAATGCCCT,1,5013056
yjbJ_predicted,9.333333333333334,60,5,AAGCGGGTCATATTTTCCCA,55,5010216
yjbJ_predicted,7.833333333333333,51,5,AAGCCGTTCAAGTGTAATAA,46,5012166
yjbJ_predicted,3.8333333333333335,27,5,AACGAGGTCGAAATTGCGCT,22,4996989
yjbJ_predicted,3.3333333333333335,24,5,AAAGTTAGGCCCGCTTACAA,19,5018180
yjbJ_predicted,6.333333333333333,42,5,AAAGGCAAAGAACATAATTG,37,5000439
yjbJ_predicted,6.833333333333333,45,5,AAACCTACGTGCAGTGTGAA,40,4995384
yjbJ_predicted,3.3333333333333335,24,5,AAACCATATTATATTTAGTG,19,5018461
yjbJ_predicted,0.6,6,4,TTGGAAGCTCGCCTCTATAA,2,4996247
yjbJ_predicted,7.6,41,4,TTCAGTGAGGATTGCGATAG,37,5016395
yjbJ_predicted,1.8,12,4,TTCAGGCCCACGCCATCAGA,8,4999425
yjbJ_predicted,2.8,17,4,TTCAGCACTTATCGTCACCT,13,5006354
yjbJ_predicted,10.2,54,4,TTATCTAGCTTAGGGATAAG,50,5005748
yjbJ_predicted,9.4,50,4,TTATCATTCGGTGGTGATCC,46,4999369
yjbJ_predicted,6.4,35,4,TTAATCCATCTAGTCTAAGA,31,5000369
yjbJ_predicted,0.6,6,4,TGTGTAAGTGTCGAATACGA,2,5007542
yjbJ_predicted,0.4,5,4,TGTGGACTGATATGTGATGG,1,5010160
yjbJ_predicted,8.8,47,4,TGTAATCCCATGGGTCATGA,43,4999614
yjbJ_predicted,0.6,6,4,TGGTAGCCGGGAATGGAGAT,2,5016612
yjbJ_predicted,1.0,8,4,TGGCGAATGCATGCGTGATG,4,5027913
yjbJ_predicted,0.4,5,4,TGGCAGGATTATCGCCTATG,1,4997520
yjbJ_predicted,10.0,53,4,TGGAAGTGCGACACCATGGT,49,5021364
yjbJ_predicted,15.6,81,4,TGGAACGGATTCCTGAATTG,77,5018533
yjbJ_predicted,20.4,105,4,TGCTTGAGGGGTCATCAGCT,101,4997055
yjbJ_predicted,7.0,38,4,TGCGGTCAGACCCAGGAAGG,34,5007633
yjbJ_predicted,0.4,5,4,TCTGCATCGCATGACGAGGG,1,5011513
yjbJ_predicted,8.6,46,4,TCTCCAACGTTTATTACTAA,42,5019001
yjbJ_predicted,8.2,44,4,TCGGGTGCTCGTGTGCCCAT,40,4996954
yjbJ_predicted,10.2,54,4,TCGAGTGACATGTGGTCAGA,50,5018228
yjbJ_predicted,5.6,31,4,TCCTCCGAAGCGGGTGTACG,27,4998578
yjbJ_predicted,19.2,99,4,TCCGCCATCTTCTATTGTAA,95,5026926
yjbJ_predicted,9.0,48,4,TCACGCCATCCCCCGGTCAC,44,5010919
yjbJ_predicted,3.4,20,4,TATCGTTTCGGGACTTCGCC,16,4997442
yjbJ_predicted,0.4,5,4,TATAAGGCACCATATGATAA,1,5003673
yjbJ_predicted,0.6,6,4,TAGGCCGGCGGCCGAATGGA,2,5012961
yjbJ_predicted,4.8,27,4,TAGCTTCCTGAAGAGAATGA,23,5015339
yjbJ_predicted,0.4,5,4,TACGCGACCTGTAAAAAATG,1,5024172
yjbJ_predicted,0.4,5,4,TACCCGACCAGACTAGGCTT,1,5002357
yjbJ_predicted,0.4,5,4,GTTGCAGATGTCTTCGCGCC,1,5007794
yjbJ_predicted,0.4,5,4,GTTCTTGGGTGTTAACTCTA,1,5003513
yjbJ_predicted,6.0,33,4,GTTCTCCTCTGGACGGTACC,29,4994902
yjbJ_predicted,7.0,38,4,GTTATTTCTGGCTGTTAATA,34,4998521
yjbJ_predicted,12.6,66,4,GTGTTCACTAGACCATTTAG,62,5026334
yjbJ_predicted,9.0,48,4,GTCTTGGTAGTGCACTTAGA,44,5028915
yjbJ_predicted,11.6,61,4,GTCTTGATCGTGTGCGGCCT,57,5007308
yjbJ_predicted,7.2,39,4,GTCCAAGCTCCTAAGAAATT,35,4995345
yjbJ_predicted,9.6,51,4,GTCAGCACACGAATAAGGCA,47,5031028
yjbJ_predicted,1.2,9,4,GGTTTCGCTCTTGTACACCC,5,5009409
yjbJ_predicted,20.8,107,4,GGTTGCAACGTATGAGTCAT,103,5008284
yjbJ_predicted,5.6,31,4,GGTGCTCGATCAATACTTAC,27,5020079
yjbJ_predicted,6.8,37,4,GGGCATGCAGAAGCTAGCTT,33,5018301
yjbJ_predicted,0.4,5,4,GGCGGGTGCGAAAAGCAAAT,1,4996087
yjbJ_predicted,12.6,66,4,GGAATCAGTTATACCTGGCC,62,5008913
yjbJ_predicted,0.4,5,4,GCTGGCAAGCTTTGGGAATC,1,5004880
yjbJ_predicted,0.4,5,4,GCGAGGCGGGCCACGGTGCA,1,4995553
yjbJ_predicted,0.4,5,4,GCGAACCTTGGCTCACTGAG,1,4994766
yjbJ_predicted,9.0,48,4,GCCTAACGGGCTCTCACGGA,44,5026900
yjbJ_predicted,0.4,5,4,GCATGTTCTACAACGATTGG,1,5015528
yjbJ_predicted,0.4,5,4,GATGCACATCGGCCGTCTTA,1,5006366
yjbJ_predicted,0.4,5,4,GAGCCCATTAGGCCCTATAG,1,5005646
yjbJ_predicted,9.6,51,4,GACGCCGAAGCGCTTGACAA,47,5009955
yjbJ_predicted,0.4,5,4,CTGTCGCACAGGTGCTCTGA,1,4994997
yjbJ_predicted,1.0,8,4,CTCTAGTATAAGTCGAAATT,4,5005052
yjbJ_predicted,8.0,43,4,CTCGGCGTGGGCGGTTCGCG,39,4999551
yjbJ_predicted,8.6,46,4,CTCATTTAGGCCCTAACGTG,42,4996459
yjbJ_predicted,0.4,5,4,CTAGAAAGGGTGAGCGGTTG,1,5020300
yjbJ_predicted,6.8,37,4,CGTTGCGGTCACGGGCCAAT,33,5007119
yjbJ_predicted,0.4,5,4,CGTACTGCGTACCTCAACTT,1,5015336
yjbJ_predicted,9.0,48,4,CGGGGCTTACTCGGGGCTAG,44,4997126
yjbJ_predicted,7.4,40,4,CGGGCCGTAGGGGTTCTATT,36,5025722
yjbJ_predicted,0.4,5,4,CGGAGCTCCATTGAGTATTG,1,5012362
yjbJ_predicted,5.8,32,4,CGCGGGTACGGAAGCCTTGG,28,5021045
yjbJ_predicted,0.6,6,4,CGATGCCACCGTATGATCTG,2,5018565
yjbJ_predicted,0.4,5,4,CCTTGCCCTTGCAACCCAGA,1,5000623
yjbJ_predicted,7.6,41,4,CCTATACGCAGGTAGGTACA,37,5013587
yjbJ_predicted,0.4,5,4,CCGGAGGCCATAAGGACCTC,1,5022644
yjbJ_predicted,5.0,28,4,CCGCACGTATAAATGCACAT,24,5016494
yjbJ_predicted,4.8,27,4,CCACTTTCGCCGTCAAGGGC,23,4998734
yjbJ_predicted,10.6,56,4,CCACTACGAGCATCCTCATG,52,5015543
yjbJ_predicted,6.2,34,4,CCACCTGACCGGGGGCACAA,30,5002412
yjbJ_predicted,9.0,48,4,CCAATCCGCACCGGGTTTAT,44,5020940
yjbJ_predicted,0.4,5,4,CATTTTGGATCGTATTAGAC,1,5025281
yjbJ_predicted,0.6,6,4,CATGATGCCGTGCAAGTTAA,2,5006251
yjbJ_predicted,1.4,10,4,CATCTGGGCAACTTCTGTAT,6,5023544
yjbJ_predicted,10.8,57,4,CATCCTAACGATTAATAAAT,53,5005769
yjbJ_predicted,0.4,5,4,CATATTTAGGATTGACAGAT,1,5020426
yjbJ_predicted,0.4,5,4,CAGTATGGTGTATACGTTTC,1,5026895
yjbJ_predicted,5.4,30,4,CAGCAAATTCGAGATTGGTA,26,5024783
yjbJ_predicted,7.2,39,4,CACTTAGTCTTAGACATGAA,35,5023526
yjbJ_predicted,6.0,33,4,CACTGGTGACCCTTCCGACG,29,5009934
yjbJ_predicted,0.4,5,4,CAATCTGGGTCCGTCATTAT,1,5010935
yjbJ_predicted,7.4,40,4,CAAAGGGGTAGCCACCGGAC,36,5013903
yjbJ_predicted,0.4,5,4,CAAAAGAGATGCAGGATTAG,1,5013598
yjbJ_predicted,1.0,8,4,ATTAAGGTACCCGGCGCCTG,4,5029714
yjbJ_predicted,0.4,5,4,ATGCAGTCAGACCACCACGC,1,5003212
yjbJ_predicted,16.4,85,4,ATCCGAGTGGACATAACTTA,81,4997455
yjbJ_predicted,0.4,5,4,ATCCGAGGCGGAAATGAGTG,1,5029974
yjbJ_predicted,6.0,33,4,ATCCAACAAGCTCCCATTAG,29,5007499
yjbJ_predicted,0.4,5,4,ATATAGTGTATGAAGAGCTT,1,4997693
yjbJ_predicted,0.4,5,4,ATAGTTCACGCATGCAAGCG,1,5017120
yjbJ_predicted,10.4,55,4,ATAAAAAACCTGTCATGCAA,51,5021295
yjbJ_predicted,0.4,5,4,AGTAGAAACCTAGGAAGGGA,1,5017956
yjbJ_predicted,4.8,27,4,AGCGTGAACACTAAGGGCCA,23,5031032
yjbJ_predicted,4.8,27,4,AGCGTAACAGACGTAATGAG,23,4997288
yjbJ_predicted,8.8,47,4,AGAGCAGACTGTTGTTCACT,43,5016730
yjbJ_predicted,0.4,5,4,AGAATAGTACACAAATATCG,1,5001636
yjbJ_predicted,0.6,6,4,ACGCACTTTTGCCCGAGAAC,2,5001166
yjbJ_predicted,7.0,38,4,ACCGTGTCCGAAGGGATAGG,34,5026818
yjbJ_predicted,0.6,6,4,ACCCATAAATCGAGGGATTA,2,5028125
yjbJ_predicted,0.4,5,4,ACATTTGCACTGCATATCGG,1,4998894
yjbJ_predicted,12.6,66,4,ACATGTACCGTGCGCCTACT,62,4995703
yjbJ_predicted,9.0,48,4,ACAGGAGCCCTTAGCGGACA,44,5019435
yjbJ_predicted,4.4,25,4,ACAGAAGGCAGACGCGACCG,21,5021407
yjbJ_predicted,5.0,28,4,ACAAGTTCATTCCAGCCGGT,24,5005458
yjbJ_predicted,7.8,42,4,AATTCACTAGCCCAGCAAAT,38,5006037
yjbJ_predicted,0.4,5,4,AATCTTGCTTTTAGTTGCGA,1,5019491
yjbJ_predicted,12.8,67,4,AATCCTCACGGTCCCTCTCC,63,5025588
yjbJ_predicted,8.8,47,4,AAGTATAGTGTGCACGGTAC,43,5018064
yjbJ_predicted,0.4,5,4,AACTCACTGGAATACAGCTT,1,5005271
yjbJ_predicted,0.4,5,4,AACTAGGAGTCGTTTCGTTG,1,5017299
yjbJ_predicted,0.5,4,3,TTTTGATCCACATCGCTTTT,1,5027056
yjbJ_predicted,5.0,22,3,TTTAGGATGGATAGTTATTG,19,5028445
yjbJ_predicted,10.75,45,3,TTCGGATTCGCACTCACCCG,42,5022882
yjbJ_predicted,0.75,5,3,TTCAGGATGCTGGCAGAGGG,2,4994775
yjbJ_predicted,18.25,75,3,TTCACACGTCTCGGGATATC,72,5025851
yjbJ_predicted,1.25,7,3,TTATTCCGTCTGTCGTAAAG,4,5007245
yjbJ_predicted,8.75,37,3,TTAATGTGGGCACCCGGTCC,34,4996600
yjbJ_predicted,15.5,64,3,TGTTTCAGTTTTAAGAAAGT,61,4996118
yjbJ_predicted,1.5,8,3,TGTTTAGTTCTGCATTATCT,5,4997694
yjbJ_predicted,0.5,4,3,TGTGGACAATGGCCGGATGC,1,5021805
yjbJ_predicted,10.25,43,3,TGGGATGTGCCTGTGTGTAT,40,5008257
yjbJ_predicted,0.5,4,3,TGGAACCAATTGTCAGATTT,1,5019358
yjbJ_predicted,5.5,24,3,TGCTAGACTGAGCATCGTTA,21,5002951
yjbJ_predicted,10.0,42,3,TGCCTTCGGCGTGTCGCAGA,39,5029031
yjbJ_predicted,8.75,37,3,TGCAATCCGTTACGGTCCAC,34,5003635
yjbJ_predicted,0.5,4,3,TGATTTGTCGCTCCCGTGTT,1,5019983
yjbJ_predicted,12.5,52,3,TGATTGCCATCCTCCTAATC,49,5000948
yjbJ_predicted,8.0,34,3,TGATCCTCATCTGGTATGGA,31,5025491
yjbJ_predicted,0.5,4,3,TGAGGGCCGTTGGACCAATA,1,5006042
yjbJ_predicted,11.25,47,3,TCTTTTGGAAGGCTACGCCT,44,5005771
yjbJ_predicted,8.0,34,3,TCTTCTATCGACAACCAGAA,31,4995092
yjbJ_predicted,10.75,45,3,TCTCCTACCACCAGACTCGC,42,5027138
yjbJ_predicted,0.5,4,3,TCTAACATGGATGCGGAAAG,1,5018050
yjbJ_predicted,0.5,4,3,TCGGGCTGAATAGTTTGGTG,1,5018755
yjbJ_predicted,25.25,103,3,TCGGCAAAGCGATGCGTCTA,100,5014475
yjbJ_predicted,5.0,22,3,TCGCCACAAATGTGCCTATT,19,5010843
yjbJ_predicted,12.5,52,3,TCGAATTCGGAATCTTCAAA,49,5011834
yjbJ_predicted,11.5,48,3,TCCGGCCAGACTCGCGGTCA,45,5021748
yjbJ_predicted,2.75,13,3,TCACCCTAACACGGATCTTC,10,5001686
yjbJ_predicted,10.5,44,3,TATTCGTTCGGACCATTGTA,41,5026324
yjbJ_predicted,9.5,40,3,TATGCCCCAATGCGATGTAT,37,5021450
yjbJ_predicted,8.25,35,3,TAGCAGTACACGCATTTTGT,32,5023811
yjbJ_predicted,11.75,49,3,TAGCAAGCGGTCCCTTAGTA,46,5020065
yjbJ_predicted,8.75,37,3,TAACGTGTGTTACCGCACCA,34,5003504
yjbJ_predicted,10.0,42,3,GTTACACGACAGATGGACTC,39,5015943
yjbJ_predicted,0.5,4,3,GTGTGCAGAGGTGCCGCCAT,1,5002427
yjbJ_predicted,3.25,15,3,GTGGTGCGATACGGGTCGGT,12,5008458
yjbJ_predicted,8.5,36,3,GTGGGATCTCGTACACGTCT,33,5025981
yjbJ_predicted,12.5,52,3,GTATTATCATCTGATAACGC,49,5020032
yjbJ_predicted,0.5,4,3,GTAAGAGTGACAACGGAGTT,1,5021303
yjbJ_predicted,8.0,34,3,GGTTAGAAATGTAAGAGCCT,31,5000640
yjbJ_predicted,7.0,30,3,GGGAGCGTCTTGTAGAGTAC,27,5001592
yjbJ_predicted,11.75,49,3,GGCTATCCGGAACGTCGTTA,46,5020806
yjbJ_predicted,0.5,4,3,GGCGATACAGATACAGGTTG,1,4999114
yjbJ_predicted,16.0,66,3,GGAGTTCGTGTGATCATCCT,63,5027148
yjbJ_predicted,28.0,114,3,GCTCCTCGGTCTATTTCCCC,111,4999318
yjbJ_predicted,4.5,20,3,GCTACAATTGTGGATACCCG,17,5011392
yjbJ_predicted,9.75,41,3,GCGCGAAATTCACAGAGTCC,38,5017762
yjbJ_predicted,9.0,38,3,GCCTATAATCGAGATTCAGG,35,5012188
yjbJ_predicted,13.75,57,3,GCCGAGCTAATGTGGAAGCA,54,5011080
yjbJ_predicted,3.75,17,3,GCCCAACCGCTGAATCGCAT,14,5003069
yjbJ_predicted,0.5,4,3,GCCATGAGATCCGTAAACAG,1,5011785
yjbJ_predicted,17.25,71,3,GCATCGGGACTGTTCCTACT,68,5010206
yjbJ_predicted,12.0,50,3,GCAGCGATTAGCGCGACACA,47,5002633
yjbJ_predicted,0.75,5,3,GATCCGAGGAACGAATTGGA,2,5020964
yjbJ_predicted,0.5,4,3,GAGAATCACCGCCTGAAGGT,1,5014113
yjbJ_predicted,0.5,4,3,GAATGTTTCGGTTGTATTGA,1,5011213
yjbJ_predicted,14.75,61,3,GAACGCGGTGAGTACCAACG,58,5009902
yjbJ_predicted,12.75,53,3,GAACCTAAGTATCCGACGGG,50,5029492
yjbJ_predicted,0.5,4,3,GAAATATGTGGCTGTGACGT,1,5028731
yjbJ_predicted,0.5,4,3,CTTTGAAGAGAGGTATATAA,1,5025242
yjbJ_predicted,14.25,59,3,CTTGGCATAACCAGAGTCCT,56,5025044
yjbJ_predicted,6.25,27,3,CTGGTTTGCCGTGGCATAAG,24,4999342
yjbJ_predicted,0.5,4,3,CTGCGGGTTAATACCAGCTT,1,5005256
yjbJ_predicted,1.25,7,3,CTGAGGCGTTGCCGTAATCT,4,5014440
yjbJ_predicted,18.0,74,3,CTCACGCCAATCCAAGGGTC,71,4995463
yjbJ_predicted,0.5,4,3,CTATAGCCAGACGAATGGTT,1,5029806
yjbJ_predicted,0.5,4,3,CGTGTGAGTCCGCAGGTCAG,1,5021535
yjbJ_predicted,0.5,4,3,CGTAATTAGCTTTCTGGGCT,1,5015088
yjbJ_predicted,8.25,35,3,CGGTCACTTCAACGTCGGAA,32,5024166
yjbJ_predicted,13.25,55,3,CGGGTGTACAACTGGTTCGA,52,5005209
yjbJ_predicted,0.5,4,3,CGGGGTTAGACCGTCTCGAT,1,5026753
yjbJ_predicted,12.0,50,3,CGATAACGCATGTCTTTTGC,47,5015462
yjbJ_predicted,11.0,46,3,CGAATCTACAAATACGCGCC,43,5022965
yjbJ_predicted,10.75,45,3,CCTTCGGAAGTAACCTTGCC,42,5006520
yjbJ_predicted,4.5,20,3,CCAGCCGAACCTGTTAGTTC,17,5023384
yjbJ_predicted,0.5,4,3,CAGTACGACTACCTAACACT,1,5012041
yjbJ_predicted,0.5,4,3,CAGAACCATGGACGGGTTGT,1,5009954
yjbJ_predicted,9.25,39,3,CACATAGTAGGGCCAAAATG,36,5024996
yjbJ_predicted,1.25,7,3,ATTATACTAGGGGGGTGATA,4,5023393
yjbJ_predicted,0.5,4,3,ATGTGGAATCTCGGCCGCTG,1,5026629
yjbJ_predicted,0.5,4,3,ATGCGTGACGGGATGGCATT,1,5014182
yjbJ_predicted,0.5,4,3,ATGACTACATACCGCAATAC,1,5025262
yjbJ_predicted,11.75,49,3,ATCTCCAAGCGTCCTACCTC,46,4999645
yjbJ_predicted,11.75,49,3,ATCGACTTATTGCGAACAGG,46,5030823
yjbJ_predicted,13.0,54,3,ATCATGCTTAGGCGCTTAAA,51,5001172
yjbJ_predicted,0.5,4,3,AGGTATAAGAGGTAGGATTT,1,5011515
yjbJ_predicted,0.5,4,3,AGGCTGCATAGTCATGTACA,1,5026359
yjbJ_predicted,0.5,4,3,AGCGGTATCCGGATATGGCG,1,5004093
yjbJ_predicted,11.5,48,3,AGAATCACAAGGTAGGCCAA,45,4999604
yjbJ_predicted,0.5,4,3,ACTTGAATGCGGCGTCTTCG,1,5004230
yjbJ_predicted,0.5,4,3,ACTGCAGAAACATAGGAACG,1,5011292
yjbJ_predicted,0.75,5,3,ACTAGACCCGCCGGTAATGC,2,5016773
yjbJ_predicted,0.5,4,3,ACGTAGTACGTCACCCCGAA,1,5011007
yjbJ_predicted,0.5,4,3,ACGCTGAGCATCCTCGCGGC,1,5009044
yjbJ_predicted,9.25,39,3,ACCCCGGCGGTTCACCTGGT,36,5014678
yjbJ_predicted,8.75,37,3,ACACTGACTGATCATGCTTC,34,5009859
yjbJ_predicted,0.5,4,3,ACACGTTAGGCAGTCATGCC,1,5017804
yjbJ_predicted,21.25,87,3,AATGAACCACGTTCATGGGT,84,5026531
yjbJ_predicted,11.0,46,3,AAGTGTCTTTGGTGGCGATT,43,4994879
yjbJ_predicted,9.0,38,3,AAGGCTTTCCCAATTTCCCT,35,5005092
yjbJ_predicted,0.5,4,3,AACTTTGTACAAATCCTTTT,1,5003487
yjbJ_predicted,13.5,56,3,AAATTATGCAACGCGCCCGT,53,4999886
yjbJ_predicted,9.75,41,3,AAATCGAACTATTCACAATC,38,5019682
yjbJ_predicted,7.5,32,3,AAAACGTTCTTCGTAGGAGC,29,5022399
yjbJ_predicted,14.666666666666666,45,2,TTTTACTAAGTTTATCGGCA,43,5022441
yjbJ_predicted,15.666666666666666,48,2,TTTGTATATCTCCCCTACGT,46,5026710
yjbJ_predicted,0.6666666666666666,3,2,TTCGGTTGTAGAGGGACGAA,1,5005630
yjbJ_predicted,0.6666666666666666,3,2,TTCGAAGTGTTCTGTGGGCA,1,5006607
yjbJ_predicted,12.333333333333334,38,2,TTCCGTAGACAAACCATGAA,36,5029778
yjbJ_predicted,15.666666666666666,48,2,TTATAGTGGGGTTTATACAC,46,5004246
yjbJ_predicted,0.6666666666666666,3,2,TTAAGATTCACCACTAGCAA,1,5020822
yjbJ_predicted,59.0,178,2,TGTTCGACAAGTAGCGGGTT,176,5029071
yjbJ_predicted,0.6666666666666666,3,2,TGGAATGTTTGATCGCCCTG,1,5025051
yjbJ_predicted,23.333333333333332,71,2,TGCTTTGGCGTGATGAGTCT,69,5013936
yjbJ_predicted,9.666666666666666,30,2,TGCTGTAAGGAAAATAAGCA,28,5023829
yjbJ_predicted,19.666666666666668,60,2,TGCGCTACCTGCGATGTATC,58,5007332
yjbJ_predicted,11.666666666666666,36,2,TGACTAGGATTATAGCTGTA,34,5016229
yjbJ_predicted,4.333333333333333,14,2,TGACAGAACAATTGTATTCA,12,5013909
yjbJ_predicted,0.6666666666666666,3,2,TCTGTACCCTCGTGTACACA,1,5004909
yjbJ_predicted,15.333333333333334,47,2,TCGTCTGTAGACGAGCTCCA,45,5030771
yjbJ_predicted,14.666666666666666,45,2,TCGGCACTAGTGCGGGATCT,43,5002326
yjbJ_predicted,7.0,22,2,TCGCGGATTGTAAACTTCCT,20,4998719
yjbJ_predicted,9.0,28,2,TCCTATTCTTCAACCCAGGG,26,5022398
yjbJ_predicted,1.0,4,2,TCCAGTGAGGGGCGAATCGT,2,5002678
yjbJ_predicted,21.0,64,2,TCATATACAATGCTCCTTGT,62,4998315
yjbJ_predicted,1.0,4,2,TCAGGAAACACTCAGGAGTT,2,5024088
yjbJ_predicted,10.0,31,2,TCAAGCGAGCCCGGATCGGT,29,4997120
yjbJ_predicted,22.333333333333332,68,2,TATCTAAATGCCAGTCCGTG,66,5010443
yjbJ_predicted,1.0,4,2,TACCTGTCTCGTGAGATACT,2,5004526
yjbJ_predicted,0.6666666666666666,3,2,TAAGCTCGCCTCTGCTCAGT,1,4999356
yjbJ_predicted,21.0,64,2,GTTTTCCACTGTGTCCAATT,62,5007586
yjbJ_predicted,13.666666666666666,42,2,GTCGGAGACTGTCCGCGACA,40,5006785
yjbJ_predicted,17.0,52,2,GTCCCTATTAAGGCGATCGT,50,5001979
yjbJ_predicted,0.6666666666666666,3,2,GTATGATGTATCATTGAGCT,1,5012781
yjbJ_predicted,0.6666666666666666,3,2,GGGTAAGGGCGGTCAGTTTG,1,5019769
yjbJ_predicted,0.6666666666666666,3,2,GGGGCCGGGAGTAAGTAGAA,1,5021228
yjbJ_predicted,32.666666666666664,99,2,GGGGACGGTCTCTGTTCGCC,97,5010946
yjbJ_predicted,0.6666666666666666,3,2,GGGCGCGTACATGTCACCCT,1,5014394
yjbJ_predicted,6.0,19,2,GGCTCTTAAGGCGTTGCCTG,17,4996869
yjbJ_predicted,16.0,49,2,GGCGCATCGTGACGATGGAT,47,5012566
yjbJ_predicted,12.666666666666666,39,2,GGATACTTTAACCTGGGTCA,37,4995760
yjbJ_predicted,0.6666666666666666,3,2,GCTCGTCATTCCCGCAAACG,1,5026382
yjbJ_predicted,8.0,25,2,GCTCGAAAGCTACGGGACAT,23,5027233
yjbJ_predicted,13.333333333333334,41,2,GCGTGACTCCCATTCATGCA,39,5012823
yjbJ_predicted,19.666666666666668,60,2,GCGGTCAGGGCGGATCGTGG,58,5027205
yjbJ_predicted,13.333333333333334,41,2,GCGCAGGAGCGCGCACAGTG,39,4997553
yjbJ_predicted,7.0,22,2,GCCTCTGGCAAACTTACCCC,20,5007496
yjbJ_predicted,8.666666666666666,27,2,GCCTCATGCTGGACTATTAG,25,5002279
yjbJ_predicted,0.6666666666666666,3,2,GCATTAGGGAACCATGTCTA,1,5015790
yjbJ_predicted,27.666666666666668,84,2,GCACCCCCTTGATTCTCACG,82,5019167
yjbJ_predicted,0.6666666666666666,3,2,GCAACACGGGGAACGAGACC,1,5005409
yjbJ_predicted,12.666666666666666,39,2,GATTATCTCCCCTTTTGGCT,37,5008021
yjbJ_predicted,11.0,34,2,GATGACGGTGAGCCAGAGCA,32,5016149
yjbJ_predicted,0.6666666666666666,3,2,GAGAGCGGTGTTATCGATTT,1,5017213
yjbJ_predicted,0.6666666666666666,3,2,GACAACTTGCTAAGTACAGG,1,5002212
yjbJ_predicted,0.6666666666666666,3,2,GAAACCGGAATTAGCCTCAC,1,5001394
yjbJ_predicted,8.0,25,2,CTTCATAGAACAATGTCTGT,23,5006256
yjbJ_predicted,17.333333333333332,53,2,CTGTCTTCGTGCCCAATCAT,51,4995903
yjbJ_predicted,12.333333333333334,38,2,CTGGCCGGCGCCCGACATGC,36,5031154
yjbJ_predicted,3.6666666666666665,12,2,CTGACGGAACATTTGAATCC,10,5016991
yjbJ_predicted,16.333333333333332,50,2,CTCTTGTAAGTCATGAAAGA,48,5029422
yjbJ_predicted,0.6666666666666666,3,2,CTCCATGAAAGCAGTCGTCG,1,5003818
yjbJ_predicted,4.0,13,2,CTATTCAAAGAACATCAGCG,11,5030639
yjbJ_predicted,11.333333333333334,35,2,CTACTAGCATACGTTACACT,33,5001055
yjbJ_predicted,0.6666666666666666,3,2,CGTGAATCATGGCATTTAAA,1,4995714
yjbJ_predicted,0.6666666666666666,3,2,CGTCGTTGGACTCGTACTTT,1,5011147
yjbJ_predicted,0.6666666666666666,3,2,CGTCCGGCTCCTGGCATTTT,1,5013008
yjbJ_predicted,0.6666666666666666,3,2,CGTACGTCTCGACACCGCTC,1,5002356
yjbJ_predicted,29.333333333333332,89,2,CGGAACAGTTGTTGGACTAT,87,4997983
yjbJ_predicted,21.0,64,2,CGCAGATCTACGGACGGCTT,62,5019052
yjbJ_predicted,0.6666666666666666,3,2,CCTTGTCGTTCATGTTTGCT,1,5020411
yjbJ_predicted,27.0,82,2,CCTTCGGTCCCCCTAGCCTA,80,5014795
yjbJ_predicted,7.333333333333333,23,2,CCTGTCGAAGGTTGTACGGT,21,5005885
yjbJ_predicted,33.0,100,2,CCTCATATACGTGAGACTTA,98,5030927
yjbJ_predicted,0.6666666666666666,3,2,CCTCACCTGCGATGCGAAGG,1,4996191
yjbJ_predicted,7.0,22,2,CCGGACTTGGCGGGTTACTA,20,5006473
yjbJ_predicted,14.0,43,2,CCCAAGGCGGTAAATGTGAC,41,5026202
yjbJ_predicted,13.666666666666666,42,2,CCAAAAACTCAGTCTCGCAA,40,5027740
yjbJ_predicted,0.6666666666666666,3,2,CATTTAGTATGATGGAACGT,1,5004693
yjbJ_predicted,2.3333333333333335,8,2,CAGTTTCCGGCAGGACTCAT,6,5024736
yjbJ_predicted,16.666666666666668,51,2,CAGTTCATGTAGTCCTCTCT,49,5012791
yjbJ_predicted,0.6666666666666666,3,2,CAGGCTCAACTTAAGGATGG,1,5022775
yjbJ_predicted,7.0,22,2,CAGCGTTTGGACCCCTCGTA,20,5011769
yjbJ_predicted,15.0,46,2,CAGCGAAGGAGATATGCAAA,44,4996310
yjbJ_predicted,4.333333333333333,14,2,CAGAATAACTTCTCCAGGGA,12,5028096
yjbJ_predicted,13.333333333333334,41,2,CACTGGCGCGCTAAGAGAGC,39,5002576
yjbJ_predicted,0.6666666666666666,3,2,ATTTGGCCTGTAATCGACCC,1,4994784
yjbJ_predicted,11.333333333333334,35,2,ATTGTGGTCTAATTCACCCC,33,5020837
yjbJ_predicted,0.6666666666666666,3,2,ATGTTAGGACGTATAAAGTT,1,5009824
yjbJ_predicted,0.6666666666666666,3,2,ATGGGATGTGCATATAGATA,1,4998371
yjbJ_predicted,9.0,28,2,ATGGCTCGTCGTCCTTATAA,26,4997489
yjbJ_predicted,10.666666666666666,33,2,ATGGATCGGATAAGGTCAAC,31,5028167
yjbJ_predicted,11.666666666666666,36,2,ATGCAACGTGGCAGTCCTCA,34,5001322
yjbJ_predicted,35.0,106,2,ATCTTCTAATGGGAATGGCA,104,5019309
yjbJ_predicted,21.333333333333332,65,2,ATATGCCACTCCCTCCCTAC,63,5030335
yjbJ_predicted,10.0,31,2,ATAAGTCCGAGGTACCTTAT,29,4997769
yjbJ_predicted,3.3333333333333335,11,2,AGTCGAGGCCCTTTATATAG,9,5005699
yjbJ_predicted,19.333333333333332,59,2,AGGGTTAAAATGTCGGAAAC,57,5005815
yjbJ_predicted,14.666666666666666,45,2,AGGCTCGCTACCTTGGATGA,43,5024256
yjbJ_predicted,0.6666666666666666,3,2,AGGCAACCCCGGTTTTTTTT,1,5023302
yjbJ_predicted,12.0,37,2,AGGATCCGTCATGACAGTTA,35,5024134
yjbJ_predicted,12.333333333333334,38,2,AGCTGCGACCCTCCGTCGGG,36,4998656
yjbJ_predicted,14.666666666666666,45,2,AGAGAGGGTCAAAATGAACC,43,5021110
yjbJ_predicted,12.0,37,2,ACTGACTTAGCGTGACATAC,35,5023708
yjbJ_predicted,7.0,22,2,ACGGAGCATGAATGCCATAT,20,5007356
yjbJ_predicted,10.333333333333334,32,2,ACCCTTTAGCGGGGAGGATC,30,5008124
yjbJ_predicted,12.333333333333334,38,2,ACAGGGATCACGCCGATTGC,36,5016651
yjbJ_predicted,1.6666666666666667,6,2,ACACAATCACCCCAATTAAC,4,5029168
yjbJ_predicted,3.3333333333333335,11,2,ACACAAAAGATTCCATTCCA,9,5025806
yjbJ_predicted,17.333333333333332,53,2,AATAACGCCTTGGGAGCGAC,51,5014362
yjbJ_predicted,9.666666666666666,30,2,AAGTGATTGATGAAACGGAC,28,4999932
yjbJ_predicted,43.0,130,2,AAGCTTAATAGGTTGAGGTG,128,5027428
yjbJ_predicted,2.0,7,2,AAGCCAAGAACAAGGTCCTT,5,5026645
yjbJ_predicted,1.3333333333333333,5,2,AACTTCAGGATCCAGTAAAT,3,5018362
yjbJ_predicted,0.6666666666666666,3,2,AACGTGTACCGAAAGCGTTT,1,4997563
yjbJ_predicted,11.333333333333334,35,2,AACCGTTCTGAACCCTCCAA,33,5019578
yjbJ_predicted,16.666666666666668,51,2,AACCGAGGGGCCACAAGCCC,49,5003303
yjbJ_predicted,16.0,49,2,AAAGAATAATTCAAGGGGGT,47,5026142
yjbJ_predicted,10.666666666666666,33,2,AAAACCGCCAAGCGCCAGAT,31,5021387
yjbJ_predicted,3.5,7,1,TTTGGACTACGGTCTATAAA,6,5025534
yjbJ_predicted,6.5,13,1,TTGCGCTCTGTACTCCGTGC,12,5015057
yjbJ_predicted,24.0,48,1,TGTTGACTGTGTAAGTCAAA,47,4995769
yjbJ_predicted,1.0,2,1,TGTGAGGTAAGGGCTGTAAA,1,5010350
yjbJ_predicted,1.5,3,1,TGTCGCGAAAGGCCGAGCAT,2,5021224
yjbJ_predicted,18.0,36,1,TGTATAAATTGTCTAGGACT,35,5010937
yjbJ_predicted,25.5,51,1,TGTAACGAACGGAACCGATT,50,4999378
yjbJ_predicted,25.0,50,1,TGGAGGGCTCCTATCGAGCT,49,5019992
yjbJ_predicted,27.5,55,1,TGCTGCAGTTAACTCGAGAC,54,5012333
yjbJ_predicted,1.0,2,1,TGCGGGAAGATTGTGGAATA,1,4998848
yjbJ_predicted,12.5,25,1,TGCAATGGCAAAAGTGAGTA,24,5029922
yjbJ_predicted,1.0,2,1,TGATACGGTAATTAGACCCG,1,5009546
yjbJ_predicted,1.0,2,1,TGACCTTGTGAATTAGCATA,1,5019608
yjbJ_predicted,19.0,38,1,TCTTATACAATATGGCAGAT,37,5031006
yjbJ_predicted,20.0,40,1,TCTGCGAAAACAGCTTTCGG,39,5013975
yjbJ_predicted,1.0,2,1,TCTCGAGGGTCCTGGAGGCC,1,5024388
yjbJ_predicted,1.0,2,1,TCTCCACGGGATAGCTTCAT,1,5026401
yjbJ_predicted,1.0,2,1,TCGCTTTGTGGTGTTGAATA,1,4997159
yjbJ_predicted,37.5,75,1,TCCTTTGAGCGCGTATGGTA,74,5025715
yjbJ_predicted,30.0,60,1,TCCAGCCGTCAAGTGAGGTG,59,5028720
yjbJ_predicted,23.5,47,1,TCAGGGTCTTTATCGTGACA,46,4999934
yjbJ_predicted,21.0,42,1,TCAACTCACCTAGTAATCCC,41,5009290
yjbJ_predicted,1.0,2,1,TACGCGGACAACGATCAAGA,1,5013546
yjbJ_predicted,23.0,46,1,TACAAAGGCCCAAGTGCAGG,45,5015788
yjbJ_predicted,1.0,2,1,TAAGCGCCCGGGGATTATGG,1,5008539
yjbJ_predicted,36.5,73,1,TAAACTGGAAAATGTCCGAC,72,4994732
yjbJ_predicted,20.5,41,1,TAAAACTGGTTACGGCACCG,40,5015792
yjbJ_predicted,16.5,33,1,GTTGACGGAGGGGTGCCACA,32,4998303
yjbJ_predicted,24.5,49,1,GTTAACAATGTACTTACGTT,48,5013791
yjbJ_predicted,10.0,20,1,GTGGAAGTCCCTTGTATGGC,19,5009623
yjbJ_predicted,1.0,2,1,GTGCAGCCATCACGGGAATG,1,5016897
yjbJ_predicted,23.0,46,1,GTGACATGAGAACGTCGTAT,45,5014899
yjbJ_predicted,1.0,2,1,GTCTGTATATGGATCCGGCT,1,5016889
yjbJ_predicted,24.5,49,1,GTACTCGGCTTGTGAAAAAA,48,5001601
yjbJ_predicted,22.5,45,1,GTAATCGATGCCGTGGGATT,44,5029164
yjbJ_predicted,9.5,19,1,GGTGCCGAAATCCGGCAAGA,18,5027184
yjbJ_predicted,27.5,55,1,GGTATCCATTTTAGTGAAAC,54,5015975
yjbJ_predicted,34.5,69,1,GGTAGCTATACGTGACCTAG,68,5011237
yjbJ_predicted,73.0,146,1,GGGGTGCTATGTCTACTGTC,145,4996338
yjbJ_predicted,16.5,33,1,GGCGGCTGGATCGAGCACCC,32,4994974
yjbJ_predicted,1.0,2,1,GGCCTAGAATTGGACTCAAC,1,5008468
yjbJ_predicted,31.0,62,1,GGCAAGGTATAATTCTGTGA,61,5010219
yjbJ_predicted,29.5,59,1,GCTGGAAATCACGTGAAACA,58,5015334
yjbJ_predicted,16.5,33,1,GCGTGGTGGTAAAGGTGAGT,32,5028292
yjbJ_predicted,3.5,7,1,GCCTACTTACACTTGCTCCT,6,4998245
yjbJ_predicted,15.5,31,1,GCAGGGACAACACGGGCGCC,30,5029773
yjbJ_predicted,25.0,50,1,GCACCTCCAACAACATAGGT,49,5007191
yjbJ_predicted,5.0,10,1,GAAATTTCTCCCTCCTTCTT,9,5004050
yjbJ_predicted,11.0,22,1,CTTGGGTTTGTAATAACGCT,21,5007137
yjbJ_predicted,27.0,54,1,CTGTTCCGGTCCTCACCGAT,53,4998389
yjbJ_predicted,23.0,46,1,CTGTATCCACGAACAAGCGC,45,5023908
yjbJ_predicted,23.5,47,1,CTGCTTAGGCGGGACTTACT,46,5025163
yjbJ_predicted,1.0,2,1,CTCGTTGAGTTAAGTCAGCT,1,5002708
yjbJ_predicted,1.0,2,1,CTCGGGTGCTGTCTTAGATC,1,5007080
yjbJ_predicted,1.0,2,1,CTCAACATTAAGTTTTGTGA,1,4996300
yjbJ_predicted,24.0,48,1,CTAGGTGGTGTGAGGCCTAG,47,5004656
yjbJ_predicted,45.0,90,1,CTACGATGGGCCGATCTCAA,89,4998306
yjbJ_predicted,14.0,28,1,CTACCTACTCGTATATGGCT,27,5014575
yjbJ_predicted,16.0,32,1,CTAAATCGGATTTGGAAAGT,31,5016183
yjbJ_predicted,19.5,39,1,CGTTTGATATCGATGGGCTT,38,5013681
yjbJ_predicted,1.0,2,1,CGTTGGGGCAACTGGTTGCA,1,5001232
yjbJ_predicted,14.0,28,1,CGTGTTAAAGCCGGGTCATT,27,5009883
yjbJ_predicted,50.5,101,1,CGTCTGCATTTAGAAGAGCC,100,5002956
yjbJ_predicted,13.0,26,1,CGGTAGGGCTGATGCAGCTT,25,5018040
yjbJ_predicted,1.0,2,1,CGGGGTCCACTGTAGCGTTC,1,5005843
yjbJ_predicted,1.0,2,1,CGGCGGCCGAGGGGATTCCT,1,5015002
yjbJ_predicted,15.5,31,1,CGGAATCTCACTCACTGTGA,30,5024389
yjbJ_predicted,1.0,2,1,CGCGTTCGTAGGTAAACACA,1,5014510
yjbJ_predicted,27.0,54,1,CGATTACGAGGTCGAGTCGT,53,5026431
yjbJ_predicted,1.0,2,1,CGATGGATTACCGCATGGGG,1,5012673
yjbJ_predicted,22.0,44,1,CGACTCGTATTAGCGTGCGT,43,5006716
yjbJ_predicted,26.5,53,1,CGACCACAAGCGGAGTGCCT,52,5001593
yjbJ_predicted,27.5,55,1,CCGCACGGGCTGAAGGACAA,54,5028070
yjbJ_predicted,28.5,57,1,CCCTGTTCACCCTACCCATT,56,5005737
yjbJ_predicted,18.0,36,1,CCAAGGGGGTTAATAGTAGA,35,5012890
yjbJ_predicted,23.5,47,1,CATGTCATAATTTCCCTCGT,46,5001542
yjbJ_predicted,27.0,54,1,CATCCTCCCCTACATTATCT,53,5013921
yjbJ_predicted,18.5,37,1,CATAGGGGGGTGGGGACCGT,36,5021691
yjbJ_predicted,26.5,53,1,CAGTAGTGATGACTCCGTGT,52,4994820
yjbJ_predicted,1.0,2,1,CAGGGACTTACAACTCGGGA,1,5027327
yjbJ_predicted,1.0,2,1,CACGCTTCTTCGCGTAGGGT,1,5006208
yjbJ_predicted,14.0,28,1,CAAAATGGCGCACATGCGCC,27,5006433
yjbJ_predicted,13.5,27,1,CAAAAAACGATAACAGGCCC,26,4995587
yjbJ_predicted,31.0,62,1,ATTGGTCGAGGAGACCGCTC,61,5016068
yjbJ_predicted,20.0,40,1,ATTATACGACTTCTTAGACT,39,5012071
yjbJ_predicted,6.0,12,1,ATTAGGGAAGCACTGTCCAT,11,5009728
yjbJ_predicted,1.0,2,1,ATCAGCAACTCAAGAGTTAA,1,5002836
yjbJ_predicted,1.0,2,1,ATAGCGAAGTGTTTGTGTGG,1,5030289
yjbJ_predicted,1.5,3,1,ATACTTTATGCCGCTTGATG,2,5010100
yjbJ_predicted,29.0,58,1,ATACATGGACCGGGGCTATA,57,5013543
yjbJ_predicted,24.5,49,1,AGTCGGGCACACCTTGTTTA,48,5030862
yjbJ_predicted,1.0,2,1,AGTCCGTTCAAACAACGGTT,1,4995678
yjbJ_predicted,2.0,4,1,AGTATGTGGCACCTCCGTAA,3,5018155
yjbJ_predicted,21.0,42,1,AGGCTAGGATCCTCTGCCAC,41,5029786
yjbJ_predicted,1.0,2,1,AGGAGGTAGTCTGGGCAAGC,1,4997870
yjbJ_predicted,5.5,11,1,AGGACCCCTTGTGGCAACAC,10,4998319
yjbJ_predicted,9.5,19,1,AGATTCCCGTGATATAAAGC,18,5027932
yjbJ_predicted,40.0,80,1,ACTTTGCGGGTCTACTAAGC,79,5002592
yjbJ_predicted,1.0,2,1,ACGTTCACTACCAAGCAAGG,1,5023714
yjbJ_predicted,24.5,49,1,ACGTGCCCGCCCATATACCA,48,4997840
yjbJ_predicted,30.5,61,1,ACGGGTTCCCGCAGTGGATA,60,5023189
yjbJ_predicted,20.5,41,1,ACATAGGCCCAGAAAGGTAG,40,5031147
yjbJ_predicted,1.5,3,1,ACACTGTGGGGTTTCGGTCA,2,5005410
yjbJ_predicted,25.5,51,1,AATGTAACTGGATCATTACT,50,5024934
yjbJ_predicted,23.5,47,1,AATATACTCGCTCCGACAGC,46,5004470
yjbJ_predicted,1.0,2,1,AAGTCCGAAACGGCAGGTTC,1,5030394
yjbJ_predicted,10.0,20,1,AAGTAGTCGTTTGGCTTCGG,19,5023943
yjbJ_predicted,11.5,23,1,AAGTAGCATGGAAGGAGACT,22,5010383
yjbJ_predicted,16.5,33,1,AAGGTAAGGCGCCATCAAGC,32,4996870
yjbJ_predicted,16.0,32,1,AACGAGTAATGAGGTTTACA,31,4999566
yjbJ_predicted,1.0,2,1,AAATTGGCTGCGTTGTTCAT,1,5001756
yjbJ_predicted,13.5,27,1,AAAAGAAGGACGATGGCCCA,26,5010581
yjbJ_predicted,0.010869565217391304,91,91,GGCGTTCGGCGCACCACGAC,0,5000389
yjbJ_predicted,0.014285714285714285,69,69,GTACTAGGTCCTGTCCGCGT,0,5016641
yjbJ_predicted,0.014285714285714285,69,69,GCTGGGGCCAGATATCTTAG,0,4995794
yjbJ_predicted,0.014492753623188406,68,68,GTAGCCTGCACATTCATTCC,0,4996266
yjbJ_predicted,0.014492753623188406,68,68,AAGGGAATAGTAACTTGAAT,0,4994855
yjbJ_predicted,0.014705882352941176,67,67,ATACCTGTTTCGTACTAATT,0,4999209
yjbJ_predicted,0.015625,63,63,ACGGCGCTAGATACCTGCAG,0,5013956
yjbJ_predicted,0.016129032258064516,61,61,GAGTGTCAGCAACCTGGCTA,0,4999966
yjbJ_predicted,0.016129032258064516,61,61,CGTGCAGTTGGCCCCCCGTA,0,5016479
yjbJ_predicted,0.01639344262295082,60,60,CCTACGAGTCGCGGCACGGT,0,4996650
yjbJ_predicted,0.01639344262295082,60,60,ACGCAGAGTAATGGCGGAAT,0,5000356
yjbJ_predicted,0.016666666666666666,59,59,GTTGAACCGATTTCTGGTGA,0,4999139
yjbJ_predicted,0.016666666666666666,59,59,CCTGACGTGCAATAGCGCGA,0,5014257
yjbJ_predicted,0.01694915254237288,58,58,CAAATAGTTGTATTGGCCTG,0,5001193
yjbJ_predicted,0.01818181818181818,54,54,TTTGCTTTCACCACATGAAT,0,4997272
yjbJ_predicted,0.018518518518518517,53,53,GGTTCCCCGCTGTTCCAGAG,0,5013306
yjbJ_predicted,0.018518518518518517,53,53,GCCTGGGATCCTCAGTAGGT,0,5014075
yjbJ_predicted,0.018518518518518517,53,53,AGTAGTTCCGTTCATACCGT,0,5012032
yjbJ_predicted,0.018518518518518517,53,53,AATTCCCCAGATTGGGGCTG,0,5008495
yjbJ_predicted,0.018867924528301886,52,52,GTGGACGAGACTTCCGAAAT,0,4994817
yjbJ_predicted,0.019230769230769232,51,51,TGTTCGATGCTGCAGCCATA,0,5007673
yjbJ_predicted,0.019230769230769232,51,51,AGTCATTGAAGGTTCATTAG,0,5030396
yjbJ_predicted,0.0196078431372549,50,50,TCAATACTTCATAAAGTCGT,0,5008953
yjbJ_predicted,0.0196078431372549,50,50,CCTGGGTGGCACTATAGACG,0,4999197
yjbJ_predicted,0.02,49,49,GGTTGTTACCCAGCCGTAGC,0,5013132
yjbJ_predicted,0.02,49,49,GGACTTATTATCACTCACAA,0,5008118
yjbJ_predicted,0.02,49,49,GGACAGCTTCCGAGTGTTAG,0,5003511
yjbJ_predicted,0.02,49,49,GATTGTAAGGTACAAGTTTT,0,4999195
yjbJ_predicted,0.02,49,49,ATGGGGAGTCGAACGTTAAC,0,5002779
yjbJ_predicted,0.02,49,49,AGAGCCGACCCCATGGTCCT,0,5018204
yjbJ_predicted,0.02,49,49,AAGCCGCGTGTAATGGTTAT,0,5003567
yjbJ_predicted,0.02040816326530612,48,48,GACTTATACTATGTGTAGAT,0,4998754
yjbJ_predicted,0.02040816326530612,48,48,CCAATATTTTATGAGTAGTT,0,5008642
yjbJ_predicted,0.020833333333333332,47,47,ATATTTTGAGTTAGCACGTA,0,5016944
yjbJ_predicted,0.02127659574468085,46,46,GTTCGTAGTCAGCGTCCTGA,0,5000851
yjbJ_predicted,0.02127659574468085,46,46,CGGGACAAGACAACAATAGT,0,4999881
yjbJ_predicted,0.02127659574468085,46,46,CCCTTCCCGATGGTTATGCA,0,5029086
yjbJ_predicted,0.02127659574468085,46,46,ATTTGGCAACAATTGAGAAC,0,5005205
yjbJ_predicted,0.02127659574468085,46,46,ATTGTTAATCTTTTGCGTTT,0,5005977
yjbJ_predicted,0.02127659574468085,46,46,AGGCTTAGGGTTGGGCCATT,0,5028182
yjbJ_predicted,0.02127659574468085,46,46,AACTTAGAGGCTGGCAAACT,0,5001226
yjbJ_predicted,0.021739130434782608,45,45,TCGTAAACAGAAGCCGTTAG,0,4997695
yjbJ_predicted,0.022222222222222223,44,44,TTACTCTCACATAGGGACCA,0,5002171
yjbJ_predicted,0.022222222222222223,44,44,GGATCATCCGCATCTCTCTA,0,5000987
yjbJ_predicted,0.022222222222222223,44,44,CGGACAATCGCTGCATGCAG,0,4996944
yjbJ_predicted,0.022727272727272728,43,43,TTAGACACCATTTATCCGCG,0,5013344
yjbJ_predicted,0.022727272727272728,43,43,GCTGGGCCTGCGTCCTGTAA,0,4998201
yjbJ_predicted,0.022727272727272728,43,43,CTAAAATGGGATTTGCGATT,0,4997980
yjbJ_predicted,0.022727272727272728,43,43,AGCCAATCGCATGGGATCAT,0,5012714
yjbJ_predicted,0.023255813953488372,42,42,TGGGTCATTTGGGAACTCAT,0,4997038
yjbJ_predicted,0.023255813953488372,42,42,GTTTCCAGGGACCTATGAGG,0,5017067
yjbJ_predicted,0.023255813953488372,42,42,GGGGACATGGAGCCCCTTAT,0,5003333
yjbJ_predicted,0.023255813953488372,42,42,GACGCGGCCACGGTATGATG,0,5007967
yjbJ_predicted,0.023255813953488372,42,42,CGCTGGCGAATTCCCACCAT,0,5023665
yjbJ_predicted,0.023809523809523808,41,41,TTGGTCTTAGGCATCTTGAA,0,5013984
yjbJ_predicted,0.023809523809523808,41,41,TGTCCTGACTCAAATACTGT,0,5001586
yjbJ_predicted,0.023809523809523808,41,41,GCTTGCTAAGTATGAAACCA,0,5022323
yjbJ_predicted,0.023809523809523808,41,41,CGCCTTCTATTCTATGTTGG,0,5017279
yjbJ_predicted,0.023809523809523808,41,41,CAAGATACGGCAATACTTAG,0,4995511
yjbJ_predicted,0.023809523809523808,41,41,ACCTGATTGGCATGTTGGGG,0,4997414
yjbJ_predicted,0.023809523809523808,41,41,AAAGGCGGAAGGCTCCGACA,0,5028195
yjbJ_predicted,0.024390243902439025,40,40,TAAGAACATATGCCTCGTAT,0,5016847
yjbJ_predicted,0.024390243902439025,40,40,GTGTTGGAATTTGCTTGATG,0,5003030
yjbJ_predicted,0.024390243902439025,40,40,GTCAGGGCGGCTTAAATTAT,0,5021042
yjbJ_predicted,0.024390243902439025,40,40,GGCCTGGCGCAGCTTGTATC,0,5023756
yjbJ_predicted,0.024390243902439025,40,40,CTTATAGCTAGTGACATGCT,0,5001565
yjbJ_predicted,0.024390243902439025,40,40,CACAAGCGAGGGGCGGGACA,0,5024666
yjbJ_predicted,0.024390243902439025,40,40,AGTGGTCCCGGCCGCGTGGT,0,5026922
yjbJ_predicted,0.024390243902439025,40,40,ACGTTTACTGAAATAGTGCA,0,5023899
yjbJ_predicted,0.024390243902439025,40,40,AAATTGTCCTAAGTAGGAGA,0,5015075
yjbJ_predicted,0.025,39,39,TAGCACACGGGATTCTCTAA,0,5004730
yjbJ_predicted,0.025,39,39,CCCCTTTCAAGTTGGGTTAA,0,5008586
yjbJ_predicted,0.025,39,39,CAGTCACTAGCAAGGCTCAG,0,5006492
yjbJ_predicted,0.02564102564102564,38,38,TTTAACGGAGCGTTTTCGAT,0,5004963
yjbJ_predicted,0.02564102564102564,38,38,TCGGACAACCGCTCAGGCGC,0,4996986
yjbJ_predicted,0.02564102564102564,38,38,TCGAACGGCCTTAAGCAGCT,0,4999722
yjbJ_predicted,0.02564102564102564,38,38,GAAGTGATCAGCCCGACCAG,0,5014285
yjbJ_predicted,0.02564102564102564,38,38,CTCTCATGATGACTATTAAT,0,4998215
yjbJ_predicted,0.02564102564102564,38,38,CGCGCGCCGACAGTTGAACT,0,5024700
yjbJ_predicted,0.02564102564102564,38,38,CATTATGGGTGCGTTCCCTA,0,5001864
yjbJ_predicted,0.02564102564102564,38,38,ATTCAGAATTAGAATAGATA,0,5028929
yjbJ_predicted,0.02631578947368421,37,37,TCATGACCCAGTCAGCTTAC,0,5022735
yjbJ_predicted,0.02631578947368421,37,37,GCCGGGTTTGCTGTTGCAGG,0,5001539
yjbJ_predicted,0.02631578947368421,37,37,GCATGGTAATCGCGGCCCAA,0,5024013
yjbJ_predicted,0.02631578947368421,37,37,CCCATTTTGGTGATTTTCAT,0,5010791
yjbJ_predicted,0.02631578947368421,37,37,CAGCGCGCGCTCTGGACGTA,0,5015953
yjbJ_predicted,0.02631578947368421,37,37,AGTCAGGGGGGCTTGCATCT,0,5006099
yjbJ_predicted,0.02631578947368421,37,37,AGTCACGCGGGTTGACCGGT,0,5015341
yjbJ_predicted,0.02631578947368421,37,37,ACAAATCAGGTCAAGGATCA,0,5004563
yjbJ_predicted,0.02702702702702703,36,36,TATTCGATCCCGATGCCGGA,0,5006713
yjbJ_predicted,0.02702702702702703,36,36,TATGATGTCGTTGCCTGTAT,0,5019749
yjbJ_predicted,0.02702702702702703,36,36,GGTGTGTTCATATAGCTAGG,0,5016901
yjbJ_predicted,0.02702702702702703,36,36,GGTACGAGGTACGGTCGGCA,0,5002831
yjbJ_predicted,0.02702702702702703,36,36,GCTCTATTGCCCTCATTAGT,0,5014218
yjbJ_predicted,0.02702702702702703,36,36,GCCAGACCACAGTGTCTTCA,0,5017932
yjbJ_predicted,0.02702702702702703,36,36,CTGAACCAAACTCACACAAT,0,5005832
yjbJ_predicted,0.02702702702702703,36,36,CTGAAAGATTTGGTACGAAT,0,5007964
yjbJ_predicted,0.02702702702702703,36,36,CTAGCATAGCACATCTGGGT,0,5020656
yjbJ_predicted,0.02702702702702703,36,36,CGTTGGAACCGTTACTACCA,0,5004366
yjbJ_predicted,0.02702702702702703,36,36,CACGTGGGGGGGGTAATTTC,0,5009332
yjbJ_predicted,0.02702702702702703,36,36,AAAAAAGTCACTAACTCTCC,0,4998439
yjbJ_predicted,0.027777777777777776,35,35,TTTGGTCCCGTATCGAAGGA,0,5000255
yjbJ_predicted,0.027777777777777776,35,35,TGCTATTCATGGCAACCTTC,0,5005772
yjbJ_predicted,0.027777777777777776,35,35,TCGATCTGATTCGGCCCGAT,0,4996486
yjbJ_predicted,0.027777777777777776,35,35,GGGGGATAGTCCTTCAAATA,0,5007627
yjbJ_predicted,0.027777777777777776,35,35,CTGTCAGATTAACTTATACG,0,4998013
yjbJ_predicted,0.027777777777777776,35,35,CTCATACGATGCGTTGCACA,0,5003704
yjbJ_predicted,0.027777777777777776,35,35,CCGGTCGGTTAGGGGCGCGT,0,4996702
yjbJ_predicted,0.027777777777777776,35,35,ATTTGTTAGAAACCTAACAT,0,5006844
yjbJ_predicted,0.027777777777777776,35,35,ATGTTATCCACGTTAAGGCT,0,5012621
yjbJ_predicted,0.027777777777777776,35,35,ATGGAACCGCCACCTAATCT,0,5008296
yjbJ_predicted,0.02857142857142857,34,34,TGTCCGTCGGTCTGGAAACG,0,5029556
yjbJ_predicted,0.02857142857142857,34,34,TAGGTTGCCGTCGAACCGAA,0,4997484
yjbJ_predicted,0.02857142857142857,34,34,TACTTGTAGATTGGTTGTAT,0,4996953
yjbJ_predicted,0.02857142857142857,34,34,GTGGTAAAATGGGCTTCCTC,0,5024051
yjbJ_predicted,0.02857142857142857,34,34,GGTCATAGAAGATTCTCTTC,0,5027265
yjbJ_predicted,0.02857142857142857,34,34,GGGGTGATTAGCCAGCTGTA,0,4999202
yjbJ_predicted,0.02857142857142857,34,34,GGCTGGCCTGGTCCCGATTA,0,5012852
yjbJ_predicted,0.02857142857142857,34,34,CGACTCCACGAAGGTCAAAA,0,4998278
yjbJ_predicted,0.02857142857142857,34,34,CAGGAAGGAGTTCGACAAGC,0,5030495
yjbJ_predicted,0.02857142857142857,34,34,ATGGTTCTGTCATTAACTAG,0,5001153
yjbJ_predicted,0.02857142857142857,34,34,ATAGGGATATGGGAATGATG,0,5009230
yjbJ_predicted,0.02857142857142857,34,34,ACGCACTAGGGGTGTAGCAT,0,5026928
yjbJ_predicted,0.02857142857142857,34,34,ACAGGGCGCAAGACACATAA,0,5027104
yjbJ_predicted,0.02857142857142857,34,34,AATAGGGTTAGCTCAGGTTC,0,5027893
yjbJ_predicted,0.029411764705882353,33,33,TTCCACGATTTGGGTAATGA,0,4999800
yjbJ_predicted,0.029411764705882353,33,33,TGTAATCGCATCAGTATACG,0,5002653
yjbJ_predicted,0.029411764705882353,33,33,TCTGGAGGTGTAGAAGGATA,0,5013232
yjbJ_predicted,0.029411764705882353,33,33,TATGTGTTGGTATCGCGTTA,0,5011273
yjbJ_predicted,0.029411764705882353,33,33,TATCTGTAAGGATGCTGAGC,0,5025486
yjbJ_predicted,0.029411764705882353,33,33,TAATTACGCAGCCCGCCGGT,0,5024165
yjbJ_predicted,0.029411764705882353,33,33,GGTAGCAGCTTGAGCTCTAA,0,5021476
yjbJ_predicted,0.029411764705882353,33,33,GCTTATTCAACTATGAACCC,0,5009882
yjbJ_predicted,0.029411764705882353,33,33,CTTATTGGATCTTAATTTCA,0,5010827
yjbJ_predicted,0.029411764705882353,33,33,CGCCCGGGTGCACTTATCAG,0,5028397
yjbJ_predicted,0.029411764705882353,33,33,ATTGCTCGGTATTCCGACCA,0,5002533
yjbJ_predicted,0.029411764705882353,33,33,ATACCCATGATGGGAGAGAT,0,4998012
yjbJ_predicted,0.029411764705882353,33,33,ACGTACTGGGAGGGGATCAT,0,5013261
yjbJ_predicted,0.029411764705882353,33,33,ACGCCGCTCTTGCTGCTGAC,0,4995003
yjbJ_predicted,0.029411764705882353,33,33,AACGGGCGGTAGCGAAGGTA,0,5023809
yjbJ_predicted,0.030303030303030304,32,32,TGGTGACTCATACCCCAGGT,0,5018457
yjbJ_predicted,0.030303030303030304,32,32,TCTTCTGCAGACTTTTGTAT,0,5012906
yjbJ_predicted,0.030303030303030304,32,32,TCTTACTATGTCCGGCCCAA,0,4997303
yjbJ_predicted,0.030303030303030304,32,32,TCAGGGAGCGCTGTGCCTCA,0,5019084
yjbJ_predicted,0.030303030303030304,32,32,TCAGGAATAGGCTGTGTGGT,0,5015723
yjbJ_predicted,0.030303030303030304,32,32,TACCTAACCGTTCTTCTTGC,0,5003245
yjbJ_predicted,0.030303030303030304,32,32,GTCGTAGGGCCGTTTGATGC,0,4996508
yjbJ_predicted,0.030303030303030304,32,32,GCCCAGGTAGATCCTGGATA,0,4997620
yjbJ_predicted,0.030303030303030304,32,32,GCAGCACTCGATACATAACA,0,5014053
yjbJ_predicted,0.030303030303030304,32,32,GAGGGCGATTGTGGACCAGC,0,5027253
yjbJ_predicted,0.030303030303030304,32,32,GACCCTTTAAGTAGTACAGG,0,5003830
yjbJ_predicted,0.030303030303030304,32,32,GACACGACTATGCGTGTACG,0,5002180
yjbJ_predicted,0.030303030303030304,32,32,CTGAGAGCTTAGTAAGTGTA,0,4997777
yjbJ_predicted,0.030303030303030304,32,32,CCCCCAGACAGTAGTCAATA,0,5020067
yjbJ_predicted,0.030303030303030304,32,32,CACGAAATGTTATCGTGAAT,0,5026780
yjbJ_predicted,0.030303030303030304,32,32,ATGCTTTGTCCGTCCAGACT,0,5017217
yjbJ_predicted,0.030303030303030304,32,32,AATTAGGCCTACCGCCGCGT,0,4997428
yjbJ_predicted,0.03125,31,31,TTGGAAGGAGTAATTCTTAC,0,5024325
yjbJ_predicted,0.03125,31,31,TTCTTGGGATGGAACTCCGA,0,5005083
yjbJ_predicted,0.03125,31,31,TCGAGCGGGTTTGTACCTTC,0,5004543
yjbJ_predicted,0.03125,31,31,TAGGGGCTGGAAGACGGCTA,0,5003693
yjbJ_predicted,0.03125,31,31,GTGCCGAGGTCGAATCCACA,0,5016791
yjbJ_predicted,0.03125,31,31,GGTTCCACACGAATCCGGGT,0,5023808
yjbJ_predicted,0.03125,31,31,GGTAGGCGAACTTGGATGCA,0,4997115
yjbJ_predicted,0.03125,31,31,GCTAGCACATCCCACCACGA,0,5026048
yjbJ_predicted,0.03125,31,31,GCGACGGCCCGGGTTGGCAG,0,5021989
yjbJ_predicted,0.03125,31,31,GCCTGTTATCAACTACCGCT,0,5029682
yjbJ_predicted,0.03125,31,31,GCCGGTAAAGCCGCGTAGCG,0,5026750
yjbJ_predicted,0.03125,31,31,GAGCTCCGCTATACTTAGTG,0,5022842
yjbJ_predicted,0.03125,31,31,GAGCGAGTGCGAAGAGTAAG,0,5012761
yjbJ_predicted,0.03125,31,31,CTGAGTAGACTATTGTCAAA,0,4996631
yjbJ_predicted,0.03125,31,31,CGCCGGTTCCTACTTAGCAT,0,5010322
yjbJ_predicted,0.03125,31,31,CGCACTGTCTTTAAAGTGTT,0,5019666
yjbJ_predicted,0.03125,31,31,CGATGACGCATTAACCACGT,0,5030227
yjbJ_predicted,0.03125,31,31,CCCGCCCTGCTTTGTAACTA,0,5007824
yjbJ_predicted,0.03125,31,31,CCCCGCGCTCTCCCGACAGG,0,5010041
yjbJ_predicted,0.03125,31,31,ATGTCGCACCGCAGGAGGAC,0,5022796
yjbJ_predicted,0.03125,31,31,AATTGGCTTCAGGTTAGTAG,0,5006062
yjbJ_predicted,0.03125,31,31,AATTCTACTATTTATGACGT,0,5008852
yjbJ_predicted,0.03125,31,31,AACCCTTGATCTTCTCAGCT,0,4996169
yjbJ_predicted,0.03125,31,31,AACAGAAGGGGGGCCTAGCT,0,5016172
yjbJ_predicted,0.03125,31,31,AAACTCAGAAGTAGGAACAT,0,5005131
yjbJ_predicted,0.03125,31,31,AAACGCGGGGCATCTTCTCC,0,5013438
yjbJ_predicted,0.03225806451612903,30,30,TTCGGATTACTGCACTCGCT,0,5004904
yjbJ_predicted,0.03225806451612903,30,30,TTCAGGGCCGCGAGTTGTTG,0,5001804
yjbJ_predicted,0.03225806451612903,30,30,TGCCTATCACCTGTCGAAAT,0,5008567
yjbJ_predicted,0.03225806451612903,30,30,TGATTCGTCAAAACGGAGCC,0,4995156
yjbJ_predicted,0.03225806451612903,30,30,TGATAATAGATACAATGCTT,0,5006205
yjbJ_predicted,0.03225806451612903,30,30,TGAGGCAGCCTCAAAATTTG,0,5028214
yjbJ_predicted,0.03225806451612903,30,30,TCTGTCCAAGTGACCCACTA,0,5008255
yjbJ_predicted,0.03225806451612903,30,30,TAAACTTGTTCAAATGCTTA,0,5027016
yjbJ_predicted,0.03225806451612903,30,30,GTCCAGACAGATCAATGTCA,0,5018495
yjbJ_predicted,0.03225806451612903,30,30,GTACGTGGGATCTCAAGAAA,0,5002474
yjbJ_predicted,0.03225806451612903,30,30,GGGACGAGTCTGGCTTGGTT,0,5020836
yjbJ_predicted,0.03225806451612903,30,30,GGCGGCAATGCTGGAGGCAG,0,5019389
yjbJ_predicted,0.03225806451612903,30,30,GGCCGAATCGGTCCTCTTAT,0,5014807
yjbJ_predicted,0.03225806451612903,30,30,GCGGCAACCTCTACATAAGG,0,5001416
yjbJ_predicted,0.03225806451612903,30,30,GCGGAGAAAACCGGACGGAA,0,5025913
yjbJ_predicted,0.03225806451612903,30,30,GATGGAATACTGGCATTAAT,0,4995526
yjbJ_predicted,0.03225806451612903,30,30,GACCCAATGAGACCGTGAAT,0,5029335
yjbJ_predicted,0.03225806451612903,30,30,CGGAGCTAATGGTTGAGGCG,0,5004931
yjbJ_predicted,0.03225806451612903,30,30,CGACTCGTCCAAATTTTGGA,0,4996171
yjbJ_predicted,0.03225806451612903,30,30,CCTTGTAACGTCTTAATCGG,0,5029737
yjbJ_predicted,0.03225806451612903,30,30,CCAGTTTAGCTGGATATTAA,0,5008040
yjbJ_predicted,0.03225806451612903,30,30,CAAAATACTTTGGAGGGCAT,0,5023562
yjbJ_predicted,0.03225806451612903,30,30,ATGTCTCCAGTTGGCCGATG,0,5004591
yjbJ_predicted,0.03225806451612903,30,30,AGTTCACCGGGGAGGGTCAT,0,4996624
yjbJ_predicted,0.03225806451612903,30,30,AGCGTGCGTGGTTTACGAGA,0,5000717
yjbJ_predicted,0.03225806451612903,30,30,AGCGTAGCTTCTCCATGTGG,0,5025775
yjbJ_predicted,0.03225806451612903,30,30,AGAGTATGAGATCGATTCAA,0,5002313
yjbJ_predicted,0.03225806451612903,30,30,AGACCACTTCTCTACGCTAA,0,5003064
yjbJ_predicted,0.03225806451612903,30,30,ACGCGACACGTTGTGCGTTA,0,5027941
yjbJ_predicted,0.03225806451612903,30,30,AATTTTGCTACCTTACGTGC,0,4999552
yjbJ_predicted,0.03333333333333333,29,29,TGGAATGGACCATCGTCCGT,0,5013386
yjbJ_predicted,0.03333333333333333,29,29,TGCGGCCATCTAGGACCTCA,0,4997850
yjbJ_predicted,0.03333333333333333,29,29,TGCCACAGTTCATGGTTAAC,0,5016147
yjbJ_predicted,0.03333333333333333,29,29,TGCATCGAATCATTCATGGC,0,5003840
yjbJ_predicted,0.03333333333333333,29,29,TCGTGTAGCAGCTGCGAAAT,0,5016415
yjbJ_predicted,0.03333333333333333,29,29,GGTATAGGTGAGGATCGCGT,0,5004226
yjbJ_predicted,0.03333333333333333,29,29,GCCGCGGAGCGGGCTCGCGG,0,4995194
yjbJ_predicted,0.03333333333333333,29,29,GCAAGTCTATAGAGAGAACA,0,4997577
yjbJ_predicted,0.03333333333333333,29,29,GACACTCAAATGTACATGCA,0,5001654
yjbJ_predicted,0.03333333333333333,29,29,CTGTTTGCAGCCGCCCGCTT,0,5005898
yjbJ_predicted,0.03333333333333333,29,29,CGGTTCCGATCCTGGTAAGA,0,5011435
yjbJ_predicted,0.03333333333333333,29,29,CGGACAGCGCAAAACAACTC,0,5010361
yjbJ_predicted,0.03333333333333333,29,29,CGCTCCATGCTAACAAGTAC,0,5012753
yjbJ_predicted,0.03333333333333333,29,29,CAACCAGAAAGTACTCTGAG,0,5007467
yjbJ_predicted,0.03333333333333333,29,29,ATACGCATATAAAGTATTGC,0,5009831
yjbJ_predicted,0.03333333333333333,29,29,AGATGTTCTAAAGACAGGGT,0,5014254
yjbJ_predicted,0.03333333333333333,29,29,ACGTTCATTCATGGGCTCTT,0,5024107
yjbJ_predicted,0.03333333333333333,29,29,ACGGACGTGATAGGACGCTT,0,5011173
yjbJ_predicted,0.034482758620689655,28,28,TTGAAGTCAGTCCTCGTGTT,0,5012700
yjbJ_predicted,0.034482758620689655,28,28,TTAAACTCTAGACAATAGCA,0,5015201
yjbJ_predicted,0.034482758620689655,28,28,TCTCCTCGTACCTGTACGGT,0,5024409
yjbJ_predicted,0.034482758620689655,28,28,TCGATACAGGCGTAGCCCAT,0,5006279
yjbJ_predicted,0.034482758620689655,28,28,TCCTGTACTGGGTTTGTCAC,0,4996216
yjbJ_predicted,0.034482758620689655,28,28,TATAAATATCAAACCTCTCA,0,5003512
yjbJ_predicted,0.034482758620689655,28,28,TAGAAGGTGGACCTCTAGCA,0,5029166
yjbJ_predicted,0.034482758620689655,28,28,TACTACCGATAGGTGGTTAT,0,5020354
yjbJ_predicted,0.034482758620689655,28,28,GGCGGGACATCATGTGTTTG,0,5005897
yjbJ_predicted,0.034482758620689655,28,28,GGATGGCCTGTCGGTCTTGC,0,5008751
yjbJ_predicted,0.034482758620689655,28,28,GATTGCTGGAAATGCGATCT,0,5009297
yjbJ_predicted,0.034482758620689655,28,28,CTTAGCTAGGGGATTAGTAA,0,5005162
yjbJ_predicted,0.034482758620689655,28,28,CTGTTGGAAAATCCCTCCAG,0,5027805
yjbJ_predicted,0.034482758620689655,28,28,CGTCGTCTTCTGCTTGGGTG,0,5017332
yjbJ_predicted,0.034482758620689655,28,28,CGGTGATAGGTGCTCATAGG,0,5028002
yjbJ_predicted,0.034482758620689655,28,28,CGAGAAATGGCACCGACCCT,0,5005183
yjbJ_predicted,0.034482758620689655,28,28,CCGGTACGAGTCTAGGATAG,0,5000516
yjbJ_predicted,0.034482758620689655,28,28,CCGATCCTATCACTTGCCGC,0,5000776
yjbJ_predicted,0.034482758620689655,28,28,CCGAGGAGCTCGTATGGCAA,0,5007224
yjbJ_predicted,0.034482758620689655,28,28,ATCCCGACGTGTGTTGCTAG,0,5015251
yjbJ_predicted,0.034482758620689655,28,28,ACTTAGTCACCCTGTTCCCT,0,5026968
yjbJ_predicted,0.03571428571428571,27,27,TTTATAGAAGGCAAAATCCC,0,5000659
yjbJ_predicted,0.03571428571428571,27,27,TTGGCATACCTATAATTCCT,0,5024836
yjbJ_predicted,0.03571428571428571,27,27,TTCGTCTTATTGGATATTGT,0,5001950
yjbJ_predicted,0.03571428571428571,27,27,TTACCTTGGATTATAAGGGG,0,5028598
yjbJ_predicted,0.03571428571428571,27,27,TTAAGTGTACGATCCGGATC,0,5011329
yjbJ_predicted,0.03571428571428571,27,27,TGTCCAAACAGGGGAAAAAT,0,5021263
yjbJ_predicted,0.03571428571428571,27,27,TCGCGCTGGACAGACCCTCT,0,5024553
yjbJ_predicted,0.03571428571428571,27,27,TATACTGGTAGCATGTTCGA,0,5011743
yjbJ_predicted,0.03571428571428571,27,27,TACTAAAGGACATGTGTAGT,0,5009117
yjbJ_predicted,0.03571428571428571,27,27,TAACCAGAATAAGCGCTGGT,0,5000258
yjbJ_predicted,0.03571428571428571,27,27,GGCATATAAGGGAGCAGCTA,0,5000506
yjbJ_predicted,0.03571428571428571,27,27,GGAGACACTCTCGAGACAGG,0,5006179
yjbJ_predicted,0.03571428571428571,27,27,GCTGGAACATATCTTAGCGC,0,5014946
yjbJ_predicted,0.03571428571428571,27,27,GCGTCTGGCGTTACCATGAT,0,5019170
yjbJ_predicted,0.03571428571428571,27,27,CTTTGTTAATTGGGATGTCT,0,5000140
yjbJ_predicted,0.03571428571428571,27,27,CGTTGTAGCTGGGCGCCACC,0,4995719
yjbJ_predicted,0.03571428571428571,27,27,CGCGTCTTAAACCTGCAGCC,0,5009147
yjbJ_predicted,0.03571428571428571,27,27,CAATCTTTTTTTCCTGTCAC,0,5001564
yjbJ_predicted,0.03571428571428571,27,27,ATTAGCCCACCACCTAATCG,0,4998235
yjbJ_predicted,0.03571428571428571,27,27,AGTGACCCCCGTACCGCATA,0,5020470
yjbJ_predicted,0.03571428571428571,27,27,AGGTAAGCGAGTCATTATAC,0,5008560
yjbJ_predicted,0.03571428571428571,27,27,AGCCACTGTCGGTTAAATGA,0,4996931
yjbJ_predicted,0.03571428571428571,27,27,ACGCGACAGCGAACTGCTCA,0,5025229
yjbJ_predicted,0.03571428571428571,27,27,ACAGTCGAAGTCGGTCTGAT,0,5023408
yjbJ_predicted,0.037037037037037035,26,26,TTGTGACCCAGTGGTAAGCA,0,5005430
yjbJ_predicted,0.037037037037037035,26,26,TTGTCAGGGGACCACAGACT,0,5010956
yjbJ_predicted,0.037037037037037035,26,26,TCCCGGCCAGTGTGACACGC,0,5004002
yjbJ_predicted,0.037037037037037035,26,26,TCAGTCCCCCACTTTGGGAC,0,5001095
yjbJ_predicted,0.037037037037037035,26,26,TCAGTCATCAAGTTATGACT,0,5003793
yjbJ_predicted,0.037037037037037035,26,26,TCAAGGAGGGTGCTGCAGAT,0,5025280
yjbJ_predicted,0.037037037037037035,26,26,GGTATAATGCACTGAGATGT,0,5020341
yjbJ_predicted,0.037037037037037035,26,26,GGGGTACGGGTCCGTCTATG,0,5023816
yjbJ_predicted,0.037037037037037035,26,26,GGGCAGAGTGTGCTCGCTAA,0,5005015
yjbJ_predicted,0.037037037037037035,26,26,GGCGACGGCCGGTACTAACT,0,5010009
yjbJ_predicted,0.037037037037037035,26,26,GGAAAGGCTGATTTTACAGC,0,4997362
yjbJ_predicted,0.037037037037037035,26,26,GCTTGGGGACTTCGTGCGTG,0,5000029
yjbJ_predicted,0.037037037037037035,26,26,GCTGAAGGCGTGTGTCAGCT,0,5007897
yjbJ_predicted,0.037037037037037035,26,26,GCTCGGGCGGCTCATGATGA,0,5007408
yjbJ_predicted,0.037037037037037035,26,26,GCGTGGTACGCAGTGTGGCA,0,4995373
yjbJ_predicted,0.037037037037037035,26,26,GATAAAAATCTATGTACCTA,0,5009280
yjbJ_predicted,0.037037037037037035,26,26,GAGACCAGCTAGACGCAGGG,0,5003274
yjbJ_predicted,0.037037037037037035,26,26,CTGCGAACGTGTGTTGCCTT,0,5020210
yjbJ_predicted,0.037037037037037035,26,26,CGTCCAGTGAGTCAGCCTTG,0,5017677
yjbJ_predicted,0.037037037037037035,26,26,CGTCACACACCGGCCACAGA,0,5006603
yjbJ_predicted,0.037037037037037035,26,26,CGCTCATAGCTGTCATACAT,0,5016018
yjbJ_predicted,0.037037037037037035,26,26,CGAAGCCTATAAAGTTTCCA,0,5029165
yjbJ_predicted,0.037037037037037035,26,26,CCGTTATGAGAGACGACAGT,0,5002128
yjbJ_predicted,0.037037037037037035,26,26,CCGGGTATTCTTCGGCTGTC,0,5000840
yjbJ_predicted,0.037037037037037035,26,26,CCGGAGCTTTTGTTTGGTTT,0,5002360
yjbJ_predicted,0.037037037037037035,26,26,CCCCTGGCTACCATAAGCGA,0,5018126
yjbJ_predicted,0.037037037037037035,26,26,CCCCGAGGTTAACCAACGCA,0,5018864
yjbJ_predicted,0.037037037037037035,26,26,CATCGCCGTGCAAACGTTTT,0,4998020
yjbJ_predicted,0.037037037037037035,26,26,CAGTGACGATCCAGCGAGGG,0,5003409
yjbJ_predicted,0.037037037037037035,26,26,ATATGTCCTGTTATAATGTG,0,5021178
yjbJ_predicted,0.037037037037037035,26,26,ATAAGGGGTGAGGTGAGACA,0,5026181
yjbJ_predicted,0.037037037037037035,26,26,AGTGATGCGGACTCTCGCCC,0,5015915
yjbJ_predicted,0.037037037037037035,26,26,AGGGAGTTCCCATCGGAGGC,0,5001454
yjbJ_predicted,0.037037037037037035,26,26,AGCCTCCATCCGCGGGGTCT,0,4995851
yjbJ_predicted,0.037037037037037035,26,26,ACTTGTGAGCATCAGTGAAC,0,5001231
yjbJ_predicted,0.037037037037037035,26,26,AATGAGGTGCTTATCGCTCA,0,5018623
yjbJ_predicted,0.037037037037037035,26,26,AAGCGAGTGTTCGTGTCGGT,0,5010858
yjbJ_predicted,0.038461538461538464,25,25,TTGTATAATAGATCTTTCGC,0,5006799
yjbJ_predicted,0.038461538461538464,25,25,TTGCGAGGTGATCTGCAAGC,0,5011349
yjbJ_predicted,0.038461538461538464,25,25,TTCGTCGTGCGCGGGGACTG,0,4997737
yjbJ_predicted,0.038461538461538464,25,25,TTCATCCTATGAGTCGCGTA,0,5014108
yjbJ_predicted,0.038461538461538464,25,25,TGTGCCATCGTCATAGTACA,0,5015697
yjbJ_predicted,0.038461538461538464,25,25,TGTAGAGCTAAAGGGGGCTC,0,5024826
yjbJ_predicted,0.038461538461538464,25,25,TGTAAAGAACTGTCGTTACA,0,5001430
yjbJ_predicted,0.038461538461538464,25,25,TGGCGGGGGACGTGTCTGAC,0,5028589
yjbJ_predicted,0.038461538461538464,25,25,TGGAACTACCGAGACTTGGT,0,5026417
yjbJ_predicted,0.038461538461538464,25,25,TCGTAACCGGGAGCGCGGAC,0,5027381
yjbJ_predicted,0.038461538461538464,25,25,TCGACCATACAAATATGTCG,0,5000067
yjbJ_predicted,0.038461538461538464,25,25,TCATTCCCAAGGAGGCTAGA,0,5015843
yjbJ_predicted,0.038461538461538464,25,25,TATCGGTCAAGGCTTATTCT,0,5016821
yjbJ_predicted,0.038461538461538464,25,25,TAGGCAAAATTCAATCCCGG,0,5008357
yjbJ_predicted,0.038461538461538464,25,25,GTCCGTTATTTCCGTCAGGT,0,5002400
yjbJ_predicted,0.038461538461538464,25,25,GTCATGAGAATACTTGAAAA,0,5011606
yjbJ_predicted,0.038461538461538464,25,25,GGTAATAGATGTAGTGATTT,0,5004647
yjbJ_predicted,0.038461538461538464,25,25,GGGAACGGCGTTTTTGCTAT,0,5002560
yjbJ_predicted,0.038461538461538464,25,25,GGCGGGTAGAAATGAGTCAG,0,4995205
yjbJ_predicted,0.038461538461538464,25,25,GGAAATACGACCAGTGGCTT,0,4999935
yjbJ_predicted,0.038461538461538464,25,25,GCTGTCCTTTCATGTAGAGT,0,5007330
yjbJ_predicted,0.038461538461538464,25,25,GCGTGGAACAATGATCTTCA,0,5007120
yjbJ_predicted,0.038461538461538464,25,25,GCGGGAGACGTAGCCGGTGT,0,5021600
yjbJ_predicted,0.038461538461538464,25,25,GCCCACGTCATAGGAAAAAC,0,5012662
yjbJ_predicted,0.038461538461538464,25,25,GCCATATCCGAAACGAGTAC,0,5026090
yjbJ_predicted,0.038461538461538464,25,25,GATGTTCGCAAACCTGATAA,0,4996072
yjbJ_predicted,0.038461538461538464,25,25,GAGCACGGGCAGCGTTCACT,0,5007277
yjbJ_predicted,0.038461538461538464,25,25,GACCCGATGCGATACCCGAT,0,5007104
yjbJ_predicted,0.038461538461538464,25,25,GACAGTTGACAACCGTTTCT,0,5016862
yjbJ_predicted,0.038461538461538464,25,25,GACAAGTGTTAGGTTAGCTG,0,5009232
yjbJ_predicted,0.038461538461538464,25,25,GAATTCTCCGGTAGCTACGT,0,5009122
yjbJ_predicted,0.038461538461538464,25,25,CTTAAAATGGTACTCTAAAC,0,5024416
yjbJ_predicted,0.038461538461538464,25,25,CTAGTGTCACTCTGTTCAGT,0,5001828
yjbJ_predicted,0.038461538461538464,25,25,CGTCTTAGCCTCTCCAGTAG,0,5012267
yjbJ_predicted,0.038461538461538464,25,25,CGCGGGTCTGCAGGAGTGTA,0,5025697
yjbJ_predicted,0.038461538461538464,25,25,CGCAAATTTTGGGAACGCAA,0,5019298
yjbJ_predicted,0.038461538461538464,25,25,CGATCGTCGATTGTTCACAC,0,5029314
yjbJ_predicted,0.038461538461538464,25,25,CGACATGAGGGCTCGGTAGG,0,5003451
yjbJ_predicted,0.038461538461538464,25,25,CCGATATGAAGTTTCTGCGA,0,4995024
yjbJ_predicted,0.038461538461538464,25,25,CCATTGAGGCGCCGAGATTA,0,5000433
yjbJ_predicted,0.038461538461538464,25,25,CATTCCGGTGTCCAGATAGA,0,5017242
yjbJ_predicted,0.038461538461538464,25,25,CATTAGCGCTATAGAACGAG,0,5003885
yjbJ_predicted,0.038461538461538464,25,25,CATGTTTGACCCCGTAACTT,0,5013539
yjbJ_predicted,0.038461538461538464,25,25,CATATGGAGGTACGCCACCA,0,5021129
yjbJ_predicted,0.038461538461538464,25,25,CAGGATGAGCACCGTATCCT,0,5001909
yjbJ_predicted,0.038461538461538464,25,25,ATCCCGCGCGTTAAATAAAC,0,5027637
yjbJ_predicted,0.038461538461538464,25,25,ACCCCCCGGACCAACGGTTC,0,5028491
yjbJ_predicted,0.038461538461538464,25,25,ACAGCGCAGCCAAACGAGAT,0,5011609
yjbJ_predicted,0.038461538461538464,25,25,ACAACTGGCGCATTGCTTTG,0,5000163
yjbJ_predicted,0.038461538461538464,25,25,AATCTGATGGAAGCCTCAGG,0,5027383
yjbJ_predicted,0.038461538461538464,25,25,AAAGCTCTGCACAAACTGCA,0,5011300
yjbJ_predicted,0.04,24,24,TTTCGGAACGAACGACCATT,0,5016596
yjbJ_predicted,0.04,24,24,TTTCACCATGGCGGGCAAAA,0,4997206
yjbJ_predicted,0.04,24,24,TTGGACCATGATTCTTGTAA,0,5006198
yjbJ_predicted,0.04,24,24,TTATTTGACCTACGACGGTT,0,5019083
yjbJ_predicted,0.04,24,24,TTACACTCGTGGATCGTTGA,0,4996584
yjbJ_predicted,0.04,24,24,TGTGCCATTATTCCTCATTC,0,5025737
yjbJ_predicted,0.04,24,24,TGCGGACTCCAAAAGGCCTA,0,5013131
yjbJ_predicted,0.04,24,24,TGCCTGGCGACCAATATGCA,0,5018390
yjbJ_predicted,0.04,24,24,TCTAGGGGGCTTAAGTCTGG,0,5009629
yjbJ_predicted,0.04,24,24,TCGTTTTGGTCTAAACCCAA,0,5026385
yjbJ_predicted,0.04,24,24,TCGGAACCGGTGCAATCGGT,0,5008359
yjbJ_predicted,0.04,24,24,GTGTTGGGAACATAAATTGT,0,5005043
yjbJ_predicted,0.04,24,24,GGTGGCATATAGCGAAAACG,0,5009268
yjbJ_predicted,0.04,24,24,GGCCGAGTGGGCGAAAGATG,0,5015077
yjbJ_predicted,0.04,24,24,GCGTTATTGGAGCGAATTAG,0,5027639
yjbJ_predicted,0.04,24,24,GCGGACTCATACACTTGGTA,0,4996251
yjbJ_predicted,0.04,24,24,GATAGCACATGTAGGCTGTC,0,5006541
yjbJ_predicted,0.04,24,24,GAGCTTATCGTTTGTCACCA,0,4998640
yjbJ_predicted,0.04,24,24,GAGCGCCACTTCCTTAGTAT,0,5026878
yjbJ_predicted,0.04,24,24,GAGAACGCTAGATAAGACCA,0,5015627
yjbJ_predicted,0.04,24,24,CTTTAGCCATGGCCTATCGT,0,5019727
yjbJ_predicted,0.04,24,24,CTGTAGGTGACTTTGGCCTT,0,5015862
yjbJ_predicted,0.04,24,24,CTGCTAGATCGTATCCGGTC,0,5019487
yjbJ_predicted,0.04,24,24,CGTAGAAGAGCAGGATGGAT,0,5003768
yjbJ_predicted,0.04,24,24,CGGGGCGGGCCACCTCCGAA,0,5017235
yjbJ_predicted,0.04,24,24,CGCGTCGGTTGCTAGCTATA,0,4995967
yjbJ_predicted,0.04,24,24,CGCATTACCGCTCTACCACA,0,5015721
yjbJ_predicted,0.04,24,24,CGATTAACGGTCTGAACTAT,0,4998675
yjbJ_predicted,0.04,24,24,CATGTGATTCGTAGAAGGCG,0,4997595
yjbJ_predicted,0.04,24,24,CAGCGTGGGGTTTCGTACAT,0,5018489
yjbJ_predicted,0.04,24,24,CAGCACATATTACGAACCGG,0,5022841
yjbJ_predicted,0.04,24,24,CACTTCCGTGCTGGACGCGG,0,5001446
yjbJ_predicted,0.04,24,24,CAATGTGGATACCGAGAAGG,0,5003196
yjbJ_predicted,0.04,24,24,CAAGTTATTGTACGAGCCCT,0,5007984
yjbJ_predicted,0.04,24,24,ATTAACTGTCGGGTCGATGT,0,5016529
yjbJ_predicted,0.04,24,24,ATGTTGGGACTAGATTGTGC,0,5026363
yjbJ_predicted,0.04,24,24,AGCATGGGATTAAGCACCAG,0,5020570
yjbJ_predicted,0.04,24,24,ACTTCATATCCAGGCAACTA,0,5002675
yjbJ_predicted,0.04,24,24,AAGGCGAAATCGGCCCTACG,0,5025018
yjbJ_predicted,0.04,24,24,AAGATCGGCCGCTTGTGAAC,0,5029228
yjbJ_predicted,0.041666666666666664,23,23,TTGGTTGGCTAGACTACGTA,0,5011793
yjbJ_predicted,0.041666666666666664,23,23,TTGAGACGAGGGGTCGCCGA,0,5012783
yjbJ_predicted,0.041666666666666664,23,23,TTCATCTAAGCAGCTCGATT,0,5002508
yjbJ_predicted,0.041666666666666664,23,23,TGTCCTTTCTGTGTGCGTTT,0,5010061
yjbJ_predicted,0.041666666666666664,23,23,TGATAGGCCGAATCGTACAG,0,5020118
yjbJ_predicted,0.041666666666666664,23,23,TCGCATCAAGTAGCCAGACT,0,4995304
yjbJ_predicted,0.041666666666666664,23,23,TCATGACTGCGGTAGTGACA,0,5000316
yjbJ_predicted,0.041666666666666664,23,23,TCAGCGCGGCCACTTCTTAG,0,4996197
yjbJ_predicted,0.041666666666666664,23,23,TCAACCCTAAAGGTAGGTCG,0,5013489
yjbJ_predicted,0.041666666666666664,23,23,TATAAAAGTATAAAGGGTGC,0,4998869
yjbJ_predicted,0.041666666666666664,23,23,TACGCACGGTAGTGAGTGAA,0,5014316
yjbJ_predicted,0.041666666666666664,23,23,TACCCTGGAATGCGAGACCT,0,5006881
yjbJ_predicted,0.041666666666666664,23,23,GTTCGGAAGTGACCGCCTCG,0,5021155
yjbJ_predicted,0.041666666666666664,23,23,GTTAAGGTTGTTCGGGCGGG,0,5021451
yjbJ_predicted,0.041666666666666664,23,23,GTCAATTTGCCATCGGGGAT,0,5008338
yjbJ_predicted,0.041666666666666664,23,23,GTAGGTATCGCTTTCGGTCA,0,5020578
yjbJ_predicted,0.041666666666666664,23,23,GTAGGCTCTGTTGAAGATAT,0,5010691
yjbJ_predicted,0.041666666666666664,23,23,GGTCATCGTTGCCCTTCAGT,0,5018079
yjbJ_predicted,0.041666666666666664,23,23,GGTCAGGAGGCTAATTTTCG,0,4997078
yjbJ_predicted,0.041666666666666664,23,23,GGGTTCACCGCCTACTAACG,0,4996148
yjbJ_predicted,0.041666666666666664,23,23,GCAGCTAGGATCCTTTCGTA,0,5008717
yjbJ_predicted,0.041666666666666664,23,23,GATTGCTGTGAGGATAGATA,0,5017556
yjbJ_predicted,0.041666666666666664,23,23,GAAAGCGGCTCCCCGGGTCA,0,5016638
yjbJ_predicted,0.041666666666666664,23,23,CTTTTGCTGTCTGTAGCGGT,0,5026534
yjbJ_predicted,0.041666666666666664,23,23,CTTAAGCGATACGTAATACG,0,5020644
yjbJ_predicted,0.041666666666666664,23,23,CTAGGGAGTTTCATCCGATA,0,5026651
yjbJ_predicted,0.041666666666666664,23,23,CGGTGATCAACTTTTACGTT,0,5002228
yjbJ_predicted,0.041666666666666664,23,23,CGAGAGAGTCAATACTTCTA,0,5012317
yjbJ_predicted,0.041666666666666664,23,23,CCCGTAGAAGGTTTTCTGTT,0,5007585
yjbJ_predicted,0.041666666666666664,23,23,CCCGCTAGATTGGGAACCAA,0,4996663
yjbJ_predicted,0.041666666666666664,23,23,CCACGTCCATATTCAAACAA,0,5009407
yjbJ_predicted,0.041666666666666664,23,23,CATGATACTTTGCAGGCACT,0,5002757
yjbJ_predicted,0.041666666666666664,23,23,CATACCCCGGAGAGCAATAG,0,5006877
yjbJ_predicted,0.041666666666666664,23,23,CAGTACCGTCGGTCAGCCTT,0,5005715
yjbJ_predicted,0.041666666666666664,23,23,CAGGAAGCATAAGTGGATTT,0,5017302
yjbJ_predicted,0.041666666666666664,23,23,CAATTCTCATTCGCCGCCTG,0,5013642
yjbJ_predicted,0.041666666666666664,23,23,CAATGGGCGTGCAGTGGTGC,0,5006745
yjbJ_predicted,0.041666666666666664,23,23,CAACCCGAAAGTGATTACGG,0,4999083
yjbJ_predicted,0.041666666666666664,23,23,ATGGATCCTACCTCCGGTTT,0,4994858
yjbJ_predicted,0.041666666666666664,23,23,ATCACGGGGGTACGGTGTGG,0,5004759
yjbJ_predicted,0.041666666666666664,23,23,ATCACAGTTAACACTTGGTA,0,4999086
yjbJ_predicted,0.041666666666666664,23,23,ATACTTTAAGTGGCCTAGGG,0,5008432
yjbJ_predicted,0.041666666666666664,23,23,ATACACTAGCTCATCAATAT,0,5019553
yjbJ_predicted,0.041666666666666664,23,23,ACCCGGGCGGCAACAATTTG,0,5009998
yjbJ_predicted,0.041666666666666664,23,23,AAAGATTTTCCTCTTCGAAG,0,5011604
yjbJ_predicted,0.041666666666666664,23,23,AAACTAGCGAGGTGGGAGGT,0,5001058
yjbJ_predicted,0.043478260869565216,22,22,TTTGTGTAGTGTGCAAGACA,0,5004007
yjbJ_predicted,0.043478260869565216,22,22,TTATCCATGCAATGCAAAGA,0,5013637
yjbJ_predicted,0.043478260869565216,22,22,TGGATACTCGGGGGCGCCCT,0,5017093
yjbJ_predicted,0.043478260869565216,22,22,TGCCCGCGAGGGAGCTTAAT,0,5002348
yjbJ_predicted,0.043478260869565216,22,22,TGCCAAACAATGTTAAAATT,0,5011682
yjbJ_predicted,0.043478260869565216,22,22,TGACCAGCTCCCGAGCGTCG,0,5004249
yjbJ_predicted,0.043478260869565216,22,22,TCTGGACTCAAGCGATGTAT,0,5012523
yjbJ_predicted,0.043478260869565216,22,22,TCGCTATGACATAGCGCTGT,0,5006203
yjbJ_predicted,0.043478260869565216,22,22,TCGAACATGATGGATTTCGT,0,5003615
yjbJ_predicted,0.043478260869565216,22,22,TCCTGTTTGGACGGTCGACA,0,5006609
yjbJ_predicted,0.043478260869565216,22,22,TCATTGGTCCTGACTTCAGA,0,5022295
yjbJ_predicted,0.043478260869565216,22,22,TCATCTCAGCGGTTGCCAGG,0,4999973
yjbJ_predicted,0.043478260869565216,22,22,TCAGGCATCATCTGTATACT,0,5006815
yjbJ_predicted,0.043478260869565216,22,22,TATGGCTTGCTAGCCGGAAA,0,5002604
yjbJ_predicted,0.043478260869565216,22,22,TAAAGGAAGCAACCAAGAAG,0,5004886
yjbJ_predicted,0.043478260869565216,22,22,GTCGGCGACCTCGTAGAAGA,0,4996417
yjbJ_predicted,0.043478260869565216,22,22,GTCCTATAACGCTACGTAAT,0,5014430
yjbJ_predicted,0.043478260869565216,22,22,GGTCAATCTCTGGATCCATT,0,5025394
yjbJ_predicted,0.043478260869565216,22,22,GGCAATGCCTTTCGGCTACA,0,5002509
yjbJ_predicted,0.043478260869565216,22,22,GCAATGCGCTACGATAGTAC,0,5014982
yjbJ_predicted,0.043478260869565216,22,22,GATGCGGTACATCCCCGCGG,0,5023180
yjbJ_predicted,0.043478260869565216,22,22,GATAAAAGCCGAAATATCAG,0,5001125
yjbJ_predicted,0.043478260869565216,22,22,CTAGGGCCGCCCCCGGCAAA,0,5000816
yjbJ_predicted,0.043478260869565216,22,22,CGTCTGGAGTCCCCTAACAT,0,5022412
yjbJ_predicted,0.043478260869565216,22,22,CGTACCTCAATAGATGGGTC,0,5004890
yjbJ_predicted,0.043478260869565216,22,22,CGTAAAAGAGTTGGTAAAGA,0,5022604
yjbJ_predicted,0.043478260869565216,22,22,CGCCGAAACGAAACTAAAGG,0,5029260
yjbJ_predicted,0.043478260869565216,22,22,CCGATGTGGACTGCATGGAG,0,5021752
yjbJ_predicted,0.043478260869565216,22,22,CCCTCTTCAGCACGGAATTC,0,5010479
yjbJ_predicted,0.043478260869565216,22,22,CCCGACGATTCTGGCAAGGA,0,5030089
yjbJ_predicted,0.043478260869565216,22,22,CAGGCCCTGGTAGAACAACG,0,5025519
yjbJ_predicted,0.043478260869565216,22,22,ATGCAAGGTAAAACCGCATT,0,5007149
yjbJ_predicted,0.043478260869565216,22,22,ATGACTTATCTCAGGTTCGC,0,5029635
yjbJ_predicted,0.043478260869565216,22,22,ATACGAGGAGGCCTTGCAAC,0,5021541
yjbJ_predicted,0.043478260869565216,22,22,ATACAAAATCAATTGGAATG,0,5024924
yjbJ_predicted,0.043478260869565216,22,22,AGGTGAAAGAGATACGGATA,0,5006493
yjbJ_predicted,0.043478260869565216,22,22,AGGGTACGGGCGAAGAAAAG,0,4996319
yjbJ_predicted,0.043478260869565216,22,22,AGCTCCTCGGCCTACCGGGT,0,5028259
yjbJ_predicted,0.043478260869565216,22,22,AGCGGCGGGGGCAGATCGCG,0,5002276
yjbJ_predicted,0.043478260869565216,22,22,AGAGAGTAGTAAGTTCAGTT,0,5028497
yjbJ_predicted,0.043478260869565216,22,22,ACTAGCGTTTCGGAATTCGT,0,4998065
yjbJ_predicted,0.043478260869565216,22,22,ACGCTGCGGATCGATCGCAT,0,5018361
yjbJ_predicted,0.043478260869565216,22,22,ACGCCCAAGCATACTCAAAA,0,5027029
yjbJ_predicted,0.043478260869565216,22,22,ACCGAGATCTCCAGACAGGT,0,5004038
yjbJ_predicted,0.043478260869565216,22,22,ACAGCGGTGGGAGAGAAGAG,0,5020068
yjbJ_predicted,0.043478260869565216,22,22,AAGTTGACATTTTGCTAAGA,0,5021199
yjbJ_predicted,0.045454545454545456,21,21,TTTGCAGCCGCGGCACCAAA,0,5019508
yjbJ_predicted,0.045454545454545456,21,21,TTGTGGTCAGAGCAAATTTT,0,5023124
yjbJ_predicted,0.045454545454545456,21,21,TTGCCCCTCGGCGGGATAAC,0,5016918
yjbJ_predicted,0.045454545454545456,21,21,TTCTGACCCAAACTCTGCGA,0,4995898
yjbJ_predicted,0.045454545454545456,21,21,TTCGGTCATTTCGTTGATAA,0,5013345
yjbJ_predicted,0.045454545454545456,21,21,TTAGCCGGTCGTTTAAGTTG,0,4997475
yjbJ_predicted,0.045454545454545456,21,21,TGGGTCTAGCTAACTCCTGT,0,4999313
yjbJ_predicted,0.045454545454545456,21,21,TGGATAAATCCAATCCGTTA,0,4997858
yjbJ_predicted,0.045454545454545456,21,21,TGCCTTTACTACGCATGTGA,0,4996313
yjbJ_predicted,0.045454545454545456,21,21,TGATGCATCGCTGGGCTGGT,0,5008083
yjbJ_predicted,0.045454545454545456,21,21,TGAACATCGAGCCACAGTCG,0,5004428
yjbJ_predicted,0.045454545454545456,21,21,TCTTGGGAGTTATCTAGGAT,0,4997083
yjbJ_predicted,0.045454545454545456,21,21,TAGGTCCCTTCGCAACTACT,0,5007491
yjbJ_predicted,0.045454545454545456,21,21,TAGCAAAGTAGCATGCTGCA,0,5005172
yjbJ_predicted,0.045454545454545456,21,21,TACGATCGTAAGGCTTAGGG,0,4996611
yjbJ_predicted,0.045454545454545456,21,21,TACACCAACTCCCTGGGGGA,0,4996174
yjbJ_predicted,0.045454545454545456,21,21,TACAACGGGGGATCGGATTT,0,5003450
yjbJ_predicted,0.045454545454545456,21,21,GTGTAGGGGTCAAGGTTGAG,0,5004906
yjbJ_predicted,0.045454545454545456,21,21,GTGTACTCTAAATATTGGCA,0,5004388
yjbJ_predicted,0.045454545454545456,21,21,GTCTTAGCACGGTCTTAGAA,0,5019582
yjbJ_predicted,0.045454545454545456,21,21,GTCGGACGTACGTAGAGGAG,0,5019288
yjbJ_predicted,0.045454545454545456,21,21,GTATTATTTCCGGGAGTTGT,0,5016700
yjbJ_predicted,0.045454545454545456,21,21,GGTGGAGACGGGTCGGCCCT,0,5017254
yjbJ_predicted,0.045454545454545456,21,21,GGGTTTATGGCTCACAGGCT,0,5018125
yjbJ_predicted,0.045454545454545456,21,21,GGGTAGTTTGGAGTATCAGT,0,5001701
yjbJ_predicted,0.045454545454545456,21,21,GGCCGTGACTAGAGCTCGAC,0,5004976
yjbJ_predicted,0.045454545454545456,21,21,GGCATTATAACTATTCACAA,0,5003718
yjbJ_predicted,0.045454545454545456,21,21,GGCACGATTGGACATACTTC,0,5013395
yjbJ_predicted,0.045454545454545456,21,21,GCGTGGGTTTATGGGCACTA,0,5017957
yjbJ_predicted,0.045454545454545456,21,21,GCGGGTCTTTGTCTGAGTTG,0,5017596
yjbJ_predicted,0.045454545454545456,21,21,GCGCTGAGGAATCACGCAGC,0,5002793
yjbJ_predicted,0.045454545454545456,21,21,GCGCTCGCAAAACCGATAGC,0,5021937
yjbJ_predicted,0.045454545454545456,21,21,GCCTACAGGGAGATTATCCA,0,5025631
yjbJ_predicted,0.045454545454545456,21,21,GCCCGATGCAGAGATTGCGT,0,4998224
yjbJ_predicted,0.045454545454545456,21,21,GCCCGATCGGGGGACCCATC,0,4998202
yjbJ_predicted,0.045454545454545456,21,21,GCAGAAATCCGTTTCACCTG,0,4999637
yjbJ_predicted,0.045454545454545456,21,21,GATCCCTGTCTGTTTCGCTG,0,5001841
yjbJ_predicted,0.045454545454545456,21,21,GACGCCAACCAGGTTCCGAT,0,5007466
yjbJ_predicted,0.045454545454545456,21,21,GACCGCCAATCGACACGCTT,0,5001784
yjbJ_predicted,0.045454545454545456,21,21,GAACTGGTCTGTTCCCCGGC,0,5017289
yjbJ_predicted,0.045454545454545456,21,21,CTTAGCAAGCCAGGATTCCT,0,5004364
yjbJ_predicted,0.045454545454545456,21,21,CTGTAGACCGCAGGAAATGT,0,5021605
yjbJ_predicted,0.045454545454545456,21,21,CTCAACGCAGCTTATCAACA,0,5030206
yjbJ_predicted,0.045454545454545456,21,21,CTCAACGACTGCAGGAAATT,0,5002603
yjbJ_predicted,0.045454545454545456,21,21,CTAGGTACCCTGGCCAGTGT,0,5000947
yjbJ_predicted,0.045454545454545456,21,21,CTACGAGGGGGGATCTACCT,0,5022405
yjbJ_predicted,0.045454545454545456,21,21,CTACCGAAAGCCGCCGCTAA,0,5007264
yjbJ_predicted,0.045454545454545456,21,21,CGGTTACGTGTCCAGTTGAG,0,5025147
yjbJ_predicted,0.045454545454545456,21,21,CGGCTGTGCTTGATAGGGGC,0,5016903
yjbJ_predicted,0.045454545454545456,21,21,CGAGTGTAAGGAGCCTTCGG,0,4999829
yjbJ_predicted,0.045454545454545456,21,21,CGACCGGTCGGTTAATAATC,0,4996172
yjbJ_predicted,0.045454545454545456,21,21,CGACAGGACGATTATAGGTT,0,5005392
yjbJ_predicted,0.045454545454545456,21,21,CCTTCCCAGCTAAACGATGA,0,5026950
yjbJ_predicted,0.045454545454545456,21,21,CCCATTCTTACCTTGCAGCC,0,5030292
yjbJ_predicted,0.045454545454545456,21,21,CCACTGGTGTCAAGCTGTGG,0,5015551
yjbJ_predicted,0.045454545454545456,21,21,CATGCGAGTCACCCGGAGTC,0,4999553
yjbJ_predicted,0.045454545454545456,21,21,CATCCCCTGAGCTCAGAACA,0,5000968
yjbJ_predicted,0.045454545454545456,21,21,CAGTACGACCCCGCTGTCCA,0,5016020
yjbJ_predicted,0.045454545454545456,21,21,CAAGACGCTAATAATCAACA,0,5010531
yjbJ_predicted,0.045454545454545456,21,21,CAACAGAGTCGAAATGCATG,0,5000043
yjbJ_predicted,0.045454545454545456,21,21,ATGATATACACAAATCGGGT,0,4997117
yjbJ_predicted,0.045454545454545456,21,21,ATGAAGCATGACTCATACTG,0,5000638
yjbJ_predicted,0.045454545454545456,21,21,ATCTGTATAAATGCACGAGT,0,5006536
yjbJ_predicted,0.045454545454545456,21,21,ATCGAGTATGGTGTGATAAT,0,5005348
yjbJ_predicted,0.045454545454545456,21,21,AGCTTAACCCGACTATCTAT,0,5028648
yjbJ_predicted,0.045454545454545456,21,21,ACTTGAGCGTAGATAAGTTT,0,5030584
yjbJ_predicted,0.045454545454545456,21,21,ACTCGAATAGACTCGTTAAT,0,5003198
yjbJ_predicted,0.045454545454545456,21,21,ACGTTGCTAGCTTTAGGGAT,0,5027586
yjbJ_predicted,0.045454545454545456,21,21,ACGTACCATCTTGACCATCT,0,5012608
yjbJ_predicted,0.045454545454545456,21,21,ACGCGCATTGACGTAAGGTG,0,4996458
yjbJ_predicted,0.045454545454545456,21,21,ACCTCCAAAGAGGGGCACTG,0,5022182
yjbJ_predicted,0.045454545454545456,21,21,ACCATAGCAGGATAGTGTTC,0,5021242
yjbJ_predicted,0.045454545454545456,21,21,AATTACCCTATTGGTCTTAC,0,5011977
yjbJ_predicted,0.045454545454545456,21,21,AAGCGTTTTCTTTACAGCAG,0,5020944
yjbJ_predicted,0.047619047619047616,20,20,TTCATCTGCCTTCTAAGGCA,0,5014381
yjbJ_predicted,0.047619047619047616,20,20,TGTTCCGCGCCTTCCCTCCG,0,5024352
yjbJ_predicted,0.047619047619047616,20,20,TGTGACTTGGGAACTAAAAT,0,5026503
yjbJ_predicted,0.047619047619047616,20,20,TGTCGTCTCATCATTTATTT,0,5024555
yjbJ_predicted,0.047619047619047616,20,20,TGGCTCTTGTTGGCCGTCCA,0,5029257
yjbJ_predicted,0.047619047619047616,20,20,TGAACGCCATCGCGTAGGGT,0,5000950
yjbJ_predicted,0.047619047619047616,20,20,TCGGACACAGCCCTCCGGTA,0,5012769
yjbJ_predicted,0.047619047619047616,20,20,TCCCGACTCAGACAGACTTG,0,5015073
yjbJ_predicted,0.047619047619047616,20,20,TCCAGTAATTGGGAGATCGT,0,4998752
yjbJ_predicted,0.047619047619047616,20,20,TCCAGGACTTATGTTTGTAA,0,5023563
yjbJ_predicted,0.047619047619047616,20,20,TATCTTACATTATTAGAAAT,0,5006387
yjbJ_predicted,0.047619047619047616,20,20,TAGCCTCCTTGGCGAACCAT,0,5005349
yjbJ_predicted,0.047619047619047616,20,20,TACTTGCTTATTTCAAGGTT,0,5001447
yjbJ_predicted,0.047619047619047616,20,20,TAAGGGGCAAACGCGAACGG,0,5025365
yjbJ_predicted,0.047619047619047616,20,20,TAAGCACACATTCTGCTCCT,0,5004534
yjbJ_predicted,0.047619047619047616,20,20,GTAAGTAAGGTATGGAATTA,0,5028427
yjbJ_predicted,0.047619047619047616,20,20,GGTTAGGCCGTACCGGCGTC,0,5003312
yjbJ_predicted,0.047619047619047616,20,20,GGTCATATCTAAGTGGTCTT,0,5018157
yjbJ_predicted,0.047619047619047616,20,20,GGTACGACGCTGATTGTAGT,0,5005983
yjbJ_predicted,0.047619047619047616,20,20,GCGTACATAGGAGCTTGCTG,0,5000168
yjbJ_predicted,0.047619047619047616,20,20,GAGTATCACGGCTCTAACAG,0,5026591
yjbJ_predicted,0.047619047619047616,20,20,GAGTACAACTAAATCAGGCA,0,5003194
yjbJ_predicted,0.047619047619047616,20,20,GAGGTCATCGCAGAGGTGGC,0,5005223
yjbJ_predicted,0.047619047619047616,20,20,GAGAGGGATCGCCACGGAAT,0,4997715
yjbJ_predicted,0.047619047619047616,20,20,GACAGATCGCAGATATTTGT,0,5000618
yjbJ_predicted,0.047619047619047616,20,20,CTGCAAGGACACGCGACGGA,0,5021661
yjbJ_predicted,0.047619047619047616,20,20,CTACGAAGTCCGGACCGCCC,0,5007712
yjbJ_predicted,0.047619047619047616,20,20,CGTGGACCGTAAAGCCCTTG,0,4994765
yjbJ_predicted,0.047619047619047616,20,20,CGTAAGTGCACAGTCTGACT,0,5013167
yjbJ_predicted,0.047619047619047616,20,20,CGGTCAGAAAGGTAGCTCTT,0,5010477
yjbJ_predicted,0.047619047619047616,20,20,CGGGGACCTGGGTCCCGGTT,0,5023087
yjbJ_predicted,0.047619047619047616,20,20,CGGGCGAGAGCCCGATAGCA,0,5003320
yjbJ_predicted,0.047619047619047616,20,20,CGGAATTTAAAACTATATGT,0,4995706
yjbJ_predicted,0.047619047619047616,20,20,CGCTAGGCTCATCGCAACGT,0,5006511
yjbJ_predicted,0.047619047619047616,20,20,CGCCTACTCATCAAACGCAT,0,4995028
yjbJ_predicted,0.047619047619047616,20,20,CGCCCCGCATATAGGATCGC,0,5006178
yjbJ_predicted,0.047619047619047616,20,20,CGCACGGGCCATGCCGTATG,0,5015796
yjbJ_predicted,0.047619047619047616,20,20,CGATAGCAGAATCCCTTGTT,0,5007797
yjbJ_predicted,0.047619047619047616,20,20,CGACTGGGGGGTGCGGGTTC,0,5019344
yjbJ_predicted,0.047619047619047616,20,20,CGAATTCTGTTCCAACCTAT,0,5027251
yjbJ_predicted,0.047619047619047616,20,20,CCGGTCTTATTCCGCCCTCT,0,5029347
yjbJ_predicted,0.047619047619047616,20,20,CCATTCGATCGATTCCGCGA,0,5006097
yjbJ_predicted,0.047619047619047616,20,20,CATTTACACCCCAGACAGGG,0,4995240
yjbJ_predicted,0.047619047619047616,20,20,CATAGTCATGTGTATATGGT,0,5002632
yjbJ_predicted,0.047619047619047616,20,20,CATAGAGTAACAGAAAGCTG,0,4997277
yjbJ_predicted,0.047619047619047616,20,20,CAGGCTTCTCGCGGCTCCCC,0,5028244
yjbJ_predicted,0.047619047619047616,20,20,CAGCGGTCGATCTACGTTTG,0,4997588
yjbJ_predicted,0.047619047619047616,20,20,CACCGGGCACCTCGGTTAGG,0,5013958
yjbJ_predicted,0.047619047619047616,20,20,CAAAACTCCCGCGACAAACA,0,5001758
yjbJ_predicted,0.047619047619047616,20,20,ATTCGATCATAGAAGCTCTT,0,5022185
yjbJ_predicted,0.047619047619047616,20,20,ATTAGGTGGTAAATGAAAAA,0,5012728
yjbJ_predicted,0.047619047619047616,20,20,ATGTATGCCCGGCCTATTCA,0,5028088
yjbJ_predicted,0.047619047619047616,20,20,ATGAATTCCGCCTGCCTCAA,0,5000004
yjbJ_predicted,0.047619047619047616,20,20,ATCGATACATGAGGCCTCTG,0,5002227
yjbJ_predicted,0.047619047619047616,20,20,ATCCCGTCACATTCATGATG,0,5023506
yjbJ_predicted,0.047619047619047616,20,20,ATAGGTCCACGTTATTTGCA,0,5002442
yjbJ_predicted,0.047619047619047616,20,20,AGTTGCCCCGATAATGCTGT,0,5007869
yjbJ_predicted,0.047619047619047616,20,20,AGGTCTCGGGTATTGCGACT,0,5013937
yjbJ_predicted,0.047619047619047616,20,20,AGGGAGGAACCACCCACTTA,0,5003796
yjbJ_predicted,0.047619047619047616,20,20,AGGGAAGATACAGCCCCGTA,0,5019902
yjbJ_predicted,0.047619047619047616,20,20,AGGCTGAACGACTATATTGC,0,5023433
yjbJ_predicted,0.047619047619047616,20,20,AGGCAATCGGGGCTTTACTA,0,4999839
yjbJ_predicted,0.047619047619047616,20,20,AGGACTTGTGAGTTAGAAAT,0,5015318
yjbJ_predicted,0.047619047619047616,20,20,AGCTTGAAGCAGATCACGAA,0,5010336
yjbJ_predicted,0.047619047619047616,20,20,AGCGCGACTCGCGGGTAAGA,0,5018066
yjbJ_predicted,0.047619047619047616,20,20,AGATGAGCTAGAAGCTTATA,0,5008465
yjbJ_predicted,0.047619047619047616,20,20,AGAGTGTGTGACAGGCTTAC,0,5029364
yjbJ_predicted,0.047619047619047616,20,20,AGACGGTTATTGCGGACAAC,0,4997209
yjbJ_predicted,0.047619047619047616,20,20,ACTGTTGCGATTCATTTTGT,0,5002009
yjbJ_predicted,0.047619047619047616,20,20,ACTGCTGATCGCGGGTCACA,0,5023984
yjbJ_predicted,0.047619047619047616,20,20,ACCGGTCCCAACGTGCTGAC,0,5027908
yjbJ_predicted,0.047619047619047616,20,20,ACCCAGATTGCTTATGGTAT,0,5008035
yjbJ_predicted,0.047619047619047616,20,20,AATTTACCGATAAGTGGAAT,0,5010525
yjbJ_predicted,0.047619047619047616,20,20,AATAGGATATCTGTCTTCAA,0,5009401
yjbJ_predicted,0.047619047619047616,20,20,AAGGACATCTTAGGGAATCA,0,5001380
yjbJ_predicted,0.047619047619047616,20,20,AAGAACCCGCGAGGCGACGG,0,5001451
yjbJ_predicted,0.047619047619047616,20,20,AACCAGTTAAGTACCACAGG,0,5020938
yjbJ_predicted,0.05,19,19,TTATATAGTGGATTGACGAT,0,5030834
yjbJ_predicted,0.05,19,19,TGTCTTCCCGGGCGGTAAGG,0,5024251
yjbJ_predicted,0.05,19,19,TGTAGGGTTTCTGTAGCGGA,0,4999481
yjbJ_predicted,0.05,19,19,TGCGCACGCAGCTACACTCG,0,5013457
yjbJ_predicted,0.05,19,19,TGATTAGTCGTTCCTACTTG,0,4996819
yjbJ_predicted,0.05,19,19,TGACATCGGCTGTTTATCCG,0,4995282
yjbJ_predicted,0.05,19,19,TCTGCGTCAGTCTGGTGATA,0,4995551
yjbJ_predicted,0.05,19,19,TCTGCCTGGCGGGCGTAGCA,0,5025212
yjbJ_predicted,0.05,19,19,TCGTCCAAAACAATCCGATA,0,5001842
yjbJ_predicted,0.05,19,19,TCCTTCCACGTGTCCGACAT,0,5019373
yjbJ_predicted,0.05,19,19,TCCGCATATAAATAGATGTT,0,5005259
yjbJ_predicted,0.05,19,19,TCATGAGTATCTCGCGCCAC,0,5021679
yjbJ_predicted,0.05,19,19,TCACAAAGATTGATAAGTTC,0,4995663
yjbJ_predicted,0.05,19,19,TATTGCACTTTGCTAAGATG,0,5009487
yjbJ_predicted,0.05,19,19,TATGGCGATTGGGGTCGAAC,0,5008809
yjbJ_predicted,0.05,19,19,TATGCAACCACCTTGGACTG,0,5016155
yjbJ_predicted,0.05,19,19,TATAAGCGCGGGTTTTGAGC,0,5010292
yjbJ_predicted,0.05,19,19,TAGGTCAGGGATAGCCTCAC,0,4996950
yjbJ_predicted,0.05,19,19,TAGGTAGTCACATGGAGATG,0,5014054
yjbJ_predicted,0.05,19,19,TAGGGGTGTCCATGAACGGG,0,5001052
yjbJ_predicted,0.05,19,19,TAGATGCGGATTCCTTTACA,0,5026483
yjbJ_predicted,0.05,19,19,TACTGTGCCCCGTTCAATTG,0,5018090
yjbJ_predicted,0.05,19,19,TAATTCGCTTTTTGGATGGT,0,5003611
yjbJ_predicted,0.05,19,19,TAAGGGATCGCGACACACGT,0,5030458
yjbJ_predicted,0.05,19,19,TAACATCCTACAGTCGAGAT,0,5018456
yjbJ_predicted,0.05,19,19,GTTGAACCGTGGAGATTCGA,0,5017095
yjbJ_predicted,0.05,19,19,GTCTGGCGTCGGATATGGGG,0,5009127
yjbJ_predicted,0.05,19,19,GTCTCTTTAGGTACAGGCTC,0,5001729
yjbJ_predicted,0.05,19,19,GTATTTACCACAGACCCAAG,0,5016696
yjbJ_predicted,0.05,19,19,GTAGCCTTGACCAGTATGGT,0,5021172
yjbJ_predicted,0.05,19,19,GTACGGGGGTCCGACTAAGA,0,5019952
yjbJ_predicted,0.05,19,19,GTAATATGCACGACAGTATA,0,5006434
yjbJ_predicted,0.05,19,19,GTAAAAACCGCTTCGGAAAG,0,5008393
yjbJ_predicted,0.05,19,19,GGTTTGCCGAATTAGCAGTA,0,4996794
yjbJ_predicted,0.05,19,19,GGGAACTTGGTCTGTTATCA,0,5024723
yjbJ_predicted,0.05,19,19,GGCTGTTTCGGTGGTAGTGA,0,5022066
yjbJ_predicted,0.05,19,19,GGCATATGGTTCGAACAAGT,0,5013517
yjbJ_predicted,0.05,19,19,GGATGAGCGACTCCAGCGTG,0,5005284
yjbJ_predicted,0.05,19,19,GGAGCTACCTAGCGTGCTCT,0,4994684
yjbJ_predicted,0.05,19,19,GGACTTCGAGTCATGCCAGC,0,5008197
yjbJ_predicted,0.05,19,19,GCGGGGCACAGGAGCCGTGG,0,5014568
yjbJ_predicted,0.05,19,19,GCGGACGTCTGTCGCTTCTA,0,5017294
yjbJ_predicted,0.05,19,19,GCGCTTGTTTATGATGGGCG,0,4998982
yjbJ_predicted,0.05,19,19,GCGATGGATGCTAGATGGGG,0,5021717
yjbJ_predicted,0.05,19,19,GCCTAAGGGGTTTCATAAGC,0,5020132
yjbJ_predicted,0.05,19,19,GCCAGCGAACGGAATCTCTA,0,5005487
yjbJ_predicted,0.05,19,19,GAGGTCAGGAAGGCAGCTAA,0,4995041
yjbJ_predicted,0.05,19,19,GACTGTGAGTAGCCAGTCCA,0,5003735
yjbJ_predicted,0.05,19,19,GACTCCTTACCAAAAGCTAC,0,5017907
yjbJ_predicted,0.05,19,19,GAATAACGGGAATACAGTAA,0,5000764
yjbJ_predicted,0.05,19,19,GAACTCTGCTAATTAATCTC,0,5007036
yjbJ_predicted,0.05,19,19,GAACAATCCCACCCTTATGT,0,5031206
yjbJ_predicted,0.05,19,19,CTTTCGTACTCGAAAAGTAA,0,5018231
yjbJ_predicted,0.05,19,19,CTTCCCTAAGGCTATCCGGG,0,5008578
yjbJ_predicted,0.05,19,19,CTGCCCCGGGGAACGGTAAC,0,5005634
yjbJ_predicted,0.05,19,19,CTATAGAATCTGTGGAGCGT,0,5008361
yjbJ_predicted,0.05,19,19,CGTAGAATACGGATCAAGGG,0,5028221
yjbJ_predicted,0.05,19,19,CCTTGAACACTAAGTAAAGA,0,5031102
yjbJ_predicted,0.05,19,19,CCTACCAAAGCTTCGCTTAG,0,5023979
yjbJ_predicted,0.05,19,19,CCGTAAGCCATAGACCTGCT,0,5015618
yjbJ_predicted,0.05,19,19,CATTTATTTTACTGGGACGA,0,5015292
yjbJ_predicted,0.05,19,19,CAGTAGCGCCCTAATCTCGA,0,5008794
yjbJ_predicted,0.05,19,19,CAGGCATAGGAGCCTTCCGT,0,5010475
yjbJ_predicted,0.05,19,19,CACGTACTCAGATCGTTTCC,0,5017044
yjbJ_predicted,0.05,19,19,ATTATGGCCTAACCGCGATC,0,5021536
yjbJ_predicted,0.05,19,19,ATGATACCAGACTCAAGCCA,0,5000263
yjbJ_predicted,0.05,19,19,ATCCCGCTCCCAGTTACTCC,0,5002285
yjbJ_predicted,0.05,19,19,ATCATATGCTTAAATAAGAA,0,5011083
yjbJ_predicted,0.05,19,19,AGTTCTTACGTAGGTCAACA,0,5025247
yjbJ_predicted,0.05,19,19,AGGCATCGTGGTGGATTAAG,0,5000071
yjbJ_predicted,0.05,19,19,AGCTGGTTCGGTATGATGCT,0,5002676
yjbJ_predicted,0.05,19,19,AGCGGGTTCGTCATTTTCAA,0,5013676
yjbJ_predicted,0.05,19,19,AGCGACGCCTGAGGTCATGC,0,5022689
yjbJ_predicted,0.05,19,19,AGCATTGTAGAGGGACTCCA,0,5015777
yjbJ_predicted,0.05,19,19,AGACGCTGTATAAGATTGAT,0,4994832
yjbJ_predicted,0.05,19,19,AGACGACTTGTGCTATGGCA,0,5023060
yjbJ_predicted,0.05,19,19,ACTGTGCGGTAGGGCTAGCT,0,5022029
yjbJ_predicted,0.05,19,19,ACTCCCCCATAATACGGTAT,0,4998756
yjbJ_predicted,0.05,19,19,ACGGCACGGTGATGACAAAG,0,5020695
yjbJ_predicted,0.05,19,19,AATGCGTAAAAAACGCTGGT,0,5013983
yjbJ_predicted,0.05,19,19,AATCCTGTGCGCATGGTTCC,0,5019742
yjbJ_predicted,0.05,19,19,AATCCACTGCGGGGTTGTGA,0,5010808
yjbJ_predicted,0.05,19,19,AAGTTTGGGAAAGGAGCGTG,0,5020461
yjbJ_predicted,0.05,19,19,AAGGATCTTGGACTGACCAC,0,5005254
yjbJ_predicted,0.05,19,19,AACGTAAACGACACTTTGTC,0,5006982
yjbJ_predicted,0.05,19,19,AAATTAGCACTCGACCAGGG,0,5028217
yjbJ_predicted,0.05263157894736842,18,18,TTGTCGCCATTAAGTGTCAT,0,4996714
yjbJ_predicted,0.05263157894736842,18,18,TTGGTCTTCAATGCAGGGCC,0,5022864
yjbJ_predicted,0.05263157894736842,18,18,TTGCGGACTAGACGCTTAGG,0,5018915
yjbJ_predicted,0.05263157894736842,18,18,TTGATGGTAAACTAAAGCCG,0,5010699
yjbJ_predicted,0.05263157894736842,18,18,TTCTACCATGACTTAAGAGC,0,5014336
yjbJ_predicted,0.05263157894736842,18,18,TTCCTGGCGCACAGCGGGTT,0,5007905
yjbJ_predicted,0.05263157894736842,18,18,TTAATCTACGGGGAGTAAGA,0,5013059
yjbJ_predicted,0.05263157894736842,18,18,TGGTTTGAGGTTATATAATG,0,5008400
yjbJ_predicted,0.05263157894736842,18,18,TGGTTTCCCCAATTTGACAT,0,5017931
yjbJ_predicted,0.05263157894736842,18,18,TGGATCTCGCATAGAGACAT,0,5024665
yjbJ_predicted,0.05263157894736842,18,18,TGCAGGAATGGATTAGCGTT,0,5006845
yjbJ_predicted,0.05263157894736842,18,18,TGAAGGTAGCCAGGTCCTCT,0,5016680
yjbJ_predicted,0.05263157894736842,18,18,TGAAACGGGGGCTCTGATCC,0,5021841
yjbJ_predicted,0.05263157894736842,18,18,TCTTGCTACTATCGTCAGAG,0,4996456
yjbJ_predicted,0.05263157894736842,18,18,TCTCCTAAGAAACTCTCACG,0,5022584
yjbJ_predicted,0.05263157894736842,18,18,TCGCCCGTGTTCGAAACGCA,0,5004624
yjbJ_predicted,0.05263157894736842,18,18,TCCCGCTTTAATGGATCCCG,0,5022139
yjbJ_predicted,0.05263157894736842,18,18,TATGTTCGCGTTATGAATTG,0,5006139
yjbJ_predicted,0.05263157894736842,18,18,TATAGAGTCCGCGGAACCCA,0,5018882
yjbJ_predicted,0.05263157894736842,18,18,TAGCGTCTTCCAAAGATGCT,0,5013111
yjbJ_predicted,0.05263157894736842,18,18,TAGCATTTTACCAAGGGTAG,0,4995609
yjbJ_predicted,0.05263157894736842,18,18,TAATTCAGGAGGGAATAAGT,0,5025831
yjbJ_predicted,0.05263157894736842,18,18,TAAGAACGTTTCGATTCGCC,0,5017772
yjbJ_predicted,0.05263157894736842,18,18,GTTATACCGGTCTTGGATAG,0,5006314
yjbJ_predicted,0.05263157894736842,18,18,GTGAACCTTGTTTGGTGACT,0,4996893
yjbJ_predicted,0.05263157894736842,18,18,GTCGCCGTATGAGCCCCAGG,0,5009659
yjbJ_predicted,0.05263157894736842,18,18,GTCCCTTACTAGGTACATCA,0,5001419
yjbJ_predicted,0.05263157894736842,18,18,GTCATCCGAATCTCACATAT,0,4996636
yjbJ_predicted,0.05263157894736842,18,18,GTAGCCTGACACCCAAGTCC,0,5010360
yjbJ_predicted,0.05263157894736842,18,18,GGTTGGAACTCACAGCGGCT,0,4997383
yjbJ_predicted,0.05263157894736842,18,18,GGTTCCTGGAAAGAATCCTC,0,5002808
yjbJ_predicted,0.05263157894736842,18,18,GGTGCGGGTTTCTGGAAGCT,0,5016361
yjbJ_predicted,0.05263157894736842,18,18,GGTCTAAAGTGAGCGGTCTG,0,5001478
yjbJ_predicted,0.05263157894736842,18,18,GGTACTCCCACAAGTTAAGG,0,5002487
yjbJ_predicted,0.05263157894736842,18,18,GGGTACATTAGCGGATACGC,0,5008260
yjbJ_predicted,0.05263157894736842,18,18,GGGGATGTAGTGGGGGGTTT,0,5017406
yjbJ_predicted,0.05263157894736842,18,18,GGCTATATCCGCAAATCTAT,0,4994823
yjbJ_predicted,0.05263157894736842,18,18,GGATTAGGGTCGTACCATTT,0,5025809
yjbJ_predicted,0.05263157894736842,18,18,GGACTTTCTTTACATGGCGT,0,5010193
yjbJ_predicted,0.05263157894736842,18,18,GCTTGGCTATCACGCACGGT,0,5011984
yjbJ_predicted,0.05263157894736842,18,18,GCGTTATCACGTTTTCGTGA,0,5021633
yjbJ_predicted,0.05263157894736842,18,18,GCGTGTCTTCTCGTACAGGG,0,5000432
yjbJ_predicted,0.05263157894736842,18,18,GATTCGGCGGAGGGTCTGCC,0,5019051
yjbJ_predicted,0.05263157894736842,18,18,GATGGGTTTACCTCGGAAAT,0,5031232
yjbJ_predicted,0.05263157894736842,18,18,GATAACTGCCATACTGATTC,0,5003571
yjbJ_predicted,0.05263157894736842,18,18,GAGACGCTGCGAGGATACCT,0,5000619
yjbJ_predicted,0.05263157894736842,18,18,GACGCGAAGCGTCTTGAGAC,0,4997276
yjbJ_predicted,0.05263157894736842,18,18,GACACTTTACAGACCGTTAC,0,5013229
yjbJ_predicted,0.05263157894736842,18,18,GAACGAACGTAGGAGGGTAC,0,5027060
yjbJ_predicted,0.05263157894736842,18,18,GAAATGGTGCCAGTAACGTA,0,5022605
yjbJ_predicted,0.05263157894736842,18,18,CTTGCTGTCTAGATGAACAT,0,4995993
yjbJ_predicted,0.05263157894736842,18,18,CTTCACCAATGGTACCAATC,0,5009633
yjbJ_predicted,0.05263157894736842,18,18,CTGTCAAGTTACGGTAGTCA,0,5024351
yjbJ_predicted,0.05263157894736842,18,18,CTGCACAGGAGCCAGTTTAG,0,5010566
yjbJ_predicted,0.05263157894736842,18,18,CTATATGTGCGCGACAGCCC,0,5020729
yjbJ_predicted,0.05263157894736842,18,18,CTACGTTTCCGCTGTCCGTT,0,5011867
yjbJ_predicted,0.05263157894736842,18,18,CGTGCCGCCTTATGACGTGC,0,4996747
yjbJ_predicted,0.05263157894736842,18,18,CGGTCGTCATTATCCGATAT,0,5006027
yjbJ_predicted,0.05263157894736842,18,18,CGGGGGAAACGTTTGGGAGA,0,5016693
yjbJ_predicted,0.05263157894736842,18,18,CGGACATCGAATCAGCTCTA,0,4996154
yjbJ_predicted,0.05263157894736842,18,18,CGCGGGGTGGGATACGCACG,0,5014721
yjbJ_predicted,0.05263157894736842,18,18,CGCGCTCATCAGGGGACGTG,0,4999054
yjbJ_predicted,0.05263157894736842,18,18,CGCCTCGTGGCTACACCGCG,0,4996258
yjbJ_predicted,0.05263157894736842,18,18,CGAATCCGGCCAGTCGTCGG,0,5019162
yjbJ_predicted,0.05263157894736842,18,18,CCGCCGTTCACGGGTGGGCG,0,5007761
yjbJ_predicted,0.05263157894736842,18,18,CCCTTGTGCACGCAGGCTCC,0,4997722
yjbJ_predicted,0.05263157894736842,18,18,CCCGCGGCATTGGAATCTGT,0,5022919
yjbJ_predicted,0.05263157894736842,18,18,CCCCAGTCTTGATGATAAGA,0,4995331
yjbJ_predicted,0.05263157894736842,18,18,CCAACACCGGCATATGGCGG,0,4996043
yjbJ_predicted,0.05263157894736842,18,18,CATACGGTCAGCGATAGTTG,0,5015472
yjbJ_predicted,0.05263157894736842,18,18,CAGTAACTCACGATAGGTGA,0,5004784
yjbJ_predicted,0.05263157894736842,18,18,CACGGTGGAAATGTGTACGG,0,5026705
yjbJ_predicted,0.05263157894736842,18,18,CACATCAATGTACTCAGCGC,0,5007304
yjbJ_predicted,0.05263157894736842,18,18,CACAGTGGAGAAAGGTTGTT,0,5000967
yjbJ_predicted,0.05263157894736842,18,18,CAAGCCCGACCTGGAGGATG,0,5004802
yjbJ_predicted,0.05263157894736842,18,18,CAAACGCCCATGTAGGTCGC,0,5015469
yjbJ_predicted,0.05263157894736842,18,18,ATTTGGTTTTCGCATTTCTT,0,5003545
yjbJ_predicted,0.05263157894736842,18,18,ATTGAGGTCGGCCTTCCCAG,0,5028323
yjbJ_predicted,0.05263157894736842,18,18,ATGCGTAGGCCTCTTAAAAG,0,5014883
yjbJ_predicted,0.05263157894736842,18,18,ATAGCGCACGGATCAATGTG,0,5008452
yjbJ_predicted,0.05263157894736842,18,18,ATACGTACCATGGGGAGTAC,0,5025473
yjbJ_predicted,0.05263157894736842,18,18,AGTCTCGTTACCCTCAAAGC,0,5007537
yjbJ_predicted,0.05263157894736842,18,18,AGTAGTGCGACAGGGTAAGA,0,5015203
yjbJ_predicted,0.05263157894736842,18,18,AGGTAGTTGACAACCGTCGT,0,4999082
yjbJ_predicted,0.05263157894736842,18,18,AGGGCGTCCGGAACATTTGT,0,5010768
yjbJ_predicted,0.05263157894736842,18,18,AGGACGACGAGTGGCAGCCC,0,5018468
yjbJ_predicted,0.05263157894736842,18,18,AGCATTGGGCTGCCACCTAG,0,5009748
yjbJ_predicted,0.05263157894736842,18,18,AGATGAATCGCACCAATGAA,0,5018007
yjbJ_predicted,0.05263157894736842,18,18,AGATCCGTCCGCTTACTGCA,0,5023681
yjbJ_predicted,0.05263157894736842,18,18,AGAGGGAATTATATCGAAGC,0,5018203
yjbJ_predicted,0.05263157894736842,18,18,ACGTCCGTTCACGTTCATAT,0,5014262
yjbJ_predicted,0.05263157894736842,18,18,ACGGGCGCGAGTTGTCCTGC,0,5022779
yjbJ_predicted,0.05263157894736842,18,18,ACGAATGTCCCAATGAGCAG,0,5008039
yjbJ_predicted,0.05263157894736842,18,18,ACCTGTATTGGGAGTAATCG,0,5008937
yjbJ_predicted,0.05263157894736842,18,18,ACCCACGTTGGATTAAGTTA,0,5018182
yjbJ_predicted,0.05263157894736842,18,18,ACAGTTAGGACTGCGAGCAT,0,5005854
yjbJ_predicted,0.05263157894736842,18,18,ACAGCCTACTGGGCAAGCGC,0,4995930
yjbJ_predicted,0.05263157894736842,18,18,ACAGACTACGGATACGGAGA,0,5010857
yjbJ_predicted,0.05263157894736842,18,18,ACACAGGACTTCGGGCAGGT,0,4994696
yjbJ_predicted,0.05263157894736842,18,18,ACAATGGTTTCTCAAGTTGT,0,5004272
yjbJ_predicted,0.05555555555555555,17,17,TTTACGCGACGAGGACTCGC,0,5000569
yjbJ_predicted,0.05555555555555555,17,17,TTGTTTGCTTAGCATTCTAC,0,5002048
yjbJ_predicted,0.05555555555555555,17,17,TTATAGGATTGGAAAGCCCA,0,5002854
yjbJ_predicted,0.05555555555555555,17,17,TGTCGGGGGCAATCTGCCAA,0,4996543
yjbJ_predicted,0.05555555555555555,17,17,TGGCCCTGACATATGGTCAG,0,5023159
yjbJ_predicted,0.05555555555555555,17,17,TGCTTGAGGTCATACTGTAT,0,5000799
yjbJ_predicted,0.05555555555555555,17,17,TGCGTAAGGGTGCGATATAT,0,5010675
yjbJ_predicted,0.05555555555555555,17,17,TGCGATACCGTGCAGGAACT,0,4999889
yjbJ_predicted,0.05555555555555555,17,17,TGATCCAGCGAGCGACTTTT,0,5023977
yjbJ_predicted,0.05555555555555555,17,17,TCTGTCTCAAAGGATAATTT,0,5010643
yjbJ_predicted,0.05555555555555555,17,17,TCTGGTTGTACGTTCAAAAT,0,5008117
yjbJ_predicted,0.05555555555555555,17,17,TCGTGCAAGTTACGGTGGCT,0,5018994
yjbJ_predicted,0.05555555555555555,17,17,TCGCGGCGTACATTAGAACC,0,5002013
yjbJ_predicted,0.05555555555555555,17,17,TCGCAAATCGAATCCGTTCT,0,5011926
yjbJ_predicted,0.05555555555555555,17,17,TCCCGTGCGACGTCGAGGAT,0,5001339
yjbJ_predicted,0.05555555555555555,17,17,TCATACGAAGGCAGATAACG,0,5016057
yjbJ_predicted,0.05555555555555555,17,17,TCATACCTCGTTGCAGAGTC,0,5011934
yjbJ_predicted,0.05555555555555555,17,17,TCAGTCCGAGGGATTGGAGC,0,5024982
yjbJ_predicted,0.05555555555555555,17,17,TCACTCCGGTATGGATAAGC,0,5028695
yjbJ_predicted,0.05555555555555555,17,17,TAAGACAGAGGCATATAGGA,0,5001088
yjbJ_predicted,0.05555555555555555,17,17,TAAATTCTTTCCATACACAA,0,5007725
yjbJ_predicted,0.05555555555555555,17,17,GTTTTGAGGGATACGACACG,0,5025043
yjbJ_predicted,0.05555555555555555,17,17,GTTGTAATTGAGAGAGAATC,0,5025645
yjbJ_predicted,0.05555555555555555,17,17,GTTGGGATAAACATTTGTCG,0,5019218
yjbJ_predicted,0.05555555555555555,17,17,GTTCTGCGCTAACTACAGAC,0,5012233
yjbJ_predicted,0.05555555555555555,17,17,GTGATGGCGCTTCGATCTAG,0,5003803
yjbJ_predicted,0.05555555555555555,17,17,GTACTAGGTATGCCGAAAGC,0,5017612
yjbJ_predicted,0.05555555555555555,17,17,GTACGGAGGCTGCGGATGTA,0,5008850
yjbJ_predicted,0.05555555555555555,17,17,GGGCTGAATACACTACACGA,0,5023711
yjbJ_predicted,0.05555555555555555,17,17,GGGAGATACAGTTCATCGTT,0,4995579
yjbJ_predicted,0.05555555555555555,17,17,GGCAAAATCAGCAAGTCATT,0,5017056
yjbJ_predicted,0.05555555555555555,17,17,GGAGGGCTGGTTTGTGCAAC,0,5015508
yjbJ_predicted,0.05555555555555555,17,17,GGAACTGGGGTGCCACGATA,0,5021495
yjbJ_predicted,0.05555555555555555,17,17,GCTTGGCTTGCCCGCTTAAG,0,5024282
yjbJ_predicted,0.05555555555555555,17,17,GCTTCGCAAACCGGTACAGT,0,5005711
yjbJ_predicted,0.05555555555555555,17,17,GCGTACCTTCATCGGTAGGA,0,5009256
yjbJ_predicted,0.05555555555555555,17,17,GCGCCTATTAAGCTGGGGCA,0,4995274
yjbJ_predicted,0.05555555555555555,17,17,GCGAGTATCCGCACCAGTTC,0,5016302
yjbJ_predicted,0.05555555555555555,17,17,GCCGGACCTACCTTAAGGAT,0,5016044
yjbJ_predicted,0.05555555555555555,17,17,GAGTGATAACGGAACGGGCG,0,5017955
yjbJ_predicted,0.05555555555555555,17,17,GAGGCCTGTTCGAAGCAATC,0,5019573
yjbJ_predicted,0.05555555555555555,17,17,GAGAGGGCTCCATCTCCAGG,0,5022199
yjbJ_predicted,0.05555555555555555,17,17,GACTTGTGATGAGCACCTGC,0,5000319
yjbJ_predicted,0.05555555555555555,17,17,GACGAGCCGGAGAAGTCAGT,0,5010793
yjbJ_predicted,0.05555555555555555,17,17,GACACTATGACCGCCCTATC,0,5006817
yjbJ_predicted,0.05555555555555555,17,17,GAATCGAACATATACGAGCT,0,4998272
yjbJ_predicted,0.05555555555555555,17,17,GAAGGTAGTCTTGGTATCCT,0,5020092
yjbJ_predicted,0.05555555555555555,17,17,GAAGCTGTATCGGACTTGGT,0,5006940
yjbJ_predicted,0.05555555555555555,17,17,GAAGCCTTGCTTTTTCTTAT,0,5007504
yjbJ_predicted,0.05555555555555555,17,17,GAACAGGGCGTGTGGTCTTC,0,5004028
yjbJ_predicted,0.05555555555555555,17,17,GAACAATACATCGACTTCAC,0,5017676
yjbJ_predicted,0.05555555555555555,17,17,CTTGGCGTCGCTATAGGCGG,0,5029206
yjbJ_predicted,0.05555555555555555,17,17,CTTCGTCCGATGGTATATAG,0,4998732
yjbJ_predicted,0.05555555555555555,17,17,CTTAACTCCGAAGTACAATT,0,5011522
yjbJ_predicted,0.05555555555555555,17,17,CTGTGCAGGATCGTAGCTTT,0,5014258
yjbJ_predicted,0.05555555555555555,17,17,CTGTATCTGGCAAGCAAAAA,0,5010838
yjbJ_predicted,0.05555555555555555,17,17,CTGCTATTGCAGAGTGTTCC,0,4996134
yjbJ_predicted,0.05555555555555555,17,17,CTGCAAGTGTCCATACGTAA,0,5029607
yjbJ_predicted,0.05555555555555555,17,17,CTATCTATAAGGCCTGCTTT,0,5025146
yjbJ_predicted,0.05555555555555555,17,17,CTAGAGCCGCTGGATGATTT,0,5009832
yjbJ_predicted,0.05555555555555555,17,17,CGTTTGCCGTTTCTTAACGG,0,4995741
yjbJ_predicted,0.05555555555555555,17,17,CGTGAAATGCCAATGATGAA,0,5006340
yjbJ_predicted,0.05555555555555555,17,17,CGGGTGAATTTGGCTAAGTG,0,5023749
yjbJ_predicted,0.05555555555555555,17,17,CGGCCATTTGCACTCCAATA,0,5017054
yjbJ_predicted,0.05555555555555555,17,17,CGGCAAACTTATTCGGAGCT,0,5003900
yjbJ_predicted,0.05555555555555555,17,17,CGGAAGATGATGTGCAGTGG,0,5005012
yjbJ_predicted,0.05555555555555555,17,17,CGCTTCTAATTACTGGTTAC,0,5010618
yjbJ_predicted,0.05555555555555555,17,17,CGCGAACGTTCTGTTCATAA,0,5010167
yjbJ_predicted,0.05555555555555555,17,17,CGCCCTTGTAGAAATTGGAG,0,4998498
yjbJ_predicted,0.05555555555555555,17,17,CGCAGCTCCTAGCCAATAAA,0,5025333
yjbJ_predicted,0.05555555555555555,17,17,CGATTCGGGACCACCCTCCA,0,5022915
yjbJ_predicted,0.05555555555555555,17,17,CGAGGGTCGTATCGGTTTGG,0,5012059
yjbJ_predicted,0.05555555555555555,17,17,CGACATCGTTAAGCGAAAAG,0,5027299
yjbJ_predicted,0.05555555555555555,17,17,CCTTCGCTTACGTCGCTTAC,0,5012005
yjbJ_predicted,0.05555555555555555,17,17,CCTGGATCGCAGGGCCTCGT,0,5026092
yjbJ_predicted,0.05555555555555555,17,17,CCGGCTCCGTACAAGAACCA,0,4995891
yjbJ_predicted,0.05555555555555555,17,17,CCCTAGTTACAGTTATTTTA,0,5000363
yjbJ_predicted,0.05555555555555555,17,17,CCCACTCCGCTCAGAATGGC,0,5008827
yjbJ_predicted,0.05555555555555555,17,17,CCCACCCGACCTAGAATGCT,0,5002602
yjbJ_predicted,0.05555555555555555,17,17,CCAGAGCATCTACTAAGGCA,0,5027598
yjbJ_predicted,0.05555555555555555,17,17,CCACATTAAGCGCTCGCGTT,0,5007938
yjbJ_predicted,0.05555555555555555,17,17,CATGTGGCGCGTTAGATATC,0,5028827
yjbJ_predicted,0.05555555555555555,17,17,CATAAGTATGGTATCTTTCT,0,5019665
yjbJ_predicted,0.05555555555555555,17,17,CAGAGTAAAATTTGCCTTCA,0,5008648
yjbJ_predicted,0.05555555555555555,17,17,CACGGATTCTAACGGAATCC,0,4996625
yjbJ_predicted,0.05555555555555555,17,17,CACCCGTCACTCATATGGTA,0,5009387
yjbJ_predicted,0.05555555555555555,17,17,CACATAGCCCGCCCGTGCGC,0,4995643
yjbJ_predicted,0.05555555555555555,17,17,CAAATAAGTGCCGATGAGAC,0,5013858
yjbJ_predicted,0.05555555555555555,17,17,ATTGGCTCGATTAACCTATG,0,5009800
yjbJ_predicted,0.05555555555555555,17,17,ATTCCTCAAGACATGCGACG,0,5017730
yjbJ_predicted,0.05555555555555555,17,17,ATGGGGGGGGGTTTCCGTAC,0,5016486
yjbJ_predicted,0.05555555555555555,17,17,ATGATCCCATTTAGTCAGCT,0,5000706
yjbJ_predicted,0.05555555555555555,17,17,ATCGTTTCCCACCTGGAGAT,0,5015196
yjbJ_predicted,0.05555555555555555,17,17,ATCGTCTTCATGACAATGTA,0,4999960
yjbJ_predicted,0.05555555555555555,17,17,ATACGGCACGCTGGAAGAAA,0,5030978
yjbJ_predicted,0.05555555555555555,17,17,AGTCCATCGGTAAGTCTGGG,0,5022594
yjbJ_predicted,0.05555555555555555,17,17,AGCATGAGTCTAAAGGCCCG,0,5019350
yjbJ_predicted,0.05555555555555555,17,17,AGATGATGGAGACAATGTCA,0,5024072
yjbJ_predicted,0.05555555555555555,17,17,AGATACCACTTCACTTAGCA,0,5002631
yjbJ_predicted,0.05555555555555555,17,17,AGACTCAAAACTGTGATTGC,0,5013164
yjbJ_predicted,0.05555555555555555,17,17,ACTGCGTGGCTCCGGCTTAA,0,5002727
yjbJ_predicted,0.05555555555555555,17,17,ACCCGTCATTTGCAATGATC,0,5001023
yjbJ_predicted,0.05555555555555555,17,17,ACATCCGCTGTGTTGCGCTC,0,5013351
yjbJ_predicted,0.05555555555555555,17,17,AATTTACGTTTGGGACCACA,0,4995241
yjbJ_predicted,0.05555555555555555,17,17,AATGTCATAACAAGTGCGAC,0,5025978
yjbJ_predicted,0.05555555555555555,17,17,AATGACCAACAAGCCTGAAT,0,5022495
yjbJ_predicted,0.05555555555555555,17,17,AACCGTGGTGGCCAGTTTTG,0,5013029
yjbJ_predicted,0.05555555555555555,17,17,AAATTTTTGCCGAGGACACT,0,5028383
yjbJ_predicted,0.05555555555555555,17,17,AAATGTCTAGAGGTATGTAA,0,5029098
yjbJ_predicted,0.05555555555555555,17,17,AAAAACCATAGAAGATGATG,0,5020728
yjbJ_predicted,0.058823529411764705,16,16,TTTCGCATGTAGGGCAGAGT,0,4995485
yjbJ_predicted,0.058823529411764705,16,16,TTGTTGGCGCTCGTTGGTCT,0,5012097
yjbJ_predicted,0.058823529411764705,16,16,TTGGCCATACTTTACTTATT,0,4996889
yjbJ_predicted,0.058823529411764705,16,16,TTCGCAACGAAATCCCTGTT,0,5019306
yjbJ_predicted,0.058823529411764705,16,16,TTCCGGAAACTCGCAGGTAA,0,5031026
yjbJ_predicted,0.058823529411764705,16,16,TTCATTTCTTACATCGGCAA,0,5031283
yjbJ_predicted,0.058823529411764705,16,16,TGGTATGTGGTCCGGAAACA,0,5007026
yjbJ_predicted,0.058823529411764705,16,16,TGGCCGCCGGAGAGCGGCAA,0,5017533
yjbJ_predicted,0.058823529411764705,16,16,TGCGGAATGAGTAAGTGGGT,0,5010947
yjbJ_predicted,0.058823529411764705,16,16,TGCGCTACGGAAGCTGCACA,0,4996795
yjbJ_predicted,0.058823529411764705,16,16,TGCATTCTGCCAACTAACAA,0,4998091
yjbJ_predicted,0.058823529411764705,16,16,TGCATGGGCTGTCGAACGAA,0,5008752
yjbJ_predicted,0.058823529411764705,16,16,TGATTGCGTCCACAATGCGC,0,4996480
yjbJ_predicted,0.058823529411764705,16,16,TCTGGACGTTGACTGCCAAA,0,5001618
yjbJ_predicted,0.058823529411764705,16,16,TCTGCTTACCATGAAACAAT,0,5027228
yjbJ_predicted,0.058823529411764705,16,16,TCGGGACGAGGTAACGGTTG,0,5008639
yjbJ_predicted,0.058823529411764705,16,16,TCGCCGTTAGATTTCCTGGG,0,5019343
yjbJ_predicted,0.058823529411764705,16,16,TCCATAGAGTAAATTGCGGA,0,5020031
yjbJ_predicted,0.058823529411764705,16,16,TCCAGGGATCTCATGAATAA,0,5014847
yjbJ_predicted,0.058823529411764705,16,16,TCCAGCGCAGGTTTTCCCCG,0,4998551
yjbJ_predicted,0.058823529411764705,16,16,TCATCGCCCGGAACACTTCA,0,5013730
yjbJ_predicted,0.058823529411764705,16,16,TCATCCTCGGAAAGACTTAG,0,4999116
yjbJ_predicted,0.058823529411764705,16,16,TCAGTATCAAGGGTGTGTAC,0,5014261
yjbJ_predicted,0.058823529411764705,16,16,TCAGGTACGCGCTCTTCACG,0,5020858
yjbJ_predicted,0.058823529411764705,16,16,TCACCGCTTACGACGCTAGT,0,5027549
yjbJ_predicted,0.058823529411764705,16,16,TATTGTCCCTACAGCATTAA,0,5023387
yjbJ_predicted,0.058823529411764705,16,16,TATGGCACGTTCGCCGTAGA,0,5025515
yjbJ_predicted,0.058823529411764705,16,16,TATCTCAGTTCGTCCGATAA,0,5030896
yjbJ_predicted,0.058823529411764705,16,16,TATCGCGTGGGGTTGGAAAC,0,5006848
yjbJ_predicted,0.058823529411764705,16,16,TATCAGCAGTTAGAAACCAT,0,5018916
yjbJ_predicted,0.058823529411764705,16,16,TAGTCATCAAGTCCTGATAT,0,5013721
yjbJ_predicted,0.058823529411764705,16,16,TAGGTTGGGGAATGCTCATA,0,5020923
yjbJ_predicted,0.058823529411764705,16,16,TACGCTTGCAGCTTTTCAGG,0,5022196
yjbJ_predicted,0.058823529411764705,16,16,TACACCCTCGTTGGTGTCCC,0,4995569
yjbJ_predicted,0.058823529411764705,16,16,TAATGCACCGACATGTGACT,0,5003497
yjbJ_predicted,0.058823529411764705,16,16,TAAGTGCCGGGAGTGGGTTG,0,5001014
yjbJ_predicted,0.058823529411764705,16,16,GTTGGAATTATGGGCCAACA,0,5010692
yjbJ_predicted,0.058823529411764705,16,16,GTTAAGGGAGACCCCGCGTA,0,5024035
yjbJ_predicted,0.058823529411764705,16,16,GTGTATTTCGTCGCTCGATC,0,5000214
yjbJ_predicted,0.058823529411764705,16,16,GTGGTGTGTATTAGAATCGA,0,5031222
yjbJ_predicted,0.058823529411764705,16,16,GTGCTACAGATATTGACTGT,0,5025297
yjbJ_predicted,0.058823529411764705,16,16,GTGATGTTTACTCACGGGCA,0,5010482
yjbJ_predicted,0.058823529411764705,16,16,GTGAGACCTCCGTGAATTTC,0,5021864
yjbJ_predicted,0.058823529411764705,16,16,GTCTGGGCGCACGCGGGTTT,0,5003664
yjbJ_predicted,0.058823529411764705,16,16,GTAACTGGCAATCCACGACT,0,5014501
yjbJ_predicted,0.058823529411764705,16,16,GGTATCGCAAGGTAGTTGGA,0,5006734
yjbJ_predicted,0.058823529411764705,16,16,GGGTTGGTTAGGTAGGCTCA,0,5023633
yjbJ_predicted,0.058823529411764705,16,16,GGCTCTGTGTGTGGCATGTA,0,5030818
yjbJ_predicted,0.058823529411764705,16,16,GGCGTATACAGGTTCATTAA,0,5016291
yjbJ_predicted,0.058823529411764705,16,16,GGCCTCGCGCGCATTCCAGT,0,5029144
yjbJ_predicted,0.058823529411764705,16,16,GGATCATAATTTCGAGAAAC,0,5019766
yjbJ_predicted,0.058823529411764705,16,16,GCTTTAGCGTGGTATCGCTT,0,5017431
yjbJ_predicted,0.058823529411764705,16,16,GCTGGCCCTGGTTGAGCGGT,0,5019387
yjbJ_predicted,0.058823529411764705,16,16,GCTAAACAGGGAGTGTCAGG,0,5019341
yjbJ_predicted,0.058823529411764705,16,16,GCCGGCTGACAGACAAGACC,0,5018360
yjbJ_predicted,0.058823529411764705,16,16,GCCGCAGGTTACGGGATCGA,0,4996218
yjbJ_predicted,0.058823529411764705,16,16,GATGATGTAGGGATAAGGCA,0,5010640
yjbJ_predicted,0.058823529411764705,16,16,GATCTTTAATTATTATGACA,0,5018056
yjbJ_predicted,0.058823529411764705,16,16,GATCGACCCGCAGGGATATG,0,5004397
yjbJ_predicted,0.058823529411764705,16,16,GATCATACTGCGAGTTTAGA,0,5000744
yjbJ_predicted,0.058823529411764705,16,16,GACACCGACAAAGAAGGTGT,0,5003577
yjbJ_predicted,0.058823529411764705,16,16,GAATCGTTTTTACCAAGATA,0,5004131
yjbJ_predicted,0.058823529411764705,16,16,CTTAGCGTGGATTGGTGTTG,0,4997805
yjbJ_predicted,0.058823529411764705,16,16,CTGGTGCCGAAAAAGCTGAA,0,5030551
yjbJ_predicted,0.058823529411764705,16,16,CTGGGGACGGCACCGGTAAA,0,5014275
yjbJ_predicted,0.058823529411764705,16,16,CTGCTTAGAGCGGCGTAGTC,0,5020060
yjbJ_predicted,0.058823529411764705,16,16,CTAGGCAAGACTGTCCAACC,0,4996376
yjbJ_predicted,0.058823529411764705,16,16,CTAATGGGTTTAACATGATT,0,4996479
yjbJ_predicted,0.058823529411764705,16,16,CGTTGTTGCACGTTTAGCCC,0,5022218
yjbJ_predicted,0.058823529411764705,16,16,CGTTCAGGAAGGCGTCTGGT,0,4997621
yjbJ_predicted,0.058823529411764705,16,16,CGTGGTCTGGGCATTATTGA,0,4994950
yjbJ_predicted,0.058823529411764705,16,16,CGTGAACGTTCGCGGGGATA,0,5021732
yjbJ_predicted,0.058823529411764705,16,16,CGGTACGCTCTACGCGCAGC,0,4999023
yjbJ_predicted,0.058823529411764705,16,16,CGGGATATCGTTAGTCTTCT,0,5007512
yjbJ_predicted,0.058823529411764705,16,16,CGCTGGCTGTCCGACGGGTT,0,4997156
yjbJ_predicted,0.058823529411764705,16,16,CGCCCAGAACTTCACAGATA,0,4998014
yjbJ_predicted,0.058823529411764705,16,16,CGCACCATTTCAGTGCGTAT,0,5029095
yjbJ_predicted,0.058823529411764705,16,16,CGATACAGCATGCAACCGGA,0,5030426
yjbJ_predicted,0.058823529411764705,16,16,CGAGGTTAAGGCTTCGCCCC,0,5023807
yjbJ_predicted,0.058823529411764705,16,16,CGAAGGAACCAACGATTTCC,0,5023345
yjbJ_predicted,0.058823529411764705,16,16,CGAAGCAGGCCTAATTCAAG,0,5008497
yjbJ_predicted,0.058823529411764705,16,16,CGAACCCTCTACCCGAACCT,0,4998524
yjbJ_predicted,0.058823529411764705,16,16,CCTGGGAGGTCGAAAGCCGC,0,5018795
yjbJ_predicted,0.058823529411764705,16,16,CCTCATGAGGACCTAGTGTG,0,5019753
yjbJ_predicted,0.058823529411764705,16,16,CCTATGCAGTCTTCATTTGT,0,4999467
yjbJ_predicted,0.058823529411764705,16,16,CCGGGCCGTGTTCAGATATT,0,5002209
yjbJ_predicted,0.058823529411764705,16,16,CCGGCTTCATGTGGAAGTAG,0,5018593
yjbJ_predicted,0.058823529411764705,16,16,CCCTCCTTTATTTATGTGAT,0,5017860
yjbJ_predicted,0.058823529411764705,16,16,CCCGTCTGATAGGCCTTTTG,0,4995367
yjbJ_predicted,0.058823529411764705,16,16,CCCAGGACAGCTAGTGGATG,0,5029975
yjbJ_predicted,0.058823529411764705,16,16,CCATTGCCGATCGCCGCGGT,0,5007148
yjbJ_predicted,0.058823529411764705,16,16,CCACTAAACGTCCAGTCGTA,0,5010004
yjbJ_predicted,0.058823529411764705,16,16,CATTTTGTCACATCAAAAAC,0,4997243
yjbJ_predicted,0.058823529411764705,16,16,CATTTACCCTGGCTTTCGTT,0,5014490
yjbJ_predicted,0.058823529411764705,16,16,CATTAAACAATAGTTGGTAT,0,4996708
yjbJ_predicted,0.058823529411764705,16,16,CATCAGAAACTGCAACTCAA,0,5027467
yjbJ_predicted,0.058823529411764705,16,16,CAGTTCTGCTTGTCGCAACG,0,5006060
yjbJ_predicted,0.058823529411764705,16,16,CAGTGAATCGTTAATCGCGT,0,5005953
yjbJ_predicted,0.058823529411764705,16,16,CAGGAGATTATACTTTTGTT,0,5023748
yjbJ_predicted,0.058823529411764705,16,16,CACTGCATATGAACGGCATG,0,5028050
yjbJ_predicted,0.058823529411764705,16,16,CACCGACCCTGAGTCTAAGG,0,5017937
yjbJ_predicted,0.058823529411764705,16,16,CAAAACCGCAAGGGTGCCCA,0,5005990
yjbJ_predicted,0.058823529411764705,16,16,ATTTGCTAGACTCCACAGGA,0,5012765
yjbJ_predicted,0.058823529411764705,16,16,ATGGGACTCTATACCCGCAT,0,5013067
yjbJ_predicted,0.058823529411764705,16,16,ATGGATTGCTTGTCGGTTGT,0,5006820
yjbJ_predicted,0.058823529411764705,16,16,ATGCGCTGGACGTCTCCATG,0,4999374
yjbJ_predicted,0.058823529411764705,16,16,ATGCATCTGGGCGCTTAAAC,0,5010031
yjbJ_predicted,0.058823529411764705,16,16,ATGAGTAACCCACCCGGGCA,0,5002081
yjbJ_predicted,0.058823529411764705,16,16,ATCGTGGTTAGGGTTGCCGG,0,5012756
yjbJ_predicted,0.058823529411764705,16,16,ATCGGTAATAATCAATCTAA,0,4999456
yjbJ_predicted,0.058823529411764705,16,16,ATACGCAAACGGAAGGTCAG,0,5028600
yjbJ_predicted,0.058823529411764705,16,16,AGTTATAACGTAGACCTCAG,0,5015393
yjbJ_predicted,0.058823529411764705,16,16,AGTCGGCCTCGGTTTGGAGC,0,5007272
yjbJ_predicted,0.058823529411764705,16,16,AGTAGTTTTTGGAACAGCAG,0,5011252
yjbJ_predicted,0.058823529411764705,16,16,AGTACTCCTATATCAAGGGT,0,4995051
yjbJ_predicted,0.058823529411764705,16,16,AGTAACGCGTATCAAATACG,0,5008189
yjbJ_predicted,0.058823529411764705,16,16,AGGTATCCAGGCTCGAGAAT,0,5001800
yjbJ_predicted,0.058823529411764705,16,16,AGGGGAATGGGGCCGATCTG,0,5020323
yjbJ_predicted,0.058823529411764705,16,16,AGGACTACCCCCACTTAAAG,0,5008910
yjbJ_predicted,0.058823529411764705,16,16,AGCGACGTTTGAGTGGGCGT,0,5014079
yjbJ_predicted,0.058823529411764705,16,16,AGCCACTACCTCTTTTGTCA,0,5019146
yjbJ_predicted,0.058823529411764705,16,16,AGCAGGGATCCGAGCCGCGA,0,4995461
yjbJ_predicted,0.058823529411764705,16,16,ACTTCCGGTATGAAGGCTCC,0,5028489
yjbJ_predicted,0.058823529411764705,16,16,ACTGCGGATCGAAAAAATAG,0,5004490
yjbJ_predicted,0.058823529411764705,16,16,ACGTAGCTTGTGTACTGGGA,0,4998238
yjbJ_predicted,0.058823529411764705,16,16,ACGCCATCATTTCCCAGCGT,0,5018153
yjbJ_predicted,0.058823529411764705,16,16,ACCATGTCCCGGGCTCAACT,0,5024161
yjbJ_predicted,0.058823529411764705,16,16,ACACAAGGAAACAACCTCTG,0,5018280
yjbJ_predicted,0.058823529411764705,16,16,ACAAGGAAAGGCTAATAAAG,0,5018574
yjbJ_predicted,0.058823529411764705,16,16,AATGTCGCGTTCACTGAATC,0,5016166
yjbJ_predicted,0.058823529411764705,16,16,AATCGAGCTATGCGCGATCT,0,5018886
yjbJ_predicted,0.058823529411764705,16,16,AACCGGAAGCAGTATCAAGT,0,5028641
yjbJ_predicted,0.058823529411764705,16,16,AAAGGAGGATTGTGCAAATG,0,5026532
yjbJ_predicted,0.0625,15,15,TTTGCCTTTTGCTCAGATTT,0,5013270
yjbJ_predicted,0.0625,15,15,TTGCCCGTGACGAAGAATTA,0,5030035
yjbJ_predicted,0.0625,15,15,TTCTTCGTTGGAACGAAATT,0,4994731
yjbJ_predicted,0.0625,15,15,TTCTGAGAACGCTCCCGCGT,0,5029608
yjbJ_predicted,0.0625,15,15,TTCTAGAGCGACATCTCATC,0,5030972
yjbJ_predicted,0.0625,15,15,TTCTAACTCCTCCACTTAAT,0,5015386
yjbJ_predicted,0.0625,15,15,TTCCGTGTCTCAGTTGTTTA,0,5029015
yjbJ_predicted,0.0625,15,15,TTCCCCTTTGCTCAAAGAGG,0,5008158
yjbJ_predicted,0.0625,15,15,TGTTTTTACCAGCGGTCCAC,0,5029587
yjbJ_predicted,0.0625,15,15,TGTGGTTTACGACGCATTCT,0,5008308
yjbJ_predicted,0.0625,15,15,TGTCACCGCGACACGTTATA,0,5005749
yjbJ_predicted,0.0625,15,15,TGGCGTTAGGTGGATCGGGT,0,5029317
yjbJ_predicted,0.0625,15,15,TGGATTTCTGGCCCATCCAA,0,5005621
yjbJ_predicted,0.0625,15,15,TGGAGGGGGGGTTATAATCC,0,5023398
yjbJ_predicted,0.0625,15,15,TGCTGCCTAATGGAGCACTA,0,5005776
yjbJ_predicted,0.0625,15,15,TGCACCTCTGGGCACCACCT,0,5003801
yjbJ_predicted,0.0625,15,15,TCTTCTGCTAAGCACGTCAG,0,5000176
yjbJ_predicted,0.0625,15,15,TCTTATAATGTACGCACCCC,0,4997880
yjbJ_predicted,0.0625,15,15,TCTGGCACCCAATCCGTCCT,0,5006335
yjbJ_predicted,0.0625,15,15,TCTGCTACCCCTAGTACAAA,0,5030566
yjbJ_predicted,0.0625,15,15,TCTGCCGGGAAACCGACCAG,0,4995826
yjbJ_predicted,0.0625,15,15,TCGTATTTGTATTAAACTCA,0,5015151
yjbJ_predicted,0.0625,15,15,TCGGGACCTCGTCCGTGTCC,0,5010568
yjbJ_predicted,0.0625,15,15,TCGGAAGTCCACAGACACAA,0,4997280
yjbJ_predicted,0.0625,15,15,TCGCCGACGTTCTACATCCG,0,5005795
yjbJ_predicted,0.0625,15,15,TCCTACAATCTGCGAAATGA,0,5025198
yjbJ_predicted,0.0625,15,15,TCCAATACATGTGCCAGGTC,0,5020645
yjbJ_predicted,0.0625,15,15,TCAGTTAAATCGGCCCCGAT,0,5011555
yjbJ_predicted,0.0625,15,15,TCACGCGAGCGGTATAAGAA,0,5023652
yjbJ_predicted,0.0625,15,15,TCAATGGACTCTTGGTGCTT,0,5007143
yjbJ_predicted,0.0625,15,15,TATTATGGTTTGTGGTTACG,0,5000410
yjbJ_predicted,0.0625,15,15,TAGGTGTCTCAACCTCTTCG,0,5009591
yjbJ_predicted,0.0625,15,15,TAGGGCGGGACCGACCGGGT,0,5024300
yjbJ_predicted,0.0625,15,15,TAGAACAGTATCTGACCCGG,0,4994768
yjbJ_predicted,0.0625,15,15,TACGCCAGGGGGCTTAAGAG,0,4997861
yjbJ_predicted,0.0625,15,15,TAAGTGAGCCGTCAATGGGA,0,5002851
yjbJ_predicted,0.0625,15,15,TAAGGGACTGACCGACGTAT,0,5014156
yjbJ_predicted,0.0625,15,15,TAACCGTGGGCGTTCTCCAT,0,5011553
yjbJ_predicted,0.0625,15,15,TAAAGTCCGCCTTTGATTCG,0,4998661
yjbJ_predicted,0.0625,15,15,GTTTTGCTCACTGGCCGAGA,0,5027101
yjbJ_predicted,0.0625,15,15,GTTGTGTATCGCTTTCCAGT,0,5023324
yjbJ_predicted,0.0625,15,15,GTGTTGATACGACTAGGGTC,0,5025613
yjbJ_predicted,0.0625,15,15,GTGATAGCGCCGGCTCGGTC,0,5022131
yjbJ_predicted,0.0625,15,15,GTCTTAGTGGGAAGGAAATA,0,5016109
yjbJ_predicted,0.0625,15,15,GTCGATACCCTCGCCCACGT,0,5008583
yjbJ_predicted,0.0625,15,15,GTCGAGAGGTTGGACCCTAA,0,5000696
yjbJ_predicted,0.0625,15,15,GTCCCCCTGTGTGTGTCGGC,0,5007461
yjbJ_predicted,0.0625,15,15,GTATGTTCCTCTTCAGGAAG,0,5010400
yjbJ_predicted,0.0625,15,15,GTACAGTGGGTATATTCACT,0,5022930
yjbJ_predicted,0.0625,15,15,GTAAGAGTTACTTTCCCGAC,0,5001036
yjbJ_predicted,0.0625,15,15,GGTTTCTCAGTTTGGGACGA,0,5017788
yjbJ_predicted,0.0625,15,15,GGTTGTATGATAACCATGCC,0,4998750
yjbJ_predicted,0.0625,15,15,GGTACTAACGGGAACTATTT,0,4997290
yjbJ_predicted,0.0625,15,15,GGGGAGCAACTCCGATCATG,0,4996510
yjbJ_predicted,0.0625,15,15,GGGCGCTTTCCGGCGTTCGG,0,5014290
yjbJ_predicted,0.0625,15,15,GGGATTGGAGGGTACGAGGA,0,4995606
yjbJ_predicted,0.0625,15,15,GGCGTCTTGAGCTACTAGGC,0,5015435
yjbJ_predicted,0.0625,15,15,GGCCAAGCTCCCCTGCGACG,0,5004259
yjbJ_predicted,0.0625,15,15,GGAAGGCGCCGCGGGCCAGA,0,5013488
yjbJ_predicted,0.0625,15,15,GGAAAAGAAGCAATGAGCGA,0,5028160
yjbJ_predicted,0.0625,15,15,GCTTCACGTAGAGATCACGG,0,5019408
yjbJ_predicted,0.0625,15,15,GCTTAACGAAGACCCGAATT,0,5012884
yjbJ_predicted,0.0625,15,15,GCTGCTTCCATACTGGAAGC,0,5026459
yjbJ_predicted,0.0625,15,15,GCTGCCTTCAACGCCTTCGG,0,4998657
yjbJ_predicted,0.0625,15,15,GCTCGTTGGATACTGATCCG,0,5017059
yjbJ_predicted,0.0625,15,15,GCGGTCCAGATCTTCGGGAT,0,5026038
yjbJ_predicted,0.0625,15,15,GCGGACACGAACATTGGTCT,0,5031092
yjbJ_predicted,0.0625,15,15,GCCCGGTAGCCAACCTACTA,0,5014016
yjbJ_predicted,0.0625,15,15,GCCCCGATCAACTGCTGGGA,0,4999212
yjbJ_predicted,0.0625,15,15,GCCAAGTGGTGATATCTCCA,0,5026370
yjbJ_predicted,0.0625,15,15,GCATAAGCGAACATCCAGGA,0,5006283
yjbJ_predicted,0.0625,15,15,GCAGGTTCATGTTAGGGGAA,0,5003940
yjbJ_predicted,0.0625,15,15,GCAGCGTCTGTATGCACCAG,0,5009275
yjbJ_predicted,0.0625,15,15,GCAGAGTCGAAGAACAGCGG,0,5015821
yjbJ_predicted,0.0625,15,15,GCACTTTGCCTCGGTCCGCT,0,5000988
yjbJ_predicted,0.0625,15,15,GATTCGCATTTGTGCATTGC,0,5009696
yjbJ_predicted,0.0625,15,15,GATTCGCAGCCTCGGGAGCC,0,5024777
yjbJ_predicted,0.0625,15,15,GATCCAAGGCGATGTGATTG,0,5014703
yjbJ_predicted,0.0625,15,15,GATAATCTACGCAACAATGT,0,5012399
yjbJ_predicted,0.0625,15,15,GATAACTGTTTGGTCTCAAA,0,4999733
yjbJ_predicted,0.0625,15,15,GAGTTGGGAGGGCGTTGCCA,0,5023343
yjbJ_predicted,0.0625,15,15,GAGGTGTTCTGCACATAAGT,0,5012470
yjbJ_predicted,0.0625,15,15,GAGGGCATTGTAGGACATTG,0,5004892
yjbJ_predicted,0.0625,15,15,GAGAGTACTTCTATCCAACT,0,5003795
yjbJ_predicted,0.0625,15,15,GACATCGTCACGCTTGGCCC,0,5015735
yjbJ_predicted,0.0625,15,15,GACAGTACGATCAAAATCTT,0,5007975
yjbJ_predicted,0.0625,15,15,CTTATTCCGTGCTCGGCCAC,0,5024062
yjbJ_predicted,0.0625,15,15,CTTATGAGAAATATAACCCT,0,5030119
yjbJ_predicted,0.0625,15,15,CTGTGATGTATATACATTAT,0,5005028
yjbJ_predicted,0.0625,15,15,CTGCCCCTCCCTAACCCTAC,0,5011547
yjbJ_predicted,0.0625,15,15,CTGACAACGTGATCCCACCT,0,5030341
yjbJ_predicted,0.0625,15,15,CTCTCTCTTGCTACGAAACT,0,5009518
yjbJ_predicted,0.0625,15,15,CTCTCAAGGTGCTGCCAGCA,0,5009213
yjbJ_predicted,0.0625,15,15,CTCGAGACAACGAACTTTTC,0,4997710
yjbJ_predicted,0.0625,15,15,CTCGACGTTTGGTGGGCTAA,0,5012270
yjbJ_predicted,0.0625,15,15,CTCCTTGCGGGAGGGAGTTA,0,5015321
yjbJ_predicted,0.0625,15,15,CTCAGTCACATAGCGCTTCT,0,4997332
yjbJ_predicted,0.0625,15,15,CTAGGGTGTGTTCTCCGCCC,0,5027711
yjbJ_predicted,0.0625,15,15,CTAACCGATTAGCGTGTTCT,0,5012111
yjbJ_predicted,0.0625,15,15,CGTTGTTTTGTAAGCCTGCA,0,5020429
yjbJ_predicted,0.0625,15,15,CGTTCATTACCGTGTAGGTG,0,5014227
yjbJ_predicted,0.0625,15,15,CGTCTACGTCAATAGTATTC,0,5004195
yjbJ_predicted,0.0625,15,15,CGTACAGCTTATGTGCCCCA,0,5005797
yjbJ_predicted,0.0625,15,15,CGGGGTATGTCAGATTCCTA,0,5016422
yjbJ_predicted,0.0625,15,15,CGGGGGCGCTTGGCTACCGC,0,5014126
yjbJ_predicted,0.0625,15,15,CGGGCAAGGTACATTTCGCA,0,5008395
yjbJ_predicted,0.0625,15,15,CGGCATAGGGTCACGGAATT,0,5002872
yjbJ_predicted,0.0625,15,15,CGGACTGAGTTTATCTTAAT,0,4995177
yjbJ_predicted,0.0625,15,15,CGCTTCCAGTGGTGGTTAAG,0,5025452
yjbJ_predicted,0.0625,15,15,CGCTGAGGGAGTACGCGTTT,0,5018752
yjbJ_predicted,0.0625,15,15,CGCGTAGGCTTAAACAGACA,0,5021657
yjbJ_predicted,0.0625,15,15,CGCGCGTAACAAACGAATTA,0,5014597
yjbJ_predicted,0.0625,15,15,CGATGGGAACGACTCCAGAA,0,5023634
yjbJ_predicted,0.0625,15,15,CGAGTCATGCGGCTTCACAA,0,4998522
yjbJ_predicted,0.0625,15,15,CGACGTGCCGTGGCGACCTC,0,4996283
yjbJ_predicted,0.0625,15,15,CGAATTTAACGACAAGACTG,0,5027447
yjbJ_predicted,0.0625,15,15,CGAAGTTTGACACGCGTGGA,0,5024914
yjbJ_predicted,0.0625,15,15,CGAACTGGGCTGACATCTGT,0,5004765
yjbJ_predicted,0.0625,15,15,CCTCCGGTATCATCAGGGAC,0,5007022
yjbJ_predicted,0.0625,15,15,CCTAAGATTCTTTAGTATAG,0,5028243
yjbJ_predicted,0.0625,15,15,CCGGACGAAGTTTGAGTGTG,0,5005924
yjbJ_predicted,0.0625,15,15,CCGCGGCTGTCTCGGTGGGT,0,5027760
yjbJ_predicted,0.0625,15,15,CCGCGGCTCGTCTTCGTCCT,0,4997717
yjbJ_predicted,0.0625,15,15,CCCTCTGCGCCTGCCGGGAA,0,5005056
yjbJ_predicted,0.0625,15,15,CCCGTTAGAGCGTCATTCGA,0,5014732
yjbJ_predicted,0.0625,15,15,CCCGATATCCACGTGCGGAG,0,4999955
yjbJ_predicted,0.0625,15,15,CCCGAGGACCTTTGGATCCC,0,5017761
yjbJ_predicted,0.0625,15,15,CCCCAGAGAGGCACGCGGAG,0,5024844
yjbJ_predicted,0.0625,15,15,CCAGTCCACGGGGGTCCGCA,0,5000742
yjbJ_predicted,0.0625,15,15,CCACCGTCTGCCCTCGTTTC,0,5017426
yjbJ_predicted,0.0625,15,15,CCACAAACGCTAAGTGGTAT,0,5024192
yjbJ_predicted,0.0625,15,15,CATTTGTGTATCAGGACGTG,0,5022275
yjbJ_predicted,0.0625,15,15,CATTAAGCATAGAGGGGCTC,0,5006033
yjbJ_predicted,0.0625,15,15,CATGTACGTCGTGTGACTTA,0,5007307
yjbJ_predicted,0.0625,15,15,CATGGCATATTTGAGACGCC,0,5012492
yjbJ_predicted,0.0625,15,15,CATATTGTATTGAGAATGAC,0,5006191
yjbJ_predicted,0.0625,15,15,CAGGTTCCACGCCTTCGTGA,0,5026702
yjbJ_predicted,0.0625,15,15,CAGCTAATCGGTATTATTCG,0,5001280
yjbJ_predicted,0.0625,15,15,CAGATAGCATTCCCTACACA,0,5010962
yjbJ_predicted,0.0625,15,15,CACGGCGCCGACACCCGATC,0,5026998
yjbJ_predicted,0.0625,15,15,CACAAAGCACCATGAGATAG,0,4997192
yjbJ_predicted,0.0625,15,15,ATTGCTCGGGTGAAAATCAG,0,5005054
yjbJ_predicted,0.0625,15,15,ATTCGTCCCTCTAATTATGA,0,5001583
yjbJ_predicted,0.0625,15,15,ATACGGTGGCCTAATTCCAG,0,5006496
yjbJ_predicted,0.0625,15,15,ATAATCCTGCATTCGTCATG,0,5007625
yjbJ_predicted,0.0625,15,15,ATAACGCTGTGTAAGTTGGT,0,4998512
yjbJ_predicted,0.0625,15,15,AGTTCACGCGTCATCGGGAA,0,5020966
yjbJ_predicted,0.0625,15,15,AGTCGGACCATAGATTGAGT,0,5018302
yjbJ_predicted,0.0625,15,15,AGTAGAAGGGAAGGAGCAAT,0,5008368
yjbJ_predicted,0.0625,15,15,AGGCAATTGTGCTAAAGAGA,0,4998361
yjbJ_predicted,0.0625,15,15,AGCTCGGTTGAGAACAGACA,0,5021753
yjbJ_predicted,0.0625,15,15,AGATGCCGCTGCTAGCAGTG,0,5010481
yjbJ_predicted,0.0625,15,15,AGAATACCCGTTATTTTCGT,0,5005751
yjbJ_predicted,0.0625,15,15,AGAAGTGTTGGTCCGAGTTG,0,5000239
yjbJ_predicted,0.0625,15,15,ACTGGTTAGAGCCCAGGGCT,0,5006106
yjbJ_predicted,0.0625,15,15,ACTGCATTTGTTATTCTTTT,0,5011869
yjbJ_predicted,0.0625,15,15,ACTATCTACAAGCGTGGTCA,0,5007705
yjbJ_predicted,0.0625,15,15,ACCTGCCCGGGAGCAGGTCT,0,5025429
yjbJ_predicted,0.0625,15,15,ACCGCGACTGTGCAATGAAA,0,4998747
yjbJ_predicted,0.0625,15,15,ACCAGGACAGAGCGCTTTCA,0,5025865
yjbJ_predicted,0.0625,15,15,ACATGGCAATATGGGTGCTA,0,5006955
yjbJ_predicted,0.0625,15,15,ACAGGTCATGGCCGTCTGAT,0,5006746
yjbJ_predicted,0.0625,15,15,ACACTGGCGACTTAAATCAT,0,5001312
yjbJ_predicted,0.0625,15,15,ACACCCGGGACTGGCTTTAC,0,4995193
yjbJ_predicted,0.0625,15,15,ACAAGTGGAAACATATAATC,0,5014750
yjbJ_predicted,0.0625,15,15,AATTGTGAGTTCACGCGCGG,0,5020146
yjbJ_predicted,0.0625,15,15,AATTCTCTATGGACCTGGGT,0,5023751
yjbJ_predicted,0.0625,15,15,AATAGTTGGAACTGTTTCAC,0,5002208
yjbJ_predicted,0.0625,15,15,AATACATCGCACAACGGTTT,0,5011989
yjbJ_predicted,0.0625,15,15,AAGCGGGGCCAGTGGGGCCG,0,5015722
yjbJ_predicted,0.0625,15,15,AACTTGCACTAGCTCATGAT,0,5028402
yjbJ_predicted,0.0625,15,15,AACTCAGGAAGTATAACTCT,0,5019370
yjbJ_predicted,0.0625,15,15,AACGGCTTTACCGAAGTATA,0,5020462
yjbJ_predicted,0.0625,15,15,AACGCGAATTGTTTTAAGAG,0,5031007
yjbJ_predicted,0.0625,15,15,AACATGATAACGTGGGGTAG,0,5004800
yjbJ_predicted,0.0625,15,15,AAATTGGGATAAACCCCAGA,0,5016062
yjbJ_predicted,0.0625,15,15,AAAGGCGAGAGAGTCACAGA,0,5021112
yjbJ_predicted,0.0625,15,15,AAAACATCGGTAGTTTGCTT,0,5001211
yjbJ_predicted,0.06666666666666667,14,14,TTTGAGGTGATCGGAATTAG,0,4997163
yjbJ_predicted,0.06666666666666667,14,14,TTTCGACGCCTATGAGTGAA,0,5027782
yjbJ_predicted,0.06666666666666667,14,14,TTGTTGCGCAACAATAGATC,0,5020066
yjbJ_predicted,0.06666666666666667,14,14,TTGTCGTCTTCTAAGATAAT,0,4997599
yjbJ_predicted,0.06666666666666667,14,14,TTGATTGCCTCATGTACATA,0,5026446
yjbJ_predicted,0.06666666666666667,14,14,TTGAGTGTCTTAGATCCTGA,0,5002855
yjbJ_predicted,0.06666666666666667,14,14,TTCTTGGCGCCCACCCAGGT,0,5020539
yjbJ_predicted,0.06666666666666667,14,14,TTCTGGACTCAGCCTTTTGT,0,5013112
yjbJ_predicted,0.06666666666666667,14,14,TTCGTAAAGGCAATGTTTAG,0,5016337
yjbJ_predicted,0.06666666666666667,14,14,TTCCGTTCGGGTTCCCAAAT,0,5002132
yjbJ_predicted,0.06666666666666667,14,14,TTCCCTATAATGGAAAACGG,0,5008956
yjbJ_predicted,0.06666666666666667,14,14,TTCACCATAAACAGCCTAAG,0,5023078
yjbJ_predicted,0.06666666666666667,14,14,TTCAAAAGCGGGACTTCGAG,0,5004251
yjbJ_predicted,0.06666666666666667,14,14,TTAGAAGAATAGTGGACTGA,0,5021886
yjbJ_predicted,0.06666666666666667,14,14,TTACAGTGGCTCGGGACGTG,0,5016184
yjbJ_predicted,0.06666666666666667,14,14,TGTTTAGATAAGACGGCAGT,0,5027766
yjbJ_predicted,0.06666666666666667,14,14,TGTGCGGTTCATCAACACGC,0,5001799
yjbJ_predicted,0.06666666666666667,14,14,TGTGACATTTAATTATGGAA,0,5017305
yjbJ_predicted,0.06666666666666667,14,14,TGGTTTGGTGCTACAAGCCT,0,5022884
yjbJ_predicted,0.06666666666666667,14,14,TGGTGGGTTGCAAGGCTATC,0,5008103
yjbJ_predicted,0.06666666666666667,14,14,TGGTGAGGCCGTAAGTGCCT,0,5024868
yjbJ_predicted,0.06666666666666667,14,14,TGGTAACTATGCGCCGCACA,0,5019185
yjbJ_predicted,0.06666666666666667,14,14,TGCTGGGACCATGTCAGTTA,0,5022142
yjbJ_predicted,0.06666666666666667,14,14,TGCTCGAGATACATTTGATC,0,5017893
yjbJ_predicted,0.06666666666666667,14,14,TGCTCCTAGTCATGAGCGCG,0,4996217
yjbJ_predicted,0.06666666666666667,14,14,TGCATCCTGGGCGAAAGGAT,0,5024232
yjbJ_predicted,0.06666666666666667,14,14,TGATTTGAGCGCTTCGGTAA,0,5002553
yjbJ_predicted,0.06666666666666667,14,14,TGACCTTTGTTTGGGTTCGC,0,5022534
yjbJ_predicted,0.06666666666666667,14,14,TCTTGACCAAGGCTTCCGAG,0,4997315
yjbJ_predicted,0.06666666666666667,14,14,TCTTACGTTTGCGTCGGCGC,0,5004045
yjbJ_predicted,0.06666666666666667,14,14,TCTCACCATTCCCGATGAAA,0,5017247
yjbJ_predicted,0.06666666666666667,14,14,TCTATTTTGCCCAGTTAGCC,0,5009626
yjbJ_predicted,0.06666666666666667,14,14,TCGGGTCCCTTGTATTGGTT,0,4999915
yjbJ_predicted,0.06666666666666667,14,14,TCGCTGGTCCACAGTGTGCA,0,4998104
yjbJ_predicted,0.06666666666666667,14,14,TCCTTTCTACTGACACCGCT,0,5018657
yjbJ_predicted,0.06666666666666667,14,14,TCCGGCAGCGGTCTCTTGTA,0,4997211
yjbJ_predicted,0.06666666666666667,14,14,TCCATCAAAGTTCGCCACAT,0,5017287
yjbJ_predicted,0.06666666666666667,14,14,TAGGTTGTAGCCCCAAACCC,0,5007226
yjbJ_predicted,0.06666666666666667,14,14,TAGCTCCATTCACCTGCCGT,0,5026509
yjbJ_predicted,0.06666666666666667,14,14,TAGCTCAACAACGGCATTTG,0,5012051
yjbJ_predicted,0.06666666666666667,14,14,TACGTTCGCCCGCAACCCTG,0,5027531
yjbJ_predicted,0.06666666666666667,14,14,TACGAGATCGCGTCTGTCGT,0,5021962
yjbJ_predicted,0.06666666666666667,14,14,TACAGTTAAATGGTGTCGAA,0,4998457
yjbJ_predicted,0.06666666666666667,14,14,TAAGTGTCATTGGAAGGTAG,0,5003853
yjbJ_predicted,0.06666666666666667,14,14,GTTTCAACCAATGAAGTACA,0,5020087
yjbJ_predicted,0.06666666666666667,14,14,GTTTAGCATCACGTCGTAAA,0,5018490
yjbJ_predicted,0.06666666666666667,14,14,GTTGATCCCCATTTACACCA,0,5016726
yjbJ_predicted,0.06666666666666667,14,14,GTTGAACTCCTTACACCATG,0,5027304
yjbJ_predicted,0.06666666666666667,14,14,GTTCTATCGTTCAGCGGAGC,0,5016245
yjbJ_predicted,0.06666666666666667,14,14,GTTCCCTGACGTTTCATGGT,0,5030434
yjbJ_predicted,0.06666666666666667,14,14,GTGTAGAGCACTTCGAAGAT,0,5003606
yjbJ_predicted,0.06666666666666667,14,14,GTGCTAAGTACAAGTTAAAT,0,5011106
yjbJ_predicted,0.06666666666666667,14,14,GTGAAGCATGCTTCCAATGC,0,5015316
yjbJ_predicted,0.06666666666666667,14,14,GTCTATGGCACAGACACCCG,0,5020601
yjbJ_predicted,0.06666666666666667,14,14,GGTGCGTGGGTTTTCTTCAT,0,5016849
yjbJ_predicted,0.06666666666666667,14,14,GGTCATCCGGGCTTCATAGG,0,5006586
yjbJ_predicted,0.06666666666666667,14,14,GGTATTCCTTATTCCATCAT,0,5025443
yjbJ_predicted,0.06666666666666667,14,14,GGGCAAGATATGGCAATAAC,0,5019523
yjbJ_predicted,0.06666666666666667,14,14,GGGAGGGACGCATCTCCAGC,0,5008034
yjbJ_predicted,0.06666666666666667,14,14,GGGAATATCGTTTTAACTTA,0,5022015
yjbJ_predicted,0.06666666666666667,14,14,GGGAATAAGCCCGGTGACAT,0,5008750
yjbJ_predicted,0.06666666666666667,14,14,GGCCGCACCTGGGGTGGAAA,0,5014566
yjbJ_predicted,0.06666666666666667,14,14,GGAGCGTACGGTGCTGAGAT,0,5029340
yjbJ_predicted,0.06666666666666667,14,14,GGAGAAATGTCCTGGACACT,0,5013371
yjbJ_predicted,0.06666666666666667,14,14,GCTGTTTACGTGCCTCCAAG,0,4999022
yjbJ_predicted,0.06666666666666667,14,14,GCTCTCAATCCGACTCCAGA,0,5025632
yjbJ_predicted,0.06666666666666667,14,14,GCTCGTAGCCTGAAATGATC,0,5012062
yjbJ_predicted,0.06666666666666667,14,14,GCTCCTAGAATTAAAACCTG,0,5002814
yjbJ_predicted,0.06666666666666667,14,14,GCTCCAGCGGAGCCACAAAA,0,5015889
yjbJ_predicted,0.06666666666666667,14,14,GCTCACTGGGCGCCCCTCGC,0,4997597
yjbJ_predicted,0.06666666666666667,14,14,GCTAACTCATCGCAAAGAGC,0,4996762
yjbJ_predicted,0.06666666666666667,14,14,GCGGGACCCTCACGACAGGA,0,5022767
yjbJ_predicted,0.06666666666666667,14,14,GCGCGCGCTATCTGATGCCC,0,5030801
yjbJ_predicted,0.06666666666666667,14,14,GCGAGCCATTACCGCCTCGG,0,4999368
yjbJ_predicted,0.06666666666666667,14,14,GCCAGGTGCGGTCCTGTTCT,0,4998556
yjbJ_predicted,0.06666666666666667,14,14,GCATTCATGGAAGAAAAGGA,0,5013225
yjbJ_predicted,0.06666666666666667,14,14,GCATAGGAGGGACGGTATTT,0,5000164
yjbJ_predicted,0.06666666666666667,14,14,GCAGGAGAACAGAACCGGCC,0,5011665
yjbJ_predicted,0.06666666666666667,14,14,GATTCTAGGCAACACGTCCA,0,5020794
yjbJ_predicted,0.06666666666666667,14,14,GATTCATTTTATATCATCCG,0,5012989
yjbJ_predicted,0.06666666666666667,14,14,GATCTAGAACCTGGGTCGGA,0,5007215
yjbJ_predicted,0.06666666666666667,14,14,GATAAGGACCCAATTCATAG,0,5012279
yjbJ_predicted,0.06666666666666667,14,14,GAGTAGGGTTTCCTCAACAC,0,5013018
yjbJ_predicted,0.06666666666666667,14,14,GAGGGAATACCGTTTCGTTC,0,5013839
yjbJ_predicted,0.06666666666666667,14,14,GAGGCCAGGCAGATCTGCAA,0,5008590
yjbJ_predicted,0.06666666666666667,14,14,GAGAACCGGAGTTAGATAGA,0,5011825
yjbJ_predicted,0.06666666666666667,14,14,GAAGGATACCTGTATAAATC,0,5028995
yjbJ_predicted,0.06666666666666667,14,14,GAAACGTGGGCGGGAGCTCA,0,5022183
yjbJ_predicted,0.06666666666666667,14,14,CTTCTTGTGGCCGTTATAAT,0,5006153
yjbJ_predicted,0.06666666666666667,14,14,CTTAGGTAAGGCCAGAGACT,0,5028800
yjbJ_predicted,0.06666666666666667,14,14,CTCTCTCCATGGCATACTGT,0,5003967
yjbJ_predicted,0.06666666666666667,14,14,CTCCATTGGTAAGTCTACAG,0,5011656
yjbJ_predicted,0.06666666666666667,14,14,CTAGCCCGAACCTGACGCCT,0,4995022
yjbJ_predicted,0.06666666666666667,14,14,CGTTACCTATCTCTACGTTC,0,5012656
yjbJ_predicted,0.06666666666666667,14,14,CGTTAAGAAAAATCGTCAGA,0,5026542
yjbJ_predicted,0.06666666666666667,14,14,CGGTGCCTGGCAGTTGTCAA,0,5013659
yjbJ_predicted,0.06666666666666667,14,14,CGGTATTCATGGAGCAGCGT,0,5020127
yjbJ_predicted,0.06666666666666667,14,14,CGGTAAAATTAGTCAACAGT,0,5009624
yjbJ_predicted,0.06666666666666667,14,14,CGGGCCATAAGCATGATCTG,0,4998900
yjbJ_predicted,0.06666666666666667,14,14,CGGCCTGCATGCGCAGGCAT,0,4996321
yjbJ_predicted,0.06666666666666667,14,14,CGGCCTGCAGCAAATGTGGT,0,5023129
yjbJ_predicted,0.06666666666666667,14,14,CGGCCTACGTCTTACTAGAG,0,5027039
yjbJ_predicted,0.06666666666666667,14,14,CGGCATACGGAGCTATATCA,0,5008116
yjbJ_predicted,0.06666666666666667,14,14,CGGCAGCCGGACGAAGCACA,0,5018329
yjbJ_predicted,0.06666666666666667,14,14,CGCGGGCTAGCGATAGACAG,0,5024995
yjbJ_predicted,0.06666666666666667,14,14,CGCGACGACACACCACAGCT,0,4997867
yjbJ_predicted,0.06666666666666667,14,14,CGATTGAGTGAGAGCGGCAT,0,5018893
yjbJ_predicted,0.06666666666666667,14,14,CGAGGCACTAGTTAGGTCGT,0,5020528
yjbJ_predicted,0.06666666666666667,14,14,CGAACGTTAGGGATACACTT,0,5023107
yjbJ_predicted,0.06666666666666667,14,14,CGAAACTCGAACCATGGAGT,0,5017813
yjbJ_predicted,0.06666666666666667,14,14,CCTTATAACATGGTATTCGT,0,5016209
yjbJ_predicted,0.06666666666666667,14,14,CCTCGCGGTATTCCAACCTT,0,4996601
yjbJ_predicted,0.06666666666666667,14,14,CCTAGTTCCTGGCGGAGAAA,0,5003117
yjbJ_predicted,0.06666666666666667,14,14,CCGGAGTGAGTATGGGTTGC,0,5022117
yjbJ_predicted,0.06666666666666667,14,14,CCGAGTTGTTGGATCACGAA,0,5001836
yjbJ_predicted,0.06666666666666667,14,14,CCGACCTCGTTAAATATCCG,0,5014915
yjbJ_predicted,0.06666666666666667,14,14,CCGACCAGCCCCCCAAGGGG,0,5008119
yjbJ_predicted,0.06666666666666667,14,14,CCCGGAATAATCGTAGCTAC,0,5001497
yjbJ_predicted,0.06666666666666667,14,14,CCCGCAACAAGTTGTCTAGG,0,4999896
yjbJ_predicted,0.06666666666666667,14,14,CCCCATCGCCTGCAGTTGGC,0,5014202
yjbJ_predicted,0.06666666666666667,14,14,CCCAGGGCTACTATGGCCAT,0,5029750
yjbJ_predicted,0.06666666666666667,14,14,CCCACTCGTGGATTATAGTA,0,5016829
yjbJ_predicted,0.06666666666666667,14,14,CCAGTGTTGTGCGTTGGTAA,0,5012491
yjbJ_predicted,0.06666666666666667,14,14,CCAGTCCGTTACACACTCGG,0,5005038
yjbJ_predicted,0.06666666666666667,14,14,CATTTTACGGGATTAGCCTA,0,5027087
yjbJ_predicted,0.06666666666666667,14,14,CATGAGATTAACCGCAGTGA,0,5021932
yjbJ_predicted,0.06666666666666667,14,14,CATCGGCTAGTTCTACTTGA,0,5018621
yjbJ_predicted,0.06666666666666667,14,14,CATCGGCATAGCAGAAGAGA,0,5017967
yjbJ_predicted,0.06666666666666667,14,14,CAGGGTCTATTAAACCTGCC,0,5011792
yjbJ_predicted,0.06666666666666667,14,14,CACGCACGGGACTTTCTGGT,0,5001091
yjbJ_predicted,0.06666666666666667,14,14,CAATTTCCCCAGAGGACGAA,0,5009128
yjbJ_predicted,0.06666666666666667,14,14,CAATGCGGGTCGTTCGTTGT,0,5026752
yjbJ_predicted,0.06666666666666667,14,14,CAATAGTTCTGTGGAGTGTT,0,5003236
yjbJ_predicted,0.06666666666666667,14,14,CAACGGAATGATAAACACAG,0,5017092
yjbJ_predicted,0.06666666666666667,14,14,CAAACAAAGGAGCCTCAAGA,0,5000890
yjbJ_predicted,0.06666666666666667,14,14,ATTCTCACTGTGAGTAAACA,0,5005974
yjbJ_predicted,0.06666666666666667,14,14,ATTCCCGAGCGGCTATGCAT,0,5022551
yjbJ_predicted,0.06666666666666667,14,14,ATTACTGTCTCTACCCGTGC,0,5023844
yjbJ_predicted,0.06666666666666667,14,14,ATCCTATAACCGGCATTACA,0,5002651
yjbJ_predicted,0.06666666666666667,14,14,ATCAGTTACCAGAAGAGCAT,0,5005143
yjbJ_predicted,0.06666666666666667,14,14,ATAGTCTGCGACACTGCTAA,0,5012089
yjbJ_predicted,0.06666666666666667,14,14,ATAGGATAATTAATTGCGTA,0,5007331
yjbJ_predicted,0.06666666666666667,14,14,ATAGAAGAGCGCGCGAACAT,0,5011082
yjbJ_predicted,0.06666666666666667,14,14,ATACGGAGTAGGTCCGACCT,0,5021047
yjbJ_predicted,0.06666666666666667,14,14,ATACCTTTGCATATCCGGCT,0,5000162
yjbJ_predicted,0.06666666666666667,14,14,ATACCCGCAGCGTGTAAAGG,0,5010221
yjbJ_predicted,0.06666666666666667,14,14,AGTGTAAGATATTCCGTGGG,0,5020743
yjbJ_predicted,0.06666666666666667,14,14,AGTCTGTCCGGCAGCAAGCG,0,5016740
yjbJ_predicted,0.06666666666666667,14,14,AGTCTGAGTGTCATTGTTTC,0,5004564
yjbJ_predicted,0.06666666666666667,14,14,AGTCTACACCGCGAGTCCTA,0,5008469
yjbJ_predicted,0.06666666666666667,14,14,AGGCGGGTGAATAGGTAGCA,0,5018751
yjbJ_predicted,0.06666666666666667,14,14,AGGCCGTGATTCCTAATTTA,0,5015373
yjbJ_predicted,0.06666666666666667,14,14,AGGAAGTAACGCATATCTGG,0,5003604
yjbJ_predicted,0.06666666666666667,14,14,AGCTTGGTATATATAGTAGC,0,4995953
yjbJ_predicted,0.06666666666666667,14,14,AGCTCAGGGTATAAGGCAGA,0,5013611
yjbJ_predicted,0.06666666666666667,14,14,AGCTATGTCTCGACGTAAAT,0,5017130
yjbJ_predicted,0.06666666666666667,14,14,AGATACTTGCATAACTATCA,0,4999376
yjbJ_predicted,0.06666666666666667,14,14,AGAGACGCAACCTTCGCGCT,0,4998410
yjbJ_predicted,0.06666666666666667,14,14,ACTAGGGCGGGGCAGCGGGT,0,5022165
yjbJ_predicted,0.06666666666666667,14,14,ACTAATTACCCTCGTCTCAC,0,5014978
yjbJ_predicted,0.06666666666666667,14,14,ACTAAAGTCAGTGGTCCTCT,0,5000264
yjbJ_predicted,0.06666666666666667,14,14,ACGTGCACTGATACAAACAG,0,5000261
yjbJ_predicted,0.06666666666666667,14,14,ACGTCTTGAGTCTTGTGAGA,0,5005927
yjbJ_predicted,0.06666666666666667,14,14,ACGGGGAAGACACTCATCAT,0,5014800
yjbJ_predicted,0.06666666666666667,14,14,ACGGACGTTATAGATAGGGT,0,5012969
yjbJ_predicted,0.06666666666666667,14,14,ACCGGCAGGCCTTAAAGCGA,0,5010567
yjbJ_predicted,0.06666666666666667,14,14,ACCCGCTTGCCATGATCGCG,0,5018820
yjbJ_predicted,0.06666666666666667,14,14,ACCCCAGTCAAGGGTGAACT,0,5002278
yjbJ_predicted,0.06666666666666667,14,14,ACCATTGGTGTCAGCGGCTC,0,4998437
yjbJ_predicted,0.06666666666666667,14,14,ACCATGTACCGCTAAACATT,0,5000798
yjbJ_predicted,0.06666666666666667,14,14,ACCAATAGTAAAGCCCGATA,0,5003192
yjbJ_predicted,0.06666666666666667,14,14,ACCAATAGGTAAGGTGTCGC,0,5011748
yjbJ_predicted,0.06666666666666667,14,14,AATCTAGAGACGCGGTAGTT,0,5014611
yjbJ_predicted,0.06666666666666667,14,14,AATACCCAGTCTTTTAGGCA,0,5012274
yjbJ_predicted,0.06666666666666667,14,14,AAGGCTTGGCAATAGATACT,0,4995231
yjbJ_predicted,0.06666666666666667,14,14,AAGCCGCAGAGGGTTTCGTG,0,5030302
yjbJ_predicted,0.06666666666666667,14,14,AAGACCGGAGACATCGTGGC,0,5024478
yjbJ_predicted,0.06666666666666667,14,14,AAGAATGCAGCCTGTTTCAC,0,5017588
yjbJ_predicted,0.06666666666666667,14,14,AACGAACGCCCTCAAACAAG,0,5016794
yjbJ_predicted,0.06666666666666667,14,14,AACCGAATGTTACTTCGACG,0,4995181
yjbJ_predicted,0.06666666666666667,14,14,AACCATTTCTCCGCTAATCC,0,5026727
yjbJ_predicted,0.06666666666666667,14,14,AACAAGTAATCGAAGACTAA,0,5026419
yjbJ_predicted,0.06666666666666667,14,14,AAATGCCGGTAGGGACGACA,0,5004571
yjbJ_predicted,0.06666666666666667,14,14,AAAGTTTAGGGACAAACATT,0,5006068
yjbJ_predicted,0.06666666666666667,14,14,AAAGAGCGTGCTGGGGGTGA,0,4994930
yjbJ_predicted,0.06666666666666667,14,14,AAACACTTGGCCCCGTGGTG,0,5016178
yjbJ_predicted,0.07142857142857142,13,13,TTTTCAGGGCTCACAATGAG,0,5006253
yjbJ_predicted,0.07142857142857142,13,13,TTTGTGCTGTTAGTTATTTG,0,5002883
yjbJ_predicted,0.07142857142857142,13,13,TTTCGACGAAGGTAGTTTTG,0,5014926
yjbJ_predicted,0.07142857142857142,13,13,TTGTGCGAGGTGAAACAGTG,0,5030940
yjbJ_predicted,0.07142857142857142,13,13,TTGTCAGCCCCAAGGGCGAT,0,4995503
yjbJ_predicted,0.07142857142857142,13,13,TTGTACCTTGATCAGCTTCT,0,5019186
yjbJ_predicted,0.07142857142857142,13,13,TTGTAAAAGTCATGCGCGGG,0,5012840
yjbJ_predicted,0.07142857142857142,13,13,TTGAGTGTCAGCTATTCCTA,0,5014569
yjbJ_predicted,0.07142857142857142,13,13,TTCATTCTCCAGCTGCCGAA,0,5018330
yjbJ_predicted,0.07142857142857142,13,13,TTCACACTCTGTATAGCAGT,0,5017173
yjbJ_predicted,0.07142857142857142,13,13,TTATATGGCTAATCAAGATA,0,5014277
yjbJ_predicted,0.07142857142857142,13,13,TTAACTGGAGGACAGAATAG,0,5022609
yjbJ_predicted,0.07142857142857142,13,13,TGTTATGGCGATCTGGATTA,0,5017756
yjbJ_predicted,0.07142857142857142,13,13,TGTGTCAGTGGATACCATTC,0,5019795
yjbJ_predicted,0.07142857142857142,13,13,TGTCTAGTGGGTGGCACAGG,0,5003435
yjbJ_predicted,0.07142857142857142,13,13,TGTCGGTCCAATGGACAAGA,0,5011197
yjbJ_predicted,0.07142857142857142,13,13,TGTCGCGAAGTTTTGGCGGT,0,5004003
yjbJ_predicted,0.07142857142857142,13,13,TGTAAGGCGTTCTGTGACTG,0,5005998
yjbJ_predicted,0.07142857142857142,13,13,TGGTATTGGGTGGTTTAGCC,0,4997871
yjbJ_predicted,0.07142857142857142,13,13,TGGCGGTGCAGAGAGGGAGA,0,4996973
yjbJ_predicted,0.07142857142857142,13,13,TGGCCCGAGCAGAAGCTCGA,0,5008619
yjbJ_predicted,0.07142857142857142,13,13,TGGATTTGCGCCGCACAGAA,0,4995372
yjbJ_predicted,0.07142857142857142,13,13,TGGATTGGGAACGCGAGGGG,0,5029427
yjbJ_predicted,0.07142857142857142,13,13,TGGAAGGACGCCTTCCAAAA,0,5010098
yjbJ_predicted,0.07142857142857142,13,13,TGCTACACCGCTGAGTTACT,0,5001867
yjbJ_predicted,0.07142857142857142,13,13,TGCTAATCAGCGAGCAGGTC,0,5008453
yjbJ_predicted,0.07142857142857142,13,13,TGCGGCAGCAATGTTATATG,0,5029059
yjbJ_predicted,0.07142857142857142,13,13,TGCAAAGTGTGAGTGAATTA,0,5007281
yjbJ_predicted,0.07142857142857142,13,13,TGATACATTAGCCATTCTGT,0,5016359
yjbJ_predicted,0.07142857142857142,13,13,TCTTAACCCGGCTTGTTCAG,0,4997663
yjbJ_predicted,0.07142857142857142,13,13,TCTCGGACCTACGGTATTCG,0,5002549
yjbJ_predicted,0.07142857142857142,13,13,TCCGAACTTGTGGCATATCA,0,5006109
yjbJ_predicted,0.07142857142857142,13,13,TCCCACAGCGTGATTATTTG,0,5001401
yjbJ_predicted,0.07142857142857142,13,13,TCACTAGGTCTTCTCCACAT,0,5024375
yjbJ_predicted,0.07142857142857142,13,13,TATGTCCGTAGTTCGATAGC,0,5014536
yjbJ_predicted,0.07142857142857142,13,13,TATGGGTTGTTCAATCGTGG,0,5000826
yjbJ_predicted,0.07142857142857142,13,13,TATGCTTCCTGGAATCGCTC,0,5015338
yjbJ_predicted,0.07142857142857142,13,13,TAGATTTGTGGTATGGGTAC,0,5031056
yjbJ_predicted,0.07142857142857142,13,13,TAGAGTTTTGAGTTAGTTTA,0,5000108
yjbJ_predicted,0.07142857142857142,13,13,TAGAAATCGGTCTCGCAGGT,0,5021849
yjbJ_predicted,0.07142857142857142,13,13,TACTTATTCGCTTGGCCGTA,0,5026700
yjbJ_predicted,0.07142857142857142,13,13,TACCTCGCCACACGGAAAAG,0,5015272
yjbJ_predicted,0.07142857142857142,13,13,TACAGATCTACATTCTCCAT,0,5001496
yjbJ_predicted,0.07142857142857142,13,13,TAAGGCTCCAGTTCTAGTAT,0,5023410
yjbJ_predicted,0.07142857142857142,13,13,TAAATCTCATCGGGGGGTAT,0,5028372
yjbJ_predicted,0.07142857142857142,13,13,GTTTCCAGCCGTGGGGTCGC,0,5030294
yjbJ_predicted,0.07142857142857142,13,13,GTTGGGAATTTCGGAGAACA,0,5022181
yjbJ_predicted,0.07142857142857142,13,13,GTTGCGCTTAGGTCAAGCAT,0,5009118
yjbJ_predicted,0.07142857142857142,13,13,GTTAACTGTTCGCGGCGCAA,0,5029763
yjbJ_predicted,0.07142857142857142,13,13,GTGGTTTCTGCTGGGAGTTC,0,5015688
yjbJ_predicted,0.07142857142857142,13,13,GTGGACGGTCTCCGGTGATA,0,5024194
yjbJ_predicted,0.07142857142857142,13,13,GTGATCGAGTTCTATGTGAA,0,4996780
yjbJ_predicted,0.07142857142857142,13,13,GTCTTAGGGAGTTCCGCAGT,0,5014581
yjbJ_predicted,0.07142857142857142,13,13,GTCGGGCCAATTCCCGGAAC,0,5016115
yjbJ_predicted,0.07142857142857142,13,13,GTCACGTCGCGACTTGGAAC,0,5018954
yjbJ_predicted,0.07142857142857142,13,13,GTCACCTGGCGACTGTGGAT,0,5001908
yjbJ_predicted,0.07142857142857142,13,13,GTATTCTTTACAGTGGAATG,0,5027508
yjbJ_predicted,0.07142857142857142,13,13,GTAGTAACTTTTACCGGGTC,0,5006715
yjbJ_predicted,0.07142857142857142,13,13,GTAGGACCTTAGCAGTTGGG,0,5020441
yjbJ_predicted,0.07142857142857142,13,13,GTACTGCCTACGGAATTGCA,0,5017236
yjbJ_predicted,0.07142857142857142,13,13,GGTTATTACTTAGGCGCAAC,0,5005215
yjbJ_predicted,0.07142857142857142,13,13,GGTGTGTGTCTGCAATCGAG,0,5018416
yjbJ_predicted,0.07142857142857142,13,13,GGGTGAATTATGGGTAGGTG,0,4996754
yjbJ_predicted,0.07142857142857142,13,13,GGGTAAGCTCCACACGCACA,0,5004491
yjbJ_predicted,0.07142857142857142,13,13,GGGGTACGTATTTTTACGCT,0,5016946
yjbJ_predicted,0.07142857142857142,13,13,GGGGGAAGTGACGGGCGAAA,0,5018819
yjbJ_predicted,0.07142857142857142,13,13,GGGCAATACATCAGTGCGGG,0,4995599
yjbJ_predicted,0.07142857142857142,13,13,GGCTTCACAGGATGTTGGGT,0,5006765
yjbJ_predicted,0.07142857142857142,13,13,GGCTGCGTGTTGATGCAGGC,0,4996493
yjbJ_predicted,0.07142857142857142,13,13,GGCTACGTTACCCCGTTAGT,0,5024825
yjbJ_predicted,0.07142857142857142,13,13,GGCGACTGATAAACGACTAC,0,5000624
yjbJ_predicted,0.07142857142857142,13,13,GGACTGGGCTAGGGAGTCAG,0,5028997
yjbJ_predicted,0.07142857142857142,13,13,GGAATGGTTTGTACAGTTAT,0,5004869
yjbJ_predicted,0.07142857142857142,13,13,GGAACCTCATTATTCGCTTG,0,5013804
yjbJ_predicted,0.07142857142857142,13,13,GCTTTACCCATCTGGGCCGT,0,4998052
yjbJ_predicted,0.07142857142857142,13,13,GCGTCCACCTATGCGATCGG,0,4998252
yjbJ_predicted,0.07142857142857142,13,13,GCGTATTCAACATATGTAAA,0,4999468
yjbJ_predicted,0.07142857142857142,13,13,GCGCTTCTTTATTGGCGGAC,0,4998255
yjbJ_predicted,0.07142857142857142,13,13,GCGCTAGCTCAATAAACTCA,0,5029022
yjbJ_predicted,0.07142857142857142,13,13,GCGAGATAACCCGTAGGAGT,0,5019061
yjbJ_predicted,0.07142857142857142,13,13,GCCTCCTCATTACGTGCATA,0,5013078
yjbJ_predicted,0.07142857142857142,13,13,GCATAAGTGGTACTATGTAC,0,5009631
yjbJ_predicted,0.07142857142857142,13,13,GCACGTTGATGCCGGCCGTA,0,5010271
yjbJ_predicted,0.07142857142857142,13,13,GCAAGGCTTTGTCTGTAGGT,0,4996481
yjbJ_predicted,0.07142857142857142,13,13,GATTAGTCTACGTTAAAAGA,0,4999203
yjbJ_predicted,0.07142857142857142,13,13,GATGCGGTCCCAGGCAGGGA,0,5025538
yjbJ_predicted,0.07142857142857142,13,13,GAGTTGTGGAACACTTCAAT,0,5001123
yjbJ_predicted,0.07142857142857142,13,13,GAGGTTCGCATGTGCTACTC,0,5014952
yjbJ_predicted,0.07142857142857142,13,13,GAGGGCTAGGACGTCTTACA,0,5017207
yjbJ_predicted,0.07142857142857142,13,13,GAGGGAGGCCGCGTGCGGTA,0,5023241
yjbJ_predicted,0.07142857142857142,13,13,GAGGCGTAAAAGGTGGGCCG,0,5004361
yjbJ_predicted,0.07142857142857142,13,13,GAGGACGGCTGCCCAACGGT,0,4996570
yjbJ_predicted,0.07142857142857142,13,13,GAGGAACAGCGAATACGGCC,0,5028405
yjbJ_predicted,0.07142857142857142,13,13,GAGCGCGGATCTGCGAAGAC,0,5017331
yjbJ_predicted,0.07142857142857142,13,13,GAGAACTCGACTTTTCCCAC,0,5007562
yjbJ_predicted,0.07142857142857142,13,13,GAGAACATTGGAGTAAGTTT,0,5010535
yjbJ_predicted,0.07142857142857142,13,13,GACTGCTTTGTCCACCGTTA,0,5029404
yjbJ_predicted,0.07142857142857142,13,13,GACGTGCGCCCGCACTTGGC,0,5018378
yjbJ_predicted,0.07142857142857142,13,13,GACGAGGAAGTCCTAGGGAT,0,5022963
yjbJ_predicted,0.07142857142857142,13,13,GAATGGTACAGATTATAGAT,0,5012502
yjbJ_predicted,0.07142857142857142,13,13,GAATCTCTAAACACGGCTTA,0,5007947
yjbJ_predicted,0.07142857142857142,13,13,GAAGCTTGACTTCACTTCCA,0,5006104
yjbJ_predicted,0.07142857142857142,13,13,GAACCCGTTGACGGGCCGGG,0,5005559
yjbJ_predicted,0.07142857142857142,13,13,GAAATAGGGGTTGTGTAGAC,0,5030552
yjbJ_predicted,0.07142857142857142,13,13,CTTTACTGGTCAGGCCCAGG,0,5020205
yjbJ_predicted,0.07142857142857142,13,13,CTTGTGAATGCGGCCTAACA,0,4997644
yjbJ_predicted,0.07142857142857142,13,13,CTTGAGACTCCCGCTCGTGA,0,5009408
yjbJ_predicted,0.07142857142857142,13,13,CTGGAGGCATACCTGTGCTT,0,5002277
yjbJ_predicted,0.07142857142857142,13,13,CTGCTGCGGCTCGGCAGCAG,0,5014033
yjbJ_predicted,0.07142857142857142,13,13,CTGCGTGGGTAAGCTTTGAG,0,5019555
yjbJ_predicted,0.07142857142857142,13,13,CTGAGTAAGTGAACTTACAA,0,5025475
yjbJ_predicted,0.07142857142857142,13,13,CTGAACGTGCCGCGGCGCCA,0,5017662
yjbJ_predicted,0.07142857142857142,13,13,CTCTGGTTTCCATTCTTAAA,0,5006389
yjbJ_predicted,0.07142857142857142,13,13,CTCTACTGTGTGCCAAAAAG,0,4997417
yjbJ_predicted,0.07142857142857142,13,13,CTCAGTTGCTTGGGACCGTT,0,5012263
yjbJ_predicted,0.07142857142857142,13,13,CTATCACTATGGATGTCAGG,0,5012939
yjbJ_predicted,0.07142857142857142,13,13,CGTTGTGTTGTTTATCCTAA,0,5000357
yjbJ_predicted,0.07142857142857142,13,13,CGTGCGTCCTTACTACCGCT,0,5003971
yjbJ_predicted,0.07142857142857142,13,13,CGGGACGTGTTGGGTCTTCT,0,4999975
yjbJ_predicted,0.07142857142857142,13,13,CGGATGCATATCATCGCTCA,0,5030821
yjbJ_predicted,0.07142857142857142,13,13,CGGACGTTGCGCATTTGGAT,0,5018712
yjbJ_predicted,0.07142857142857142,13,13,CGCGCTTTCGTGGAACATGA,0,4998349
yjbJ_predicted,0.07142857142857142,13,13,CGACCTATCTCCAACACTTT,0,5020941
yjbJ_predicted,0.07142857142857142,13,13,CGACCCCTTCGAGCCTTGCT,0,5027434
yjbJ_predicted,0.07142857142857142,13,13,CCTGGGTAAAGGTTGTAATC,0,5003031
yjbJ_predicted,0.07142857142857142,13,13,CCGTTAGATCTCCCTAATCC,0,5003522
yjbJ_predicted,0.07142857142857142,13,13,CCGTAGACAACGGTGAAGCT,0,5018889
yjbJ_predicted,0.07142857142857142,13,13,CCGGCTTGAATGCCTATTAG,0,5014399
yjbJ_predicted,0.07142857142857142,13,13,CCGAATACCGAGCACATTTG,0,4999119
yjbJ_predicted,0.07142857142857142,13,13,CCCTACTGCATTGGTAGCCG,0,5007850
yjbJ_predicted,0.07142857142857142,13,13,CCCGTGAGGGCGCAGCAGGG,0,5016391
yjbJ_predicted,0.07142857142857142,13,13,CCCATATTTGTATTTGCTTA,0,5026824
yjbJ_predicted,0.07142857142857142,13,13,CCATGGGGTGGACTAAGCCA,0,5010693
yjbJ_predicted,0.07142857142857142,13,13,CCAGGCCGTACGAGTTTATA,0,5024168
yjbJ_predicted,0.07142857142857142,13,13,CCAGCGCGGAATTTTCCCTT,0,5018861
yjbJ_predicted,0.07142857142857142,13,13,CCACGGGAGATTGGTTCATA,0,5010911
yjbJ_predicted,0.07142857142857142,13,13,CCACAGTGAGCTAACGAATG,0,5011685
yjbJ_predicted,0.07142857142857142,13,13,CATTCGCCTTAGCCGTCACA,0,5019620
yjbJ_predicted,0.07142857142857142,13,13,CATGATGAATGCTTAATTCG,0,5017452
yjbJ_predicted,0.07142857142857142,13,13,CATCCTAAGAGGAGGACCAA,0,5010435
yjbJ_predicted,0.07142857142857142,13,13,CATACTTCAGACGAACCCGC,0,5004332
yjbJ_predicted,0.07142857142857142,13,13,CAGGTCGAGGACGCAGGCAA,0,5000165
yjbJ_predicted,0.07142857142857142,13,13,CAGGCGTGGTACGGCAGCGA,0,5025471
yjbJ_predicted,0.07142857142857142,13,13,CAGCAAGTAAGCGGCGGTCC,0,5012352
yjbJ_predicted,0.07142857142857142,13,13,CACTTCCTACGGAAAGAATA,0,4999165
yjbJ_predicted,0.07142857142857142,13,13,CACCACCGTGAAACCTGGTA,0,5021797
yjbJ_predicted,0.07142857142857142,13,13,CACAGTTGCCTGGCAACCCA,0,5025768
yjbJ_predicted,0.07142857142857142,13,13,CACACCAGGCCGGTATTTCC,0,4998464
yjbJ_predicted,0.07142857142857142,13,13,CAACCGACCTTAGCATGATT,0,5022331
yjbJ_predicted,0.07142857142857142,13,13,CAACATTGCGTGCCGGGGAG,0,5006063
yjbJ_predicted,0.07142857142857142,13,13,CAAAACAGGGGTTAATGTGA,0,5007122
yjbJ_predicted,0.07142857142857142,13,13,ATTTTTAAAGGATAGGTGGG,0,5024397
yjbJ_predicted,0.07142857142857142,13,13,ATTTCGAGAAGAACCTAAGT,0,5001915
yjbJ_predicted,0.07142857142857142,13,13,ATTTAGCATTTATCGCATGA,0,5029079
yjbJ_predicted,0.07142857142857142,13,13,ATTGTCCGGTCTCAGCTCGG,0,5004164
yjbJ_predicted,0.07142857142857142,13,13,ATTGATTTCGTGACCATTTC,0,5014598
yjbJ_predicted,0.07142857142857142,13,13,ATTGACATATTCGGCTAGGT,0,4994690
yjbJ_predicted,0.07142857142857142,13,13,ATCTCATGCTAGGTAAGGTT,0,5017602
yjbJ_predicted,0.07142857142857142,13,13,ATCTCACCAGCGACAACAGT,0,5018443
yjbJ_predicted,0.07142857142857142,13,13,ATCCGATAAAGATGCTGGCA,0,5021201
yjbJ_predicted,0.07142857142857142,13,13,ATCCAGGCCCTGCGCAATGC,0,5003499
yjbJ_predicted,0.07142857142857142,13,13,ATCAATGCGTAGGAGACTAG,0,5000375
yjbJ_predicted,0.07142857142857142,13,13,ATATAGAGCTGTCGAACGGT,0,5029254
yjbJ_predicted,0.07142857142857142,13,13,ATAGGGATCGAAAATCGATA,0,5021195
yjbJ_predicted,0.07142857142857142,13,13,ATAGCTACTGGCACCTGTCG,0,5011489
yjbJ_predicted,0.07142857142857142,13,13,ATAGCTACAGTCCACCCTCT,0,5026758
yjbJ_predicted,0.07142857142857142,13,13,ATAGCCTCGTCCGTAAACTT,0,4996774
yjbJ_predicted,0.07142857142857142,13,13,AGTTGCCACACTATGGTTCG,0,5009203
yjbJ_predicted,0.07142857142857142,13,13,AGTGGGTGTCTTATCCGCCA,0,5017585
yjbJ_predicted,0.07142857142857142,13,13,AGTCAAATCGGGACACTCTT,0,5018920
yjbJ_predicted,0.07142857142857142,13,13,AGTAGCGTAGTATTTAAACA,0,5017679
yjbJ_predicted,0.07142857142857142,13,13,AGCTACCAATCAAGTAGACT,0,5018595
yjbJ_predicted,0.07142857142857142,13,13,AGCCTAGAAAGGCTTCTTCC,0,5021555
yjbJ_predicted,0.07142857142857142,13,13,AGACGTATCTAGGGACTATA,0,5018407
yjbJ_predicted,0.07142857142857142,13,13,AGACCTGCGCCATTGGGAAA,0,5022219
yjbJ_predicted,0.07142857142857142,13,13,AGACAGTCCCCGCCAAGTAA,0,5014370
yjbJ_predicted,0.07142857142857142,13,13,AGAAGGTTTCTATCCGAAAA,0,5013463
yjbJ_predicted,0.07142857142857142,13,13,ACTACCCTGCGCTACGGTTT,0,5011998
yjbJ_predicted,0.07142857142857142,13,13,ACGTGTTTCTATGTTGCCGT,0,5019163
yjbJ_predicted,0.07142857142857142,13,13,ACGTGAGTCTCGAAAAAGTC,0,5022778
yjbJ_predicted,0.07142857142857142,13,13,ACGGTGGAGATGTAAACAGT,0,5030013
yjbJ_predicted,0.07142857142857142,13,13,ACGGCATATAGGAGATGTGT,0,5020878
yjbJ_predicted,0.07142857142857142,13,13,ACGCGGAAATCCACTTCCTC,0,5007629
yjbJ_predicted,0.07142857142857142,13,13,ACCTTTTGGCACTTAACGAT,0,5002585
yjbJ_predicted,0.07142857142857142,13,13,ACCGCCTTAATTAATTAATC,0,5020292
yjbJ_predicted,0.07142857142857142,13,13,ACCCTTCACGATTTGCGACT,0,5029434
yjbJ_predicted,0.07142857142857142,13,13,ACCCGTCGGTCGAGTTTATA,0,5023698
yjbJ_predicted,0.07142857142857142,13,13,AATTCGCGCGGACGCTTTCT,0,4999419
yjbJ_predicted,0.07142857142857142,13,13,AATATCTAGCGCTGTAGCTG,0,5018951
yjbJ_predicted,0.07142857142857142,13,13,AATAAATCATTTGACCGAGC,0,5027741
yjbJ_predicted,0.07142857142857142,13,13,AAGCTCGTGTCTCCCAACCT,0,5008624
yjbJ_predicted,0.07142857142857142,13,13,AACTCCACTACAGTCAAGGA,0,5013271
yjbJ_predicted,0.07142857142857142,13,13,AAACGCTTAGTCAAAGGTAG,0,5004079
yjbJ_predicted,0.07142857142857142,13,13,AAACCAACGTTCCGATGGTG,0,5030846
yjbJ_predicted,0.07692307692307693,12,12,TTTTGATAGTGGCCGGTGGC,0,5012702
yjbJ_predicted,0.07692307692307693,12,12,TTTTCTCACTTGCCATTATC,0,5027468
yjbJ_predicted,0.07692307692307693,12,12,TTTCGACAGTAGTAAACCTC,0,5018992
yjbJ_predicted,0.07692307692307693,12,12,TTTCCAGCCGTTTAGCCTTC,0,4996185
yjbJ_predicted,0.07692307692307693,12,12,TTTAAACGGCCTCGTAAACA,0,5014314
yjbJ_predicted,0.07692307692307693,12,12,TTGGTTGAAAAGGGCGTTTA,0,5016242
yjbJ_predicted,0.07692307692307693,12,12,TTGCCCCACGTTGGAGCTAC,0,4999349
yjbJ_predicted,0.07692307692307693,12,12,TTGATGTATGGAGTCTCCCA,0,5025226
yjbJ_predicted,0.07692307692307693,12,12,TTGATCCCATCTGCCAGGCG,0,4998689
yjbJ_predicted,0.07692307692307693,12,12,TTCTGGTAGAGTATCAAACA,0,5011230
yjbJ_predicted,0.07692307692307693,12,12,TTCGAAGTGATCGCCCATGT,0,4995201
yjbJ_predicted,0.07692307692307693,12,12,TTATTAAGCTCCTGGAGTCA,0,5015467
yjbJ_predicted,0.07692307692307693,12,12,TTATGGGAGGGAGGGGCATT,0,4998904
yjbJ_predicted,0.07692307692307693,12,12,TTAGGGGCACGACAAATAGA,0,5002608
yjbJ_predicted,0.07692307692307693,12,12,TTACATGATGGAGCCAGGTC,0,5005393
yjbJ_predicted,0.07692307692307693,12,12,TGTGTTCGTAAGGATAGAAA,0,4995859
yjbJ_predicted,0.07692307692307693,12,12,TGTATGTTACTACTTCACAT,0,5004919
yjbJ_predicted,0.07692307692307693,12,12,TGGTCCGGAAGACTGCTAAT,0,4999846
yjbJ_predicted,0.07692307692307693,12,12,TGGTAGACCATTTAACGTGT,0,5022811
yjbJ_predicted,0.07692307692307693,12,12,TGGGTTAGCTGCCGACGGTC,0,5001228
yjbJ_predicted,0.07692307692307693,12,12,TGGGTAACCTGGAGGTCACT,0,5028900
yjbJ_predicted,0.07692307692307693,12,12,TGGGGCTGCATTATTAATTT,0,5010556
yjbJ_predicted,0.07692307692307693,12,12,TGGCGGGATCTACTAATACA,0,4996173
yjbJ_predicted,0.07692307692307693,12,12,TGGCGAGTATAAACGACGAT,0,5016348
yjbJ_predicted,0.07692307692307693,12,12,TGGCATGATGTCTGAGGTCA,0,5030678
yjbJ_predicted,0.07692307692307693,12,12,TGCTGCTGCCCGTTCTCGAA,0,5014547
yjbJ_predicted,0.07692307692307693,12,12,TGCTCCAAATGAGGCATACT,0,5027002
yjbJ_predicted,0.07692307692307693,12,12,TGCATGACTGGTCAGCATCT,0,4997913
yjbJ_predicted,0.07692307692307693,12,12,TGATTATAACGGAACAGTAT,0,5018838
yjbJ_predicted,0.07692307692307693,12,12,TGATGTCCTTATAGACATTT,0,4999160
yjbJ_predicted,0.07692307692307693,12,12,TGATGCTGTCGCTGCCGACG,0,5000360
yjbJ_predicted,0.07692307692307693,12,12,TGATCGGCTCGTCGAGTTCT,0,5031209
yjbJ_predicted,0.07692307692307693,12,12,TGAGGGTAGAGAATCTCCCA,0,5005890
yjbJ_predicted,0.07692307692307693,12,12,TGACGGTGCTTTTGCCATTT,0,5012109
yjbJ_predicted,0.07692307692307693,12,12,TGACGGCCGATGACTTTCAA,0,5025845
yjbJ_predicted,0.07692307692307693,12,12,TGAAAAATTTTTCGCATACA,0,5025696
yjbJ_predicted,0.07692307692307693,12,12,TCTGAATATCGTTTGGCCGT,0,5024152
yjbJ_predicted,0.07692307692307693,12,12,TCTCCGATAGTCAGCAGACA,0,5013375
yjbJ_predicted,0.07692307692307693,12,12,TCTATCCCAACGTTCCTACA,0,5030282
yjbJ_predicted,0.07692307692307693,12,12,TCGGCTCGGGCGTTAAGTTG,0,5015813
yjbJ_predicted,0.07692307692307693,12,12,TCCGTGTAGGGAAACTTCTG,0,4998875
yjbJ_predicted,0.07692307692307693,12,12,TCCGGCTCCGGGATTCACTA,0,5014312
yjbJ_predicted,0.07692307692307693,12,12,TCCGCCCTTTGTTGGAATAT,0,5023960
yjbJ_predicted,0.07692307692307693,12,12,TCCCTACGTATTTCATTACG,0,5026669
yjbJ_predicted,0.07692307692307693,12,12,TCATCCATCCATACCGTAGC,0,5009021
yjbJ_predicted,0.07692307692307693,12,12,TCATACGTCCGTGTAACAGC,0,5027019
yjbJ_predicted,0.07692307692307693,12,12,TCAACTCGTTAAGCGCTCGA,0,4998614
yjbJ_predicted,0.07692307692307693,12,12,TCAAAATAATGTTCTCGCCC,0,5009921
yjbJ_predicted,0.07692307692307693,12,12,TATTGAGGAGTTGTATGAAC,0,5024869
yjbJ_predicted,0.07692307692307693,12,12,TATTCCGGTTTCGGACTGGT,0,5018976
yjbJ_predicted,0.07692307692307693,12,12,TATGTACCGAACACCTCGAC,0,5009057
yjbJ_predicted,0.07692307692307693,12,12,TATATAGCTGACTACCATTG,0,5008071
yjbJ_predicted,0.07692307692307693,12,12,TAGGGCGCCAGAGGTATAGA,0,5012853
yjbJ_predicted,0.07692307692307693,12,12,TAGGAACGTGTGACAGAAAT,0,5028898
yjbJ_predicted,0.07692307692307693,12,12,TAGCCTTCTCTGTGGGTTCA,0,5024286
yjbJ_predicted,0.07692307692307693,12,12,TAGCCTTAATACCGTGCACT,0,5007310
yjbJ_predicted,0.07692307692307693,12,12,TAGATTCTTAATCCATCAGC,0,5006098
yjbJ_predicted,0.07692307692307693,12,12,TAGAACAAGGTGCGCTCGCA,0,5020002
yjbJ_predicted,0.07692307692307693,12,12,TACTGACACATAAGCGTATC,0,4996771
yjbJ_predicted,0.07692307692307693,12,12,TAACCGGACCCCCTGGGTAG,0,5023884
yjbJ_predicted,0.07692307692307693,12,12,TAAAGCCAATAGCCTCAATA,0,5017383
yjbJ_predicted,0.07692307692307693,12,12,GTTTGTCTGCATTGGATGCG,0,5005652
yjbJ_predicted,0.07692307692307693,12,12,GTTGATGTGGCGGCGCAAAA,0,5020308
yjbJ_predicted,0.07692307692307693,12,12,GTGTTCAAAACAGCAGTTAG,0,5017090
yjbJ_predicted,0.07692307692307693,12,12,GTGTGCTGGTCTCTTTGATG,0,5012134
yjbJ_predicted,0.07692307692307693,12,12,GTGGTGGCCGCGCTCAACAC,0,5029234
yjbJ_predicted,0.07692307692307693,12,12,GTGCACATTGAGCCCTGGCC,0,4995949
yjbJ_predicted,0.07692307692307693,12,12,GTGACAAGAACCCATATCTT,0,5022817
yjbJ_predicted,0.07692307692307693,12,12,GTCTGCAGCAGACGATCTTG,0,5014299
yjbJ_predicted,0.07692307692307693,12,12,GTCATATACAATCTCATTAA,0,5001557
yjbJ_predicted,0.07692307692307693,12,12,GTCACATATTTAGGCATCTA,0,4998925
yjbJ_predicted,0.07692307692307693,12,12,GTCAATACGGGGTGACTCGC,0,5017397
yjbJ_predicted,0.07692307692307693,12,12,GTCAATAAGTGGACTGCAAA,0,4998581
yjbJ_predicted,0.07692307692307693,12,12,GTATGTACCGCTTACCACGC,0,5010325
yjbJ_predicted,0.07692307692307693,12,12,GTAGTCCGTTATGTTCAAGT,0,5008957
yjbJ_predicted,0.07692307692307693,12,12,GTAGAATAAGTACAAACACT,0,5021692
yjbJ_predicted,0.07692307692307693,12,12,GGTTTTCGTCCTCGCTAGCT,0,5027781
yjbJ_predicted,0.07692307692307693,12,12,GGTTGCCACCTGTGCAGACT,0,5003422
yjbJ_predicted,0.07692307692307693,12,12,GGTTAGGCCTGGATGATAAG,0,5021076
yjbJ_predicted,0.07692307692307693,12,12,GGTGTGCGGGCATCTTTGCA,0,5020274
yjbJ_predicted,0.07692307692307693,12,12,GGTGACAAAGACCGGCCGCA,0,5016567
yjbJ_predicted,0.07692307692307693,12,12,GGTCTTAGCGGTTGGGAGTT,0,5022959
yjbJ_predicted,0.07692307692307693,12,12,GGTCCTGACCCCTAAAACCA,0,5017085
yjbJ_predicted,0.07692307692307693,12,12,GGTATGAAGTCGGGGGGAAA,0,5011832
yjbJ_predicted,0.07692307692307693,12,12,GGGTCAGACTTATTAATCGC,0,5002703
yjbJ_predicted,0.07692307692307693,12,12,GGGCTTCACTCTCCAGACGA,0,5025179
yjbJ_predicted,0.07692307692307693,12,12,GGGCCAAGATATTGATCTAC,0,5016399
yjbJ_predicted,0.07692307692307693,12,12,GGGATGGGCACGTTAGCGTG,0,4999662
yjbJ_predicted,0.07692307692307693,12,12,GGGATATTATTGCGGGGTTT,0,4997429
yjbJ_predicted,0.07692307692307693,12,12,GGGAGGTTAAAGTTCCAGCC,0,4997427
yjbJ_predicted,0.07692307692307693,12,12,GGGAACTTTGCTCAAGTACA,0,5028807
yjbJ_predicted,0.07692307692307693,12,12,GGCGCCAAGTCAGACAGGGT,0,5026318
yjbJ_predicted,0.07692307692307693,12,12,GGCGAGGTGCTGTCATCTGA,0,4999445
yjbJ_predicted,0.07692307692307693,12,12,GGCCCTACGTGTGAGATGCT,0,5024455
yjbJ_predicted,0.07692307692307693,12,12,GGCACAAATCTTCGCGGAGG,0,4996230
yjbJ_predicted,0.07692307692307693,12,12,GGCAATGGATCAGTTTCAAG,0,5004560
yjbJ_predicted,0.07692307692307693,12,12,GGAGGAGCGTATGAGAAACA,0,5027620
yjbJ_predicted,0.07692307692307693,12,12,GGAGATGATAGCCAGTGTCA,0,5000930
yjbJ_predicted,0.07692307692307693,12,12,GCTTCCCGGAGCACCTCCAA,0,5018829
yjbJ_predicted,0.07692307692307693,12,12,GCTGCTACTCCAATCTGACA,0,5008424
yjbJ_predicted,0.07692307692307693,12,12,GCTATGTAGCGGAAGTAGAG,0,5003174
yjbJ_predicted,0.07692307692307693,12,12,GCGTGGTACTTTTATGTCCA,0,5010397
yjbJ_predicted,0.07692307692307693,12,12,GCGCCGATGGCTCGATAGAT,0,5023046
yjbJ_predicted,0.07692307692307693,12,12,GCCATTATATGTGGGTTTCC,0,5026666
yjbJ_predicted,0.07692307692307693,12,12,GCATTGGGATGAGTGCATGA,0,5000259
yjbJ_predicted,0.07692307692307693,12,12,GCAGATTACTCTTATCGCTA,0,4999533
yjbJ_predicted,0.07692307692307693,12,12,GCACTAATCTTTCCAATCCG,0,4998132
yjbJ_predicted,0.07692307692307693,12,12,GATTTGGGTTTAGGGCAATA,0,5012265
yjbJ_predicted,0.07692307692307693,12,12,GATCGAGTTAGTCATCGGCA,0,4996065
yjbJ_predicted,0.07692307692307693,12,12,GATCAACAGGAAATAGTCAT,0,5012938
yjbJ_predicted,0.07692307692307693,12,12,GATATGCGGGCTGGTCAGCT,0,5011635
yjbJ_predicted,0.07692307692307693,12,12,GAGTTGGATCACCATCATCA,0,5016810
yjbJ_predicted,0.07692307692307693,12,12,GAGTTGCAGCAGCGGGTGGT,0,5027486
yjbJ_predicted,0.07692307692307693,12,12,GAGGCCTAACCCCGATGACC,0,4997006
yjbJ_predicted,0.07692307692307693,12,12,GAGGCAAATGTTTTTCATAG,0,5028825
yjbJ_predicted,0.07692307692307693,12,12,GACCATGCTGAGGCAAGTAT,0,5021186
yjbJ_predicted,0.07692307692307693,12,12,GACCACGGTTGAGGGCAGGT,0,5017467
yjbJ_predicted,0.07692307692307693,12,12,GACATACCTGGCAAGCTAGT,0,5027537
yjbJ_predicted,0.07692307692307693,12,12,GAAGGTTGGCGTATGGGTAT,0,5007114
yjbJ_predicted,0.07692307692307693,12,12,CTTTTTCTACATCGCCAACA,0,5010772
yjbJ_predicted,0.07692307692307693,12,12,CTTTAACGAGAGAGCCGCTT,0,5004373
yjbJ_predicted,0.07692307692307693,12,12,CTTGGTGGCGGGACCACAGG,0,5025227
yjbJ_predicted,0.07692307692307693,12,12,CTGTCATGAGCAGAGCACCA,0,5003066
yjbJ_predicted,0.07692307692307693,12,12,CTGGTTGTGTAAGTGGGCAG,0,5005930
yjbJ_predicted,0.07692307692307693,12,12,CTGGACTACCTACACACTCC,0,4999296
yjbJ_predicted,0.07692307692307693,12,12,CTGCCGGAAGAAAGCCCACG,0,5025700
yjbJ_predicted,0.07692307692307693,12,12,CTCGTGCCTCTGGTGAATCA,0,5004147
yjbJ_predicted,0.07692307692307693,12,12,CTCGGGGATTCGGGCTTTGA,0,5014726
yjbJ_predicted,0.07692307692307693,12,12,CTCCGGCGGTTAGCAAGCAG,0,5021845
yjbJ_predicted,0.07692307692307693,12,12,CTATTAGGTTTTAAACGTTG,0,4994932
yjbJ_predicted,0.07692307692307693,12,12,CTAACCTTGAAAGTTTCTAC,0,5014977
yjbJ_predicted,0.07692307692307693,12,12,CTAACCTCCACTAAGGTCGT,0,4998489
yjbJ_predicted,0.07692307692307693,12,12,CGTGCAGGTGTATTGGTAAG,0,4998359
yjbJ_predicted,0.07692307692307693,12,12,CGTGAGACCCCTCGATTATT,0,5018340
yjbJ_predicted,0.07692307692307693,12,12,CGTCACAGAGTCTTGGAAAG,0,4996259
yjbJ_predicted,0.07692307692307693,12,12,CGTATACTCCCACTAGGGTA,0,5014973
yjbJ_predicted,0.07692307692307693,12,12,CGTAAACGGTTTAGACTCAA,0,5027100
yjbJ_predicted,0.07692307692307693,12,12,CGGTCACGGGACACCTATCT,0,5015237
yjbJ_predicted,0.07692307692307693,12,12,CGGGTAAGTAGAGTTGTCGT,0,5029464
yjbJ_predicted,0.07692307692307693,12,12,CGGACAGGCAAGAAGACGAG,0,5021671
yjbJ_predicted,0.07692307692307693,12,12,CGCGGCAGGGTCGGTATAGT,0,5010003
yjbJ_predicted,0.07692307692307693,12,12,CGATTACACCACTGTGTTGG,0,5010346
yjbJ_predicted,0.07692307692307693,12,12,CGAGGAAGGCCACCGAAACC,0,5021092
yjbJ_predicted,0.07692307692307693,12,12,CGACTTCGTTAGGAACCTTA,0,5003605
yjbJ_predicted,0.07692307692307693,12,12,CGACGACCACTCTAATAAGG,0,5019584
yjbJ_predicted,0.07692307692307693,12,12,CCTACGTAAATTGGTAGCTC,0,5002705
yjbJ_predicted,0.07692307692307693,12,12,CCTACCCACGCAGGTGCCAT,0,5009114
yjbJ_predicted,0.07692307692307693,12,12,CCGGCTCCAGGTGTTAGCCG,0,5022052
yjbJ_predicted,0.07692307692307693,12,12,CCCTAACTGGTGGGTAAAGA,0,5023420
yjbJ_predicted,0.07692307692307693,12,12,CCCGCGTCAGCTACTGTAAA,0,5010859
yjbJ_predicted,0.07692307692307693,12,12,CCCCCCGAGATTGTGAGAGA,0,5012445
yjbJ_predicted,0.07692307692307693,12,12,CCATGGTACTATCCTGCGGG,0,5013197
yjbJ_predicted,0.07692307692307693,12,12,CCAGTCACATTCTCAAGGGA,0,5006650
yjbJ_predicted,0.07692307692307693,12,12,CATCCTCGATAAGGAGCATA,0,5017810
yjbJ_predicted,0.07692307692307693,12,12,CATCAGGAACTGCACGCAGT,0,5029741
yjbJ_predicted,0.07692307692307693,12,12,CATATGTTCGATTATTACTC,0,5004382
yjbJ_predicted,0.07692307692307693,12,12,CATACTACGGGCGTCCCGTT,0,5013686
yjbJ_predicted,0.07692307692307693,12,12,CATAAGTACCCCGGGTGTAG,0,5025065
yjbJ_predicted,0.07692307692307693,12,12,CAGTAATCTGTCGTACCCAC,0,5024554
yjbJ_predicted,0.07692307692307693,12,12,CAGGGTTACGCTTCAATTCC,0,4996971
yjbJ_predicted,0.07692307692307693,12,12,CAGGGACAGCGGCTGCCCGG,0,5026028
yjbJ_predicted,0.07692307692307693,12,12,CAGGCTAGCCGGGCATAGTT,0,5006546
yjbJ_predicted,0.07692307692307693,12,12,CAGCGTCGAAGAATTAGTGT,0,5029470
yjbJ_predicted,0.07692307692307693,12,12,CAGATCAGGCCAGGCGATTC,0,5009035
yjbJ_predicted,0.07692307692307693,12,12,CAGAGTCACCCCACTGTCGC,0,5029514
yjbJ_predicted,0.07692307692307693,12,12,CAGAATCAATAGTCCCTTAA,0,5029568
yjbJ_predicted,0.07692307692307693,12,12,CACGTAAGGCGCAGCAAATC,0,5014950
yjbJ_predicted,0.07692307692307693,12,12,CACGGGCGTGAGTATCAAAT,0,5017355
yjbJ_predicted,0.07692307692307693,12,12,CAATACTTAGCACAGCGTTT,0,5004299
yjbJ_predicted,0.07692307692307693,12,12,CAAGGTAGCGTGGACATCAA,0,5008041
yjbJ_predicted,0.07692307692307693,12,12,CAAGCCTTTACGCTCAGGTA,0,4998980
yjbJ_predicted,0.07692307692307693,12,12,CAACGCTCCATCCGACCAGG,0,5012064
yjbJ_predicted,0.07692307692307693,12,12,CAAATGTCGCCGGTACGTCA,0,5018996
yjbJ_predicted,0.07692307692307693,12,12,ATTTCCGTTTGGGTCGCGGG,0,5028442
yjbJ_predicted,0.07692307692307693,12,12,ATTGGTTCAAGTCTGGTATG,0,5002095
yjbJ_predicted,0.07692307692307693,12,12,ATTGGCCGGCCTGTCTGGTT,0,5002607
yjbJ_predicted,0.07692307692307693,12,12,ATTCATCGAGGTTTCCATTA,0,4997835
yjbJ_predicted,0.07692307692307693,12,12,ATGGAAACACGTCGTCCTTT,0,5028954
yjbJ_predicted,0.07692307692307693,12,12,ATGCTTTCTGGGGTTATACG,0,5008758
yjbJ_predicted,0.07692307692307693,12,12,ATGAGTTTGTAGCTCGCCAT,0,5007891
yjbJ_predicted,0.07692307692307693,12,12,ATCGCGGAGTCCGCGAAGTT,0,5004726
yjbJ_predicted,0.07692307692307693,12,12,ATCCGGCTATGCATCTGCGA,0,5008753
yjbJ_predicted,0.07692307692307693,12,12,ATAGAGGGAGACGTAGCCGG,0,5016435
yjbJ_predicted,0.07692307692307693,12,12,ATACTCCGAGCGTGTCTCGT,0,5014599
yjbJ_predicted,0.07692307692307693,12,12,ATAATTTCTGGCATTAGAGC,0,4998705
yjbJ_predicted,0.07692307692307693,12,12,ATAAAGAATGGGTTCCTCGG,0,4997701
yjbJ_predicted,0.07692307692307693,12,12,AGTTAAAATAAGAGTTATGG,0,5026732
yjbJ_predicted,0.07692307692307693,12,12,AGTCTTGAATGGAACAGACT,0,5003010
yjbJ_predicted,0.07692307692307693,12,12,AGTATTGCTCTCCGCTCGCG,0,5024847
yjbJ_predicted,0.07692307692307693,12,12,AGGTCGGGTTTCCCCTAGGG,0,4995669
yjbJ_predicted,0.07692307692307693,12,12,AGGTAATCGCAGTGAGCCAT,0,5012556
yjbJ_predicted,0.07692307692307693,12,12,AGGGCAACGTTTCTGGCGTC,0,5020209
yjbJ_predicted,0.07692307692307693,12,12,AGGCCATTGCTACGGGCAGC,0,5010187
yjbJ_predicted,0.07692307692307693,12,12,AGCGACTTTTTCGGGCTTTG,0,4999371
yjbJ_predicted,0.07692307692307693,12,12,AGCATACCGCCTAGACCATA,0,5010381
yjbJ_predicted,0.07692307692307693,12,12,AGATGTATCGGGTATGAACT,0,5002079
yjbJ_predicted,0.07692307692307693,12,12,AGAGCTTATTTATCTGATGA,0,5015124
yjbJ_predicted,0.07692307692307693,12,12,AGAGCGGCTACCACGCGGAT,0,5021878
yjbJ_predicted,0.07692307692307693,12,12,AGACGAGCTTAACCGCTGAA,0,5019219
yjbJ_predicted,0.07692307692307693,12,12,AGACCGGTAATATAATATGC,0,5022463
yjbJ_predicted,0.07692307692307693,12,12,AGACCCGAGATCCTTGTAAT,0,4998873
yjbJ_predicted,0.07692307692307693,12,12,AGACAGGGGCTGGCCAGGCA,0,5000278
yjbJ_predicted,0.07692307692307693,12,12,AGAAGCCAGATGGGGGACAT,0,5023566
yjbJ_predicted,0.07692307692307693,12,12,ACTTAGCAGGACTCGTGACA,0,5017398
yjbJ_predicted,0.07692307692307693,12,12,ACTTAAATTCCTGAAGGGAA,0,4997586
yjbJ_predicted,0.07692307692307693,12,12,ACTACGGGGTGACGATCAAT,0,5026896
yjbJ_predicted,0.07692307692307693,12,12,ACGTCCCTTACCGGCGGAGT,0,5002001
yjbJ_predicted,0.07692307692307693,12,12,ACGCGTATATGATGAAAACG,0,5006643
yjbJ_predicted,0.07692307692307693,12,12,ACCTTTATTGTTCGCATTGA,0,5019925
yjbJ_predicted,0.07692307692307693,12,12,ACCTTCTATTGGACCTGGAG,0,5005373
yjbJ_predicted,0.07692307692307693,12,12,ACCTGCTACTTGGAGTCAAG,0,5005202
yjbJ_predicted,0.07692307692307693,12,12,ACCCACACGGTCTTACAGCT,0,5030409
yjbJ_predicted,0.07692307692307693,12,12,ACATTAAGTGTACAGCTACT,0,4998206
yjbJ_predicted,0.07692307692307693,12,12,ACAGTGATTATGCTGCTTGT,0,4995720
yjbJ_predicted,0.07692307692307693,12,12,ACAGCAGTATCCACGGGAAA,0,5026590
yjbJ_predicted,0.07692307692307693,12,12,AATTGTCAAAAGCAGTAGTT,0,5001974
yjbJ_predicted,0.07692307692307693,12,12,AATTCACTGAATTCAGGTTA,0,5002513
yjbJ_predicted,0.07692307692307693,12,12,AATGTTATAAATCCAACGCC,0,5017382
yjbJ_predicted,0.07692307692307693,12,12,AATGGGAAAGTGCCTAAATT,0,4996020
yjbJ_predicted,0.07692307692307693,12,12,AATCCGAGTGCATCGAGGCT,0,4999448
yjbJ_predicted,0.07692307692307693,12,12,AACCGCCCGTCCCCTGGGGT,0,5003756
yjbJ_predicted,0.07692307692307693,12,12,AACAATCGTCCTCAATCGGC,0,5006972
yjbJ_predicted,0.07692307692307693,12,12,AAATGGAAATATGCTGTAGC,0,5011078
yjbJ_predicted,0.07692307692307693,12,12,AAAGGTCACCATTCTTCCCA,0,5000205
yjbJ_predicted,0.07692307692307693,12,12,AAAGCCAGGGTGAGAAGCCC,0,5018779
yjbJ_predicted,0.07692307692307693,12,12,AAACGTATTCGGGCAGGGGT,0,5027520
yjbJ_predicted,0.07692307692307693,12,12,AAACAGAGTAACCCGTGCTT,0,5001156
yjbJ_predicted,0.08333333333333333,11,11,TTTTTGTGGGTGAGGATTTG,0,5023449
yjbJ_predicted,0.08333333333333333,11,11,TTTTGGACCGGAAACTGTAA,0,5019184
yjbJ_predicted,0.08333333333333333,11,11,TTTGAAAACTAGATTGCACT,0,5018761
yjbJ_predicted,0.08333333333333333,11,11,TTGGTTAGTCTTCGGTAGGT,0,5011616
yjbJ_predicted,0.08333333333333333,11,11,TTGGATAAGGGCTCCTCTCA,0,5019616
yjbJ_predicted,0.08333333333333333,11,11,TTGGACCGGCGCTTCGTCAC,0,5002006
yjbJ_predicted,0.08333333333333333,11,11,TTGCACATTGCCTCCAGATA,0,4999830
yjbJ_predicted,0.08333333333333333,11,11,TTCTAGCAAGACGTCTGATG,0,5001936
yjbJ_predicted,0.08333333333333333,11,11,TTCCCGTATGTACTATGCTT,0,5023733
yjbJ_predicted,0.08333333333333333,11,11,TTCACGTGGACAAAGGTTCC,0,4996003
yjbJ_predicted,0.08333333333333333,11,11,TTATGGATCTACGTAAAATA,0,5000248
yjbJ_predicted,0.08333333333333333,11,11,TTATCTTGCTACGGGGCACA,0,5026733
yjbJ_predicted,0.08333333333333333,11,11,TTAGTCACGGTTCTCTGATC,0,5021041
yjbJ_predicted,0.08333333333333333,11,11,TTAGGGGTTGCTTGCCGAAA,0,5024457
yjbJ_predicted,0.08333333333333333,11,11,TTAGGGACGCCACTTCTCGA,0,5002461
yjbJ_predicted,0.08333333333333333,11,11,TTAATGACCTTGTGCCAGAA,0,5014492
yjbJ_predicted,0.08333333333333333,11,11,TTAAGGTTATGCCGGAAGCG,0,5006515
yjbJ_predicted,0.08333333333333333,11,11,TTAACTCTGGGCTTCACATA,0,5023852
yjbJ_predicted,0.08333333333333333,11,11,TGTTTTGGCTTTACTTCACC,0,5004187
yjbJ_predicted,0.08333333333333333,11,11,TGTTTCCTCAATGATCGGCC,0,5014401
yjbJ_predicted,0.08333333333333333,11,11,TGTTCATTTAAAGCAAAGAT,0,5021478
yjbJ_predicted,0.08333333333333333,11,11,TGTCGGCTAGCCAATAAGGA,0,4996605
yjbJ_predicted,0.08333333333333333,11,11,TGGTGTCACCGACATGGGTC,0,5023068
yjbJ_predicted,0.08333333333333333,11,11,TGGTAGATCGCAAATGAGGA,0,4997256
yjbJ_predicted,0.08333333333333333,11,11,TGGGCAGCAGCGTTAAGATC,0,4994993
yjbJ_predicted,0.08333333333333333,11,11,TGGCATCAGAAACCAACATA,0,4996633
yjbJ_predicted,0.08333333333333333,11,11,TGGAACCAGGTTCGTGAAAT,0,5012734
yjbJ_predicted,0.08333333333333333,11,11,TGCCGATTTAAATATTAAAT,0,4994710
yjbJ_predicted,0.08333333333333333,11,11,TGATGTCGGCGCACACACAC,0,5016239
yjbJ_predicted,0.08333333333333333,11,11,TGATCCGGGAGCCGATTCAA,0,5011301
yjbJ_predicted,0.08333333333333333,11,11,TGAGGGGGCCAGACACTGTT,0,5001764
yjbJ_predicted,0.08333333333333333,11,11,TGAGGCCTGGGGCCAAGTAT,0,5002694
yjbJ_predicted,0.08333333333333333,11,11,TGAATCGACTTGTTCGTGCT,0,5005647
yjbJ_predicted,0.08333333333333333,11,11,TCTTACGGCTTACTGCAATT,0,5009660
yjbJ_predicted,0.08333333333333333,11,11,TCTGCTCTATCCGTCGGAAT,0,5026806
yjbJ_predicted,0.08333333333333333,11,11,TCTGCAGTGATCAGTAGTGG,0,5003406
yjbJ_predicted,0.08333333333333333,11,11,TCGTATAAGGAAGTATTGGT,0,5002878
yjbJ_predicted,0.08333333333333333,11,11,TCGGAGTCTAATCAAACTCA,0,5005522
yjbJ_predicted,0.08333333333333333,11,11,TCCGAGCCCGCTACAAATCT,0,5016128
yjbJ_predicted,0.08333333333333333,11,11,TCCGAAACCTCACCCAGGAC,0,5016876
yjbJ_predicted,0.08333333333333333,11,11,TCCATGAGTTCTACACAGAA,0,5000945
yjbJ_predicted,0.08333333333333333,11,11,TCCAGGATGTGAACTTCCGG,0,5014466
yjbJ_predicted,0.08333333333333333,11,11,TCCAAAGGGCAGGACTATTT,0,5011027
yjbJ_predicted,0.08333333333333333,11,11,TCATAAAGTGCTCCATATTT,0,4996331
yjbJ_predicted,0.08333333333333333,11,11,TCAGTGGCCTATGACTTAGA,0,5006832
yjbJ_predicted,0.08333333333333333,11,11,TCACGGGCAATCCTAAGGCT,0,5004489
yjbJ_predicted,0.08333333333333333,11,11,TCAAGGCAACAAGTATGGGA,0,5013260
yjbJ_predicted,0.08333333333333333,11,11,TATGAGGAAAGAACGGGTAT,0,5027131
yjbJ_predicted,0.08333333333333333,11,11,TATCGGTCCACGCGTATAAT,0,5015452
yjbJ_predicted,0.08333333333333333,11,11,TATCCTGTGTTGATCGCTAC,0,5025432
yjbJ_predicted,0.08333333333333333,11,11,TAGGACTTATCATAAGCAGT,0,5024718
yjbJ_predicted,0.08333333333333333,11,11,TAGCGAAACCACGAAGATTT,0,5007316
yjbJ_predicted,0.08333333333333333,11,11,TAGATTACAGTGGTTTCCCC,0,5011138
yjbJ_predicted,0.08333333333333333,11,11,TAGATCTACATCTGATTCCC,0,5001520
yjbJ_predicted,0.08333333333333333,11,11,TAGATCATCGAATATCGTGT,0,5007431
yjbJ_predicted,0.08333333333333333,11,11,TAGAGTGTTTAACGGCTAAA,0,5004419
yjbJ_predicted,0.08333333333333333,11,11,TAGAGAGACCCTCATGGCGA,0,5003852
yjbJ_predicted,0.08333333333333333,11,11,TAGAACGCGGCGGTTGTAGG,0,5021175
yjbJ_predicted,0.08333333333333333,11,11,TACGCCTAGATCGAATGCAG,0,5001159
yjbJ_predicted,0.08333333333333333,11,11,TACCATGGATCTAAGTAAGT,0,5011958
yjbJ_predicted,0.08333333333333333,11,11,TACAAACAGCATGTTCTATT,0,5008261
yjbJ_predicted,0.08333333333333333,11,11,TAAGTGGCCACCTAACTCGA,0,5016370
yjbJ_predicted,0.08333333333333333,11,11,TAAGGTGTGGTACAGCGAAC,0,4998126
yjbJ_predicted,0.08333333333333333,11,11,TAAAGTTACAGGGAGTGAAG,0,4999701
yjbJ_predicted,0.08333333333333333,11,11,TAAAGCCTCCCTTGAAATTT,0,5024503
yjbJ_predicted,0.08333333333333333,11,11,GTTGTAGACCGGTAACTATT,0,5005867
yjbJ_predicted,0.08333333333333333,11,11,GTTCTCGGATTTCGGATGAA,0,5004346
yjbJ_predicted,0.08333333333333333,11,11,GTTAGGATGTGAAGCAACGT,0,5027595
yjbJ_predicted,0.08333333333333333,11,11,GTGTACGGGCAATGGCATCC,0,4995494
yjbJ_predicted,0.08333333333333333,11,11,GTGGAGATTGTCGGTGGTTA,0,5024806
yjbJ_predicted,0.08333333333333333,11,11,GTGCTAGAAAATCAGGGCTT,0,5009689
yjbJ_predicted,0.08333333333333333,11,11,GTGCCATGGTCATTTTGATC,0,5006766
yjbJ_predicted,0.08333333333333333,11,11,GTGCATGCTAATAACGCGCA,0,5026923
yjbJ_predicted,0.08333333333333333,11,11,GTGCAAGGGAATATCCCGTC,0,5027866
yjbJ_predicted,0.08333333333333333,11,11,GTGATACACTTCGACTTTTA,0,5000818
yjbJ_predicted,0.08333333333333333,11,11,GTCTCCATGCTTCGCATCTT,0,5021801
yjbJ_predicted,0.08333333333333333,11,11,GTCGATTTTGGGGCGGGCGC,0,5010829
yjbJ_predicted,0.08333333333333333,11,11,GTCGAACTGTGTAATAGTGA,0,5013014
yjbJ_predicted,0.08333333333333333,11,11,GTCCGACCGGCACACAGCCC,0,5022888
yjbJ_predicted,0.08333333333333333,11,11,GTCATGACCCGATTCCAACT,0,5021533
yjbJ_predicted,0.08333333333333333,11,11,GTATTGTGCTTGCTCCGTGT,0,5007097
yjbJ_predicted,0.08333333333333333,11,11,GTATCATGAGGGCCAGATTT,0,5023879
yjbJ_predicted,0.08333333333333333,11,11,GTAGGTTTCCCTGATCAAAC,0,5011603
yjbJ_predicted,0.08333333333333333,11,11,GTAGAATGCACTCCCTTAAG,0,4998810
yjbJ_predicted,0.08333333333333333,11,11,GTAAACTCGTAAGTCGCAAT,0,5013313
yjbJ_predicted,0.08333333333333333,11,11,GGTTACAGTAAAGTCTTACA,0,4997827
yjbJ_predicted,0.08333333333333333,11,11,GGTTAACGGGTTCAGTGTGG,0,4996478
yjbJ_predicted,0.08333333333333333,11,11,GGTGCTATGAGCCCCCCACT,0,4996050
yjbJ_predicted,0.08333333333333333,11,11,GGTCCGTGCCGTCTTTCGTT,0,5003037
yjbJ_predicted,0.08333333333333333,11,11,GGGTCACGTCACGGCTGGAC,0,5027210
yjbJ_predicted,0.08333333333333333,11,11,GGGTCAATCTATTTTGGAGG,0,5022694
yjbJ_predicted,0.08333333333333333,11,11,GGGCCGACACAGTTGAAGGG,0,5015899
yjbJ_predicted,0.08333333333333333,11,11,GGGAGCTAACAAGTGGCATG,0,5012246
yjbJ_predicted,0.08333333333333333,11,11,GGCTTCTAGTAGAAAGCAAA,0,5028672
yjbJ_predicted,0.08333333333333333,11,11,GGCTCCTCTCTTACGCCTAT,0,5025283
yjbJ_predicted,0.08333333333333333,11,11,GGCCACTATTACATCTTCGA,0,5026954
yjbJ_predicted,0.08333333333333333,11,11,GGCATAGCATTAGCACCAGC,0,4997048
yjbJ_predicted,0.08333333333333333,11,11,GGCACCGTTCGTGACAACAT,0,4999252
yjbJ_predicted,0.08333333333333333,11,11,GGCAACCACGGATACACTGT,0,5016742
yjbJ_predicted,0.08333333333333333,11,11,GGAGTCCTCTGCGGCTTGAC,0,5024368
yjbJ_predicted,0.08333333333333333,11,11,GGAGGTACATCTGTACCAGG,0,4995425
yjbJ_predicted,0.08333333333333333,11,11,GGACTGTATGCGGCCCGCAT,0,5007970
yjbJ_predicted,0.08333333333333333,11,11,GGAATTATCCGCATTGTCCT,0,5015766
yjbJ_predicted,0.08333333333333333,11,11,GGAAAAGCTGTGACAACATT,0,5005374
yjbJ_predicted,0.08333333333333333,11,11,GCTGTATTATTTTCGGGCGA,0,5008839
yjbJ_predicted,0.08333333333333333,11,11,GCTCTTTAAAGCGGCTATCC,0,5009793
yjbJ_predicted,0.08333333333333333,11,11,GCGTGGAACCCGGCGATAGG,0,5003573
yjbJ_predicted,0.08333333333333333,11,11,GCCTTTGTAAAGTCAAACTT,0,5005612
yjbJ_predicted,0.08333333333333333,11,11,GCCTTGTCGCTAATATCATC,0,5015916
yjbJ_predicted,0.08333333333333333,11,11,GCCTGGCATTGCGTTGGGGA,0,4997765
yjbJ_predicted,0.08333333333333333,11,11,GCCCGGAAGGGGTTTTACTT,0,5008888
yjbJ_predicted,0.08333333333333333,11,11,GCCATGGCTATTTACTTGGG,0,5018802
yjbJ_predicted,0.08333333333333333,11,11,GCATAAGGTCTCCGAGTTGA,0,5005493
yjbJ_predicted,0.08333333333333333,11,11,GCACAGTTAAAGGCTAGGAT,0,4996089
yjbJ_predicted,0.08333333333333333,11,11,GCAACCATGCGGATATTCCT,0,5017933
yjbJ_predicted,0.08333333333333333,11,11,GATTGGCTGTCTTCTCACAG,0,5002465
yjbJ_predicted,0.08333333333333333,11,11,GATTGGACCGATACATACAG,0,5010163
yjbJ_predicted,0.08333333333333333,11,11,GATAGTTGGATCGTTTTAAT,0,5015794
yjbJ_predicted,0.08333333333333333,11,11,GATACAAATTGCGGCTGCAT,0,5020119
yjbJ_predicted,0.08333333333333333,11,11,GAGGTATCAAATTAGTGCGG,0,5003636
yjbJ_predicted,0.08333333333333333,11,11,GAGAGCTACGTCGGACCGAT,0,5007372
yjbJ_predicted,0.08333333333333333,11,11,GACGCACTGGCGTAAGAGGC,0,5026050
yjbJ_predicted,0.08333333333333333,11,11,GACCGCTCGAAATAATCAGA,0,5006769
yjbJ_predicted,0.08333333333333333,11,11,GACATAAAAATATTAATTAG,0,5027970
yjbJ_predicted,0.08333333333333333,11,11,GACAGCCATAGCTGAACACA,0,5007035
yjbJ_predicted,0.08333333333333333,11,11,GAATGAACCCCTATGGCTAA,0,5012930
yjbJ_predicted,0.08333333333333333,11,11,CTTTATTAACACAACCCGAC,0,5026783
yjbJ_predicted,0.08333333333333333,11,11,CTTAGCTCTTTTTCCCTTAA,0,5001105
yjbJ_predicted,0.08333333333333333,11,11,CTGTGTGTGCAACGAGACCT,0,4996868
yjbJ_predicted,0.08333333333333333,11,11,CTGGGATACGCGCTGTCTAC,0,5009866
yjbJ_predicted,0.08333333333333333,11,11,CTGGAGCTATTATCGATCTG,0,5007273
yjbJ_predicted,0.08333333333333333,11,11,CTGACACTAAGACAAGCTGA,0,5019750
yjbJ_predicted,0.08333333333333333,11,11,CTGAAGCGGGCGCCGCGCGG,0,5007146
yjbJ_predicted,0.08333333333333333,11,11,CTCTTGATTTTGATCCTGAT,0,5022363
yjbJ_predicted,0.08333333333333333,11,11,CTCGGTCCTAGCGGATAGCA,0,4998466
yjbJ_predicted,0.08333333333333333,11,11,CTCGCAGCTCATATAACGAT,0,5026161
yjbJ_predicted,0.08333333333333333,11,11,CTCGACCGAAAGTGAAAGCA,0,5004648
yjbJ_predicted,0.08333333333333333,11,11,CTCCACTTGTGAGGGGGACC,0,5007570
yjbJ_predicted,0.08333333333333333,11,11,CTCCACGCTATTTTCATCTT,0,5008028
yjbJ_predicted,0.08333333333333333,11,11,CTCACTATGCCGGCTAATGC,0,5000869
yjbJ_predicted,0.08333333333333333,11,11,CTCAACAAGTTTACGACTCT,0,5005273
yjbJ_predicted,0.08333333333333333,11,11,CTATACGGAGGAGGGGTGCA,0,5013874
yjbJ_predicted,0.08333333333333333,11,11,CGTGTCCCCGTTTTGGAAGA,0,5028933
yjbJ_predicted,0.08333333333333333,11,11,CGTGGGGAGTAACGTGCTAC,0,5009906
yjbJ_predicted,0.08333333333333333,11,11,CGTGAGATATGGAGAACTTA,0,5001372
yjbJ_predicted,0.08333333333333333,11,11,CGTAATCTAACTATATAGCC,0,5009428
yjbJ_predicted,0.08333333333333333,11,11,CGTAACACACTATCCGCTGT,0,5023280
yjbJ_predicted,0.08333333333333333,11,11,CGGTCTCAGTCGCTTGAAGG,0,5003116
yjbJ_predicted,0.08333333333333333,11,11,CGGGAAAGGTTGAGCTGCCT,0,5006859
yjbJ_predicted,0.08333333333333333,11,11,CGCTTACTCAAGTATGGGAA,0,5019899
yjbJ_predicted,0.08333333333333333,11,11,CGCGATGCATAAGAATGGGT,0,5007966
yjbJ_predicted,0.08333333333333333,11,11,CGCGAAGAGGACCTTCGGGA,0,5031182
yjbJ_predicted,0.08333333333333333,11,11,CGCCTCGGCCCCAGCCCGAC,0,5024163
yjbJ_predicted,0.08333333333333333,11,11,CGCAATAATTTCTACGGAAC,0,5000324
yjbJ_predicted,0.08333333333333333,11,11,CGATGAACCAACAATGTCAG,0,5011705
yjbJ_predicted,0.08333333333333333,11,11,CGAGGGTCGAGCTAATACCT,0,5011356
yjbJ_predicted,0.08333333333333333,11,11,CGACTTCCCAGGGTACTTTC,0,5016935
yjbJ_predicted,0.08333333333333333,11,11,CGAAAGTCCTAATGGTGAAT,0,5020604
yjbJ_predicted,0.08333333333333333,11,11,CCTTTTGGGCAGGCATCAAA,0,5023346
yjbJ_predicted,0.08333333333333333,11,11,CCTGTGACGGGAAAGATTAC,0,5008222
yjbJ_predicted,0.08333333333333333,11,11,CCTAAGTCTTAACCTTATAC,0,4994872
yjbJ_predicted,0.08333333333333333,11,11,CCGTTCGCTGCATTTGCTGA,0,5001655
yjbJ_predicted,0.08333333333333333,11,11,CCGTTAGGAGGTCGCCGCGG,0,5008640
yjbJ_predicted,0.08333333333333333,11,11,CCGCCTCACGCGATGGCGCG,0,5016633
yjbJ_predicted,0.08333333333333333,11,11,CCCTTAGGGAACAAACGCAG,0,5011119
yjbJ_predicted,0.08333333333333333,11,11,CCCGTGATATTAGTCTTTCT,0,5017015
yjbJ_predicted,0.08333333333333333,11,11,CCCCTCCCTAATAGGGTCTC,0,5021445
yjbJ_predicted,0.08333333333333333,11,11,CCCCCATAAGACATTAGTTA,0,5010570
yjbJ_predicted,0.08333333333333333,11,11,CCCAAATTTGGCCACTCGCG,0,5012882
yjbJ_predicted,0.08333333333333333,11,11,CCATTGCACGTTGGGCTACT,0,5006933
yjbJ_predicted,0.08333333333333333,11,11,CCATTATGAATGCATAATGG,0,5001278
yjbJ_predicted,0.08333333333333333,11,11,CCATTACATTTAGTAGGCCG,0,5005732
yjbJ_predicted,0.08333333333333333,11,11,CCACGGCCGGCTACTACCAA,0,5028530
yjbJ_predicted,0.08333333333333333,11,11,CCACCGAGGGCCATGATAAG,0,5019383
yjbJ_predicted,0.08333333333333333,11,11,CCACCATGGAGTGATTGGAC,0,5012898
yjbJ_predicted,0.08333333333333333,11,11,CCAAGCTCCGTTGTGATTAT,0,5001832
yjbJ_predicted,0.08333333333333333,11,11,CATTTGGAGAGGTTGCAAGT,0,5023991
yjbJ_predicted,0.08333333333333333,11,11,CATGTGGTCAAGCTCTTAAA,0,5008934
yjbJ_predicted,0.08333333333333333,11,11,CATGGATATTTTGTCACGCA,0,5029213
yjbJ_predicted,0.08333333333333333,11,11,CATCGCCACGGGACTGGATT,0,5016346
yjbJ_predicted,0.08333333333333333,11,11,CATACCGGGACGCGTGTTTG,0,5010774
yjbJ_predicted,0.08333333333333333,11,11,CATAACTCCTCCGGTCATAT,0,5008638
yjbJ_predicted,0.08333333333333333,11,11,CAGGTGATGAGACTGTAACA,0,5004375
yjbJ_predicted,0.08333333333333333,11,11,CAGGGTACAGTCGCCCTCCA,0,5012273
yjbJ_predicted,0.08333333333333333,11,11,CACGTCTTACATGTGCGAGT,0,5018720
yjbJ_predicted,0.08333333333333333,11,11,CACGGCAACCATCTTGTCCC,0,4996314
yjbJ_predicted,0.08333333333333333,11,11,CAATTAGACGCCTACTTGTG,0,5014922
yjbJ_predicted,0.08333333333333333,11,11,CAATGAGAGGGCGTGTATCT,0,5001523
yjbJ_predicted,0.08333333333333333,11,11,CAATCTACAGGTGTAGATAT,0,4999335
yjbJ_predicted,0.08333333333333333,11,11,CAAGGGACCAATGAGACTCT,0,5017102
yjbJ_predicted,0.08333333333333333,11,11,ATTTGGCGGAAGATCCAGTT,0,5024366
yjbJ_predicted,0.08333333333333333,11,11,ATTTCCTAGTGACCATCTCA,0,5008288
yjbJ_predicted,0.08333333333333333,11,11,ATTTCCATGCTAATGGTCGC,0,5029169
yjbJ_predicted,0.08333333333333333,11,11,ATTGTAGAACTAATGGAGCC,0,5014633
yjbJ_predicted,0.08333333333333333,11,11,ATTGACGGGAGAAGGGGCTT,0,5030849
yjbJ_predicted,0.08333333333333333,11,11,ATTCTCGACTGCGATGCTTG,0,4997389
yjbJ_predicted,0.08333333333333333,11,11,ATTCCTAAATGTGCTCTTCC,0,4999004
yjbJ_predicted,0.08333333333333333,11,11,ATGTTTATGGGTTGAGCATA,0,5004465
yjbJ_predicted,0.08333333333333333,11,11,ATGTGTTCCTCGCCTAAACG,0,5018014
yjbJ_predicted,0.08333333333333333,11,11,ATGGTTTCCGTCACACTTGC,0,5001903
yjbJ_predicted,0.08333333333333333,11,11,ATGGAGGGATCGACCATTAA,0,4996368
yjbJ_predicted,0.08333333333333333,11,11,ATGAGGATAATGGGATCATA,0,5026999
yjbJ_predicted,0.08333333333333333,11,11,ATGACAAGCCCATTTATATG,0,5012841
yjbJ_predicted,0.08333333333333333,11,11,ATCTGGGGTTTTTTGGTCAC,0,5001631
yjbJ_predicted,0.08333333333333333,11,11,ATCGAACGTGGTAATGCCGC,0,5002862
yjbJ_predicted,0.08333333333333333,11,11,ATCCGCGTCTTCGCACTTAT,0,5020277
yjbJ_predicted,0.08333333333333333,11,11,ATACGTAGCTTGATAGTGCT,0,4995989
yjbJ_predicted,0.08333333333333333,11,11,ATACCAGTGCTTAAAGGAAT,0,5011463
yjbJ_predicted,0.08333333333333333,11,11,ATAAAGGGCGGCGCCGACTC,0,5003114
yjbJ_predicted,0.08333333333333333,11,11,ATAAACGACCCGAACACTGG,0,5012639
yjbJ_predicted,0.08333333333333333,11,11,AGTTGAATGCCAGGACCGAA,0,5025735
yjbJ_predicted,0.08333333333333333,11,11,AGTGTTGCGTGTTAAGGATA,0,5019262
yjbJ_predicted,0.08333333333333333,11,11,AGTGGGTAAGGCCGCTTCCC,0,4995023
yjbJ_predicted,0.08333333333333333,11,11,AGGTTAACTAAGACGAGTAT,0,5008538
yjbJ_predicted,0.08333333333333333,11,11,AGGGGGACATCGGGGTGCCG,0,4996373
yjbJ_predicted,0.08333333333333333,11,11,AGGCGCAAAGCGGCAGAAGG,0,5024279
yjbJ_predicted,0.08333333333333333,11,11,AGGATTAACAGAAGAGAGAG,0,5028821
yjbJ_predicted,0.08333333333333333,11,11,AGGATGGAAAAGTGTTGGTC,0,5008887
yjbJ_predicted,0.08333333333333333,11,11,AGGACGTTATTCGAATGGAA,0,5005802
yjbJ_predicted,0.08333333333333333,11,11,AGCAATACTCTTTGGTCATG,0,5011996
yjbJ_predicted,0.08333333333333333,11,11,AGATTGGCATGGAATAGCCG,0,5001004
yjbJ_predicted,0.08333333333333333,11,11,AGATCTATAGCAATAAGAGC,0,5009181
yjbJ_predicted,0.08333333333333333,11,11,AGATACGCGTGAGGGGTTTC,0,4998011
yjbJ_predicted,0.08333333333333333,11,11,AGAGTCCAGGTTTAAACGGC,0,5002347
yjbJ_predicted,0.08333333333333333,11,11,AGAGGATATAAGATCTTTGA,0,5030439
yjbJ_predicted,0.08333333333333333,11,11,AGAGAGGGAAGTGTTCAGAT,0,5011843
yjbJ_predicted,0.08333333333333333,11,11,AGACTGTAAGCGTAAGCACA,0,5019348
yjbJ_predicted,0.08333333333333333,11,11,AGACCTTGACGCCTCTAATT,0,5007218
yjbJ_predicted,0.08333333333333333,11,11,AGACATTAAGAGCATTTGAA,0,5024003
yjbJ_predicted,0.08333333333333333,11,11,AGAACGATATAAGTCAATGG,0,5020122
yjbJ_predicted,0.08333333333333333,11,11,AGAAATCATGAGTATGTTGT,0,5020251
yjbJ_predicted,0.08333333333333333,11,11,ACTTATGGCGTGGCGGGAGT,0,4997302
yjbJ_predicted,0.08333333333333333,11,11,ACGTTTCATTTTGCGAAATC,0,5020051
yjbJ_predicted,0.08333333333333333,11,11,ACGGCAAAATTTTAGGATTC,0,4998829
yjbJ_predicted,0.08333333333333333,11,11,ACGACCGCAGGGTGAAGGCC,0,5009371
yjbJ_predicted,0.08333333333333333,11,11,ACCTAAATCTTCGATTAGAT,0,5009312
yjbJ_predicted,0.08333333333333333,11,11,ACCGTTTGCATAGTACATGC,0,5012679
yjbJ_predicted,0.08333333333333333,11,11,ACCGCTGGGAAAGATCTGCC,0,5015131
yjbJ_predicted,0.08333333333333333,11,11,ACCGCGGCGTGACGTCGGGT,0,5026177
yjbJ_predicted,0.08333333333333333,11,11,ACATGTGAACACCACGGGTC,0,5008356
yjbJ_predicted,0.08333333333333333,11,11,ACATCGTGAGACGCTGCACG,0,5020717
yjbJ_predicted,0.08333333333333333,11,11,ACATACGGGTTCGTGGATTT,0,5028833
yjbJ_predicted,0.08333333333333333,11,11,ACACAACAGAGAATTCATAT,0,5014785
yjbJ_predicted,0.08333333333333333,11,11,ACAATAGAGCCGAACCACCT,0,5029980
yjbJ_predicted,0.08333333333333333,11,11,AATTGACTAGGCAAGGTTAG,0,5020481
yjbJ_predicted,0.08333333333333333,11,11,AATTCACGCACATGAGTGAA,0,5008200
yjbJ_predicted,0.08333333333333333,11,11,AATGAAGCTGCGCAGGTTTG,0,5005053
yjbJ_predicted,0.08333333333333333,11,11,AATCGGTAGATTCGTTACCC,0,4994733
yjbJ_predicted,0.08333333333333333,11,11,AATCGCACCGCACGCGGATT,0,5001907
yjbJ_predicted,0.08333333333333333,11,11,AATCAGTCGTTCGGGGATCG,0,5002803
yjbJ_predicted,0.08333333333333333,11,11,AATACGATGCTCATAGGCTA,0,5017798
yjbJ_predicted,0.08333333333333333,11,11,AAGTGATAACTAAGGGGCGC,0,5030870
yjbJ_predicted,0.08333333333333333,11,11,AAGCAGAGTGACAACGCGGA,0,5015822
yjbJ_predicted,0.08333333333333333,11,11,AACTCCCAGAGAATTCTCGA,0,5004221
yjbJ_predicted,0.08333333333333333,11,11,AACGAGCGCTGCACAGCCTA,0,5006919
yjbJ_predicted,0.08333333333333333,11,11,AACCCCGATGTTAGCCCTTC,0,5015445
yjbJ_predicted,0.08333333333333333,11,11,AACAAGATCGGGTTAGGTGC,0,5003987
yjbJ_predicted,0.08333333333333333,11,11,AAACACGCTTGTAGCTCAAG,0,5017675
yjbJ_predicted,0.09090909090909091,10,10,TTTTCAAGCTTGATTCGGGA,0,5008123
yjbJ_predicted,0.09090909090909091,10,10,TTTGGGCCGTCGGCTTCGCC,0,5025286
yjbJ_predicted,0.09090909090909091,10,10,TTTGCCAATTGGGACACAGG,0,5009100
yjbJ_predicted,0.09090909090909091,10,10,TTTCTCTGCGTTGGTCAGGG,0,5011676
yjbJ_predicted,0.09090909090909091,10,10,TTTCCGGTTTGTCAGTGTTT,0,5012518
yjbJ_predicted,0.09090909090909091,10,10,TTGGGACTCAGCGTACAAAT,0,5008879
yjbJ_predicted,0.09090909090909091,10,10,TTGGCTTCCGTACTTCCTCA,0,5015324
yjbJ_predicted,0.09090909090909091,10,10,TTGGAGTAGGTAAAGAGGGA,0,5016017
yjbJ_predicted,0.09090909090909091,10,10,TTGGAAAGCAAACATAAGTA,0,5003934
yjbJ_predicted,0.09090909090909091,10,10,TTGCAACTCGATTAGGCTGG,0,5027386
yjbJ_predicted,0.09090909090909091,10,10,TTGAGTAGAGGCACAAAATA,0,5030503
yjbJ_predicted,0.09090909090909091,10,10,TTGAAAGCGAGTATTTAAAA,0,5004801
yjbJ_predicted,0.09090909090909091,10,10,TTCTCGAACATTCCAGGATC,0,5019276
yjbJ_predicted,0.09090909090909091,10,10,TTCGGCGGTTTACTGAAAGT,0,5006012
yjbJ_predicted,0.09090909090909091,10,10,TTCAACTGCTCTATGCGACC,0,4999331
yjbJ_predicted,0.09090909090909091,10,10,TTATTGGGGTCCCCTCTTTG,0,5013583
yjbJ_predicted,0.09090909090909091,10,10,TTAGACTGGAAACAACGCTA,0,5012100
yjbJ_predicted,0.09090909090909091,10,10,TTAGAAATCGTGGGTGGGCG,0,5003430
yjbJ_predicted,0.09090909090909091,10,10,TTACCGCACACACGAGGTAC,0,4996757
yjbJ_predicted,0.09090909090909091,10,10,TTAATGGGGTCTGCGCGTGG,0,5000315
yjbJ_predicted,0.09090909090909091,10,10,TGTTCACGACAGCTGGGGGA,0,4999327
yjbJ_predicted,0.09090909090909091,10,10,TGTTAACCTGCTATCTTTAT,0,5024796
yjbJ_predicted,0.09090909090909091,10,10,TGTGACGTCAAGCACTCTAC,0,5005907
yjbJ_predicted,0.09090909090909091,10,10,TGTCTCGCAGAGTTGTGGGC,0,5000737
yjbJ_predicted,0.09090909090909091,10,10,TGTAGCTGCCTGTATAAACC,0,5003608
yjbJ_predicted,0.09090909090909091,10,10,TGTAAGTGGAAGGCGGCTTG,0,4998204
yjbJ_predicted,0.09090909090909091,10,10,TGGCGCAAGATCGAGTTATA,0,5010835
yjbJ_predicted,0.09090909090909091,10,10,TGGCAGAGTCTCGTAATCGA,0,5004807
yjbJ_predicted,0.09090909090909091,10,10,TGGATATAGCACTATGCGGT,0,5020063
yjbJ_predicted,0.09090909090909091,10,10,TGCTACGATATTCTCCCGAC,0,5007796
yjbJ_predicted,0.09090909090909091,10,10,TGCTAACGCACCGCTTACGA,0,5022103
yjbJ_predicted,0.09090909090909091,10,10,TGCCTATGACAGACGTCTTA,0,4995608
yjbJ_predicted,0.09090909090909091,10,10,TGCCGTAGCAGGCTTGCCTT,0,5004466
yjbJ_predicted,0.09090909090909091,10,10,TGCATACTAACGCGGCATGT,0,5028734
yjbJ_predicted,0.09090909090909091,10,10,TGCAAGGGCATCTTGTCCGG,0,5024178
yjbJ_predicted,0.09090909090909091,10,10,TGATGAGGCGTCATTACAAA,0,5001657
yjbJ_predicted,0.09090909090909091,10,10,TGAGTGAGAAGGTTGGACTA,0,5023421
yjbJ_predicted,0.09090909090909091,10,10,TGAGGTAACCTGGCTATGCA,0,4995078
yjbJ_predicted,0.09090909090909091,10,10,TGACTTTCACGTAACGGGTT,0,5003309
yjbJ_predicted,0.09090909090909091,10,10,TGACCTTACACATAGCCTAA,0,5028310
yjbJ_predicted,0.09090909090909091,10,10,TGACATGTGCCACCGGACTT,0,5015429
yjbJ_predicted,0.09090909090909091,10,10,TCTTCCATGTTGTTGCCTTA,0,5001518
yjbJ_predicted,0.09090909090909091,10,10,TCTTCATGAGAGGACGCGTA,0,5016875
yjbJ_predicted,0.09090909090909091,10,10,TCTGTATCCGGATAAGTCGT,0,4999987
yjbJ_predicted,0.09090909090909091,10,10,TCTGACAACTGCACCAGGTC,0,5002955
yjbJ_predicted,0.09090909090909091,10,10,TCTCCTCAACTGCTACCTTT,0,5004133
yjbJ_predicted,0.09090909090909091,10,10,TCTCCACCACGTAAATACGT,0,5027916
yjbJ_predicted,0.09090909090909091,10,10,TCGGTAGATTCGCTTGCCAA,0,5027965
yjbJ_predicted,0.09090909090909091,10,10,TCGGGGTTTGCCGTCTTGGT,0,5014612
yjbJ_predicted,0.09090909090909091,10,10,TCGGGCACAGTCTAAGACGC,0,5008082
yjbJ_predicted,0.09090909090909091,10,10,TCGCGTGGTCCTTAAACATT,0,5003421
yjbJ_predicted,0.09090909090909091,10,10,TCGCACCACTGTCCTAATAT,0,5026268
yjbJ_predicted,0.09090909090909091,10,10,TCCCTGGAAGTATCAGAGTT,0,5016699
yjbJ_predicted,0.09090909090909091,10,10,TCCACTGCAAGAGAACTCCA,0,5012074
yjbJ_predicted,0.09090909090909091,10,10,TCATACATGTAGCATAACCC,0,5023188
yjbJ_predicted,0.09090909090909091,10,10,TCATAACGTATTTTGGAGAC,0,5026893
yjbJ_predicted,0.09090909090909091,10,10,TCACTTGTGCATGCTGGAAT,0,5021912
yjbJ_predicted,0.09090909090909091,10,10,TCACGATTTCCCATAAGGCA,0,5014056
yjbJ_predicted,0.09090909090909091,10,10,TCACCGTGGGATATGTAGAT,0,5009817
yjbJ_predicted,0.09090909090909091,10,10,TCAAGTCTGGCGCGAATCCG,0,5003296
yjbJ_predicted,0.09090909090909091,10,10,TCAACATGCACCTTCAATCA,0,5002664
yjbJ_predicted,0.09090909090909091,10,10,TATTGGGGGGTACCGGCTGC,0,5030123
yjbJ_predicted,0.09090909090909091,10,10,TATTCCGCACTCTAGTGTCA,0,5025772
yjbJ_predicted,0.09090909090909091,10,10,TATAGATGGCTTGTCCTCGG,0,5013820
yjbJ_predicted,0.09090909090909091,10,10,TATAACATCAGCGACCGCCA,0,5020542
yjbJ_predicted,0.09090909090909091,10,10,TAGACTGTCGGGTGTGGTTA,0,5005796
yjbJ_predicted,0.09090909090909091,10,10,TAGACGCACCGCACCGGCCT,0,5001634
yjbJ_predicted,0.09090909090909091,10,10,TACGCGAGTATTATCGATAG,0,5020832
yjbJ_predicted,0.09090909090909091,10,10,TACGAGGGCGCGGCACCTCA,0,4996384
yjbJ_predicted,0.09090909090909091,10,10,TAATGCCAGCACCGCGTGGA,0,5010369
yjbJ_predicted,0.09090909090909091,10,10,TAACGCATTTGAAACTCTCT,0,5027850
yjbJ_predicted,0.09090909090909091,10,10,TAAATTTTGGCGGACGCTGG,0,5006645
yjbJ_predicted,0.09090909090909091,10,10,TAAACTTTTAGATGTTACCG,0,5000699
yjbJ_predicted,0.09090909090909091,10,10,GTTTTTTTAGGCGTTGTGGT,0,5006675
yjbJ_predicted,0.09090909090909091,10,10,GTTTGAACCTCCCGGCCCCT,0,5004343
yjbJ_predicted,0.09090909090909091,10,10,GTTTCATCATATTTTTCAAT,0,5020646
yjbJ_predicted,0.09090909090909091,10,10,GTTACCGAATGTACCGACCC,0,5020873
yjbJ_predicted,0.09090909090909091,10,10,GTTAAACTTAGAGGTGTTGA,0,5003067
yjbJ_predicted,0.09090909090909091,10,10,GTGGCTTTCACCAAGATAAA,0,5018689
yjbJ_predicted,0.09090909090909091,10,10,GTGCAAGCGCATCGCGGGTG,0,5020198
yjbJ_predicted,0.09090909090909091,10,10,GTGATCTCCAGTGTCATAGA,0,5026535
yjbJ_predicted,0.09090909090909091,10,10,GTCCAGGGCACCCCTTATAT,0,5020282
yjbJ_predicted,0.09090909090909091,10,10,GTAGGAACAGAATAGTCGTA,0,5002804
yjbJ_predicted,0.09090909090909091,10,10,GTAGAGTCATTTTACAGGGG,0,4997891
yjbJ_predicted,0.09090909090909091,10,10,GTAGAGGACTCCTATTGTTC,0,4995796
yjbJ_predicted,0.09090909090909091,10,10,GTACAGGTCTCCTGTGAACG,0,5011964
yjbJ_predicted,0.09090909090909091,10,10,GTACACAACGAACACACGCT,0,4999962
yjbJ_predicted,0.09090909090909091,10,10,GTAATGAATGTGCGGAGTGC,0,5004505
yjbJ_predicted,0.09090909090909091,10,10,GTAAGGGATCTAACTGTGCC,0,4996957
yjbJ_predicted,0.09090909090909091,10,10,GTAAGAAAGAGCACCAGATG,0,4998086
yjbJ_predicted,0.09090909090909091,10,10,GGTTCCTTATTCAGCGAACC,0,4997096
yjbJ_predicted,0.09090909090909091,10,10,GGTTCAGCGTCGAGCTAGTT,0,5025590
yjbJ_predicted,0.09090909090909091,10,10,GGTGTTCAAATATCATAGGA,0,5023252
yjbJ_predicted,0.09090909090909091,10,10,GGTGCTCCTGTTTGGTGACA,0,5004943
yjbJ_predicted,0.09090909090909091,10,10,GGTCTACATGAGTCCCGAGA,0,5004677
yjbJ_predicted,0.09090909090909091,10,10,GGTCCCGACACCCACTGGCG,0,5000234
yjbJ_predicted,0.09090909090909091,10,10,GGTATGGGCGGCTACTTATT,0,5001480
yjbJ_predicted,0.09090909090909091,10,10,GGTATCTGACGGTGGACCAT,0,5007447
yjbJ_predicted,0.09090909090909091,10,10,GGTAGCTCTTCAAGGGTTGT,0,5015583
yjbJ_predicted,0.09090909090909091,10,10,GGGTTTCTACGGTACGACGG,0,5022500
yjbJ_predicted,0.09090909090909091,10,10,GGGGGGTGTAAGGGAAGAAC,0,5006292
yjbJ_predicted,0.09090909090909091,10,10,GGGGACTTGGAGCGAAACGA,0,5022111
yjbJ_predicted,0.09090909090909091,10,10,GGGCACATGCAATCGTCCTG,0,5009043
yjbJ_predicted,0.09090909090909091,10,10,GGGATTTTGTTCTATATCGA,0,5016469
yjbJ_predicted,0.09090909090909091,10,10,GGGAATACGTAGAAGGTAGC,0,5020228
yjbJ_predicted,0.09090909090909091,10,10,GGCTGACCCTCTTATATCAA,0,5011940
yjbJ_predicted,0.09090909090909091,10,10,GGCGCCAGGAAGTAAGCCAC,0,5028114
yjbJ_predicted,0.09090909090909091,10,10,GGCGCATGGAACGGCAGTTT,0,5029448
yjbJ_predicted,0.09090909090909091,10,10,GGCCTCTTGCTAACCTATTG,0,5005198
yjbJ_predicted,0.09090909090909091,10,10,GGCCGTGAGAAGACTTTAAA,0,5006117
yjbJ_predicted,0.09090909090909091,10,10,GGCCCAACTCCCAGATGATG,0,5027701
yjbJ_predicted,0.09090909090909091,10,10,GGCCAGCTGAACCATGCCGA,0,4995938
yjbJ_predicted,0.09090909090909091,10,10,GGCATGCGATCACTATTGGA,0,5011390
yjbJ_predicted,0.09090909090909091,10,10,GGCAGAAATGCGGTTGTATG,0,5002012
yjbJ_predicted,0.09090909090909091,10,10,GGCACGGACAAATGACTAGG,0,5000089
yjbJ_predicted,0.09090909090909091,10,10,GGCACCGGACGCCAAACTTT,0,4998553
yjbJ_predicted,0.09090909090909091,10,10,GGATTCCGCTGAGGCCCTCC,0,4998312
yjbJ_predicted,0.09090909090909091,10,10,GGATTACCTAGCATGCACAC,0,5013026
yjbJ_predicted,0.09090909090909091,10,10,GGAGGTAGCCGGTCAATTGT,0,5012327
yjbJ_predicted,0.09090909090909091,10,10,GGACATCAAGAATGAGGAAC,0,5001980
yjbJ_predicted,0.09090909090909091,10,10,GGAACGTCTAATAGTCACCA,0,4999708
yjbJ_predicted,0.09090909090909091,10,10,GCTTCTTTAGGCCGCTCCGT,0,5001785
yjbJ_predicted,0.09090909090909091,10,10,GCTTCGGGACAGTGTGGTTA,0,5029225
yjbJ_predicted,0.09090909090909091,10,10,GCTTCCCCGAAAACCCCGTC,0,5006578
yjbJ_predicted,0.09090909090909091,10,10,GCTCGAGCACGAGCAGTTAG,0,5019071
yjbJ_predicted,0.09090909090909091,10,10,GCTCACCACGCCCAAGCGGA,0,5004362
yjbJ_predicted,0.09090909090909091,10,10,GCGGTCTATGTTGGGATGCC,0,5024818
yjbJ_predicted,0.09090909090909091,10,10,GCGGCTCGAGGCGCGGCATC,0,5004605
yjbJ_predicted,0.09090909090909091,10,10,GCGCGCATTCGCTGCATGGA,0,5012181
yjbJ_predicted,0.09090909090909091,10,10,GCGATGGGTAGTAACGACCG,0,5019774
yjbJ_predicted,0.09090909090909091,10,10,GCGATACCTTAGGCGATCTC,0,5000731
yjbJ_predicted,0.09090909090909091,10,10,GCGAGGTTAGTTGTGGTTGT,0,5003336
yjbJ_predicted,0.09090909090909091,10,10,GCCGTAGGCGGCATGCTACA,0,5003662
yjbJ_predicted,0.09090909090909091,10,10,GCCGACTTTCGCAGGGGGCT,0,5003210
yjbJ_predicted,0.09090909090909091,10,10,GCCCTTAGAACCTTGTTTAC,0,4999765
yjbJ_predicted,0.09090909090909091,10,10,GCCCCGAAGCTCTTTAACGT,0,5022781
yjbJ_predicted,0.09090909090909091,10,10,GCCACGATGTCGAGCTAGCT,0,5014448
yjbJ_predicted,0.09090909090909091,10,10,GCAGTCTGGGCGGGACAATT,0,5020865
yjbJ_predicted,0.09090909090909091,10,10,GCAGAGCTTTTGGTGAGAGA,0,5024803
yjbJ_predicted,0.09090909090909091,10,10,GCAATCCCCACGCTCGTAAT,0,5014078
yjbJ_predicted,0.09090909090909091,10,10,GATCCGCGTGGACTGACGAA,0,5014225
yjbJ_predicted,0.09090909090909091,10,10,GATCAGGTTGCGGACCTTAT,0,5002114
yjbJ_predicted,0.09090909090909091,10,10,GATATGGCCATAAACGCAAT,0,5020431
yjbJ_predicted,0.09090909090909091,10,10,GATACCGGGATAATAAGGGA,0,5029526
yjbJ_predicted,0.09090909090909091,10,10,GAGTGGGTCGCTTATGTTGA,0,5008394
yjbJ_predicted,0.09090909090909091,10,10,GAGGTTGAGGGAGTAAGTGC,0,5004082
yjbJ_predicted,0.09090909090909091,10,10,GAGGGTGGTCCTGTTGGTAG,0,4999621
yjbJ_predicted,0.09090909090909091,10,10,GAGGGGCCATACCCCAGCCG,0,5017089
yjbJ_predicted,0.09090909090909091,10,10,GAGCTTCAAATGTGGCCTCA,0,5023895
yjbJ_predicted,0.09090909090909091,10,10,GAGATTGCGGTTATAAGTCA,0,5007296
yjbJ_predicted,0.09090909090909091,10,10,GAGACTGGGAATGTCGGGCA,0,4994994
yjbJ_predicted,0.09090909090909091,10,10,GACTAAAATAGACTTGGGAA,0,5030679
yjbJ_predicted,0.09090909090909091,10,10,GACGATCTTCAATAAGGTTG,0,5001872
yjbJ_predicted,0.09090909090909091,10,10,GACAAAGTGGGTTCCCTCGC,0,5022436
yjbJ_predicted,0.09090909090909091,10,10,GAATTAAGAACAGAGGTCGT,0,5008788
yjbJ_predicted,0.09090909090909091,10,10,GAATCCCATGATGCATTGGC,0,5022550
yjbJ_predicted,0.09090909090909091,10,10,GAAATCAGACAGAGCCAAAC,0,5029621
yjbJ_predicted,0.09090909090909091,10,10,GAAACGGTTTACATCTTAAC,0,5006983
yjbJ_predicted,0.09090909090909091,10,10,GAAACCTTTTTAGCGGCATC,0,5000722
yjbJ_predicted,0.09090909090909091,10,10,GAAACCAGGCTCCACGGGTG,0,5016150
yjbJ_predicted,0.09090909090909091,10,10,GAAAACAAATGTGGCTGTGG,0,5000240
yjbJ_predicted,0.09090909090909091,10,10,CTTTATTGGGCACAGAGTGT,0,5004559
yjbJ_predicted,0.09090909090909091,10,10,CTTTATCTTCCACCCTAGAC,0,4996386
yjbJ_predicted,0.09090909090909091,10,10,CTGGGTCTCTGTCCACTTGG,0,5010248
yjbJ_predicted,0.09090909090909091,10,10,CTGAGTAATATTCGATTGAC,0,5016356
yjbJ_predicted,0.09090909090909091,10,10,CTCAGGAATACGATTGGTCA,0,5002459
yjbJ_predicted,0.09090909090909091,10,10,CTCACGTGTAGCTGTGGTGC,0,5006298
yjbJ_predicted,0.09090909090909091,10,10,CTATAATGCCATCTTGACAT,0,5027128
yjbJ_predicted,0.09090909090909091,10,10,CTAGTCCTATATACAGCTTT,0,5012551
yjbJ_predicted,0.09090909090909091,10,10,CTAAACTCCTATAGAGCCTG,0,5009880
yjbJ_predicted,0.09090909090909091,10,10,CTAAACCAAGAGGGCCGAAG,0,4996756
yjbJ_predicted,0.09090909090909091,10,10,CGTTTCTTCGATGGGGCGCT,0,5028528
yjbJ_predicted,0.09090909090909091,10,10,CGTTATGCGTCTACGTCCGC,0,5022883
yjbJ_predicted,0.09090909090909091,10,10,CGTTAAACGTTAGAAACGGA,0,5003455
yjbJ_predicted,0.09090909090909091,10,10,CGTGGTCATCATCCATTGCG,0,5017587
yjbJ_predicted,0.09090909090909091,10,10,CGTCTAGATCATTTACATGT,0,4995209
yjbJ_predicted,0.09090909090909091,10,10,CGTAAGCTTAATCCAGGGAT,0,5001158
yjbJ_predicted,0.09090909090909091,10,10,CGTAAGAATTGATTGGCGTG,0,5012180
yjbJ_predicted,0.09090909090909091,10,10,CGTAACGTCACGTAAAACAT,0,4995562
yjbJ_predicted,0.09090909090909091,10,10,CGGTAAAAGTTTAAGGTAAT,0,5030656
yjbJ_predicted,0.09090909090909091,10,10,CGGGCCGCACGGGATAGCGC,0,5014540
yjbJ_predicted,0.09090909090909091,10,10,CGGGAGCACTTGCCTTATCT,0,4996974
yjbJ_predicted,0.09090909090909091,10,10,CGGCCTAGGATCTTAGGCAT,0,5021730
yjbJ_predicted,0.09090909090909091,10,10,CGGAGGCCTACAGCAACGCG,0,5005165
yjbJ_predicted,0.09090909090909091,10,10,CGGAAACCTCAAAGGTGGCT,0,5026823
yjbJ_predicted,0.09090909090909091,10,10,CGCTTGATTCTACGGGGCCA,0,5021232
yjbJ_predicted,0.09090909090909091,10,10,CGCCTAAGTGATCACTTCAT,0,4995737
yjbJ_predicted,0.09090909090909091,10,10,CGCCGTTAGAGCTTATCCTT,0,5023022
yjbJ_predicted,0.09090909090909091,10,10,CGATCATCACTCTCAACTGT,0,5028256
yjbJ_predicted,0.09090909090909091,10,10,CGAGGTTAGTAACATCACAC,0,5022240
yjbJ_predicted,0.09090909090909091,10,10,CGAGAGCGGCTGTAGCAGTT,0,5030076
yjbJ_predicted,0.09090909090909091,10,10,CGACCTCTACTGGCTCGGGG,0,5031123
yjbJ_predicted,0.09090909090909091,10,10,CCTTGCAATTCTACACGATG,0,5009217
yjbJ_predicted,0.09090909090909091,10,10,CCTAGGATAAGATAACTGTA,0,5014447
yjbJ_predicted,0.09090909090909091,10,10,CCGGGGTTCACTGTCCGCAG,0,4999027
yjbJ_predicted,0.09090909090909091,10,10,CCCGCTTACTATCATTCTAG,0,5022736
yjbJ_predicted,0.09090909090909091,10,10,CCCGCGCAATCTTCGTACGT,0,5012415
yjbJ_predicted,0.09090909090909091,10,10,CCCCTTATCACTTGACCCAA,0,5025488
yjbJ_predicted,0.09090909090909091,10,10,CCCCCGCAAACACCGGAGGT,0,5014471
yjbJ_predicted,0.09090909090909091,10,10,CCAGGAGCGTCAGTCGTCGT,0,5015167
yjbJ_predicted,0.09090909090909091,10,10,CCAGCATGCGCGACCCCAGT,0,5028828
yjbJ_predicted,0.09090909090909091,10,10,CCACTTAGCGATGTGAACCA,0,5009391
yjbJ_predicted,0.09090909090909091,10,10,CCACCCGTCTATCGTACATT,0,5031005
yjbJ_predicted,0.09090909090909091,10,10,CCACAGACCCAGGTAAACTG,0,5024828
yjbJ_predicted,0.09090909090909091,10,10,CCAATGCGCCTAGGTGTGGC,0,5009139
yjbJ_predicted,0.09090909090909091,10,10,CCAACAAAGTTCAATCTCAT,0,5008693
yjbJ_predicted,0.09090909090909091,10,10,CATTTCTTTGAAACCAGGGT,0,4995723
yjbJ_predicted,0.09090909090909091,10,10,CATGTCGATAGGTACGAAGC,0,5019305
yjbJ_predicted,0.09090909090909091,10,10,CATGCCCTGGGCCACGACTA,0,5024761
yjbJ_predicted,0.09090909090909091,10,10,CATGCACGATTACCTTGGCC,0,5025975
yjbJ_predicted,0.09090909090909091,10,10,CATCGGTTTACACCCAAGAT,0,5009183
yjbJ_predicted,0.09090909090909091,10,10,CATCCCTCCTCAACATACAT,0,5007117
yjbJ_predicted,0.09090909090909091,10,10,CATAGATTGACCGAGCCGCC,0,5027466
yjbJ_predicted,0.09090909090909091,10,10,CAGTTCACTCAAGACCGTAA,0,5010251
yjbJ_predicted,0.09090909090909091,10,10,CAGTACGTTCCATTGCGTTA,0,5017419
yjbJ_predicted,0.09090909090909091,10,10,CAGGACCACTCAATTAGCGT,0,5027548
yjbJ_predicted,0.09090909090909091,10,10,CAGAAGCCCCCTCCCAGTCA,0,4994819
yjbJ_predicted,0.09090909090909091,10,10,CACTTGCCCGTGGCATTGCG,0,5010957
yjbJ_predicted,0.09090909090909091,10,10,CACTATTAATGGCCGTCTGT,0,5000340
yjbJ_predicted,0.09090909090909091,10,10,CACTACGCAATGTCTAGAAT,0,5019863
yjbJ_predicted,0.09090909090909091,10,10,CACCTCACGGCCTCGGGTGT,0,5022236
yjbJ_predicted,0.09090909090909091,10,10,CACCCTCTGTAACTTGGCTT,0,4999530
yjbJ_predicted,0.09090909090909091,10,10,CACAGGGAAACGCGTTTGTC,0,5028193
yjbJ_predicted,0.09090909090909091,10,10,CACACGTGATTCAAGGGACA,0,5005955
yjbJ_predicted,0.09090909090909091,10,10,CAAGGAGTGGGCGGGGCGAG,0,5011987
yjbJ_predicted,0.09090909090909091,10,10,CAAGCCCGCACATCCGCTAG,0,5019561
yjbJ_predicted,0.09090909090909091,10,10,CAACTTTCAACAGATGCAGT,0,4997443
yjbJ_predicted,0.09090909090909091,10,10,CAACTACAGCGTCGCGATAC,0,5025974
yjbJ_predicted,0.09090909090909091,10,10,CAAAGACGGTAACCGCCGCT,0,5015702
yjbJ_predicted,0.09090909090909091,10,10,CAAAAGGACACTGTACGAGA,0,5014600
yjbJ_predicted,0.09090909090909091,10,10,ATTTTCTTGCCGGACTGGTC,0,5018572
yjbJ_predicted,0.09090909090909091,10,10,ATTTAAACTGCTGAGCAGAG,0,5006070
yjbJ_predicted,0.09090909090909091,10,10,ATTCTTCTGAAGAAAGTGCG,0,5008341
yjbJ_predicted,0.09090909090909091,10,10,ATTCTTATTAAGTAAGTACG,0,5028132
yjbJ_predicted,0.09090909090909091,10,10,ATGTGGTGCACGGTTCACAT,0,5015299
yjbJ_predicted,0.09090909090909091,10,10,ATGTCTCCACCGTGGGATCA,0,5005601
yjbJ_predicted,0.09090909090909091,10,10,ATGTACATAGAATCAGTGAT,0,5012269
yjbJ_predicted,0.09090909090909091,10,10,ATGGGAGGTTATCGATCGGT,0,5021176
yjbJ_predicted,0.09090909090909091,10,10,ATGGCTTTATTCGGTGTCAG,0,4996872
yjbJ_predicted,0.09090909090909091,10,10,ATGGAGCAACGGGGTAACAA,0,5002780
yjbJ_predicted,0.09090909090909091,10,10,ATGGAATCGATCGCAAGGGG,0,5024966
yjbJ_predicted,0.09090909090909091,10,10,ATGAGGCCACGACCTACCCA,0,4999766
yjbJ_predicted,0.09090909090909091,10,10,ATGAGCACTCCCGGAACTGA,0,5019263
yjbJ_predicted,0.09090909090909091,10,10,ATCTAGAGATCAATCTAGAA,0,5024014
yjbJ_predicted,0.09090909090909091,10,10,ATCGTTACGACTATGCGCGG,0,5012471
yjbJ_predicted,0.09090909090909091,10,10,ATCGGTGGGAAATATGCATC,0,5001050
yjbJ_predicted,0.09090909090909091,10,10,ATCGATATGCACGTTGGCCT,0,5019716
yjbJ_predicted,0.09090909090909091,10,10,ATCCCGCATGGAGTAAACTT,0,5006436
yjbJ_predicted,0.09090909090909091,10,10,ATCCCAGCTTCGGTCAATCT,0,5009286
yjbJ_predicted,0.09090909090909091,10,10,ATATCTTATCGTCGTGGAGT,0,5001276
yjbJ_predicted,0.09090909090909091,10,10,ATATAAATCCCTATTAGCCA,0,5002667
yjbJ_predicted,0.09090909090909091,10,10,ATAGGGAAGGGGAATGCAGC,0,5003090
yjbJ_predicted,0.09090909090909091,10,10,ATACGGGCCTTGGGGATCCC,0,5023039
yjbJ_predicted,0.09090909090909091,10,10,ATACGGACTCAACCGCACTA,0,5013383
yjbJ_predicted,0.09090909090909091,10,10,ATACAGTTGCTGATTCTGTC,0,5012597
yjbJ_predicted,0.09090909090909091,10,10,AGTTGGTCCCGCGGCCAGTT,0,5006575
yjbJ_predicted,0.09090909090909091,10,10,AGTTGGAAGAACTTGAGCCA,0,5014517
yjbJ_predicted,0.09090909090909091,10,10,AGTTACGGGTGACGCATCGT,0,5028591
yjbJ_predicted,0.09090909090909091,10,10,AGTGACGAATGGTCACTTTT,0,5026464
yjbJ_predicted,0.09090909090909091,10,10,AGTCGCAATTAACAAAAGCC,0,4998060
yjbJ_predicted,0.09090909090909091,10,10,AGTATACTATCCCGATCCGA,0,5023699
yjbJ_predicted,0.09090909090909091,10,10,AGGTAGTGCTCCCGGGTACA,0,5010081
yjbJ_predicted,0.09090909090909091,10,10,AGGGACATAATCTGTAGATC,0,5021430
yjbJ_predicted,0.09090909090909091,10,10,AGGCGGGATTACCCGGGACA,0,5008616
yjbJ_predicted,0.09090909090909091,10,10,AGGAGCGAGCTCTTTACCTA,0,5010490
yjbJ_predicted,0.09090909090909091,10,10,AGGAGATATAAAAATACTTT,0,5011065
yjbJ_predicted,0.09090909090909091,10,10,AGCTACAGGGGGAGGGAAAA,0,4994816
yjbJ_predicted,0.09090909090909091,10,10,AGCGGGTTTAGGCTAGGGAT,0,4997250
yjbJ_predicted,0.09090909090909091,10,10,AGCCCGAGGAAAGCTGGCAC,0,5017531
yjbJ_predicted,0.09090909090909091,10,10,AGCCACCCGTGGGGGTTAAT,0,5018844
yjbJ_predicted,0.09090909090909091,10,10,AGATTTGCTTAGAGAACAAT,0,5009599
yjbJ_predicted,0.09090909090909091,10,10,AGATGTTTTGGTAGCCTCAT,0,5002014
yjbJ_predicted,0.09090909090909091,10,10,AGATATAGGAGAATGGTGTC,0,5002135
yjbJ_predicted,0.09090909090909091,10,10,AGATACACGCGGTTCATAGT,0,5009412
yjbJ_predicted,0.09090909090909091,10,10,AGAGATTCCGGTCCCGACAA,0,4996726
yjbJ_predicted,0.09090909090909091,10,10,AGAGATAGTTACGATACCGG,0,4999095
yjbJ_predicted,0.09090909090909091,10,10,AGACTCACAGTAAAGCGAGG,0,5020164
yjbJ_predicted,0.09090909090909091,10,10,AGAACGCGGGACTGCCTATC,0,5003120
yjbJ_predicted,0.09090909090909091,10,10,ACTTTTTTTTGGACGTCTCA,0,4995591
yjbJ_predicted,0.09090909090909091,10,10,ACTTTTAGAGTCAGGGTAGC,0,5017384
yjbJ_predicted,0.09090909090909091,10,10,ACTTCCTGACGGTCTGAGGT,0,5009394
yjbJ_predicted,0.09090909090909091,10,10,ACTGGATTGCCCGTTGTCTT,0,5016501
yjbJ_predicted,0.09090909090909091,10,10,ACTCGAGTTTGTTCAATGGA,0,5028406
yjbJ_predicted,0.09090909090909091,10,10,ACGCAACGTGACCCGTTACT,0,5007659
yjbJ_predicted,0.09090909090909091,10,10,ACCTCAATCAATATCGAGGA,0,5015210
yjbJ_predicted,0.09090909090909091,10,10,ACCGAGACCACCTGCGCAAT,0,5010110
yjbJ_predicted,0.09090909090909091,10,10,ACCCTAGTCGCCAGACTCAA,0,4995825
yjbJ_predicted,0.09090909090909091,10,10,ACCCGCATCATGTTGTATTG,0,5015559
yjbJ_predicted,0.09090909090909091,10,10,ACCCCATTAACTAACGGGTT,0,5018656
yjbJ_predicted,0.09090909090909091,10,10,ACCACAGACCGCCCGCTTCC,0,5014708
yjbJ_predicted,0.09090909090909091,10,10,ACCACAAATCATTACCTGAT,0,5020597
yjbJ_predicted,0.09090909090909091,10,10,ACATGCGCGCCTGATACAGG,0,5001953
yjbJ_predicted,0.09090909090909091,10,10,ACAATAGTTGAAATTGGTGA,0,5009243
yjbJ_predicted,0.09090909090909091,10,10,AATTCAGAGCATAGCCAATT,0,5023013
yjbJ_predicted,0.09090909090909091,10,10,AATGGTGTCTCTGCAGGAGA,0,5024403
yjbJ_predicted,0.09090909090909091,10,10,AATGGGTGTGGGTACGTGAA,0,5027088
yjbJ_predicted,0.09090909090909091,10,10,AATGAAGGAGGCCATGTCAT,0,5025619
yjbJ_predicted,0.09090909090909091,10,10,AATCGGGGACCTGACGAAGC,0,5013334
yjbJ_predicted,0.09090909090909091,10,10,AATATCTGGCGATAGATGCA,0,5006091
yjbJ_predicted,0.09090909090909091,10,10,AATAAGACATGTGCTCGTTC,0,5020924
yjbJ_predicted,0.09090909090909091,10,10,AAGTGATGTGCGGATGGGTC,0,5006332
yjbJ_predicted,0.09090909090909091,10,10,AAGGCGACTTGATATTAGAG,0,4998025
yjbJ_predicted,0.09090909090909091,10,10,AAGACGGTGTTCTTGCTGTT,0,5013221
yjbJ_predicted,0.09090909090909091,10,10,AAGACCTGTAGGTGCACGGA,0,5007221
yjbJ_predicted,0.09090909090909091,10,10,AAAGTCTTGAAATCACAATT,0,5008731
yjbJ_predicted,0.09090909090909091,10,10,AAAGGATCGGTACGTTTGCT,0,4994688
yjbJ_predicted,0.09090909090909091,10,10,AAAGCGAAGTCGCTTTCATT,0,5022430
yjbJ_predicted,0.1,9,9,TTTTTACACGATGCTGCGGA,0,5031241
yjbJ_predicted,0.1,9,9,TTTTGCTGCTCACCGTTTTG,0,5019681
yjbJ_predicted,0.1,9,9,TTTTCGTTCTTTGCCGTCAT,0,5016588
yjbJ_predicted,0.1,9,9,TTTGTTGCTTGTTGTCCTGA,0,5001241
yjbJ_predicted,0.1,9,9,TTTGTGTTCACGGGATTTGT,0,4997090
yjbJ_predicted,0.1,9,9,TTGTCACACCAATGGTGCTA,0,5030436
yjbJ_predicted,0.1,9,9,TTGGAGTCAACTCAGCCGGA,0,5023678
yjbJ_predicted,0.1,9,9,TTGCAACCCTCTTGGACCTA,0,5010700
yjbJ_predicted,0.1,9,9,TTCTTGTTTACTACTTGGCC,0,5007901
yjbJ_predicted,0.1,9,9,TTCTTGTATGGGGGTGCTAA,0,4998537
yjbJ_predicted,0.1,9,9,TTCTATGCCGAAAAATGAAG,0,5013600
yjbJ_predicted,0.1,9,9,TTCTATCGGCGGGCGAGAGT,0,5002415
yjbJ_predicted,0.1,9,9,TTCGTGATAGATAAATCGCA,0,4996156
yjbJ_predicted,0.1,9,9,TTCGTCCGCTCGTCAGACGG,0,5017191
yjbJ_predicted,0.1,9,9,TTCGGATGCGACGAATTAGT,0,5020611
yjbJ_predicted,0.1,9,9,TTCCTACCAAAAACCCCAAA,0,5006115
yjbJ_predicted,0.1,9,9,TTCCCACGAAAGATGCATAC,0,5026985
yjbJ_predicted,0.1,9,9,TTATCCGGACAGTCTCCGGC,0,5022072
yjbJ_predicted,0.1,9,9,TTAGTCGCCTGCGCGTCAAC,0,5001873
yjbJ_predicted,0.1,9,9,TTAGTCAAAGAATACTATCA,0,5022105
yjbJ_predicted,0.1,9,9,TTAGGCCCTGCGCCCTCTAT,0,5022286
yjbJ_predicted,0.1,9,9,TTAGGACCAAATCGACGTTC,0,5018031
yjbJ_predicted,0.1,9,9,TTACCCTGATTCTGGAACCG,0,5030088
yjbJ_predicted,0.1,9,9,TTAACGTATAGTTCAACCAC,0,5007376
yjbJ_predicted,0.1,9,9,TGTTTGATCTTCAAAGAGCA,0,5006988
yjbJ_predicted,0.1,9,9,TGTTTAATTATGGGCGTTAG,0,5021141
yjbJ_predicted,0.1,9,9,TGTGGCTTCATTCGGAAGGA,0,5023887
yjbJ_predicted,0.1,9,9,TGTCAGAATCGAGAAGACAG,0,5030790
yjbJ_predicted,0.1,9,9,TGTCACGTATACAATACACA,0,5016530
yjbJ_predicted,0.1,9,9,TGGTATCTAATAACTTTGAG,0,5014651
yjbJ_predicted,0.1,9,9,TGGTAATAACAGGCTAACGG,0,4996848
yjbJ_predicted,0.1,9,9,TGGTAACCCTTCTTAATAGG,0,5019820
yjbJ_predicted,0.1,9,9,TGGGTCTACCGGCTTTGAGT,0,5030479
yjbJ_predicted,0.1,9,9,TGGGCGTGCTCTCAGGGAGG,0,5013867
yjbJ_predicted,0.1,9,9,TGGGACTCTGTCCAGTAGAG,0,5025465
yjbJ_predicted,0.1,9,9,TGGCTTTGTCATTGTCTCCT,0,5006984
yjbJ_predicted,0.1,9,9,TGGCGACTTTTGCCAAGCGT,0,5029679
yjbJ_predicted,0.1,9,9,TGGCACTTCACCATTTTCTC,0,5014819
yjbJ_predicted,0.1,9,9,TGCTTCGCAAATTTGAACTT,0,5012155
yjbJ_predicted,0.1,9,9,TGCTCTCATCTTCGGTTCGG,0,5026649
yjbJ_predicted,0.1,9,9,TGCTCGGATATTGGGTTCCA,0,5006278
yjbJ_predicted,0.1,9,9,TGCGGACTAAATTACCATCC,0,5021278
yjbJ_predicted,0.1,9,9,TGCGAGCCTTAATATGAAGC,0,5006763
yjbJ_predicted,0.1,9,9,TGCATTTGATGTGACGTGTG,0,5006577
yjbJ_predicted,0.1,9,9,TGCATGGGATCAGATTGCGG,0,5012396
yjbJ_predicted,0.1,9,9,TGCACTTGACTGGCTCAGCG,0,5022122
yjbJ_predicted,0.1,9,9,TGATGATGGCAGCCGGAATA,0,5022844
yjbJ_predicted,0.1,9,9,TGATCTTCAGGCGAGGACTT,0,5007518
yjbJ_predicted,0.1,9,9,TGATAATGCGGGAGGTTACT,0,5010059
yjbJ_predicted,0.1,9,9,TGAGTAGAGTGCGGAGTTAG,0,5006720
yjbJ_predicted,0.1,9,9,TGAGGTCTTAGCCAAAGCTG,0,5002892
yjbJ_predicted,0.1,9,9,TGAGGTCAGCCCTGTGGCAG,0,4997934
yjbJ_predicted,0.1,9,9,TGACACCGCTCCGTAGGCAA,0,5026074
yjbJ_predicted,0.1,9,9,TCTTTGGTAGCCTCGCCCCG,0,5023679
yjbJ_predicted,0.1,9,9,TCTTGCTTTCGGAATCTTCT,0,5029083
yjbJ_predicted,0.1,9,9,TCTTGCTTATTGGAGGGATC,0,4997119
yjbJ_predicted,0.1,9,9,TCTGTGCGCAGCTGCTACTA,0,5002706
yjbJ_predicted,0.1,9,9,TCTGGAGTCTGGCTTTCAGG,0,5009734
yjbJ_predicted,0.1,9,9,TCTCGGGGACAGTCTTCGAA,0,5010459
yjbJ_predicted,0.1,9,9,TCTCATGGACAGCACCTAGG,0,5025123
yjbJ_predicted,0.1,9,9,TCTAGGTAACTGCCCAACTC,0,4997591
yjbJ_predicted,0.1,9,9,TCGTTCAAATGCACTGGGGA,0,5003302
yjbJ_predicted,0.1,9,9,TCGTATGCCGCCATGCCCTG,0,5002914
yjbJ_predicted,0.1,9,9,TCGGTCATCTTGTAGATGGC,0,5017514
yjbJ_predicted,0.1,9,9,TCGGGGGTGGTTTAGATCAC,0,4997892
yjbJ_predicted,0.1,9,9,TCGCAGCCCCAATCGGGTTA,0,5005993
yjbJ_predicted,0.1,9,9,TCGAGGGATCGCCTCGGGCG,0,5029776
yjbJ_predicted,0.1,9,9,TCCGGCCAGACGAGGAGGAG,0,5003521
yjbJ_predicted,0.1,9,9,TCCGCAAACGATCGGCCTAG,0,5009291
yjbJ_predicted,0.1,9,9,TCCATACACTCGTAGGTACC,0,5021959
yjbJ_predicted,0.1,9,9,TCCAGGAGTCCGGCGGTCAG,0,4997622
yjbJ_predicted,0.1,9,9,TCCAGAGAAGTCGTTTAACC,0,5025945
yjbJ_predicted,0.1,9,9,TCCAATGATCAGGCCTCCGA,0,5001587
yjbJ_predicted,0.1,9,9,TCATGGATAAGACTCGTGTG,0,5013311
yjbJ_predicted,0.1,9,9,TCATCAGAAGGTTCAGTGTT,0,5022434
yjbJ_predicted,0.1,9,9,TATGGTAGCGGCGCCAATCT,0,5007134
yjbJ_predicted,0.1,9,9,TATGCGATCAGGCTTCCATT,0,5012163
yjbJ_predicted,0.1,9,9,TATATGGCGGACATCGTGAA,0,5012601
yjbJ_predicted,0.1,9,9,TATAATTCCCAATCATCATC,0,5002403
yjbJ_predicted,0.1,9,9,TAGTGTTGTCGTCTTTATAA,0,4999403
yjbJ_predicted,0.1,9,9,TAGCGATCTGGATATCCTTT,0,4998246
yjbJ_predicted,0.1,9,9,TAGCCACATACGAGGGGAAA,0,5011005
yjbJ_predicted,0.1,9,9,TAGATCCCACCCTAAGGATG,0,5013961
yjbJ_predicted,0.1,9,9,TAGAGGTCACGGTCTTGCTA,0,5018552
yjbJ_predicted,0.1,9,9,TACTACACACCTCAATTTGG,0,5010824
yjbJ_predicted,0.1,9,9,TACGTTAGGGCGTAGTTCGA,0,5023307
yjbJ_predicted,0.1,9,9,TACGCTACTATCGGAAGGTC,0,5024949
yjbJ_predicted,0.1,9,9,TACGCGATGCTTTACTATAG,0,5016343
yjbJ_predicted,0.1,9,9,TACACTCCGCTTACCGGTAT,0,5003797
yjbJ_predicted,0.1,9,9,TAACGGTTGATGAATTAGGT,0,5002581
yjbJ_predicted,0.1,9,9,TAACAGGCGAGGGAAACTGA,0,4998113
yjbJ_predicted,0.1,9,9,TAAAGGGTACGACGCAGTAG,0,5019027
yjbJ_predicted,0.1,9,9,GTTTAACTTAGGCAGAGATG,0,5024802
yjbJ_predicted,0.1,9,9,GTTGGGAGGCTCAGTGCCCG,0,5013893
yjbJ_predicted,0.1,9,9,GTTCAGGTGCCCACTTGAAC,0,5029253
yjbJ_predicted,0.1,9,9,GTTAGGTTGCTCGTCGGTGA,0,5028026
yjbJ_predicted,0.1,9,9,GTTAGCCGAAAAGATTTCGG,0,4999855
yjbJ_predicted,0.1,9,9,GTTACAGAAACAGAAGTGGA,0,5018214
yjbJ_predicted,0.1,9,9,GTGTGGGATGCCACGCTCAA,0,5002725
yjbJ_predicted,0.1,9,9,GTGTGATCAGGACAGGCGGC,0,5000527
yjbJ_predicted,0.1,9,9,GTGTAGGGAACAACAGTGTT,0,5009844
yjbJ_predicted,0.1,9,9,GTGGTAAACGTTGACTTCTT,0,5021667
yjbJ_predicted,0.1,9,9,GTGCGCAAATACATTAGAGC,0,5003374
yjbJ_predicted,0.1,9,9,GTGCCTTTAGTGGGGCGTCA,0,5025767
yjbJ_predicted,0.1,9,9,GTGAATTTGCTTAGCGAGCC,0,5024720
yjbJ_predicted,0.1,9,9,GTCTTACGCCACGGCCGCGC,0,5013100
yjbJ_predicted,0.1,9,9,GTCTGCTCTACGAGCGTCGG,0,5027995
yjbJ_predicted,0.1,9,9,GTCTCGTCACGCTCGGCGAC,0,5011077
yjbJ_predicted,0.1,9,9,GTCGATCGGGTTGTTTTTAG,0,4999676
yjbJ_predicted,0.1,9,9,GTCCTTCCAATCCTTACGTT,0,5019908
yjbJ_predicted,0.1,9,9,GTCCTGATCCGGCAGCAATA,0,5007344
yjbJ_predicted,0.1,9,9,GTCCAATTCCCGGCCCCGTG,0,4996395
yjbJ_predicted,0.1,9,9,GTATTTATCCGTTGGCTTGA,0,5027978
yjbJ_predicted,0.1,9,9,GTATTGTTAGACTATCGTGC,0,5017238
yjbJ_predicted,0.1,9,9,GTATCTAGGCCCCCTAAAAT,0,5023845
yjbJ_predicted,0.1,9,9,GTAGTCCCTAGTGGCAGAGG,0,5010129
yjbJ_predicted,0.1,9,9,GTAGACCGTGGTTCTCAGAA,0,5014782
yjbJ_predicted,0.1,9,9,GTACACGTAGTGCGCGGGGT,0,5029872
yjbJ_predicted,0.1,9,9,GTAATGGCCGTGAGATAAGG,0,4998208
yjbJ_predicted,0.1,9,9,GTAATCGAAACCCGCTCAGT,0,5022520
yjbJ_predicted,0.1,9,9,GTAACTTTTAGCGGTTAAAT,0,5027331
yjbJ_predicted,0.1,9,9,GTAACGTTCGTTTTCACGCA,0,5004420
yjbJ_predicted,0.1,9,9,GTAAAACTTTTTCCATAGGG,0,4999806
yjbJ_predicted,0.1,9,9,GGTTGTGCCACGACTTTTGG,0,5012965
yjbJ_predicted,0.1,9,9,GGTTGAAAGTTGTGTTTGAG,0,4999725
yjbJ_predicted,0.1,9,9,GGTCATTAGATGCTCGACGA,0,5001000
yjbJ_predicted,0.1,9,9,GGTCAGGTGGCTTAGCTATT,0,5013881
yjbJ_predicted,0.1,9,9,GGGTGGTTCTTTCACTCGGT,0,5017126
yjbJ_predicted,0.1,9,9,GGGTCTAGCAGCTGTAGAAT,0,5025278
yjbJ_predicted,0.1,9,9,GGGTCCTTATCGTGCGTCGT,0,5010164
yjbJ_predicted,0.1,9,9,GGGTATTCCGTTGGCCGCAT,0,5008754
yjbJ_predicted,0.1,9,9,GGGTAGCGTTTCTCCGTATT,0,5009358
yjbJ_predicted,0.1,9,9,GGGGGAATTTTCAATATAAG,0,5030689
yjbJ_predicted,0.1,9,9,GGGGCAGCTTTGTATCCTAA,0,5022545
yjbJ_predicted,0.1,9,9,GGGCGCTAGGTATTCGACCG,0,5027538
yjbJ_predicted,0.1,9,9,GGGCATCGGAGGCGCAAGGA,0,5001871
yjbJ_predicted,0.1,9,9,GGGAGTGGCGAAAAAGAATT,0,5016045
yjbJ_predicted,0.1,9,9,GGGACCCCGCGTAACACGCT,0,5017244
yjbJ_predicted,0.1,9,9,GGGACAGAGCTCTGGACCCA,0,5002726
yjbJ_predicted,0.1,9,9,GGCCTGCAGATCTCAAACTA,0,5013657
yjbJ_predicted,0.1,9,9,GGCCCGGCTCTGACGTATGC,0,5007687
yjbJ_predicted,0.1,9,9,GGCCAGCGTATATTTACTAT,0,4998449
yjbJ_predicted,0.1,9,9,GGCATGAATGCGAGTCCAAT,0,5026350
yjbJ_predicted,0.1,9,9,GGCATATCTACTGGAAGGAG,0,5002984
yjbJ_predicted,0.1,9,9,GGCAAGTTCCGATGGACAGA,0,5001129
yjbJ_predicted,0.1,9,9,GGATTCCAGGGTCTATAAAG,0,5009152
yjbJ_predicted,0.1,9,9,GGAGCCCATCGAAAATCCCA,0,4995243
yjbJ_predicted,0.1,9,9,GGACGTGCTTTCCACATTAG,0,5012513
yjbJ_predicted,0.1,9,9,GGACACATGATCCTTTAGAT,0,5002894
yjbJ_predicted,0.1,9,9,GCTTGGGATTCGACAGGGCG,0,5028495
yjbJ_predicted,0.1,9,9,GCTGTCAACGCGGGGCTCTA,0,5007726
yjbJ_predicted,0.1,9,9,GCTACTCGTAGGGACTTTAA,0,5001685
yjbJ_predicted,0.1,9,9,GCGTACATGTGCTGGTCCCA,0,5001847
yjbJ_predicted,0.1,9,9,GCGCTCTGCGCCAGCAGATA,0,4995102
yjbJ_predicted,0.1,9,9,GCGCTACCGAGCGTGTACAT,0,4997318
yjbJ_predicted,0.1,9,9,GCCTCTTCGCAACGGCGAGA,0,5018774
yjbJ_predicted,0.1,9,9,GCCTATAAAGGACATGACCC,0,5027605
yjbJ_predicted,0.1,9,9,GCCGTTGGTCTGAACTTTCA,0,5023095
yjbJ_predicted,0.1,9,9,GCCGTGGCGCCCATTCTGTC,0,5011602
yjbJ_predicted,0.1,9,9,GCCCGCATTGTTACAGGAAC,0,4999496
yjbJ_predicted,0.1,9,9,GCCCGATGAGCAGTGGTAAC,0,5016244
yjbJ_predicted,0.1,9,9,GCCAGTGAATTAAGGCCCAT,0,5010050
yjbJ_predicted,0.1,9,9,GCCAGGACTTGTGCGCTGTA,0,5016105
yjbJ_predicted,0.1,9,9,GCATGACGTCCATTCCAGTC,0,5011640
yjbJ_predicted,0.1,9,9,GCATCCTCAACATGGTTGTT,0,5010544
yjbJ_predicted,0.1,9,9,GCATACATGTGCAGAACACA,0,5030582
yjbJ_predicted,0.1,9,9,GCAGCCCAGTACCAGTGATT,0,4998790
yjbJ_predicted,0.1,9,9,GCACCGCGAAGAGAATACAC,0,5022941
yjbJ_predicted,0.1,9,9,GCACCCGCGCATGATTGCGG,0,5009999
yjbJ_predicted,0.1,9,9,GCAAGGGCATACTTGCACTT,0,5013041
yjbJ_predicted,0.1,9,9,GATTTGAATCTGTTAATGGT,0,5020312
yjbJ_predicted,0.1,9,9,GATTTAAGCCGCGTACAGAA,0,5015232
yjbJ_predicted,0.1,9,9,GATTCGCCGTGTTGGACAGG,0,4995637
yjbJ_predicted,0.1,9,9,GATTCAGTTCATGGGTCTAC,0,5012120
yjbJ_predicted,0.1,9,9,GATGTCAAATGGAGACCATA,0,5000366
yjbJ_predicted,0.1,9,9,GATGGGCGTAAGCCTCCTCA,0,5024837
yjbJ_predicted,0.1,9,9,GATGGCTACAGGCTTAAATT,0,5028947
yjbJ_predicted,0.1,9,9,GATCTGTGCATGCTGCGCGA,0,5024486
yjbJ_predicted,0.1,9,9,GATATGGAAGGGTCGCTGCA,0,5016036
yjbJ_predicted,0.1,9,9,GAGTGCAGTTGGAGTTAGTT,0,5021796
yjbJ_predicted,0.1,9,9,GAGTCGCGTGGCAACGGCAT,0,5025815
yjbJ_predicted,0.1,9,9,GAGTAATTTTTGAACAGCGG,0,5006105
yjbJ_predicted,0.1,9,9,GAGGCTAAACTAACACCGCA,0,5030808
yjbJ_predicted,0.1,9,9,GAGCAGAGCGGTGTTGCTAT,0,5027189
yjbJ_predicted,0.1,9,9,GACTGGCATTTCAGAATATA,0,5015137
yjbJ_predicted,0.1,9,9,GACTCGCTTGCAATTATTCA,0,5020977
yjbJ_predicted,0.1,9,9,GACGCTTCATGCAAGGTTGC,0,5025875
yjbJ_predicted,0.1,9,9,GACGCTGTGCCTACGCGGTA,0,5028649
yjbJ_predicted,0.1,9,9,GACATAATAGATTCCGAGTT,0,5027393
yjbJ_predicted,0.1,9,9,GACAGAGCCATCTGAATCCC,0,5021882
yjbJ_predicted,0.1,9,9,GACAACCACGCACATAGATA,0,5027624
yjbJ_predicted,0.1,9,9,GAAGGTAAGTGACGCCAGTT,0,4998109
yjbJ_predicted,0.1,9,9,GAAAGAAAGGCTCCGGCTAA,0,5014945
yjbJ_predicted,0.1,9,9,GAAAACAACTAGCGTTTCGT,0,5021995
yjbJ_predicted,0.1,9,9,GAAAAAGTGGACCCGTTAGG,0,5027155
yjbJ_predicted,0.1,9,9,CTTTGATAAGGAGTCGCCAG,0,5030748
yjbJ_predicted,0.1,9,9,CTTTCATGATTACCGTTCAT,0,5017741
yjbJ_predicted,0.1,9,9,CTTTACTTTAACTTAGGGAG,0,4995950
yjbJ_predicted,0.1,9,9,CTTGTTTGGATCTGAGGCGT,0,5001588
yjbJ_predicted,0.1,9,9,CTTGTAGAGCGACAAGGTTC,0,5015944
yjbJ_predicted,0.1,9,9,CTTCTTCGCATGCCGCTGGA,0,4996342
yjbJ_predicted,0.1,9,9,CTTAGTCACCAAGGTGTAAG,0,5011333
yjbJ_predicted,0.1,9,9,CTTAGGAGTCAATCTACAAT,0,5010572
yjbJ_predicted,0.1,9,9,CTGTGATTGTAGATGTGTTG,0,5023017
yjbJ_predicted,0.1,9,9,CTGTCGGCGTGGATTACTAA,0,5001393
yjbJ_predicted,0.1,9,9,CTGCGATGGACGGCCTTAGT,0,5019595
yjbJ_predicted,0.1,9,9,CTGCCCGTCTAACTTGCTAG,0,5008404
yjbJ_predicted,0.1,9,9,CTGACCGCAGAAAACACTGG,0,5010579
yjbJ_predicted,0.1,9,9,CTCTACGAGATATTTAGCAG,0,5001323
yjbJ_predicted,0.1,9,9,CTCGTCGTAGCTGGAGCGAT,0,5010895
yjbJ_predicted,0.1,9,9,CTCGGAGTCTGACCGTTACG,0,5008206
yjbJ_predicted,0.1,9,9,CTCGATCACACGGGGGAACA,0,5001830
yjbJ_predicted,0.1,9,9,CTCGACCCAGCTTGATCTTA,0,5003408
yjbJ_predicted,0.1,9,9,CTAGTGTGTAGTTCAGGTAA,0,5017049
yjbJ_predicted,0.1,9,9,CTAGGTGGGTTGGAGTGTGT,0,5027200
yjbJ_predicted,0.1,9,9,CTACGATGTGCAACCAACGT,0,5023580
yjbJ_predicted,0.1,9,9,CTACATGTGCCCCCGCAGCT,0,5002652
yjbJ_predicted,0.1,9,9,CTAACGACGCATACGCCAGA,0,5012851
yjbJ_predicted,0.1,9,9,CTAACCGTTCTAGGCGCTAG,0,5006883
yjbJ_predicted,0.1,9,9,CGTTTATCGGACCCAAGGCA,0,5004933
yjbJ_predicted,0.1,9,9,CGTGCTCTGTGTGTAGAGAG,0,4994933
yjbJ_predicted,0.1,9,9,CGTGCCCAACAAGCAAGGCC,0,4995366
yjbJ_predicted,0.1,9,9,CGTACTCGGGAAATAACGAT,0,5026036
yjbJ_predicted,0.1,9,9,CGGTTTCGATCTTGACAATT,0,5024716
yjbJ_predicted,0.1,9,9,CGGTCGCGACCCTAGTTGCA,0,5005846
yjbJ_predicted,0.1,9,9,CGGTACCATGGAATACGTTA,0,5022370
yjbJ_predicted,0.1,9,9,CGGGGGTGAGGAGTCTGGTA,0,5009066
yjbJ_predicted,0.1,9,9,CGGGCGCTGGTCACGGACCT,0,5014468
yjbJ_predicted,0.1,9,9,CGGGATTCATCCGACCGCAT,0,5017562
yjbJ_predicted,0.1,9,9,CGGGAGTGTCCGGGTCGAGG,0,5030019
yjbJ_predicted,0.1,9,9,CGGGACGAAGTGTAGAATCT,0,4996597
yjbJ_predicted,0.1,9,9,CGGCCGGAAGCCATCGTTCT,0,5026449
yjbJ_predicted,0.1,9,9,CGGATCCGCCTATTCGCCGG,0,5021091
yjbJ_predicted,0.1,9,9,CGGAACGCACCTACTCGGGA,0,5014989
yjbJ_predicted,0.1,9,9,CGCTGCCCTCTACAGAGTTT,0,5001310
yjbJ_predicted,0.1,9,9,CGCTCCGGATGAAGGGTCAA,0,5011146
yjbJ_predicted,0.1,9,9,CGCGTTTCCCGTGGAGGCGT,0,5010419
yjbJ_predicted,0.1,9,9,CGCGTTACGTCAGGCAAGGA,0,5017704
yjbJ_predicted,0.1,9,9,CGCGATTTGTGCTTAACGAT,0,5014951
yjbJ_predicted,0.1,9,9,CGCCAGCTTCGACGGACTAT,0,5016722
yjbJ_predicted,0.1,9,9,CGCACTATCGGCCTAATCGT,0,5030981
yjbJ_predicted,0.1,9,9,CGCACATTCCAGGAAACAAC,0,4999601
yjbJ_predicted,0.1,9,9,CGCAAATCGTAGCCCAGGTA,0,5024811
yjbJ_predicted,0.1,9,9,CGATTTTCTTATCTCCTAAG,0,5014868
yjbJ_predicted,0.1,9,9,CGATTAAGTTATGAGGATAA,0,5023480
yjbJ_predicted,0.1,9,9,CGAGGTCACGGCCCCATCAG,0,5030750
yjbJ_predicted,0.1,9,9,CGAGCCGTTGATCGGGTGGT,0,5020739
yjbJ_predicted,0.1,9,9,CGAAAACCCCGGTCAGGGAT,0,5016207
yjbJ_predicted,0.1,9,9,CCTGGTTCGGGTCTCTCCGC,0,5025964
yjbJ_predicted,0.1,9,9,CCGGGGGTCTGCTCGATTTC,0,5002153
yjbJ_predicted,0.1,9,9,CCGCAAAGATGTTAGGTCCT,0,5004320
yjbJ_predicted,0.1,9,9,CCGAGCAGATAGCGGTCTTG,0,5014485
yjbJ_predicted,0.1,9,9,CCCTGCATCGGAGCGAGCAT,0,5020792
yjbJ_predicted,0.1,9,9,CCCTCCGTTATAGGACTCGG,0,5006741
yjbJ_predicted,0.1,9,9,CCCGCTACACCGTGCGTGGT,0,5012864
yjbJ_predicted,0.1,9,9,CCCCCTCTCCGTCGGAGTCA,0,5012847
yjbJ_predicted,0.1,9,9,CCCCCTAGGCCGGTGTCACT,0,5007935
yjbJ_predicted,0.1,9,9,CCCCACGTCGTTCGTAAATA,0,4999512
yjbJ_predicted,0.1,9,9,CCCATGCCTGACAATCATAT,0,5009469
yjbJ_predicted,0.1,9,9,CCATTTTTTATTTGCCGCTA,0,4996488
yjbJ_predicted,0.1,9,9,CCATTAACTTAGCCGCGCAT,0,5013788
yjbJ_predicted,0.1,9,9,CCAGCTCATGCGTCTGGACG,0,5020681
yjbJ_predicted,0.1,9,9,CCACGCACGCGTAGGGACGC,0,5017088
yjbJ_predicted,0.1,9,9,CCAACGGCCCTGACACTGGT,0,5030015
yjbJ_predicted,0.1,9,9,CCAAACGAGTGTAAGTTCGA,0,5024642
yjbJ_predicted,0.1,9,9,CATGGAGGGGAGCCTTACAT,0,5008546
yjbJ_predicted,0.1,9,9,CATGAGGCCGTACTGGGGGT,0,5011659
yjbJ_predicted,0.1,9,9,CATGAGATATTTCACGATAT,0,5028202
yjbJ_predicted,0.1,9,9,CATCCATTTAGTTTAGGGAG,0,4998184
yjbJ_predicted,0.1,9,9,CATCAAAGTCTCGTCCGCAG,0,5017394
yjbJ_predicted,0.1,9,9,CATACGTCGGTTAAAAGCGT,0,5003281
yjbJ_predicted,0.1,9,9,CAGTCAGTCACCGTGTATGA,0,5018883
yjbJ_predicted,0.1,9,9,CAGGTCTATTTTCTGGGCAG,0,5018906
yjbJ_predicted,0.1,9,9,CAGGGGTTTGTCCACTGTTT,0,4998151
yjbJ_predicted,0.1,9,9,CAGGATGCATAAAGGCGTTA,0,5000361
yjbJ_predicted,0.1,9,9,CACTGTATTGGCTGTACCCG,0,5008027
yjbJ_predicted,0.1,9,9,CACTGGTCGTATGGTAATGC,0,5018525
yjbJ_predicted,0.1,9,9,CACTGATCCTTCACGGGTTA,0,5014432
yjbJ_predicted,0.1,9,9,CACCGTTTCTTAGCGGGTAG,0,5029915
yjbJ_predicted,0.1,9,9,CACAGAGGATACTGTGACAA,0,5007071
yjbJ_predicted,0.1,9,9,CACAAACCCGTTTAAGGCCT,0,5029369
yjbJ_predicted,0.1,9,9,CAATCAGTGTGTTCAATTCG,0,5021758
yjbJ_predicted,0.1,9,9,CAACATCAGCGACATGTTGC,0,5011238
yjbJ_predicted,0.1,9,9,CAACAACCCGCTTGTACTGG,0,4994689
yjbJ_predicted,0.1,9,9,ATTTTTGCGTAGCGATGTAA,0,5021435
yjbJ_predicted,0.1,9,9,ATTTCTGCGAGCCGTATGCT,0,4996840
yjbJ_predicted,0.1,9,9,ATTGGGGGGTGATCCAGTGT,0,5027276
yjbJ_predicted,0.1,9,9,ATTCCCTTCGTGTCATTTAA,0,5001450
yjbJ_predicted,0.1,9,9,ATTAGGCGCCTTCCACAAGC,0,5005577
yjbJ_predicted,0.1,9,9,ATGGCATGTAAGCATGTCCA,0,5009110
yjbJ_predicted,0.1,9,9,ATGCGCGGCAACGCCGGGGT,0,5010515
yjbJ_predicted,0.1,9,9,ATGCGCGAGTGATCTTGTGG,0,5001753
yjbJ_predicted,0.1,9,9,ATCGTAGCCTTGGAAACATC,0,5011953
yjbJ_predicted,0.1,9,9,ATCGCCACTTGAGTTACCGA,0,5019558
yjbJ_predicted,0.1,9,9,ATCGATAGGCTGGGGTTCAC,0,5022942
yjbJ_predicted,0.1,9,9,ATCGAAATCATAGAACGTTG,0,5015186
yjbJ_predicted,0.1,9,9,ATCCTCCTCAGGGGATGATA,0,4997859
yjbJ_predicted,0.1,9,9,ATATTATGCCCCAAAGTTAC,0,5005342
yjbJ_predicted,0.1,9,9,ATATGAGGGCAGTCAGTACA,0,5010042
yjbJ_predicted,0.1,9,9,ATAGGTTAAATCCCGGATAA,0,5010165
yjbJ_predicted,0.1,9,9,ATAGATTTAATCTGCTTGAA,0,4996843
yjbJ_predicted,0.1,9,9,ATACGATTCGTCAATAATAA,0,4998440
yjbJ_predicted,0.1,9,9,ATAAGTCTAGCAACCCCGGC,0,4994970
yjbJ_predicted,0.1,9,9,AGTTATCCCTTGGAACTTTT,0,5024987
yjbJ_predicted,0.1,9,9,AGTTAACTGCGGTAATATTT,0,4998431
yjbJ_predicted,0.1,9,9,AGTCCACGACCACCAAATTA,0,5016987
yjbJ_predicted,0.1,9,9,AGTCAGCTACCACTCTAAAA,0,4996951
yjbJ_predicted,0.1,9,9,AGTCAGAAGTACGTATCGCT,0,5015891
yjbJ_predicted,0.1,9,9,AGTCAAGATCGCAATAGTGT,0,5017239
yjbJ_predicted,0.1,9,9,AGTATAGGGGCGCATCGATG,0,5006140
yjbJ_predicted,0.1,9,9,AGGTTTACTGATACGGATTG,0,5015729
yjbJ_predicted,0.1,9,9,AGGTGTTGCGAGCCCGTCGT,0,4997317
yjbJ_predicted,0.1,9,9,AGGGCGCCTTCAGTGGATAT,0,5025373
yjbJ_predicted,0.1,9,9,AGGCTTCACGCCCCAATATG,0,5000141
yjbJ_predicted,0.1,9,9,AGGCTGGCAGCGGGCCGACC,0,4997815
yjbJ_predicted,0.1,9,9,AGGCGACGAATCCGCCGTGC,0,5018169
yjbJ_predicted,0.1,9,9,AGGAGAAAGGCCTTAGCTCC,0,5017712
yjbJ_predicted,0.1,9,9,AGGACGCACTACAATATCGC,0,5005119
yjbJ_predicted,0.1,9,9,AGCTGATAACCGGGAAATAT,0,5002025
yjbJ_predicted,0.1,9,9,AGCTCTTACTGGCATTTGAA,0,5016306
yjbJ_predicted,0.1,9,9,AGCGCGATACACGTATCTCT,0,5028044
yjbJ_predicted,0.1,9,9,AGCCTCCCCTGCCCCTCCCA,0,5023183
yjbJ_predicted,0.1,9,9,AGCCGTATGCCACTAATCTA,0,5006030
yjbJ_predicted,0.1,9,9,AGCATTCTAAGTAGCACGGC,0,5027238
yjbJ_predicted,0.1,9,9,AGCATACGTTCCTACAGGCG,0,5031158
yjbJ_predicted,0.1,9,9,AGATTAGTGTCTCCATGGCC,0,5003921
yjbJ_predicted,0.1,9,9,AGAGTGCTGTCCGCTCACAA,0,5011202
yjbJ_predicted,0.1,9,9,AGACTTAGCACTCTCGTTTG,0,5019885
yjbJ_predicted,0.1,9,9,AGACTCTCGGCAAGCTCGCG,0,4998789
yjbJ_predicted,0.1,9,9,AGACGTCGATTGTCACCCGG,0,5007676
yjbJ_predicted,0.1,9,9,AGACAGATCCAGTGTCCGCG,0,5002460
yjbJ_predicted,0.1,9,9,ACTTACAGGGGAAGCGGGAG,0,5009690
yjbJ_predicted,0.1,9,9,ACTCCTAAACGCGGTTATTA,0,5026112
yjbJ_predicted,0.1,9,9,ACTCCACCAAGGAGTCCGGT,0,5007129
yjbJ_predicted,0.1,9,9,ACTAAACGCTGCCGGCTCCT,0,5025284
yjbJ_predicted,0.1,9,9,ACGTCTACTGTGATTAAGAA,0,5007876
yjbJ_predicted,0.1,9,9,ACGTATCAGGCCTTCGTTTC,0,5024380
yjbJ_predicted,0.1,9,9,ACGGGAGTCTGCTACAATTG,0,5009020
yjbJ_predicted,0.1,9,9,ACGGCATCAATGTCCAGAAG,0,5009803
yjbJ_predicted,0.1,9,9,ACGGAAGGCGAAGACCGAGC,0,5006900
yjbJ_predicted,0.1,9,9,ACGGAACAAGAGTACGAAGC,0,5008183
yjbJ_predicted,0.1,9,9,ACGCAGCTTGCGTTAGAAGA,0,5023194
yjbJ_predicted,0.1,9,9,ACGACTGCTTCATTTGGTAA,0,5027406
yjbJ_predicted,0.1,9,9,ACCTGGCAGGATCGAAGTAG,0,5003811
yjbJ_predicted,0.1,9,9,ACCTAGTATTGGACATGGGA,0,5029692
yjbJ_predicted,0.1,9,9,ACCGTTCCCGATTACGAAGC,0,5023706
yjbJ_predicted,0.1,9,9,ACCGGGTTTTACACGGTGGG,0,4998484
yjbJ_predicted,0.1,9,9,ACCGGCTCCGGTCCTTGTCG,0,5018990
yjbJ_predicted,0.1,9,9,ACCGAGATTGAGACACTTAA,0,5001986
yjbJ_predicted,0.1,9,9,ACCCAGGGTGTATGAGGGCT,0,5026782
yjbJ_predicted,0.1,9,9,ACCATCTGATCCGGTAAGGC,0,5010622
yjbJ_predicted,0.1,9,9,ACATCTGGGTTGTGAAAGAA,0,5014509
yjbJ_predicted,0.1,9,9,ACAGTTCTTTAGATGCCATC,0,5023643
yjbJ_predicted,0.1,9,9,ACACCCGGCATTATGTACCT,0,5015947
yjbJ_predicted,0.1,9,9,ACAAGTGATGTATCGTCGTG,0,5030469
yjbJ_predicted,0.1,9,9,AATTTTAAGCGTAACATCAA,0,4999958
yjbJ_predicted,0.1,9,9,AATTGGTGTAGTTCCTGCGC,0,5017619
yjbJ_predicted,0.1,9,9,AATTAACAGGTTACATGCTT,0,5013485
yjbJ_predicted,0.1,9,9,AATGGTTATTGTGCAATACT,0,5009863
yjbJ_predicted,0.1,9,9,AATGCCGTCTTTCTGTATAA,0,4994983
yjbJ_predicted,0.1,9,9,AATCTTAGTTACATTATTAA,0,5002269
yjbJ_predicted,0.1,9,9,AAGTTTGTCACGACAGTGCG,0,5021475
yjbJ_predicted,0.1,9,9,AAGTGGGATCCAATCGTCCC,0,5029361
yjbJ_predicted,0.1,9,9,AAGTCAATAGGATCGTACTG,0,5019055
yjbJ_predicted,0.1,9,9,AAGATATGTTGAAATTGGAC,0,5003922
yjbJ_predicted,0.1,9,9,AAGAGGACTGACACACGGGT,0,5020595
yjbJ_predicted,0.1,9,9,AACTAAGTAGTTGTAGAAAT,0,5022407
yjbJ_predicted,0.1,9,9,AACGGCTCATCGTAACTTTT,0,4997766
yjbJ_predicted,0.1,9,9,AACGCCAGGAATTACCACGT,0,4998729
yjbJ_predicted,0.1,9,9,AACGACTTGACAAGGCACAT,0,5002544
yjbJ_predicted,0.1,9,9,AACCTGCTTTCCATGGACAT,0,5013840
yjbJ_predicted,0.1,9,9,AACATATATCGTAACCACGG,0,5029523
yjbJ_predicted,0.1,9,9,AAATAAGCTAATAAATAATA,0,5013754
yjbJ_predicted,0.1,9,9,AAACCTGGCGGCTCATTGCT,0,5005124
yjbJ_predicted,0.1,9,9,AAACAACGTATTACTCTCTT,0,4997649
yjbJ_predicted,0.1,9,9,AAAAGAATCCAGGATGTAGA,0,5005407
yjbJ_predicted,0.1111111111111111,8,8,TTTTGGCAAAGCGTGCGTCA,0,5010275
yjbJ_predicted,0.1111111111111111,8,8,TTTCCAGATGGAGGAATTAG,0,5004275
yjbJ_predicted,0.1111111111111111,8,8,TTTCACCGGTGGGCTGCGCT,0,5022995
yjbJ_predicted,0.1111111111111111,8,8,TTTATGGAAGGGCCGCAGAT,0,5011839
yjbJ_predicted,0.1111111111111111,8,8,TTTATCATAGACATTACAAT,0,5011692
yjbJ_predicted,0.1111111111111111,8,8,TTTAGACTAGCCAAGTCTTC,0,5028049
yjbJ_predicted,0.1111111111111111,8,8,TTGGCCCTTCCGTTGCAAGA,0,5021347
yjbJ_predicted,0.1111111111111111,8,8,TTGGCCCGGGATGATTTATG,0,5010047
yjbJ_predicted,0.1111111111111111,8,8,TTGGAAACCGACCTCAGATG,0,5019015
yjbJ_predicted,0.1111111111111111,8,8,TTGCGGGCGCCGTGCGTCAG,0,4999851
yjbJ_predicted,0.1111111111111111,8,8,TTGCGAATGGGCACACCTAC,0,4998087
yjbJ_predicted,0.1111111111111111,8,8,TTGACGCAGGCATTACCCTC,0,5002309
yjbJ_predicted,0.1111111111111111,8,8,TTCTCTAGGCCTTGCTGGCG,0,5019187
yjbJ_predicted,0.1111111111111111,8,8,TTCGTTTATAGTATTGGGGT,0,5025122
yjbJ_predicted,0.1111111111111111,8,8,TTCGGAACATCCCCTAACTC,0,5015648
yjbJ_predicted,0.1111111111111111,8,8,TTCGCATAAGCGGCCCAAAG,0,5007470
yjbJ_predicted,0.1111111111111111,8,8,TTCCGGATGGCGTGTCTCTT,0,4998481
yjbJ_predicted,0.1111111111111111,8,8,TTCCCTTTGATACCATAAGA,0,4994772
yjbJ_predicted,0.1111111111111111,8,8,TTCCCTTAGAACTCCGTCCC,0,4997039
yjbJ_predicted,0.1111111111111111,8,8,TTCAACCGCGGTCACTCATC,0,5006307
yjbJ_predicted,0.1111111111111111,8,8,TTAGGCTTACATAACGGATT,0,5004396
yjbJ_predicted,0.1111111111111111,8,8,TTAATTGAAACGCCGGCGAA,0,5029061
yjbJ_predicted,0.1111111111111111,8,8,TTAATTACATTAGTAGTCCA,0,5003896
yjbJ_predicted,0.1111111111111111,8,8,TTAAGCCGGAATGGGGAGTC,0,4997481
yjbJ_predicted,0.1111111111111111,8,8,TGTTGTTCAGGTAAGCGTCC,0,5025448
yjbJ_predicted,0.1111111111111111,8,8,TGTTCTGAGGAATAGGCCTA,0,5019587
yjbJ_predicted,0.1111111111111111,8,8,TGTGACATACGTCACATAAG,0,5020088
yjbJ_predicted,0.1111111111111111,8,8,TGTCCCTTCACCCTGAGCAG,0,5020653
yjbJ_predicted,0.1111111111111111,8,8,TGTAGACGTGCCTTGTTTCA,0,4998250
yjbJ_predicted,0.1111111111111111,8,8,TGTACGTAAGTCTTGCGTGT,0,5023214
yjbJ_predicted,0.1111111111111111,8,8,TGGTTCTGCCATGGAAATTG,0,5011904
yjbJ_predicted,0.1111111111111111,8,8,TGGTGTCGTAGATTTTCCGT,0,5019526
yjbJ_predicted,0.1111111111111111,8,8,TGGTCTTTAGTCGAACAGGG,0,5029733
yjbJ_predicted,0.1111111111111111,8,8,TGGGACCTACTAGGCTATCA,0,5015330
yjbJ_predicted,0.1111111111111111,8,8,TGGCCATGTAAACGAAATGG,0,4999053
yjbJ_predicted,0.1111111111111111,8,8,TGGACGAAGACCTCCAATGA,0,5002735
yjbJ_predicted,0.1111111111111111,8,8,TGGACAGACTTATCCTCATC,0,5010788
yjbJ_predicted,0.1111111111111111,8,8,TGCTCGGGCTGCCGTGAAGG,0,5026311
yjbJ_predicted,0.1111111111111111,8,8,TGCTAAAATTGGGAGAATAC,0,5015500
yjbJ_predicted,0.1111111111111111,8,8,TGCCCGCCGTTATATCTCAG,0,4998525
yjbJ_predicted,0.1111111111111111,8,8,TGCAGTTACTGGATCTACCT,0,5028855
yjbJ_predicted,0.1111111111111111,8,8,TGCACTCCATTCTCTGGCTC,0,5021855
yjbJ_predicted,0.1111111111111111,8,8,TGAGTGGCGCATAATGATAA,0,4996693
yjbJ_predicted,0.1111111111111111,8,8,TGAGTACTGAGCTAGAAAAT,0,5002715
yjbJ_predicted,0.1111111111111111,8,8,TGACGGTGTTGATACAGGTT,0,5008330
yjbJ_predicted,0.1111111111111111,8,8,TGACCCAGGACTCTCACGAG,0,5023423
yjbJ_predicted,0.1111111111111111,8,8,TCTGTTTAGCGGGGTCCTGT,0,5002796
yjbJ_predicted,0.1111111111111111,8,8,TCTGGTCTTATCAGATCTGT,0,5019692
yjbJ_predicted,0.1111111111111111,8,8,TCTCGAGGGCCGGTTCTTTC,0,5014309
yjbJ_predicted,0.1111111111111111,8,8,TCTACGGGAGTGCCATCGGC,0,5029493
yjbJ_predicted,0.1111111111111111,8,8,TCGTTCTGCTACTTACGACA,0,5018518
yjbJ_predicted,0.1111111111111111,8,8,TCGCGGGCAATATCGCCTGG,0,5021285
yjbJ_predicted,0.1111111111111111,8,8,TCGCCAACGCGTCCGGGGCG,0,5017726
yjbJ_predicted,0.1111111111111111,8,8,TCGCATTACGCGAAGTCTTA,0,5004011
yjbJ_predicted,0.1111111111111111,8,8,TCGACCAAATTTCACCATTA,0,5012044
yjbJ_predicted,0.1111111111111111,8,8,TCCGCTGACGCTTACTACCA,0,5000028
yjbJ_predicted,0.1111111111111111,8,8,TCCGACTTCCATGCGCACAC,0,5024918
yjbJ_predicted,0.1111111111111111,8,8,TCCCGATCTCATAATATAAG,0,4997275
yjbJ_predicted,0.1111111111111111,8,8,TCCCCGCATCCACGTGGCCA,0,5029787
yjbJ_predicted,0.1111111111111111,8,8,TCCAACCACCCTTTAAATCT,0,4998575
yjbJ_predicted,0.1111111111111111,8,8,TCATGTATTCTCCTGCATCT,0,4998273
yjbJ_predicted,0.1111111111111111,8,8,TCATGGAGTAAAGGGTGGGT,0,5003569
yjbJ_predicted,0.1111111111111111,8,8,TCATCATTCCTGTTAGCTAT,0,5029097
yjbJ_predicted,0.1111111111111111,8,8,TCAGCGCGCGTCCGGAGGTT,0,4998812
yjbJ_predicted,0.1111111111111111,8,8,TCACTTTCTGCCCAAGACGG,0,5018773
yjbJ_predicted,0.1111111111111111,8,8,TCACAGTGTTTTGGATGTAA,0,5003415
yjbJ_predicted,0.1111111111111111,8,8,TCAATGTGTGGCGGACGCTG,0,5006333
yjbJ_predicted,0.1111111111111111,8,8,TATTATCTCAGTTTGTAGTC,0,5017149
yjbJ_predicted,0.1111111111111111,8,8,TATTAGAACTCGAATGGTAT,0,5007077
yjbJ_predicted,0.1111111111111111,8,8,TATGTGGTAATACTAACTAC,0,5018885
yjbJ_predicted,0.1111111111111111,8,8,TATGTAGCTGAGGCATCGGA,0,5007020
yjbJ_predicted,0.1111111111111111,8,8,TATGGAGACATGGACTCAAC,0,5021821
yjbJ_predicted,0.1111111111111111,8,8,TATCTGCATCGAATGTGGGC,0,5029267
yjbJ_predicted,0.1111111111111111,8,8,TATCGGCCCGCGCGATATAG,0,5031052
yjbJ_predicted,0.1111111111111111,8,8,TATCCAGAAACGATGTCATT,0,4998540
yjbJ_predicted,0.1111111111111111,8,8,TATATTCTTTATCATTCTGA,0,5017626
yjbJ_predicted,0.1111111111111111,8,8,TATAGCTGGTCAGGGGGGAT,0,5007371
yjbJ_predicted,0.1111111111111111,8,8,TATAGATTGGGGTTCAACCA,0,5019967
yjbJ_predicted,0.1111111111111111,8,8,TAGGTTTCGCACGTTACACC,0,5025575
yjbJ_predicted,0.1111111111111111,8,8,TAGGATCGGTTCAGAACTAC,0,5009691
yjbJ_predicted,0.1111111111111111,8,8,TAGGACGGTCGTAGGCCTCA,0,5017843
yjbJ_predicted,0.1111111111111111,8,8,TAGCAAACGACGCATAGGCA,0,4995895
yjbJ_predicted,0.1111111111111111,8,8,TAGATTGGACTACCAGGTGG,0,5025042
yjbJ_predicted,0.1111111111111111,8,8,TACTTCTGTCGCGTACAGAC,0,5022280
yjbJ_predicted,0.1111111111111111,8,8,TACTGAAGCGATGCACTTCC,0,5027980
yjbJ_predicted,0.1111111111111111,8,8,TACTCCCCGTCGCCCACTGT,0,4998451
yjbJ_predicted,0.1111111111111111,8,8,TACTACAGTTACCAGTCCAA,0,5014450
yjbJ_predicted,0.1111111111111111,8,8,TACGGGCGACCTCCGACATG,0,5010276
yjbJ_predicted,0.1111111111111111,8,8,TACGGCTTCACCCGCCGTCC,0,5018451
yjbJ_predicted,0.1111111111111111,8,8,TACGAGCATGCCCAGCCAAG,0,5028854
yjbJ_predicted,0.1111111111111111,8,8,TACCTTGCTCTGCTTCTTTA,0,5011042
yjbJ_predicted,0.1111111111111111,8,8,TACCGCTAAGTTGGCCGCAG,0,5031066
yjbJ_predicted,0.1111111111111111,8,8,TACCAGGTACACAGGTGACC,0,5013486
yjbJ_predicted,0.1111111111111111,8,8,TAATCTGCTGATATGGCCCA,0,5014436
yjbJ_predicted,0.1111111111111111,8,8,TAATCAATACAGTTTGCATA,0,5019131
yjbJ_predicted,0.1111111111111111,8,8,TAATAGCACTTAGGTATAGC,0,5011043
yjbJ_predicted,0.1111111111111111,8,8,TAAGCCTTGGATTCTAAGGT,0,5002463
yjbJ_predicted,0.1111111111111111,8,8,TAAGATGGGTCTCCATATTG,0,5012642
yjbJ_predicted,0.1111111111111111,8,8,TAACCAATTAGCCGGGCTGA,0,5019096
yjbJ_predicted,0.1111111111111111,8,8,TAACATGGGTCTTAATGATA,0,5021915
yjbJ_predicted,0.1111111111111111,8,8,TAACATATCACAAGCGCTCT,0,5008358
yjbJ_predicted,0.1111111111111111,8,8,GTTGATACCGCCGGGGACCT,0,5029258
yjbJ_predicted,0.1111111111111111,8,8,GTTCTGATAACGTTAACTAA,0,5022606
yjbJ_predicted,0.1111111111111111,8,8,GTTCTCTGTTGTTCAAACCA,0,5008935
yjbJ_predicted,0.1111111111111111,8,8,GTTCCGTGCATCCATTTCCA,0,5018788
yjbJ_predicted,0.1111111111111111,8,8,GTGTATTCGAGTAGACGTAC,0,5019291
yjbJ_predicted,0.1111111111111111,8,8,GTGGGCTATAAAAGATCACT,0,5024137
yjbJ_predicted,0.1111111111111111,8,8,GTGCACTTGGTTCAACGAAT,0,5008643
yjbJ_predicted,0.1111111111111111,8,8,GTGACCATCTGCCAAAGCGA,0,5013121
yjbJ_predicted,0.1111111111111111,8,8,GTGACAAAGCGCAGTACTAC,0,5018095
yjbJ_predicted,0.1111111111111111,8,8,GTCTTAGTTGTCGCTTCGTA,0,5019759
yjbJ_predicted,0.1111111111111111,8,8,GTCGGGATAGTGCAGGAAGA,0,5006850
yjbJ_predicted,0.1111111111111111,8,8,GTCGGACTTCATTAACTCTG,0,5029686
yjbJ_predicted,0.1111111111111111,8,8,GTCATGGGGTAGTGAGCTTC,0,5027912
yjbJ_predicted,0.1111111111111111,8,8,GTCAGTGTAGCCTTCCTTGA,0,5011234
yjbJ_predicted,0.1111111111111111,8,8,GTACGGGGAGATAAATCCTC,0,5029373
yjbJ_predicted,0.1111111111111111,8,8,GTACCACTATCTTTCTCTTC,0,5027718
yjbJ_predicted,0.1111111111111111,8,8,GTAATGTGATTCGTCAAGCT,0,5002273
yjbJ_predicted,0.1111111111111111,8,8,GTAAATGCGGGACGTCACGA,0,5001993
yjbJ_predicted,0.1111111111111111,8,8,GGTTTTTCTGCGGACTGACT,0,5004136
yjbJ_predicted,0.1111111111111111,8,8,GGTTGAACTAGAACTGAGCA,0,5007379
yjbJ_predicted,0.1111111111111111,8,8,GGTTCCTATGTATCCTGTCT,0,5001436
yjbJ_predicted,0.1111111111111111,8,8,GGTGGACTCACAAATTATGT,0,5025984
yjbJ_predicted,0.1111111111111111,8,8,GGTCTGATCGTTAAAAATGG,0,5015931
yjbJ_predicted,0.1111111111111111,8,8,GGTCGTCACCTTTTACATAC,0,4996115
yjbJ_predicted,0.1111111111111111,8,8,GGTAGCTGAGTCGCGATTGT,0,5008310
yjbJ_predicted,0.1111111111111111,8,8,GGGTTTTAATAGCGAGTAAG,0,5001734
yjbJ_predicted,0.1111111111111111,8,8,GGGTTCTCTTGACTCTATAG,0,5008396
yjbJ_predicted,0.1111111111111111,8,8,GGGGTTCATTAGCCGCACAC,0,5024233
yjbJ_predicted,0.1111111111111111,8,8,GGGGTTATGTACGTCATGTA,0,5001558
yjbJ_predicted,0.1111111111111111,8,8,GGGGTCTACATCAATCAAAC,0,5019016
yjbJ_predicted,0.1111111111111111,8,8,GGGGTAATTAGGGGATACGC,0,5011706
yjbJ_predicted,0.1111111111111111,8,8,GGGGCAACTCCGCACAATCA,0,5012506
yjbJ_predicted,0.1111111111111111,8,8,GGGGACAAAGCAACAGTTCT,0,5001754
yjbJ_predicted,0.1111111111111111,8,8,GGCTGTGTCAGCAAATCAAA,0,5024552
yjbJ_predicted,0.1111111111111111,8,8,GGCTCGGTGTAGCCTGGGTG,0,5006209
yjbJ_predicted,0.1111111111111111,8,8,GGCGCGATGTGATTTGTTCT,0,5008688
yjbJ_predicted,0.1111111111111111,8,8,GGCGCCAAGGTCGCTGCGGC,0,5019744
yjbJ_predicted,0.1111111111111111,8,8,GGCACTGACCGGGGCCGCGA,0,5014023
yjbJ_predicted,0.1111111111111111,8,8,GGCAAATTTTTGAGGCACTA,0,5021591
yjbJ_predicted,0.1111111111111111,8,8,GGATACGCATGGGGGACCGT,0,5019346
yjbJ_predicted,0.1111111111111111,8,8,GGATAAGGATTAAGAAACGG,0,5000842
yjbJ_predicted,0.1111111111111111,8,8,GGAGAGGTGCCACGAGCCCT,0,5020420
yjbJ_predicted,0.1111111111111111,8,8,GGAGACCGCACGCATTTCGA,0,5017763
yjbJ_predicted,0.1111111111111111,8,8,GGAGAATTCATTCGAGGTTA,0,5026081
yjbJ_predicted,0.1111111111111111,8,8,GGACCCAGTGCAGCACCTGA,0,5005451
yjbJ_predicted,0.1111111111111111,8,8,GGACACGATCAGATGATACT,0,5004788
yjbJ_predicted,0.1111111111111111,8,8,GGAACTACGGAAATCGAACG,0,4994966
yjbJ_predicted,0.1111111111111111,8,8,GGAAAAAGCAAGATCCTAAT,0,5028584
yjbJ_predicted,0.1111111111111111,8,8,GGAAAAAGACTTTCTCCTCG,0,5023838
yjbJ_predicted,0.1111111111111111,8,8,GCTTTGACGCCATAGTGTCA,0,5012140
yjbJ_predicted,0.1111111111111111,8,8,GCTTTCGGCTCACAAAATTG,0,5023021
yjbJ_predicted,0.1111111111111111,8,8,GCTGTCCTAGGGTGTCTGGG,0,5030432
yjbJ_predicted,0.1111111111111111,8,8,GCTGTCACCAACGGTAGACT,0,5018758
yjbJ_predicted,0.1111111111111111,8,8,GCTGCATGGGCCTCAGATCC,0,4999678
yjbJ_predicted,0.1111111111111111,8,8,GCTACTCAAGAATGCTTGGT,0,4996742
yjbJ_predicted,0.1111111111111111,8,8,GCGGTCATTGGGCAGACGCA,0,5016852
yjbJ_predicted,0.1111111111111111,8,8,GCGGCCCGACCAGCCGGGGT,0,5006943
yjbJ_predicted,0.1111111111111111,8,8,GCGCGGGAGATCGATTATCT,0,4995561
yjbJ_predicted,0.1111111111111111,8,8,GCGCGCAATAGGGACACATT,0,5010923
yjbJ_predicted,0.1111111111111111,8,8,GCGACCACATGCTATCTCCT,0,5013857
yjbJ_predicted,0.1111111111111111,8,8,GCCGTTCGTGTCCACGCTAG,0,5010739
yjbJ_predicted,0.1111111111111111,8,8,GCCGTCACTATGCAGTCTCA,0,5023672
yjbJ_predicted,0.1111111111111111,8,8,GCCGCGTGTACCACAACGTT,0,5004012
yjbJ_predicted,0.1111111111111111,8,8,GCCCTTGCCCCGGTGTGCTT,0,5011500
yjbJ_predicted,0.1111111111111111,8,8,GCCCGCTACGGGAAGCTCTC,0,5023969
yjbJ_predicted,0.1111111111111111,8,8,GCCAATGCGGTAGGCAACGC,0,5003323
yjbJ_predicted,0.1111111111111111,8,8,GCATCTTAGCCGATATAGAC,0,5017099
yjbJ_predicted,0.1111111111111111,8,8,GCATAGCTGATGGTGAACGG,0,5022018
yjbJ_predicted,0.1111111111111111,8,8,GCAGGTAGCGATGGACTTTC,0,4995058
yjbJ_predicted,0.1111111111111111,8,8,GCAGAATATGTGTTGGTTGA,0,4995992
yjbJ_predicted,0.1111111111111111,8,8,GCAAATAATTTTCGGGCTGC,0,5007872
yjbJ_predicted,0.1111111111111111,8,8,GATTTATGTGTACTGTAAGG,0,5015533
yjbJ_predicted,0.1111111111111111,8,8,GATTTATGCATTAGACTATA,0,5030601
yjbJ_predicted,0.1111111111111111,8,8,GATTCGGCCGACCGCCTTTA,0,5023704
yjbJ_predicted,0.1111111111111111,8,8,GATACCGTAGAGTTCCGAAC,0,5024705
yjbJ_predicted,0.1111111111111111,8,8,GAGTCATCCGTACTTCAACA,0,5023137
yjbJ_predicted,0.1111111111111111,8,8,GAGGTGTATTAACCATGTGG,0,5029502
yjbJ_predicted,0.1111111111111111,8,8,GAGGGGGCACGAAAGTTTGG,0,4996579
yjbJ_predicted,0.1111111111111111,8,8,GAGGCCGTGTCGGAAACGGC,0,5012469
yjbJ_predicted,0.1111111111111111,8,8,GAGGAGGCCGATGTTGCGGA,0,5021218
yjbJ_predicted,0.1111111111111111,8,8,GAGAACAGGCGAGACCCACG,0,5024917
yjbJ_predicted,0.1111111111111111,8,8,GACTTATGTCCACCTCGGAA,0,4995470
yjbJ_predicted,0.1111111111111111,8,8,GACTGGAAGCAATCCTCGGA,0,4997041
yjbJ_predicted,0.1111111111111111,8,8,GACTGCCTTACATTATTCAT,0,5005253
yjbJ_predicted,0.1111111111111111,8,8,GACGTACCGCAGTAAACCGA,0,5000033
yjbJ_predicted,0.1111111111111111,8,8,GACATGCCAATCGCATAATC,0,4994856
yjbJ_predicted,0.1111111111111111,8,8,GAATGCGTCATGAACTGGGG,0,5000265
yjbJ_predicted,0.1111111111111111,8,8,GAATCGACATGCCCCATCAA,0,5019577
yjbJ_predicted,0.1111111111111111,8,8,GAAGTTTATCTGGTGTCGGT,0,5024027
yjbJ_predicted,0.1111111111111111,8,8,GAAGTTGTCCTGGAGCACTG,0,4999789
yjbJ_predicted,0.1111111111111111,8,8,GAAGTTCATCTTGGCCAGAT,0,4998934
yjbJ_predicted,0.1111111111111111,8,8,GAAGTAACGGCCCAATTGCC,0,5029449
yjbJ_predicted,0.1111111111111111,8,8,GAAGAGTATCCGGTTAAGAC,0,5027708
yjbJ_predicted,0.1111111111111111,8,8,GAACTATCTTTTTTTCTCTG,0,4998415
yjbJ_predicted,0.1111111111111111,8,8,GAAACGGAGCAAATGAGGTA,0,4997981
yjbJ_predicted,0.1111111111111111,8,8,CTTTCCCCTGCTTCTTGCCT,0,5006932
yjbJ_predicted,0.1111111111111111,8,8,CTTTCAGATTGACGACGAGA,0,4996422
yjbJ_predicted,0.1111111111111111,8,8,CTTCTGGTCAACCGTGCTAT,0,4995454
yjbJ_predicted,0.1111111111111111,8,8,CTTCTCATGCCATCCCAGAT,0,5011897
yjbJ_predicted,0.1111111111111111,8,8,CTTCGCTCACTCAAGACGTG,0,4999850
yjbJ_predicted,0.1111111111111111,8,8,CTTCCTAGGGCCAGCGGTCT,0,5021832
yjbJ_predicted,0.1111111111111111,8,8,CTTATAGGGGATACCTAGGT,0,4995438
yjbJ_predicted,0.1111111111111111,8,8,CTTAACGTTCCAAGGCAATG,0,5017584
yjbJ_predicted,0.1111111111111111,8,8,CTGTTTCATAATTTCTGGCA,0,4995275
yjbJ_predicted,0.1111111111111111,8,8,CTGGTAGAGGACGGCGATGG,0,5010213
yjbJ_predicted,0.1111111111111111,8,8,CTGCCTAGGTGTCAACGGCA,0,5018563
yjbJ_predicted,0.1111111111111111,8,8,CTGATCGGCTGATCGCCGTA,0,5024066
yjbJ_predicted,0.1111111111111111,8,8,CTGAATGATCTATTGACAGT,0,5026229
yjbJ_predicted,0.1111111111111111,8,8,CTCTTGTAGCGGAGAGATCT,0,4998872
yjbJ_predicted,0.1111111111111111,8,8,CTCTATAATTAAAATGTGGA,0,5007943
yjbJ_predicted,0.1111111111111111,8,8,CTCTACACAATAATAGCGAT,0,4998803
yjbJ_predicted,0.1111111111111111,8,8,CTCTAAAGGAGGGCGTGTTC,0,5012648
yjbJ_predicted,0.1111111111111111,8,8,CTCGCAAGGATGGTCACTGG,0,5031017
yjbJ_predicted,0.1111111111111111,8,8,CTATTTGTATGCTAAGCGTA,0,5013169
yjbJ_predicted,0.1111111111111111,8,8,CTATTGCCGGCAAAACTGAG,0,5021269
yjbJ_predicted,0.1111111111111111,8,8,CTATATAGAAGGCTTTGTTA,0,5007800
yjbJ_predicted,0.1111111111111111,8,8,CTATAGACACACTTTTCAGT,0,5017152
yjbJ_predicted,0.1111111111111111,8,8,CTACTACTGGCTAGCACCAC,0,5005175
yjbJ_predicted,0.1111111111111111,8,8,CTACCCCTAGTTTCAAAGGG,0,5007183
yjbJ_predicted,0.1111111111111111,8,8,CTACATGCGATCTCACGAAA,0,5025367
yjbJ_predicted,0.1111111111111111,8,8,CTACACTCTTTTTATGGTGT,0,5000505
yjbJ_predicted,0.1111111111111111,8,8,CTAAACCGACATCCTCGTCT,0,5009435
yjbJ_predicted,0.1111111111111111,8,8,CGTTAAACGCACAGCTTCTG,0,5013013
yjbJ_predicted,0.1111111111111111,8,8,CGTGCCTTCATTTATGAATT,0,5022934
yjbJ_predicted,0.1111111111111111,8,8,CGTGAGACGGCGGCTATCGT,0,5016905
yjbJ_predicted,0.1111111111111111,8,8,CGTGAACAGACAGGTCGTGG,0,5006561
yjbJ_predicted,0.1111111111111111,8,8,CGTAACAACGCTAAAGTAAG,0,5012657
yjbJ_predicted,0.1111111111111111,8,8,CGGTTCGCATGATCGACGAA,0,5003580
yjbJ_predicted,0.1111111111111111,8,8,CGGTGTCTACATATACGCGT,0,5022782
yjbJ_predicted,0.1111111111111111,8,8,CGGTGGTGAGCGTGGCTCGA,0,5008954
yjbJ_predicted,0.1111111111111111,8,8,CGGTACAGGTCCACATTATG,0,5003848
yjbJ_predicted,0.1111111111111111,8,8,CGGGGTGTGAGCGGCAACAA,0,4995887
yjbJ_predicted,0.1111111111111111,8,8,CGGGGCTCCGCCATTTTATT,0,5014913
yjbJ_predicted,0.1111111111111111,8,8,CGGGCTGACTGGGCGCTCAT,0,5020353
yjbJ_predicted,0.1111111111111111,8,8,CGGGAGGAGCAGTTAACGAA,0,5022095
yjbJ_predicted,0.1111111111111111,8,8,CGGCTGTGCGGCGAGTGACG,0,4995411
yjbJ_predicted,0.1111111111111111,8,8,CGGAGTGGCGGCAGTGGTCG,0,5022150
yjbJ_predicted,0.1111111111111111,8,8,CGGACTAACCGACCCAGTAC,0,4998435
yjbJ_predicted,0.1111111111111111,8,8,CGCTTGCTTTGGATTGGATT,0,5001530
yjbJ_predicted,0.1111111111111111,8,8,CGCTGGTCGTTTCCAGATAC,0,5007598
yjbJ_predicted,0.1111111111111111,8,8,CGCCTTATTGGACCATGACT,0,5001369
yjbJ_predicted,0.1111111111111111,8,8,CGCCTCCTAGACTGTGGCCA,0,5001690
yjbJ_predicted,0.1111111111111111,8,8,CGCCGGTCACCAGACAGCCT,0,5027404
yjbJ_predicted,0.1111111111111111,8,8,CGCAGCGTTCACGCCTATGG,0,5023077
yjbJ_predicted,0.1111111111111111,8,8,CGATAAGAGGTAGTGTAGCA,0,5028331
yjbJ_predicted,0.1111111111111111,8,8,CGAGGCGCCACTCCGGTCCC,0,5026205
yjbJ_predicted,0.1111111111111111,8,8,CGAGCATCTAAAGCGTCTCT,0,5028222
yjbJ_predicted,0.1111111111111111,8,8,CGAGAAAGGGTAGAGTGTGG,0,5029880
yjbJ_predicted,0.1111111111111111,8,8,CGACTCCATGCGATCACCAG,0,5014757
yjbJ_predicted,0.1111111111111111,8,8,CGACCGAATGTCTGTGCCGC,0,4995818
yjbJ_predicted,0.1111111111111111,8,8,CGAACCTCAGCATCGTATAC,0,5000525
yjbJ_predicted,0.1111111111111111,8,8,CCTTCGGCGATACACTCGAG,0,5030352
yjbJ_predicted,0.1111111111111111,8,8,CCTGTCTTTACGTCACAGTA,0,5020352
yjbJ_predicted,0.1111111111111111,8,8,CCTCGCTTGACACATGAGAT,0,5027575
yjbJ_predicted,0.1111111111111111,8,8,CCTCCAGGCAGCACCGGTCA,0,4996499
yjbJ_predicted,0.1111111111111111,8,8,CCTATCTTTACAGATAGCTT,0,4996285
yjbJ_predicted,0.1111111111111111,8,8,CCTAGAAAATAATGATACAT,0,5003373
yjbJ_predicted,0.1111111111111111,8,8,CCGGGCAAGGTATTACTTGT,0,4994721
yjbJ_predicted,0.1111111111111111,8,8,CCGCTTTGTATATCAAAGTA,0,5007674
yjbJ_predicted,0.1111111111111111,8,8,CCGAGCCCAATCAATACCAC,0,4995053
yjbJ_predicted,0.1111111111111111,8,8,CCGAAAAGTGCCAACCTTCA,0,5028417
yjbJ_predicted,0.1111111111111111,8,8,CCCTGCTTCTACACCTACGA,0,4998310
yjbJ_predicted,0.1111111111111111,8,8,CCCTAATAGGGTGGATTCAT,0,5010465
yjbJ_predicted,0.1111111111111111,8,8,CCCTAAGGGTAGTGCTTCGC,0,5001943
yjbJ_predicted,0.1111111111111111,8,8,CCCCATTAGAATCCGTTGCA,0,5017560
yjbJ_predicted,0.1111111111111111,8,8,CCCCACCCCATATTCACCCT,0,5018487
yjbJ_predicted,0.1111111111111111,8,8,CCCAGACCTGCGCTGACTTC,0,5013503
yjbJ_predicted,0.1111111111111111,8,8,CCCACATTCATTACCTTTGA,0,5005490
yjbJ_predicted,0.1111111111111111,8,8,CCATTTGCCTCTCCAATATA,0,5013108
yjbJ_predicted,0.1111111111111111,8,8,CCAGTTCGTTTAGTAGTTTG,0,5012754
yjbJ_predicted,0.1111111111111111,8,8,CCAGTCAGCCACTGCTATGT,0,4994960
yjbJ_predicted,0.1111111111111111,8,8,CCAGGTCGCGGTAAGGTGGA,0,5030141
yjbJ_predicted,0.1111111111111111,8,8,CCAGCCGGCTGGTCGCAGGA,0,5019848
yjbJ_predicted,0.1111111111111111,8,8,CCAGAGTCCCCTGGGAAGGA,0,5012136
yjbJ_predicted,0.1111111111111111,8,8,CCACCGTGTACAAGTTTTCC,0,5028294
yjbJ_predicted,0.1111111111111111,8,8,CCACCGTCCGGATTCTTGTA,0,5020008
yjbJ_predicted,0.1111111111111111,8,8,CCACCGGTGTATCCCCGAGC,0,5017057
yjbJ_predicted,0.1111111111111111,8,8,CCACATGCCGTATATCTTGT,0,5012824
yjbJ_predicted,0.1111111111111111,8,8,CATTGCCCCACGCTAGAGGG,0,5020409
yjbJ_predicted,0.1111111111111111,8,8,CATCGCAAAAGAGTAATGGG,0,5000677
yjbJ_predicted,0.1111111111111111,8,8,CATCCACAGCACTATCATTA,0,4995681
yjbJ_predicted,0.1111111111111111,8,8,CAGTTGGCGCGCCCCGACAC,0,5007157
yjbJ_predicted,0.1111111111111111,8,8,CAGTAGTCCAATTAAATTTA,0,5004214
yjbJ_predicted,0.1111111111111111,8,8,CAGGCACGTCACGAGATTCA,0,5018603
yjbJ_predicted,0.1111111111111111,8,8,CAGCACTTCGAGCATTAGTG,0,5002556
yjbJ_predicted,0.1111111111111111,8,8,CAGACCGACGTTAGTTGACT,0,5019194
yjbJ_predicted,0.1111111111111111,8,8,CACGTTTTCGACCATAATCA,0,5005770
yjbJ_predicted,0.1111111111111111,8,8,CACGGCGTACCGTGGTAGTA,0,5023864
yjbJ_predicted,0.1111111111111111,8,8,CACGCACCAGTTAACCGTGT,0,5002236
yjbJ_predicted,0.1111111111111111,8,8,CACCGAGTGCGTCGCTCTAC,0,5031306
yjbJ_predicted,0.1111111111111111,8,8,CACCCCTCACGATAGAGTGT,0,5012800
yjbJ_predicted,0.1111111111111111,8,8,CACCCATTCTGGCTCGCCGA,0,5024092
yjbJ_predicted,0.1111111111111111,8,8,CACACAGAAGACAAGGGCAT,0,5028673
yjbJ_predicted,0.1111111111111111,8,8,CAATGCTTAGTTCAAGGAGT,0,5028343
yjbJ_predicted,0.1111111111111111,8,8,CAAGAGGGACCAGCTTAGGG,0,4996385
yjbJ_predicted,0.1111111111111111,8,8,CAACCGGTATCATGTTTAAT,0,5016124
yjbJ_predicted,0.1111111111111111,8,8,CAAAGTGTTGTAGTCTCTCC,0,4995827
yjbJ_predicted,0.1111111111111111,8,8,CAAAAGATAAGTCATAACGA,0,5028284
yjbJ_predicted,0.1111111111111111,8,8,ATTTTAACATCGATCCGTGA,0,5016426
yjbJ_predicted,0.1111111111111111,8,8,ATTTCGATACAATTTTGTAG,0,4996187
yjbJ_predicted,0.1111111111111111,8,8,ATTTCCCCCCGTAGGCTTGC,0,4996196
yjbJ_predicted,0.1111111111111111,8,8,ATTTACACGCGATGTCCGGG,0,5011645
yjbJ_predicted,0.1111111111111111,8,8,ATTGTTTCTTCTTCTGGTAG,0,5013243
yjbJ_predicted,0.1111111111111111,8,8,ATTGTTCATACCTCTTGGAT,0,5017786
yjbJ_predicted,0.1111111111111111,8,8,ATTGTGATTTTAGACTCCGC,0,4997830
yjbJ_predicted,0.1111111111111111,8,8,ATTGGCGCTGCCGCCACCTA,0,5013387
yjbJ_predicted,0.1111111111111111,8,8,ATTGGCGCAGCAAGTGAATA,0,5009586
yjbJ_predicted,0.1111111111111111,8,8,ATTGCTTTATTACAGGAATG,0,5029769
yjbJ_predicted,0.1111111111111111,8,8,ATTCGAATGCCACGAGGTAC,0,5020355
yjbJ_predicted,0.1111111111111111,8,8,ATTACCGGTTGCGAGTGTTC,0,5008566
yjbJ_predicted,0.1111111111111111,8,8,ATGTCGAGTGTCGGGCCTAA,0,4998488
yjbJ_predicted,0.1111111111111111,8,8,ATGGAAACCCAAGTCGGATG,0,5029139
yjbJ_predicted,0.1111111111111111,8,8,ATGCTTTTTTATACATAGCT,0,4998281
yjbJ_predicted,0.1111111111111111,8,8,ATGCCAAGCCTTAACAGATC,0,5017812
yjbJ_predicted,0.1111111111111111,8,8,ATGCAAGCGCACCGGAAATA,0,4999373
yjbJ_predicted,0.1111111111111111,8,8,ATCTTTGGGGGCTAGACCCC,0,4996758
yjbJ_predicted,0.1111111111111111,8,8,ATCTTACCAAGCTTAATTAC,0,5003579
yjbJ_predicted,0.1111111111111111,8,8,ATCGGTTCCCGAGTTGGCAG,0,4996722
yjbJ_predicted,0.1111111111111111,8,8,ATCGACAGTGTTAATATGGG,0,5027154
yjbJ_predicted,0.1111111111111111,8,8,ATCGAATTAAAGTGTGCTCG,0,5014221
yjbJ_predicted,0.1111111111111111,8,8,ATCCCTGTAATAATCCCACA,0,4995057
yjbJ_predicted,0.1111111111111111,8,8,ATCAAAGACCCCGAAAACCC,0,5015409
yjbJ_predicted,0.1111111111111111,8,8,ATACTGCTATTGGTGACGTA,0,5001081
yjbJ_predicted,0.1111111111111111,8,8,ATACCATGCTGGGGGTCCTA,0,5015276
yjbJ_predicted,0.1111111111111111,8,8,ATAATTACAGGGTCAAGCCC,0,5004499
yjbJ_predicted,0.1111111111111111,8,8,ATAATGCAACATATAGTAAC,0,5009478
yjbJ_predicted,0.1111111111111111,8,8,ATAACTAGAAATTTACATAC,0,5022667
yjbJ_predicted,0.1111111111111111,8,8,AGTTATCACAACAATATTAC,0,5028897
yjbJ_predicted,0.1111111111111111,8,8,AGTTAATGCTACAATGCCAC,0,5018236
yjbJ_predicted,0.1111111111111111,8,8,AGTGTACTACTCAATTCTGC,0,5029308
yjbJ_predicted,0.1111111111111111,8,8,AGTGGTTGGAGTCTGAGGTA,0,5015670
yjbJ_predicted,0.1111111111111111,8,8,AGTAGAGTCCGGGGAAGCTT,0,5021802
yjbJ_predicted,0.1111111111111111,8,8,AGTACCTGTGCTCATACGGG,0,5004873
yjbJ_predicted,0.1111111111111111,8,8,AGTAATGCTGAATACTTACA,0,5006073
yjbJ_predicted,0.1111111111111111,8,8,AGTAAATATAGTCCGGTATA,0,4997386
yjbJ_predicted,0.1111111111111111,8,8,AGGGAGAGCCGGGAAACCAA,0,5015313
yjbJ_predicted,0.1111111111111111,8,8,AGGGACAAGGCTGCCAGGCC,0,5021739
yjbJ_predicted,0.1111111111111111,8,8,AGGGAACAACCACGTGATGT,0,5018234
yjbJ_predicted,0.1111111111111111,8,8,AGGAGCCTGAGTGCAACTCA,0,5019805
yjbJ_predicted,0.1111111111111111,8,8,AGGACTAGCATATGCTACAT,0,5015074
yjbJ_predicted,0.1111111111111111,8,8,AGGAACCACCATAAGTCGGC,0,5021053
yjbJ_predicted,0.1111111111111111,8,8,AGCTTACAATCCGCTTGTAG,0,5001093
yjbJ_predicted,0.1111111111111111,8,8,AGCTCGTAAGGCTAGCGGAT,0,5014098
yjbJ_predicted,0.1111111111111111,8,8,AGCTAACCCCCCTGTCTGCA,0,5030658
yjbJ_predicted,0.1111111111111111,8,8,AGCGCTAAGGCGATTTGTGT,0,4999927
yjbJ_predicted,0.1111111111111111,8,8,AGCCGCACGCACGCTATCAA,0,5001938
yjbJ_predicted,0.1111111111111111,8,8,AGCATATTGGATACTGGCGG,0,5002554
yjbJ_predicted,0.1111111111111111,8,8,AGATTAATCGGCACAATAAT,0,5029298
yjbJ_predicted,0.1111111111111111,8,8,AGATCTAAATTAATCGCTAG,0,5025671
yjbJ_predicted,0.1111111111111111,8,8,AGATAATGGAGATCAGCGTG,0,4999136
yjbJ_predicted,0.1111111111111111,8,8,AGAGCGGGCGACTCTCGCCC,0,5021877
yjbJ_predicted,0.1111111111111111,8,8,AGAGAGTATACACACGAAAG,0,5025542
yjbJ_predicted,0.1111111111111111,8,8,AGACCCGGTGCGGCTACTAC,0,5010424
yjbJ_predicted,0.1111111111111111,8,8,AGACACGCCCTTAAGGGGAA,0,4998899
yjbJ_predicted,0.1111111111111111,8,8,AGAAGCGTAACTTGTCCCTT,0,5025206
yjbJ_predicted,0.1111111111111111,8,8,AGAAACGTAATGGGTGTCAG,0,5022335
yjbJ_predicted,0.1111111111111111,8,8,ACTGGTAATGGGATGATTGG,0,5000800
yjbJ_predicted,0.1111111111111111,8,8,ACTGATTACCTCTCTCCCAC,0,5022016
yjbJ_predicted,0.1111111111111111,8,8,ACTGAAACACCGGTGAGACG,0,5004535
yjbJ_predicted,0.1111111111111111,8,8,ACTCCAACACTGTCGAAGAT,0,5013897
yjbJ_predicted,0.1111111111111111,8,8,ACTCACGAGGTTGATCGGCT,0,5025782
yjbJ_predicted,0.1111111111111111,8,8,ACTATCTCGATGATCGCTAC,0,5023902
yjbJ_predicted,0.1111111111111111,8,8,ACTATCAAAAGGGTCAATGA,0,5001730
yjbJ_predicted,0.1111111111111111,8,8,ACGGTAGTATCCAACGTAGC,0,5023878
yjbJ_predicted,0.1111111111111111,8,8,ACGCCATTTAACGTAGTCGT,0,5012228
yjbJ_predicted,0.1111111111111111,8,8,ACGACTGCTCTGATAAACTT,0,5011386
yjbJ_predicted,0.1111111111111111,8,8,ACGAACTTGGCCCCCGGTTA,0,5005452
yjbJ_predicted,0.1111111111111111,8,8,ACCTGTCTAGGATCAGCGGC,0,5022682
yjbJ_predicted,0.1111111111111111,8,8,ACCTCGGCGCGCACAGATGG,0,5014489
yjbJ_predicted,0.1111111111111111,8,8,ACCGGCCTACAGGTTCCCTT,0,5022415
yjbJ_predicted,0.1111111111111111,8,8,ACCGAGCCTGAAATATCGCG,0,5004167
yjbJ_predicted,0.1111111111111111,8,8,ACCCGTAAGTGGGCTTGTCG,0,5021205
yjbJ_predicted,0.1111111111111111,8,8,ACCCCCCGCATAGTCACATC,0,5017621
yjbJ_predicted,0.1111111111111111,8,8,ACCAGTCAGTCTGGTTATGG,0,5004996
yjbJ_predicted,0.1111111111111111,8,8,ACCAATCAGGGGGTAGTAGT,0,5001344
yjbJ_predicted,0.1111111111111111,8,8,ACAGTTGGAACGCTCATCAA,0,5000738
yjbJ_predicted,0.1111111111111111,8,8,ACAGCTCCTATACCAGAAGT,0,5004032
yjbJ_predicted,0.1111111111111111,8,8,ACAGAATGCTAAGGACCCCC,0,4996107
yjbJ_predicted,0.1111111111111111,8,8,ACACATGACAGACAATCATA,0,5030599
yjbJ_predicted,0.1111111111111111,8,8,ACAATGTAGCAATCCGCCCT,0,5001395
yjbJ_predicted,0.1111111111111111,8,8,ACAATCGTCGTCTTTCGTAG,0,4995007
yjbJ_predicted,0.1111111111111111,8,8,ACAAGTAGATCGATGATTTT,0,5018127
yjbJ_predicted,0.1111111111111111,8,8,AATTATTGCGGAGGTCCAAT,0,5004673
yjbJ_predicted,0.1111111111111111,8,8,AATGTTTCCGTTCTATCGAT,0,5003918
yjbJ_predicted,0.1111111111111111,8,8,AATGCGCAGGAGACGGAAGG,0,5019040
yjbJ_predicted,0.1111111111111111,8,8,AATGCGAGATATAATAGGTC,0,5020692
yjbJ_predicted,0.1111111111111111,8,8,AATCCACTAATGCTGCGCGA,0,5022921
yjbJ_predicted,0.1111111111111111,8,8,AATCCACCTTGTTGGCCGAG,0,5009809
yjbJ_predicted,0.1111111111111111,8,8,AATAGGATGCGATGTTGGTC,0,5018832
yjbJ_predicted,0.1111111111111111,8,8,AAGTGCTAGGCCCATCAGGA,0,5009801
yjbJ_predicted,0.1111111111111111,8,8,AAGGTGCCGGGTCTGGTGCT,0,5004323
yjbJ_predicted,0.1111111111111111,8,8,AAGCTGTCTAGCGCTCTTCC,0,5005682
yjbJ_predicted,0.1111111111111111,8,8,AACTTACCTCTTCGAGGAGA,0,5021237
yjbJ_predicted,0.1111111111111111,8,8,AACGGTAAATCAAATATCGG,0,4997187
yjbJ_predicted,0.1111111111111111,8,8,AACGGGTTCTTCGCCGATTA,0,5007997
yjbJ_predicted,0.1111111111111111,8,8,AACGCTCTGCTGTAGCATTC,0,5030451
yjbJ_predicted,0.1111111111111111,8,8,AACGCAGGACTAGCTCGCTT,0,5029742
yjbJ_predicted,0.1111111111111111,8,8,AACGCAACTGTTATTGCGCC,0,4997319
yjbJ_predicted,0.1111111111111111,8,8,AACGACTAGCCGTACCGTTG,0,4995852
yjbJ_predicted,0.1111111111111111,8,8,AACCGGTCTTCATGTCGATT,0,5028401
yjbJ_predicted,0.1111111111111111,8,8,AAATCATTTGGGAGATCTAA,0,5017958
yjbJ_predicted,0.1111111111111111,8,8,AAAGGGTCAACATCCGCCCC,0,5004732
yjbJ_predicted,0.1111111111111111,8,8,AAAACACACGTGATAGACAA,0,5011734
yjbJ_predicted,0.125,7,7,TTTTCTCTTGCCGCTTTTCA,0,5019538
yjbJ_predicted,0.125,7,7,TTTTATGGGACCCTACCGAT,0,5030816
yjbJ_predicted,0.125,7,7,TTTGAGATAGTCAACAGGCG,0,5005431
yjbJ_predicted,0.125,7,7,TTTGACTGTCTTCGCCCAAT,0,5005088
yjbJ_predicted,0.125,7,7,TTTCGAATCCCCGTGTAACC,0,5008993
yjbJ_predicted,0.125,7,7,TTTCGAACGTCACGGTACTA,0,5016263
yjbJ_predicted,0.125,7,7,TTTATGATTGAATAAGCCAC,0,5027499
yjbJ_predicted,0.125,7,7,TTTAGTGACCGATGCCGAAA,0,5012342
yjbJ_predicted,0.125,7,7,TTTAGGTCACGATTGGACCG,0,5005141
yjbJ_predicted,0.125,7,7,TTTAGACATGCAGTCTTCTA,0,5027665
yjbJ_predicted,0.125,7,7,TTTACGTCTGGTCCACATTG,0,5009753
yjbJ_predicted,0.125,7,7,TTGGATGATTAGTAGCGGCA,0,5016678
yjbJ_predicted,0.125,7,7,TTGCTGGAGTTCAATTTTTG,0,5006356
yjbJ_predicted,0.125,7,7,TTGCCGGCGACAAATCGCCG,0,4996362
yjbJ_predicted,0.125,7,7,TTGATCACGCGCGTATCTAC,0,5022970
yjbJ_predicted,0.125,7,7,TTGAAGTCAGCCGCACGGAG,0,5013535
yjbJ_predicted,0.125,7,7,TTCGATTTTCATGCTTGGAG,0,5013173
yjbJ_predicted,0.125,7,7,TTCCCTCGCCGGGTAACCTG,0,5013256
yjbJ_predicted,0.125,7,7,TTCCATATCGGATAAGCAGC,0,5011750
yjbJ_predicted,0.125,7,7,TTCCAGTACGCCGGCGTCAC,0,5020945
yjbJ_predicted,0.125,7,7,TTATATTATTGTCGAACGCT,0,4996929
yjbJ_predicted,0.125,7,7,TTATATGCCAGGGGGGTTGC,0,5014212
yjbJ_predicted,0.125,7,7,TTAGACTGTTTGGAAACACT,0,4995379
yjbJ_predicted,0.125,7,7,TTACCGTTCCAGGACCAGGA,0,5006517
yjbJ_predicted,0.125,7,7,TTAATTTGCGCGCATTTTAT,0,5013989
yjbJ_predicted,0.125,7,7,TTAATATTTGTGTGTTCCCG,0,5025993
yjbJ_predicted,0.125,7,7,TTAATACCTTACGCTCTCAA,0,5014512
yjbJ_predicted,0.125,7,7,TTAAAGGGATGCATGGAAGG,0,4997308
yjbJ_predicted,0.125,7,7,TTAAAATTAATGCGCGTGTC,0,5023653
yjbJ_predicted,0.125,7,7,TGTTCGCCTTTGTCAATTAC,0,5008718
yjbJ_predicted,0.125,7,7,TGTGTGGTAGCTGGGTGCTC,0,5007563
yjbJ_predicted,0.125,7,7,TGTCTAAGGGATTGGCACCT,0,5001866
yjbJ_predicted,0.125,7,7,TGTCGGGGGGATTCCCGTGA,0,5009788
yjbJ_predicted,0.125,7,7,TGTCCGACCCTCTAGTCTCA,0,4999504
yjbJ_predicted,0.125,7,7,TGTCATCTGCGTTTTACGCA,0,5016989
yjbJ_predicted,0.125,7,7,TGTCACCACCCGAAAGAAGC,0,5011495
yjbJ_predicted,0.125,7,7,TGTACAACCGTCACGAGTAA,0,5000843
yjbJ_predicted,0.125,7,7,TGGTAGCGTGTCTCATGCGT,0,5011198
yjbJ_predicted,0.125,7,7,TGGTACCCTTAGCAAAGATT,0,5025316
yjbJ_predicted,0.125,7,7,TGGGTACTACGCAGGCCGGA,0,5024520
yjbJ_predicted,0.125,7,7,TGGGCAGATCCTGACGGTAA,0,5002337
yjbJ_predicted,0.125,7,7,TGGCTCTGGGCCGGGGCTAA,0,5028320
yjbJ_predicted,0.125,7,7,TGGCAGTATAAGGCTGACAT,0,5029318
yjbJ_predicted,0.125,7,7,TGGCAACGGGTTGCAACACC,0,4998354
yjbJ_predicted,0.125,7,7,TGGAGTATCTGCACCAACCC,0,5025879
yjbJ_predicted,0.125,7,7,TGCTGCCTATTATAGTATAA,0,4996801
yjbJ_predicted,0.125,7,7,TGCTCGCGGAAAGCTATGCG,0,5030259
yjbJ_predicted,0.125,7,7,TGCGATGGTCTACGTGGTGG,0,5019831
yjbJ_predicted,0.125,7,7,TGCCAGCCTTTTCCAATGGT,0,5000789
yjbJ_predicted,0.125,7,7,TGATTTCAACTGATACAGCA,0,5006945
yjbJ_predicted,0.125,7,7,TGAGCTATTTTCCCCCCTGT,0,4996685
yjbJ_predicted,0.125,7,7,TGAGAGTCATTGCGGCGTCC,0,4995770
yjbJ_predicted,0.125,7,7,TGAGACCCATTTACACAATA,0,5010200
yjbJ_predicted,0.125,7,7,TGACTCTATACGTTCCCTAC,0,5002364
yjbJ_predicted,0.125,7,7,TGACGCCGCATTGATACAAT,0,5023922
yjbJ_predicted,0.125,7,7,TGACCCCGGATACAGGCTCA,0,5013310
yjbJ_predicted,0.125,7,7,TGACCATCATGGGTTTACTG,0,4996483
yjbJ_predicted,0.125,7,7,TGACAACATTAGTCTGTGTT,0,5016947
yjbJ_predicted,0.125,7,7,TGAATGGTGGGAGCCCTACA,0,5015100
yjbJ_predicted,0.125,7,7,TGAAAAGGTTTGAGTTCACG,0,5021143
yjbJ_predicted,0.125,7,7,TCTTACGGTCATCTAAGAGT,0,5005676
yjbJ_predicted,0.125,7,7,TCTTAAGTGTAGTACACGAT,0,5014467
yjbJ_predicted,0.125,7,7,TCTGGAGTTGCTGTCAAGGC,0,5029842
yjbJ_predicted,0.125,7,7,TCTGCACAACAGACAAGAAG,0,5030721
yjbJ_predicted,0.125,7,7,TCTGAACAGGTTACACGATA,0,5012076
yjbJ_predicted,0.125,7,7,TCTCTGATATAAGACGTTGG,0,5011749
yjbJ_predicted,0.125,7,7,TCTCGGGAACTGAGCTCTTT,0,5025853
yjbJ_predicted,0.125,7,7,TCTATGGTCGGCTTGTGAGA,0,5027229
yjbJ_predicted,0.125,7,7,TCTACTGCGTAATAGGGACA,0,5024394
yjbJ_predicted,0.125,7,7,TCGTACTGATGCTACTTTAC,0,5018237
yjbJ_predicted,0.125,7,7,TCGTAATGCCATTTTAACGA,0,5012421
yjbJ_predicted,0.125,7,7,TCGGGGGTAACGAGGATCAG,0,5008960
yjbJ_predicted,0.125,7,7,TCGGCCAATATAGAGAACGT,0,5029066
yjbJ_predicted,0.125,7,7,TCGGAGCTGTTTATGATGCA,0,4996773
yjbJ_predicted,0.125,7,7,TCGCCACCACCGGCGTGAGG,0,4997226
yjbJ_predicted,0.125,7,7,TCCTTTCAGAGTGAGACAAT,0,5013516
yjbJ_predicted,0.125,7,7,TCCTAGTCTATCCAGCAATA,0,5006674
yjbJ_predicted,0.125,7,7,TCCTACATTTCGTCACCCTC,0,5009886
yjbJ_predicted,0.125,7,7,TCCGGAATAAACGGTGCCCG,0,5008601
yjbJ_predicted,0.125,7,7,TCCCTTTTCAGACCGGGTCT,0,5018519
yjbJ_predicted,0.125,7,7,TCCCTAAGTGCCGTTAGATC,0,5015550
yjbJ_predicted,0.125,7,7,TCCCGTATCTAGACCCATAG,0,5030186
yjbJ_predicted,0.125,7,7,TCCATCCTACGCTGATGCAA,0,5014462
yjbJ_predicted,0.125,7,7,TCCACCTGCTATCAATGCGT,0,4995394
yjbJ_predicted,0.125,7,7,TCATTATCTTGAAAACGTAC,0,5015211
yjbJ_predicted,0.125,7,7,TCATGGACCCATCGCTCGTA,0,5001906
yjbJ_predicted,0.125,7,7,TCAGTAGGACACTCCGTAGG,0,5015328
yjbJ_predicted,0.125,7,7,TCAGCGTGTGGGTGGCCGCG,0,5012763
yjbJ_predicted,0.125,7,7,TCACGTCCAAAGACAATGTT,0,5021498
yjbJ_predicted,0.125,7,7,TATGACACGACGTCTGCTGC,0,5030016
yjbJ_predicted,0.125,7,7,TATCGTTTCTGCAGGGCGTT,0,4997629
yjbJ_predicted,0.125,7,7,TATCGCAGACACGGCGCTTT,0,5010887
yjbJ_predicted,0.125,7,7,TATCATGGTGTGCCGTCACC,0,4999057
yjbJ_predicted,0.125,7,7,TATCACCCGAACGAGATGCC,0,5028972
yjbJ_predicted,0.125,7,7,TAGTCGTTAAACTCAGAACT,0,4996709
yjbJ_predicted,0.125,7,7,TAGGTCCCTGTTTCCACCAT,0,5013529
yjbJ_predicted,0.125,7,7,TAGGGGGGTTGAAAAGTGTG,0,5015474
yjbJ_predicted,0.125,7,7,TAGGCTATTCATAGGGCCGA,0,5022785
yjbJ_predicted,0.125,7,7,TAGCTCTTCCTGCCGGCATT,0,5020609
yjbJ_predicted,0.125,7,7,TAGCCGCGCTTTACTAGGTC,0,4997372
yjbJ_predicted,0.125,7,7,TAGAGTATCCCGGGGGGTAT,0,5028131
yjbJ_predicted,0.125,7,7,TAGACCTGGTACCTTTAATT,0,5029721
yjbJ_predicted,0.125,7,7,TACTGGCCTTCCGGTTCACT,0,5017965
yjbJ_predicted,0.125,7,7,TACCTTCCTTACAGTTCGGG,0,5028635
yjbJ_predicted,0.125,7,7,TACCGATACAGGTTATGTAA,0,5020585
yjbJ_predicted,0.125,7,7,TACATTCACCGCAGATAACG,0,5003850
yjbJ_predicted,0.125,7,7,TACAAGGTGGAGAGAGCGCA,0,4995129
yjbJ_predicted,0.125,7,7,TAATTGACACTATTGCGCTG,0,5029766
yjbJ_predicted,0.125,7,7,TAAGCTCTGGCCAAACGGAC,0,5001230
yjbJ_predicted,0.125,7,7,TAACGCGGGAGTTCTAGGTA,0,5011991
yjbJ_predicted,0.125,7,7,TAACACGTGTCAACCAGTGT,0,5029301
yjbJ_predicted,0.125,7,7,TAAATAGCTTTCGCACCGCG,0,5011930
yjbJ_predicted,0.125,7,7,TAAACGTACGGGTCAGCTTT,0,5025800
yjbJ_predicted,0.125,7,7,TAAAAGACCAACTCCGGGAG,0,5011245
yjbJ_predicted,0.125,7,7,GTTGTTCGCGACACAGTTGG,0,5005218
yjbJ_predicted,0.125,7,7,GTTGCAGAGTCATTAGCGGT,0,5019226
yjbJ_predicted,0.125,7,7,GTTGAACGCGAGGCGCATTC,0,5027905
yjbJ_predicted,0.125,7,7,GTTGAAAAAGAGTTCATACA,0,5031058
yjbJ_predicted,0.125,7,7,GTTCGGTCATCAAGTAGATT,0,5004118
yjbJ_predicted,0.125,7,7,GTTCCAGCGGTGGTGATTCC,0,5029078
yjbJ_predicted,0.125,7,7,GTTATTAGTCTCAGCATTGA,0,5014513
yjbJ_predicted,0.125,7,7,GTTATATGTCAACTAAAGAA,0,5013250
yjbJ_predicted,0.125,7,7,GTTAGGGCGTAAATATAAAA,0,5005360
yjbJ_predicted,0.125,7,7,GTTAATACGCAAGTTTAATG,0,5029757
yjbJ_predicted,0.125,7,7,GTTAACTCGCTGGTAATCCA,0,5001345
yjbJ_predicted,0.125,7,7,GTGTACGTTTTCACACAGCC,0,5010529
yjbJ_predicted,0.125,7,7,GTGGCTGAGTTGGGATCCGT,0,4997279
yjbJ_predicted,0.125,7,7,GTGGCAGGCCAGTAGAACTG,0,5013356
yjbJ_predicted,0.125,7,7,GTGCCTAGTAGTGCTCTCTG,0,5023270
yjbJ_predicted,0.125,7,7,GTGCAGTGAAATAGTTTATC,0,4997296
yjbJ_predicted,0.125,7,7,GTGCAGAGCGGCCACCAGTC,0,5015476
yjbJ_predicted,0.125,7,7,GTGCAGACAGCTGATCTCCA,0,4995390
yjbJ_predicted,0.125,7,7,GTCGACGACAGCCCGGTGGA,0,4996775
yjbJ_predicted,0.125,7,7,GTCCCAACAGGTGTGCGTTT,0,5006143
yjbJ_predicted,0.125,7,7,GTCCAGCGTTGGGGGGTCGC,0,5017557
yjbJ_predicted,0.125,7,7,GTCCAGCCAGTTAAGGTTCA,0,5019251
yjbJ_predicted,0.125,7,7,GTAGTCAATGATCACAGCGT,0,5015204
yjbJ_predicted,0.125,7,7,GTACTCGGGACGGCCCTAGT,0,5026881
yjbJ_predicted,0.125,7,7,GTACGTGCTTAACGGTAAAA,0,4997761
yjbJ_predicted,0.125,7,7,GTAAATGCTTAGAGTATCGG,0,5024952
yjbJ_predicted,0.125,7,7,GGTTGGTAAGGTAAACAGGG,0,5026436
yjbJ_predicted,0.125,7,7,GGTTGGGCCGAAGGTAATCG,0,5009544
yjbJ_predicted,0.125,7,7,GGTTGGCTAAGAAGTAACAC,0,5012479
yjbJ_predicted,0.125,7,7,GGTTGGATTTTCATAATGCA,0,5021301
yjbJ_predicted,0.125,7,7,GGTTATGGCACTGTCAAGAG,0,5003378
yjbJ_predicted,0.125,7,7,GGTCTTCAGCAATTGTTCGT,0,5010573
yjbJ_predicted,0.125,7,7,GGTCTATCAGTGTACTGCTA,0,5006003
yjbJ_predicted,0.125,7,7,GGTATGGCATTAAGTCGGAG,0,5015343
yjbJ_predicted,0.125,7,7,GGTACGCCGGGTCCGCCTTG,0,5021830
yjbJ_predicted,0.125,7,7,GGGTTTTTGGCGGGACTAAA,0,5018413
yjbJ_predicted,0.125,7,7,GGGTTTACCACGGCCACAAA,0,5025479
yjbJ_predicted,0.125,7,7,GGGTTGGTCGAACGGTTCAA,0,5007681
yjbJ_predicted,0.125,7,7,GGGTTAACTTACTTTCAGCC,0,5000209
yjbJ_predicted,0.125,7,7,GGGTGCCAGGTGTATTGCAG,0,4998180
yjbJ_predicted,0.125,7,7,GGGTGATAGTAACGGTCCAA,0,4995772
yjbJ_predicted,0.125,7,7,GGGTGACGCGCAGGCAGAGG,0,5019670
yjbJ_predicted,0.125,7,7,GGGTGAACCCAGTGGCCAGT,0,5017620
yjbJ_predicted,0.125,7,7,GGGTATACAACATCGCAATA,0,5028398
yjbJ_predicted,0.125,7,7,GGGTAAATCACCCTAACACA,0,5002877
yjbJ_predicted,0.125,7,7,GGGGACTGATTCACGCCCCA,0,5011046
yjbJ_predicted,0.125,7,7,GGGCTGGATATCTTAGAACT,0,5018147
yjbJ_predicted,0.125,7,7,GGGCGAATAGCATTACGAAT,0,5021391
yjbJ_predicted,0.125,7,7,GGGCAGGACTGTAGTACTGA,0,5022404
yjbJ_predicted,0.125,7,7,GGGATTTGTGCAGTTTAACG,0,4999084
yjbJ_predicted,0.125,7,7,GGGAGTCATGGGTACATAAC,0,5030305
yjbJ_predicted,0.125,7,7,GGGAGAAAAGTGGGGCCTGA,0,5029262
yjbJ_predicted,0.125,7,7,GGGACTTCTCCATGAGGCTT,0,5024197
yjbJ_predicted,0.125,7,7,GGCTGTTTCATAAACGGGAA,0,5013141
yjbJ_predicted,0.125,7,7,GGCTGGGCCGATGGCGCCTC,0,5018061
yjbJ_predicted,0.125,7,7,GGCACCATCGACGGGTTGAA,0,5028362
yjbJ_predicted,0.125,7,7,GGCACACTAGCAACCGTTAA,0,5014219
yjbJ_predicted,0.125,7,7,GGCACAATTCTACAAACTAG,0,5006181
yjbJ_predicted,0.125,7,7,GGCAAGGCACCTGGCCCGCG,0,5012929
yjbJ_predicted,0.125,7,7,GGATCCATTCCGGATGTATC,0,5011619
yjbJ_predicted,0.125,7,7,GGATACGGGCTATTATGGCC,0,5025658
yjbJ_predicted,0.125,7,7,GGAGGATTAGTCCATAAATC,0,5007809
yjbJ_predicted,0.125,7,7,GGAGACAGCAGGATCATTTT,0,5006343
yjbJ_predicted,0.125,7,7,GGAGAATCCTGTTGGCAAGT,0,5018539
yjbJ_predicted,0.125,7,7,GGAATCGCACGCCCGCTCTT,0,5002262
yjbJ_predicted,0.125,7,7,GGAAGTGCTCCTAGGGATAA,0,5006963
yjbJ_predicted,0.125,7,7,GGAACGCATTTTTACAACTG,0,5003423
yjbJ_predicted,0.125,7,7,GCTGTGATTCCGACAAGGCA,0,5010483
yjbJ_predicted,0.125,7,7,GCTGCGCCAACGAGAAACCG,0,5009965
yjbJ_predicted,0.125,7,7,GCTCTCTGGCCCTCCATTTC,0,5009184
yjbJ_predicted,0.125,7,7,GCTCTCGTTACTCGTAACAT,0,5025561
yjbJ_predicted,0.125,7,7,GCTCGTACTTTGATGCGCAT,0,5013654
yjbJ_predicted,0.125,7,7,GCTATAGCTCCAGCACGGCC,0,5005607
yjbJ_predicted,0.125,7,7,GCTAGTTACAAACTTTAGGG,0,5026581
yjbJ_predicted,0.125,7,7,GCTACACTCATACTAATCAT,0,5022164
yjbJ_predicted,0.125,7,7,GCTACACGCCTATTGGCAGC,0,5024820
yjbJ_predicted,0.125,7,7,GCGTTTTTAAAAAAGTCTTA,0,5014527
yjbJ_predicted,0.125,7,7,GCGTAGCATGCTTTGTGCAA,0,5008802
yjbJ_predicted,0.125,7,7,GCGTAATCCCTGGACATCCA,0,5007672
yjbJ_predicted,0.125,7,7,GCGCTTATGGAGGCAGCAAA,0,5012176
yjbJ_predicted,0.125,7,7,GCGCTCTGTAGAACATAATG,0,4995427
yjbJ_predicted,0.125,7,7,GCGCGACGTCAGAACGCAAA,0,5026256
yjbJ_predicted,0.125,7,7,GCGCCAATGGCTAGGAAAGG,0,4998002
yjbJ_predicted,0.125,7,7,GCCTTTGCCGAATGACATAT,0,5006863
yjbJ_predicted,0.125,7,7,GCCTGAGATCCAGAAGTTAA,0,5027197
yjbJ_predicted,0.125,7,7,GCCAGTGGAGTGGAGTCAGA,0,5027873
yjbJ_predicted,0.125,7,7,GCCAATGTTAAGTCCTCGGG,0,5024239
yjbJ_predicted,0.125,7,7,GCATGGGCCAGGAAATAGAA,0,5002747
yjbJ_predicted,0.125,7,7,GCATATTGTCGGGTTTATGC,0,5008425
yjbJ_predicted,0.125,7,7,GCATATCGCCTAAAATGCTT,0,5001346
yjbJ_predicted,0.125,7,7,GCATAGCGGGGTTAATACTA,0,5005150
yjbJ_predicted,0.125,7,7,GCAGGCCGCCTTATCGTTGA,0,5016254
yjbJ_predicted,0.125,7,7,GCAGGAGAGTGCGTGAGAAC,0,5002401
yjbJ_predicted,0.125,7,7,GCACGCACGGACCTGGGTGT,0,5019205
yjbJ_predicted,0.125,7,7,GCACGAAATGAGATAACTAT,0,5020231
yjbJ_predicted,0.125,7,7,GCACATCGTCGGCAGACCGC,0,5017269
yjbJ_predicted,0.125,7,7,GCAATGTGTCGTACAACCTT,0,5024386
yjbJ_predicted,0.125,7,7,GCAAGATATTGTGTCAGGGT,0,5001925
yjbJ_predicted,0.125,7,7,GATTGTAACAGCGATCACAA,0,5020838
yjbJ_predicted,0.125,7,7,GATTCGCTGATACCCCCAAC,0,5019714
yjbJ_predicted,0.125,7,7,GATGTGTCCGAGGTCCAGGG,0,4999246
yjbJ_predicted,0.125,7,7,GATGTGACGGTGCAGGCTTC,0,5009061
yjbJ_predicted,0.125,7,7,GATGTGACCACCATCAATTA,0,5006414
yjbJ_predicted,0.125,7,7,GATCGATCGCACTTCGACTT,0,4998755
yjbJ_predicted,0.125,7,7,GATATTTTTGACTGGCACGA,0,5018891
yjbJ_predicted,0.125,7,7,GATATCATTAGGGCCACGGA,0,4997733
yjbJ_predicted,0.125,7,7,GATAGTGGCCGGTCCCTAAT,0,5019683
yjbJ_predicted,0.125,7,7,GATAGACCCGGTCTTCAAGT,0,5024526
yjbJ_predicted,0.125,7,7,GAGTTTGATAACTGAAATAA,0,4997886
yjbJ_predicted,0.125,7,7,GAGTCGTAGCCTAATACAAC,0,5008227
yjbJ_predicted,0.125,7,7,GAGGTTAGTCTAGCGCTATC,0,5025650
yjbJ_predicted,0.125,7,7,GAGGGTCACATCAGCCCCTC,0,5020782
yjbJ_predicted,0.125,7,7,GAGCTGCCGCTCTCGAGTAA,0,5003305
yjbJ_predicted,0.125,7,7,GAGATGCCGTTCCACTCCCA,0,5018895
yjbJ_predicted,0.125,7,7,GAGACAAACATCTGCAAGGT,0,4996683
yjbJ_predicted,0.125,7,7,GACTTGTCGTCTCTAGTAGG,0,5011720
yjbJ_predicted,0.125,7,7,GACTCTAAACAAGCCTTGGT,0,5026387
yjbJ_predicted,0.125,7,7,GACGAAGGACGCATTGTCAA,0,4995675
yjbJ_predicted,0.125,7,7,GACCGCACCATCAGGCCAGG,0,4995455
yjbJ_predicted,0.125,7,7,GACCATTTTTCATAGCTAAT,0,5010445
yjbJ_predicted,0.125,7,7,GAATGTAGGCTTAATATACT,0,4999900
yjbJ_predicted,0.125,7,7,GAATGGGACGAGCGACGGAT,0,5009708
yjbJ_predicted,0.125,7,7,GAATAACGACAGCTCCATTC,0,4997917
yjbJ_predicted,0.125,7,7,GAAGTCCCAAGATTAGGAAT,0,4998147
yjbJ_predicted,0.125,7,7,GAAGGTCCGGTTGTGTGGTT,0,5025072
yjbJ_predicted,0.125,7,7,GAAGACGATTCGTCTTCGGG,0,5002087
yjbJ_predicted,0.125,7,7,GAAGAATTTATAATGGTGCT,0,4998051
yjbJ_predicted,0.125,7,7,GAAAGAGCGGGTTCACAGTA,0,4999904
yjbJ_predicted,0.125,7,7,GAAACATCCGATCGGTGGAC,0,5010253
yjbJ_predicted,0.125,7,7,GAAACAATTGTCCGAGCCCG,0,5016456
yjbJ_predicted,0.125,7,7,GAAAACTGCCACGGTTAGCG,0,5007727
yjbJ_predicted,0.125,7,7,CTTTTTCAATCCCTTACGGA,0,5009441
yjbJ_predicted,0.125,7,7,CTTTGGTCCAAGCAAATTAC,0,5015291
yjbJ_predicted,0.125,7,7,CTTGAGGGCGCTTGGTGGAA,0,5019740
yjbJ_predicted,0.125,7,7,CTTGACTGAGCATTTAAAAG,0,5029072
yjbJ_predicted,0.125,7,7,CTTCCAGTTAATGTGAAAAG,0,5000074
yjbJ_predicted,0.125,7,7,CTTACCATCACCTAAATTTT,0,4999111
yjbJ_predicted,0.125,7,7,CTGTTTACTCTTACGTAACA,0,5012241
yjbJ_predicted,0.125,7,7,CTGTGAATTGGGATCGCATG,0,5013741
yjbJ_predicted,0.125,7,7,CTGGCGTGAGTTTCCGCACA,0,5018597
yjbJ_predicted,0.125,7,7,CTGGACTACCGCGTTTACTT,0,5029406
yjbJ_predicted,0.125,7,7,CTGCTCGCCCGTGTCGGCAT,0,5014431
yjbJ_predicted,0.125,7,7,CTGCTCCGTAAGATTCCTAC,0,5001282
yjbJ_predicted,0.125,7,7,CTGCGCCTGCCGCAATCCCA,0,5005399
yjbJ_predicted,0.125,7,7,CTGCCAGCAGAAATATACGG,0,4996602
yjbJ_predicted,0.125,7,7,CTGATTTACGGTCCATCGTT,0,5016672
yjbJ_predicted,0.125,7,7,CTGACGCCGTGTATACATCT,0,5006443
yjbJ_predicted,0.125,7,7,CTCCTTGGTCTTCACTGGGA,0,5020652
yjbJ_predicted,0.125,7,7,CTCATCGCGTGCAGTTCCGC,0,5015584
yjbJ_predicted,0.125,7,7,CTCATAAGGTGATGTATCTT,0,5015265
yjbJ_predicted,0.125,7,7,CTCAGTATTATATCGCGCAT,0,5008012
yjbJ_predicted,0.125,7,7,CTAGGATTGAAAATTAAGCT,0,5001930
yjbJ_predicted,0.125,7,7,CTAATTGTTTATGGGCGGCT,0,5023677
yjbJ_predicted,0.125,7,7,CTAAGGCTTCCGTCGCAGCG,0,5006411
yjbJ_predicted,0.125,7,7,CTAAGGCTTAGGAGAGCCTC,0,5017656
yjbJ_predicted,0.125,7,7,CGTTTGAGAAGTTGCAGCGT,0,5020530
yjbJ_predicted,0.125,7,7,CGTTTCACAAGTCCGGTCAC,0,4998485
yjbJ_predicted,0.125,7,7,CGTTTAACGGTCTTCATGGA,0,5022961
yjbJ_predicted,0.125,7,7,CGTTGTAGACTACGGATGTT,0,5023353
yjbJ_predicted,0.125,7,7,CGTTACGACGGAGCGTCTAT,0,5004558
yjbJ_predicted,0.125,7,7,CGTGTTGTAAGTAGGAAAAG,0,5003110
yjbJ_predicted,0.125,7,7,CGTGTTAAGATGCCAGAGAG,0,5027334
yjbJ_predicted,0.125,7,7,CGTGCGCCACGGAGTCGCAA,0,5005039
yjbJ_predicted,0.125,7,7,CGTGAGACAACGGCCTCTTC,0,4998360
yjbJ_predicted,0.125,7,7,CGTCTGGGCGGTTCAGAGAA,0,4997079
yjbJ_predicted,0.125,7,7,CGTCGGAGCGAGACGTCATA,0,4997719
yjbJ_predicted,0.125,7,7,CGTCCTACGTGATCGGGAAA,0,4998442
yjbJ_predicted,0.125,7,7,CGTCATCATCCGTACTTCAC,0,5025366
yjbJ_predicted,0.125,7,7,CGTATTAAGAGTTATCATAC,0,5015893
yjbJ_predicted,0.125,7,7,CGTATCCATCCCCGATGAGT,0,5011350
yjbJ_predicted,0.125,7,7,CGTATAGGTGGTAATCAGCG,0,5029794
yjbJ_predicted,0.125,7,7,CGGTTTCCGACGAATGACGC,0,5019388
yjbJ_predicted,0.125,7,7,CGGTCTTTGGTACGCTGGCG,0,5003725
yjbJ_predicted,0.125,7,7,CGGGTCTCACGTAAGGAGTT,0,5007346
yjbJ_predicted,0.125,7,7,CGGGGTGCAGGTACAGGGGT,0,5025477
yjbJ_predicted,0.125,7,7,CGGGGAGAAATTTTTGGGGA,0,5017485
yjbJ_predicted,0.125,7,7,CGGGCAACGTTAACCTGTAG,0,5019862
yjbJ_predicted,0.125,7,7,CGGCTGTGTGTATCAACAAA,0,5010526
yjbJ_predicted,0.125,7,7,CGGCTATGTTGTCCCGTCTA,0,4997059
yjbJ_predicted,0.125,7,7,CGGCCCTTAAAGTGCAAGTA,0,5003669
yjbJ_predicted,0.125,7,7,CGGATGAGCCAGCCACTACC,0,5028610
yjbJ_predicted,0.125,7,7,CGGACCAAAGTCGTTACTGG,0,5022569
yjbJ_predicted,0.125,7,7,CGGAACGGTATTGAATTGGG,0,5005855
yjbJ_predicted,0.125,7,7,CGCTTACTATCTGTGTTACG,0,5017251
yjbJ_predicted,0.125,7,7,CGCTGGTATCGTGGTAATTG,0,5023266
yjbJ_predicted,0.125,7,7,CGCCTGCCGTGTGTTGTGAG,0,5007000
yjbJ_predicted,0.125,7,7,CGCCACCGCATCAAAAGATC,0,5023819
yjbJ_predicted,0.125,7,7,CGCATTAACACAAGCCGTAC,0,5017139
yjbJ_predicted,0.125,7,7,CGCAGTGTGACCTCGGCGTT,0,5027564
yjbJ_predicted,0.125,7,7,CGCAGACATTACTAAAGCTC,0,5005882
yjbJ_predicted,0.125,7,7,CGATTGGTTCGCCGGTGGCC,0,5000075
yjbJ_predicted,0.125,7,7,CGATACTCTGTCAACAGTGA,0,5021772
yjbJ_predicted,0.125,7,7,CGATACAGGTGCTAATCTAT,0,5000032
yjbJ_predicted,0.125,7,7,CGATAAAGCGGGTGACAGAA,0,5001155
yjbJ_predicted,0.125,7,7,CGACGATCAGCAGGGGCAGG,0,5015245
yjbJ_predicted,0.125,7,7,CCTTTCTATCGTTAAGAAGA,0,5020805
yjbJ_predicted,0.125,7,7,CCTGCCGAGCGCGTTGTAGG,0,4997594
yjbJ_predicted,0.125,7,7,CCTCCGAACTATAAGTGGTC,0,5014435
yjbJ_predicted,0.125,7,7,CCTATCACACGGAAGTAATC,0,4997680
yjbJ_predicted,0.125,7,7,CCTACCACCAACGTTGCATC,0,5024719
yjbJ_predicted,0.125,7,7,CCGTTGGTTCCGGACTATCA,0,4996401
yjbJ_predicted,0.125,7,7,CCGTATTGGGAATGAACTAT,0,5012899
yjbJ_predicted,0.125,7,7,CCGTAGTTAGAAGTCCGTTT,0,5012887
yjbJ_predicted,0.125,7,7,CCGTACCCTCTTAACATGCA,0,5006305
yjbJ_predicted,0.125,7,7,CCGGTTGATTATACCTAGCT,0,5006245
yjbJ_predicted,0.125,7,7,CCGGCGAGGTTACGTGGTTA,0,5004607
yjbJ_predicted,0.125,7,7,CCGCGACTGGCCGAGGGCTA,0,5026973
yjbJ_predicted,0.125,7,7,CCGATACCCACAGGCGTAGG,0,5011855
yjbJ_predicted,0.125,7,7,CCGACCTCCGACATTATATA,0,4998696
yjbJ_predicted,0.125,7,7,CCGAAGGCGTAATGTGCCGA,0,5011503
yjbJ_predicted,0.125,7,7,CCCTTCTCTTTTGCAAGAAG,0,4998709
yjbJ_predicted,0.125,7,7,CCCGAGGTCTCGACTTAGTT,0,5029268
yjbJ_predicted,0.125,7,7,CCCCGTTGAGAATAAAAGAG,0,5029601
yjbJ_predicted,0.125,7,7,CCCATTTAAGCGATCATCGA,0,5002704
yjbJ_predicted,0.125,7,7,CCCAGTGTTAGTAGACGGCG,0,4999882
yjbJ_predicted,0.125,7,7,CCACTCTCAGGCGTTACTTG,0,5007628
yjbJ_predicted,0.125,7,7,CCACACAATCAACGAATAAT,0,5029775
yjbJ_predicted,0.125,7,7,CCAATAAGACTCTGGAGTCT,0,5003093
yjbJ_predicted,0.125,7,7,CCAAGTGGTCACCTCAAAAC,0,5021750
yjbJ_predicted,0.125,7,7,CATTTCAGACCAGCGCGAAA,0,5016032
yjbJ_predicted,0.125,7,7,CATTGGGGCTGCATTTAAAC,0,5000817
yjbJ_predicted,0.125,7,7,CATTGCTCACTAGCATCAGG,0,5023836
yjbJ_predicted,0.125,7,7,CATTGAGCTAATAGGCTTAT,0,5002188
yjbJ_predicted,0.125,7,7,CATTCTTACTCCAGAAACGA,0,5003034
yjbJ_predicted,0.125,7,7,CATTCTCGACGGACTTGTGC,0,5013226
yjbJ_predicted,0.125,7,7,CATTCGAATCTATAGGCGCA,0,5010265
yjbJ_predicted,0.125,7,7,CATGTTCCTTTTATTCTCGC,0,5010690
yjbJ_predicted,0.125,7,7,CATGGGATTACATAAATCCG,0,5010604
yjbJ_predicted,0.125,7,7,CATCAAAGAGCGATGTTCAG,0,5028105
yjbJ_predicted,0.125,7,7,CATATTCCGGTTGATAACGG,0,5020338
yjbJ_predicted,0.125,7,7,CATATACGCGTCGGTGGAGC,0,5011025
yjbJ_predicted,0.125,7,7,CATATAACGCGTTTTTGTGT,0,5026025
yjbJ_predicted,0.125,7,7,CAGTTCGATGGGCGCTTCAA,0,5010509
yjbJ_predicted,0.125,7,7,CAGTGAACAGTTCATGGACC,0,4995368
yjbJ_predicted,0.125,7,7,CAGTATTATTCGCCCTGCCA,0,5009060
yjbJ_predicted,0.125,7,7,CAGTAAAAGTTTGGGAGGTG,0,5023031
yjbJ_predicted,0.125,7,7,CAGGTATCATCACTGGGGTC,0,5026884
yjbJ_predicted,0.125,7,7,CAGGTAACACCCGCTGGGAA,0,5004790
yjbJ_predicted,0.125,7,7,CAGCCACCTGTCCTTTGTCT,0,5007398
yjbJ_predicted,0.125,7,7,CAGCAGCGGTTAGAAGCAAC,0,5014861
yjbJ_predicted,0.125,7,7,CAGAGGGACATTTGGTGGTT,0,5016904
yjbJ_predicted,0.125,7,7,CACGAGAGTAACGGGATCAC,0,5003898
yjbJ_predicted,0.125,7,7,CACCTCCGTGGCGGCGAGTT,0,4995932
yjbJ_predicted,0.125,7,7,CACATCTGTCGCTAGCGAAT,0,5010434
yjbJ_predicted,0.125,7,7,CAATTTCTGGCCGAACACTC,0,5001424
yjbJ_predicted,0.125,7,7,CAATTCTTAATGGGGACGAG,0,4998902
yjbJ_predicted,0.125,7,7,CAAGGCATGCGTGCTAATCC,0,5026978
yjbJ_predicted,0.125,7,7,CAACGACTAACGAGATCATG,0,5011772
yjbJ_predicted,0.125,7,7,CAACACAGCATCGAGAGAAG,0,4996715
yjbJ_predicted,0.125,7,7,ATTGGCGGCTATGGTAGCGG,0,5029957
yjbJ_predicted,0.125,7,7,ATTGACTCAGTAATAATCTG,0,4995991
yjbJ_predicted,0.125,7,7,ATTCGACTCTCATCTGCGAG,0,5013859
yjbJ_predicted,0.125,7,7,ATTCCATGTGCACCAGCCTC,0,5009879
yjbJ_predicted,0.125,7,7,ATTATAAAGTTTCATCGTGT,0,5027895
yjbJ_predicted,0.125,7,7,ATTAGTCCTCCCTGTTAACG,0,5019954
yjbJ_predicted,0.125,7,7,ATGTGCGTGTACCTGAGAGT,0,5019147
yjbJ_predicted,0.125,7,7,ATGTCCCATAGTAGGCTTGA,0,5009093
yjbJ_predicted,0.125,7,7,ATGTAGGCGCTATGTAGGCA,0,5005250
yjbJ_predicted,0.125,7,7,ATGGTGCCTGAGTGCCTTTT,0,5000747
yjbJ_predicted,0.125,7,7,ATGGCCAACAAACCCGTCTC,0,5020559
yjbJ_predicted,0.125,7,7,ATGGAACCGGAAGTCTAGTT,0,5018821
yjbJ_predicted,0.125,7,7,ATGACAGGGAACCTCGACTA,0,5007406
yjbJ_predicted,0.125,7,7,ATCTATTCGCTGACTCAGCC,0,5023924
yjbJ_predicted,0.125,7,7,ATCGGTTATTACGAAGGTCC,0,5008564
yjbJ_predicted,0.125,7,7,ATCGCTCGGCGTCCTTTAGT,0,4998301
yjbJ_predicted,0.125,7,7,ATCCTTCTAGTGAGTAGATG,0,5023164
yjbJ_predicted,0.125,7,7,ATCCTAAATTGTGAAAATAA,0,5023417
yjbJ_predicted,0.125,7,7,ATCACACGGACGTTGTCGGA,0,4998214
yjbJ_predicted,0.125,7,7,ATATTTTAGGCGCTCGGAAT,0,5017896
yjbJ_predicted,0.125,7,7,ATATTCAGCAGGAGCCTGAT,0,5013461
yjbJ_predicted,0.125,7,7,ATATCTAGGCGATCTCTGAA,0,5026981
yjbJ_predicted,0.125,7,7,ATATCATAGAGTTACTAAAT,0,5004159
yjbJ_predicted,0.125,7,7,ATAGCGGGTGGTCAACCAAA,0,5023128
yjbJ_predicted,0.125,7,7,ATAAGACTCGGTTGTTGACT,0,5022173
yjbJ_predicted,0.125,7,7,ATAACCCTAATAGCCGCGTC,0,5019428
yjbJ_predicted,0.125,7,7,ATAAACGTCAATGTCAAGAT,0,5020178
yjbJ_predicted,0.125,7,7,AGTTGATGAGCGTAGTTGCT,0,5008871
yjbJ_predicted,0.125,7,7,AGTTAGCCCGATCTCACTTT,0,4995116
yjbJ_predicted,0.125,7,7,AGTGTCGCGCCGAACTGGAA,0,5030507
yjbJ_predicted,0.125,7,7,AGTCAGCCGCGCGCCCATTT,0,5009355
yjbJ_predicted,0.125,7,7,AGTATTATTAGCCGCATCGG,0,5007875
yjbJ_predicted,0.125,7,7,AGTACCCCTAGTTATTGTGC,0,5018372
yjbJ_predicted,0.125,7,7,AGTACAATCAGAATGAGACA,0,5011215
yjbJ_predicted,0.125,7,7,AGTAATACTCGATGTGGAGG,0,5002033
yjbJ_predicted,0.125,7,7,AGGTTATGTCTGGGCTAATA,0,5011079
yjbJ_predicted,0.125,7,7,AGGTGGTATAACGGCATTCT,0,5023400
yjbJ_predicted,0.125,7,7,AGGTCGGTAACCATAACGCC,0,5011158
yjbJ_predicted,0.125,7,7,AGGCTGTTTCTCTCTCAAAT,0,5013934
yjbJ_predicted,0.125,7,7,AGGCCTGCCCTCGGGGCTAT,0,5024742
yjbJ_predicted,0.125,7,7,AGGAGGGATCTGCTATTTTT,0,5007529
yjbJ_predicted,0.125,7,7,AGGAGCACGAGCTAATGCGG,0,4997091
yjbJ_predicted,0.125,7,7,AGCTAACAATTGTTCGGGAC,0,5011355
yjbJ_predicted,0.125,7,7,AGCGCGTTTCCGGTTTCCAC,0,5021368
yjbJ_predicted,0.125,7,7,AGCCTCCGCTTCCTTTCTCA,0,4995641
yjbJ_predicted,0.125,7,7,AGCCCTCCGCCGCTTCCGCA,0,5018523
yjbJ_predicted,0.125,7,7,AGCCCACCCTCCGGATTAGT,0,5008024
yjbJ_predicted,0.125,7,7,AGCCAGCCTGTGATCCTGGC,0,5020028
yjbJ_predicted,0.125,7,7,AGCACAGACATAGCGGTCAC,0,5025870
yjbJ_predicted,0.125,7,7,AGAGTAAGGGCCATACGACT,0,5028205
yjbJ_predicted,0.125,7,7,AGAGCAGTCGTAGTCACCCA,0,4997781
yjbJ_predicted,0.125,7,7,AGAGATCCAGGCATGTTAAT,0,5000166
yjbJ_predicted,0.125,7,7,AGAGAGTTAACGGGTTCGAT,0,5009336
yjbJ_predicted,0.125,7,7,AGACGGGAATCTTACGCCGT,0,5031293
yjbJ_predicted,0.125,7,7,AGAACAAGCGAAAAAACCAT,0,5008262
yjbJ_predicted,0.125,7,7,ACTTGTCACAAGTGGGGACC,0,5001843
yjbJ_predicted,0.125,7,7,ACTTCTTTTGTCAGTAGATC,0,5006952
yjbJ_predicted,0.125,7,7,ACTTATGTTTTCCCGGGCAT,0,5020648
yjbJ_predicted,0.125,7,7,ACTGGCACGTTGCGAACTTA,0,4998736
yjbJ_predicted,0.125,7,7,ACTGAGCGTGCCCAGTGATC,0,4998973
yjbJ_predicted,0.125,7,7,ACTCGCAATCGTACAAGCCA,0,5004935
yjbJ_predicted,0.125,7,7,ACTCGATTACTGAGACTTTC,0,4996202
yjbJ_predicted,0.125,7,7,ACGTAGAAATCTGAGATAAG,0,5017285
yjbJ_predicted,0.125,7,7,ACGTACTAGCTCAGATAGTT,0,5014364
yjbJ_predicted,0.125,7,7,ACGGCTAATGACGCCTTGTC,0,5021990
yjbJ_predicted,0.125,7,7,ACGGACTTCGCGTTATCGAA,0,4996082
yjbJ_predicted,0.125,7,7,ACGCTGTGCCAGAGGCTCGT,0,5016079
yjbJ_predicted,0.125,7,7,ACGCCTTCTTAATTTACAAA,0,5019560
yjbJ_predicted,0.125,7,7,ACGCCTCAAGCGGTGTAATC,0,5017815
yjbJ_predicted,0.125,7,7,ACGCCGCCTTTAAACGCTTG,0,5003084
yjbJ_predicted,0.125,7,7,ACGCCAATTGTGCGCGAGCT,0,4999073
yjbJ_predicted,0.125,7,7,ACGATACCAGGCTTTAAAGC,0,5011103
yjbJ_predicted,0.125,7,7,ACCTTCTTGGCGCACGATGT,0,5014445
yjbJ_predicted,0.125,7,7,ACCTTCAGTCCCTACGAGGC,0,4999323
yjbJ_predicted,0.125,7,7,ACCTACGCAGACATGGGCGC,0,5004817
yjbJ_predicted,0.125,7,7,ACCCGAGGGCGTCTACTGCT,0,5008224
yjbJ_predicted,0.125,7,7,ACCCCGTGGATATTCAGGCA,0,5017156
yjbJ_predicted,0.125,7,7,ACCATTCTCCAGAATCCGTT,0,5009258
yjbJ_predicted,0.125,7,7,ACCACCCTCCTAGGCTGGTT,0,5027452
yjbJ_predicted,0.125,7,7,ACATGAGGGACCGTCGAAGT,0,5011662
yjbJ_predicted,0.125,7,7,ACATCTGTTAATACTTCGTC,0,4997364
yjbJ_predicted,0.125,7,7,ACAGGTACGTGTTCTAATTC,0,5005277
yjbJ_predicted,0.125,7,7,ACAGCGTCACTCAGAGAGGA,0,5028474
yjbJ_predicted,0.125,7,7,ACAATGGCATATGTCTAACA,0,5022530
yjbJ_predicted,0.125,7,7,ACAACCCAGCCGGGCTTAAC,0,5003841
yjbJ_predicted,0.125,7,7,ACAACACATCTACGAACAGA,0,4995856
yjbJ_predicted,0.125,7,7,AATTTAGGCCTTTTTTCACA,0,5022292
yjbJ_predicted,0.125,7,7,AATTGGTTCCATCATACTTG,0,5027246
yjbJ_predicted,0.125,7,7,AATTAAGCGGATTCCTGAGT,0,4994691
yjbJ_predicted,0.125,7,7,AATGTTATATTGGTTACGAA,0,5016692
yjbJ_predicted,0.125,7,7,AATGTGCGTGGTGGGACACT,0,5008588
yjbJ_predicted,0.125,7,7,AATGGGTAAATAAGGGTTCA,0,5029683
yjbJ_predicted,0.125,7,7,AATGGGATAGGGAGCAATTA,0,5023212
yjbJ_predicted,0.125,7,7,AATGATTAGTTTAAGTAAAT,0,5003833
yjbJ_predicted,0.125,7,7,AATGAGCATTGGGGGGGTTG,0,5022297
yjbJ_predicted,0.125,7,7,AATCGGCTCTTCTGCACTCG,0,5013220
yjbJ_predicted,0.125,7,7,AATCAACCAGTGCGTAGGAT,0,5026933
yjbJ_predicted,0.125,7,7,AATATGACTGAGTGTTCGCA,0,5024490
yjbJ_predicted,0.125,7,7,AATAGTGGTAAAGAGTTGCG,0,5005798
yjbJ_predicted,0.125,7,7,AATACGAACGGGAGCGGGTT,0,5031008
yjbJ_predicted,0.125,7,7,AATAACTTATGAGTGTTCTT,0,4995576
yjbJ_predicted,0.125,7,7,AAGTTAAAGTAAGAAGCCTG,0,5003740
yjbJ_predicted,0.125,7,7,AAGGGTACATTCGGCTCCGA,0,5007407
yjbJ_predicted,0.125,7,7,AAGATTCCTATTTGCATTTA,0,5025755
yjbJ_predicted,0.125,7,7,AAGAGTCTACGCCCTGGAGA,0,5018244
yjbJ_predicted,0.125,7,7,AAGAACTCCATTGGCCTTGT,0,5013123
yjbJ_predicted,0.125,7,7,AACTTTGAACCCACGTTCGT,0,5022076
yjbJ_predicted,0.125,7,7,AACTTGTCAGTTTGCCGGCT,0,5025019
yjbJ_predicted,0.125,7,7,AACGTTCGACACAAAGGACG,0,4997598
yjbJ_predicted,0.125,7,7,AACGTCTTGTCGCTACGCAA,0,5028309
yjbJ_predicted,0.125,7,7,AACGGCGGTAACTGGGTTAA,0,5016533
yjbJ_predicted,0.125,7,7,AACCGTTTGCTACATAGCCC,0,4997248
yjbJ_predicted,0.125,7,7,AACCCATTGCGAATAGACAA,0,5025592
yjbJ_predicted,0.125,7,7,AACCAACGCAAGTTGCGGCT,0,5017359
yjbJ_predicted,0.125,7,7,AACAGTGACAGATTATGTTG,0,5012704
yjbJ_predicted,0.125,7,7,AAATTAAACACTACAGAGTT,0,5020348
yjbJ_predicted,0.125,7,7,AAATACCAATGGACTACAAC,0,5012822
yjbJ_predicted,0.125,7,7,AAAGCCATGAACTTTTGATT,0,4994888
yjbJ_predicted,0.125,7,7,AAAGATGGTCGCCCGTTGTC,0,5024367
yjbJ_predicted,0.125,7,7,AAAGAGGACGCCGAATGAGA,0,5020714
yjbJ_predicted,0.125,7,7,AAACGCTCCTTTCCTCATGT,0,5003258
yjbJ_predicted,0.125,7,7,AAAACTAAAGATTTAGCAGG,0,5010769
yjbJ_predicted,0.125,7,7,AAAACCGGTGGAGACACGGG,0,5013346
yjbJ_predicted,0.125,7,7,AAAAAGGGGTCTATCCCGGA,0,5013474
yjbJ_predicted,0.14285714285714285,6,6,TTTTTGGAGTACTACGAGCT,0,5023320
yjbJ_predicted,0.14285714285714285,6,6,TTTTGACCAGGAACCCGGAT,0,5031108
yjbJ_predicted,0.14285714285714285,6,6,TTTTCTGGGAATAGTCCGCT,0,5015700
yjbJ_predicted,0.14285714285714285,6,6,TTTGTGGATCGGGTGATTTG,0,5024456
yjbJ_predicted,0.14285714285714285,6,6,TTTGTCCCGAGCCTCCACTC,0,4999439
yjbJ_predicted,0.14285714285714285,6,6,TTTCGGAAGAAAGGATATTC,0,4996421
yjbJ_predicted,0.14285714285714285,6,6,TTTCGCCTTGTCAGAGTCAT,0,5026803
yjbJ_predicted,0.14285714285714285,6,6,TTTCGCAAACTTGCCCAATT,0,5019266
yjbJ_predicted,0.14285714285714285,6,6,TTTCACAAGGTTCAGGCATG,0,5019550
yjbJ_predicted,0.14285714285714285,6,6,TTTCAATTAGTTTTTACGCT,0,5012586
yjbJ_predicted,0.14285714285714285,6,6,TTGTCCGTAGTAGGTTGTCA,0,5021781
yjbJ_predicted,0.14285714285714285,6,6,TTGCACCTTCAAGATTCTGA,0,5018345
yjbJ_predicted,0.14285714285714285,6,6,TTGATATAAGTTTGTAGAGT,0,5021204
yjbJ_predicted,0.14285714285714285,6,6,TTGAGACCTCTGGACCCTAG,0,5028328
yjbJ_predicted,0.14285714285714285,6,6,TTCTTAGATGCATAGACACT,0,5004517
yjbJ_predicted,0.14285714285714285,6,6,TTCTCCGTCCCATGTCATTT,0,5011574
yjbJ_predicted,0.14285714285714285,6,6,TTCTACTCCTACGCCTCCGT,0,5015918
yjbJ_predicted,0.14285714285714285,6,6,TTCGCGGGACGTTTCTTGAT,0,5020763
yjbJ_predicted,0.14285714285714285,6,6,TTCGCCGTTACCAAATTTAA,0,5012866
yjbJ_predicted,0.14285714285714285,6,6,TTCCGAACAGAGCAGTGGAG,0,5020376
yjbJ_predicted,0.14285714285714285,6,6,TTCCCGTCTCTAGATCGTGC,0,5000753
yjbJ_predicted,0.14285714285714285,6,6,TTCATGTAGACGAGGTATAT,0,5000821
yjbJ_predicted,0.14285714285714285,6,6,TTCAGGAGGGTTTAGAGACA,0,5013495
yjbJ_predicted,0.14285714285714285,6,6,TTCACCAGTTTGAAGAACTT,0,4996836
yjbJ_predicted,0.14285714285714285,6,6,TTCAATGGATGTTTTTGGCC,0,5003381
yjbJ_predicted,0.14285714285714285,6,6,TTATGTCGAGACTGGCGAAG,0,5018199
yjbJ_predicted,0.14285714285714285,6,6,TTAGTGTGTCTTCAATACCA,0,5025156
yjbJ_predicted,0.14285714285714285,6,6,TTAGTGCAGACACCCCGAAA,0,5002481
yjbJ_predicted,0.14285714285714285,6,6,TTAGGGCTTTTGGATAAGAG,0,4996629
yjbJ_predicted,0.14285714285714285,6,6,TTAGGCTCACGCTCGCAGAA,0,5025360
yjbJ_predicted,0.14285714285714285,6,6,TTAGCCAGATATTGCGTCGG,0,4998490
yjbJ_predicted,0.14285714285714285,6,6,TTAGAAATTTAGTAAGTACT,0,4997825
yjbJ_predicted,0.14285714285714285,6,6,TTAGAAACAGCAGGTAAGGT,0,5030966
yjbJ_predicted,0.14285714285714285,6,6,TTACGTCATATCCAAGCGCG,0,5027440
yjbJ_predicted,0.14285714285714285,6,6,TTACAATGTAGTCCAGTTAA,0,5021136
yjbJ_predicted,0.14285714285714285,6,6,TTAATGATTGAATCTAGTTC,0,5026677
yjbJ_predicted,0.14285714285714285,6,6,TGTTGGATATTAGCTAGGAA,0,5022866
yjbJ_predicted,0.14285714285714285,6,6,TGTTATTCGTCTCATGGGCT,0,5015630
yjbJ_predicted,0.14285714285714285,6,6,TGTCGCGAGGCTTGTTCAAA,0,5007454
yjbJ_predicted,0.14285714285714285,6,6,TGTCAGAGTCATGGATCACT,0,5030349
yjbJ_predicted,0.14285714285714285,6,6,TGTCACCAAGTCGAGGCGGA,0,4997826
yjbJ_predicted,0.14285714285714285,6,6,TGGTTGCTTCCGTGAATATA,0,5016480
yjbJ_predicted,0.14285714285714285,6,6,TGGTGTTGTCAACCCACCTC,0,5010357
yjbJ_predicted,0.14285714285714285,6,6,TGGTCAGGGGACGTATATGT,0,5024631
yjbJ_predicted,0.14285714285714285,6,6,TGGGTCCGAGAGGGTCGCTT,0,5001227
yjbJ_predicted,0.14285714285714285,6,6,TGGGCACGCTGCACCTATCG,0,4995937
yjbJ_predicted,0.14285714285714285,6,6,TGGCTCTTCACTCAAGGCAT,0,5000728
yjbJ_predicted,0.14285714285714285,6,6,TGGCGGCCGCGCAGCACTGT,0,5018592
yjbJ_predicted,0.14285714285714285,6,6,TGGCCACACAGCCGCAGAAA,0,5021468
yjbJ_predicted,0.14285714285714285,6,6,TGGCAGCTCAGACGTGTCAC,0,5016250
yjbJ_predicted,0.14285714285714285,6,6,TGCTCGAAATGACTAGGATA,0,5013456
yjbJ_predicted,0.14285714285714285,6,6,TGCTACACGAAACAGTGACT,0,5005368
yjbJ_predicted,0.14285714285714285,6,6,TGCGGCCGTGGAAAGTCGTA,0,5017221
yjbJ_predicted,0.14285714285714285,6,6,TGCCTGCGATAGAACAATTT,0,5022603
yjbJ_predicted,0.14285714285714285,6,6,TGCCTCACGTCTTACACAGC,0,5013228
yjbJ_predicted,0.14285714285714285,6,6,TGCATGGGAGTCACCAGACT,0,5013002
yjbJ_predicted,0.14285714285714285,6,6,TGCATATGAGGCATTCCCGA,0,5018598
yjbJ_predicted,0.14285714285714285,6,6,TGCAATAGGATGGGTGGGTT,0,5013097
yjbJ_predicted,0.14285714285714285,6,6,TGATCTCATACTCAGTTGGA,0,5002422
yjbJ_predicted,0.14285714285714285,6,6,TGATCGCGGCGTAGCAAGTT,0,5028571
yjbJ_predicted,0.14285714285714285,6,6,TGATACATAGCACTCCTGGA,0,5026505
yjbJ_predicted,0.14285714285714285,6,6,TGAGCATAGGTGAGGTCAAT,0,5008456
yjbJ_predicted,0.14285714285714285,6,6,TGACAGCCGTTCGGGATGAG,0,5029451
yjbJ_predicted,0.14285714285714285,6,6,TGACACATCGGGGCCAACTC,0,5015475
yjbJ_predicted,0.14285714285714285,6,6,TGAATACTCATGGTAAGTCC,0,5026029
yjbJ_predicted,0.14285714285714285,6,6,TGAAGGCCTACGTCCGAGTA,0,5025719
yjbJ_predicted,0.14285714285714285,6,6,TGAACCTGCCTGACCTGTTT,0,5014181
yjbJ_predicted,0.14285714285714285,6,6,TCTTTGAGCCGATATTTATA,0,5014497
yjbJ_predicted,0.14285714285714285,6,6,TCTTCCCGTACTATTGCCAA,0,5023635
yjbJ_predicted,0.14285714285714285,6,6,TCTGTATTGGCAACCATTTC,0,5011212
yjbJ_predicted,0.14285714285714285,6,6,TCTGCGGATACCCCATGTGG,0,5011831
yjbJ_predicted,0.14285714285714285,6,6,TCTCTGTGAAAATGTGTTTA,0,5010524
yjbJ_predicted,0.14285714285714285,6,6,TCTCATGGCCTAGGCTCGTC,0,5010274
yjbJ_predicted,0.14285714285714285,6,6,TCTAAGGTTAGCCTGAACTT,0,5019851
yjbJ_predicted,0.14285714285714285,6,6,TCTAAGCTAAACGGGGTAGG,0,4999437
yjbJ_predicted,0.14285714285714285,6,6,TCGGGGCGCACAGTGACCAT,0,5016534
yjbJ_predicted,0.14285714285714285,6,6,TCGGGAGGCGACATCAACCC,0,5019029
yjbJ_predicted,0.14285714285714285,6,6,TCGGAACAAAGATCGGCTCT,0,5008537
yjbJ_predicted,0.14285714285714285,6,6,TCGCTGGACTTTCTCCCGTC,0,5001434
yjbJ_predicted,0.14285714285714285,6,6,TCGCCAGTTGCGTTGCTGGG,0,5011751
yjbJ_predicted,0.14285714285714285,6,6,TCGAATGTGATCAGCCTCAA,0,5009463
yjbJ_predicted,0.14285714285714285,6,6,TCCTCGTAATGGCCGGCTGT,0,5001775
yjbJ_predicted,0.14285714285714285,6,6,TCCTCATAAGCGCTATCCGA,0,5012499
yjbJ_predicted,0.14285714285714285,6,6,TCCGCCTGGGGATTCCAGGT,0,5010695
yjbJ_predicted,0.14285714285714285,6,6,TCCCCGCCCACGATAAGTAA,0,5026538
yjbJ_predicted,0.14285714285714285,6,6,TCCAGTGGGTTAGCATTATC,0,5012531
yjbJ_predicted,0.14285714285714285,6,6,TCCAAGTAAATTCAGCAGTG,0,5017291
yjbJ_predicted,0.14285714285714285,6,6,TCATGACTATGTCGAACTGG,0,4998350
yjbJ_predicted,0.14285714285714285,6,6,TCAGTTCTACTAAGGAACAG,0,4996820
yjbJ_predicted,0.14285714285714285,6,6,TCAGCCTCCGTGGTCTCATT,0,5011493
yjbJ_predicted,0.14285714285714285,6,6,TCACTGTTAGCATCACCCTT,0,5015932
yjbJ_predicted,0.14285714285714285,6,6,TCACTAAGGACGTGGTCATC,0,5007638
yjbJ_predicted,0.14285714285714285,6,6,TCAAGTGCGTCGAGACCGAC,0,5030121
yjbJ_predicted,0.14285714285714285,6,6,TCAAGCACGCGGCACACTCA,0,5002985
yjbJ_predicted,0.14285714285714285,6,6,TCAAAGTTCGGTCGGGATAT,0,5006989
yjbJ_predicted,0.14285714285714285,6,6,TATGGTGTTAGGGGGCTGCA,0,5019164
yjbJ_predicted,0.14285714285714285,6,6,TATGGCAAAGATAAGCCGAA,0,5016940
yjbJ_predicted,0.14285714285714285,6,6,TATATTTGGCCCTCTGGATG,0,5028973
yjbJ_predicted,0.14285714285714285,6,6,TATACTTGCCGGACTATGGG,0,5009031
yjbJ_predicted,0.14285714285714285,6,6,TATAAGGGTGTAATCTACAA,0,5020506
yjbJ_predicted,0.14285714285714285,6,6,TAGGGCTCACCCGGGGGTCA,0,5019872
yjbJ_predicted,0.14285714285714285,6,6,TAGGCTCGTGCCTCCTAACC,0,5020856
yjbJ_predicted,0.14285714285714285,6,6,TAGGCCCGGAGGGTTCTGAG,0,5003307
yjbJ_predicted,0.14285714285714285,6,6,TAGGATTTAGATTTCGTTCT,0,5003932
yjbJ_predicted,0.14285714285714285,6,6,TAGCGGTAGTATGAGTTGTA,0,5021582
yjbJ_predicted,0.14285714285714285,6,6,TAGCGACAGAATGCGTGCTA,0,5008156
yjbJ_predicted,0.14285714285714285,6,6,TAGCATCAGTGATGATATGT,0,5016453
yjbJ_predicted,0.14285714285714285,6,6,TAGAACAGATCAGCGTGATC,0,5013743
yjbJ_predicted,0.14285714285714285,6,6,TACTGCAGACACAAATAGAT,0,5016813
yjbJ_predicted,0.14285714285714285,6,6,TACTCCTCAAAGTGGCTTGT,0,5002639
yjbJ_predicted,0.14285714285714285,6,6,TACGGATTGTGAGGCGCGTA,0,5010134
yjbJ_predicted,0.14285714285714285,6,6,TACGCTGCTGGTGGCGTTGG,0,5005637
yjbJ_predicted,0.14285714285714285,6,6,TACGCCACTGGACCGGAAGA,0,5001124
yjbJ_predicted,0.14285714285714285,6,6,TACCTACATTACCACTACGG,0,5011330
yjbJ_predicted,0.14285714285714285,6,6,TACCGGGCAGAAACTTAGTG,0,5024795
yjbJ_predicted,0.14285714285714285,6,6,TAATAAAAGGCGGCAGAGAG,0,5027712
yjbJ_predicted,0.14285714285714285,6,6,TAAGCCCCAAGCGGGGATAT,0,4998302
yjbJ_predicted,0.14285714285714285,6,6,TAACTGGCGGGGGGCCTGGT,0,5016298
yjbJ_predicted,0.14285714285714285,6,6,TAAACCTGGACACCGTCTAC,0,5010701
yjbJ_predicted,0.14285714285714285,6,6,GTTTCCGGGACTGGAGCAAG,0,4995271
yjbJ_predicted,0.14285714285714285,6,6,GTTTATACGATCCTATCTAC,0,5021871
yjbJ_predicted,0.14285714285714285,6,6,GTTTATAAAGCCTTGGAGGT,0,5027182
yjbJ_predicted,0.14285714285714285,6,6,GTTTAAGGCAGAAACAATGG,0,5006852
yjbJ_predicted,0.14285714285714285,6,6,GTTGGCGGTAACTCGGTTCT,0,5015970
yjbJ_predicted,0.14285714285714285,6,6,GTTGGAGACTGACGACAGCA,0,5012296
yjbJ_predicted,0.14285714285714285,6,6,GTTCCAGCGCCTTTCTGTAG,0,4999237
yjbJ_predicted,0.14285714285714285,6,6,GTTCCACGGTCTCCTCGGCG,0,5020089
yjbJ_predicted,0.14285714285714285,6,6,GTTCACTAGCACCTGGGGAT,0,5020696
yjbJ_predicted,0.14285714285714285,6,6,GTTCACCGGAGGTAGCTCTA,0,5029237
yjbJ_predicted,0.14285714285714285,6,6,GTTCAACTAAGGAGTATTTG,0,4999596
yjbJ_predicted,0.14285714285714285,6,6,GTTAGTCCTGCCGGTGCCCG,0,5017190
yjbJ_predicted,0.14285714285714285,6,6,GTGTGACGTGGGGGCTGGTG,0,5001519
yjbJ_predicted,0.14285714285714285,6,6,GTGTCAAATAACAGGTGTTC,0,5009131
yjbJ_predicted,0.14285714285714285,6,6,GTGGAGAGCTAGACGGTATA,0,5022971
yjbJ_predicted,0.14285714285714285,6,6,GTGCGAATCCTGGACACGTG,0,5003845
yjbJ_predicted,0.14285714285714285,6,6,GTGAAACTACTACTGTTGTA,0,5008324
yjbJ_predicted,0.14285714285714285,6,6,GTCTATCGATCAGACGACGG,0,4999024
yjbJ_predicted,0.14285714285714285,6,6,GTCGTTAGTTAGACATGTGA,0,5011847
yjbJ_predicted,0.14285714285714285,6,6,GTCGCTACTGGGGCGGCTCC,0,5027279
yjbJ_predicted,0.14285714285714285,6,6,GTCCTGGCCGATCTAGGCTG,0,5017484
yjbJ_predicted,0.14285714285714285,6,6,GTCCGGCCAGTCCACGCTCT,0,5030739
yjbJ_predicted,0.14285714285714285,6,6,GTCACACAGGAATGCATTGG,0,5001984
yjbJ_predicted,0.14285714285714285,6,6,GTCAAAGTATGTGCTCATGG,0,5023027
yjbJ_predicted,0.14285714285714285,6,6,GTATTGTCCCACCCAGCTAA,0,5017432
yjbJ_predicted,0.14285714285714285,6,6,GTATTGCTCTTAAATTCTGA,0,4995806
yjbJ_predicted,0.14285714285714285,6,6,GTATAGACTGCCTCGACGAT,0,4998821
yjbJ_predicted,0.14285714285714285,6,6,GTAGTCCCCAGCTGAAGATA,0,5022763
yjbJ_predicted,0.14285714285714285,6,6,GTAGGCCCGCACACGGTTCC,0,5003072
yjbJ_predicted,0.14285714285714285,6,6,GTAGATAGGGCGAAAGGCAG,0,5017543
yjbJ_predicted,0.14285714285714285,6,6,GTAGAAAAGGCGCGACGTTT,0,5004766
yjbJ_predicted,0.14285714285714285,6,6,GTACTCCTTGTGTGCCAAAT,0,5011453
yjbJ_predicted,0.14285714285714285,6,6,GTACAGACTGAATCCGACGG,0,5029063
yjbJ_predicted,0.14285714285714285,6,6,GGTTGGACATTACTCGCCGG,0,5000687
yjbJ_predicted,0.14285714285714285,6,6,GGTTGACTTTATGGATATGT,0,5005901
yjbJ_predicted,0.14285714285714285,6,6,GGTTGACGTCAAATGCCTAT,0,5025770
yjbJ_predicted,0.14285714285714285,6,6,GGTGCGTGGGCAGGGTCATG,0,5025151
yjbJ_predicted,0.14285714285714285,6,6,GGTGCCGCACCGGTGCTCTT,0,5013355
yjbJ_predicted,0.14285714285714285,6,6,GGTCGTGGACTCGGACTGCA,0,5016978
yjbJ_predicted,0.14285714285714285,6,6,GGTCGGTAGCCCAGTGCGTC,0,5024955
yjbJ_predicted,0.14285714285714285,6,6,GGGTTTGGATCACTTATCTC,0,5030702
yjbJ_predicted,0.14285714285714285,6,6,GGGTTTCTGTCTTCCAGTCC,0,4995510
yjbJ_predicted,0.14285714285714285,6,6,GGGTTGGATAACTGCCGCAG,0,5011856
yjbJ_predicted,0.14285714285714285,6,6,GGGTTCTCCTTAAGATAGCA,0,5003298
yjbJ_predicted,0.14285714285714285,6,6,GGGTGTATATCGTCGTCACT,0,4997645
yjbJ_predicted,0.14285714285714285,6,6,GGGGTTGTCATTTTGTGGCC,0,5013992
yjbJ_predicted,0.14285714285714285,6,6,GGGGTATGCAACCAGACGAT,0,5003519
yjbJ_predicted,0.14285714285714285,6,6,GGGGTAACCATAACCAGTTA,0,5028129
yjbJ_predicted,0.14285714285714285,6,6,GGGGGACGACAAGAATTCGA,0,5019669
yjbJ_predicted,0.14285714285714285,6,6,GGGGCAAGTTCACGGCGCTA,0,4998148
yjbJ_predicted,0.14285714285714285,6,6,GGGCTCTGGGTAACGCAGGT,0,5001127
yjbJ_predicted,0.14285714285714285,6,6,GGGCCATGTCCTCCCCTTAG,0,5009071
yjbJ_predicted,0.14285714285714285,6,6,GGGACTAAAAAAACACTAAA,0,4999324
yjbJ_predicted,0.14285714285714285,6,6,GGCGTGAGGTTATCGCGCGC,0,5021342
yjbJ_predicted,0.14285714285714285,6,6,GGCGCTGAATACCCGGCAAA,0,5021898
yjbJ_predicted,0.14285714285714285,6,6,GGCGAAAGGCTTTTGCAGAA,0,5000745
yjbJ_predicted,0.14285714285714285,6,6,GGCAGCTTCTGTACACTTAT,0,5027580
yjbJ_predicted,0.14285714285714285,6,6,GGCAGCAACTAGCCGGGAAA,0,5007854
yjbJ_predicted,0.14285714285714285,6,6,GGCAAGGCACCTAACCAAGG,0,5006968
yjbJ_predicted,0.14285714285714285,6,6,GGATGTTAGCTTGGCCAGGC,0,5030468
yjbJ_predicted,0.14285714285714285,6,6,GGATGATGCACCGCCGCCTA,0,5013104
yjbJ_predicted,0.14285714285714285,6,6,GGATGAGCGATCAGAAAATT,0,4994848
yjbJ_predicted,0.14285714285714285,6,6,GGATCAGCCCATTGGAACGA,0,5013331
yjbJ_predicted,0.14285714285714285,6,6,GGATATGGGCCATGGCGGAT,0,5010327
yjbJ_predicted,0.14285714285714285,6,6,GGATAGAGGCAGGGATGCGA,0,5024034
yjbJ_predicted,0.14285714285714285,6,6,GGAGTATCTTAGGGGCATGA,0,5025335
yjbJ_predicted,0.14285714285714285,6,6,GGAGCACGGCATCCCCGTAG,0,5002634
yjbJ_predicted,0.14285714285714285,6,6,GGAGACCGGAGTCTAACTTC,0,5001658
yjbJ_predicted,0.14285714285714285,6,6,GGACCACGGGAGATCATATC,0,5008383
yjbJ_predicted,0.14285714285714285,6,6,GGAACCCTGTCGAGATTATA,0,5031190
yjbJ_predicted,0.14285714285714285,6,6,GCTTTGAATGATTTAGCGAT,0,5002189
yjbJ_predicted,0.14285714285714285,6,6,GCTTTATCCGACCGAGCATT,0,5010149
yjbJ_predicted,0.14285714285714285,6,6,GCTTCGAACGGTACGTCAAG,0,4995484
yjbJ_predicted,0.14285714285714285,6,6,GCTGGTTTACTATTATTGAT,0,5002898
yjbJ_predicted,0.14285714285714285,6,6,GCTGGCATTGACTGAGCTGC,0,5018379
yjbJ_predicted,0.14285714285714285,6,6,GCTGGCACATACGAGTGCTT,0,5008919
yjbJ_predicted,0.14285714285714285,6,6,GCTCGTGGGGGATCACGACG,0,4998162
yjbJ_predicted,0.14285714285714285,6,6,GCTCGTCCTACTCCTCAGCA,0,4997225
yjbJ_predicted,0.14285714285714285,6,6,GCTCAACTCTTGGGAAGAAG,0,5007118
yjbJ_predicted,0.14285714285714285,6,6,GCTATCGAGGTCTATCGAGG,0,5028834
yjbJ_predicted,0.14285714285714285,6,6,GCTAGGTTTTCGTTTGTTTG,0,5017960
yjbJ_predicted,0.14285714285714285,6,6,GCTACAGGCATTACCCAATG,0,5001205
yjbJ_predicted,0.14285714285714285,6,6,GCGGGGCTAAATAAGCACAT,0,5005921
yjbJ_predicted,0.14285714285714285,6,6,GCGCCTGTCGTTGTGCGAGT,0,5002729
yjbJ_predicted,0.14285714285714285,6,6,GCCTGAGCTGCAGTCACCGT,0,5012117
yjbJ_predicted,0.14285714285714285,6,6,GCCGTTATTAATACTCTATA,0,5014470
yjbJ_predicted,0.14285714285714285,6,6,GCCGTCTTGAGGTAAGGCCT,0,5025222
yjbJ_predicted,0.14285714285714285,6,6,GCCGTCGGCCAATGATCGGT,0,5004494
yjbJ_predicted,0.14285714285714285,6,6,GCCGGGTCTAATAGCATTCA,0,5014009
yjbJ_predicted,0.14285714285714285,6,6,GCCGCTGCCAGATCTACATC,0,5010777
yjbJ_predicted,0.14285714285714285,6,6,GCCGAACTTGTAGACCGCCG,0,5013712
yjbJ_predicted,0.14285714285714285,6,6,GCCGAACCGACACTCCATCT,0,5006438
yjbJ_predicted,0.14285714285714285,6,6,GCCCCGGGAGGCAAAACGCG,0,5014972
yjbJ_predicted,0.14285714285714285,6,6,GCCCATTCCCATGGAGTAAG,0,5025299
yjbJ_predicted,0.14285714285714285,6,6,GCCATTCTATTAGTAGGAAG,0,5029256
yjbJ_predicted,0.14285714285714285,6,6,GCATGCCTCTGATCCAATAT,0,5025609
yjbJ_predicted,0.14285714285714285,6,6,GCAGTTCCCCTTCAGGAGAA,0,5008483
yjbJ_predicted,0.14285714285714285,6,6,GCAGGTAACCCAGTAGGCTA,0,5017478
yjbJ_predicted,0.14285714285714285,6,6,GCAGGGAATACTGAAGGCAT,0,5019161
yjbJ_predicted,0.14285714285714285,6,6,GCACTGGATTAGAGAGTTAC,0,5029011
yjbJ_predicted,0.14285714285714285,6,6,GCACGCGGTGAGGAGATGAT,0,4999438
yjbJ_predicted,0.14285714285714285,6,6,GCAATCGCTGGTCATCGTCC,0,5020437
yjbJ_predicted,0.14285714285714285,6,6,GCAAGTTTTCTAGTTGTGGC,0,5012106
yjbJ_predicted,0.14285714285714285,6,6,GCAAGGTATGTCCGTAATCT,0,4998094
yjbJ_predicted,0.14285714285714285,6,6,GCAAAGTGATCTTGGGGAAT,0,5021267
yjbJ_predicted,0.14285714285714285,6,6,GCAAACCGACCATAACCCTC,0,5020469
yjbJ_predicted,0.14285714285714285,6,6,GATTTCTATCGAGATTTTGG,0,5005954
yjbJ_predicted,0.14285714285714285,6,6,GATTCGTAATCATAATTGAT,0,5009543
yjbJ_predicted,0.14285714285714285,6,6,GATTAGGTCGAAATAGGCAA,0,4999853
yjbJ_predicted,0.14285714285714285,6,6,GATGTAGCCACTCCGGAATA,0,5012548
yjbJ_predicted,0.14285714285714285,6,6,GATGCAAGTTACCTCTTGGC,0,5002997
yjbJ_predicted,0.14285714285714285,6,6,GATCAAACATTAACAACGTT,0,5001668
yjbJ_predicted,0.14285714285714285,6,6,GATAAAATCTAATACGCTAG,0,4998573
yjbJ_predicted,0.14285714285714285,6,6,GAGGGGCTGGTGAGATTTTT,0,4998226
yjbJ_predicted,0.14285714285714285,6,6,GAGCTTTTAATAGCTCACAG,0,5002270
yjbJ_predicted,0.14285714285714285,6,6,GAGCGCAGCCGTTGCCGAGT,0,5023167
yjbJ_predicted,0.14285714285714285,6,6,GAGCAGAAGAGCCGGAACCT,0,5022438
yjbJ_predicted,0.14285714285714285,6,6,GAGCACGAATCTGAATAAGT,0,5025073
yjbJ_predicted,0.14285714285714285,6,6,GAGATAATGCGTATCCTTGG,0,5009240
yjbJ_predicted,0.14285714285714285,6,6,GACTTTATGGCGTGTCTCAA,0,4995246
yjbJ_predicted,0.14285714285714285,6,6,GACTTCGTAGATATAGCGAT,0,5029374
yjbJ_predicted,0.14285714285714285,6,6,GACTCTTCACTCGAAACAAT,0,5024263
yjbJ_predicted,0.14285714285714285,6,6,GACTCAGATTCCGCTCGGTG,0,5009909
yjbJ_predicted,0.14285714285714285,6,6,GACGGAGGATGAGCGACAGC,0,5014024
yjbJ_predicted,0.14285714285714285,6,6,GACGCAATGTTCAGTTCAAC,0,5024533
yjbJ_predicted,0.14285714285714285,6,6,GACGAAATTGGAAACAACAT,0,4998761
yjbJ_predicted,0.14285714285714285,6,6,GACCTTACTACATAAACTAC,0,5005909
yjbJ_predicted,0.14285714285714285,6,6,GACCAGTAACCTGGCAGGAT,0,5029846
yjbJ_predicted,0.14285714285714285,6,6,GACATATTTCGTTACGCCAC,0,5013793
yjbJ_predicted,0.14285714285714285,6,6,GAATTGCCCGATACCAAACA,0,4997743
yjbJ_predicted,0.14285714285714285,6,6,GAATTATCGGGAGGCTCATA,0,5020069
yjbJ_predicted,0.14285714285714285,6,6,GAATCATCCTGAACTGGTAG,0,5018666
yjbJ_predicted,0.14285714285714285,6,6,GAATAGAACGCATTCCACTT,0,4999833
yjbJ_predicted,0.14285714285714285,6,6,GAAGGGTTCTTCGTTCTGTA,0,5025474
yjbJ_predicted,0.14285714285714285,6,6,GAAGCTTCAAAGGCTGGCTC,0,5024356
yjbJ_predicted,0.14285714285714285,6,6,GAAGCCCATCTTTACTTACC,0,5018425
yjbJ_predicted,0.14285714285714285,6,6,GAACAGGTGCAAGCACGTTG,0,5010279
yjbJ_predicted,0.14285714285714285,6,6,GAAAGGCGTGATTTTCAGTT,0,5016203
yjbJ_predicted,0.14285714285714285,6,6,GAAAGATTCCCTAAACTAAC,0,5005496
yjbJ_predicted,0.14285714285714285,6,6,CTTTGATGCGAATTACCGGA,0,5021040
yjbJ_predicted,0.14285714285714285,6,6,CTTTAGGACATTCCCTATGT,0,5021888
yjbJ_predicted,0.14285714285714285,6,6,CTTGTAGGGAGCAAGTGAGC,0,5018830
yjbJ_predicted,0.14285714285714285,6,6,CTTGTAAAGGGGCTTCAACG,0,5018576
yjbJ_predicted,0.14285714285714285,6,6,CTTGGGAACTCACACAATTA,0,5024399
yjbJ_predicted,0.14285714285714285,6,6,CTTCTGAAGGGCTCTTTATA,0,5013866
yjbJ_predicted,0.14285714285714285,6,6,CTTCGAGTAGTTCGTATAAT,0,5025763
yjbJ_predicted,0.14285714285714285,6,6,CTTCAAAAGAGCATATCTAT,0,5010340
yjbJ_predicted,0.14285714285714285,6,6,CTTATTCTGTGACCAGACTT,0,5013381
yjbJ_predicted,0.14285714285714285,6,6,CTTAGTCGATCCGGTAATAG,0,5004257
yjbJ_predicted,0.14285714285714285,6,6,CTTAGTCCCAAGCAAACCCC,0,5029446
yjbJ_predicted,0.14285714285714285,6,6,CTTAGGGAATGCGTGAGTCG,0,5024307
yjbJ_predicted,0.14285714285714285,6,6,CTTACTTTGGTTGGAATGGT,0,5008311
yjbJ_predicted,0.14285714285714285,6,6,CTTACCAGGATCTACCCAAA,0,5026394
yjbJ_predicted,0.14285714285714285,6,6,CTTAACACGCCGCACCACTG,0,5003741
yjbJ_predicted,0.14285714285714285,6,6,CTGTAAGCAGGCTAGGGTGT,0,4998459
yjbJ_predicted,0.14285714285714285,6,6,CTGGACAGTAAAACATACTT,0,5024750
yjbJ_predicted,0.14285714285714285,6,6,CTGCTATGACACTATGAGAT,0,5006878
yjbJ_predicted,0.14285714285714285,6,6,CTGCGGAAGATGACCGATAT,0,5007290
yjbJ_predicted,0.14285714285714285,6,6,CTGCGCGGTTCTAGGAAACA,0,5009515
yjbJ_predicted,0.14285714285714285,6,6,CTGCATAAGCCTGTTAGCAT,0,5000846
yjbJ_predicted,0.14285714285714285,6,6,CTGATAAATCTGTGCTGGGG,0,5007906
yjbJ_predicted,0.14285714285714285,6,6,CTGAGTGCAGTGGCTATACA,0,5020831
yjbJ_predicted,0.14285714285714285,6,6,CTGAGCATCCTCTGAGGGTG,0,4994869
yjbJ_predicted,0.14285714285714285,6,6,CTCTCCGCCAAGAACGTCGT,0,5005330
yjbJ_predicted,0.14285714285714285,6,6,CTCGTGGGCAAGGCCACACC,0,5016111
yjbJ_predicted,0.14285714285714285,6,6,CTCCCTCTGAAGTCGGACAC,0,5005105
yjbJ_predicted,0.14285714285714285,6,6,CTCCAGCGTCCTGAGTTCCT,0,5017874
yjbJ_predicted,0.14285714285714285,6,6,CTATAAAAACGTTACCACGG,0,5019213
yjbJ_predicted,0.14285714285714285,6,6,CTAGTCTCACGGACGGTATC,0,5013698
yjbJ_predicted,0.14285714285714285,6,6,CTAGCTACACAACATAATAG,0,5029309
yjbJ_predicted,0.14285714285714285,6,6,CTAGAGCACATGGTAGTCGA,0,4997432
yjbJ_predicted,0.14285714285714285,6,6,CTACTTAAACGCAATGAGAT,0,5005457
yjbJ_predicted,0.14285714285714285,6,6,CTACGAGGGGATTGCATGCC,0,5027894
yjbJ_predicted,0.14285714285714285,6,6,CTAATATCAGTGAAACATCA,0,5013998
yjbJ_predicted,0.14285714285714285,6,6,CTAACGCCTGTTCCCAAGAG,0,5030351
yjbJ_predicted,0.14285714285714285,6,6,CGTTGGAACGGCATTAGTCC,0,5013589
yjbJ_predicted,0.14285714285714285,6,6,CGTTCGTGCGTGACTTTCAT,0,5003306
yjbJ_predicted,0.14285714285714285,6,6,CGTGAAGTGTGCCCCTGTCA,0,5002365
yjbJ_predicted,0.14285714285714285,6,6,CGTCTACCAGCAGAGTACTG,0,5002915
yjbJ_predicted,0.14285714285714285,6,6,CGTAGGTGTTTCGCACAGTA,0,5015690
yjbJ_predicted,0.14285714285714285,6,6,CGTACGCGGGACACTGGAGG,0,5010161
yjbJ_predicted,0.14285714285714285,6,6,CGGGTGAGGTGTAAGCGGCG,0,5011393
yjbJ_predicted,0.14285714285714285,6,6,CGGGTACGCATTTGAGTTCC,0,5026075
yjbJ_predicted,0.14285714285714285,6,6,CGGGGGTTCGCGGAGTGTCG,0,5011461
yjbJ_predicted,0.14285714285714285,6,6,CGGGAGGTGTCCTGCACGAT,0,5017645
yjbJ_predicted,0.14285714285714285,6,6,CGGGACGACCGTCAGCGAAC,0,5016259
yjbJ_predicted,0.14285714285714285,6,6,CGGCCGGCTGGGAAGATGTA,0,5004393
yjbJ_predicted,0.14285714285714285,6,6,CGGCAGAGGCTCTTCTGTAG,0,5022361
yjbJ_predicted,0.14285714285714285,6,6,CGGAACGATCGTATACCACA,0,5003874
yjbJ_predicted,0.14285714285714285,6,6,CGGAAAATATTCTTACCCAA,0,5026879
yjbJ_predicted,0.14285714285714285,6,6,CGCGAGACTCAAGTGATGTC,0,4996651
yjbJ_predicted,0.14285714285714285,6,6,CGCGAATGGAAGAAAGTATA,0,5029695
yjbJ_predicted,0.14285714285714285,6,6,CGCGAAGTGCAAAGCGACTA,0,5016920
yjbJ_predicted,0.14285714285714285,6,6,CGCCGCGAAGAAGATCCGTA,0,4995143
yjbJ_predicted,0.14285714285714285,6,6,CGCAGAATGCCTCACCGGAC,0,5014433
yjbJ_predicted,0.14285714285714285,6,6,CGCACTAACTTACCATGCGT,0,5017078
yjbJ_predicted,0.14285714285714285,6,6,CGCAAAGATAGGGAGAATTA,0,5020861
yjbJ_predicted,0.14285714285714285,6,6,CGATCTCAGTCTACCTGACA,0,5007831
yjbJ_predicted,0.14285714285714285,6,6,CGACTCACATCGAACGGCGC,0,5005261
yjbJ_predicted,0.14285714285714285,6,6,CGACGCATCCGCAATGAGCC,0,5011799
yjbJ_predicted,0.14285714285714285,6,6,CGAAGGGGGAGGGATCAGAA,0,4995533
yjbJ_predicted,0.14285714285714285,6,6,CGAAAGGATGACTTCGTAGT,0,5015726
yjbJ_predicted,0.14285714285714285,6,6,CCTTTTTGCTTGGGCCTCGC,0,5023209
yjbJ_predicted,0.14285714285714285,6,6,CCTTTGAGATCCTCAGTCAT,0,4998552
yjbJ_predicted,0.14285714285714285,6,6,CCTTTCAGTCAGATTACCCT,0,5027729
yjbJ_predicted,0.14285714285714285,6,6,CCTGCCCTTGGTAAGTCGGA,0,5002024
yjbJ_predicted,0.14285714285714285,6,6,CCTGCCCGTTGGCTTGGTGT,0,5028047
yjbJ_predicted,0.14285714285714285,6,6,CCTCTAGGCAACCTGCGATT,0,5014638
yjbJ_predicted,0.14285714285714285,6,6,CCGTGGAACTATGAGAGTAC,0,5027201
yjbJ_predicted,0.14285714285714285,6,6,CCGGATGCTCAGAGTAAACA,0,5022057
yjbJ_predicted,0.14285714285714285,6,6,CCGCTGCCCAGCGTCTTAGA,0,5028382
yjbJ_predicted,0.14285714285714285,6,6,CCGAACCCTTTCACCTTATC,0,5002321
yjbJ_predicted,0.14285714285714285,6,6,CCCGTTTGCTACATGCAATT,0,5017974
yjbJ_predicted,0.14285714285714285,6,6,CCCGGGCTTTGGTAGAATGT,0,4999087
yjbJ_predicted,0.14285714285714285,6,6,CCCCGGTTACATCGGAGTCG,0,5030303
yjbJ_predicted,0.14285714285714285,6,6,CCCCACAATCCTCTGCCCTG,0,4995936
yjbJ_predicted,0.14285714285714285,6,6,CCCATTACACCTTGACCATT,0,5010456
yjbJ_predicted,0.14285714285714285,6,6,CCCAGTCATGACAGTTGAAG,0,5026185
yjbJ_predicted,0.14285714285714285,6,6,CCCAAGGAGCGCGCAAGAAA,0,5006580
yjbJ_predicted,0.14285714285714285,6,6,CCATCCTTGTGTCCGTTAAG,0,5016175
yjbJ_predicted,0.14285714285714285,6,6,CCAGTTTACCTATAAAAGGT,0,5006437
yjbJ_predicted,0.14285714285714285,6,6,CCAGCCGATGGTCACGAGGA,0,5023754
yjbJ_predicted,0.14285714285714285,6,6,CCACTAGCGCGTAACTGGTT,0,5022470
yjbJ_predicted,0.14285714285714285,6,6,CCAAAGATAGATGGGTATAC,0,5009933
yjbJ_predicted,0.14285714285714285,6,6,CATGCGCTGAGGCCTACTGC,0,5014177
yjbJ_predicted,0.14285714285714285,6,6,CATGCGCCGACAGGGCGGTG,0,5028371
yjbJ_predicted,0.14285714285714285,6,6,CATGAGGTTAATCATCGAGC,0,5008996
yjbJ_predicted,0.14285714285714285,6,6,CATCGATAAGCAGGGGGCCA,0,5012112
yjbJ_predicted,0.14285714285714285,6,6,CATCATAGTACCAAAAGAGG,0,4995832
yjbJ_predicted,0.14285714285714285,6,6,CATCAGGAACCTGTCGTACA,0,5002312
yjbJ_predicted,0.14285714285714285,6,6,CATAATTTTCTTTTAGGTAC,0,5019363
yjbJ_predicted,0.14285714285714285,6,6,CAGTTTAAAAGGTCCTCGTT,0,5021809
yjbJ_predicted,0.14285714285714285,6,6,CAGTGGACATCGCCAGCATT,0,5011414
yjbJ_predicted,0.14285714285714285,6,6,CAGGGGTACACAGCCTACAG,0,5008782
yjbJ_predicted,0.14285714285714285,6,6,CAGGATCCAAACAAGTTCGC,0,5018978
yjbJ_predicted,0.14285714285714285,6,6,CAGATATGGAACCCGGTAGG,0,4997229
yjbJ_predicted,0.14285714285714285,6,6,CAGAGGGCAAAAGAATGGTA,0,5012730
yjbJ_predicted,0.14285714285714285,6,6,CAGAGCGCGGGCATCATGGT,0,5011031
yjbJ_predicted,0.14285714285714285,6,6,CAGACAATTATTTCCGGTAG,0,5028364
yjbJ_predicted,0.14285714285714285,6,6,CACGGCAGGGCGCACCTGTT,0,5029774
yjbJ_predicted,0.14285714285714285,6,6,CACGCGGCCTTCACAGTCGT,0,5022116
yjbJ_predicted,0.14285714285714285,6,6,CACGCATGGGGGGCAGATGA,0,5000364
yjbJ_predicted,0.14285714285714285,6,6,CACGAGCTGTTCCTCTTTCT,0,5018911
yjbJ_predicted,0.14285714285714285,6,6,CACCGTGGATGCTGCCATGC,0,5007896
yjbJ_predicted,0.14285714285714285,6,6,CACCGTGATAAGTCGGTCTG,0,4998630
yjbJ_predicted,0.14285714285714285,6,6,CACCGGTGTGTATCATAATT,0,5014127
yjbJ_predicted,0.14285714285714285,6,6,CACCCCCAGATTTCCTCCAT,0,5019981
yjbJ_predicted,0.14285714285714285,6,6,CACCCAAGGAGCCGCATCTT,0,5028423
yjbJ_predicted,0.14285714285714285,6,6,CACCAGGCAAGACTGTCCAC,0,5014682
yjbJ_predicted,0.14285714285714285,6,6,CACATTCTCCGCTATAGAGC,0,5023319
yjbJ_predicted,0.14285714285714285,6,6,CACACACACCGATCCTACGC,0,4999639
yjbJ_predicted,0.14285714285714285,6,6,CAATTACGGATACATCTAAC,0,4999554
yjbJ_predicted,0.14285714285714285,6,6,CAATGTACTCGTCTATTGAT,0,4997400
yjbJ_predicted,0.14285714285714285,6,6,CAATGGTTGGATAGAACTAG,0,5024220
yjbJ_predicted,0.14285714285714285,6,6,CAATGGGTTTCGGATGACTA,0,5009969
yjbJ_predicted,0.14285714285714285,6,6,CAATCCCATTCTAGACGGGT,0,5019736
yjbJ_predicted,0.14285714285714285,6,6,CAATCAGCCATGGGTATGCA,0,5027579
yjbJ_predicted,0.14285714285714285,6,6,CAATAGGCAGTACCAAGGGT,0,4997837
yjbJ_predicted,0.14285714285714285,6,6,CAAGTTGGTTATGTCGTAAC,0,5010685
yjbJ_predicted,0.14285714285714285,6,6,CAAGAGGACAGACATTGCTA,0,4998057
yjbJ_predicted,0.14285714285714285,6,6,CAAGAATATTGATCTGAGAC,0,5030031
yjbJ_predicted,0.14285714285714285,6,6,CAACGATATGCGCCTCCAGT,0,5029447
yjbJ_predicted,0.14285714285714285,6,6,CAAAGTACAAGTCTTCGCGA,0,5010826
yjbJ_predicted,0.14285714285714285,6,6,ATTTTGTTGGATATCTTTGA,0,5010044
yjbJ_predicted,0.14285714285714285,6,6,ATTTTAATGGGTGACAGTGT,0,5019811
yjbJ_predicted,0.14285714285714285,6,6,ATTTACCCGAGAGTAGGGCA,0,5030809
yjbJ_predicted,0.14285714285714285,6,6,ATTGCGTGGCGAACAGATAC,0,5012206
yjbJ_predicted,0.14285714285714285,6,6,ATTGCGTGACCGCAGAAACA,0,5004134
yjbJ_predicted,0.14285714285714285,6,6,ATTAGTTGTGAGCCTCCTCT,0,4998809
yjbJ_predicted,0.14285714285714285,6,6,ATGTTGCCGTGGAGCTCCAA,0,4996482
yjbJ_predicted,0.14285714285714285,6,6,ATGTTCTGCCGGTTCTCAAC,0,5000044
yjbJ_predicted,0.14285714285714285,6,6,ATGTTATGTAATTTAGAGTA,0,5004961
yjbJ_predicted,0.14285714285714285,6,6,ATGGTCTGTGTTAGAAGAAG,0,5006544
yjbJ_predicted,0.14285714285714285,6,6,ATGGATCCTGGGGATGCGGC,0,5003490
yjbJ_predicted,0.14285714285714285,6,6,ATGCTTATGATCCCTGGCTG,0,5019127
yjbJ_predicted,0.14285714285714285,6,6,ATGCTGACCTTGGAAAGTTT,0,5019195
yjbJ_predicted,0.14285714285714285,6,6,ATGCGTATAGAGAAGACGAG,0,5016021
yjbJ_predicted,0.14285714285714285,6,6,ATGCATTTTTAAATTCCCCA,0,5010168
yjbJ_predicted,0.14285714285714285,6,6,ATCTCCCAAACTATGGGGGT,0,5002769
yjbJ_predicted,0.14285714285714285,6,6,ATCTCAAGGTTATGGTAACA,0,5027921
yjbJ_predicted,0.14285714285714285,6,6,ATCTAGGTTATTGAATGAGG,0,5030883
yjbJ_predicted,0.14285714285714285,6,6,ATCGGGTCCGTATAATCCAA,0,4995060
yjbJ_predicted,0.14285714285714285,6,6,ATCCGAGAGCTTAGAGAAAC,0,5021166
yjbJ_predicted,0.14285714285714285,6,6,ATCCCCTTAACCTCGAGGCC,0,5000558
yjbJ_predicted,0.14285714285714285,6,6,ATATCTCGAATAACCATGAT,0,5011101
yjbJ_predicted,0.14285714285714285,6,6,ATATCCTCCGGGCTCATCTA,0,5021501
yjbJ_predicted,0.14285714285714285,6,6,ATAGCACAAAAGCGTAATAG,0,4998564
yjbJ_predicted,0.14285714285714285,6,6,ATACTGCTGCTATGGTACGT,0,5024283
yjbJ_predicted,0.14285714285714285,6,6,ATACGTCATAGTGGGTTGTG,0,4994967
yjbJ_predicted,0.14285714285714285,6,6,ATAAATTGTTGGCACTTTGG,0,5014487
yjbJ_predicted,0.14285714285714285,6,6,AGTTTACTATATGAGTGCAA,0,5008912
yjbJ_predicted,0.14285714285714285,6,6,AGTTATAGTTCGAGTCATTG,0,5023484
yjbJ_predicted,0.14285714285714285,6,6,AGTGTGTTTTTGAACGAAAG,0,5023427
yjbJ_predicted,0.14285714285714285,6,6,AGTGTGAGCAGGTGGGCGGT,0,5024974
yjbJ_predicted,0.14285714285714285,6,6,AGTGCATTCTTTCATAAGTA,0,5028339
yjbJ_predicted,0.14285714285714285,6,6,AGTCGCAGCCCGACAAAATA,0,5007230
yjbJ_predicted,0.14285714285714285,6,6,AGTATCAGGTGTTCGACACC,0,5024240
yjbJ_predicted,0.14285714285714285,6,6,AGTATATGGAGGTTAGTAAG,0,5012299
yjbJ_predicted,0.14285714285714285,6,6,AGTACAATTATACGATCGTA,0,4999029
yjbJ_predicted,0.14285714285714285,6,6,AGGTTTTCCCAGGATAGTAG,0,5012268
yjbJ_predicted,0.14285714285714285,6,6,AGGTTCCTAATTTTATGGTT,0,5021128
yjbJ_predicted,0.14285714285714285,6,6,AGGTTAATTAACCAGGGCAA,0,5009395
yjbJ_predicted,0.14285714285714285,6,6,AGGTCCTGTCGCTCATACGC,0,5000891
yjbJ_predicted,0.14285714285714285,6,6,AGGTAAGACATCACGACGGT,0,4998826
yjbJ_predicted,0.14285714285714285,6,6,AGGGGCTGGTCATAGCTGCG,0,5010401
yjbJ_predicted,0.14285714285714285,6,6,AGGCCTCACGGGAATGAATT,0,5002739
yjbJ_predicted,0.14285714285714285,6,6,AGGCCCGTGTGACAGTTGGA,0,4995799
yjbJ_predicted,0.14285714285714285,6,6,AGGATTACGGTCTCCAGCCC,0,5026874
yjbJ_predicted,0.14285714285714285,6,6,AGGATGGGACGGCTTTCTAA,0,5027401
yjbJ_predicted,0.14285714285714285,6,6,AGGAGCTGTGCCTCCGTTCT,0,5031208
yjbJ_predicted,0.14285714285714285,6,6,AGGAGAGTCCGCTGTCGAGC,0,5009019
yjbJ_predicted,0.14285714285714285,6,6,AGGAAAGGGCGTCGGTACCT,0,5005072
yjbJ_predicted,0.14285714285714285,6,6,AGCTCCTTCGAGGCACCATA,0,5030020
yjbJ_predicted,0.14285714285714285,6,6,AGCGCTCCCTCGTCGCGTGC,0,5028548
yjbJ_predicted,0.14285714285714285,6,6,AGCCAATTAGTGTCCATGTT,0,5029973
yjbJ_predicted,0.14285714285714285,6,6,AGCATAGTTCGAATGGTCCC,0,5026109
yjbJ_predicted,0.14285714285714285,6,6,AGATTTCACGTAGCGTACAC,0,5004445
yjbJ_predicted,0.14285714285714285,6,6,AGATCTCAATAGATCACTGA,0,5013900
yjbJ_predicted,0.14285714285714285,6,6,AGATACAGCCTTTTACTTGG,0,4998607
yjbJ_predicted,0.14285714285714285,6,6,AGAGTACTTCTATTACTGGT,0,5026212
yjbJ_predicted,0.14285714285714285,6,6,AGAGCCCCCGCTGCGATCAT,0,5030078
yjbJ_predicted,0.14285714285714285,6,6,AGACCCGTTTTGGGTCATCC,0,5004417
yjbJ_predicted,0.14285714285714285,6,6,AGACCCACAAAGATCTTTTC,0,5004132
yjbJ_predicted,0.14285714285714285,6,6,AGAATGGGGGTACTCCACTG,0,5005113
yjbJ_predicted,0.14285714285714285,6,6,AGAACAGGGAAAAAGTATGT,0,5026230
yjbJ_predicted,0.14285714285714285,6,6,AGAAATGGTCGTCATATGAT,0,5030299
yjbJ_predicted,0.14285714285714285,6,6,AGAAACCCGGAGTCCGAACT,0,5020030
yjbJ_predicted,0.14285714285714285,6,6,ACTTTTAGTTCGCCGTGAAG,0,5016450
yjbJ_predicted,0.14285714285714285,6,6,ACTTGCATCTGCGCAGAAAG,0,5030934
yjbJ_predicted,0.14285714285714285,6,6,ACTTGAAAAAGACATTCTGA,0,5015724
yjbJ_predicted,0.14285714285714285,6,6,ACTTCCGTCGCTCTAATATT,0,5022486
yjbJ_predicted,0.14285714285714285,6,6,ACTTAGGCGCCAGCAGTGCC,0,5019957
yjbJ_predicted,0.14285714285714285,6,6,ACTTAAGGGACTTTTTTGCT,0,5007868
yjbJ_predicted,0.14285714285714285,6,6,ACTGGGTGATGTAACGCAGC,0,4997665
yjbJ_predicted,0.14285714285714285,6,6,ACTGCGGCGATATCGAACTT,0,4999041
yjbJ_predicted,0.14285714285714285,6,6,ACTACAGCTGGGTAGTTCCT,0,5009892
yjbJ_predicted,0.14285714285714285,6,6,ACGTGGTAACATGCTAAATT,0,5025878
yjbJ_predicted,0.14285714285714285,6,6,ACGTGGCAGCCGTAATGGCC,0,5010860
yjbJ_predicted,0.14285714285714285,6,6,ACGTGATAGAATTACACAAC,0,5020025
yjbJ_predicted,0.14285714285714285,6,6,ACGTCGTATAAGAGCGCGCC,0,5001664
yjbJ_predicted,0.14285714285714285,6,6,ACGGTCTGACCACGTACCCA,0,4999345
yjbJ_predicted,0.14285714285714285,6,6,ACGGGGGGGCCACGGACATC,0,4996413
yjbJ_predicted,0.14285714285714285,6,6,ACGGGCGTGGATCGTTATAG,0,5021808
yjbJ_predicted,0.14285714285714285,6,6,ACGGGAGTTTCTACTATTCG,0,5018808
yjbJ_predicted,0.14285714285714285,6,6,ACGCGCAAACGGAATGCGCA,0,5013099
yjbJ_predicted,0.14285714285714285,6,6,ACGACGCGGAATCACCCACT,0,5018828
yjbJ_predicted,0.14285714285714285,6,6,ACGACCTCATATTAGAGATG,0,5016985
yjbJ_predicted,0.14285714285714285,6,6,ACGAATTGGCGACTTTTGAA,0,5017048
yjbJ_predicted,0.14285714285714285,6,6,ACCTTGACACGACTTCGGAT,0,5024855
yjbJ_predicted,0.14285714285714285,6,6,ACCTGACCGGCGATGTGCTC,0,5029908
yjbJ_predicted,0.14285714285714285,6,6,ACCTCGTCCGGCTTGAGAAA,0,5000072
yjbJ_predicted,0.14285714285714285,6,6,ACCGCGGCCCTGTGCGCGCC,0,5013985
yjbJ_predicted,0.14285714285714285,6,6,ACCCTGCACACGAGAGCGCA,0,4997552
yjbJ_predicted,0.14285714285714285,6,6,ACCCGCTACCAGTCCGGATT,0,5014188
yjbJ_predicted,0.14285714285714285,6,6,ACCCATGGGCTGTATTTTCT,0,5001242
yjbJ_predicted,0.14285714285714285,6,6,ACCATGCGTAAAGGTTCAAG,0,4999569
yjbJ_predicted,0.14285714285714285,6,6,ACCACGTGTCAGGGTTATCT,0,5014397
yjbJ_predicted,0.14285714285714285,6,6,ACATGTGGGGTATGGAAGAT,0,5022630
yjbJ_predicted,0.14285714285714285,6,6,ACATCTTAATCAATTCTATT,0,5025250
yjbJ_predicted,0.14285714285714285,6,6,ACATATTGGAATAATAGTGC,0,5017083
yjbJ_predicted,0.14285714285714285,6,6,ACAGGGCATGGTGCCTCGTG,0,5007508
yjbJ_predicted,0.14285714285714285,6,6,ACAGCTGAGTGAACTGTAGG,0,5021981
yjbJ_predicted,0.14285714285714285,6,6,ACACTTTTAACCTATGTCAA,0,5021996
yjbJ_predicted,0.14285714285714285,6,6,ACACCACCTCTACCAGAACT,0,4996018
yjbJ_predicted,0.14285714285714285,6,6,ACACACATGGAACGTTCTAC,0,5000488
yjbJ_predicted,0.14285714285714285,6,6,ACAATTCGAAAGGGCTGGCC,0,5015209
yjbJ_predicted,0.14285714285714285,6,6,ACAATCATTCTGAGACGAAG,0,5015896
yjbJ_predicted,0.14285714285714285,6,6,ACAAGATGTATTACTAGATA,0,5021938
yjbJ_predicted,0.14285714285714285,6,6,AATTTTGGGACATACGGAAA,0,5012016
yjbJ_predicted,0.14285714285714285,6,6,AATTTCGGGGTAAGCTTCGT,0,5003489
yjbJ_predicted,0.14285714285714285,6,6,AATTTCACAAGCCTGGCTTA,0,5001662
yjbJ_predicted,0.14285714285714285,6,6,AATTTAATTGATGTGGGAAA,0,4997460
yjbJ_predicted,0.14285714285714285,6,6,AATTGTCAGTCCAGCTTACT,0,5030323
yjbJ_predicted,0.14285714285714285,6,6,AATTAGTTGGCCACGTACGA,0,5010115
yjbJ_predicted,0.14285714285714285,6,6,AATTACTAGATGTAGGCGAA,0,5009277
yjbJ_predicted,0.14285714285714285,6,6,AATGAGGATATGGGGCGGTA,0,5007589
yjbJ_predicted,0.14285714285714285,6,6,AATATGCAACCGGAAGGGAA,0,5023481
yjbJ_predicted,0.14285714285714285,6,6,AATATACCTTCCTATAAGGA,0,4998232
yjbJ_predicted,0.14285714285714285,6,6,AATAGGGACTGGCCGTTAGA,0,4998576
yjbJ_predicted,0.14285714285714285,6,6,AAGTGGTAAGAGTGTCAAGC,0,4994905
yjbJ_predicted,0.14285714285714285,6,6,AAGTGGATGCAGAACACAAC,0,5009923
yjbJ_predicted,0.14285714285714285,6,6,AAGTACCCGTGGTGACACGT,0,5015248
yjbJ_predicted,0.14285714285714285,6,6,AAGGTGTAGACTGGCTGACT,0,5012320
yjbJ_predicted,0.14285714285714285,6,6,AAGGTGGGTCAGCTCTACTC,0,5018760
yjbJ_predicted,0.14285714285714285,6,6,AAGCTGCGAGATCTTAGGCA,0,5018540
yjbJ_predicted,0.14285714285714285,6,6,AAGCTCACCGCTCAGTGACT,0,5021348
yjbJ_predicted,0.14285714285714285,6,6,AAGCGTGGAAGCGTAAACTG,0,5004971
yjbJ_predicted,0.14285714285714285,6,6,AAGCAAGCTCTGGCTGGCAT,0,5017019
yjbJ_predicted,0.14285714285714285,6,6,AAGATCGTTCGGTACGGGAC,0,5011786
yjbJ_predicted,0.14285714285714285,6,6,AACTTGGGATGACTGCGCAG,0,5027816
yjbJ_predicted,0.14285714285714285,6,6,AACTTGAACTTCCAACGGGG,0,5024873
yjbJ_predicted,0.14285714285714285,6,6,AACTGCTGCCTGCTTTTAGA,0,5003837
yjbJ_predicted,0.14285714285714285,6,6,AACGTAAAGGATGGAGCCAA,0,5012135
yjbJ_predicted,0.14285714285714285,6,6,AACGAGATATCTTTCTCGAG,0,5022850
yjbJ_predicted,0.14285714285714285,6,6,AACCTCGTAATGAACGTGGT,0,4996067
yjbJ_predicted,0.14285714285714285,6,6,AACCTCACTCGTGAGCGGAA,0,4995763
yjbJ_predicted,0.14285714285714285,6,6,AACATGCGGTCTGGGTCGCA,0,4994787
yjbJ_predicted,0.14285714285714285,6,6,AACAGGTTAATTGCCCTATA,0,5002283
yjbJ_predicted,0.14285714285714285,6,6,AAATTTTGGGCCGGTGTAGC,0,5026008
yjbJ_predicted,0.14285714285714285,6,6,AAATCTTTGTAGTGGCATCA,0,4999159
yjbJ_predicted,0.14285714285714285,6,6,AAATAGACATCACCCGCTGT,0,5021866
yjbJ_predicted,0.14285714285714285,6,6,AAAGTGTCCAGAGTTTAATG,0,5006782
yjbJ_predicted,0.14285714285714285,6,6,AAAGTGGCGCTTGGGGCCGT,0,5012732
yjbJ_predicted,0.14285714285714285,6,6,AAAGGCTGAATGTTACGACT,0,5019141
yjbJ_predicted,0.14285714285714285,6,6,AAACTTTGTAAAGGTACGGA,0,5009936
yjbJ_predicted,0.14285714285714285,6,6,AAACAACGGAGGGTCAGAGC,0,4996681
yjbJ_predicted,0.14285714285714285,6,6,AAAATGACGAAATCACGTTT,0,5004218
yjbJ_predicted,0.14285714285714285,6,6,AAAAGTTGAACGTCTGACCT,0,5023316
yjbJ_predicted,0.14285714285714285,6,6,AAAAGGCTTTAGATCCTTTG,0,5016388
yjbJ_predicted,0.14285714285714285,6,6,AAAAGCCCTGAGAAGGGTCA,0,5024147
yjbJ_predicted,0.14285714285714285,6,6,AAAACATATCCTACCGATCA,0,5020558
yjbJ_predicted,0.16666666666666666,5,5,TTTTTGGATAGGCGGGGGTT,0,5021310
yjbJ_predicted,0.16666666666666666,5,5,TTTTGCGAGCGTATACAAGA,0,5010536
yjbJ_predicted,0.16666666666666666,5,5,TTTGTTCAGCCCCGTTTCCC,0,5026550
yjbJ_predicted,0.16666666666666666,5,5,TTTGTGACCGTTCATTGTCG,0,5029229
yjbJ_predicted,0.16666666666666666,5,5,TTTGTGAAACGGCTTATACC,0,5010779
yjbJ_predicted,0.16666666666666666,5,5,TTTCATTGTAACCGGCCCCG,0,5020104
yjbJ_predicted,0.16666666666666666,5,5,TTTATATGAAAGGGTTAGAG,0,5009029
yjbJ_predicted,0.16666666666666666,5,5,TTTACAACCCTGCGCTTAGC,0,4999727
yjbJ_predicted,0.16666666666666666,5,5,TTGTCACCGTAGGGTTTAAT,0,5000802
yjbJ_predicted,0.16666666666666666,5,5,TTGTAGTTTAATGTCCCGCG,0,4996874
yjbJ_predicted,0.16666666666666666,5,5,TTGGTTTCCATTGACTACAT,0,5011739
yjbJ_predicted,0.16666666666666666,5,5,TTGGTTAGCCCCGGCGTAGC,0,5005501
yjbJ_predicted,0.16666666666666666,5,5,TTGGTCTTACAAGGCGTGCC,0,5022135
yjbJ_predicted,0.16666666666666666,5,5,TTGGGTGTAGACGGCGGTGT,0,5019091
yjbJ_predicted,0.16666666666666666,5,5,TTGGCTAACGAGAGCTAAAA,0,5001358
yjbJ_predicted,0.16666666666666666,5,5,TTGGCGGTTACCCTGGTAGG,0,5024015
yjbJ_predicted,0.16666666666666666,5,5,TTGGCCTGGTCTATAGGAAC,0,5015641
yjbJ_predicted,0.16666666666666666,5,5,TTGCGCAGTATTCCATCCAT,0,4995293
yjbJ_predicted,0.16666666666666666,5,5,TTGATTTGCGAGATCACTTG,0,5008133
yjbJ_predicted,0.16666666666666666,5,5,TTGATCAAGGGTACCGATCA,0,5016241
yjbJ_predicted,0.16666666666666666,5,5,TTGACAACTTTGCCGGACAT,0,5008397
yjbJ_predicted,0.16666666666666666,5,5,TTCTGCTCCCTGACCGTTCG,0,5024977
yjbJ_predicted,0.16666666666666666,5,5,TTCTCAAAGACTCATGGACA,0,4995589
yjbJ_predicted,0.16666666666666666,5,5,TTCGTGTCGCCGGCCTTTTG,0,4997085
yjbJ_predicted,0.16666666666666666,5,5,TTCGGTGTTAAGGCGGACGC,0,5008826
yjbJ_predicted,0.16666666666666666,5,5,TTCGGGGTGGAGTTTCCTCG,0,5019137
yjbJ_predicted,0.16666666666666666,5,5,TTCCTTTAGTCCCGGGGCCT,0,5016074
yjbJ_predicted,0.16666666666666666,5,5,TTCCCTCTCGTAGAGCCCAA,0,5018822
yjbJ_predicted,0.16666666666666666,5,5,TTCCCACATCTCGCCAAAGG,0,5003366
yjbJ_predicted,0.16666666666666666,5,5,TTCCAGCTGAAGTTATTCGA,0,5022755
yjbJ_predicted,0.16666666666666666,5,5,TTCATGGACAAGTCGGTGGT,0,4994866
yjbJ_predicted,0.16666666666666666,5,5,TTCATGATCCCGGGCAACTT,0,4995434
yjbJ_predicted,0.16666666666666666,5,5,TTCATCGGGATGAACCAGGT,0,5007446
yjbJ_predicted,0.16666666666666666,5,5,TTCAGAAGTATCAGGAGGTT,0,5026405
yjbJ_predicted,0.16666666666666666,5,5,TTCACCCAGGGTGTGTCGCT,0,5006652
yjbJ_predicted,0.16666666666666666,5,5,TTCAAGGCCCCTTTATATTA,0,5011768
yjbJ_predicted,0.16666666666666666,5,5,TTATGAACCGGTCTAATTCT,0,5023509
yjbJ_predicted,0.16666666666666666,5,5,TTAGTTTCGCTCTTTTTTGT,0,5011465
yjbJ_predicted,0.16666666666666666,5,5,TTAGCCAGGAATGTTTACGG,0,5015236
yjbJ_predicted,0.16666666666666666,5,5,TTAGAAACTACATTGACAAA,0,5013525
yjbJ_predicted,0.16666666666666666,5,5,TTACTCTGCAGTCGCTCGAT,0,5014102
yjbJ_predicted,0.16666666666666666,5,5,TTACGCAGTATGGTAAACGG,0,5003847
yjbJ_predicted,0.16666666666666666,5,5,TTACGAAAAGGTACAGAGGT,0,5024822
yjbJ_predicted,0.16666666666666666,5,5,TTAATTGACCCACACGGTGT,0,5028348
yjbJ_predicted,0.16666666666666666,5,5,TTAATCTTTTGACGTATCAT,0,5025208
yjbJ_predicted,0.16666666666666666,5,5,TTAATCTGAGGTAACTGTCG,0,5006830
yjbJ_predicted,0.16666666666666666,5,5,TTAAGTTTCCCACCGCGGGT,0,4994718
yjbJ_predicted,0.16666666666666666,5,5,TTAACCGCGAGGGGCGCTAG,0,5017938
yjbJ_predicted,0.16666666666666666,5,5,TTAAATGGATCAGTGACGTT,0,5019606
yjbJ_predicted,0.16666666666666666,5,5,TTAAATAGGTCAACTTTAGG,0,4995196
yjbJ_predicted,0.16666666666666666,5,5,TTAAAAAACGCCGAATGCTG,0,5030199
yjbJ_predicted,0.16666666666666666,5,5,TGTTTTGGAAGCCGGGTGAC,0,5015340
yjbJ_predicted,0.16666666666666666,5,5,TGTTCGAAAGACAGGGTTCA,0,5018339
yjbJ_predicted,0.16666666666666666,5,5,TGTCGGTATCCGTTGGTTCT,0,5025654
yjbJ_predicted,0.16666666666666666,5,5,TGTCGGGTGTGGTTGTCCAA,0,5022699
yjbJ_predicted,0.16666666666666666,5,5,TGTCAGGGGCGTAACTGGCT,0,5020688
yjbJ_predicted,0.16666666666666666,5,5,TGGTTGAAAGGATCTAGGTA,0,4998608
yjbJ_predicted,0.16666666666666666,5,5,TGGTGATTATAGACCTTTAC,0,5000503
yjbJ_predicted,0.16666666666666666,5,5,TGGTCCTTCTGTCCGAAAAA,0,5013725
yjbJ_predicted,0.16666666666666666,5,5,TGGTCACAGCAAATTCACCC,0,5020473
yjbJ_predicted,0.16666666666666666,5,5,TGGGTCAATATAATCGGAAC,0,5002853
yjbJ_predicted,0.16666666666666666,5,5,TGGGGCTGACGGGACGTGAC,0,5023101
yjbJ_predicted,0.16666666666666666,5,5,TGGCTTCTCGGATTAACAAG,0,4995583
yjbJ_predicted,0.16666666666666666,5,5,TGGAGACAGAACCTCGCGTA,0,5010450
yjbJ_predicted,0.16666666666666666,5,5,TGGAATATTCGGCCTTTCAG,0,5008450
yjbJ_predicted,0.16666666666666666,5,5,TGGAACCAACTTCGGGTAAG,0,5011757
yjbJ_predicted,0.16666666666666666,5,5,TGCTTTAAGGACTCTAAGGT,0,5014933
yjbJ_predicted,0.16666666666666666,5,5,TGCGTCCCCCGTGACAAATT,0,5028547
yjbJ_predicted,0.16666666666666666,5,5,TGCGGGAGTTTGCATGCGAA,0,5006751
yjbJ_predicted,0.16666666666666666,5,5,TGCGCGAAGGTGGCAGGGCG,0,5013938
yjbJ_predicted,0.16666666666666666,5,5,TGCCTCGGGAAATAAAAGAT,0,5001995
yjbJ_predicted,0.16666666666666666,5,5,TGCCCCTTCAACGAGTCTCA,0,5004273
yjbJ_predicted,0.16666666666666666,5,5,TGCCATTAGGTAACCGAGGA,0,4996895
yjbJ_predicted,0.16666666666666666,5,5,TGCATGAACGGAATGGAGCC,0,4999091
yjbJ_predicted,0.16666666666666666,5,5,TGCATCTCGGCTTGAACTTG,0,5028216
yjbJ_predicted,0.16666666666666666,5,5,TGCACTCGATTCGGTCAATG,0,5018071
yjbJ_predicted,0.16666666666666666,5,5,TGCACATATTACGTTAGAGG,0,5022669
yjbJ_predicted,0.16666666666666666,5,5,TGCAAGCGCGTTGCCGATAT,0,5004773
yjbJ_predicted,0.16666666666666666,5,5,TGCAACCACTGCAGGCTCGA,0,5011161
yjbJ_predicted,0.16666666666666666,5,5,TGATCGCAACGAGAAGTGCA,0,5025320
yjbJ_predicted,0.16666666666666666,5,5,TGAGGGATGATAAATTGAGT,0,5019410
yjbJ_predicted,0.16666666666666666,5,5,TGACACGTTCAAAGTCCAGC,0,5026659
yjbJ_predicted,0.16666666666666666,5,5,TGAAATCCGCATTTGGGGTA,0,5027119
yjbJ_predicted,0.16666666666666666,5,5,TGAAAAGCCTAGTCATCGAC,0,5003812
yjbJ_predicted,0.16666666666666666,5,5,TCTTGAGTAAAATGTCCCGA,0,5006987
yjbJ_predicted,0.16666666666666666,5,5,TCTTATTCCCTCGAGCGCAT,0,5013248
yjbJ_predicted,0.16666666666666666,5,5,TCTTAGGACAAGTTGTTATT,0,5003426
yjbJ_predicted,0.16666666666666666,5,5,TCTCTAGAATGTTCGCGATT,0,5025759
yjbJ_predicted,0.16666666666666666,5,5,TCTCGCTGCATGCATGGCCG,0,4996125
yjbJ_predicted,0.16666666666666666,5,5,TCTAGGCACAGGCAAGGCAG,0,5006413
yjbJ_predicted,0.16666666666666666,5,5,TCTAAAGACCGGTGAATCTA,0,4995646
yjbJ_predicted,0.16666666666666666,5,5,TCGTGAGCTGAATCGCTTGT,0,5002795
yjbJ_predicted,0.16666666666666666,5,5,TCGTCTGGGTGCAGCAACCA,0,5017259
yjbJ_predicted,0.16666666666666666,5,5,TCGTAGCAGTGGGGTGCTAG,0,5007274
yjbJ_predicted,0.16666666666666666,5,5,TCGGTTACTTCTACGAAATC,0,5028718
yjbJ_predicted,0.16666666666666666,5,5,TCGGTGGGTGCACCACTTGT,0,5001257
yjbJ_predicted,0.16666666666666666,5,5,TCGGTAAGCAGGCACCAATC,0,5003195
yjbJ_predicted,0.16666666666666666,5,5,TCGGGTCTTACGCTGGACGT,0,5026536
yjbJ_predicted,0.16666666666666666,5,5,TCGGGAGGTTAGGCCACGTC,0,5000825
yjbJ_predicted,0.16666666666666666,5,5,TCGGCTCAACTGGGGCGCGA,0,5001656
yjbJ_predicted,0.16666666666666666,5,5,TCGGATGGATGTCCAGGGTG,0,5002989
yjbJ_predicted,0.16666666666666666,5,5,TCGGACCAACAGGGGTACCT,0,5029019
yjbJ_predicted,0.16666666666666666,5,5,TCGCTGATCAATACGTTCAT,0,5011933
yjbJ_predicted,0.16666666666666666,5,5,TCGCGTCGCCCGGGGCCACT,0,4996392
yjbJ_predicted,0.16666666666666666,5,5,TCGCGAGATATGAAGAATAG,0,5006349
yjbJ_predicted,0.16666666666666666,5,5,TCGCAAACGGGCTGAACCGA,0,5013764
yjbJ_predicted,0.16666666666666666,5,5,TCGATACGGTTCGGTTGAGG,0,4999788
yjbJ_predicted,0.16666666666666666,5,5,TCATTGACACTCTGTAGCGT,0,5012963
yjbJ_predicted,0.16666666666666666,5,5,TCATTACAGTGCACCCTCTT,0,5023962
yjbJ_predicted,0.16666666666666666,5,5,TCATCATCGTAATGCTTATC,0,4997519
yjbJ_predicted,0.16666666666666666,5,5,TCAGTTTTCTCACGAACTGA,0,5008274
yjbJ_predicted,0.16666666666666666,5,5,TCAGCCCATGAGATATCTGT,0,5010818
yjbJ_predicted,0.16666666666666666,5,5,TCAGATCACCCCGGGTTCTT,0,5027956
yjbJ_predicted,0.16666666666666666,5,5,TCACTTAGAGGCTAAGTCTA,0,5027550
yjbJ_predicted,0.16666666666666666,5,5,TCACTGTTGCTGTCGCCCTA,0,5003228
yjbJ_predicted,0.16666666666666666,5,5,TCACGTGCGACAGTAACGGT,0,5001103
yjbJ_predicted,0.16666666666666666,5,5,TCACGCCAAATTAAGATCTT,0,5021082
yjbJ_predicted,0.16666666666666666,5,5,TCACGAGGTGCTTTCTCTGG,0,4999663
yjbJ_predicted,0.16666666666666666,5,5,TCAAGCAGCGCGCAAAACGG,0,5030880
yjbJ_predicted,0.16666666666666666,5,5,TATTTCACAGGCAATTCATA,0,4997273
yjbJ_predicted,0.16666666666666666,5,5,TATTCCTGACGAACGCTGCG,0,5021465
yjbJ_predicted,0.16666666666666666,5,5,TATTAATGGTCAAATTGTAG,0,5013149
yjbJ_predicted,0.16666666666666666,5,5,TATGCGTCCGAGTCGTACAC,0,5007514
yjbJ_predicted,0.16666666666666666,5,5,TATCGGTTAGAACATGTCAA,0,5026696
yjbJ_predicted,0.16666666666666666,5,5,TATACATTTGAGTAGCTGAA,0,5000630
yjbJ_predicted,0.16666666666666666,5,5,TAGGTGTTCCGTCTCGGTCT,0,5000236
yjbJ_predicted,0.16666666666666666,5,5,TAGGTAAGCCGCGGGTTTGC,0,5016824
yjbJ_predicted,0.16666666666666666,5,5,TAGGCTTTTTGGGTTGTTTT,0,5029396
yjbJ_predicted,0.16666666666666666,5,5,TAGGCAACCTATTGCGCCAA,0,5012829
yjbJ_predicted,0.16666666666666666,5,5,TAGGATTCACAGCCAGGTTT,0,5010135
yjbJ_predicted,0.16666666666666666,5,5,TAGGATTACACTATAAGCAA,0,5017870
yjbJ_predicted,0.16666666666666666,5,5,TAGGATGTTGTTGTTTCTCG,0,5015317
yjbJ_predicted,0.16666666666666666,5,5,TAGCCATGAAGCGTCTGTCT,0,5015845
yjbJ_predicted,0.16666666666666666,5,5,TAGCCACGTTATAATTAAAT,0,5018629
yjbJ_predicted,0.16666666666666666,5,5,TAGACAGGGTCGCGGATTAG,0,5006824
yjbJ_predicted,0.16666666666666666,5,5,TAGAAAGCAGGTAGGGATAT,0,5013601
yjbJ_predicted,0.16666666666666666,5,5,TACGGGGACACCCTCTTCCA,0,5019239
yjbJ_predicted,0.16666666666666666,5,5,TACGGAGGAGTACATTCTCC,0,4996155
yjbJ_predicted,0.16666666666666666,5,5,TACGCCCTTAGAAAGACAGA,0,4998027
yjbJ_predicted,0.16666666666666666,5,5,TACGAATTTCATGTTCTTGT,0,5013203
yjbJ_predicted,0.16666666666666666,5,5,TACCTGGCAATGCCGTAAGA,0,5007043
yjbJ_predicted,0.16666666666666666,5,5,TACCACATCTTGAGTAGTAT,0,5005664
yjbJ_predicted,0.16666666666666666,5,5,TACATCGTGTGAGTTGCAGC,0,4997212
yjbJ_predicted,0.16666666666666666,5,5,TAATGTCCCCTTAGACTTTA,0,4997571
yjbJ_predicted,0.16666666666666666,5,5,TAAGCGAGCACGCCGGTGTC,0,5016321
yjbJ_predicted,0.16666666666666666,5,5,TAAGAAGGTAACGCAGAATA,0,5006146
yjbJ_predicted,0.16666666666666666,5,5,TAACGGACTCGAAATAATTC,0,4999400
yjbJ_predicted,0.16666666666666666,5,5,TAACCCCCCTCTGCATCGGT,0,5004006
yjbJ_predicted,0.16666666666666666,5,5,TAAATTGTGCTGCCTGGGTG,0,5020621
yjbJ_predicted,0.16666666666666666,5,5,TAAATCATATTGAGAGGCCA,0,5018809
yjbJ_predicted,0.16666666666666666,5,5,TAAATATGATACATTGCGTC,0,5005581
yjbJ_predicted,0.16666666666666666,5,5,TAAAGTATGGCCGGTCGAAT,0,5017429
yjbJ_predicted,0.16666666666666666,5,5,TAAAGGCGTGTCCAGTCAAA,0,5031312
yjbJ_predicted,0.16666666666666666,5,5,TAAACGCGTTGTGCACGAGG,0,4997872
yjbJ_predicted,0.16666666666666666,5,5,TAAAACCCCACACAGCACTT,0,5002242
yjbJ_predicted,0.16666666666666666,5,5,GTTTTTCTCGAATTCCCTGT,0,5015305
yjbJ_predicted,0.16666666666666666,5,5,GTTTTGTTCTATCTGATGGA,0,5006552
yjbJ_predicted,0.16666666666666666,5,5,GTTTCTGATCGCTAATTCAT,0,5006180
yjbJ_predicted,0.16666666666666666,5,5,GTTTCGCTCGGGCCTTGGGA,0,5006970
yjbJ_predicted,0.16666666666666666,5,5,GTTTCATGCAAGCTTACAAA,0,5002663
yjbJ_predicted,0.16666666666666666,5,5,GTTCGCGGCCGGTCGAAGCT,0,5029461
yjbJ_predicted,0.16666666666666666,5,5,GTTCGAAAATAGGAGTAAGA,0,5013016
yjbJ_predicted,0.16666666666666666,5,5,GTTCCATTATGTGTAGTTGG,0,5020864
yjbJ_predicted,0.16666666666666666,5,5,GTTACTCGACGGGACCACAC,0,5002420
yjbJ_predicted,0.16666666666666666,5,5,GTTACAGTCGTCATAACTAG,0,5002097
yjbJ_predicted,0.16666666666666666,5,5,GTTAATTCCGAAAAGACGAA,0,5015608
yjbJ_predicted,0.16666666666666666,5,5,GTGTCGGACCTGTCGGAGCC,0,5015497
yjbJ_predicted,0.16666666666666666,5,5,GTGTAATGTAATTTGCTCAC,0,5007596
yjbJ_predicted,0.16666666666666666,5,5,GTGGAGGGGGTTATCGTCTG,0,5022996
yjbJ_predicted,0.16666666666666666,5,5,GTGGAACGGTACCTACCTAC,0,5003632
yjbJ_predicted,0.16666666666666666,5,5,GTGCTTTGCCGACCGCAGGA,0,5012029
yjbJ_predicted,0.16666666666666666,5,5,GTGCGGCAGCTCAAGTTTGT,0,5024559
yjbJ_predicted,0.16666666666666666,5,5,GTGCAGTCTAGGCTGCTCGG,0,5024891
yjbJ_predicted,0.16666666666666666,5,5,GTGATCCAAAAGGTCTGGGG,0,5003241
yjbJ_predicted,0.16666666666666666,5,5,GTGAGATCAGCCGCGTGTCG,0,5028466
yjbJ_predicted,0.16666666666666666,5,5,GTCGTTCATTGCCACAAGAT,0,5015587
yjbJ_predicted,0.16666666666666666,5,5,GTCCGCTTATCCATCCAATT,0,5014390
yjbJ_predicted,0.16666666666666666,5,5,GTCCAGGGTCAGGCGACATC,0,5012991
yjbJ_predicted,0.16666666666666666,5,5,GTCATATTCAAGTTGAGGAC,0,5000673
yjbJ_predicted,0.16666666666666666,5,5,GTCATACATTACCCTAACGC,0,4998120
yjbJ_predicted,0.16666666666666666,5,5,GTATTTCTATAATGGGTAGC,0,4995577
yjbJ_predicted,0.16666666666666666,5,5,GTATTGTTCGTATAAGCGGA,0,5027484
yjbJ_predicted,0.16666666666666666,5,5,GTATTAACTGCGGTTCAAAC,0,5020929
yjbJ_predicted,0.16666666666666666,5,5,GTATACAGTTCGACAGACCC,0,5008917
yjbJ_predicted,0.16666666666666666,5,5,GTAGTCCGTCGCACCCCCGT,0,5010710
yjbJ_predicted,0.16666666666666666,5,5,GTAGGCTGAAACAACGCTCG,0,5015335
yjbJ_predicted,0.16666666666666666,5,5,GTAGGACCTGGCCTGTCCGA,0,5001140
yjbJ_predicted,0.16666666666666666,5,5,GTACTCCGATTTGCGGGTGC,0,4996656
yjbJ_predicted,0.16666666666666666,5,5,GTACTACCTCAACACGTTCT,0,4997709
yjbJ_predicted,0.16666666666666666,5,5,GTACAACTAAACCCCACGTT,0,5025358
yjbJ_predicted,0.16666666666666666,5,5,GTAAGGTCTTCGCCCTACGG,0,5011818
yjbJ_predicted,0.16666666666666666,5,5,GTAAGCAAGAATATTACATA,0,5005984
yjbJ_predicted,0.16666666666666666,5,5,GTAAACAAATTCCCTGATAA,0,5003843
yjbJ_predicted,0.16666666666666666,5,5,GGTTCTCATGGACGCAAAAG,0,5023062
yjbJ_predicted,0.16666666666666666,5,5,GGTCTTTTGTACGGCCTATA,0,5020779
yjbJ_predicted,0.16666666666666666,5,5,GGTCTCCTTTCTGAACGTAT,0,4997789
yjbJ_predicted,0.16666666666666666,5,5,GGTCGTTCTATCGATCCGTA,0,5023604
yjbJ_predicted,0.16666666666666666,5,5,GGTCGAGTTTGAAATACTGA,0,5025525
yjbJ_predicted,0.16666666666666666,5,5,GGTCCCAATGGATATTGTGG,0,5021002
yjbJ_predicted,0.16666666666666666,5,5,GGTATTTTCCGTGAAGCCGG,0,5021004
yjbJ_predicted,0.16666666666666666,5,5,GGTATCACGTGCAGAATTTT,0,5001870
yjbJ_predicted,0.16666666666666666,5,5,GGTACCAGAATACGATATCT,0,5017413
yjbJ_predicted,0.16666666666666666,5,5,GGTACAGCTAAATAGCCCGT,0,5027169
yjbJ_predicted,0.16666666666666666,5,5,GGTAAGCCTGGCTAATACAC,0,5022969
yjbJ_predicted,0.16666666666666666,5,5,GGTAACTGGTCGGTTCGAAC,0,5011708
yjbJ_predicted,0.16666666666666666,5,5,GGGTTGACCGGTCACATTAA,0,5008193
yjbJ_predicted,0.16666666666666666,5,5,GGGTCCTATTCCTTGGCCGA,0,5008922
yjbJ_predicted,0.16666666666666666,5,5,GGGGCTTATATCGCGAATTA,0,4999479
yjbJ_predicted,0.16666666666666666,5,5,GGGGCGATGCGTCGTTTATT,0,5030065
yjbJ_predicted,0.16666666666666666,5,5,GGGGCATAGCACTCACAACA,0,5031187
yjbJ_predicted,0.16666666666666666,5,5,GGGGAGTAACGGACTGGTGA,0,5007900
yjbJ_predicted,0.16666666666666666,5,5,GGGGACCTTGAAATTACTTT,0,4999657
yjbJ_predicted,0.16666666666666666,5,5,GGGCGATACATCGATGACAC,0,5020240
yjbJ_predicted,0.16666666666666666,5,5,GGGCGACTCACAAGCTTTGT,0,4996922
yjbJ_predicted,0.16666666666666666,5,5,GGGCCTTTTAGGGTTGAGCC,0,5009541
yjbJ_predicted,0.16666666666666666,5,5,GGGCCAACAGCGTGGTTTCA,0,4996894
yjbJ_predicted,0.16666666666666666,5,5,GGGACGCTTCTTGCGTTCAG,0,4998244
yjbJ_predicted,0.16666666666666666,5,5,GGGAACTCATGGCGACCAAT,0,4996710
yjbJ_predicted,0.16666666666666666,5,5,GGCTTCGGTAACTACAGCTT,0,5004430
yjbJ_predicted,0.16666666666666666,5,5,GGCTGACTATCACTTATTGA,0,4995117
yjbJ_predicted,0.16666666666666666,5,5,GGCGTAGGCACACATGGCGC,0,4997170
yjbJ_predicted,0.16666666666666666,5,5,GGCGGTGAGTTGAAAATGTG,0,5010426
yjbJ_predicted,0.16666666666666666,5,5,GGCGGTCCGGTATTATGGCC,0,4994944
yjbJ_predicted,0.16666666666666666,5,5,GGCGGATTGACTCTCAACAC,0,5014502
yjbJ_predicted,0.16666666666666666,5,5,GGCGGACAGTGTGCGATACT,0,5018579
yjbJ_predicted,0.16666666666666666,5,5,GGCGCACAAACACTTTTGTA,0,4998926
yjbJ_predicted,0.16666666666666666,5,5,GGCGAACCACCTGGTGGGAA,0,5022120
yjbJ_predicted,0.16666666666666666,5,5,GGCCTGTGGCTAATGGCGTT,0,4999257
yjbJ_predicted,0.16666666666666666,5,5,GGCCTCTGATTCGTTCGTTT,0,5002010
yjbJ_predicted,0.16666666666666666,5,5,GGCCGTTGCTTGTTTCAGGA,0,5005279
yjbJ_predicted,0.16666666666666666,5,5,GGCCCGTGGCGCTCCCCTAG,0,5001456
yjbJ_predicted,0.16666666666666666,5,5,GGCCCAGGGCCTACCGGGCA,0,5025110
yjbJ_predicted,0.16666666666666666,5,5,GGCACTGGTTCTTAATTGTA,0,5026698
yjbJ_predicted,0.16666666666666666,5,5,GGATTCCGCGGCTTCGAGCA,0,5009360
yjbJ_predicted,0.16666666666666666,5,5,GGATTCCCAGCGCTGTCTTT,0,5002555
yjbJ_predicted,0.16666666666666666,5,5,GGAGGGCAAACCTAAGGTAT,0,5026046
yjbJ_predicted,0.16666666666666666,5,5,GGAGCATAGATCCAGCCGGT,0,5023372
yjbJ_predicted,0.16666666666666666,5,5,GGACTAGATCGGGCAGTGCA,0,5001951
yjbJ_predicted,0.16666666666666666,5,5,GGAATATCGAGAATACAGAG,0,5003680
yjbJ_predicted,0.16666666666666666,5,5,GGAACGAGGTATTTAGAACG,0,5002546
yjbJ_predicted,0.16666666666666666,5,5,GCTTTTGGGGCACACGTAAA,0,5023476
yjbJ_predicted,0.16666666666666666,5,5,GCTTTTCCTTCTGGCTTTAC,0,4996409
yjbJ_predicted,0.16666666666666666,5,5,GCTTTGGCGTGTCAAGTTTA,0,5004719
yjbJ_predicted,0.16666666666666666,5,5,GCTTTATACGTCGGATCATA,0,5029322
yjbJ_predicted,0.16666666666666666,5,5,GCTTGGTTGTGTGAATTGCT,0,5003297
yjbJ_predicted,0.16666666666666666,5,5,GCTTGGCCTCTTAGTGACGG,0,5028396
yjbJ_predicted,0.16666666666666666,5,5,GCTTCAGCGGTCTCTAGGTT,0,5027683
yjbJ_predicted,0.16666666666666666,5,5,GCTGGCCGGAACTCATCCCA,0,5007429
yjbJ_predicted,0.16666666666666666,5,5,GCTGGATAGAAGTATTTTCC,0,5022916
yjbJ_predicted,0.16666666666666666,5,5,GCTGCAAGAAACTCTACGAT,0,5019551
yjbJ_predicted,0.16666666666666666,5,5,GCTCTCTGTCTTACTTGCAT,0,5009759
yjbJ_predicted,0.16666666666666666,5,5,GCTCGGCCCATTCGCTAGAC,0,5010212
yjbJ_predicted,0.16666666666666666,5,5,GCTCGCAGCAAACCACCTCA,0,5023454
yjbJ_predicted,0.16666666666666666,5,5,GCTCAGGTACCTCCGTCACT,0,5018594
yjbJ_predicted,0.16666666666666666,5,5,GCTATTTAAGTCAGTTAAGA,0,5026180
yjbJ_predicted,0.16666666666666666,5,5,GCTAGGTATAGCGGGTCCGG,0,5024369
yjbJ_predicted,0.16666666666666666,5,5,GCTACTCTTTCAGGAGGAAA,0,5022620
yjbJ_predicted,0.16666666666666666,5,5,GCGTTGGAGAGCCATGTTGA,0,5021961
yjbJ_predicted,0.16666666666666666,5,5,GCGTGTGAAACGGGTAAACG,0,5001922
yjbJ_predicted,0.16666666666666666,5,5,GCGTCCTATACATGGCTTAT,0,5011612
yjbJ_predicted,0.16666666666666666,5,5,GCGTACTTTAGCAGCTTGGT,0,4999763
yjbJ_predicted,0.16666666666666666,5,5,GCGGATCTAATCAATCGGTC,0,5029096
yjbJ_predicted,0.16666666666666666,5,5,GCGGAGTTAATCTATGTATA,0,5023155
yjbJ_predicted,0.16666666666666666,5,5,GCGGAGCCCTCATGCGTATA,0,4997906
yjbJ_predicted,0.16666666666666666,5,5,GCGCATTGGCCAACCCCTTG,0,4998492
yjbJ_predicted,0.16666666666666666,5,5,GCCTCTGGGTGTGTTTCTAT,0,4998017
yjbJ_predicted,0.16666666666666666,5,5,GCCTCGCACGTGGCCTACGC,0,5024012
yjbJ_predicted,0.16666666666666666,5,5,GCCCTAAGGACTTGTGTGAA,0,5009501
yjbJ_predicted,0.16666666666666666,5,5,GCCCGTGTAGATGGAACTCT,0,5000845
yjbJ_predicted,0.16666666666666666,5,5,GCCAGAGCTGGAGAACCAGC,0,4997081
yjbJ_predicted,0.16666666666666666,5,5,GCCACCACACTCGGGATGGC,0,5024916
yjbJ_predicted,0.16666666666666666,5,5,GCCAATTCCTTTCCACTAGC,0,5002792
yjbJ_predicted,0.16666666666666666,5,5,GCATGTACTCTGATGAGGTT,0,5022465
yjbJ_predicted,0.16666666666666666,5,5,GCATCGAGAACCTCAGCGGA,0,5003308
yjbJ_predicted,0.16666666666666666,5,5,GCATATTAATAGAAAAAACT,0,5006846
yjbJ_predicted,0.16666666666666666,5,5,GCATATCGTGACACGTTTAT,0,5024334
yjbJ_predicted,0.16666666666666666,5,5,GCAGAATGATGACCCAGATC,0,5008898
yjbJ_predicted,0.16666666666666666,5,5,GCACAGAAGGCGGCGTGATG,0,5015977
yjbJ_predicted,0.16666666666666666,5,5,GCAATTAATTCAATTGTTGT,0,5002148
yjbJ_predicted,0.16666666666666666,5,5,GCAAGTTCAAAGTACGGTCT,0,5016639
yjbJ_predicted,0.16666666666666666,5,5,GCAAGCAAGTTGATCAATAT,0,5002248
yjbJ_predicted,0.16666666666666666,5,5,GATTTGACTCATGCTGTTAA,0,5003592
yjbJ_predicted,0.16666666666666666,5,5,GATTATGCGGATACGTGTAT,0,5022242
yjbJ_predicted,0.16666666666666666,5,5,GATTATCAATTCTGGAACGA,0,5003206
yjbJ_predicted,0.16666666666666666,5,5,GATGGAAATCACGCAAGACG,0,5023184
yjbJ_predicted,0.16666666666666666,5,5,GATGCGCAAAGAATGCCTCC,0,5011163
yjbJ_predicted,0.16666666666666666,5,5,GATGAAAAGGTTGTTCGCTG,0,5029584
yjbJ_predicted,0.16666666666666666,5,5,GATCTTGATCCAATGTTCGA,0,5030014
yjbJ_predicted,0.16666666666666666,5,5,GATCATCCGAGCTTTGTAAT,0,5013713
yjbJ_predicted,0.16666666666666666,5,5,GATACTTACTTTTTTGAGTC,0,5009169
yjbJ_predicted,0.16666666666666666,5,5,GATACGGCGTCGATGTAACC,0,5023630
yjbJ_predicted,0.16666666666666666,5,5,GATAAGTCCACCAGGGCACG,0,5005453
yjbJ_predicted,0.16666666666666666,5,5,GAGTACAGTGTAGCTGAAAA,0,5010393
yjbJ_predicted,0.16666666666666666,5,5,GAGGGTCTGGCTGCATTTTG,0,5003242
yjbJ_predicted,0.16666666666666666,5,5,GAGGCCACGGAATGTTGCTT,0,5017764
yjbJ_predicted,0.16666666666666666,5,5,GAGCCCTAATAGCTGGAGCA,0,4998385
yjbJ_predicted,0.16666666666666666,5,5,GACTGTCGTTCGTAACTCAT,0,5005357
yjbJ_predicted,0.16666666666666666,5,5,GACTAGGATGCACCGCCACG,0,4996017
yjbJ_predicted,0.16666666666666666,5,5,GACGCGGTTATCTCAGTTAT,0,5000785
yjbJ_predicted,0.16666666666666666,5,5,GACGCGGACGAGATTCAATC,0,4996638
yjbJ_predicted,0.16666666666666666,5,5,GACCCGTATCTGTTTGAGCA,0,5019896
yjbJ_predicted,0.16666666666666666,5,5,GACATTCTATGTTGACGAGA,0,5025761
yjbJ_predicted,0.16666666666666666,5,5,GACAGCTATCTACGACGCCC,0,5026182
yjbJ_predicted,0.16666666666666666,5,5,GAATGCAGACAGTGTATGCA,0,5027121
yjbJ_predicted,0.16666666666666666,5,5,GAATCCTTACCGGGGAGAGT,0,5026935
yjbJ_predicted,0.16666666666666666,5,5,GAATACTGCGTATGGTCTCT,0,4999038
yjbJ_predicted,0.16666666666666666,5,5,GAAGTGCCCGTCCCTTAACT,0,5006472
yjbJ_predicted,0.16666666666666666,5,5,GAACGTGCACATATCTACAG,0,4997702
yjbJ_predicted,0.16666666666666666,5,5,GAAATATATGCGCCGGGGCA,0,4995640
yjbJ_predicted,0.16666666666666666,5,5,GAAATAAGATAGATACGTGA,0,4994906
yjbJ_predicted,0.16666666666666666,5,5,GAAACGCCCCGTTCCCCTTC,0,4995276
yjbJ_predicted,0.16666666666666666,5,5,GAAAAGAGGTGCACGTCTCT,0,5013513
yjbJ_predicted,0.16666666666666666,5,5,CTTTCCAGCCGCGCTGACTG,0,5011550
yjbJ_predicted,0.16666666666666666,5,5,CTTTACGATAATGGTATTCA,0,5001432
yjbJ_predicted,0.16666666666666666,5,5,CTTTAAGGTGAGCGGGGACG,0,5023322
yjbJ_predicted,0.16666666666666666,5,5,CTTTAAAATCCTGTGGCTAA,0,4999959
yjbJ_predicted,0.16666666666666666,5,5,CTTGTCCGGCACTACGTGTA,0,5005979
yjbJ_predicted,0.16666666666666666,5,5,CTTCTTCACGGGTATTAGCT,0,4996426
yjbJ_predicted,0.16666666666666666,5,5,CTTCTCAGTCATATATTAAC,0,5015812
yjbJ_predicted,0.16666666666666666,5,5,CTTCTACTAATCCAAACATT,0,5018005
yjbJ_predicted,0.16666666666666666,5,5,CTTATGATCTTCAAGAGATG,0,5012784
yjbJ_predicted,0.16666666666666666,5,5,CTTATCCTCTTAAATAATGT,0,5017643
yjbJ_predicted,0.16666666666666666,5,5,CTGTTCTTCGGCAGGAGTGA,0,5000560
yjbJ_predicted,0.16666666666666666,5,5,CTGTCATTTATTATCAGCAA,0,5000581
yjbJ_predicted,0.16666666666666666,5,5,CTGGTAGGTCGTAGAACTAG,0,4995459
yjbJ_predicted,0.16666666666666666,5,5,CTGGGTCATCCGGCATTTCT,0,5001337
yjbJ_predicted,0.16666666666666666,5,5,CTGGGCAGACGACTCAGGTA,0,5012908
yjbJ_predicted,0.16666666666666666,5,5,CTGGCGTCTAGAATCCTTTC,0,5007131
yjbJ_predicted,0.16666666666666666,5,5,CTGGAGCCACATCGCATCTC,0,4998813
yjbJ_predicted,0.16666666666666666,5,5,CTGGACGGATCAGTTAAGTA,0,5015778
yjbJ_predicted,0.16666666666666666,5,5,CTGCTTATCAGCGGATTCGC,0,5013012
yjbJ_predicted,0.16666666666666666,5,5,CTGCTGTGGAAAGTCATCCG,0,5026173
yjbJ_predicted,0.16666666666666666,5,5,CTGCCTCTGAAGTAGTGAAA,0,5002919
yjbJ_predicted,0.16666666666666666,5,5,CTGCCACGGCTGATAGCGAT,0,5018888
yjbJ_predicted,0.16666666666666666,5,5,CTCTTAGGCTCTCTCGAGTA,0,5030201
yjbJ_predicted,0.16666666666666666,5,5,CTCGGTCAGATTTTCCGCTT,0,5010541
yjbJ_predicted,0.16666666666666666,5,5,CTCGCTCGGTTTAGTCCTGA,0,5004659
yjbJ_predicted,0.16666666666666666,5,5,CTCCGTAGCCGGGTACAACG,0,5000837
yjbJ_predicted,0.16666666666666666,5,5,CTCATAGCTGCGCGAGATCT,0,5023375
yjbJ_predicted,0.16666666666666666,5,5,CTCATAAGGCACATACTAAT,0,5012319
yjbJ_predicted,0.16666666666666666,5,5,CTCAGCACGACCGCGTGTCC,0,5031001
yjbJ_predicted,0.16666666666666666,5,5,CTCACGTCTCATAGCTTCTA,0,5030977
yjbJ_predicted,0.16666666666666666,5,5,CTATTGCGGCATCAACAATG,0,5015178
yjbJ_predicted,0.16666666666666666,5,5,CTATGGTCTTTCCTCGGATA,0,5001946
yjbJ_predicted,0.16666666666666666,5,5,CTATATGTTTCGTAGGTTAA,0,5024690
yjbJ_predicted,0.16666666666666666,5,5,CTAGGCGTAAGGGGTATCGG,0,5017227
yjbJ_predicted,0.16666666666666666,5,5,CTAGATGCCCCAGTTGAGTT,0,5020438
yjbJ_predicted,0.16666666666666666,5,5,CTAGACGTTGGGAATTAGCA,0,5026623
yjbJ_predicted,0.16666666666666666,5,5,CTAGAAATTTGATAGGAGTC,0,5014976
yjbJ_predicted,0.16666666666666666,5,5,CTACTCCTATTTAGCTCATA,0,5001448
yjbJ_predicted,0.16666666666666666,5,5,CTACTAGGCTAAGCGCCATT,0,5021389
yjbJ_predicted,0.16666666666666666,5,5,CTACCGACCGTCGGGCTTCC,0,4997415
yjbJ_predicted,0.16666666666666666,5,5,CTACAACAGGGGAAGCATTT,0,5024198
yjbJ_predicted,0.16666666666666666,5,5,CGTTACGAGCGCAAACCTTT,0,5022639
yjbJ_predicted,0.16666666666666666,5,5,CGTGTTGGGTTTCTAAGCGA,0,5026547
yjbJ_predicted,0.16666666666666666,5,5,CGTGTCGTCGGTTAATCGTA,0,5021276
yjbJ_predicted,0.16666666666666666,5,5,CGTGTCCGACTTTACAGCCT,0,5013459
yjbJ_predicted,0.16666666666666666,5,5,CGTAAGAGGGACGCACGGAG,0,5024329
yjbJ_predicted,0.16666666666666666,5,5,CGTAAGAAATATCGCATTGG,0,5006409
yjbJ_predicted,0.16666666666666666,5,5,CGGTTGAGGATATTGGGGAA,0,5018850
yjbJ_predicted,0.16666666666666666,5,5,CGGTGGCCACAGTCTGGGTC,0,5012262
yjbJ_predicted,0.16666666666666666,5,5,CGGTGAATAATATGTTCGGG,0,5021650
yjbJ_predicted,0.16666666666666666,5,5,CGGTCAGTCAATTTTTCTAA,0,5020674
yjbJ_predicted,0.16666666666666666,5,5,CGGTCAGTAGTATCTGGGGA,0,5003576
yjbJ_predicted,0.16666666666666666,5,5,CGGTCAGCGACCGTCATTCT,0,5006616
yjbJ_predicted,0.16666666666666666,5,5,CGGTCAGCATTCTGTTGTGT,0,5014727
yjbJ_predicted,0.16666666666666666,5,5,CGGTATCATCAAATATCACT,0,5026809
yjbJ_predicted,0.16666666666666666,5,5,CGGTAACGTTTTGGAATGCG,0,5030300
yjbJ_predicted,0.16666666666666666,5,5,CGGGTTTTAGCGGCTGACCA,0,5012536
yjbJ_predicted,0.16666666666666666,5,5,CGGGGGCTCTATCTCAACGA,0,5005544
yjbJ_predicted,0.16666666666666666,5,5,CGGGATACATCCGGAAACGC,0,5019430
yjbJ_predicted,0.16666666666666666,5,5,CGGCTGCTGCGGGATGAGGC,0,5011718
yjbJ_predicted,0.16666666666666666,5,5,CGCTTTACTTTAAGGCTCGA,0,4999972
yjbJ_predicted,0.16666666666666666,5,5,CGCTTCAGCGGGCAGCCATG,0,5019473
yjbJ_predicted,0.16666666666666666,5,5,CGCTGGCTTGGGCGTAGGGT,0,4998016
yjbJ_predicted,0.16666666666666666,5,5,CGCTGCTTATTATAAATTTG,0,5027365
yjbJ_predicted,0.16666666666666666,5,5,CGCTCCCATTCATATACGCT,0,5011575
yjbJ_predicted,0.16666666666666666,5,5,CGCTCAAAGGGGGTCCGACC,0,5006559
yjbJ_predicted,0.16666666666666666,5,5,CGCGGTCATTCAGGGACACT,0,5014151
yjbJ_predicted,0.16666666666666666,5,5,CGCGGTATAGAACGGTAAAG,0,5009701
yjbJ_predicted,0.16666666666666666,5,5,CGCGCCAGCGGATAACGCTT,0,5002102
yjbJ_predicted,0.16666666666666666,5,5,CGCCTTAGCATATCTAATAA,0,4997793
yjbJ_predicted,0.16666666666666666,5,5,CGCCTTACAACTATGGGACT,0,5007707
yjbJ_predicted,0.16666666666666666,5,5,CGCCTCCGTTTGCGGACAAA,0,5028103
yjbJ_predicted,0.16666666666666666,5,5,CGCCGGCATACGGCCGCCCG,0,5022840
yjbJ_predicted,0.16666666666666666,5,5,CGCAGGTTGACGTGGATCTG,0,5006829
yjbJ_predicted,0.16666666666666666,5,5,CGCAATGAGCGCGCAAAAAC,0,5006388
yjbJ_predicted,0.16666666666666666,5,5,CGATGGCGTTATTGACTACA,0,5019384
yjbJ_predicted,0.16666666666666666,5,5,CGATCAGATAGCATATATTT,0,4995933
yjbJ_predicted,0.16666666666666666,5,5,CGAGTGGTCTCACCATGGCG,0,5013971
yjbJ_predicted,0.16666666666666666,5,5,CGAGGGCAATCTCGAGTCAC,0,4996056
yjbJ_predicted,0.16666666666666666,5,5,CGAGAACCGTTATTTTTTAT,0,5006864
yjbJ_predicted,0.16666666666666666,5,5,CGACGGCGGACACGGCAACA,0,5026009
yjbJ_predicted,0.16666666666666666,5,5,CGACCGGCTTGCTCGTTTCC,0,5015252
yjbJ_predicted,0.16666666666666666,5,5,CGACATTTAATCATACCAAC,0,5021297
yjbJ_predicted,0.16666666666666666,5,5,CGACAATGCATTACCAGTGC,0,5015353
yjbJ_predicted,0.16666666666666666,5,5,CGAAATGTTATCGAAAATCG,0,5024379
yjbJ_predicted,0.16666666666666666,5,5,CGAAAGCGCGGTCATGTATA,0,5008918
yjbJ_predicted,0.16666666666666666,5,5,CCTTCGAAGCGTCTCAGAGA,0,5021697
yjbJ_predicted,0.16666666666666666,5,5,CCTTCCACGTTAAATTTGGC,0,5011120
yjbJ_predicted,0.16666666666666666,5,5,CCTTAGGATACTAAGTCCAG,0,5010064
yjbJ_predicted,0.16666666666666666,5,5,CCTCGAGGAGGGTCTTGTGT,0,5027809
yjbJ_predicted,0.16666666666666666,5,5,CCTCACCTATCTCACGGAGA,0,5016146
yjbJ_predicted,0.16666666666666666,5,5,CCTCAATTCTTAACTGTGAG,0,5029992
yjbJ_predicted,0.16666666666666666,5,5,CCTATTGCACTCGTCACTCT,0,4995705
yjbJ_predicted,0.16666666666666666,5,5,CCTAGTTTTGACATAAAAAT,0,5005188
yjbJ_predicted,0.16666666666666666,5,5,CCTAAAGGTGAAGAGGGTAT,0,5028091
yjbJ_predicted,0.16666666666666666,5,5,CCGTTAGTAACGCATGTTAG,0,5013715
yjbJ_predicted,0.16666666666666666,5,5,CCGTAGGTGAATGATGGAGT,0,5004894
yjbJ_predicted,0.16666666666666666,5,5,CCGGGAAGGCGCCGAAGGAC,0,5022658
yjbJ_predicted,0.16666666666666666,5,5,CCGGAACGCATTTAACTTAT,0,5018002
yjbJ_predicted,0.16666666666666666,5,5,CCGCTGTCGAGACAGCCAGC,0,5002750
yjbJ_predicted,0.16666666666666666,5,5,CCGATGGTATGGGTTTCGCC,0,5031067
yjbJ_predicted,0.16666666666666666,5,5,CCGAATTAGGCCAAGCCTTT,0,5002978
yjbJ_predicted,0.16666666666666666,5,5,CCCTGGGTTGACACCCGCTA,0,4995700
yjbJ_predicted,0.16666666666666666,5,5,CCCGTAAGTCATTGGTCATT,0,5000531
yjbJ_predicted,0.16666666666666666,5,5,CCCGGATACGGTTTAGAAAT,0,5029371
yjbJ_predicted,0.16666666666666666,5,5,CCCGAGTGTGCAAATGACGA,0,5026342
yjbJ_predicted,0.16666666666666666,5,5,CCCCGGCCCGTGAAATTTTA,0,5028754
yjbJ_predicted,0.16666666666666666,5,5,CCCCCAACGTGGCTGGGCTC,0,5025264
yjbJ_predicted,0.16666666666666666,5,5,CCCCAGGGGCGACGGCTGCT,0,5019883
yjbJ_predicted,0.16666666666666666,5,5,CCAGTGGCGAACGGACATTT,0,5007051
yjbJ_predicted,0.16666666666666666,5,5,CCAGGCCTTAGACAAGTGGG,0,5020275
yjbJ_predicted,0.16666666666666666,5,5,CCAGAGAGTCACCGATTAGG,0,5010730
yjbJ_predicted,0.16666666666666666,5,5,CCACTTGCGAAGAAGGTGGC,0,5005421
yjbJ_predicted,0.16666666666666666,5,5,CCAAAGTAGCCGGGAGTCGT,0,5017809
yjbJ_predicted,0.16666666666666666,5,5,CATTTCTCCTGCTGAACACT,0,5005956
yjbJ_predicted,0.16666666666666666,5,5,CATGTGGCACACGGTTGTAA,0,5010466
yjbJ_predicted,0.16666666666666666,5,5,CATCGGTTGCTAGGTGTGTG,0,5000606
yjbJ_predicted,0.16666666666666666,5,5,CATCGGGGCGAGAAGTTAAG,0,5021085
yjbJ_predicted,0.16666666666666666,5,5,CATCAGACTGTGATGCCCAC,0,4999801
yjbJ_predicted,0.16666666666666666,5,5,CATATCCAAAGTGGTACAGT,0,5028403
yjbJ_predicted,0.16666666666666666,5,5,CATAGAATAATTAGTGCGGA,0,5009522
yjbJ_predicted,0.16666666666666666,5,5,CATAAGTGAGGTTGATTTTA,0,5008337
yjbJ_predicted,0.16666666666666666,5,5,CATAAAGCTATGGGGCCAGA,0,5029912
yjbJ_predicted,0.16666666666666666,5,5,CAGTATATAACCCCCATGAC,0,5016251
yjbJ_predicted,0.16666666666666666,5,5,CAGTACGCCAGTCACTCCGT,0,5010162
yjbJ_predicted,0.16666666666666666,5,5,CAGTACCGACTGCTTCTAGG,0,5019224
yjbJ_predicted,0.16666666666666666,5,5,CAGGTTCTGGCCTTTCATCA,0,5025953
yjbJ_predicted,0.16666666666666666,5,5,CAGGTCCCGAGGGGAATCCT,0,5000976
yjbJ_predicted,0.16666666666666666,5,5,CAGGTAAGCGGGTACTGTAG,0,5030387
yjbJ_predicted,0.16666666666666666,5,5,CAGGCAGTTTGTATCGTGTA,0,5024940
yjbJ_predicted,0.16666666666666666,5,5,CAGCCTTCACGGACTATTAC,0,5027300
yjbJ_predicted,0.16666666666666666,5,5,CAGCCGCGGTACATGAAGCC,0,4998283
yjbJ_predicted,0.16666666666666666,5,5,CAGATCGATAGAGTCTCCGC,0,5004095
yjbJ_predicted,0.16666666666666666,5,5,CAGAGTCACGGTGGCGGTTG,0,5012610
yjbJ_predicted,0.16666666666666666,5,5,CAGAATGCTTGTCTTCGTAC,0,5002784
yjbJ_predicted,0.16666666666666666,5,5,CAGAACTGCAACAAAACGTA,0,5015188
yjbJ_predicted,0.16666666666666666,5,5,CAGAAAATGTCGGCTTTCTT,0,5013919
yjbJ_predicted,0.16666666666666666,5,5,CACTTTTTTGGGTCCTTTAC,0,5023911
yjbJ_predicted,0.16666666666666666,5,5,CACTACTCACGCATAGTACG,0,5024391
yjbJ_predicted,0.16666666666666666,5,5,CACGTTCAACGTGTCCCAAA,0,5007401
yjbJ_predicted,0.16666666666666666,5,5,CACGGTTCACGCTCCGCATT,0,5013275
yjbJ_predicted,0.16666666666666666,5,5,CACCGTCTGGACGCGCATCT,0,5026122
yjbJ_predicted,0.16666666666666666,5,5,CACCGCTTTGTTTTAAGCAT,0,5002685
yjbJ_predicted,0.16666666666666666,5,5,CACCGCGCCAAAGGGGTGCA,0,5012873
yjbJ_predicted,0.16666666666666666,5,5,CACCCATGAAAAGTTCCGGA,0,5007192
yjbJ_predicted,0.16666666666666666,5,5,CACATTAGTAGATATTTAGT,0,5018001
yjbJ_predicted,0.16666666666666666,5,5,CACAGTATACTCTTCCTACA,0,5002173
yjbJ_predicted,0.16666666666666666,5,5,CACAGGTTGAATTCCCAATA,0,5001703
yjbJ_predicted,0.16666666666666666,5,5,CACAGCTCATTAGCCTTTTG,0,5021108
yjbJ_predicted,0.16666666666666666,5,5,CACAGCGCAGAATCGCCGAA,0,5014176
yjbJ_predicted,0.16666666666666666,5,5,CACACGAATGTGATGTATCT,0,5025336
yjbJ_predicted,0.16666666666666666,5,5,CAATTCCTGCGGTAACGACG,0,5027487
yjbJ_predicted,0.16666666666666666,5,5,CAATGCAACCAATTGTGCTG,0,5012238
yjbJ_predicted,0.16666666666666666,5,5,CAAGGTTTCTGTCTCGAACT,0,5009919
yjbJ_predicted,0.16666666666666666,5,5,CAAAGCACACAACAGGGTAT,0,5004482
yjbJ_predicted,0.16666666666666666,5,5,CAAAGAGTGTAGGCAATATT,0,5018087
yjbJ_predicted,0.16666666666666666,5,5,CAAACCTCTGCAGCACCGTT,0,5002552
yjbJ_predicted,0.16666666666666666,5,5,CAAAAATGCTGTCCCGACGC,0,5005606
yjbJ_predicted,0.16666666666666666,5,5,ATTTTTAGACCTTGCTTAAA,0,5002437
yjbJ_predicted,0.16666666666666666,5,5,ATTTATTCTACTCTCATGAC,0,5011141
yjbJ_predicted,0.16666666666666666,5,5,ATTGTGTTGTGGATGATCAT,0,5010269
yjbJ_predicted,0.16666666666666666,5,5,ATTGGTACGGATAGATTGAG,0,5023518
yjbJ_predicted,0.16666666666666666,5,5,ATTGGCTTCAATCAGAACGC,0,5031003
yjbJ_predicted,0.16666666666666666,5,5,ATTGCGAGAGCTCTACCCGT,0,5001262
yjbJ_predicted,0.16666666666666666,5,5,ATTGACAGGGCTCTCCGCTA,0,5021815
yjbJ_predicted,0.16666666666666666,5,5,ATTCGCACCCGCGTTGAGAA,0,4998219
yjbJ_predicted,0.16666666666666666,5,5,ATTATTCCATGGCATGCGGC,0,5010731
yjbJ_predicted,0.16666666666666666,5,5,ATTATGCTTTATCTCGCTAT,0,5003654
yjbJ_predicted,0.16666666666666666,5,5,ATTACTATCTAGGACATTCA,0,5016409
yjbJ_predicted,0.16666666666666666,5,5,ATTAATCCAGACTGACTTTG,0,5026510
yjbJ_predicted,0.16666666666666666,5,5,ATTAACTTACGGCCTCGTAG,0,5021266
yjbJ_predicted,0.16666666666666666,5,5,ATTAAAGTTACGAGGGTACG,0,5010043
yjbJ_predicted,0.16666666666666666,5,5,ATGTATGATCCCAGGAAGTC,0,5026183
yjbJ_predicted,0.16666666666666666,5,5,ATGTAACTTAACCTCTCGTG,0,5028262
yjbJ_predicted,0.16666666666666666,5,5,ATGGTCTGGTTACACATACT,0,5013687
yjbJ_predicted,0.16666666666666666,5,5,ATGGTACAATAGGTGCTAAG,0,5016134
yjbJ_predicted,0.16666666666666666,5,5,ATGGGGGAAGTCGGCGGAGC,0,5018884
yjbJ_predicted,0.16666666666666666,5,5,ATGGCTAAGGAGCGTATGGT,0,5011826
yjbJ_predicted,0.16666666666666666,5,5,ATGGCGGATCCCTAGGAAGA,0,5018806
yjbJ_predicted,0.16666666666666666,5,5,ATGGACCCGCCTCGATTTAC,0,5030820
yjbJ_predicted,0.16666666666666666,5,5,ATGCTATTGATGTGACAATA,0,5027981
yjbJ_predicted,0.16666666666666666,5,5,ATGCTAGAATGGGGTAACAT,0,5002979
yjbJ_predicted,0.16666666666666666,5,5,ATGCACACGGGTATATAGTA,0,5000805
yjbJ_predicted,0.16666666666666666,5,5,ATGATTAAGGGTCGGCACAA,0,5010510
yjbJ_predicted,0.16666666666666666,5,5,ATCTTGCTCACGGCAGCCTC,0,5022140
yjbJ_predicted,0.16666666666666666,5,5,ATCTGTGGAGTTTAGTTAAT,0,5006590
yjbJ_predicted,0.16666666666666666,5,5,ATCTGTCCAGACCGTCGCAA,0,5020914
yjbJ_predicted,0.16666666666666666,5,5,ATCTGGCTGGTCGGTTCCAA,0,5008130
yjbJ_predicted,0.16666666666666666,5,5,ATCTCAGGTTGGCCCCCCGA,0,5010358
yjbJ_predicted,0.16666666666666666,5,5,ATCGGGCTGGTGACGACTTT,0,5001421
yjbJ_predicted,0.16666666666666666,5,5,ATCCGACCACATGTCTGTTA,0,5029159
yjbJ_predicted,0.16666666666666666,5,5,ATCCCTAGGGGGGTGATTTC,0,5004561
yjbJ_predicted,0.16666666666666666,5,5,ATCCCAGCTGTCCACGAGGA,0,5029781
yjbJ_predicted,0.16666666666666666,5,5,ATCAGAGAACCGATCAGCCC,0,5028035
yjbJ_predicted,0.16666666666666666,5,5,ATATCGTTTAGTCATAGATG,0,5020677
yjbJ_predicted,0.16666666666666666,5,5,ATAGTTAGGATAATCCGCAG,0,5006753
yjbJ_predicted,0.16666666666666666,5,5,ATAGGTATAACCTTTGAGAG,0,4999352
yjbJ_predicted,0.16666666666666666,5,5,ATAGGTAGTGATCAGACTGG,0,4996037
yjbJ_predicted,0.16666666666666666,5,5,ATAGCCTTATGGTTCAAACA,0,5003280
yjbJ_predicted,0.16666666666666666,5,5,ATAGAAATGAAGGCCCCAGA,0,5000893
yjbJ_predicted,0.16666666666666666,5,5,ATACTGGTTTGCATGCTAGT,0,4999895
yjbJ_predicted,0.16666666666666666,5,5,ATACCTAGTGAGTGTGAACG,0,5013436
yjbJ_predicted,0.16666666666666666,5,5,ATAAGTAAGACGGGATTTAG,0,5012579
yjbJ_predicted,0.16666666666666666,5,5,ATAACGATTGTAGTCGGCAT,0,5011324
yjbJ_predicted,0.16666666666666666,5,5,ATAAACCTGGACCCCGTTGA,0,5016208
yjbJ_predicted,0.16666666666666666,5,5,AGTTGTGTGGGCTACTAGGC,0,5011979
yjbJ_predicted,0.16666666666666666,5,5,AGTGTTATCGACGTCACTTG,0,4996377
yjbJ_predicted,0.16666666666666666,5,5,AGTGGCCGGCTGGATAATCT,0,5005861
yjbJ_predicted,0.16666666666666666,5,5,AGTGACCCAGTCTTGGGGGA,0,5012259
yjbJ_predicted,0.16666666666666666,5,5,AGTGACAGAAAAAGTGCATG,0,5007334
yjbJ_predicted,0.16666666666666666,5,5,AGTCTGCTCTGTCGCTCGTG,0,4997905
yjbJ_predicted,0.16666666666666666,5,5,AGTCGCATTTCGGTGCGTAC,0,5009468
yjbJ_predicted,0.16666666666666666,5,5,AGTCACTATTCGGTGCGTCT,0,5005278
yjbJ_predicted,0.16666666666666666,5,5,AGGTGCGACACCAATATTAG,0,5031119
yjbJ_predicted,0.16666666666666666,5,5,AGGTCCGGTTTAATAGCGGT,0,5010934
yjbJ_predicted,0.16666666666666666,5,5,AGGCGTTTTCGGGTAGGTCA,0,5028830
yjbJ_predicted,0.16666666666666666,5,5,AGGCGCAGTATCTTCATACG,0,5028555
yjbJ_predicted,0.16666666666666666,5,5,AGGCAGGAACATTGTCCGTG,0,5009568
yjbJ_predicted,0.16666666666666666,5,5,AGGCAGCAAGTGGGGCGATA,0,5010188
yjbJ_predicted,0.16666666666666666,5,5,AGGATTCGTGAACGTGAAAT,0,5020443
yjbJ_predicted,0.16666666666666666,5,5,AGGAGGCGGCATGATGATTT,0,5000794
yjbJ_predicted,0.16666666666666666,5,5,AGGAGGATCTCGTAGACTGG,0,4995742
yjbJ_predicted,0.16666666666666666,5,5,AGGAGAACCGAGCTAATCAT,0,5001768
yjbJ_predicted,0.16666666666666666,5,5,AGGACTAACTTGAATCCAAC,0,5008074
yjbJ_predicted,0.16666666666666666,5,5,AGGACCATTCGACGGTTTTA,0,4994977
yjbJ_predicted,0.16666666666666666,5,5,AGGACAAAAGACTGTTCTAG,0,5014504
yjbJ_predicted,0.16666666666666666,5,5,AGCTGAGTGCATTATCAGAT,0,5016746
yjbJ_predicted,0.16666666666666666,5,5,AGCTCGAGGCTAATTGCACT,0,4999961
yjbJ_predicted,0.16666666666666666,5,5,AGCGGGAAGTACGTTGGCGA,0,5021279
yjbJ_predicted,0.16666666666666666,5,5,AGCGGCCGCACAGTTCCGCC,0,5028329
yjbJ_predicted,0.16666666666666666,5,5,AGCCCTGGGTCTGAGCATTA,0,4998133
yjbJ_predicted,0.16666666666666666,5,5,AGCACGTATGCGATCGTAAA,0,5002906
yjbJ_predicted,0.16666666666666666,5,5,AGCAATTCGAGTTGGTAATG,0,5008403
yjbJ_predicted,0.16666666666666666,5,5,AGCAAACCCAAGGTTACCAC,0,5030921
yjbJ_predicted,0.16666666666666666,5,5,AGATGATCTTCTAAGTCGGG,0,5018726
yjbJ_predicted,0.16666666666666666,5,5,AGAGTCGTCGGTACACATGC,0,5003304
yjbJ_predicted,0.16666666666666666,5,5,AGAGCCAGTAAGTGTGCTAT,0,5000323
yjbJ_predicted,0.16666666666666666,5,5,AGAGACTCCGATGGGTTTCA,0,5015354
yjbJ_predicted,0.16666666666666666,5,5,AGACCGGCTCTCGCCACAGG,0,5022807
yjbJ_predicted,0.16666666666666666,5,5,AGACCCTGGGCACGGAGTAG,0,5017188
yjbJ_predicted,0.16666666666666666,5,5,AGAATATCGTTTGAACCCTA,0,5014873
yjbJ_predicted,0.16666666666666666,5,5,AGAACGGCATTCAGGCACTG,0,5008738
yjbJ_predicted,0.16666666666666666,5,5,AGAAACTTCTGTCGTCATAT,0,5026899
yjbJ_predicted,0.16666666666666666,5,5,ACTGGCGTGTATACAGTGGC,0,5008577
yjbJ_predicted,0.16666666666666666,5,5,ACTGGCCAAGTATCCAACGG,0,5024983
yjbJ_predicted,0.16666666666666666,5,5,ACTGAACGGCATGACGAAAT,0,5004389
yjbJ_predicted,0.16666666666666666,5,5,ACTCTTACCACGACGGTCGT,0,5024208
yjbJ_predicted,0.16666666666666666,5,5,ACTCGTCTACGCAGATCAGG,0,4999595
yjbJ_predicted,0.16666666666666666,5,5,ACTAGCTTACGGTCGTTCCT,0,5030085
yjbJ_predicted,0.16666666666666666,5,5,ACTAATTGATCCGGGTTAAG,0,5006248
yjbJ_predicted,0.16666666666666666,5,5,ACTAATGCTGAACGCAAGCA,0,5002946
yjbJ_predicted,0.16666666666666666,5,5,ACGTTTTGCGGGTGTCCCCA,0,4997207
yjbJ_predicted,0.16666666666666666,5,5,ACGTTGTCTCGCAGTCTTAA,0,5006418
yjbJ_predicted,0.16666666666666666,5,5,ACGTAACGAATACTGTTGGA,0,5025599
yjbJ_predicted,0.16666666666666666,5,5,ACGGTTCTCCTGCGCCCTAT,0,5023279
yjbJ_predicted,0.16666666666666666,5,5,ACGGGACCTGCGGTGATTTA,0,5027519
yjbJ_predicted,0.16666666666666666,5,5,ACGGCTCTAACTGGGAAGTT,0,5010655
yjbJ_predicted,0.16666666666666666,5,5,ACGCCGATCAAGGGCCGGTG,0,5003963
yjbJ_predicted,0.16666666666666666,5,5,ACGAGGCCTGGCCCCGCAGG,0,5006334
yjbJ_predicted,0.16666666666666666,5,5,ACGACGCCTCCGATTCCACG,0,5004932
yjbJ_predicted,0.16666666666666666,5,5,ACGAAGTCTCCCCGAAGGAG,0,5012960
yjbJ_predicted,0.16666666666666666,5,5,ACCTGGTTCAGGCGAGCGCT,0,5018860
yjbJ_predicted,0.16666666666666666,5,5,ACCTGAGTATCTAGGGCTTA,0,4998723
yjbJ_predicted,0.16666666666666666,5,5,ACCTAGGAATCCGCTTTTCA,0,4995430
yjbJ_predicted,0.16666666666666666,5,5,ACCTAAACTTTAGTCTAGGG,0,5009839
yjbJ_predicted,0.16666666666666666,5,5,ACCGGTTAGATACTCAAGAT,0,5015436
yjbJ_predicted,0.16666666666666666,5,5,ACCGGTAAGCGACCATGAAT,0,5022195
yjbJ_predicted,0.16666666666666666,5,5,ACCCTGCACTATTCTCTTTC,0,5005928
yjbJ_predicted,0.16666666666666666,5,5,ACCATAGCCCAAGGGCAGGG,0,5002204
yjbJ_predicted,0.16666666666666666,5,5,ACCAGCTGTGTCGGCTCGCA,0,5008291
yjbJ_predicted,0.16666666666666666,5,5,ACATTTCCTGCACTCAAGGA,0,5014645
yjbJ_predicted,0.16666666666666666,5,5,ACATTGGCGGCCGCCATCGC,0,4996825
yjbJ_predicted,0.16666666666666666,5,5,ACATTCGTCCACCAATGGTC,0,5027066
yjbJ_predicted,0.16666666666666666,5,5,ACATTATGGCACGAACCGGC,0,5001089
yjbJ_predicted,0.16666666666666666,5,5,ACATGTGGAGCGAACAATCC,0,4996434
yjbJ_predicted,0.16666666666666666,5,5,ACATCCGTTGTGCAACCTAC,0,5029292
yjbJ_predicted,0.16666666666666666,5,5,ACAGTTCCTCACGTTGGGGA,0,5005681
yjbJ_predicted,0.16666666666666666,5,5,ACAGCTCGGCGGTGTGCGTG,0,5018296
yjbJ_predicted,0.16666666666666666,5,5,ACACGGCTCATATACCGCGG,0,5005810
yjbJ_predicted,0.16666666666666666,5,5,ACACGGATCGGTCGGCAGTA,0,4996948
yjbJ_predicted,0.16666666666666666,5,5,ACACCAGCTGAATCCGCCTA,0,5011985
yjbJ_predicted,0.16666666666666666,5,5,ACAAACTGGACAGAGGCCCA,0,5009830
yjbJ_predicted,0.16666666666666666,5,5,ACAAACATCCTCGCCTTCGA,0,4997128
yjbJ_predicted,0.16666666666666666,5,5,AATTTTTTGGCTTGAAACGG,0,5005988
yjbJ_predicted,0.16666666666666666,5,5,AATTTGACCAACGGGGAGAC,0,4995451
yjbJ_predicted,0.16666666666666666,5,5,AATGGCCCACTTAGCAGATA,0,4997947
yjbJ_predicted,0.16666666666666666,5,5,AATGGATGTGGCAAGAGCCA,0,4998999
yjbJ_predicted,0.16666666666666666,5,5,AATGGATAGCCGTGTCTAGA,0,5004464
yjbJ_predicted,0.16666666666666666,5,5,AATGATGTGGGACCGACCAG,0,4996524
yjbJ_predicted,0.16666666666666666,5,5,AATCCGCGAAGTTGTAAGGT,0,5006740
yjbJ_predicted,0.16666666666666666,5,5,AAGTTCGTCGGGGCCGTCCC,0,5002416
yjbJ_predicted,0.16666666666666666,5,5,AAGGTAATGGGCCACTATCC,0,4996429
yjbJ_predicted,0.16666666666666666,5,5,AAGGGCATACTCGGAGCCAC,0,5005869
yjbJ_predicted,0.16666666666666666,5,5,AAGGAATTCGCGCGGCTGTT,0,5000018
yjbJ_predicted,0.16666666666666666,5,5,AAGCTTGTTCCGAATCGATG,0,5027510
yjbJ_predicted,0.16666666666666666,5,5,AAGCCTGAGGAATAAGCTCA,0,5024328
yjbJ_predicted,0.16666666666666666,5,5,AAGCCAAATTCGCAGTACGT,0,5023326
yjbJ_predicted,0.16666666666666666,5,5,AAGATGAGACCCTAGGGTAA,0,5004015
yjbJ_predicted,0.16666666666666666,5,5,AAGAGTTAAGGGTTAGGGTG,0,5005839
yjbJ_predicted,0.16666666666666666,5,5,AAGAAGTCCGGAATAAATGA,0,5029545
yjbJ_predicted,0.16666666666666666,5,5,AACTTCGATTGATTCATGAT,0,5007106
yjbJ_predicted,0.16666666666666666,5,5,AACGAAACGCAGAGATATTT,0,5013790
yjbJ_predicted,0.16666666666666666,5,5,AACCCTTTGCTTTACTGTTG,0,5004192
yjbJ_predicted,0.16666666666666666,5,5,AACCCCTGGCATGCCATTTG,0,5018668
yjbJ_predicted,0.16666666666666666,5,5,AACATAGAGTGTGATACCAA,0,5018754
yjbJ_predicted,0.16666666666666666,5,5,AACAGAGCCGTTAGGCGTGC,0,5005372
yjbJ_predicted,0.16666666666666666,5,5,AAAGTAACCTCACATAACCA,0,5019472
yjbJ_predicted,0.16666666666666666,5,5,AAAGCACGGAGCCTGCTCTC,0,5016691
yjbJ_predicted,0.16666666666666666,5,5,AAACGAACTGAGACGCAGAG,0,5007656
yjbJ_predicted,0.16666666666666666,5,5,AAACCCCAGGTATGCGTATT,0,5005688
yjbJ_predicted,0.16666666666666666,5,5,AAACAATATTTAACCATCCT,0,5001218
yjbJ_predicted,0.16666666666666666,5,5,AAAATCGGAACAGTCGGATC,0,4999681
yjbJ_predicted,0.16666666666666666,5,5,AAAAGTATGTGAAAGTAAAC,0,4998247
yjbJ_predicted,0.16666666666666666,5,5,AAAACTTCTGCGGACTGGCA,0,5026864
yjbJ_predicted,0.2,4,4,TTTTTTAGCGACATCTTAGA,0,5000047
yjbJ_predicted,0.2,4,4,TTTTGGGGAAATGAAGTGTT,0,5026805
yjbJ_predicted,0.2,4,4,TTTTCTTTCTAAGTCCGGTT,0,5014291
yjbJ_predicted,0.2,4,4,TTTTATCCTCTTAATATAGG,0,5012395
yjbJ_predicted,0.2,4,4,TTTTACCGAAAAGGCCCCAT,0,5008263
yjbJ_predicted,0.2,4,4,TTTTACACTGGAAGTAAATG,0,4995171
yjbJ_predicted,0.2,4,4,TTTGTCCTAGCGTAGGTCTG,0,4996873
yjbJ_predicted,0.2,4,4,TTTGCTACACCGCACTTTTT,0,4996062
yjbJ_predicted,0.2,4,4,TTTCGTACTTAAGGTGCGCA,0,5024788
yjbJ_predicted,0.2,4,4,TTTCAGAACGGCTAGGATGA,0,5009115
yjbJ_predicted,0.2,4,4,TTTATTCGGGCGTACTTCAA,0,5009380
yjbJ_predicted,0.2,4,4,TTTATGGGGCTACGGGCCTC,0,5003169
yjbJ_predicted,0.2,4,4,TTTATAGACCGTGTCTTCGT,0,5000780
yjbJ_predicted,0.2,4,4,TTTATAAGGTGACGCGGATT,0,5008423
yjbJ_predicted,0.2,4,4,TTTAGAGTACGTCCATCCCT,0,5010099
yjbJ_predicted,0.2,4,4,TTTAGAGGATAGGCGTCAGA,0,5010224
yjbJ_predicted,0.2,4,4,TTTAATGCATGAGTACCCCT,0,5013860
yjbJ_predicted,0.2,4,4,TTTAACTAAGATTCCTTCTA,0,5008127
yjbJ_predicted,0.2,4,4,TTGGTTTAATGAAATCTAAC,0,5010958
yjbJ_predicted,0.2,4,4,TTGGTGTTAATGGTAGCGGT,0,4997875
yjbJ_predicted,0.2,4,4,TTGGTCGGTATAACTATGAA,0,5018914
yjbJ_predicted,0.2,4,4,TTGGCATGAATTACATATCA,0,4996728
yjbJ_predicted,0.2,4,4,TTGGAGGGGTATGACTTAGA,0,5012903
yjbJ_predicted,0.2,4,4,TTGGACAACTACGGATTACA,0,5022162
yjbJ_predicted,0.2,4,4,TTGGAAAGCAGATACGTTTA,0,5014818
yjbJ_predicted,0.2,4,4,TTGCCGGCAGTTATCATGAT,0,5015797
yjbJ_predicted,0.2,4,4,TTGATTATAGCGGAATAGTC,0,5001570
yjbJ_predicted,0.2,4,4,TTGAGGCCGTAGGTAGTAAG,0,5012900
yjbJ_predicted,0.2,4,4,TTGAGCATCTAAACAACGCA,0,5017871
yjbJ_predicted,0.2,4,4,TTGACATTTAGTCCTCCTTG,0,4996137
yjbJ_predicted,0.2,4,4,TTGAATGGCGCACAAGGTGT,0,5027949
yjbJ_predicted,0.2,4,4,TTGAACTTTTACTTGTCTCA,0,5022133
yjbJ_predicted,0.2,4,4,TTCTGATGCCACACAGCCAG,0,5016387
yjbJ_predicted,0.2,4,4,TTCTATTTCGCGGTGCGGCA,0,5027875
yjbJ_predicted,0.2,4,4,TTCTACATCAGCGGTTAATG,0,5005836
yjbJ_predicted,0.2,4,4,TTCGTGGACGGAGAATTAAT,0,5018508
yjbJ_predicted,0.2,4,4,TTCGGGGATAGGCGCTGCAT,0,5028005
yjbJ_predicted,0.2,4,4,TTCGCCTTGTCTGCAAAAAT,0,5003218
yjbJ_predicted,0.2,4,4,TTCGATTGGTCTTCGAGGGC,0,5011745
yjbJ_predicted,0.2,4,4,TTCCCGGCGACCGAAGGCCC,0,5011811
yjbJ_predicted,0.2,4,4,TTCCATGTAGCAGCTTGTGC,0,5030369
yjbJ_predicted,0.2,4,4,TTCATTTCTGCGGGGTCTCC,0,5009695
yjbJ_predicted,0.2,4,4,TTCATCCTTAATATGGCAGA,0,5010218
yjbJ_predicted,0.2,4,4,TTCAGTTGCCCCCGCATCTT,0,4994822
yjbJ_predicted,0.2,4,4,TTATTGGACTTCACTCACTG,0,5000678
yjbJ_predicted,0.2,4,4,TTATCAGATCACGCTGAAGG,0,5012966
yjbJ_predicted,0.2,4,4,TTATAGATTGTTGACTACTT,0,5006141
yjbJ_predicted,0.2,4,4,TTATACGTGCTGCCACAAGC,0,5031151
yjbJ_predicted,0.2,4,4,TTAGTAGTCGCCAGGATGCG,0,4998205
yjbJ_predicted,0.2,4,4,TTAGATGGTGCTTGTACAGT,0,5023222
yjbJ_predicted,0.2,4,4,TTACTTGACAGGGTAGGGGT,0,5012533
yjbJ_predicted,0.2,4,4,TTACCTGTGAACCGTTTTTG,0,5016215
yjbJ_predicted,0.2,4,4,TTACCATGATTCTGCACAGT,0,5006312
yjbJ_predicted,0.2,4,4,TTAATTACCGCATTGGAAGT,0,5003171
yjbJ_predicted,0.2,4,4,TTAAGTATCCACCGGAACGG,0,5020006
yjbJ_predicted,0.2,4,4,TTAAGGCCGCCTTAGATTAA,0,5008365
yjbJ_predicted,0.2,4,4,TTAAAAGCGAGGGATGTATA,0,4998923
yjbJ_predicted,0.2,4,4,TGTTGGACTTTCGTCGTCAC,0,5007128
yjbJ_predicted,0.2,4,4,TGTTCTCGATAATGTCTTGA,0,4996642
yjbJ_predicted,0.2,4,4,TGTTACGAAATCTTGTAGCA,0,4995785
yjbJ_predicted,0.2,4,4,TGTGTTCTTGTCTGGAATGG,0,5016253
yjbJ_predicted,0.2,4,4,TGTGTGTTAGGACTGCTCTC,0,5016587
yjbJ_predicted,0.2,4,4,TGTGGGGGACATGCGGCCCG,0,5029767
yjbJ_predicted,0.2,4,4,TGTGGATGCGCATGCGGGCG,0,5001375
yjbJ_predicted,0.2,4,4,TGTGAGGCATCTATCCAGGT,0,5001827
yjbJ_predicted,0.2,4,4,TGTGAACAGGTCATAAGCAT,0,5025153
yjbJ_predicted,0.2,4,4,TGTCGATCAACTGCCTAAAG,0,4999455
yjbJ_predicted,0.2,4,4,TGTCAGATGCTATAACAGGT,0,4999254
yjbJ_predicted,0.2,4,4,TGTAGATAACTGAGGATTAG,0,5009763
yjbJ_predicted,0.2,4,4,TGTAGAAGCCGTCGGACGCA,0,5016878
yjbJ_predicted,0.2,4,4,TGTACGACATTAAACCGGGG,0,5023018
yjbJ_predicted,0.2,4,4,TGGTTCCCGGTTCGGGTGAG,0,5026406
yjbJ_predicted,0.2,4,4,TGGTGTGCTTAGGAAAAAGC,0,4994740
yjbJ_predicted,0.2,4,4,TGGTCCGATCCCGGCACAAG,0,5003794
yjbJ_predicted,0.2,4,4,TGGCGGTGTGGAGCATAGAT,0,4998629
yjbJ_predicted,0.2,4,4,TGGACGCCCGTACGGATATG,0,5014801
yjbJ_predicted,0.2,4,4,TGGACAGGATGCTGCGAGGG,0,5003237
yjbJ_predicted,0.2,4,4,TGGACACTCATTAATTCGTC,0,4996797
yjbJ_predicted,0.2,4,4,TGGAACAGTATCTAGAGTCA,0,5015498
yjbJ_predicted,0.2,4,4,TGCTTCTATAACGAGCGTGC,0,5013829
yjbJ_predicted,0.2,4,4,TGCTTCACACATATGCTCTG,0,5018648
yjbJ_predicted,0.2,4,4,TGCTGTAAGTACGCTATTAC,0,5023833
yjbJ_predicted,0.2,4,4,TGCGTGCATCATATCTCCTA,0,5023072
yjbJ_predicted,0.2,4,4,TGCGTCTCGCACGACGGTTA,0,5029047
yjbJ_predicted,0.2,4,4,TGCGGTTAATCATTCAATTT,0,4999917
yjbJ_predicted,0.2,4,4,TGCGGTGTCAGAAGATTAAT,0,5027091
yjbJ_predicted,0.2,4,4,TGCGGGCAGTCCAGGATCGG,0,5014729
yjbJ_predicted,0.2,4,4,TGCGGCAAATCTAAAAGAGT,0,5014630
yjbJ_predicted,0.2,4,4,TGCGAATTGGTGGTACCCCA,0,5014753
yjbJ_predicted,0.2,4,4,TGCGAAGGTTACACATATGT,0,5024470
yjbJ_predicted,0.2,4,4,TGCCTGCTCTATCCTCTACC,0,5000418
yjbJ_predicted,0.2,4,4,TGCCCTGGGTAGGGCTCGTT,0,5009699
yjbJ_predicted,0.2,4,4,TGCCCAGTGCGCCTTGATAT,0,5008134
yjbJ_predicted,0.2,4,4,TGCAGCCCGATGCGAGTACT,0,4995673
yjbJ_predicted,0.2,4,4,TGCACTCATGTGGGGAGTAG,0,5011209
yjbJ_predicted,0.2,4,4,TGCACATTCGACCGGGATCT,0,5028290
yjbJ_predicted,0.2,4,4,TGATTTTGTATCTTTAGAGG,0,5015014
yjbJ_predicted,0.2,4,4,TGATCGTGTATCATTGGGTT,0,5010437
yjbJ_predicted,0.2,4,4,TGATATTATGTTTGAACGTT,0,5017288
yjbJ_predicted,0.2,4,4,TGATAGCTCAACGTCTTACG,0,5007605
yjbJ_predicted,0.2,4,4,TGATACGATAATAGGCCAGG,0,5003166
yjbJ_predicted,0.2,4,4,TGAGTATGGTGGAATAATTT,0,4996011
yjbJ_predicted,0.2,4,4,TGAGGGTTCTCCCGCGATTG,0,5011605
yjbJ_predicted,0.2,4,4,TGAGGATCCGAATATGCGTA,0,5025238
yjbJ_predicted,0.2,4,4,TGAGCAAAAAGGAAGGCCTA,0,5019392
yjbJ_predicted,0.2,4,4,TGAGAGTTAAGTGAGAGTAG,0,5013729
yjbJ_predicted,0.2,4,4,TGACGTGGCAGTCGAAGGTA,0,5006903
yjbJ_predicted,0.2,4,4,TGACCTGAATTCACTCCACG,0,5022121
yjbJ_predicted,0.2,4,4,TGACATTGTTTCAGATGTAA,0,5018093
yjbJ_predicted,0.2,4,4,TGACATGCATAGTCAACTAT,0,5008460
yjbJ_predicted,0.2,4,4,TGACACGATCGGTACTAAGA,0,5000604
yjbJ_predicted,0.2,4,4,TGAATTCCGAGCAAACCGCG,0,5008611
yjbJ_predicted,0.2,4,4,TGAAGGCACTGCTCATTCCT,0,4996788
yjbJ_predicted,0.2,4,4,TGAAGCTCGTCCCCGCCCTA,0,5016607
yjbJ_predicted,0.2,4,4,TGAACTTGCATGATGTGGGC,0,5016457
yjbJ_predicted,0.2,4,4,TGAACTCCTCCTTCAAAGGT,0,5006997
yjbJ_predicted,0.2,4,4,TCTTTAGCTACTAGTCCGCT,0,5025773
yjbJ_predicted,0.2,4,4,TCTTAGTTCTACCCTAGTTT,0,5008646
yjbJ_predicted,0.2,4,4,TCTTAGACAACTATGGGTAG,0,5012101
yjbJ_predicted,0.2,4,4,TCTGTGCGATTTGGCAGCCC,0,5006928
yjbJ_predicted,0.2,4,4,TCTGGCTATATTGAGAGCGA,0,5018138
yjbJ_predicted,0.2,4,4,TCTGCGTCTATCGGCGATCA,0,5002243
yjbJ_predicted,0.2,4,4,TCTGCGGTCATGGTTCTGAT,0,5028927
yjbJ_predicted,0.2,4,4,TCTGCCCTCTCATAGCTCAC,0,5017816
yjbJ_predicted,0.2,4,4,TCTGCAATATCGCCACAAGC,0,5018029
yjbJ_predicted,0.2,4,4,TCTCTGAGGGTCCCCCGAGG,0,5010485
yjbJ_predicted,0.2,4,4,TCTCTCTAATCCGTAGTATA,0,5026673
yjbJ_predicted,0.2,4,4,TCTCAGCGTAGGGGGTGGAA,0,5012242
yjbJ_predicted,0.2,4,4,TCGTGCAAACTGGTCACCCG,0,5026616
yjbJ_predicted,0.2,4,4,TCGGCTCCTAATTCAGCAAA,0,5014119
yjbJ_predicted,0.2,4,4,TCGGCGAGGAGCGAAGCGAG,0,5020871
yjbJ_predicted,0.2,4,4,TCGGCCGCGTGGGTCTTGCC,0,5000013
yjbJ_predicted,0.2,4,4,TCGGCATGTTATTAGTTAGC,0,5012720
yjbJ_predicted,0.2,4,4,TCGGAGGGATCAAATCACGA,0,5000622
yjbJ_predicted,0.2,4,4,TCGGACCACTATCGTCGCTA,0,5005195
yjbJ_predicted,0.2,4,4,TCGCTTTTCGTCCTATCGAT,0,5018711
yjbJ_predicted,0.2,4,4,TCGCTTTGTGGATGGTTCGT,0,4999037
yjbJ_predicted,0.2,4,4,TCGCTTGCAGAACGGTCCTC,0,5012018
yjbJ_predicted,0.2,4,4,TCGCTGAGAAGCTACATCAG,0,5027035
yjbJ_predicted,0.2,4,4,TCGCTCAGTGCGGAGGTCGG,0,5025669
yjbJ_predicted,0.2,4,4,TCGCTCACGTTTCGTTCTCC,0,4998366
yjbJ_predicted,0.2,4,4,TCGCGGAACTAACGGTCTTA,0,5011086
yjbJ_predicted,0.2,4,4,TCGAGCCAGGATGCCGTATC,0,4994773
yjbJ_predicted,0.2,4,4,TCGACGCTTCGATGGATACT,0,4998129
yjbJ_predicted,0.2,4,4,TCGACGATTTATGTCCGTTC,0,5016642
yjbJ_predicted,0.2,4,4,TCGACAGCGTGGGGGCGCCT,0,5004399
yjbJ_predicted,0.2,4,4,TCGAACGGGTACCGTTTGTG,0,4996039
yjbJ_predicted,0.2,4,4,TCCTTTTCGAACGATCAGGT,0,5010303
yjbJ_predicted,0.2,4,4,TCCTGTTTGGTAATTAGATG,0,5008857
yjbJ_predicted,0.2,4,4,TCCGTTCACTCGCATTTCAT,0,4998665
yjbJ_predicted,0.2,4,4,TCCGCGACAGCGATTCTGGA,0,5015267
yjbJ_predicted,0.2,4,4,TCCATCTACCATAAGAGCTT,0,5021265
yjbJ_predicted,0.2,4,4,TCCAGGCAGAGAGGAAGAGG,0,5005633
yjbJ_predicted,0.2,4,4,TCCACTCCCACAAGCAGGAA,0,5020281
yjbJ_predicted,0.2,4,4,TCCACGAGCCCCTCAAGCAG,0,5022445
yjbJ_predicted,0.2,4,4,TCCAATTTGGACATATAAGG,0,5009943
yjbJ_predicted,0.2,4,4,TCCAAGGAAACTCCTGAAGC,0,5000583
yjbJ_predicted,0.2,4,4,TCCAACATCCTAGGTATCCA,0,5022526
yjbJ_predicted,0.2,4,4,TCCAAAAATAACTCCACCAT,0,4996256
yjbJ_predicted,0.2,4,4,TCATTGCCAGCAGTACTGAT,0,5024937
yjbJ_predicted,0.2,4,4,TCATTCGGTGACCGTCTATT,0,4995759
yjbJ_predicted,0.2,4,4,TCATTCGGGCGCGAGACTTT,0,5000768
yjbJ_predicted,0.2,4,4,TCATTCGGCAGAAATTCACT,0,5014183
yjbJ_predicted,0.2,4,4,TCATAAGATCGCAAGGCGGG,0,5013107
yjbJ_predicted,0.2,4,4,TCAGGTGGTATTCTGGGTAT,0,4995332
yjbJ_predicted,0.2,4,4,TCAGCATACGAGACTCGAAG,0,5027944
yjbJ_predicted,0.2,4,4,TCACGTTGTTAGCCACGCGA,0,5009562
yjbJ_predicted,0.2,4,4,TCACGTGACTTATTACCGCT,0,5028492
yjbJ_predicted,0.2,4,4,TCACCCGCGGTCTTTTTATG,0,5030027
yjbJ_predicted,0.2,4,4,TCACATACGGAGGTCAGTCG,0,5012680
yjbJ_predicted,0.2,4,4,TCAATTTTGGGCCTGACTAT,0,5007892
yjbJ_predicted,0.2,4,4,TCAAGCAGTGCATCGTTTCA,0,5027745
yjbJ_predicted,0.2,4,4,TATTGCTGGCTTACTCTTAC,0,5023680
yjbJ_predicted,0.2,4,4,TATTCTGCGGCCATTATGAC,0,5001168
yjbJ_predicted,0.2,4,4,TATTAGAGATGGATAATAGC,0,4999380
yjbJ_predicted,0.2,4,4,TATGTTTCATGTGCGTTTCC,0,5010621
yjbJ_predicted,0.2,4,4,TATGCCTCCCACGCTGGTGG,0,5018428
yjbJ_predicted,0.2,4,4,TATGCACGTATTGACCAGAG,0,5028640
yjbJ_predicted,0.2,4,4,TATCTGCATTAGATGGATGT,0,5014439
yjbJ_predicted,0.2,4,4,TATCGTCGTTTTCGACATGG,0,4999818
yjbJ_predicted,0.2,4,4,TATCCCACTACCCTAGTCGC,0,5009018
yjbJ_predicted,0.2,4,4,TATCAGAAGGTTATTTCCCA,0,5003936
yjbJ_predicted,0.2,4,4,TATATGTTCGTAGGGGACAT,0,5008115
yjbJ_predicted,0.2,4,4,TATATACGACGTGATCAGTT,0,5027157
yjbJ_predicted,0.2,4,4,TAGGGCCGTACTCATATTTT,0,5021025
yjbJ_predicted,0.2,4,4,TAGGCGGAGGGGGTGTTGGA,0,5029006
yjbJ_predicted,0.2,4,4,TAGGCCTATTTGCATTTTAG,0,5025902
yjbJ_predicted,0.2,4,4,TAGCTCTGCCGCCATCCGCG,0,5005073
yjbJ_predicted,0.2,4,4,TAGCGTAACTTTCGACGCTG,0,5027551
yjbJ_predicted,0.2,4,4,TAGATTGCGGGCGCTAAGAA,0,5018887
yjbJ_predicted,0.2,4,4,TAGAGATATCCCGTCTCCTC,0,5020101
yjbJ_predicted,0.2,4,4,TACTGTTCCATTACAATACG,0,5011315
yjbJ_predicted,0.2,4,4,TACTGTGGCAGCCTCCGGCG,0,5020781
yjbJ_predicted,0.2,4,4,TACTGCAGAACAAAGACGCA,0,5016957
yjbJ_predicted,0.2,4,4,TACTGACTGCGCAAATCGTC,0,5019103
yjbJ_predicted,0.2,4,4,TACTCGTTAGTGTCCCTGCG,0,5019574
yjbJ_predicted,0.2,4,4,TACGGGTTCAGCATTACAAC,0,5026163
yjbJ_predicted,0.2,4,4,TACGCTAGGGGAATCAACGC,0,5001589
yjbJ_predicted,0.2,4,4,TACGAACTAAGTAGTCGTAC,0,5012133
yjbJ_predicted,0.2,4,4,TACCTCAACGGACTCCGAGA,0,5022827
yjbJ_predicted,0.2,4,4,TACCCGGTACCAACATCTTA,0,5028408
yjbJ_predicted,0.2,4,4,TACCCATAGATCAAGAGGGT,0,4997556
yjbJ_predicted,0.2,4,4,TACCCACGGACACGGCTGTA,0,4996606
yjbJ_predicted,0.2,4,4,TACCACTTTATGATCTTATG,0,4998279
yjbJ_predicted,0.2,4,4,TACCAACAAAACGGTGTTCT,0,5022188
yjbJ_predicted,0.2,4,4,TACAGGTGGCCCCGGGTTTA,0,5016553
yjbJ_predicted,0.2,4,4,TACAAGAGAGGCATATAAAC,0,5016859
yjbJ_predicted,0.2,4,4,TACAACATCCCAGCAGCGAA,0,5009123
yjbJ_predicted,0.2,4,4,TAATTAGTTGTTGTACCGTC,0,5000262
yjbJ_predicted,0.2,4,4,TAATATATCGACCTGGCTCA,0,5001809
yjbJ_predicted,0.2,4,4,TAATACGCGGTTTACTCCAT,0,5017684
yjbJ_predicted,0.2,4,4,TAAGTTGAGAGACGAGCTCA,0,5022843
yjbJ_predicted,0.2,4,4,TAAGGTGCTTCAGGGAAATT,0,5029541
yjbJ_predicted,0.2,4,4,TAAGGGTCCACAATGTTTCA,0,5020289
yjbJ_predicted,0.2,4,4,TAAATTGCGATACTCGGATA,0,5013033
yjbJ_predicted,0.2,4,4,TAAAAGTCCCGCACAGGCTT,0,5028151
yjbJ_predicted,0.2,4,4,GTTTGGGTGCGTATCGCCAA,0,5007986
yjbJ_predicted,0.2,4,4,GTTTCCTTAGATACGTCAGG,0,4996586
yjbJ_predicted,0.2,4,4,GTTTCAGCAGAAGCAGCATT,0,4996123
yjbJ_predicted,0.2,4,4,GTTTAATTTAAACAACTTGC,0,5004054
yjbJ_predicted,0.2,4,4,GTTGATATTCATGGATCTGA,0,5002573
yjbJ_predicted,0.2,4,4,GTTCCTCAGCAAGTAACAAC,0,5004334
yjbJ_predicted,0.2,4,4,GTTCCCGCCCTCGTCCCAAG,0,5024400
yjbJ_predicted,0.2,4,4,GTTCCAAGACTAACTAATGC,0,5014919
yjbJ_predicted,0.2,4,4,GTTATACCCGAGACAGAAGG,0,5006854
yjbJ_predicted,0.2,4,4,GTTAGTCTTCATCACTAAAT,0,5026091
yjbJ_predicted,0.2,4,4,GTGTTTGGCCATTAGGGGGG,0,5011256
yjbJ_predicted,0.2,4,4,GTGTGTCACATTAGGGATAT,0,5004857
yjbJ_predicted,0.2,4,4,GTGTCACGAGGGTGCGAGGG,0,5025860
yjbJ_predicted,0.2,4,4,GTGGTAAAACCACGGCAGTG,0,5011089
yjbJ_predicted,0.2,4,4,GTGGGGTAATGGTCCTCAAG,0,5016718
yjbJ_predicted,0.2,4,4,GTGCTTTATAACATGCGCGT,0,5019511
yjbJ_predicted,0.2,4,4,GTGCTGTGTCTTTTAAGGGT,0,5013420
yjbJ_predicted,0.2,4,4,GTGCCCACCTTCAGAAGTAA,0,5001981
yjbJ_predicted,0.2,4,4,GTGATCAGTTTACCCGAGTT,0,5018030
yjbJ_predicted,0.2,4,4,GTCTCGACATGGAAATTATC,0,5028254
yjbJ_predicted,0.2,4,4,GTCGGGTACGATACATCTGC,0,5018987
yjbJ_predicted,0.2,4,4,GTCCTTTGATGCAAGGTTCT,0,5028715
yjbJ_predicted,0.2,4,4,GTCCTCTGTCGGGCCAAGGT,0,5002317
yjbJ_predicted,0.2,4,4,GTCCGTTACTGATTGTCTGA,0,4995558
yjbJ_predicted,0.2,4,4,GTCCGTGTTGGGGTTCCACC,0,5003377
yjbJ_predicted,0.2,4,4,GTCCACAAGTCACCCTACCC,0,4997561
yjbJ_predicted,0.2,4,4,GTCCACAACTTGGGGAAGAA,0,5027553
yjbJ_predicted,0.2,4,4,GTCCAACCATTGGAAATCAT,0,5008970
yjbJ_predicted,0.2,4,4,GTCAGGCATGAGTGATAAGT,0,5003957
yjbJ_predicted,0.2,4,4,GTCAGCCGGGCAGATCACCT,0,5007039
yjbJ_predicted,0.2,4,4,GTCACACGCCTCGCCACGAC,0,5017074
yjbJ_predicted,0.2,4,4,GTCAAGGCCGCGAGGGTTGA,0,5018967
yjbJ_predicted,0.2,4,4,GTATCGTACGTGTCTCTAGC,0,5015606
yjbJ_predicted,0.2,4,4,GTATATGGCGCGGACAACGT,0,5001881
yjbJ_predicted,0.2,4,4,GTATAAGCGGGCGCGAACAA,0,5024514
yjbJ_predicted,0.2,4,4,GTAGCCTAATTACGGTTAAT,0,5006969
yjbJ_predicted,0.2,4,4,GTAGAGGGTAATATTGCATT,0,4999982
yjbJ_predicted,0.2,4,4,GTACGTACCACCGTGAGTTC,0,5023213
yjbJ_predicted,0.2,4,4,GTACCAAATAAGCGTCGAAC,0,5003115
yjbJ_predicted,0.2,4,4,GTACACGTGGCATAAACGTC,0,5015552
yjbJ_predicted,0.2,4,4,GTAAGGGGTAAGCCGGGGCA,0,5019396
yjbJ_predicted,0.2,4,4,GGTTGGGTTGCGATTCTTAC,0,5000532
yjbJ_predicted,0.2,4,4,GGTTAACTCGGTACCAGAAC,0,5020999
yjbJ_predicted,0.2,4,4,GGTGTACGGGTAGTTGGGAA,0,5009473
yjbJ_predicted,0.2,4,4,GGTGGTTTTGTCTTGGAATT,0,5000193
yjbJ_predicted,0.2,4,4,GGTGGGGGCCTTCATCCTAG,0,5025814
yjbJ_predicted,0.2,4,4,GGTGGACGTAGCCCTCACCC,0,5011639
yjbJ_predicted,0.2,4,4,GGTGCGGATGGAAGGGTTCA,0,5025093
yjbJ_predicted,0.2,4,4,GGTGATAGCTACTGGGCTAT,0,4998532
yjbJ_predicted,0.2,4,4,GGTGAGCCTGTAAATAAATC,0,5007601
yjbJ_predicted,0.2,4,4,GGTCTCATATCGCGGTGTCG,0,5022205
yjbJ_predicted,0.2,4,4,GGTCGGCTCGCTACCGTTGA,0,5000185
yjbJ_predicted,0.2,4,4,GGTCATGGCGAGATGGGTTA,0,5014251
yjbJ_predicted,0.2,4,4,GGTAGGCCGGTAATCCCGCA,0,4995866
yjbJ_predicted,0.2,4,4,GGTAGAACGGTAGTTACGCC,0,5009606
yjbJ_predicted,0.2,4,4,GGTAAACCCCTAAACGCTCA,0,5008486
yjbJ_predicted,0.2,4,4,GGGTTCGTCCGGAATCTTCG,0,5030493
yjbJ_predicted,0.2,4,4,GGGTCGTATACATTGCCTTG,0,5026650
yjbJ_predicted,0.2,4,4,GGGTAAAAGCACGTTTTTTA,0,5014073
yjbJ_predicted,0.2,4,4,GGGGTGTAAGGACACGGAGG,0,5024824
yjbJ_predicted,0.2,4,4,GGGGGTGACGGTTGACAGAA,0,4996531
yjbJ_predicted,0.2,4,4,GGGGAGTACACCTATTAAAT,0,5018052
yjbJ_predicted,0.2,4,4,GGGGACGAGTCATACAACGA,0,5001342
yjbJ_predicted,0.2,4,4,GGGCGTTGATTAGAATTCCT,0,5004229
yjbJ_predicted,0.2,4,4,GGGCGCCACGGACCTCTGTT,0,5010457
yjbJ_predicted,0.2,4,4,GGGCACTGCTTAATGTCATC,0,4996080
yjbJ_predicted,0.2,4,4,GGGCACCTTAAGTCCCCCGG,0,5002214
yjbJ_predicted,0.2,4,4,GGGCACACTCCGCGAAAGAA,0,4995713
yjbJ_predicted,0.2,4,4,GGGATATACATCTGACGATT,0,5008364
yjbJ_predicted,0.2,4,4,GGGAAGGACAGGAGGTTTAA,0,4996339
yjbJ_predicted,0.2,4,4,GGGAAGACAAAAGCATTAAA,0,5011518
yjbJ_predicted,0.2,4,4,GGGAACAGATGGGATAACCA,0,5021378
yjbJ_predicted,0.2,4,4,GGGAAAGAACGAGACGATGG,0,5021406
yjbJ_predicted,0.2,4,4,GGCTGTCAACTGTCTCCTCC,0,5012901
yjbJ_predicted,0.2,4,4,GGCTCAAGAGTGCGGAATGT,0,5002596
yjbJ_predicted,0.2,4,4,GGCTATTAGATGACGCATCT,0,5019215
yjbJ_predicted,0.2,4,4,GGCGTGTCCTTTACCCCCAG,0,5017897
yjbJ_predicted,0.2,4,4,GGCCTTTGATCAGAAATGCC,0,5005182
yjbJ_predicted,0.2,4,4,GGCCTTTAAAGCCGTACGTA,0,5006648
yjbJ_predicted,0.2,4,4,GGCCTTGCCCCTATGTATAA,0,5023251
yjbJ_predicted,0.2,4,4,GGCCTCCTGAATTTCTATTA,0,5026877
yjbJ_predicted,0.2,4,4,GGCCGCTGCTTGCGTTATTA,0,5024418
yjbJ_predicted,0.2,4,4,GGCATACGGAAGATGCACAA,0,5025912
yjbJ_predicted,0.2,4,4,GGCAGAGCTGATTGAAAGGT,0,5014106
yjbJ_predicted,0.2,4,4,GGCACAATATATCCGTCGCT,0,5028424
yjbJ_predicted,0.2,4,4,GGATTGATGTGTGGGCTGCT,0,5020713
yjbJ_predicted,0.2,4,4,GGATGATCTAAGTACGGGAA,0,5011870
yjbJ_predicted,0.2,4,4,GGATATCATAGTTAATAGTT,0,5013964
yjbJ_predicted,0.2,4,4,GGATACAAACGGGTCTTTGA,0,5022912
yjbJ_predicted,0.2,4,4,GGAGCGACCAGGGAATAGGT,0,5025399
yjbJ_predicted,0.2,4,4,GGAGCCCGGCTGGAGATGAA,0,5006957
yjbJ_predicted,0.2,4,4,GGAGCATCTTGAGTCGTAGA,0,5016811
yjbJ_predicted,0.2,4,4,GGAGAAGCTCGACCATTCCA,0,4994692
yjbJ_predicted,0.2,4,4,GGACTGGAATTCCCTATTCA,0,5026367
yjbJ_predicted,0.2,4,4,GGACGGACGTAGTATACTGA,0,5009617
yjbJ_predicted,0.2,4,4,GGACGAATCGTGCACACCGA,0,5029408
yjbJ_predicted,0.2,4,4,GGACATCAAAGGGGGTGTAC,0,5022758
yjbJ_predicted,0.2,4,4,GGAACCTTCTGTTCCGAATA,0,5010256
yjbJ_predicted,0.2,4,4,GGAAATTTTATCTCGTTAGT,0,5020735
yjbJ_predicted,0.2,4,4,GCTTGATTTTGCCAAATAAG,0,5028978
yjbJ_predicted,0.2,4,4,GCTTAGTCTTTTCCCATCTT,0,5023769
yjbJ_predicted,0.2,4,4,GCTGTGCGTGTCTAACCCAT,0,5014178
yjbJ_predicted,0.2,4,4,GCTGGCATGGTCTAACACGA,0,4997285
yjbJ_predicted,0.2,4,4,GCTGCACAATCCTGGTGTTT,0,5012367
yjbJ_predicted,0.2,4,4,GCTGACACGTGCGGAGGCAG,0,4996768
yjbJ_predicted,0.2,4,4,GCTCGATTGGAAATCGTCCG,0,5009120
yjbJ_predicted,0.2,4,4,GCTCAGCCCTCACATGTGGT,0,5026861
yjbJ_predicted,0.2,4,4,GCTAGATCGGGTGGGCCGCC,0,5025389
yjbJ_predicted,0.2,4,4,GCTACTCCTAGATCCTAGTT,0,5027173
yjbJ_predicted,0.2,4,4,GCGTTTGTTGAGATTTTGCT,0,5015430
yjbJ_predicted,0.2,4,4,GCGTGTATTTTACAAGCAAC,0,4997252
yjbJ_predicted,0.2,4,4,GCGTGGCTACAGACATGTAC,0,5030843
yjbJ_predicted,0.2,4,4,GCGTGAGCTAATCAAGTCGT,0,5022553
yjbJ_predicted,0.2,4,4,GCGTCGATCCGGCAGATACT,0,5002977
yjbJ_predicted,0.2,4,4,GCGGTCCTCGACAGTTATCA,0,5018241
yjbJ_predicted,0.2,4,4,GCGGTAAACGAGGCGAGATG,0,5000850
yjbJ_predicted,0.2,4,4,GCGGGGCGGGGCTACATTAA,0,5025053
yjbJ_predicted,0.2,4,4,GCGGCTGTAGTATCCGACCG,0,5011822
yjbJ_predicted,0.2,4,4,GCGGCTCACTGTGCACGGGC,0,5001702
yjbJ_predicted,0.2,4,4,GCGGAAGTGATGCACAGTGA,0,5007634
yjbJ_predicted,0.2,4,4,GCGGAACTGTGCCTGTCTCA,0,5004001
yjbJ_predicted,0.2,4,4,GCGCATTACAGTAGCACAGG,0,5028699
yjbJ_predicted,0.2,4,4,GCGAGCCCGAGGCACTATGT,0,5001135
yjbJ_predicted,0.2,4,4,GCCGGCACACTAATACAATA,0,5028200
yjbJ_predicted,0.2,4,4,GCCGCCCCCGACCTCCATAG,0,5015295
yjbJ_predicted,0.2,4,4,GCCGACAAAATTGCGACAGT,0,5020773
yjbJ_predicted,0.2,4,4,GCCCTAGTCCCTTCAGAATA,0,5004507
yjbJ_predicted,0.2,4,4,GCCCGAGATCTGGCATTGAT,0,5020176
yjbJ_predicted,0.2,4,4,GCCCCAGAACGGCCTAATTT,0,4996945
yjbJ_predicted,0.2,4,4,GCCATGTGATGTTCAGGTCA,0,5026903
yjbJ_predicted,0.2,4,4,GCCAGTTGACATCATAAGTA,0,4999819
yjbJ_predicted,0.2,4,4,GCCAGTAATTGGCCGATGAA,0,5027635
yjbJ_predicted,0.2,4,4,GCCAGATGCGATTGTACAGT,0,5023371
yjbJ_predicted,0.2,4,4,GCATGGGGCCTTCGGGGTTC,0,5009601
yjbJ_predicted,0.2,4,4,GCATCGTCATCGGCTCGACG,0,5005784
yjbJ_predicted,0.2,4,4,GCAGTTAAAGTTGTCTGAGA,0,5000660
yjbJ_predicted,0.2,4,4,GCACTTGTGGCAAGGTAGAA,0,5024612
yjbJ_predicted,0.2,4,4,GCACGCGTTAGATTCTCGTA,0,4995746
yjbJ_predicted,0.2,4,4,GCACATTGGGTGTGGAGTAC,0,5016408
yjbJ_predicted,0.2,4,4,GCACATGGCAAGTGAGCCTT,0,5025453
yjbJ_predicted,0.2,4,4,GCAATATGTGGGTTTAAATC,0,5020654
yjbJ_predicted,0.2,4,4,GCAATACTAGACATTGATCA,0,4998145
yjbJ_predicted,0.2,4,4,GCAAGCCCGGACCAAGGACA,0,5020605
yjbJ_predicted,0.2,4,4,GCAAGAATCGCACCGGGCAA,0,5028360
yjbJ_predicted,0.2,4,4,GCAAATAGAGTCATACCAGG,0,5001869
yjbJ_predicted,0.2,4,4,GCAAACGAGAGTTCCTCTTT,0,5005434
yjbJ_predicted,0.2,4,4,GCAAAACATAGGCTTCTTTG,0,5005055
yjbJ_predicted,0.2,4,4,GATTTAACAGTGATTTGCTA,0,5011081
yjbJ_predicted,0.2,4,4,GATTGTGAATATAGGCAGCT,0,5003856
yjbJ_predicted,0.2,4,4,GATTACTTGCCGGGGGCACA,0,5023904
yjbJ_predicted,0.2,4,4,GATGGGGTTAATTACTATAC,0,5026034
yjbJ_predicted,0.2,4,4,GATGGACCCGAAACCTAAAT,0,5029595
yjbJ_predicted,0.2,4,4,GATCTCACGTCCGGATAAGC,0,5016720
yjbJ_predicted,0.2,4,4,GATCAAGGGACTTTGGCTAC,0,5011563
yjbJ_predicted,0.2,4,4,GATAGTGTGTACGTTTTCAA,0,5022265
yjbJ_predicted,0.2,4,4,GATACGACCTTGCTTCCTGG,0,5028465
yjbJ_predicted,0.2,4,4,GATAATTCAGTTATGTTATC,0,5014962
yjbJ_predicted,0.2,4,4,GATAATCAGTGCCTATGTCA,0,5005351
yjbJ_predicted,0.2,4,4,GATAACGCATTGATGCGTGG,0,5014781
yjbJ_predicted,0.2,4,4,GAGTTCACCCGAGCAAACTC,0,4995465
yjbJ_predicted,0.2,4,4,GAGTGTATCAACTGATGCGG,0,5022307
yjbJ_predicted,0.2,4,4,GAGTGGGGTGTATAGAGAAT,0,5019068
yjbJ_predicted,0.2,4,4,GAGTCTGGACACAATCACTC,0,5020027
yjbJ_predicted,0.2,4,4,GAGGTTTATCACGCTAGGGT,0,5024956
yjbJ_predicted,0.2,4,4,GAGGTTGAGCAAGGGGCATT,0,5020716
yjbJ_predicted,0.2,4,4,GAGGATGGCGTCATAGGTCC,0,5002767
yjbJ_predicted,0.2,4,4,GAGGAGGATCCGGAGTGCAA,0,4999002
yjbJ_predicted,0.2,4,4,GAGGACTACGCAAGGAAGGA,0,5028965
yjbJ_predicted,0.2,4,4,GAGCTTTGTATAGGTATGTC,0,5002098
yjbJ_predicted,0.2,4,4,GAGCCTCCACCAAGAAGCCG,0,5028775
yjbJ_predicted,0.2,4,4,GAGCATTTAGGGTATAGCTT,0,4999925
yjbJ_predicted,0.2,4,4,GAGATTCTGCTACATACCGG,0,5027198
yjbJ_predicted,0.2,4,4,GAGATCGCCTTGCAGTCGGG,0,5030682
yjbJ_predicted,0.2,4,4,GAGACGGCCGGTGTTCACCG,0,5020702
yjbJ_predicted,0.2,4,4,GAGACGCACAACAGTCCGAG,0,5009138
yjbJ_predicted,0.2,4,4,GACTAATGATGGGGCTCTTT,0,5005102
yjbJ_predicted,0.2,4,4,GACGTAGGGAACAGACGAAC,0,5014412
yjbJ_predicted,0.2,4,4,GACGCTGTCGATTCTACAGG,0,4998560
yjbJ_predicted,0.2,4,4,GACGAACAATCAAGGAGAGG,0,5015530
yjbJ_predicted,0.2,4,4,GACCTGGGTGCAGCTTCCGT,0,5023758
yjbJ_predicted,0.2,4,4,GACCAAACCAGAAGCGGGGG,0,4999731
yjbJ_predicted,0.2,4,4,GACAACAACGGGTAGCAGGA,0,5014715
yjbJ_predicted,0.2,4,4,GAATGAGAGAACACTCGGAC,0,5023370
yjbJ_predicted,0.2,4,4,GAATACTCTCTAGCACGCCT,0,5001284
yjbJ_predicted,0.2,4,4,GAAGGTTCAGAGGAGAGTGT,0,5002732
yjbJ_predicted,0.2,4,4,GAAGGCTTGGACTGACTTCC,0,5010812
yjbJ_predicted,0.2,4,4,GAAGCCATGCTCATTCCTGT,0,5007653
yjbJ_predicted,0.2,4,4,GAAGCAGGCGCTCGATAGAC,0,5009889
yjbJ_predicted,0.2,4,4,GAAGATGGACTGACTTCGCT,0,5030506
yjbJ_predicted,0.2,4,4,GAAGATCGTATCGATAGCTG,0,5003816
yjbJ_predicted,0.2,4,4,GAACGAGCGCGGATTATGTA,0,5000835
yjbJ_predicted,0.2,4,4,GAACCCAAATAAACCCACGG,0,5026972
yjbJ_predicted,0.2,4,4,GAACATTGGATAGATGGAGG,0,5002104
yjbJ_predicted,0.2,4,4,GAACATGGATGGTAAGTAAA,0,5019509
yjbJ_predicted,0.2,4,4,GAAAGGGCGCCGGAAGGGTT,0,5002011
yjbJ_predicted,0.2,4,4,GAAACGGGAGGAGTATAAGG,0,5017946
yjbJ_predicted,0.2,4,4,GAAACATGGATGTGTTCCCC,0,5007626
yjbJ_predicted,0.2,4,4,CTTTTTTAAGATTTAGTAGA,0,4999842
yjbJ_predicted,0.2,4,4,CTTTCCTGAACAGGGGGGCA,0,5000529
yjbJ_predicted,0.2,4,4,CTTCGAATGATCAGTAGGGT,0,5026063
yjbJ_predicted,0.2,4,4,CTTCAAGTGCATGGATTTAG,0,5002763
yjbJ_predicted,0.2,4,4,CTTCAACTGATCTCTTTGAA,0,5020660
yjbJ_predicted,0.2,4,4,CTTATTTCCTTATGTTCGAG,0,5011638
yjbJ_predicted,0.2,4,4,CTTAGGGACATTTAGGCCCA,0,5007545
yjbJ_predicted,0.2,4,4,CTTAGGCCCGACCCACAGTC,0,5003846
yjbJ_predicted,0.2,4,4,CTTAGAGTGAAGTACCATCA,0,5018136
yjbJ_predicted,0.2,4,4,CTGTTGTACGAATCAAGTGG,0,5009806
yjbJ_predicted,0.2,4,4,CTGTGGCCGAACCCACTGTG,0,5025084
yjbJ_predicted,0.2,4,4,CTGTCACTTTCTCTTGCCTC,0,5012986
yjbJ_predicted,0.2,4,4,CTGTACATTTCAATCTTAGT,0,5023329
yjbJ_predicted,0.2,4,4,CTGTAACGTTTAACTAAGCC,0,5008873
yjbJ_predicted,0.2,4,4,CTGGTTTCTTACTACGGAAG,0,5020507
yjbJ_predicted,0.2,4,4,CTGGGTTGCCTATAAGTTTG,0,5027558
yjbJ_predicted,0.2,4,4,CTGGGCCCTTCAATACGCCA,0,5012325
yjbJ_predicted,0.2,4,4,CTGGCAGCTCAGCGACGTTT,0,4996104
yjbJ_predicted,0.2,4,4,CTGGCAGAGGTTGCGATCTA,0,5014403
yjbJ_predicted,0.2,4,4,CTGGCACACCCTCTAGAAGT,0,5013279
yjbJ_predicted,0.2,4,4,CTGGAGGAGATGGAACAATG,0,5003480
yjbJ_predicted,0.2,4,4,CTGCGTCTGAAGGCATCGAA,0,5017360
yjbJ_predicted,0.2,4,4,CTGCGGCTCCAGTGTTCGCG,0,5011963
yjbJ_predicted,0.2,4,4,CTGCGATTCCGGTATCAACG,0,5020870
yjbJ_predicted,0.2,4,4,CTGCAACGGTATCCTGAGGG,0,4995974
yjbJ_predicted,0.2,4,4,CTGATACTGGGAAAGACCTC,0,5001090
yjbJ_predicted,0.2,4,4,CTGAACATGGCGGGTTCAAT,0,5013766
yjbJ_predicted,0.2,4,4,CTCTTCCCAGCGCGTTGCAG,0,5025805
yjbJ_predicted,0.2,4,4,CTCTCAAATCCGATGCAGTG,0,4997314
yjbJ_predicted,0.2,4,4,CTCGTTTTAGGTACGTACTA,0,4997914
yjbJ_predicted,0.2,4,4,CTCGTGAATATGGTTCTTAA,0,5011153
yjbJ_predicted,0.2,4,4,CTCGGCGTATATAGATCTCA,0,5020091
yjbJ_predicted,0.2,4,4,CTCCTTCCGAGTTAGGTTCT,0,5026386
yjbJ_predicted,0.2,4,4,CTCCCATTCTGATGTCCCAG,0,5014017
yjbJ_predicted,0.2,4,4,CTCAGGTGCGTTGAGTTAGT,0,5027395
yjbJ_predicted,0.2,4,4,CTCACTATCATCCGGCTAGG,0,5025364
yjbJ_predicted,0.2,4,4,CTCACTAGCAAGTAGCCCCC,0,4997175
yjbJ_predicted,0.2,4,4,CTCACAAGGTTCTATTGAGG,0,5010865
yjbJ_predicted,0.2,4,4,CTATTTTTCCACCTTTGTTC,0,5027040
yjbJ_predicted,0.2,4,4,CTATCCATGGCGCCATTATT,0,5022088
yjbJ_predicted,0.2,4,4,CTATAGGTCGCGAGCCAAGG,0,5013823
yjbJ_predicted,0.2,4,4,CTATACTAGCATCTGCCCCG,0,5021806
yjbJ_predicted,0.2,4,4,CTAGTTGACTATGTTCTGTC,0,5002908
yjbJ_predicted,0.2,4,4,CTAGCTAGGTATTCGAAGTA,0,4999113
yjbJ_predicted,0.2,4,4,CTAGATTAGCCTGTGAATGT,0,4995110
yjbJ_predicted,0.2,4,4,CTAGATCACCCCATCGGGGT,0,5024508
yjbJ_predicted,0.2,4,4,CTACCCGGTCTGACCACCGA,0,5019917
yjbJ_predicted,0.2,4,4,CTAACCCCTTTCACTCAACT,0,5019535
yjbJ_predicted,0.2,4,4,CGTTGGAAAACCGAGGGATG,0,4999382
yjbJ_predicted,0.2,4,4,CGTTGATGTATGGTTTTAAG,0,5029955
yjbJ_predicted,0.2,4,4,CGTTCTACAAGAATGTGCCG,0,5014832
yjbJ_predicted,0.2,4,4,CGTTCGAACATTGGCGGACT,0,5027659
yjbJ_predicted,0.2,4,4,CGTTCCATGTCCCCAGATCA,0,5026813
yjbJ_predicted,0.2,4,4,CGTTCAGTTTACTCTTCCAA,0,5022756
yjbJ_predicted,0.2,4,4,CGTGTGAATCTGCCAAAGGA,0,4996085
yjbJ_predicted,0.2,4,4,CGTGTATATCTGGGCTGTTG,0,5015127
yjbJ_predicted,0.2,4,4,CGTCTACTAGAGTAGTGAGC,0,5029688
yjbJ_predicted,0.2,4,4,CGTCAATGCGATGTCCGTCC,0,5011107
yjbJ_predicted,0.2,4,4,CGTAGCCTCAGCGATACCCG,0,5011255
yjbJ_predicted,0.2,4,4,CGTACCCAATACTTTGCGCC,0,5008300
yjbJ_predicted,0.2,4,4,CGGTTCACGAATAATCGACA,0,5016133
yjbJ_predicted,0.2,4,4,CGGTTAGGGCCTCTCTTTAT,0,5021203
yjbJ_predicted,0.2,4,4,CGGTCGAAAATCTCCTTGTG,0,5027920
yjbJ_predicted,0.2,4,4,CGGGTTATGAGAGTACATAA,0,5002261
yjbJ_predicted,0.2,4,4,CGGGTGGATCGGCCTAGAGC,0,5017009
yjbJ_predicted,0.2,4,4,CGGGGGTATGGAAGAGCTCA,0,5010178
yjbJ_predicted,0.2,4,4,CGGCTATCTCAAGGGGGCGG,0,5005687
yjbJ_predicted,0.2,4,4,CGGCCGTCTGTATCTCCGAA,0,5009228
yjbJ_predicted,0.2,4,4,CGGAGGCTCCCGGGGAGTTA,0,5018261
yjbJ_predicted,0.2,4,4,CGGACTATTTGGGTCGTTGC,0,5005353
yjbJ_predicted,0.2,4,4,CGGACGTCCGCTGCCGCCTT,0,4995313
yjbJ_predicted,0.2,4,4,CGGAAGGTAACGGTTACGAC,0,5009600
yjbJ_predicted,0.2,4,4,CGCTTAAACATCTCGTTTGA,0,5006543
yjbJ_predicted,0.2,4,4,CGCTGTGGTCTACAGGTGTA,0,5002402
yjbJ_predicted,0.2,4,4,CGCGTCATGGTAAGCGCCAT,0,5026608
yjbJ_predicted,0.2,4,4,CGCGTAAATCGAAAGTGGGG,0,5029948
yjbJ_predicted,0.2,4,4,CGCGGACCCCTTGGAACGTA,0,5020575
yjbJ_predicted,0.2,4,4,CGCGCTGTGCTGACAAAAGT,0,5014332
yjbJ_predicted,0.2,4,4,CGCGCTCGATGTCAATATGC,0,5004984
yjbJ_predicted,0.2,4,4,CGCGCGCCGCGCGTACATAT,0,5028313
yjbJ_predicted,0.2,4,4,CGCCTCGACCACTCGGCTAG,0,5014802
yjbJ_predicted,0.2,4,4,CGCCTACGCGATATAGATGT,0,5025586
yjbJ_predicted,0.2,4,4,CGCCGCTAACGTCTTAGTGT,0,4998491
yjbJ_predicted,0.2,4,4,CGCCGCCTTCGCGTGTATCA,0,5023211
yjbJ_predicted,0.2,4,4,CGCCCGGAGACTCGTTGGTC,0,5021154
yjbJ_predicted,0.2,4,4,CGCCCGCATTTACCGCGCAA,0,4997630
yjbJ_predicted,0.2,4,4,CGCCCAAAATTGGCAATTGG,0,5007678
yjbJ_predicted,0.2,4,4,CGCCACATCATTGCCACGCT,0,5011087
yjbJ_predicted,0.2,4,4,CGCAGGGATATCCGGGACAG,0,5004019
yjbJ_predicted,0.2,4,4,CGATTACATTTTGGGATTCA,0,4997363
yjbJ_predicted,0.2,4,4,CGAGTGGGTGTACAAACTAC,0,5013219
yjbJ_predicted,0.2,4,4,CGAGTAGAGCGTAATCACTA,0,4997376
yjbJ_predicted,0.2,4,4,CGAGCTATGCTTAGGTGCAA,0,5010528
yjbJ_predicted,0.2,4,4,CGACTCGATAGATCATCGCT,0,5002316
yjbJ_predicted,0.2,4,4,CGACGAGGAGCTGGACTAAG,0,5012555
yjbJ_predicted,0.2,4,4,CGACCACACCGACAGGCTGG,0,5011684
yjbJ_predicted,0.2,4,4,CGACAGCAAAATCACGGACC,0,4996653
yjbJ_predicted,0.2,4,4,CGACACTCGGATCTGGCGTC,0,5025911
yjbJ_predicted,0.2,4,4,CGAAGGTCATAGAGGGCATG,0,5014724
yjbJ_predicted,0.2,4,4,CGAAGGCCGGAGTGAGGTTG,0,4997796
yjbJ_predicted,0.2,4,4,CGAACGGTTTTAAGTATCAG,0,5020206
yjbJ_predicted,0.2,4,4,CCTTTTTATTACTTTTACTC,0,5026460
yjbJ_predicted,0.2,4,4,CCTTTGAGGGGGAACCCGGT,0,5030414
yjbJ_predicted,0.2,4,4,CCTTCTTAAGGGCTTACCTA,0,5019320
yjbJ_predicted,0.2,4,4,CCTTCTGCCCATGAGGCGTA,0,5019109
yjbJ_predicted,0.2,4,4,CCTTAAACACCATTAAGTGA,0,5001037
yjbJ_predicted,0.2,4,4,CCTGTCGAACTCAGGGTGCT,0,5001293
yjbJ_predicted,0.2,4,4,CCTGGGCCGCCCGGCTCCTA,0,5029462
yjbJ_predicted,0.2,4,4,CCTGGAAGTCCAGAAGTTAC,0,5027314
yjbJ_predicted,0.2,4,4,CCTCTGTGTGCACCAGCTCA,0,5028164
yjbJ_predicted,0.2,4,4,CCTCGGTACGAATACCCGGA,0,5017840
yjbJ_predicted,0.2,4,4,CCTCGGGGCAATGCGGGAGG,0,5015374
yjbJ_predicted,0.2,4,4,CCTCACGAAGAATATAATTC,0,5027220
yjbJ_predicted,0.2,4,4,CCTAGCTTAGGGCGGGCGGG,0,5018272
yjbJ_predicted,0.2,4,4,CCTAAAATCTCTCTACATCC,0,5000959
yjbJ_predicted,0.2,4,4,CCGTTCTAGCATATACCAAA,0,5002741
yjbJ_predicted,0.2,4,4,CCGGTATTCTCAGAATCTTC,0,5006202
yjbJ_predicted,0.2,4,4,CCGGTACCAAAACTCGTCCG,0,5009971
yjbJ_predicted,0.2,4,4,CCGGCAACATACCCTACTGC,0,5010344
yjbJ_predicted,0.2,4,4,CCGAGTTGAGTGCAGCACTG,0,4995771
yjbJ_predicted,0.2,4,4,CCGAGTCAGTCGAGTGGCGA,0,5026214
yjbJ_predicted,0.2,4,4,CCGAGGTCTCGATAGGAAAA,0,5025950
yjbJ_predicted,0.2,4,4,CCGACGATGCTTGTGCTTAT,0,5005578
yjbJ_predicted,0.2,4,4,CCGAAACGATTAGCATACGT,0,5019475
yjbJ_predicted,0.2,4,4,CCCTGCGACTGTCATGGTGC,0,5014434
yjbJ_predicted,0.2,4,4,CCCTGACTTTCTAACTGATG,0,5020004
yjbJ_predicted,0.2,4,4,CCCTCCTAGCGTCCCGGGCA,0,5023762
yjbJ_predicted,0.2,4,4,CCCGTTGAACTGTTACGTTG,0,5002107
yjbJ_predicted,0.2,4,4,CCCGTCTCACCATCACAAAT,0,5012045
yjbJ_predicted,0.2,4,4,CCCGGCAAGGATGATGGTAC,0,5013293
yjbJ_predicted,0.2,4,4,CCCGCGCGTACACCGTTGTA,0,5008657
yjbJ_predicted,0.2,4,4,CCCGACTGTGCACATTAAAG,0,5022468
yjbJ_predicted,0.2,4,4,CCCCTTCACGACGTTTTTCC,0,5008536
yjbJ_predicted,0.2,4,4,CCCCCTGGACAACAGGGTGT,0,5031072
yjbJ_predicted,0.2,4,4,CCCCCAGGTGGCTGCAAGGA,0,5011172
yjbJ_predicted,0.2,4,4,CCCCATCAGCGCGAGCATAA,0,5010293
yjbJ_predicted,0.2,4,4,CCCATTAGACATGGTGAGGC,0,5016101
yjbJ_predicted,0.2,4,4,CCCATCGAGTAGGCGTTGAA,0,5000539
yjbJ_predicted,0.2,4,4,CCATTCACATAGCATTACCG,0,5025521
yjbJ_predicted,0.2,4,4,CCATGGGGTTCGTGTAGAAT,0,5004545
yjbJ_predicted,0.2,4,4,CCATAGATTCGCCATTGCGT,0,4996808
yjbJ_predicted,0.2,4,4,CCAGTGTTTAACTCGCTGGA,0,5002361
yjbJ_predicted,0.2,4,4,CCAGTCAAGGAGGCGCGATA,0,5003897
yjbJ_predicted,0.2,4,4,CCACTGATCAAATGCTTAGA,0,5005379
yjbJ_predicted,0.2,4,4,CCACTACGGTGTGGGAAAAG,0,5012119
yjbJ_predicted,0.2,4,4,CCACCTTGTAGCGACGTGCC,0,4997249
yjbJ_predicted,0.2,4,4,CCACAACAGTCCGGAGCACA,0,5016031
yjbJ_predicted,0.2,4,4,CCAAGTTACGATGTTTTGAG,0,5018279
yjbJ_predicted,0.2,4,4,CATTTTTAGTCCCGCTTTTT,0,4998594
yjbJ_predicted,0.2,4,4,CATTGTTAAGCAGGCATTCT,0,5001021
yjbJ_predicted,0.2,4,4,CATTGCTGCCACGCGCTCTA,0,5016898
yjbJ_predicted,0.2,4,4,CATTGCCTATACCTGCAAGG,0,5018070
yjbJ_predicted,0.2,4,4,CATTGACTGTTTTCATGCGT,0,5015507
yjbJ_predicted,0.2,4,4,CATTACATACAAGGGTCTGT,0,5008692
yjbJ_predicted,0.2,4,4,CATTAAGCCAACGGCGAATC,0,5014823
yjbJ_predicted,0.2,4,4,CATGTGCAGCCGCGGCTTGT,0,5010266
yjbJ_predicted,0.2,4,4,CATGTGATGGGGAGGATAGG,0,5029897
yjbJ_predicted,0.2,4,4,CATGCTCGGCCTGACGGGAT,0,4994952
yjbJ_predicted,0.2,4,4,CATGCCCGGAGGCTCAATTG,0,5001760
yjbJ_predicted,0.2,4,4,CATCATGTTCGGTTCGGCTA,0,5017568
yjbJ_predicted,0.2,4,4,CATCAGATTGGGTCAGCCCA,0,5011707
yjbJ_predicted,0.2,4,4,CATAGTAAGGTGAGGATGAG,0,5000041
yjbJ_predicted,0.2,4,4,CATACATCTTCGCTGGAGAA,0,5002203
yjbJ_predicted,0.2,4,4,CAGTGTTGCGTTAGGACGGC,0,5013742
yjbJ_predicted,0.2,4,4,CAGTGCTGCTATGGCACCTA,0,5001243
yjbJ_predicted,0.2,4,4,CAGTGAGCAAGTTCTGTTGG,0,5011581
yjbJ_predicted,0.2,4,4,CAGGTTTTCTCGTGTCATTT,0,5028607
yjbJ_predicted,0.2,4,4,CAGGCAAAAGATTTTTGGCG,0,4999471
yjbJ_predicted,0.2,4,4,CAGGAGATCCGTCAGCGCTA,0,5007133
yjbJ_predicted,0.2,4,4,CAGGAGAGCCGACACGAAAC,0,5022665
yjbJ_predicted,0.2,4,4,CAGCGGCTGCATCCTTGATG,0,5017642
yjbJ_predicted,0.2,4,4,CAGCGCGTATCCGGTCAAAA,0,5000237
yjbJ_predicted,0.2,4,4,CAGCCCTTCGAACATGACTA,0,5005190
yjbJ_predicted,0.2,4,4,CAGATTCACTGTTGATCATA,0,5004023
yjbJ_predicted,0.2,4,4,CAGATAAGGAGCTTACGATG,0,5026282
yjbJ_predicted,0.2,4,4,CAGACATGGGCCATCGTACC,0,5011327
yjbJ_predicted,0.2,4,4,CAGACAGACGGCCTGTGCCT,0,5024860
yjbJ_predicted,0.2,4,4,CACTGCTGAGTTCCGTTTAA,0,5015181
yjbJ_predicted,0.2,4,4,CACTCTGAGCCAGCAAAGGA,0,4997478
yjbJ_predicted,0.2,4,4,CACTATACCCCCCTGACGCT,0,5022368
yjbJ_predicted,0.2,4,4,CACGTTTAGTTACTAATCGC,0,4999019
yjbJ_predicted,0.2,4,4,CACGGTACTCGATATACCTA,0,5012091
yjbJ_predicted,0.2,4,4,CACGGGCTAGTATGTGTACC,0,4999035
yjbJ_predicted,0.2,4,4,CACCCTTATGCACTCGGAGA,0,5011796
yjbJ_predicted,0.2,4,4,CACCCACGCGGGGAAGGAAG,0,5015233
yjbJ_predicted,0.2,4,4,CACAGAGGCTCGTGCTAGGA,0,5027807
yjbJ_predicted,0.2,4,4,CACAAGGCGCAGATAGTACC,0,5019915
yjbJ_predicted,0.2,4,4,CAATTCCGTTTAGTGGCCAT,0,5015985
yjbJ_predicted,0.2,4,4,CAATCCCCTAAAGTGTGAAT,0,5002882
yjbJ_predicted,0.2,4,4,CAAGTGGACTGCGCACCGCG,0,5022598
yjbJ_predicted,0.2,4,4,CAAGGGTCTTAAGAGGCAGG,0,5019436
yjbJ_predicted,0.2,4,4,CAACTTGAAATGCTGACGAT,0,5011060
yjbJ_predicted,0.2,4,4,CAACTAAGGGGGTTGGCGAC,0,5016775
yjbJ_predicted,0.2,4,4,CAACGTTCTACCAGGTATAA,0,5003926
yjbJ_predicted,0.2,4,4,CAACGGCAACGGTGCACCAC,0,5008360
yjbJ_predicted,0.2,4,4,CAAATGGCAAGGGGGCAGCT,0,5018514
yjbJ_predicted,0.2,4,4,CAAAGGCCGTAGGCGCTTCC,0,5006821
yjbJ_predicted,0.2,4,4,ATTTTGTCCTTTCAGGCTTT,0,5017245
yjbJ_predicted,0.2,4,4,ATTTTGCTCCCGGCTTATCT,0,5013378
yjbJ_predicted,0.2,4,4,ATTTGCTGTCCTAGACTCGC,0,5023541
yjbJ_predicted,0.2,4,4,ATTTCGATTTTTGCACTTAT,0,5010013
yjbJ_predicted,0.2,4,4,ATTTCAGTCGCTATTCCCGC,0,5002759
yjbJ_predicted,0.2,4,4,ATTGGGGTTTTTAGGCTGAA,0,5026751
yjbJ_predicted,0.2,4,4,ATTCGTCCGGACCACGAAAT,0,4995959
yjbJ_predicted,0.2,4,4,ATTCGAGTAGTATGCACAAT,0,5013079
yjbJ_predicted,0.2,4,4,ATTCAGGACCCCCGCCTAAT,0,5027523
yjbJ_predicted,0.2,4,4,ATTCAGAGGACGAACAGCCT,0,5003532
yjbJ_predicted,0.2,4,4,ATTATGACTGCCACCCGAGT,0,5029403
yjbJ_predicted,0.2,4,4,ATTATCTCGTAGCCCGACTT,0,5002662
yjbJ_predicted,0.2,4,4,ATTAAGCGAGCTTCACAATC,0,5016694
yjbJ_predicted,0.2,4,4,ATGTGCTGTACACATCGATA,0,4998635
yjbJ_predicted,0.2,4,4,ATGTCTATTGAAAAACACTG,0,5020271
yjbJ_predicted,0.2,4,4,ATGGGCCAGTCAGTTTACTG,0,5004516
yjbJ_predicted,0.2,4,4,ATGGGAAAGATATTCGGACA,0,5014844
yjbJ_predicted,0.2,4,4,ATGGCCTCTGCTCGGGATGA,0,5022724
yjbJ_predicted,0.2,4,4,ATGGACTCAGTGCGGTGTGG,0,4995777
yjbJ_predicted,0.2,4,4,ATGAGTCTCCGGCCTTTTGA,0,5002737
yjbJ_predicted,0.2,4,4,ATGAGGAAATTGGGGACTCT,0,4997868
yjbJ_predicted,0.2,4,4,ATGACTCATCGGTAGTCGTA,0,5008270
yjbJ_predicted,0.2,4,4,ATGACATGGAGAAAAGATAG,0,5006361
yjbJ_predicted,0.2,4,4,ATCTTGTTATGTCTGGCCAG,0,5028755
yjbJ_predicted,0.2,4,4,ATCTGCAGTTTGCCGTAATG,0,5017335
yjbJ_predicted,0.2,4,4,ATCTCCAGGTACGGCTGATT,0,5022730
yjbJ_predicted,0.2,4,4,ATCTACAATATTTCGAACCG,0,5024459
yjbJ_predicted,0.2,4,4,ATCGCCCTAGGACGATCTTC,0,5016911
yjbJ_predicted,0.2,4,4,ATCCGCATATTAACTGTCTA,0,5018651
yjbJ_predicted,0.2,4,4,ATCCCGGAATACCTACAAAG,0,4997666
yjbJ_predicted,0.2,4,4,ATCACATCGAGATGTTCCCT,0,4995157
yjbJ_predicted,0.2,4,4,ATATTGAGGTGTCGTATTAC,0,5015148
yjbJ_predicted,0.2,4,4,ATATTCTGCTTCCCGTCGGT,0,5026740
yjbJ_predicted,0.2,4,4,ATATTAGAAGATCTTCTCCC,0,5020163
yjbJ_predicted,0.2,4,4,ATATCCGTGTCTACTCATAG,0,5006510
yjbJ_predicted,0.2,4,4,ATATATGTCGATTTAGATTG,0,5018281
yjbJ_predicted,0.2,4,4,ATATATCGTCACCGGATGAT,0,5011274
yjbJ_predicted,0.2,4,4,ATATACGCACAGAAGATATA,0,5019246
yjbJ_predicted,0.2,4,4,ATAGTCCTCAGCCCTCCTAA,0,5025293
yjbJ_predicted,0.2,4,4,ATAGCCATATCAATAATCTA,0,5012081
yjbJ_predicted,0.2,4,4,ATACCCGGCTTAGGTTAAAC,0,5026140
yjbJ_predicted,0.2,4,4,ATACAGTTGACTCGGGGGGT,0,5012148
yjbJ_predicted,0.2,4,4,ATAATCATGACCAACCAACG,0,5004276
yjbJ_predicted,0.2,4,4,ATAACAATGCTAATCTCAAA,0,5014770
yjbJ_predicted,0.2,4,4,AGTTCGATGTACCCTAGACT,0,4995709
yjbJ_predicted,0.2,4,4,AGTTATAGTACAAGTGAGCT,0,5004806
yjbJ_predicted,0.2,4,4,AGTTAGAGGTCCCTGACCAT,0,5002523
yjbJ_predicted,0.2,4,4,AGTTACCTACTGGGCTGTAA,0,5003324
yjbJ_predicted,0.2,4,4,AGTGTCGGGAGGATGAATCG,0,5008721
yjbJ_predicted,0.2,4,4,AGTGGTTCTGTATACCCGGC,0,5019645
yjbJ_predicted,0.2,4,4,AGTGACACTGTTTTGTTCTG,0,4996603
yjbJ_predicted,0.2,4,4,AGTCTCCTTTAGAGGGCTAT,0,5018208
yjbJ_predicted,0.2,4,4,AGTCACCGGGGTAACGCCTA,0,5019183
yjbJ_predicted,0.2,4,4,AGTAAGACGATCGGCTACGG,0,5002174
yjbJ_predicted,0.2,4,4,AGGTCGGATTAAGCAGGTTC,0,5009513
yjbJ_predicted,0.2,4,4,AGGTCGCCGGTAATCCCCGG,0,4995860
yjbJ_predicted,0.2,4,4,AGGTCCCATGTCTGCTGCAG,0,5012738
yjbJ_predicted,0.2,4,4,AGGGTCGGCTAGCATCAGGG,0,5025883
yjbJ_predicted,0.2,4,4,AGGGCGTGTTCATTAGTTCG,0,5005145
yjbJ_predicted,0.2,4,4,AGGGACCGCATAGATCGCTT,0,5010970
yjbJ_predicted,0.2,4,4,AGGCTGCTCCTGTACAAAGA,0,5003397
yjbJ_predicted,0.2,4,4,AGGCCGCTCTGATCTAATTT,0,5012175
yjbJ_predicted,0.2,4,4,AGGATGTCGGAGAACATTAT,0,5007151
yjbJ_predicted,0.2,4,4,AGGATAACTTCTGGCCGGCA,0,5028568
yjbJ_predicted,0.2,4,4,AGGAAAGCGAAGGTCTCGGC,0,4998117
yjbJ_predicted,0.2,4,4,AGGAAAGCCCATGCGAAGGC,0,5013731
yjbJ_predicted,0.2,4,4,AGGAAAAACAATGCGTGGAG,0,5022279
yjbJ_predicted,0.2,4,4,AGCTCGAACCGTGCATCTCC,0,5018600
yjbJ_predicted,0.2,4,4,AGCTACTTACACTGTCAATT,0,5000143
yjbJ_predicted,0.2,4,4,AGCGAGTCCACTATCGAAAG,0,5004165
yjbJ_predicted,0.2,4,4,AGCGAGAGCGAGGCCCGGGA,0,5027162
yjbJ_predicted,0.2,4,4,AGCCTACCTCATTCTGCCTA,0,5016729
yjbJ_predicted,0.2,4,4,AGCATGAGTAGTCTGTAAGG,0,4996928
yjbJ_predicted,0.2,4,4,AGCATGAACAGCCAGTCGGG,0,5014320
yjbJ_predicted,0.2,4,4,AGCATCGGCGTCCGCAGTAA,0,5015499
yjbJ_predicted,0.2,4,4,AGATGTCAAAGTGACGCAAC,0,5022298
yjbJ_predicted,0.2,4,4,AGATCTAAGACGCTGGAGTG,0,5009566
yjbJ_predicted,0.2,4,4,AGATAAATAAGTAGGTTCTC,0,5019624
yjbJ_predicted,0.2,4,4,AGAGTGCTCACAGAGGGGTA,0,5000526
yjbJ_predicted,0.2,4,4,AGAGGGTAGTGATTCTTACA,0,5024941
yjbJ_predicted,0.2,4,4,AGAGGGGATCGGGGGACGTT,0,5014904
yjbJ_predicted,0.2,4,4,AGAGCAGGAGGTTGTTTTGT,0,5004462
yjbJ_predicted,0.2,4,4,AGACTTCCAAAGTACCTAAT,0,5004062
yjbJ_predicted,0.2,4,4,AGACGGCCTTGAGTTAACGA,0,5017565
yjbJ_predicted,0.2,4,4,AGACGCCCGAGCCATGCGTA,0,5022224
yjbJ_predicted,0.2,4,4,AGACATTGTATTTTGAATAA,0,4999153
yjbJ_predicted,0.2,4,4,AGACACGTTAACCTACTGGT,0,5011812
yjbJ_predicted,0.2,4,4,AGAATTGTTCAGTGAAAAAC,0,5009609
yjbJ_predicted,0.2,4,4,ACTTCGGGCTAGGCCCGTCC,0,5022556
yjbJ_predicted,0.2,4,4,ACTTACCTCCATAATGCCAT,0,4997798
yjbJ_predicted,0.2,4,4,ACTGTCGATACTAAACTATC,0,5014366
yjbJ_predicted,0.2,4,4,ACTGGACGGGCGGAGATCAG,0,5003925
yjbJ_predicted,0.2,4,4,ACTCGTTCCCTCGCGGATGC,0,5006941
yjbJ_predicted,0.2,4,4,ACTCGGACACTATCCATCTC,0,5027230
yjbJ_predicted,0.2,4,4,ACTCAAGCTTACCCCCCTTA,0,5013719
yjbJ_predicted,0.2,4,4,ACTAGAGTCTCATTCCGTAA,0,5028646
yjbJ_predicted,0.2,4,4,ACGTGCTACAGGCCAATTAT,0,4997165
yjbJ_predicted,0.2,4,4,ACGGGCGGTGCCAGGAAGTT,0,5005396
yjbJ_predicted,0.2,4,4,ACGGGCCTCACAAGTGATAT,0,5015406
yjbJ_predicted,0.2,4,4,ACGGCTTTCTTCGCAGTGCG,0,5027488
yjbJ_predicted,0.2,4,4,ACGGCGAACGGGGTGGAATA,0,5013352
yjbJ_predicted,0.2,4,4,ACGGAGCGCACTTAGACACG,0,4996608
yjbJ_predicted,0.2,4,4,ACGGACGCGGACATATCTAG,0,5019012
yjbJ_predicted,0.2,4,4,ACGGACGAAAGACACGGAGC,0,4996461
yjbJ_predicted,0.2,4,4,ACGCGAATAGAATATCCGCG,0,5025760
yjbJ_predicted,0.2,4,4,ACGCAGTGATACTAGACGTC,0,5013696
yjbJ_predicted,0.2,4,4,ACGCAGAGGAAGGTTCCCTC,0,5026796
yjbJ_predicted,0.2,4,4,ACGCACTAGCCTGGAATGGA,0,4997648
yjbJ_predicted,0.2,4,4,ACGAGACCCAGTAGGCCGAG,0,5017385
yjbJ_predicted,0.2,4,4,ACGACTATTAGTGTTCCGGT,0,5002565
yjbJ_predicted,0.2,4,4,ACCTTTCACGGAGACCAAGG,0,5029631
yjbJ_predicted,0.2,4,4,ACCTTCAGCTCAATTCTTAA,0,5007861
yjbJ_predicted,0.2,4,4,ACCTGTACGCACGGGCGTCC,0,4999541
yjbJ_predicted,0.2,4,4,ACCTAATTGGTGTATGCTAC,0,5002645
yjbJ_predicted,0.2,4,4,ACCGGCCAACCGATAATTAT,0,4995849
yjbJ_predicted,0.2,4,4,ACCGATAGGGCAAAAGTTGT,0,5007016
yjbJ_predicted,0.2,4,4,ACCCTCCATCTCGAGGACCG,0,5021257
yjbJ_predicted,0.2,4,4,ACCCGCGTAGATGCCAAAAA,0,5018713
yjbJ_predicted,0.2,4,4,ACCCCCCTCAGAACCGACTC,0,5002215
yjbJ_predicted,0.2,4,4,ACCAGTGGCATATCAGTGAA,0,5016293
yjbJ_predicted,0.2,4,4,ACCACTTGCACGTAGGCGGG,0,5013863
yjbJ_predicted,0.2,4,4,ACCACGAAGCGACTTCCGGT,0,5025734
yjbJ_predicted,0.2,4,4,ACCACATGCCGAATCTCTTC,0,4997208
yjbJ_predicted,0.2,4,4,ACCAATGCTGGTATGACTCC,0,4996604
yjbJ_predicted,0.2,4,4,ACCAAGCCACCTTTATCCTA,0,5002155
yjbJ_predicted,0.2,4,4,ACCAAATTTCATCCACATCA,0,5002046
yjbJ_predicted,0.2,4,4,ACCAAAAACTGGCGGCACGA,0,5019711
yjbJ_predicted,0.2,4,4,ACATAGGACATCTACACGCT,0,5026747
yjbJ_predicted,0.2,4,4,ACAGCTCTCCTAGAAGGTCT,0,5016945
yjbJ_predicted,0.2,4,4,ACAGATTTAGCATTTCTAAA,0,5006050
yjbJ_predicted,0.2,4,4,ACACGTGCCTTAATTGAGCG,0,4999460
yjbJ_predicted,0.2,4,4,ACAATTCCGAAGCAGCTGTA,0,5030747
yjbJ_predicted,0.2,4,4,ACAATTACGTACTGTATAGG,0,4995872
yjbJ_predicted,0.2,4,4,ACAAGCGCTGTGCGGAGCAG,0,5019314
yjbJ_predicted,0.2,4,4,ACAAAGTTTCTTCTGCAAGT,0,5015327
yjbJ_predicted,0.2,4,4,AATTGCTTACTTTAGGGGAT,0,4995378
yjbJ_predicted,0.2,4,4,AATGGGAGTTGCGGCATCTC,0,5001605
yjbJ_predicted,0.2,4,4,AATGAGCCTATGCTCCGTGC,0,5026137
yjbJ_predicted,0.2,4,4,AATGAGCCGGGACCCTGCCC,0,5001901
yjbJ_predicted,0.2,4,4,AATGAATATCCTCTTGCAGA,0,4996544
yjbJ_predicted,0.2,4,4,AATCTCGGGATTTATAGCTC,0,5012785
yjbJ_predicted,0.2,4,4,AATCGTGGATTGGGATTGCA,0,5028341
yjbJ_predicted,0.2,4,4,AATCGCATAAGCTGGGTACT,0,5005582
yjbJ_predicted,0.2,4,4,AATCCGATTGTATGTGAGGC,0,5029233
yjbJ_predicted,0.2,4,4,AATCCACACCCCAAAGGCTG,0,5022668
yjbJ_predicted,0.2,4,4,AATCAACATGTTTCCTACTA,0,5010738
yjbJ_predicted,0.2,4,4,AATACTTTCTGGCATCGTGC,0,5014160
yjbJ_predicted,0.2,4,4,AAGTGTCGTGACGTATAGCC,0,4996095
yjbJ_predicted,0.2,4,4,AAGTCCATGGGACTCTCGGC,0,5023524
yjbJ_predicted,0.2,4,4,AAGGTTATGATACTGAGTTT,0,5004429
yjbJ_predicted,0.2,4,4,AAGGTCAAGGCTTGTAATTA,0,5025672
yjbJ_predicted,0.2,4,4,AAGGCTCAACTCCTCAATGT,0,5014711
yjbJ_predicted,0.2,4,4,AAGGCGGGCCATAGAGGCAT,0,5002018
yjbJ_predicted,0.2,4,4,AAGGACAAGGGACGCACGAA,0,5015366
yjbJ_predicted,0.2,4,4,AAGCTGACATGGAGAGCCCT,0,5030125
yjbJ_predicted,0.2,4,4,AAGATTTGACTATCGTTCCA,0,5002880
yjbJ_predicted,0.2,4,4,AAGAATATGCATGTGTCTGT,0,5011716
yjbJ_predicted,0.2,4,4,AACTTTTGGTGTGCCCGCAA,0,4995672
yjbJ_predicted,0.2,4,4,AACTTTATGATATCGAAATA,0,5005025
yjbJ_predicted,0.2,4,4,AACTTGGTATGGACCGTAAA,0,5028896
yjbJ_predicted,0.2,4,4,AACTTGAGGAAGTCGAAAGG,0,5006804
yjbJ_predicted,0.2,4,4,AACTTATAACGAATCTCGCG,0,5026271
yjbJ_predicted,0.2,4,4,AACGTTAGCACGGCAAGACA,0,5003361
yjbJ_predicted,0.2,4,4,AACGGCTCGACAGGCACAAT,0,4995835
yjbJ_predicted,0.2,4,4,AACGCTATTCTAGTTTTGGG,0,5008724
yjbJ_predicted,0.2,4,4,AACGCGAGGTTGGCAAAAAA,0,5018159
yjbJ_predicted,0.2,4,4,AACCGACATGCTGTCGGAGT,0,4996698
yjbJ_predicted,0.2,4,4,AACCCAAAATCACTTACGCA,0,5000762
yjbJ_predicted,0.2,4,4,AAATTTGTCGCACTCTTCAA,0,5030515
yjbJ_predicted,0.2,4,4,AAATTTATAAATCGGGCAAT,0,5030026
yjbJ_predicted,0.2,4,4,AAATTCATGCTGTTATGATA,0,5022220
yjbJ_predicted,0.2,4,4,AAATCGTGGGGCCATCGTTC,0,5028361
yjbJ_predicted,0.2,4,4,AAATCCGCATGCCGAGCAAG,0,4994734
yjbJ_predicted,0.2,4,4,AAAGTGGGCACTATTGAGTA,0,4999703
yjbJ_predicted,0.2,4,4,AAAGGCTCACATTTACTCTG,0,5010458
yjbJ_predicted,0.2,4,4,AAACGTTTCTCCCAGGCCCA,0,5027607
yjbJ_predicted,0.2,4,4,AAACACACCGACAAATCTAT,0,5007184
yjbJ_predicted,0.2,4,4,AAAATGCAGAATTATAAGTG,0,4995582
yjbJ_predicted,0.2,4,4,AAAACATAGCCATAATAAGG,0,4998444
yjbJ_predicted,0.25,3,3,TTTTGTGAGTAGTGCGATTC,0,5030116
yjbJ_predicted,0.25,3,3,TTTTGATTGGTCTCAAAATA,0,5007167
yjbJ_predicted,0.25,3,3,TTTGTCTAACTCCACCAGGG,0,5028142
yjbJ_predicted,0.25,3,3,TTTGGGATTTCGTGACGGAA,0,5018683
yjbJ_predicted,0.25,3,3,TTTGCCAAAGCATGTATCCT,0,5009292
yjbJ_predicted,0.25,3,3,TTTCGCCTACAGCCCATATG,0,5009733
yjbJ_predicted,0.25,3,3,TTTCGCAACCCCCTAGTAGC,0,5009429
yjbJ_predicted,0.25,3,3,TTTCATATTTCCGATTAGTG,0,5008318
yjbJ_predicted,0.25,3,3,TTTCAGCCTCACGGCGTTAC,0,5023221
yjbJ_predicted,0.25,3,3,TTTCAACGATCCCTGGGGGA,0,5022938
yjbJ_predicted,0.25,3,3,TTTATAACGAGAAGTAAGGT,0,5002974
yjbJ_predicted,0.25,3,3,TTTAGTCTTCTCTTATCCAC,0,5021960
yjbJ_predicted,0.25,3,3,TTTAACAGTGACGTCCATAA,0,5023191
yjbJ_predicted,0.25,3,3,TTGTTGTCTTTTCGCCAGGT,0,5002999
yjbJ_predicted,0.25,3,3,TTGTTCTGCTGGCGCTGATT,0,5022846
yjbJ_predicted,0.25,3,3,TTGTGTTGTCCTCGGAGATC,0,5019713
yjbJ_predicted,0.25,3,3,TTGTCTCCTCGGGCCGCCTG,0,5028949
yjbJ_predicted,0.25,3,3,TTGTCTAAGTCCAGGTGATT,0,5001383
yjbJ_predicted,0.25,3,3,TTGTCGTTCAAGGGTAAACT,0,5027392
yjbJ_predicted,0.25,3,3,TTGGTGCGATCAAGCACAAG,0,5018426
yjbJ_predicted,0.25,3,3,TTGGGTCACGAGAGTGCCGG,0,5005654
yjbJ_predicted,0.25,3,3,TTGGCAACGGGCGCATCTAG,0,5020055
yjbJ_predicted,0.25,3,3,TTGCGAGGGATCCGGATGAC,0,5004962
yjbJ_predicted,0.25,3,3,TTGCGAAGAAGCGATAGAAA,0,5015383
yjbJ_predicted,0.25,3,3,TTGCCGCTCATAGAATCTCA,0,5020238
yjbJ_predicted,0.25,3,3,TTGAGTCTCCGTGCCGGGAT,0,4994739
yjbJ_predicted,0.25,3,3,TTGACTCGTCTCATAGCTCT,0,5030558
yjbJ_predicted,0.25,3,3,TTGACCGTTCGTTTATATTA,0,5018232
yjbJ_predicted,0.25,3,3,TTCTGTTTGTATCCATGCTC,0,5029594
yjbJ_predicted,0.25,3,3,TTCTCTGTACGTAGATTTCA,0,5000006
yjbJ_predicted,0.25,3,3,TTCTCAACAGTCCTTCGTCA,0,5020421
yjbJ_predicted,0.25,3,3,TTCGGGTATCCCCTGTCACA,0,5010324
yjbJ_predicted,0.25,3,3,TTCGGGGTATGTCGGATAAG,0,5012983
yjbJ_predicted,0.25,3,3,TTCGGCTTCCTTCGACCAGT,0,5000110
yjbJ_predicted,0.25,3,3,TTCGCGGTGTGTGCTCTCTA,0,4998668
yjbJ_predicted,0.25,3,3,TTCGCCTATACCTGAAGACC,0,5027757
yjbJ_predicted,0.25,3,3,TTCGAGATCTCACGCACATG,0,5022804
yjbJ_predicted,0.25,3,3,TTCGAGATACGTGCAGTATC,0,5002229
yjbJ_predicted,0.25,3,3,TTCCTTTAATTTGGTATTAA,0,5015358
yjbJ_predicted,0.25,3,3,TTCCTCGACAGCTTCGCCTG,0,5009523
yjbJ_predicted,0.25,3,3,TTCCGGATATCGGCGCCTTG,0,5019715
yjbJ_predicted,0.25,3,3,TTCCCGACGTCCTTTAAAAG,0,4998054
yjbJ_predicted,0.25,3,3,TTCCCCATTTGGGGGGTAAA,0,5008764
yjbJ_predicted,0.25,3,3,TTCCATTTGATCGTCATGGT,0,5012717
yjbJ_predicted,0.25,3,3,TTCAGATTCGCTTCTGGGTA,0,5025560
yjbJ_predicted,0.25,3,3,TTCAGATCATGTTAAAGTGG,0,5024313
yjbJ_predicted,0.25,3,3,TTCACCGCGTGAATCGCAGA,0,5030871
yjbJ_predicted,0.25,3,3,TTCACCCTGAGGGGTGGACT,0,5030829
yjbJ_predicted,0.25,3,3,TTCAACGAAGGGCAGAGTAT,0,4996518
yjbJ_predicted,0.25,3,3,TTCAAACGATTGCGCGGAAC,0,5025899
yjbJ_predicted,0.25,3,3,TTATCTGAGACTGAGGGAAT,0,5013380
yjbJ_predicted,0.25,3,3,TTATCATCGGGATCCTATCG,0,5000972
yjbJ_predicted,0.25,3,3,TTATAGTACGGAGAGTTCAT,0,5024278
yjbJ_predicted,0.25,3,3,TTAGACTTTGTAGGGGAAAA,0,5022084
yjbJ_predicted,0.25,3,3,TTAGACCATGTCGCGTTCTT,0,5016152
yjbJ_predicted,0.25,3,3,TTAGAACTCTATCCAGGTGT,0,5010082
yjbJ_predicted,0.25,3,3,TTACGCGAATTGCGGCAGAA,0,5026609
yjbJ_predicted,0.25,3,3,TTACGCAACAGATATATCGA,0,5026734
yjbJ_predicted,0.25,3,3,TTACACTCGAATCGCCAAGA,0,5001546
yjbJ_predicted,0.25,3,3,TTACACCACAATGTCACGTT,0,4995750
yjbJ_predicted,0.25,3,3,TTACAAGCGTCCAGGGAGCA,0,5027933
yjbJ_predicted,0.25,3,3,TTAATCATACTTTATAGTTT,0,5007677
yjbJ_predicted,0.25,3,3,TTAATAAGCCTTGTGCGGCT,0,5003083
yjbJ_predicted,0.25,3,3,TTAAACGTGGTGACTGAGGG,0,5025062
yjbJ_predicted,0.25,3,3,TGTTGGACTGGCTTTTCCGA,0,5022147
yjbJ_predicted,0.25,3,3,TGTTGCTCTCCTATGCTAGA,0,5026559
yjbJ_predicted,0.25,3,3,TGTTGCGTGCGCGACGTTGC,0,5000210
yjbJ_predicted,0.25,3,3,TGTTCCACGTATGAAATTCT,0,5000010
yjbJ_predicted,0.25,3,3,TGTTAGGGCCAACCTTGAAG,0,5017072
yjbJ_predicted,0.25,3,3,TGTGGTCTGGGCCATAGTCA,0,5007389
yjbJ_predicted,0.25,3,3,TGTGCTTCAGACAGCTAGCT,0,5016815
yjbJ_predicted,0.25,3,3,TGTCTTACTAGAGATCTACC,0,5004248
yjbJ_predicted,0.25,3,3,TGTCTACATAGTGGAATCCT,0,5021238
yjbJ_predicted,0.25,3,3,TGTCCGCGGAGGACTGTTCA,0,5014359
yjbJ_predicted,0.25,3,3,TGTCAGCTCAAATTTCCGAG,0,5003249
yjbJ_predicted,0.25,3,3,TGTATATCACAGTCAAGGGT,0,5006701
yjbJ_predicted,0.25,3,3,TGTATACGCGATTTATAGCA,0,5011352
yjbJ_predicted,0.25,3,3,TGTACTCGATGGCGTTGGGA,0,5027771
yjbJ_predicted,0.25,3,3,TGTACGGCAGGGAGCCTGAT,0,5019593
yjbJ_predicted,0.25,3,3,TGTACACTTGAGGTCCGGGG,0,5008938
yjbJ_predicted,0.25,3,3,TGGTTGCAACGCGTTCAGGC,0,5012365
yjbJ_predicted,0.25,3,3,TGGTTCTGCAACCCATAGGC,0,5025391
yjbJ_predicted,0.25,3,3,TGGTCTTAAAATGATAGAGG,0,5029640
yjbJ_predicted,0.25,3,3,TGGTATTTAAGATGCCCCTC,0,5028204
yjbJ_predicted,0.25,3,3,TGGTAAAACTGGGAAAACAT,0,5025951
yjbJ_predicted,0.25,3,3,TGGGTGCTTTCCCATGGGCT,0,5009867
yjbJ_predicted,0.25,3,3,TGGGTACGCAAGTGTGGGAC,0,4997893
yjbJ_predicted,0.25,3,3,TGGGTAATCTCTGGGCGTGC,0,5014139
yjbJ_predicted,0.25,3,3,TGGGGGACGGTGCCTAGCGC,0,5009096
yjbJ_predicted,0.25,3,3,TGGGGACGAGGTATCACAGA,0,5030774
yjbJ_predicted,0.25,3,3,TGGGCCGCTGTGGCCGCTTT,0,5030242
yjbJ_predicted,0.25,3,3,TGGGAGAAGTTGAATTCGAA,0,5000760
yjbJ_predicted,0.25,3,3,TGGCTGATGTCGAGGGAAGC,0,5011559
yjbJ_predicted,0.25,3,3,TGGCTCCGGCGGTTGTAAAC,0,5007216
yjbJ_predicted,0.25,3,3,TGGCGGGAGCGACGCCCGCA,0,5014980
yjbJ_predicted,0.25,3,3,TGGCGCCGTCACGTGCATTG,0,5016837
yjbJ_predicted,0.25,3,3,TGGCCCACGCATCCAGGGCT,0,5009255
yjbJ_predicted,0.25,3,3,TGGATCCGTCCTCGATAGTT,0,4997740
yjbJ_predicted,0.25,3,3,TGGAGGACCTTCAAGCCCCA,0,5019658
yjbJ_predicted,0.25,3,3,TGGAGCACCTCCTCGGTTGA,0,5009737
yjbJ_predicted,0.25,3,3,TGGACATACCGCTTAGTGCG,0,5005987
yjbJ_predicted,0.25,3,3,TGGAAGCAAGTTGGGCAGTT,0,5030811
yjbJ_predicted,0.25,3,3,TGGAAATCGGAGGTTTATAA,0,5021565
yjbJ_predicted,0.25,3,3,TGCTGTACTCATGCCGTCGC,0,5008658
yjbJ_predicted,0.25,3,3,TGCTAGTTTACCAGCGCTTT,0,5021173
yjbJ_predicted,0.25,3,3,TGCTAAGTTGGAATCATTAG,0,5012441
yjbJ_predicted,0.25,3,3,TGCTAACAAACATCTCGTTT,0,5011233
yjbJ_predicted,0.25,3,3,TGCCTTAACTTAGCAAAAAA,0,5013877
yjbJ_predicted,0.25,3,3,TGCCCTGTTCAGGCTATCTG,0,5006092
yjbJ_predicted,0.25,3,3,TGCAGGCTAGGAGAGATGGA,0,5026592
yjbJ_predicted,0.25,3,3,TGCAGCGAGTCACGATGTCA,0,5000371
yjbJ_predicted,0.25,3,3,TGCACGACATTATCCAAGGG,0,4995671
yjbJ_predicted,0.25,3,3,TGCAATGGCCCCTGATGATA,0,5013651
yjbJ_predicted,0.25,3,3,TGCAACGGGATTTCGGCAAA,0,5029339
yjbJ_predicted,0.25,3,3,TGATTTGCCAACGGCACATG,0,5027751
yjbJ_predicted,0.25,3,3,TGATTGTTTACTGGGAAAAG,0,5001260
yjbJ_predicted,0.25,3,3,TGATCACGAAAATCATGCGT,0,5027068
yjbJ_predicted,0.25,3,3,TGAGTATCTATAGCCAAACT,0,5000119
yjbJ_predicted,0.25,3,3,TGAGTAGAAGGCCGACCTGC,0,5015716
yjbJ_predicted,0.25,3,3,TGAGGGGCTTGGTCCGTCCC,0,5011152
yjbJ_predicted,0.25,3,3,TGACTCCTACAAGGGCACGG,0,5012647
yjbJ_predicted,0.25,3,3,TGACTCCGGAGGCACGTCAA,0,5017424
yjbJ_predicted,0.25,3,3,TGACAGGTAATAGTGCATAC,0,5023242
yjbJ_predicted,0.25,3,3,TGACACTTTTCGGTTTGTTT,0,5029207
yjbJ_predicted,0.25,3,3,TGAATTAAATGAGACTAGCT,0,5014628
yjbJ_predicted,0.25,3,3,TGAAGCTGGCTAGAAATTTC,0,5005589
yjbJ_predicted,0.25,3,3,TGAAGCGTGCGGTACCGATT,0,5006135
yjbJ_predicted,0.25,3,3,TGAACCTCTCGTAGTCTGCA,0,5007150
yjbJ_predicted,0.25,3,3,TGAAAAAACAGATTCGAGGA,0,5027284
yjbJ_predicted,0.25,3,3,TCTTAAGAAGCGCTACGAGC,0,5012494
yjbJ_predicted,0.25,3,3,TCTGACACGCTTACACCGCT,0,5003815
yjbJ_predicted,0.25,3,3,TCTCGGGTGAACCGAGTAGT,0,5023407
yjbJ_predicted,0.25,3,3,TCTCCACTGGCCGCCGAACC,0,5022711
yjbJ_predicted,0.25,3,3,TCTCAATGTTCTCTTCTCGA,0,5026333
yjbJ_predicted,0.25,3,3,TCTATCCAGCTCTGACGGTC,0,5017069
yjbJ_predicted,0.25,3,3,TCTAGTCCGTGATCATCCTT,0,5010259
yjbJ_predicted,0.25,3,3,TCTACGGGAAGAATGTCGAT,0,5004197
yjbJ_predicted,0.25,3,3,TCTACGAAGTAGAGTTCGCG,0,5026307
yjbJ_predicted,0.25,3,3,TCTACACTTTGCTCTTGTTA,0,5017959
yjbJ_predicted,0.25,3,3,TCTAATCCCAGAACCTGATG,0,5024074
yjbJ_predicted,0.25,3,3,TCGTTTGAAAGGCACGCAGT,0,4998975
yjbJ_predicted,0.25,3,3,TCGTTTAACAGGGTACGGGG,0,5024708
yjbJ_predicted,0.25,3,3,TCGTTGAGGATCCTCCAAGC,0,4999175
yjbJ_predicted,0.25,3,3,TCGTATTATAGACTCATCTT,0,5024779
yjbJ_predicted,0.25,3,3,TCGTAGGATGGCAAATACAT,0,5008009
yjbJ_predicted,0.25,3,3,TCGGGCCTAGCGTAGATATA,0,5030018
yjbJ_predicted,0.25,3,3,TCGGAATCACATCCTGCGCT,0,5012919
yjbJ_predicted,0.25,3,3,TCGCCTTTGTGTCGCGCTGC,0,5007972
yjbJ_predicted,0.25,3,3,TCGATATAAAATCAGCGGCT,0,5001033
yjbJ_predicted,0.25,3,3,TCGACAGAGAAGGAGTTATA,0,5021351
yjbJ_predicted,0.25,3,3,TCCTCCTTCATCACTTAGCT,0,5017256
yjbJ_predicted,0.25,3,3,TCCTATAGGTGATGCTATTT,0,5021434
yjbJ_predicted,0.25,3,3,TCCGTGACAGAAAGGACTCT,0,4998209
yjbJ_predicted,0.25,3,3,TCCGCAGATCGGTACTTCTA,0,4997866
yjbJ_predicted,0.25,3,3,TCCCTAGCGCGATTATTGGG,0,5021897
yjbJ_predicted,0.25,3,3,TCCCCTATGGTCTGTACTGA,0,5027462
yjbJ_predicted,0.25,3,3,TCATCTCAGAAGCATGGGCA,0,4998707
yjbJ_predicted,0.25,3,3,TCATCCGGCATTAGTGACGA,0,5002178
yjbJ_predicted,0.25,3,3,TCAGGGCCACGACTATAACT,0,4998659
yjbJ_predicted,0.25,3,3,TCAGATTACGACTGTACCGG,0,5022104
yjbJ_predicted,0.25,3,3,TCACTAGCATAGTACTCTAT,0,5003173
yjbJ_predicted,0.25,3,3,TCACCTTCTTTGCTGGACCT,0,5006444
yjbJ_predicted,0.25,3,3,TCACCGTGTTCATATTTCTA,0,5027026
yjbJ_predicted,0.25,3,3,TCACCCTCTGAGCATCAGTG,0,5030117
yjbJ_predicted,0.25,3,3,TCACAGGGTTCAATGAGCGA,0,5025217
yjbJ_predicted,0.25,3,3,TCAAGGTGCCGCCGAACGGG,0,5011439
yjbJ_predicted,0.25,3,3,TCAAATATCTTAGGCTCTAA,0,5008854
yjbJ_predicted,0.25,3,3,TCAAAGGAACGTCGTGCGTA,0,5010616
yjbJ_predicted,0.25,3,3,TATTTGAAGGGTTGATAGTT,0,5021905
yjbJ_predicted,0.25,3,3,TATTTCATTCAAAACAATAT,0,5002583
yjbJ_predicted,0.25,3,3,TATTTACAAACTGCTTGTCA,0,5007222
yjbJ_predicted,0.25,3,3,TATTATCTTGAACAAAAGAT,0,5030319
yjbJ_predicted,0.25,3,3,TATGTTGCTCAATGTCTCTC,0,5015399
yjbJ_predicted,0.25,3,3,TATGTGGAAGGGAGCATCAT,0,5007315
yjbJ_predicted,0.25,3,3,TATGGGTTATTACTAAGTGG,0,5023815
yjbJ_predicted,0.25,3,3,TATGGGGAGTGGTGTTGATA,0,5022743
yjbJ_predicted,0.25,3,3,TATGGGACTTTCGCTCCCTT,0,5002723
yjbJ_predicted,0.25,3,3,TATGGCAGTCGATACTTCAT,0,5027459
yjbJ_predicted,0.25,3,3,TATGGATCTAAACATATTCA,0,4995202
yjbJ_predicted,0.25,3,3,TATGCGCTGATGTGGTACCA,0,5014159
yjbJ_predicted,0.25,3,3,TATGCCACGGTCCGCCTTCA,0,5004602
yjbJ_predicted,0.25,3,3,TATGATCGTTCGCGGTCACA,0,5009715
yjbJ_predicted,0.25,3,3,TATCTCGAGGTTTAGCGTGT,0,5025965
yjbJ_predicted,0.25,3,3,TATCGTGAAGTAGCTCTGCT,0,5020117
yjbJ_predicted,0.25,3,3,TATCGACGTACTGCCTGATC,0,5027851
yjbJ_predicted,0.25,3,3,TATCGAAACAAGACCTAAGG,0,5026859
yjbJ_predicted,0.25,3,3,TATCCTCACTGATGGCCAAG,0,5009016
yjbJ_predicted,0.25,3,3,TATCCGCTCGGACGGTCGTG,0,5001895
yjbJ_predicted,0.25,3,3,TATCCCATTTGTTCGCGCCG,0,5028192
yjbJ_predicted,0.25,3,3,TATCACACTTGTAGAGGAAA,0,5005680
yjbJ_predicted,0.25,3,3,TATCAAACGGCTCTATCATT,0,5019169
yjbJ_predicted,0.25,3,3,TATATGGGAAGTTCTAATTA,0,5003939
yjbJ_predicted,0.25,3,3,TATAGAGTTATCTTTGTGGG,0,5028335
yjbJ_predicted,0.25,3,3,TAGGTCTTAGGGATGACTAA,0,5004252
yjbJ_predicted,0.25,3,3,TAGGGGCTCTTACCCACGCG,0,5028544
yjbJ_predicted,0.25,3,3,TAGGGCCAAGGTCGGGGATG,0,5012846
yjbJ_predicted,0.25,3,3,TAGGCCTCCATCATCAGTAA,0,5006265
yjbJ_predicted,0.25,3,3,TAGGCACGTCACAGCCCACT,0,5001343
yjbJ_predicted,0.25,3,3,TAGGCACAAAGAACTTTGGG,0,4999058
yjbJ_predicted,0.25,3,3,TAGGACAACGTATGAACCAT,0,5022384
yjbJ_predicted,0.25,3,3,TAGCAGTAGTGCTAGGGCTC,0,5018092
yjbJ_predicted,0.25,3,3,TAGCAGCCATACCTTCAATC,0,5001265
yjbJ_predicted,0.25,3,3,TAGAGCGATCTCCTGGTGGT,0,4996261
yjbJ_predicted,0.25,3,3,TAGAGCAGGGATGAGGAGTT,0,5008508
yjbJ_predicted,0.25,3,3,TAGAGAGACCGCCATACTTT,0,5007758
yjbJ_predicted,0.25,3,3,TACTTAATTCGCTAGTCATC,0,5006991
yjbJ_predicted,0.25,3,3,TACTAAAGGCTAATTGTCAA,0,4997640
yjbJ_predicted,0.25,3,3,TACGTCCGTGCAGGGCATCA,0,5009171
yjbJ_predicted,0.25,3,3,TACGGATACCGGTCTGCTTC,0,5013224
yjbJ_predicted,0.25,3,3,TACGACCTCAGTCTCGTTAG,0,4998685
yjbJ_predicted,0.25,3,3,TACCATTGGAACCGTCCACA,0,4998118
yjbJ_predicted,0.25,3,3,TACCATCTAAACATTAAATA,0,5013333
yjbJ_predicted,0.25,3,3,TACCACTTCGGCAGTGGCCA,0,5003376
yjbJ_predicted,0.25,3,3,TACATCGGGAGATCATAGCG,0,5022614
yjbJ_predicted,0.25,3,3,TACATCATTGTGCATTGCGT,0,5009069
yjbJ_predicted,0.25,3,3,TACACTGCTTGTTGACTGGT,0,5030581
yjbJ_predicted,0.25,3,3,TACACAGCTTTGAAAAATCA,0,4996505
yjbJ_predicted,0.25,3,3,TACAACCAGTATTATAAAAC,0,5021800
yjbJ_predicted,0.25,3,3,TAATTCGTCTGTATTTCTCT,0,4996045
yjbJ_predicted,0.25,3,3,TAATTCGGAACAGAGAAGTC,0,5015376
yjbJ_predicted,0.25,3,3,TAATGTAGTGACCAATCGTC,0,5018293
yjbJ_predicted,0.25,3,3,TAATAGAAGGGGGAAGGAGC,0,5000131
yjbJ_predicted,0.25,3,3,TAAGGCTCTTGTGCACATTT,0,5012797
yjbJ_predicted,0.25,3,3,TAAGCCGGGCGGTAATACTA,0,4998000
yjbJ_predicted,0.25,3,3,TAAGCCGCGTTTCGCCATGG,0,5007829
yjbJ_predicted,0.25,3,3,TAAGATTGTCTACGGAACTA,0,4998828
yjbJ_predicted,0.25,3,3,TAAGATCTCTTCAGGGAATA,0,5027036
yjbJ_predicted,0.25,3,3,TAACATCCTGGTTTGAATGT,0,5004243
yjbJ_predicted,0.25,3,3,TAAAGCTGGCGGGCGCCCTC,0,5016401
yjbJ_predicted,0.25,3,3,TAAAGCTATTGGTTACTGGG,0,4998766
yjbJ_predicted,0.25,3,3,GTTTTGCTTATTTCTCTGTA,0,5019940
yjbJ_predicted,0.25,3,3,GTTTGTCCACAATCATCAAT,0,5009450
yjbJ_predicted,0.25,3,3,GTTGTCACTGGTGTATCCGT,0,5000079
yjbJ_predicted,0.25,3,3,GTTCCAGGTAAACGCGTCCC,0,5013894
yjbJ_predicted,0.25,3,3,GTTAGGCTTACTTACATCGT,0,5014131
yjbJ_predicted,0.25,3,3,GTTAGACCCCGTGATAAGTG,0,5012515
yjbJ_predicted,0.25,3,3,GTTACTGTTACGTTGAGCGC,0,5020442
yjbJ_predicted,0.25,3,3,GTGTTTTACCGCCAGAGCCG,0,5003634
yjbJ_predicted,0.25,3,3,GTGTTGGTAACAAGTCTAAG,0,5028971
yjbJ_predicted,0.25,3,3,GTGTTGCGGTTAAGCGGTGG,0,5015632
yjbJ_predicted,0.25,3,3,GTGTCATCGTCGTTGCGCCA,0,5004331
yjbJ_predicted,0.25,3,3,GTGGTAGTAGTCTGTGTTTT,0,5012193
yjbJ_predicted,0.25,3,3,GTGGATGCTGGTTGATATGA,0,5027914
yjbJ_predicted,0.25,3,3,GTGCTTAACGCGGAGGAACT,0,5030094
yjbJ_predicted,0.25,3,3,GTGCTGGTACGTTGGGTTAA,0,5012092
yjbJ_predicted,0.25,3,3,GTGCTCCGCGTGTGGCCATT,0,5009109
yjbJ_predicted,0.25,3,3,GTGCGTAACCTCACATTCTG,0,5029675
yjbJ_predicted,0.25,3,3,GTGCGAGGGCTGAACAATTA,0,5019135
yjbJ_predicted,0.25,3,3,GTGACCCTTGGATTGCGATT,0,5000538
yjbJ_predicted,0.25,3,3,GTGAAACATTCAGAACGCCT,0,5030899
yjbJ_predicted,0.25,3,3,GTCTTATTCGTAACGGTGCT,0,5004496
yjbJ_predicted,0.25,3,3,GTCTCTGAAAGAGGATCAGG,0,4999320
yjbJ_predicted,0.25,3,3,GTCTCCGGTAACGGATTTGA,0,5010185
yjbJ_predicted,0.25,3,3,GTCGTTCGGCACCGTACAAG,0,5024969
yjbJ_predicted,0.25,3,3,GTCGTACTACAGTACTAGCA,0,5025419
yjbJ_predicted,0.25,3,3,GTCGTAAAGGTGACATGTTG,0,5016850
yjbJ_predicted,0.25,3,3,GTCGGAACACTGCCGTGGTC,0,5005337
yjbJ_predicted,0.25,3,3,GTCGATTTGTCTGTACGAAT,0,5026316
yjbJ_predicted,0.25,3,3,GTCCTTTGAGAACAGAACGT,0,5004997
yjbJ_predicted,0.25,3,3,GTCCTATGGCGCAGGGCTTA,0,5029847
yjbJ_predicted,0.25,3,3,GTCCGTTGCAAAAACACTTA,0,5016390
yjbJ_predicted,0.25,3,3,GTCCGTCTCCTCGCTCCCAC,0,5008524
yjbJ_predicted,0.25,3,3,GTCCCAGTATCACTTACAGT,0,5021899
yjbJ_predicted,0.25,3,3,GTCAAGCACCTGACGCTGGA,0,5030087
yjbJ_predicted,0.25,3,3,GTCAAATGCAAAACCGTCCA,0,5020564
yjbJ_predicted,0.25,3,3,GTCAAAAACTTAGGGAAAAG,0,5003659
yjbJ_predicted,0.25,3,3,GTATTTGGAGGCGACCACTC,0,5021846
yjbJ_predicted,0.25,3,3,GTATGTATGTAATTCGCTGT,0,5016885
yjbJ_predicted,0.25,3,3,GTATGCCTGTCAAACACTTC,0,5016697
yjbJ_predicted,0.25,3,3,GTATCGAGGCGCATACCACC,0,5017650
yjbJ_predicted,0.25,3,3,GTATAGCGCCCAGGGAATTG,0,5029043
yjbJ_predicted,0.25,3,3,GTATAAGCCACCTTCTTGAC,0,5002566
yjbJ_predicted,0.25,3,3,GTATAAGAGGTTCGACATCA,0,5015776
yjbJ_predicted,0.25,3,3,GTAGATTTTGACTGTTTAGA,0,5001777
yjbJ_predicted,0.25,3,3,GTAGAATATGGACTAAGCTA,0,4999227
yjbJ_predicted,0.25,3,3,GTACTGCGTGGTCATCTTTC,0,5002768
yjbJ_predicted,0.25,3,3,GTACGGCTAGTAAACTTCTG,0,5007247
yjbJ_predicted,0.25,3,3,GTACGCTCGATACCGGACAC,0,5017460
yjbJ_predicted,0.25,3,3,GTACATCGACTTATAAAACG,0,5027793
yjbJ_predicted,0.25,3,3,GTACATAGCGTAGGATGAAT,0,5020213
yjbJ_predicted,0.25,3,3,GTACAGCTCAGCGGGGCGGG,0,5022186
yjbJ_predicted,0.25,3,3,GTACAAGCCTCAGCTTAGTT,0,5020969
yjbJ_predicted,0.25,3,3,GTAACTACGTACAGCTCCGT,0,4999115
yjbJ_predicted,0.25,3,3,GTAAAGTTGTTAAATGCTGT,0,5005333
yjbJ_predicted,0.25,3,3,GTAAAGAGAGCGCATCTCTA,0,5009835
yjbJ_predicted,0.25,3,3,GTAAAAAGCCGGTCCGGACG,0,5024142
yjbJ_predicted,0.25,3,3,GGTTGTGCTGTTTAAAACAA,0,5016703
yjbJ_predicted,0.25,3,3,GGTTGTAACATACATCCCGT,0,5005308
yjbJ_predicted,0.25,3,3,GGTTGGGACCGCCTTTGAAT,0,5030270
yjbJ_predicted,0.25,3,3,GGTTCTGTGTCGGAACCGTA,0,5026508
yjbJ_predicted,0.25,3,3,GGTTCGCGACGACAACTACA,0,5022204
yjbJ_predicted,0.25,3,3,GGTTCCCGGAATCGTGTTCC,0,5018201
yjbJ_predicted,0.25,3,3,GGTTCCACCAGAGAGGTTCT,0,5007430
yjbJ_predicted,0.25,3,3,GGTGTGTAGGTTAATCGTAT,0,5004945
yjbJ_predicted,0.25,3,3,GGTCGATTGGACATCAAGAC,0,5004548
yjbJ_predicted,0.25,3,3,GGTCAAATCGGTTCTATTGA,0,5008936
yjbJ_predicted,0.25,3,3,GGTACCTTCCGAACCTGAGG,0,5013555
yjbJ_predicted,0.25,3,3,GGTACCCGCCCATGCATCAC,0,5003706
yjbJ_predicted,0.25,3,3,GGTAACGCCGCATTGGGTAT,0,5004265
yjbJ_predicted,0.25,3,3,GGGTTTCGAGTGGGGACCAG,0,5023368
yjbJ_predicted,0.25,3,3,GGGTTCTGGTTGCGGCTCCA,0,5018478
yjbJ_predicted,0.25,3,3,GGGTTAATCATGACGTCTGT,0,5000200
yjbJ_predicted,0.25,3,3,GGGTATCGACGTGCCTCAAC,0,5009173
yjbJ_predicted,0.25,3,3,GGGTAGTGGCCTCCCGGGCA,0,5022564
yjbJ_predicted,0.25,3,3,GGGGTGGTAACTCATTATGG,0,5007516
yjbJ_predicted,0.25,3,3,GGGGATACTCCACACGCACT,0,5019671
yjbJ_predicted,0.25,3,3,GGGGAGCGATTACGGATATT,0,5000943
yjbJ_predicted,0.25,3,3,GGGCTACTATGTAACGGTGC,0,5026784
yjbJ_predicted,0.25,3,3,GGGCGCGCAAATGCCAGCCC,0,5028859
yjbJ_predicted,0.25,3,3,GGGCATAGCTGTCACTGATA,0,5028118
yjbJ_predicted,0.25,3,3,GGGCACCAACCTCCCGGGAC,0,5018028
yjbJ_predicted,0.25,3,3,GGGATTCCGTGAAGTCCAGT,0,5027694
yjbJ_predicted,0.25,3,3,GGGATTCCCGCAAATTGAGA,0,5025808
yjbJ_predicted,0.25,3,3,GGGATGGATTCGTAGCAATT,0,4998520
yjbJ_predicted,0.25,3,3,GGGATGGAAATCCCACCGAG,0,5006450
yjbJ_predicted,0.25,3,3,GGGAGTCGTGTGCAGATCTA,0,5003661
yjbJ_predicted,0.25,3,3,GGGAGAAAAGTGGACGGTTC,0,5029255
yjbJ_predicted,0.25,3,3,GGGACCGACTCGGCCATCGA,0,5021979
yjbJ_predicted,0.25,3,3,GGGACATCGGGGGATCTGAC,0,4996042
yjbJ_predicted,0.25,3,3,GGGAAAGTCTCGGAATAGGA,0,5015928
yjbJ_predicted,0.25,3,3,GGCTTTAAGCGCTTCAAGAT,0,5014805
yjbJ_predicted,0.25,3,3,GGCTCCGTGCCTTTGGGGGA,0,5025440
yjbJ_predicted,0.25,3,3,GGCTCCCGGTTGGTGACCTT,0,5021010
yjbJ_predicted,0.25,3,3,GGCTAAGCTTTATGGCATGA,0,5021133
yjbJ_predicted,0.25,3,3,GGCGTGCTTAGATGTCGCGT,0,5009958
yjbJ_predicted,0.25,3,3,GGCGGCCGATCCCCGTTCAA,0,5004166
yjbJ_predicted,0.25,3,3,GGCGCGTCTCTCTTTAGTTT,0,5021159
yjbJ_predicted,0.25,3,3,GGCGCCCAGGAAAAACCCGA,0,5017129
yjbJ_predicted,0.25,3,3,GGCCTCTTCTCTTCCGCCAG,0,5010130
yjbJ_predicted,0.25,3,3,GGCCGATTTACGTCGAGGGG,0,5004789
yjbJ_predicted,0.25,3,3,GGCCCGCTTCGAGTGTTGTT,0,4999891
yjbJ_predicted,0.25,3,3,GGCCAGGCATGAGTGCGTAA,0,5017817
yjbJ_predicted,0.25,3,3,GGCATTGGGTGCGAGTACAC,0,5027803
yjbJ_predicted,0.25,3,3,GGCATGCGAAGGCCAACGCA,0,5018727
yjbJ_predicted,0.25,3,3,GGCATAGTCTCGATGCCCTC,0,5028835
yjbJ_predicted,0.25,3,3,GGCAGTCATGGATCTTCTAC,0,5022570
yjbJ_predicted,0.25,3,3,GGATTAGCCGTGGAGATCCA,0,5012467
yjbJ_predicted,0.25,3,3,GGATGTGGCGGATACCCGTT,0,5016138
yjbJ_predicted,0.25,3,3,GGATGGCTCATAAGTCGCAC,0,5015615
yjbJ_predicted,0.25,3,3,GGATCTTGGGAGGGCGTTGA,0,5008507
yjbJ_predicted,0.25,3,3,GGATCGTTAGTACGACATCC,0,4996249
yjbJ_predicted,0.25,3,3,GGAGTTTAATAGTCAGCTTG,0,5011474
yjbJ_predicted,0.25,3,3,GGAGTCTGCTCATACCGATC,0,5018682
yjbJ_predicted,0.25,3,3,GGAGGTGGAGGACATCACTT,0,5003216
yjbJ_predicted,0.25,3,3,GGAGCCCACATCGGGGACAA,0,4998447
yjbJ_predicted,0.25,3,3,GGAGCACAATCACCCTACAA,0,5002868
yjbJ_predicted,0.25,3,3,GGACTCGATTTGCCCGGCAT,0,5022734
yjbJ_predicted,0.25,3,3,GGACCGCGCCTGTACTCTCT,0,5009929
yjbJ_predicted,0.25,3,3,GGACCCGTAAGCAGAGTGAA,0,5017356
yjbJ_predicted,0.25,3,3,GGACCCAATCCGCCTGTGTC,0,5015298
yjbJ_predicted,0.25,3,3,GGAATTTGGTTTCTCACCTC,0,5016326
yjbJ_predicted,0.25,3,3,GGAATCAAACGCATTGATTG,0,4995432
yjbJ_predicted,0.25,3,3,GGAAGTATTATGTGGCCTTG,0,5027387
yjbJ_predicted,0.25,3,3,GGAAGCGGACAGAACCTCTT,0,5011709
yjbJ_predicted,0.25,3,3,GGAACTGTTACCAAGGCCTG,0,5013505
yjbJ_predicted,0.25,3,3,GGAACTGCGCTGAGGTCTAC,0,5024985
yjbJ_predicted,0.25,3,3,GGAAACCGCGTTGTTCAGCT,0,5014125
yjbJ_predicted,0.25,3,3,GCTTGTCATACATCTTATAG,0,5013265
yjbJ_predicted,0.25,3,3,GCTTATCTTACCCTTCCTTG,0,5003342
yjbJ_predicted,0.25,3,3,GCTCGGTGCAAATAGTGGTA,0,5001032
yjbJ_predicted,0.25,3,3,GCTCAGGTCTTATGGGGCAC,0,5031043
yjbJ_predicted,0.25,3,3,GCTAGTGCAAATCATGTTAT,0,4999112
yjbJ_predicted,0.25,3,3,GCTAGTCTGTTAAATGTCTT,0,5010653
yjbJ_predicted,0.25,3,3,GCTAGACTATCCATATAACA,0,5004742
yjbJ_predicted,0.25,3,3,GCTACCCTGTTACTTCGGAA,0,5015164
yjbJ_predicted,0.25,3,3,GCTAAGCTATTCCTAGCTGA,0,5025372
yjbJ_predicted,0.25,3,3,GCGTTGAGAAAGGCACTGTG,0,5021735
yjbJ_predicted,0.25,3,3,GCGTGGCGCCTTACGTGCTT,0,5027714
yjbJ_predicted,0.25,3,3,GCGTGCCGCCCCGCATGTTT,0,5027234
yjbJ_predicted,0.25,3,3,GCGTCTGGGTAGAAAACTTA,0,5003928
yjbJ_predicted,0.25,3,3,GCGTCTCCATAACAGCACAG,0,5029558
yjbJ_predicted,0.25,3,3,GCGTCCATGGGCTACGGCAG,0,5017835
yjbJ_predicted,0.25,3,3,GCGGTCTAAACGGCCAGATA,0,5022677
yjbJ_predicted,0.25,3,3,GCGGGATCTTCGCAGGTGAA,0,5025765
yjbJ_predicted,0.25,3,3,GCGGGAATAGGGGAGCACAT,0,5014567
yjbJ_predicted,0.25,3,3,GCGGATTCATTATGCTGCCT,0,5029336
yjbJ_predicted,0.25,3,3,GCGGAGCACGGAGGCCAACA,0,5002051
yjbJ_predicted,0.25,3,3,GCGCTCCGGATGAGATATCA,0,5001196
yjbJ_predicted,0.25,3,3,GCGCGATTGCGTGAATAACT,0,5025694
yjbJ_predicted,0.25,3,3,GCGATGGAGCACATGCATTA,0,4999843
yjbJ_predicted,0.25,3,3,GCGATCGGACGTGTTTCGTG,0,5012706
yjbJ_predicted,0.25,3,3,GCGATAGAAATTAAGTGTTT,0,5029269
yjbJ_predicted,0.25,3,3,GCGAGCCTGACTGGCTAATG,0,4998365
yjbJ_predicted,0.25,3,3,GCGAGCCAGAGACATTGCCC,0,5008406
yjbJ_predicted,0.25,3,3,GCGACGTTGGACGGTACACG,0,5009074
yjbJ_predicted,0.25,3,3,GCGAAGCGCAGCAGCGCTAA,0,4996902
yjbJ_predicted,0.25,3,3,GCGAAACTCTGTGTGCAAGC,0,5004828
yjbJ_predicted,0.25,3,3,GCCTGATCAGTTAGTGCTGC,0,5024164
yjbJ_predicted,0.25,3,3,GCCTGAGCTCAGAACGCTAC,0,5017647
yjbJ_predicted,0.25,3,3,GCCGTGTCGGATTATAGATT,0,5014572
yjbJ_predicted,0.25,3,3,GCCGTCACGTTGAGTCTGTT,0,4995000
yjbJ_predicted,0.25,3,3,GCCGGACAATTTGCGTCCAT,0,5019946
yjbJ_predicted,0.25,3,3,GCCGATGGGGCCATTCTCTG,0,5016883
yjbJ_predicted,0.25,3,3,GCCCTGATCTGAGATACAAT,0,5010951
yjbJ_predicted,0.25,3,3,GCCCCTGGAACGCCAGAGGT,0,5002643
yjbJ_predicted,0.25,3,3,GCCCCTGCCCCCCCCTGAGA,0,4996178
yjbJ_predicted,0.25,3,3,GCCCCAAGATTCCGTAGGAT,0,5008870
yjbJ_predicted,0.25,3,3,GCCCAAGAGCAAATCAATTA,0,5022318
yjbJ_predicted,0.25,3,3,GCCATCCGACACTTGATTCT,0,4995487
yjbJ_predicted,0.25,3,3,GCCATAAATCCAAAACCGAA,0,5009294
yjbJ_predicted,0.25,3,3,GCCACCATTGCGTCATCCTG,0,5030800
yjbJ_predicted,0.25,3,3,GCATGGGCCATCGGTTCGAT,0,5028944
yjbJ_predicted,0.25,3,3,GCATAGCGCGATTTACGCCG,0,4996133
yjbJ_predicted,0.25,3,3,GCAGTTTCCAGTTCCCGCGT,0,4999215
yjbJ_predicted,0.25,3,3,GCAGTTCGGACTACACTTTT,0,5011689
yjbJ_predicted,0.25,3,3,GCAGTCCGCATACCGGATTA,0,5001571
yjbJ_predicted,0.25,3,3,GCAGGCATCGTATTCTGTAT,0,5015016
yjbJ_predicted,0.25,3,3,GCAGACATCTTCTTCAGTCT,0,5017591
yjbJ_predicted,0.25,3,3,GCAATACCTGGATGGGACTC,0,5009070
yjbJ_predicted,0.25,3,3,GCAACGGAGAGCTTCGACAT,0,5004203
yjbJ_predicted,0.25,3,3,GCAACGACCGCATGTTCGAA,0,5012875
yjbJ_predicted,0.25,3,3,GCAACAAACGTCGTGTGCTC,0,5006293
yjbJ_predicted,0.25,3,3,GCAAACTTGGTGGACCACTG,0,4997253
yjbJ_predicted,0.25,3,3,GATTAGGCGTATCTCAACAG,0,5008266
yjbJ_predicted,0.25,3,3,GATGTACCACTGCTCCACTA,0,5014491
yjbJ_predicted,0.25,3,3,GATGGCCAACGCGGGACCAT,0,5012987
yjbJ_predicted,0.25,3,3,GATGAGTAACTATGTCTGGG,0,5022371
yjbJ_predicted,0.25,3,3,GATCGTCTACTTGTTCATGT,0,5022585
yjbJ_predicted,0.25,3,3,GATCGCGGTGCAATACTGAA,0,5027644
yjbJ_predicted,0.25,3,3,GATCGAGGGTTATAAGGGTA,0,5018823
yjbJ_predicted,0.25,3,3,GATCCTACCTAAGCGTTCCT,0,5020811
yjbJ_predicted,0.25,3,3,GATCCAATGATCCGGTAAGT,0,5030622
yjbJ_predicted,0.25,3,3,GATATGCTACACCTGAATCA,0,5018581
yjbJ_predicted,0.25,3,3,GATAAGATCGATCCACATGC,0,5006866
yjbJ_predicted,0.25,3,3,GATAAATGAGGGGCTCGAAT,0,5017794
yjbJ_predicted,0.25,3,3,GATAAACAGGCACTTTCAAC,0,5014683
yjbJ_predicted,0.25,3,3,GATAAAAATTTTGTTCGCCA,0,5015984
yjbJ_predicted,0.25,3,3,GAGTGGTAGTTCGACAACGT,0,5008958
yjbJ_predicted,0.25,3,3,GAGTATGAACGCAAGCGGAT,0,5014028
yjbJ_predicted,0.25,3,3,GAGGTCTTTCCCCAGTGCGC,0,4999370
yjbJ_predicted,0.25,3,3,GAGGTCCGGCCATGCTGAAC,0,5024076
yjbJ_predicted,0.25,3,3,GAGGGTATTACGTTTGGGAC,0,5022516
yjbJ_predicted,0.25,3,3,GAGGAATACTCGTCGCGGAT,0,5004204
yjbJ_predicted,0.25,3,3,GAGGAAGGCTAGAACACGCT,0,5022925
yjbJ_predicted,0.25,3,3,GAGCTGGCACTCCGCTGGCC,0,5000961
yjbJ_predicted,0.25,3,3,GAGCTACCGCGTGTTGCAAC,0,5022908
yjbJ_predicted,0.25,3,3,GAGCGCGAGTTCTAGCCTTT,0,5002231
yjbJ_predicted,0.25,3,3,GAGCCGGGGAGCAGGCGACG,0,4997865
yjbJ_predicted,0.25,3,3,GAGCATGGACGATGGTGATA,0,4996022
yjbJ_predicted,0.25,3,3,GAGATGCGAGCCAGAAAATT,0,5012123
yjbJ_predicted,0.25,3,3,GAGATCACAGCACCTGGCTT,0,5005774
yjbJ_predicted,0.25,3,3,GAGATAGGTAACGTAACGCA,0,5019192
yjbJ_predicted,0.25,3,3,GAGAGCGTCTCCCCCTCCCC,0,5029485
yjbJ_predicted,0.25,3,3,GAGAGCCGTATAGATGGCTT,0,5028980
yjbJ_predicted,0.25,3,3,GAGAGCACACATGTACTTCT,0,5005677
yjbJ_predicted,0.25,3,3,GAGAAACAATACGGCCAATG,0,5006254
yjbJ_predicted,0.25,3,3,GAGAAAATACGCGCCATCCA,0,5009437
yjbJ_predicted,0.25,3,3,GACTGGGTATGTTGTTTTTG,0,5019949
yjbJ_predicted,0.25,3,3,GACTAGAGCTACTAACTGCT,0,5016222
yjbJ_predicted,0.25,3,3,GACGTTGCCCTAAGGGTCGT,0,5020596
yjbJ_predicted,0.25,3,3,GACGTCGCACGCCACGGCGC,0,5006359
yjbJ_predicted,0.25,3,3,GACGTCATACCCCTGCTAGA,0,5014625
yjbJ_predicted,0.25,3,3,GACCCGTGTCCGTTTCTGTG,0,5004728
yjbJ_predicted,0.25,3,3,GACCAATTACGTGTTGAGTC,0,5020378
yjbJ_predicted,0.25,3,3,GACACGCGTTGTTTCCGTTT,0,5022130
yjbJ_predicted,0.25,3,3,GACACAGGTAGGTAGCTAGC,0,5012933
yjbJ_predicted,0.25,3,3,GACAAGCGGAAGCATCGGTT,0,5027058
yjbJ_predicted,0.25,3,3,GACAAGAGTACGTTCCACGG,0,4999213
yjbJ_predicted,0.25,3,3,GAATCGGTCCAAATAAACGA,0,4999558
yjbJ_predicted,0.25,3,3,GAATAAGTCCTTACCTTAGT,0,5003157
yjbJ_predicted,0.25,3,3,GAAGGCAGCCGCGACATGAC,0,5002467
yjbJ_predicted,0.25,3,3,GAACGGGTTTTGGGGAGTTC,0,5003959
yjbJ_predicted,0.25,3,3,GAACGCGTTCAGGCGTCACG,0,5003243
yjbJ_predicted,0.25,3,3,GAACGACTTCCGCCCACGCG,0,4998851
yjbJ_predicted,0.25,3,3,GAACGACGCTCTATGTACGA,0,4995335
yjbJ_predicted,0.25,3,3,GAACAGCCACGAGAGGCCCG,0,5020715
yjbJ_predicted,0.25,3,3,GAACACTTCGCGACCTCTTT,0,5010217
yjbJ_predicted,0.25,3,3,GAACACACTTGCTGTGGTAC,0,5022322
yjbJ_predicted,0.25,3,3,GAAATAACGGGCGGAAATTC,0,5024052
yjbJ_predicted,0.25,3,3,GAAAGGCGCACGTTAACGGC,0,5006929
yjbJ_predicted,0.25,3,3,GAAAGCTCTACAAGGTATTT,0,5004606
yjbJ_predicted,0.25,3,3,GAAACAGCGTGTTTGCGAGA,0,5019035
yjbJ_predicted,0.25,3,3,CTTTGTACGGCACCCCGATT,0,5027705
yjbJ_predicted,0.25,3,3,CTTTGCTTTCGGGCCTTCAA,0,5030830
yjbJ_predicted,0.25,3,3,CTTTAGTGCGCAGGGAGCAA,0,5023540
yjbJ_predicted,0.25,3,3,CTTGTCAAACAAGCTCGCAT,0,5026013
yjbJ_predicted,0.25,3,3,CTTGGGTGCACTCTCACTTC,0,5006739
yjbJ_predicted,0.25,3,3,CTTGGGAGTAAGAGTAGGGT,0,5015206
yjbJ_predicted,0.25,3,3,CTTGGCGGCGGGGTCAGTAT,0,5009730
yjbJ_predicted,0.25,3,3,CTTGACGCCTCCAAACTTAT,0,5005139
yjbJ_predicted,0.25,3,3,CTTCTTCACCTGAACGCGTA,0,5029988
yjbJ_predicted,0.25,3,3,CTTCTCCCTCCAAGTGACCT,0,5007974
yjbJ_predicted,0.25,3,3,CTTCTACTAATGTAGAATAC,0,4995542
yjbJ_predicted,0.25,3,3,CTTCGGGTACTCACGTCTTT,0,5023637
yjbJ_predicted,0.25,3,3,CTTCCATGCAAAATTTTATA,0,5024374
yjbJ_predicted,0.25,3,3,CTTCAAAGCAGATTGGTGCC,0,5029783
yjbJ_predicted,0.25,3,3,CTTATTGCATTACAAGCCCC,0,5019874
yjbJ_predicted,0.25,3,3,CTTATCCCCTGACCTACCTC,0,5018036
yjbJ_predicted,0.25,3,3,CTTAGACTCACCTGCCCAAA,0,5016923
yjbJ_predicted,0.25,3,3,CTTACGTTAAGTATGCGGTG,0,5000514
yjbJ_predicted,0.25,3,3,CTTACCTAAACTGTAGGGCG,0,5007434
yjbJ_predicted,0.25,3,3,CTGTGCTGCAAACGTAAGAC,0,5027492
yjbJ_predicted,0.25,3,3,CTGTATCGACACCGTATAGT,0,5021843
yjbJ_predicted,0.25,3,3,CTGGTGCGGTTTGCGGGCAT,0,5004519
yjbJ_predicted,0.25,3,3,CTGGTGATTGTGAAGCGGCC,0,5012616
yjbJ_predicted,0.25,3,3,CTGGACTGCATAGCAACTCC,0,5014947
yjbJ_predicted,0.25,3,3,CTGCATTCCACTCGGCAAAA,0,5014863
yjbJ_predicted,0.25,3,3,CTGCACGGAGACACAAAGGA,0,5024469
yjbJ_predicted,0.25,3,3,CTGATCTCGCGACCAAGGTG,0,5030261
yjbJ_predicted,0.25,3,3,CTGACGACATCGTCAATCCT,0,5029305
yjbJ_predicted,0.25,3,3,CTCTTGTTGTGCCGGTAGAG,0,5002572
yjbJ_predicted,0.25,3,3,CTCTGTAATTTCCGGACACC,0,4996214
yjbJ_predicted,0.25,3,3,CTCTACATTTTAAAATAGCA,0,5015019
yjbJ_predicted,0.25,3,3,CTCTACAGTTCTGTATGATA,0,5004703
yjbJ_predicted,0.25,3,3,CTCGGAAGGTTGCGTAACAA,0,5030882
yjbJ_predicted,0.25,3,3,CTCGATTCCGGGCCAGATCT,0,5007609
yjbJ_predicted,0.25,3,3,CTCGAGCTGAATTCTCTGTG,0,5023654
yjbJ_predicted,0.25,3,3,CTCGAACTGTCGGTGAAGTC,0,5014486
yjbJ_predicted,0.25,3,3,CTCCGGTCAGATTACGTCCT,0,5001452
yjbJ_predicted,0.25,3,3,CTCCGATTCTGCTTTCTTAG,0,5004763
yjbJ_predicted,0.25,3,3,CTCCCGGTGTTAAGGGCGAG,0,5028601
yjbJ_predicted,0.25,3,3,CTCCATCTGACGTACACTAG,0,5002679
yjbJ_predicted,0.25,3,3,CTCCAGGTCAATCTAGGAAT,0,5022070
yjbJ_predicted,0.25,3,3,CTCACAGGTGGTGCGGTCTG,0,5011872
yjbJ_predicted,0.25,3,3,CTATTTACATGTGGGTCGAA,0,5027146
yjbJ_predicted,0.25,3,3,CTATCAATATAGAGACCCGA,0,5009015
yjbJ_predicted,0.25,3,3,CTATATTCTGGCAATCGGAG,0,5031051
yjbJ_predicted,0.25,3,3,CTAGTTGGCCAACCGGTAAG,0,5021768
yjbJ_predicted,0.25,3,3,CTAGTGGCAGTGCCCACAGT,0,4995773
yjbJ_predicted,0.25,3,3,CTAGGTGGTCTGTTCTTTAG,0,5024701
yjbJ_predicted,0.25,3,3,CTAGGTAAAAGCCGAAATTT,0,5019060
yjbJ_predicted,0.25,3,3,CTAGACTTCACACCCCCCTA,0,5010039
yjbJ_predicted,0.25,3,3,CTACGTTAACTCGCCCCAAT,0,5011514
yjbJ_predicted,0.25,3,3,CTACGAGTGAACGCCACGGT,0,5027102
yjbJ_predicted,0.25,3,3,CTACAGGAGCGGGCATGCGT,0,5025872
yjbJ_predicted,0.25,3,3,CTACACTTTTTTGACTAGCA,0,5003766
yjbJ_predicted,0.25,3,3,CTAACGTCTTCCACCCCGGA,0,5006072
yjbJ_predicted,0.25,3,3,CGTTTTCGGTGCAGGGTTTA,0,4997845
yjbJ_predicted,0.25,3,3,CGTTTCTGCGGGATACGCAA,0,4998687
yjbJ_predicted,0.25,3,3,CGTTGGCGTCAGAGCATTGG,0,4999926
yjbJ_predicted,0.25,3,3,CGTTCGATGGAGGGATACGT,0,5023569
yjbJ_predicted,0.25,3,3,CGTGTGTAGAAGGACCTGTG,0,5018343
yjbJ_predicted,0.25,3,3,CGTGTAGCGGGGGTATAGAC,0,5000507
yjbJ_predicted,0.25,3,3,CGTGCCTGTCGGTCCGTCCT,0,5031302
yjbJ_predicted,0.25,3,3,CGTGATATTAGGCAGCGCTG,0,5025549
yjbJ_predicted,0.25,3,3,CGTGAGCGCAAAGTAGTCAG,0,5016616
yjbJ_predicted,0.25,3,3,CGTCTAAAAACGATGTAGAG,0,5009465
yjbJ_predicted,0.25,3,3,CGTCGAGGCCAACATGCGTC,0,5000054
yjbJ_predicted,0.25,3,3,CGTCGAACACGATCACGTAA,0,5016595
yjbJ_predicted,0.25,3,3,CGTCCTGCTAACGCTGGGGA,0,5006252
yjbJ_predicted,0.25,3,3,CGTCAGCGGCGTTCCTCGGC,0,5026670
yjbJ_predicted,0.25,3,3,CGTCAATATATGGCCTCCGG,0,5023123
yjbJ_predicted,0.25,3,3,CGTCAAGACAACAGCTGGTG,0,4998914
yjbJ_predicted,0.25,3,3,CGTATTCACTGAGTGAAACC,0,5003870
yjbJ_predicted,0.25,3,3,CGTATACACGGCGATCGCTG,0,5001207
yjbJ_predicted,0.25,3,3,CGTATACACGACCCCTTATT,0,5025934
yjbJ_predicted,0.25,3,3,CGTAATATTGCAGCCAAGTG,0,5006542
yjbJ_predicted,0.25,3,3,CGTAACCGGCACCCTTGGTA,0,5007592
yjbJ_predicted,0.25,3,3,CGGTTTAGCCACCTAACCCC,0,5000306
yjbJ_predicted,0.25,3,3,CGGTTCAATCATGCATTCGG,0,5029896
yjbJ_predicted,0.25,3,3,CGGTGTCTCTCTTGGACCTG,0,5009121
yjbJ_predicted,0.25,3,3,CGGTGGTAATTGGATTGATT,0,5013266
yjbJ_predicted,0.25,3,3,CGGTGCCCGTATTTTATGTT,0,5030962
yjbJ_predicted,0.25,3,3,CGGTAGTTGTATTCTAATGC,0,4997915
yjbJ_predicted,0.25,3,3,CGGTACGCTGGTTATCTGTA,0,4995426
yjbJ_predicted,0.25,3,3,CGGGCCCCTGGTTCAACACA,0,5014640
yjbJ_predicted,0.25,3,3,CGGCGTGAGGCGTTCTAAAT,0,5006005
yjbJ_predicted,0.25,3,3,CGGCGGACCGGTCAATTAAA,0,5010743
yjbJ_predicted,0.25,3,3,CGGCGCATCAACACGTTAGG,0,5012431
yjbJ_predicted,0.25,3,3,CGGCGAGGTTTGCCTTGGAG,0,4998534
yjbJ_predicted,0.25,3,3,CGGCCAAGCCACTATCTAGG,0,5016110
yjbJ_predicted,0.25,3,3,CGGATACGGCGCGGCCGGAG,0,5004052
yjbJ_predicted,0.25,3,3,CGGAGTGTAGATCGGAGTAT,0,5022128
yjbJ_predicted,0.25,3,3,CGGACGGCTGGACGAGAGGC,0,5004171
yjbJ_predicted,0.25,3,3,CGGAAGCCCGAGGGCGGCAA,0,5022929
yjbJ_predicted,0.25,3,3,CGCTGCACAATGCTATTGAT,0,5015414
yjbJ_predicted,0.25,3,3,CGCTGAGGAAGTGGTAAGCA,0,4996850
yjbJ_predicted,0.25,3,3,CGCTAATGTTCTAACCCGAC,0,5014265
yjbJ_predicted,0.25,3,3,CGCGGCTTAGGAAAATATCA,0,5026259
yjbJ_predicted,0.25,3,3,CGCGCTCAGCTCCTGTTCTT,0,5006479
yjbJ_predicted,0.25,3,3,CGCGCGACCTGCGCTGTAGA,0,5004937
yjbJ_predicted,0.25,3,3,CGCGCCAACTATTTCCCGTA,0,5009106
yjbJ_predicted,0.25,3,3,CGCCTGCGAGCCGATATAGA,0,5029671
yjbJ_predicted,0.25,3,3,CGCCTATCGGGGAATGGGCT,0,5016902
yjbJ_predicted,0.25,3,3,CGCCACGTTTATGGTACCTG,0,4996936
yjbJ_predicted,0.25,3,3,CGCATTCTTTTCCATCGGAT,0,5027302
yjbJ_predicted,0.25,3,3,CGCAGTCTGCTATTGCTGCT,0,5010058
yjbJ_predicted,0.25,3,3,CGCACAATTCGGAGCAGACG,0,5013760
yjbJ_predicted,0.25,3,3,CGATTTCTGACATTTTTGTA,0,5015134
yjbJ_predicted,0.25,3,3,CGATCGGTGCTCCGACTTAT,0,5008438
yjbJ_predicted,0.25,3,3,CGAGTTGGTCCTACTAAAGT,0,5004709
yjbJ_predicted,0.25,3,3,CGAGTGGGATTGGGAAATCA,0,4998953
yjbJ_predicted,0.25,3,3,CGAGCTTCTTACGAGATAAA,0,5001739
yjbJ_predicted,0.25,3,3,CGAGCTGGGTACTTAATTAA,0,5001968
yjbJ_predicted,0.25,3,3,CGAGCTGATTTTGCAACGGA,0,5006123
yjbJ_predicted,0.25,3,3,CGAGCTCAGCCCTTATCTGA,0,5018934
yjbJ_predicted,0.25,3,3,CGAGCGGTCCATCTTCGTGA,0,5005445
yjbJ_predicted,0.25,3,3,CGAGCCAATTAGGGTTCCTC,0,4995223
yjbJ_predicted,0.25,3,3,CGAGATTCTACAATATAATA,0,5017576
yjbJ_predicted,0.25,3,3,CGACGACGGCCCTCTAGTTG,0,5021333
yjbJ_predicted,0.25,3,3,CGACAACTCCTTCCATGGGC,0,5013376
yjbJ_predicted,0.25,3,3,CGAAGGCCGGAGTGAGTTTT,0,4997797
yjbJ_predicted,0.25,3,3,CGAACCTTATCGCACCGTGT,0,5028582
yjbJ_predicted,0.25,3,3,CGAACCCATCAAGTCGTCGC,0,5010889
yjbJ_predicted,0.25,3,3,CCTTGCTTGGCGGGAATAGT,0,5014865
yjbJ_predicted,0.25,3,3,CCTTCTAACCAGCGCCATCA,0,5022464
yjbJ_predicted,0.25,3,3,CCTTCGTGGCGTTCCGACTA,0,5008017
yjbJ_predicted,0.25,3,3,CCTGTTCTGGCAACACGGGT,0,5003958
yjbJ_predicted,0.25,3,3,CCTGGCCACTGACCCTGCAG,0,5013720
yjbJ_predicted,0.25,3,3,CCTGAGCAGATTCGGGGACC,0,5010776
yjbJ_predicted,0.25,3,3,CCTCTCGCGGGGACGCCGCT,0,5017171
yjbJ_predicted,0.25,3,3,CCTCCTCGCCCCAAGGCCGT,0,5022485
yjbJ_predicted,0.25,3,3,CCTCCGTAAACTGACTCACA,0,5018709
yjbJ_predicted,0.25,3,3,CCTATTGACCGTAATCCGGA,0,5003187
yjbJ_predicted,0.25,3,3,CCTATGACGAACTCGTATGG,0,5029119
yjbJ_predicted,0.25,3,3,CCTAGAAAGGGTATGGCATA,0,5022364
yjbJ_predicted,0.25,3,3,CCTACACGGCATCTAACGGG,0,5025459
yjbJ_predicted,0.25,3,3,CCGTTGCCCAATGTGTGGTC,0,5016299
yjbJ_predicted,0.25,3,3,CCGTAGCTGATATTCCTACC,0,5022865
yjbJ_predicted,0.25,3,3,CCGGTTCTACATGACAGTAC,0,5005411
yjbJ_predicted,0.25,3,3,CCGGCGTCTATAACGTTGGT,0,4998248
yjbJ_predicted,0.25,3,3,CCGGCACACCGAAGTTCGAC,0,5019619
yjbJ_predicted,0.25,3,3,CCGCTTAGTCCCGAGAGGGC,0,5029761
yjbJ_predicted,0.25,3,3,CCGCGTGAGTCCGACCTCCC,0,5025678
yjbJ_predicted,0.25,3,3,CCGCGCATTCCCAATGGCTT,0,5008070
yjbJ_predicted,0.25,3,3,CCGCGAATCCTGCCCCCGTG,0,5012609
yjbJ_predicted,0.25,3,3,CCGCCAACTCGCACATTAGC,0,5006184
yjbJ_predicted,0.25,3,3,CCGATTGAGCCAAGGATGAT,0,5026118
yjbJ_predicted,0.25,3,3,CCGATTGAGATTGCAACCCC,0,5029917
yjbJ_predicted,0.25,3,3,CCGATAGCCTCTGTGGCACA,0,4999928
yjbJ_predicted,0.25,3,3,CCCTTAGATCTTACGAAGCC,0,4995334
yjbJ_predicted,0.25,3,3,CCCTGTCACCCCTCGCTATC,0,5006719
yjbJ_predicted,0.25,3,3,CCCGTGGTACACCGATATAT,0,5024020
yjbJ_predicted,0.25,3,3,CCCGGCGCTCTAGTTCTTCA,0,5026409
yjbJ_predicted,0.25,3,3,CCCGGAAGCCGTTTAGGACC,0,5018295
yjbJ_predicted,0.25,3,3,CCCGCCTAGCTGAAGCCAAC,0,5013055
yjbJ_predicted,0.25,3,3,CCCGCATTGAACTGAATTCA,0,5026284
yjbJ_predicted,0.25,3,3,CCCCTTGATGGAGCGCTTAG,0,5017379
yjbJ_predicted,0.25,3,3,CCCCTTACTTCATATGTTTC,0,5019772
yjbJ_predicted,0.25,3,3,CCCCTGCATGCTCTTCGTTT,0,5007068
yjbJ_predicted,0.25,3,3,CCCCGGCCGTTGGCCTTCCC,0,5016765
yjbJ_predicted,0.25,3,3,CCCCGAAGCATGAAATCGTG,0,5021142
yjbJ_predicted,0.25,3,3,CCCCCTATGTTTGTCGGGTC,0,5007015
yjbJ_predicted,0.25,3,3,CCCCCCTCGAGATGCAATAT,0,5008290
yjbJ_predicted,0.25,3,3,CCCCATCCTCCAGATCATTT,0,4995026
yjbJ_predicted,0.25,3,3,CCCCAATGGGATGTTCTTTG,0,5008514
yjbJ_predicted,0.25,3,3,CCCATAGTAACATTGGAATC,0,5028704
yjbJ_predicted,0.25,3,3,CCCAGTGGGAACAAAACAGC,0,5000595
yjbJ_predicted,0.25,3,3,CCCAGTCCGAGGGTTCGGTT,0,5027411
yjbJ_predicted,0.25,3,3,CCCAGCTCACAAATCAATCC,0,5001555
yjbJ_predicted,0.25,3,3,CCCACGAGACTCTGATCAGG,0,5027294
yjbJ_predicted,0.25,3,3,CCCAACGCTCATCGCACCGA,0,4997134
yjbJ_predicted,0.25,3,3,CCCAACAACGCCAGTACGTC,0,5012495
yjbJ_predicted,0.25,3,3,CCATGTCAAGGACGTTATTC,0,5015852
yjbJ_predicted,0.25,3,3,CCATGGTGCCTCGCATGCGT,0,4999709
yjbJ_predicted,0.25,3,3,CCATAACACAGGTGATAGTC,0,5010980
yjbJ_predicted,0.25,3,3,CCAGTTGTATACAACATTCC,0,5028431
yjbJ_predicted,0.25,3,3,CCACCATGACAAATAGCATA,0,5023932
yjbJ_predicted,0.25,3,3,CCACAGTATTCCATATAAAA,0,5021705
yjbJ_predicted,0.25,3,3,CCAAGTTTATCGGCTAAAAA,0,5005978
yjbJ_predicted,0.25,3,3,CCAAAGCTGCCTCTGCAGGG,0,5021016
yjbJ_predicted,0.25,3,3,CATTGGCCTTGTCCCTCAAG,0,5011889
yjbJ_predicted,0.25,3,3,CATTCGCGGGTTTCACTCCC,0,4996245
yjbJ_predicted,0.25,3,3,CATTCCCACAAATCGCTCGA,0,4999989
yjbJ_predicted,0.25,3,3,CATTCCATGTCCGCCAGGGG,0,5011655
yjbJ_predicted,0.25,3,3,CATTAAAGGTTAGCGGGCCT,0,5022228
yjbJ_predicted,0.25,3,3,CATGTTATATCTACTAGGCA,0,5005318
yjbJ_predicted,0.25,3,3,CATGTGGTAAGCGATAGAGG,0,4995180
yjbJ_predicted,0.25,3,3,CATGTCTGGGGATATAAAAC,0,5013267
yjbJ_predicted,0.25,3,3,CATGGGAGCGGTGGATACCG,0,5017066
yjbJ_predicted,0.25,3,3,CATCGTTAGTGCTTATAATG,0,5010487
yjbJ_predicted,0.25,3,3,CATCGGGTTCCTTAACCTGC,0,5024327
yjbJ_predicted,0.25,3,3,CATCGCCGAATGGCCCGCTC,0,4995333
yjbJ_predicted,0.25,3,3,CATCGACAGGGCTGCGTGTT,0,5009693
yjbJ_predicted,0.25,3,3,CATCCTCTATATTTGCTTGA,0,4999010
yjbJ_predicted,0.25,3,3,CATCCACGCGTCTCAATTCG,0,5022027
yjbJ_predicted,0.25,3,3,CATATGATAAAGTGACCCGA,0,5009841
yjbJ_predicted,0.25,3,3,CATAGAGTGATGTGAACGAC,0,5009225
yjbJ_predicted,0.25,3,3,CATACCCCGGGGGGGTACAC,0,5026162
yjbJ_predicted,0.25,3,3,CAGTTTGACCCCTTTAGAGT,0,5019478
yjbJ_predicted,0.25,3,3,CAGTTGAGCGCTCGCGTTAT,0,5026465
yjbJ_predicted,0.25,3,3,CAGTGGAGCAAACTGCCGCC,0,5001486
yjbJ_predicted,0.25,3,3,CAGTGATAAAGCGTCGAGGG,0,5026364
yjbJ_predicted,0.25,3,3,CAGTCAGCTTAAGAGCCCGG,0,5002141
yjbJ_predicted,0.25,3,3,CAGTAAATTCTAACAGATCC,0,5025139
yjbJ_predicted,0.25,3,3,CAGGTCGATCTATATGATAT,0,5023352
yjbJ_predicted,0.25,3,3,CAGGCGGGATCCTAATACGA,0,5004098
yjbJ_predicted,0.25,3,3,CAGGACCTAAAGTAGTCCCC,0,5009565
yjbJ_predicted,0.25,3,3,CAGCTCGAATGCTGGAAAAG,0,4996186
yjbJ_predicted,0.25,3,3,CAGCGAGAAAGCTATGTGTA,0,5010131
yjbJ_predicted,0.25,3,3,CAGAACCATATAAGATTTTA,0,5013939
yjbJ_predicted,0.25,3,3,CAGAAACGTCGCAGTTCTTA,0,5003124
yjbJ_predicted,0.25,3,3,CACTTAGTCGTATGTTCTAA,0,5001167
yjbJ_predicted,0.25,3,3,CACTTACTCGAGACTGCTGC,0,5003562
yjbJ_predicted,0.25,3,3,CACTTACGCTGTCTGGGTTG,0,5022611
yjbJ_predicted,0.25,3,3,CACTTAAGCCGTAGTCTAGA,0,5002839
yjbJ_predicted,0.25,3,3,CACTGGAGCCTCCAACGGAC,0,5013735
yjbJ_predicted,0.25,3,3,CACGTTCGTTTAAACAGTCA,0,5001677
yjbJ_predicted,0.25,3,3,CACGGTTAAGATCCCTCAAT,0,5021499
yjbJ_predicted,0.25,3,3,CACGAACAGGAGTTGCTGAA,0,5019852
yjbJ_predicted,0.25,3,3,CACCGTGGATAGCGGCGAGC,0,5027303
yjbJ_predicted,0.25,3,3,CACCGTGATTTTCGAACTAG,0,5004179
yjbJ_predicted,0.25,3,3,CACCGTCTGATGACTATCAT,0,5002569
yjbJ_predicted,0.25,3,3,CACATGTTGGCATGTGCACG,0,5022223
yjbJ_predicted,0.25,3,3,CACAGTACCTGGCCCTTTGC,0,5012552
yjbJ_predicted,0.25,3,3,CACAGCTCCCTTTTAGTGAT,0,5001267
yjbJ_predicted,0.25,3,3,CACAAAGGTGAGTAACGAAG,0,5027137
yjbJ_predicted,0.25,3,3,CAATTCGGGCAAACGGAGCG,0,4995767
yjbJ_predicted,0.25,3,3,CAATATCGGTGTTAAGCCCT,0,5022628
yjbJ_predicted,0.25,3,3,CAATAAGTGCGCGCGCGGAA,0,4995467
yjbJ_predicted,0.25,3,3,CAAGTCAGGGCTAGGATCAT,0,5008431
yjbJ_predicted,0.25,3,3,CAACTAGCTTTGCAAGGATA,0,5008484
yjbJ_predicted,0.25,3,3,CAACGGTTAGGACGAGTAGA,0,5026568
yjbJ_predicted,0.25,3,3,CAACGGGCTTCGCGGTCAAT,0,5012046
yjbJ_predicted,0.25,3,3,CAACGATCGTATATACCGCT,0,5030453
yjbJ_predicted,0.25,3,3,CAACCTGGTTTAGCCGGAGT,0,5005365
yjbJ_predicted,0.25,3,3,CAACCTCGGGGAGCCGGTAA,0,5031189
yjbJ_predicted,0.25,3,3,CAACACTTGTGTCTACTAAG,0,4995249
yjbJ_predicted,0.25,3,3,CAACACATAGCAACCCACGC,0,5019773
yjbJ_predicted,0.25,3,3,CAACACACGCTGTTAGGTGC,0,5021074
yjbJ_predicted,0.25,3,3,CAAAGCACAGCTAACAAGAG,0,4996138
yjbJ_predicted,0.25,3,3,CAAACCCCAGAGGCCTCGGC,0,4997325
yjbJ_predicted,0.25,3,3,ATTTTGTGAGGCATCAAGCC,0,4995687
yjbJ_predicted,0.25,3,3,ATTTGTGGCCCACATGCGGA,0,5016785
yjbJ_predicted,0.25,3,3,ATTTGGGCCGTTCACCCGTG,0,5028208
yjbJ_predicted,0.25,3,3,ATTTCGGATTACGATGCCAA,0,5026372
yjbJ_predicted,0.25,3,3,ATTTATGGTGCAGTGTGGGT,0,5017043
yjbJ_predicted,0.25,3,3,ATTTACCACCCAGCACTTTA,0,5031120
yjbJ_predicted,0.25,3,3,ATTTACAGAAAGTGCCGCGA,0,5005059
yjbJ_predicted,0.25,3,3,ATTGGTGTCTAACGATAGCT,0,5030281
yjbJ_predicted,0.25,3,3,ATTGGTGGTGGACAACTTCG,0,5026274
yjbJ_predicted,0.25,3,3,ATTGCTCCCACCTTTGCTTT,0,5023154
yjbJ_predicted,0.25,3,3,ATTGATGTTCCTACGAAGTC,0,4998612
yjbJ_predicted,0.25,3,3,ATTAGGCCGAAAGCGGTTCC,0,5017579
yjbJ_predicted,0.25,3,3,ATTACGACCTTTCGCCATGA,0,5013238
yjbJ_predicted,0.25,3,3,ATTACAAGCTACACACGTAG,0,4996804
yjbJ_predicted,0.25,3,3,ATGTTTACATTCTTAGGGGT,0,5012095
yjbJ_predicted,0.25,3,3,ATGTCTGGGGTGCCCATCCT,0,5009805
yjbJ_predicted,0.25,3,3,ATGTAGAGTGGCTGGAAAGC,0,4999278
yjbJ_predicted,0.25,3,3,ATGGCTGGATGCTTAATTAT,0,4999599
yjbJ_predicted,0.25,3,3,ATGCCTGTCGGAATGCAGAA,0,4997779
yjbJ_predicted,0.25,3,3,ATGATGAGGACGAGGCTATT,0,4999528
yjbJ_predicted,0.25,3,3,ATGAGGAGTAGTGGCACTCA,0,5022225
yjbJ_predicted,0.25,3,3,ATGAACGATCATAGGTAAGT,0,5006240
yjbJ_predicted,0.25,3,3,ATGAACCGTTCGTTCAGATT,0,5024223
yjbJ_predicted,0.25,3,3,ATCTCTCAAGTCTTAAAACG,0,5004329
yjbJ_predicted,0.25,3,3,ATCTAGTCTTAACTTGAGTC,0,4999593
yjbJ_predicted,0.25,3,3,ATCTAGGGTCTAAGCTCTCT,0,5006738
yjbJ_predicted,0.25,3,3,ATCGTAGCGACTCAACAAGA,0,5009397
yjbJ_predicted,0.25,3,3,ATCGGCAACTTTCCGGGCTC,0,5025651
yjbJ_predicted,0.25,3,3,ATCCACAATGCGCCCTTGTT,0,5008437
yjbJ_predicted,0.25,3,3,ATCAGTTGTTCATACCATCC,0,5029208
yjbJ_predicted,0.25,3,3,ATCAGTCTCGCAGCTTCAAA,0,5009802
yjbJ_predicted,0.25,3,3,ATCACCCACGTGTGATCTGA,0,5013496
yjbJ_predicted,0.25,3,3,ATATTGACGGCCAATTACAA,0,5028787
yjbJ_predicted,0.25,3,3,ATATTCATTACAAAAGCTTG,0,4998227
yjbJ_predicted,0.25,3,3,ATATTATATCTCTGACCCGG,0,4997118
yjbJ_predicted,0.25,3,3,ATATCCATTAGCACGCGTCC,0,5012740
yjbJ_predicted,0.25,3,3,ATATACGACTGTGAGTTAGA,0,4999435
yjbJ_predicted,0.25,3,3,ATAGTGCGGCACGTGAAATG,0,5002272
yjbJ_predicted,0.25,3,3,ATAGGATCAGCAGAGAACCT,0,5027930
yjbJ_predicted,0.25,3,3,ATAGGAGAAGCCGCTGACGC,0,5025148
yjbJ_predicted,0.25,3,3,ATAGATCAGCTAATCAATAA,0,5021302
yjbJ_predicted,0.25,3,3,ATAATATCATACGTAGCAAG,0,5012839
yjbJ_predicted,0.25,3,3,ATAAGATATGTCTTTGAGCA,0,5018868
yjbJ_predicted,0.25,3,3,ATAAATATAGGGATTTGTCA,0,5015146
yjbJ_predicted,0.25,3,3,AGTTGTAATTCTGCCACATT,0,5002550
yjbJ_predicted,0.25,3,3,AGTTGCTGCGCTGGACACTG,0,5022478
yjbJ_predicted,0.25,3,3,AGTTGCGGGCGTACGGCATG,0,5009694
yjbJ_predicted,0.25,3,3,AGTTCTTCGCCGCGCCGTCT,0,5022440
yjbJ_predicted,0.25,3,3,AGTGTGGTTCGCACCGGTCT,0,5008796
yjbJ_predicted,0.25,3,3,AGTGTCAACTAGGTCCGTTG,0,5029665
yjbJ_predicted,0.25,3,3,AGTGGTCTCAGGATCCGATG,0,5005275
yjbJ_predicted,0.25,3,3,AGTGGCTCAGCTAACAAGTC,0,5030254
yjbJ_predicted,0.25,3,3,AGTGGCATCTAGTGGGGGGT,0,5029338
yjbJ_predicted,0.25,3,3,AGTGCCTAAGCTGGTCCAGA,0,5019244
yjbJ_predicted,0.25,3,3,AGTCTCTCATGACATACATG,0,4998090
yjbJ_predicted,0.25,3,3,AGTCGCCGCCGAGCTTAGCT,0,5018328
yjbJ_predicted,0.25,3,3,AGTATCTCTTGAGCTCCAAG,0,5005492
yjbJ_predicted,0.25,3,3,AGTAGGGTAACTTGGGGATC,0,5003454
yjbJ_predicted,0.25,3,3,AGTACGCGTGCGGAACGTCA,0,5016848
yjbJ_predicted,0.25,3,3,AGTAACGGCTTGTCGCTAGA,0,5008732
yjbJ_predicted,0.25,3,3,AGGTTTCTGCAGCCATAGAA,0,5003518
yjbJ_predicted,0.25,3,3,AGGTTCCATGCCAGCCAGGG,0,5008045
yjbJ_predicted,0.25,3,3,AGGTGTACCAATACAGCGGT,0,5025294
yjbJ_predicted,0.25,3,3,AGGTGCGGAAACAGGCCGCC,0,4998409
yjbJ_predicted,0.25,3,3,AGGTGAGGTTAGGCCATGAT,0,5029547
yjbJ_predicted,0.25,3,3,AGGTCCTGTCCAGTCTCCCA,0,5008549
yjbJ_predicted,0.25,3,3,AGGTATAACCGACGGGTTCA,0,5016819
yjbJ_predicted,0.25,3,3,AGGTACCTCAGGACGGTAAA,0,5010836
yjbJ_predicted,0.25,3,3,AGGTAATCGGTAGCCTCTCC,0,5016706
yjbJ_predicted,0.25,3,3,AGGGTTAATTGATGGGCGTA,0,5029696
yjbJ_predicted,0.25,3,3,AGGGTCACCATCTCTCAGTT,0,5030618
yjbJ_predicted,0.25,3,3,AGGGGTACCACAAGGCGGTT,0,5012042
yjbJ_predicted,0.25,3,3,AGGGCCTGTTGAGATTATGT,0,5016537
yjbJ_predicted,0.25,3,3,AGGCTTGAGTTATTAGGCCA,0,5000672
yjbJ_predicted,0.25,3,3,AGGCTCAACCCTGCTCAGAC,0,5001245
yjbJ_predicted,0.25,3,3,AGGCGATCACTATCGGGAGA,0,4996329
yjbJ_predicted,0.25,3,3,AGGCAGGAAGCTTTACGCTG,0,4997987
yjbJ_predicted,0.25,3,3,AGGCAAGTGGTCTGCATCCC,0,5023896
yjbJ_predicted,0.25,3,3,AGGATGCCTCGTTTGTGGAA,0,4995644
yjbJ_predicted,0.25,3,3,AGGATATAACGCGTAGAGTG,0,5011225
yjbJ_predicted,0.25,3,3,AGGAGTTACTTACTTTGTAA,0,5016076
yjbJ_predicted,0.25,3,3,AGGACCTGCGAGGTTCTAGT,0,5024755
yjbJ_predicted,0.25,3,3,AGGACATACTACGCGCATAA,0,5027951
yjbJ_predicted,0.25,3,3,AGGACAATCCCTTTTGATGT,0,5007337
yjbJ_predicted,0.25,3,3,AGGAATGTTTTGTCATAAGA,0,5023525
yjbJ_predicted,0.25,3,3,AGGAAGCGGGAAGATTGTCT,0,5019045
yjbJ_predicted,0.25,3,3,AGCTGGCAGTGACGTTAGCA,0,5021156
yjbJ_predicted,0.25,3,3,AGCTGACTATATTGCGTCTA,0,5015888
yjbJ_predicted,0.25,3,3,AGCTACGCACCCATCTGGGG,0,5022049
yjbJ_predicted,0.25,3,3,AGCTAAGGCGCTTTCATCTT,0,5017281
yjbJ_predicted,0.25,3,3,AGCGGTTTTAGGGGAGGCGC,0,5013454
yjbJ_predicted,0.25,3,3,AGCGCGCGTTTCATGTGTGT,0,5000724
yjbJ_predicted,0.25,3,3,AGCCTCGGGTACATAGAAAT,0,5021834
yjbJ_predicted,0.25,3,3,AGCCGTTCGTCGCTTCGAAC,0,5023897
yjbJ_predicted,0.25,3,3,AGCCGGGACCTGTGGGGAGT,0,5002184
yjbJ_predicted,0.25,3,3,AGCCGACTAACAGGACCTCC,0,5026088
yjbJ_predicted,0.25,3,3,AGCATCGCATATCTGAGCGT,0,5025080
yjbJ_predicted,0.25,3,3,AGCAGTTAGCAGGCGCGCTG,0,5015300
yjbJ_predicted,0.25,3,3,AGCACGGGATCCGAAGTGCT,0,5009808
yjbJ_predicted,0.25,3,3,AGCACGCTCTCTTACCTGTA,0,5021831
yjbJ_predicted,0.25,3,3,AGCACCACTCTCATTATCCG,0,5027979
yjbJ_predicted,0.25,3,3,AGATTTATTTCACAATGAGT,0,5009094
yjbJ_predicted,0.25,3,3,AGATTAGGGGGACTGGCGAC,0,5003938
yjbJ_predicted,0.25,3,3,AGATAAGAGTCAGTTTGCCT,0,5007889
yjbJ_predicted,0.25,3,3,AGAGTTAACTAGGAGTGGCC,0,5007336
yjbJ_predicted,0.25,3,3,AGAGGCTAGATTTCGTGTGA,0,4998274
yjbJ_predicted,0.25,3,3,AGAGGAGCAGCATGCGGTGA,0,5008500
yjbJ_predicted,0.25,3,3,AGAGGAAGGTAATCATGTCA,0,5019522
yjbJ_predicted,0.25,3,3,AGACTCCGAGGCGAGGCTGC,0,4998486
yjbJ_predicted,0.25,3,3,AGACTCCACGTCAGGACCCT,0,5002971
yjbJ_predicted,0.25,3,3,AGACTATCTCTTCGTGCGCG,0,4998034
yjbJ_predicted,0.25,3,3,AGACGTCTACGTCCGAGGAT,0,5022647
yjbJ_predicted,0.25,3,3,AGACGCAGACCTATAAGCCG,0,5009670
yjbJ_predicted,0.25,3,3,AGACACGCTTCGGCTTCACG,0,5006582
yjbJ_predicted,0.25,3,3,AGACAATCGCCCTCACCCCA,0,5009782
yjbJ_predicted,0.25,3,3,AGAATACTACTACAACTGCA,0,5024045
yjbJ_predicted,0.25,3,3,AGAACTGTACTCCGCCCATA,0,5015115
yjbJ_predicted,0.25,3,3,AGAACGGCGGAACAAGCCCT,0,5026708
yjbJ_predicted,0.25,3,3,AGAAAGCAGTGCCGAGCTAT,0,5002681
yjbJ_predicted,0.25,3,3,ACTTTGAGCTCGTATGTGCT,0,4998500
yjbJ_predicted,0.25,3,3,ACTTACTAGGCCGTAAAGAA,0,5010249
yjbJ_predicted,0.25,3,3,ACTGTCAACAGATCCTTGGT,0,5010828
yjbJ_predicted,0.25,3,3,ACTGTAGCCGGGATTTCAAT,0,5011501
yjbJ_predicted,0.25,3,3,ACTCGTCCGTAATTGAGAGA,0,5019154
yjbJ_predicted,0.25,3,3,ACTCATCGAACTACAGTAGG,0,5007284
yjbJ_predicted,0.25,3,3,ACTCAGCAATCAAAAACGAT,0,5025627
yjbJ_predicted,0.25,3,3,ACTCAGAGGACTCTTTTTGA,0,5021836
yjbJ_predicted,0.25,3,3,ACTATACGGGGCATTCCGGT,0,5010101
yjbJ_predicted,0.25,3,3,ACTACAGATCTTTCGAAAGC,0,5012190
yjbJ_predicted,0.25,3,3,ACTAATTTTTTTAGCGAGAT,0,5015082
yjbJ_predicted,0.25,3,3,ACGTTTTCGGAGGCACGGTC,0,5023160
yjbJ_predicted,0.25,3,3,ACGTTCGGCAACTGAGGAAA,0,4998364
yjbJ_predicted,0.25,3,3,ACGTTAGCGTAAACAGAAGA,0,5015347
yjbJ_predicted,0.25,3,3,ACGGGTTTCAGGGGTGGAGT,0,5015629
yjbJ_predicted,0.25,3,3,ACGGGTTTCACGTGATAAGT,0,5019858
yjbJ_predicted,0.25,3,3,ACGGGTTGTAAAGCTCGCAT,0,5001362
yjbJ_predicted,0.25,3,3,ACGGGCATCTTACGTTCAAG,0,5025739
yjbJ_predicted,0.25,3,3,ACGGCTCCTTCCTGTACAAC,0,4995509
yjbJ_predicted,0.25,3,3,ACGGATGTTTCAGAGTGTCA,0,4997167
yjbJ_predicted,0.25,3,3,ACGCCTACATATGATACAAA,0,5014735
yjbJ_predicted,0.25,3,3,ACGCCGACACCTGTGCCAGT,0,5025852
yjbJ_predicted,0.25,3,3,ACGATTACATCTCTGACACC,0,5011424
yjbJ_predicted,0.25,3,3,ACGAGCCGATCCAAATCCGT,0,5024804
yjbJ_predicted,0.25,3,3,ACGACTCCTAGATCCTGGTA,0,5030258
yjbJ_predicted,0.25,3,3,ACGAATGTGGAACTGTAGGC,0,5015997
yjbJ_predicted,0.25,3,3,ACGAAATAGGGGCACTCCGT,0,5004308
yjbJ_predicted,0.25,3,3,ACCTTGGGAACTGTAATTTC,0,5012871
yjbJ_predicted,0.25,3,3,ACCTCATAGGGATACGCGAA,0,5021184
yjbJ_predicted,0.25,3,3,ACCGTTCTGTAGTGCCTGTG,0,5006242
yjbJ_predicted,0.25,3,3,ACCGCCGGAATACCCGGGAC,0,5018385
yjbJ_predicted,0.25,3,3,ACCGCATCCGATGCTCTCGC,0,4999761
yjbJ_predicted,0.25,3,3,ACCGCACTCCCCTCGCTCGG,0,5011901
yjbJ_predicted,0.25,3,3,ACCGACTCTTTTTTTCGTGT,0,5000766
yjbJ_predicted,0.25,3,3,ACCCATATGAGGCGAAAAGA,0,5010697
yjbJ_predicted,0.25,3,3,ACCCAAGAATCAATCCGATT,0,5006927
yjbJ_predicted,0.25,3,3,ACCATTTCGTAACACCACGA,0,5001034
yjbJ_predicted,0.25,3,3,ACCATGCAAAATCTTCCAAC,0,5025985
yjbJ_predicted,0.25,3,3,ACCAATCTACCGCATGACGC,0,4999301
yjbJ_predicted,0.25,3,3,ACCAACCTTCGACCGGTGAT,0,5008466
yjbJ_predicted,0.25,3,3,ACCAACCAGGCAAACGCCGT,0,5006145
yjbJ_predicted,0.25,3,3,ACATGCGTAGCGTTGTTTTA,0,5002346
yjbJ_predicted,0.25,3,3,ACATCACCTGGTATAGATGT,0,5018732
yjbJ_predicted,0.25,3,3,ACATCAACGGCGGGTTTTCG,0,5022274
yjbJ_predicted,0.25,3,3,ACAGGTTCTGCAATGAAGAT,0,5013612
yjbJ_predicted,0.25,3,3,ACAGGGTGGGGCCTCCCATT,0,5000504
yjbJ_predicted,0.25,3,3,ACAGCGGTCCGATTTAATGT,0,5025142
yjbJ_predicted,0.25,3,3,ACAGCGCGAAACGATCACAT,0,5014128
yjbJ_predicted,0.25,3,3,ACACTGCTTAGCCAAGACTC,0,5005980
yjbJ_predicted,0.25,3,3,ACACTCCGGCAGGGCAAAAG,0,5027865
yjbJ_predicted,0.25,3,3,ACACGTATGGCAGCTTCGCG,0,5012286
yjbJ_predicted,0.25,3,3,ACACGGGATCCCGCAACGGG,0,5011297
yjbJ_predicted,0.25,3,3,ACACCGTTATACCCTAAAGT,0,5001194
yjbJ_predicted,0.25,3,3,ACACCGGAGTCTTATAGACA,0,5027402
yjbJ_predicted,0.25,3,3,ACACCGACGTTCACTTTGAC,0,4999700
yjbJ_predicted,0.25,3,3,ACAAGTGGCGACATTCGTCA,0,5028119
yjbJ_predicted,0.25,3,3,ACAAGTGCTCCCCTGACGTG,0,5006382
yjbJ_predicted,0.25,3,3,ACAACCTGCTACACGGCCCA,0,5018458
yjbJ_predicted,0.25,3,3,ACAAACATTACGGGCCGATG,0,5017657
yjbJ_predicted,0.25,3,3,AATTTGACTCCTCATTGGAC,0,5023028
yjbJ_predicted,0.25,3,3,AATTCTGTGTAAGGCCGCTA,0,4996436
yjbJ_predicted,0.25,3,3,AATTAGGGTGATCATATAGT,0,4999610
yjbJ_predicted,0.25,3,3,AATGGTGCGAACTTCTGTGT,0,5011358
yjbJ_predicted,0.25,3,3,AATGCACGGTGATTCAATCC,0,5001079
yjbJ_predicted,0.25,3,3,AATCGTGAAGCTTCTAGCTG,0,5028153
yjbJ_predicted,0.25,3,3,AATCGGGTCCGCAAATTATC,0,5027514
yjbJ_predicted,0.25,3,3,AATCCTCCTTGGAGGGCAGT,0,5017589
yjbJ_predicted,0.25,3,3,AATCCGAGTTTTTAGCGTGT,0,5013861
yjbJ_predicted,0.25,3,3,AATCAGTGAGTAGGGACATG,0,4996301
yjbJ_predicted,0.25,3,3,AATACTCGGACCTCCATGTG,0,5008367
yjbJ_predicted,0.25,3,3,AATACGAACAGCCTGTACGT,0,5018510
yjbJ_predicted,0.25,3,3,AATACCCACTCAGAGCGAAT,0,5025548
yjbJ_predicted,0.25,3,3,AATAAACTTACGATTTGACT,0,5019437
yjbJ_predicted,0.25,3,3,AAGTCCGTAGAGGCCCCAAT,0,4996654
yjbJ_predicted,0.25,3,3,AAGGGAACTGAAATCTTGGT,0,5017825
yjbJ_predicted,0.25,3,3,AAGGCCTGTAACGGGCCAAG,0,5020153
yjbJ_predicted,0.25,3,3,AAGGCCACGCGGTAGGGAAA,0,4999698
yjbJ_predicted,0.25,3,3,AAGGAGCCGCGAAGCAAAAT,0,4999620
yjbJ_predicted,0.25,3,3,AAGGAAGCGAGCTGATCCAT,0,5017189
yjbJ_predicted,0.25,3,3,AAGCTGGGCTCTATACAGAG,0,5001237
yjbJ_predicted,0.25,3,3,AAGCCGCCTGGCTGCAGAGA,0,4996515
yjbJ_predicted,0.25,3,3,AAGCCCGAGTCAATATTGCT,0,5011491
yjbJ_predicted,0.25,3,3,AAGCATGCAGAGGTTTCTCA,0,5029884
yjbJ_predicted,0.25,3,3,AAGCAGTATGTAACCAAACA,0,4997675
yjbJ_predicted,0.25,3,3,AAGAGGTGGTGCAGATATGC,0,5018507
yjbJ_predicted,0.25,3,3,AAGACGGCTAGAGATCTGCA,0,5022328
yjbJ_predicted,0.25,3,3,AAGAAGGCCCGTGCGTGAGC,0,5000434
yjbJ_predicted,0.25,3,3,AAGAAAAGAATTAGCGAACG,0,5021763
yjbJ_predicted,0.25,3,3,AACTGCTCTCTTCGGTGGCG,0,5017880
yjbJ_predicted,0.25,3,3,AACTATTCGTAGGCTGATTA,0,5005344
yjbJ_predicted,0.25,3,3,AACTACCTCTAACGCAGGAC,0,5002311
yjbJ_predicted,0.25,3,3,AACGGTGCCATGCCGTCCAA,0,5008875
yjbJ_predicted,0.25,3,3,AACGCCCCGTCTCCTGCGTA,0,5001304
yjbJ_predicted,0.25,3,3,AACGCATCCGGTCCAATCGT,0,5013841
yjbJ_predicted,0.25,3,3,AACGATCTATCTACGTCATG,0,4996241
yjbJ_predicted,0.25,3,3,AACGATCGCGTTACCAGCTA,0,4998438
yjbJ_predicted,0.25,3,3,AACCGTGGGCTTCGTGCAGA,0,5027910
yjbJ_predicted,0.25,3,3,AACCGATGTTTGGCGTTATA,0,5028463
yjbJ_predicted,0.25,3,3,AACCCACAGCACTGCCACAA,0,5007313
yjbJ_predicted,0.25,3,3,AACCAAGAGCAGGGACTTAC,0,5013165
yjbJ_predicted,0.25,3,3,AACAGGGGAGACATGTTGCA,0,5007455
yjbJ_predicted,0.25,3,3,AACACGGCGAGCACACGGCG,0,5026172
yjbJ_predicted,0.25,3,3,AAATGGGTGTAGGTCATTGT,0,5017405
yjbJ_predicted,0.25,3,3,AAATCCCAGCGCCGGCCGGA,0,5008184
yjbJ_predicted,0.25,3,3,AAAGGACTGTAAGTCCCCGA,0,5029285
yjbJ_predicted,0.25,3,3,AAACTCTCGGAACAGCGCCC,0,5009724
yjbJ_predicted,0.25,3,3,AAACGAAGAGTATCCTGCGG,0,5026934
yjbJ_predicted,0.25,3,3,AAAAGCGTCTCTCGGCATCG,0,5029668
yjbJ_predicted,0.25,3,3,AAAAGCGCTGAAACCATGCG,0,4994730
yjbJ_predicted,0.3333333333333333,2,2,TTTTCTAACGGCTCAGTGAG,0,5004255
yjbJ_predicted,0.3333333333333333,2,2,TTTTCGTTAGATGTCCAGGA,0,5027291
yjbJ_predicted,0.3333333333333333,2,2,TTTTCCCGTATGCCTCCGTA,0,5012167
yjbJ_predicted,0.3333333333333333,2,2,TTTTCAGGTGTCGGGTCTTT,0,4999443
yjbJ_predicted,0.3333333333333333,2,2,TTTTACACCATTGTTGGTCA,0,5022337
yjbJ_predicted,0.3333333333333333,2,2,TTTGTTCGCCGACACGCCCG,0,5030868
yjbJ_predicted,0.3333333333333333,2,2,TTTGGGGCGCACTCTTAGGG,0,5002181
yjbJ_predicted,0.3333333333333333,2,2,TTTGCGTGGCTCTGACCCGC,0,5010607
yjbJ_predicted,0.3333333333333333,2,2,TTTGATTTTCCCGATCGGAT,0,5002941
yjbJ_predicted,0.3333333333333333,2,2,TTTGAAAACGAGGTGGATGT,0,5003857
yjbJ_predicted,0.3333333333333333,2,2,TTTCTCCAGGGTATAGCGGG,0,5019307
yjbJ_predicted,0.3333333333333333,2,2,TTTCGGGGTCCATTTCATAA,0,4999667
yjbJ_predicted,0.3333333333333333,2,2,TTTCATTCCACACTGTTATA,0,5025543
yjbJ_predicted,0.3333333333333333,2,2,TTTCATCATTAGATTCCGTA,0,5023825
yjbJ_predicted,0.3333333333333333,2,2,TTTCAGTATACGAAGGTCAT,0,4997764
yjbJ_predicted,0.3333333333333333,2,2,TTTCAGGACGCCGGTTAGAG,0,5002948
yjbJ_predicted,0.3333333333333333,2,2,TTTCAGCCGGTATTAAGTGT,0,5018206
yjbJ_predicted,0.3333333333333333,2,2,TTTAGGATAATCATGGAGCC,0,5028386
yjbJ_predicted,0.3333333333333333,2,2,TTTAGCAAACGGTAATGCCC,0,5001695
yjbJ_predicted,0.3333333333333333,2,2,TTTACGGTTGCGACTCCTCA,0,5026174
yjbJ_predicted,0.3333333333333333,2,2,TTTACCTGTAATAGTACCTC,0,5006826
yjbJ_predicted,0.3333333333333333,2,2,TTTACCCATCTGGCGCGGTT,0,5024449
yjbJ_predicted,0.3333333333333333,2,2,TTTAATAGGCTCTCGAGGGC,0,5014722
yjbJ_predicted,0.3333333333333333,2,2,TTGTTTGGCAGTGTGACGTT,0,5023919
yjbJ_predicted,0.3333333333333333,2,2,TTGTGGACTGACTAGATAGT,0,5001700
yjbJ_predicted,0.3333333333333333,2,2,TTGTCGTATGGGCAGCGGAC,0,5005551
yjbJ_predicted,0.3333333333333333,2,2,TTGTCGTAAATTTCAGACGA,0,5012726
yjbJ_predicted,0.3333333333333333,2,2,TTGTCGATATTGGTAACCAA,0,5029264
yjbJ_predicted,0.3333333333333333,2,2,TTGTAATGCCCTGTATCGGT,0,5000183
yjbJ_predicted,0.3333333333333333,2,2,TTGTAAGTCAGGGCTCAGCA,0,5007898
yjbJ_predicted,0.3333333333333333,2,2,TTGGCTGGACCGGATATGAT,0,5010302
yjbJ_predicted,0.3333333333333333,2,2,TTGCCTTCCCCCGTCTTTGG,0,5012915
yjbJ_predicted,0.3333333333333333,2,2,TTGCCATGTTTTCACGCGCA,0,5007040
yjbJ_predicted,0.3333333333333333,2,2,TTGCATAGTAGGTATTTCCC,0,5002873
yjbJ_predicted,0.3333333333333333,2,2,TTGATGCATTCTGTATAAAC,0,5030245
yjbJ_predicted,0.3333333333333333,2,2,TTGAGTGAGTTCCCTGAGTA,0,5007341
yjbJ_predicted,0.3333333333333333,2,2,TTGAGCATGTCGCCCGGTGG,0,5022617
yjbJ_predicted,0.3333333333333333,2,2,TTGAGCAGAAGGTATATGGT,0,5024812
yjbJ_predicted,0.3333333333333333,2,2,TTGAGAGAGCTGAATTAAAA,0,5030240
yjbJ_predicted,0.3333333333333333,2,2,TTGACGCTGTTGGGGCAAGG,0,5031169
yjbJ_predicted,0.3333333333333333,2,2,TTGACAGGCCGAGACACTTA,0,4995176
yjbJ_predicted,0.3333333333333333,2,2,TTGAATTTGATCCCACCAAG,0,5026445
yjbJ_predicted,0.3333333333333333,2,2,TTGAATCCGCTACAGGTATT,0,5023097
yjbJ_predicted,0.3333333333333333,2,2,TTGAAAGCCCGACGTTTAGA,0,5015919
yjbJ_predicted,0.3333333333333333,2,2,TTCTTGTCAGTTTTACAACG,0,5030324
yjbJ_predicted,0.3333333333333333,2,2,TTCTCGTCTGTAGCGCCGGA,0,5021432
yjbJ_predicted,0.3333333333333333,2,2,TTCTATTGCCTGTCGCGACT,0,5019934
yjbJ_predicted,0.3333333333333333,2,2,TTCGGTGTATTTAGCGCTTC,0,5003495
yjbJ_predicted,0.3333333333333333,2,2,TTCCTTCCTAGCAGACCCGT,0,4996522
yjbJ_predicted,0.3333333333333333,2,2,TTCCGGACTCAAATAAATTA,0,5029792
yjbJ_predicted,0.3333333333333333,2,2,TTCCCTGGCTTGAGATAGTG,0,5016386
yjbJ_predicted,0.3333333333333333,2,2,TTCCCGCGGGGTAGATTTCT,0,5015864
yjbJ_predicted,0.3333333333333333,2,2,TTCCCCCTTGATTATGGTAG,0,5030255
yjbJ_predicted,0.3333333333333333,2,2,TTCATTGTCTGACCCAATAA,0,5020675
yjbJ_predicted,0.3333333333333333,2,2,TTCATTCTCCAGTAGGTCTC,0,5030293
yjbJ_predicted,0.3333333333333333,2,2,TTCATCTAGTACCACTAGGA,0,5023976
yjbJ_predicted,0.3333333333333333,2,2,TTCAGTATCCGTGCAAGGTC,0,4998061
yjbJ_predicted,0.3333333333333333,2,2,TTCAGCGGGAGAGATGGCTA,0,5031290
yjbJ_predicted,0.3333333333333333,2,2,TTCAAAGTTGCTTCCCGTAG,0,5014247
yjbJ_predicted,0.3333333333333333,2,2,TTATTCTATCCATTAGTCCT,0,5001807
yjbJ_predicted,0.3333333333333333,2,2,TTATTCATTTATCTAAATAC,0,5027517
yjbJ_predicted,0.3333333333333333,2,2,TTATTCACGCCGAACCGTCA,0,5006363
yjbJ_predicted,0.3333333333333333,2,2,TTATTATCGGTGGGTCAGGA,0,5016300
yjbJ_predicted,0.3333333333333333,2,2,TTATGCCAACTCAAAGCGAT,0,5023437
yjbJ_predicted,0.3333333333333333,2,2,TTATCGCCGGTTTCCGGATA,0,5006654
yjbJ_predicted,0.3333333333333333,2,2,TTATCACTCTGACTAAGCAA,0,5003757
yjbJ_predicted,0.3333333333333333,2,2,TTATAGGGGTCTAATAAATG,0,5021609
yjbJ_predicted,0.3333333333333333,2,2,TTATAGAGAACCGGGGCGCG,0,5017597
yjbJ_predicted,0.3333333333333333,2,2,TTAGTCCTGCCCGGTTTCTA,0,5001101
yjbJ_predicted,0.3333333333333333,2,2,TTAGCTGTCACAGGTTCGTA,0,5017509
yjbJ_predicted,0.3333333333333333,2,2,TTAGCGATTTGACAAACCTC,0,5006257
yjbJ_predicted,0.3333333333333333,2,2,TTAGCCTATCGGTCGAATAC,0,5025881
yjbJ_predicted,0.3333333333333333,2,2,TTAGCCATCATGCACCTGGA,0,5028760
yjbJ_predicted,0.3333333333333333,2,2,TTACTACGGTATCGCGCGAC,0,4996226
yjbJ_predicted,0.3333333333333333,2,2,TTACATGTGGAACACGCATA,0,5009711
yjbJ_predicted,0.3333333333333333,2,2,TTAAGCACAGGCTACAAGCC,0,5022766
yjbJ_predicted,0.3333333333333333,2,2,TTAAGAGACTCTCGATTAAG,0,4996163
yjbJ_predicted,0.3333333333333333,2,2,TTAACCCGAACAGAGCATTG,0,5024504
yjbJ_predicted,0.3333333333333333,2,2,TTAACATGCCCTCGCCTTAA,0,5029855
yjbJ_predicted,0.3333333333333333,2,2,TTAAACTTAACAAGGAGCAG,0,5016403
yjbJ_predicted,0.3333333333333333,2,2,TTAAAATTAAACTGTTTATT,0,5024355
yjbJ_predicted,0.3333333333333333,2,2,TGTTTCAGTTTGGCGGTTAT,0,5002785
yjbJ_predicted,0.3333333333333333,2,2,TGTTGGTATGGTGGTCCGCA,0,5017781
yjbJ_predicted,0.3333333333333333,2,2,TGTTAGTTCACATCGCACAG,0,5001198
yjbJ_predicted,0.3333333333333333,2,2,TGTGTGTCGCTCACTCTATG,0,5023777
yjbJ_predicted,0.3333333333333333,2,2,TGTGATGGGGGGCGCTGCAG,0,4997049
yjbJ_predicted,0.3333333333333333,2,2,TGTGACATACAACTTCTGCT,0,5003970
yjbJ_predicted,0.3333333333333333,2,2,TGTCCGTGGGACTCCAAAGT,0,5021537
yjbJ_predicted,0.3333333333333333,2,2,TGTCCGTAATATAGGCACAC,0,5014315
yjbJ_predicted,0.3333333333333333,2,2,TGTCCGAATTTGGACATTTA,0,4994920
yjbJ_predicted,0.3333333333333333,2,2,TGTCAGGGATAGTTCGGGAA,0,5002413
yjbJ_predicted,0.3333333333333333,2,2,TGTCACAATGTTAATGGGCA,0,5023988
yjbJ_predicted,0.3333333333333333,2,2,TGTATTTGGACGCATTTTGT,0,5024202
yjbJ_predicted,0.3333333333333333,2,2,TGTATATAGCGCGAGAGGCT,0,5030113
yjbJ_predicted,0.3333333333333333,2,2,TGTATAGTGGGACAAACGCG,0,5017286
yjbJ_predicted,0.3333333333333333,2,2,TGTATAACCCTCTCATCATA,0,5029372
yjbJ_predicted,0.3333333333333333,2,2,TGTAGCCGCATAATCAAGCC,0,5008568
yjbJ_predicted,0.3333333333333333,2,2,TGTAAGAGTTTTCCAGTGCT,0,5029378
yjbJ_predicted,0.3333333333333333,2,2,TGTAAAGCCTCATAAACGTC,0,4999664
yjbJ_predicted,0.3333333333333333,2,2,TGTAAAATAGTGCTCCGAAA,0,4995163
yjbJ_predicted,0.3333333333333333,2,2,TGGTGTCCGGAGAAACGGAC,0,5012277
yjbJ_predicted,0.3333333333333333,2,2,TGGTGGCCTTCCCTCCAAGA,0,5015463
yjbJ_predicted,0.3333333333333333,2,2,TGGTGACTTGCCTGCTACAG,0,5010770
yjbJ_predicted,0.3333333333333333,2,2,TGGTGACAAGCGTGCTAAGT,0,5023611
yjbJ_predicted,0.3333333333333333,2,2,TGGTCAAGGGCTATACGCAT,0,5000582
yjbJ_predicted,0.3333333333333333,2,2,TGGTAACCCAAACCACCAAA,0,5024617
yjbJ_predicted,0.3333333333333333,2,2,TGGGTTCAGAAAAAGTCACA,0,5028018
yjbJ_predicted,0.3333333333333333,2,2,TGGGTGGGCCTGGGGACGTG,0,5006655
yjbJ_predicted,0.3333333333333333,2,2,TGGGGGAACTGCACGGCCAC,0,5013421
yjbJ_predicted,0.3333333333333333,2,2,TGGCGAGTTTTAATATGACT,0,5004456
yjbJ_predicted,0.3333333333333333,2,2,TGGCCTACTCGGGTAAAACT,0,5019721
yjbJ_predicted,0.3333333333333333,2,2,TGGCCGCGGACTTGCCGCTT,0,5026166
yjbJ_predicted,0.3333333333333333,2,2,TGGCAGTCAGAGCGCTAACC,0,5002201
yjbJ_predicted,0.3333333333333333,2,2,TGGAGGGATTCCGATGAAGC,0,5021736
yjbJ_predicted,0.3333333333333333,2,2,TGGAGCTAACAGAGGATTGC,0,5023291
yjbJ_predicted,0.3333333333333333,2,2,TGCTTTTTTAATGAAGGTCC,0,5024309
yjbJ_predicted,0.3333333333333333,2,2,TGCTTTATCTTATGGTGCGA,0,5025098
yjbJ_predicted,0.3333333333333333,2,2,TGCTTCTCCTAGACGTTTAT,0,5020009
yjbJ_predicted,0.3333333333333333,2,2,TGCTGAAATCGTCCCAATCT,0,4997560
yjbJ_predicted,0.3333333333333333,2,2,TGCTACCGCACAAAGCTTTC,0,5026842
yjbJ_predicted,0.3333333333333333,2,2,TGCGTGCAAGACTTCTCACA,0,4999142
yjbJ_predicted,0.3333333333333333,2,2,TGCGTCCAATCCTGGGTTAA,0,4997439
yjbJ_predicted,0.3333333333333333,2,2,TGCGGTTGTTTATCTCGGCA,0,4998641
yjbJ_predicted,0.3333333333333333,2,2,TGCGCCACTCTGACGATGGG,0,5008331
yjbJ_predicted,0.3333333333333333,2,2,TGCGATTTGAAGATCAGTTA,0,5018033
yjbJ_predicted,0.3333333333333333,2,2,TGCCGAAAGAGTCAAAAATC,0,5000535
yjbJ_predicted,0.3333333333333333,2,2,TGCCCATTGCCAGGCGAGAT,0,5014369
yjbJ_predicted,0.3333333333333333,2,2,TGCCACTTTATTGATAATGC,0,5029893
yjbJ_predicted,0.3333333333333333,2,2,TGCATCCGCACGCGAGATGT,0,5028152
yjbJ_predicted,0.3333333333333333,2,2,TGCAGCTGGTATTGTGTGAA,0,5014335
yjbJ_predicted,0.3333333333333333,2,2,TGCACATCTCTCGGAAGTCG,0,5020311
yjbJ_predicted,0.3333333333333333,2,2,TGCAATCCCCATATGGAAGT,0,5011658
yjbJ_predicted,0.3333333333333333,2,2,TGATTTGAGACGAACAGCGG,0,5000114
yjbJ_predicted,0.3333333333333333,2,2,TGATTTCTCGATCTGCAAAT,0,5023998
yjbJ_predicted,0.3333333333333333,2,2,TGATGCAAGGGAGCTCGATG,0,5006875
yjbJ_predicted,0.3333333333333333,2,2,TGATATGATCCCTAGAAGTC,0,5016643
yjbJ_predicted,0.3333333333333333,2,2,TGATATATTCTTGTGAAGAA,0,5023363
yjbJ_predicted,0.3333333333333333,2,2,TGAGGGGCTGGCACAGTATT,0,5006685
yjbJ_predicted,0.3333333333333333,2,2,TGAGATATTACTGACATTGA,0,5025255
yjbJ_predicted,0.3333333333333333,2,2,TGACTTCTGATTTGCGTATG,0,5011279
yjbJ_predicted,0.3333333333333333,2,2,TGACTTCAGAGGACCGGGAG,0,5014506
yjbJ_predicted,0.3333333333333333,2,2,TGACGCGGGTGATGGCGAGT,0,5005949
yjbJ_predicted,0.3333333333333333,2,2,TGACGATGACGCCGGGCTGG,0,5003528
yjbJ_predicted,0.3333333333333333,2,2,TGACACTCATCTGTCATAGT,0,5029294
yjbJ_predicted,0.3333333333333333,2,2,TGAAGTGGATCCAGTACAGT,0,5009749
yjbJ_predicted,0.3333333333333333,2,2,TGAAGATGGGGTACACCTCC,0,5009422
yjbJ_predicted,0.3333333333333333,2,2,TGAAATTCCTACTTCAAACG,0,5004426
yjbJ_predicted,0.3333333333333333,2,2,TCTTTGCTCTGGACGTGAGT,0,5009132
yjbJ_predicted,0.3333333333333333,2,2,TCTTGGATCTAGATACGCCT,0,5024091
yjbJ_predicted,0.3333333333333333,2,2,TCTTCGGGCCTGCCTCGCTT,0,4995183
yjbJ_predicted,0.3333333333333333,2,2,TCTTCAATTTATTCCTGGGG,0,5008817
yjbJ_predicted,0.3333333333333333,2,2,TCTTACTGGTAGGACGCGTT,0,5019596
yjbJ_predicted,0.3333333333333333,2,2,TCTTACAATAGCTTCTTACT,0,5016589
yjbJ_predicted,0.3333333333333333,2,2,TCTGTCGTAATAGGCGCTTG,0,5005040
yjbJ_predicted,0.3333333333333333,2,2,TCTGGTGATCCGTTTCGGAT,0,5016956
yjbJ_predicted,0.3333333333333333,2,2,TCTGCCCTAACATGTACATG,0,5026336
yjbJ_predicted,0.3333333333333333,2,2,TCTGCAAGTTGCCTTAAGGG,0,5017022
yjbJ_predicted,0.3333333333333333,2,2,TCTGCAACCCCTTCGGTTGA,0,5012532
yjbJ_predicted,0.3333333333333333,2,2,TCTCGGCTTTACTGTAGCCT,0,5024897
yjbJ_predicted,0.3333333333333333,2,2,TCTCGCGGCGACTGATCTAA,0,5014813
yjbJ_predicted,0.3333333333333333,2,2,TCTATTGGGCGAGTTGGGGA,0,5009476
yjbJ_predicted,0.3333333333333333,2,2,TCTATTACCCTGCCTTTACT,0,5018610
yjbJ_predicted,0.3333333333333333,2,2,TCTAGGAAGTGGTGTCGACA,0,5021327
yjbJ_predicted,0.3333333333333333,2,2,TCTAGCGGGGGACAATTGGT,0,4996662
yjbJ_predicted,0.3333333333333333,2,2,TCTAACGGCACTTGTTCATC,0,5007477
yjbJ_predicted,0.3333333333333333,2,2,TCTAAACGGGGGGCTCAAAC,0,5011699
yjbJ_predicted,0.3333333333333333,2,2,TCGTTATGTTGGCTACAAGC,0,4997077
yjbJ_predicted,0.3333333333333333,2,2,TCGTTAGAACGGTCGGTCTG,0,5018455
yjbJ_predicted,0.3333333333333333,2,2,TCGTACGGTACAGGACACTT,0,5006183
yjbJ_predicted,0.3333333333333333,2,2,TCGGTGCACCATGAGTCCCT,0,5015168
yjbJ_predicted,0.3333333333333333,2,2,TCGGATACAAGTATAAGTGA,0,5026744
yjbJ_predicted,0.3333333333333333,2,2,TCGGAGCTAAGCGCTGTTAG,0,5023810
yjbJ_predicted,0.3333333333333333,2,2,TCGCGGCGCGTGCGATCTAC,0,5015601
yjbJ_predicted,0.3333333333333333,2,2,TCGCGACACTTGGCCTCTAA,0,5031227
yjbJ_predicted,0.3333333333333333,2,2,TCGCGACACTTCCCGCATCA,0,5010194
yjbJ_predicted,0.3333333333333333,2,2,TCGCCCAAGCCGTCAACAGT,0,5010136
yjbJ_predicted,0.3333333333333333,2,2,TCGCAGGCGGTCCCTGTGTT,0,5005813
yjbJ_predicted,0.3333333333333333,2,2,TCGCAAGAACCGGATTGCCT,0,5009514
yjbJ_predicted,0.3333333333333333,2,2,TCGATCGTTCGCCGCACATG,0,5011835
yjbJ_predicted,0.3333333333333333,2,2,TCGAAGAGAGCGAAACAAAC,0,5000081
yjbJ_predicted,0.3333333333333333,2,2,TCGAACTTTCAAATTGCGCG,0,5018462
yjbJ_predicted,0.3333333333333333,2,2,TCCTGCATGCCCTATAATCT,0,5027691
yjbJ_predicted,0.3333333333333333,2,2,TCCTAGTATTTCTCGGCGTA,0,5022166
yjbJ_predicted,0.3333333333333333,2,2,TCCGTTTCTGTTGGGTCTTG,0,5007244
yjbJ_predicted,0.3333333333333333,2,2,TCCGTGCAGTGTTTGATATT,0,5028102
yjbJ_predicted,0.3333333333333333,2,2,TCCGGTTGGACGGGGAATAT,0,4998671
yjbJ_predicted,0.3333333333333333,2,2,TCCGGTGACCGACGCTACTG,0,5012295
yjbJ_predicted,0.3333333333333333,2,2,TCCCTGGACTTGACAGACGC,0,4998149
yjbJ_predicted,0.3333333333333333,2,2,TCCAGTAGTTTTCACACAAC,0,5004552
yjbJ_predicted,0.3333333333333333,2,2,TCCAGGGTCTATTGCCGTAG,0,5020217
yjbJ_predicted,0.3333333333333333,2,2,TCCACGCAATCGGCGAACGC,0,5027748
yjbJ_predicted,0.3333333333333333,2,2,TCCAACGACGTAGACTGCCG,0,4999687
yjbJ_predicted,0.3333333333333333,2,2,TCCAAAACGTGTGAGTGGGT,0,5000892
yjbJ_predicted,0.3333333333333333,2,2,TCATTTCGTGCGGTGTTAGC,0,5000910
yjbJ_predicted,0.3333333333333333,2,2,TCATTCCCCTATTTACTCTA,0,5014498
yjbJ_predicted,0.3333333333333333,2,2,TCATGAATGAATCGAAGTCC,0,5015890
yjbJ_predicted,0.3333333333333333,2,2,TCATCACTGCTCAGCCATTC,0,5014135
yjbJ_predicted,0.3333333333333333,2,2,TCATATAAACATAGAAACTG,0,5025041
yjbJ_predicted,0.3333333333333333,2,2,TCATACCTTCTATGCGGAAG,0,5020319
yjbJ_predicted,0.3333333333333333,2,2,TCAGTTTACAGCTTTATCAC,0,5014701
yjbJ_predicted,0.3333333333333333,2,2,TCAGTGAATGTTAGTCGATT,0,5003035
yjbJ_predicted,0.3333333333333333,2,2,TCAGGGAGTGAGGATTGGGA,0,5014604
yjbJ_predicted,0.3333333333333333,2,2,TCAGCAATCAGCAGGGTAAA,0,5002371
yjbJ_predicted,0.3333333333333333,2,2,TCAGACCCTCCCTGGCCAAA,0,5021599
yjbJ_predicted,0.3333333333333333,2,2,TCACTGAACCCGACCTTCAG,0,5005249
yjbJ_predicted,0.3333333333333333,2,2,TCACTAGCATTTGAGTTAGT,0,5012370
yjbJ_predicted,0.3333333333333333,2,2,TCACTAACATCGCGATCAGA,0,5005660
yjbJ_predicted,0.3333333333333333,2,2,TCACGGGTTAACGGGCGCCC,0,4995743
yjbJ_predicted,0.3333333333333333,2,2,TCACGCATAAAATTAACCAC,0,5018725
yjbJ_predicted,0.3333333333333333,2,2,TCACAGGGTGTTTAATATGT,0,5014076
yjbJ_predicted,0.3333333333333333,2,2,TCACAAAGTGAGATCCCCTG,0,5009947
yjbJ_predicted,0.3333333333333333,2,2,TCAATGACCGTTCGGGCATT,0,5014559
yjbJ_predicted,0.3333333333333333,2,2,TCAACTGCGTGTGGATGAGT,0,5026652
yjbJ_predicted,0.3333333333333333,2,2,TATTTTGGCGTGAAAAAGTT,0,4996317
yjbJ_predicted,0.3333333333333333,2,2,TATTTAACCCCTGAGGCACG,0,5020682
yjbJ_predicted,0.3333333333333333,2,2,TATTGGGTATCTAAGTTACC,0,5026820
yjbJ_predicted,0.3333333333333333,2,2,TATTAGACGGACTTGTCAAT,0,5028529
yjbJ_predicted,0.3333333333333333,2,2,TATGACTCAGCCCGGCGAAT,0,5025617
yjbJ_predicted,0.3333333333333333,2,2,TATCTCGTACTACCAACGCA,0,5026358
yjbJ_predicted,0.3333333333333333,2,2,TATCGGTTATAGTCAATAGC,0,5026308
yjbJ_predicted,0.3333333333333333,2,2,TATCGGTGGGACGGTAAGAT,0,5011047
yjbJ_predicted,0.3333333333333333,2,2,TATCGATGGCAACCACCTTA,0,4997333
yjbJ_predicted,0.3333333333333333,2,2,TATCCCTTGTATCAGGGGAT,0,5001429
yjbJ_predicted,0.3333333333333333,2,2,TATCAGGGTGCAATCTACGT,0,5002654
yjbJ_predicted,0.3333333333333333,2,2,TATCAATATGTTGTCATCAC,0,5006975
yjbJ_predicted,0.3333333333333333,2,2,TATATGCCCCAGGCATGAAT,0,5004184
yjbJ_predicted,0.3333333333333333,2,2,TATACAGCCAACACATGTAC,0,5019861
yjbJ_predicted,0.3333333333333333,2,2,TATAACTTCGCGTCTTGACT,0,5014060
yjbJ_predicted,0.3333333333333333,2,2,TAGGGTTACAACGATAGTGT,0,4998909
yjbJ_predicted,0.3333333333333333,2,2,TAGGCGTTCAGCCGTGCGTA,0,5009379
yjbJ_predicted,0.3333333333333333,2,2,TAGGCCCAACGATAATGTAT,0,5008011
yjbJ_predicted,0.3333333333333333,2,2,TAGGAGGGCGTCCAGATTAT,0,5029085
yjbJ_predicted,0.3333333333333333,2,2,TAGCTCTGCAGGGACAGACC,0,5031229
yjbJ_predicted,0.3333333333333333,2,2,TAGCTAGTAGGGCGTTAGGA,0,5017454
yjbJ_predicted,0.3333333333333333,2,2,TAGCGACTTCATTAGGTCGG,0,5027283
yjbJ_predicted,0.3333333333333333,2,2,TAGCCTACCGGGGCTTTAAC,0,4997245
yjbJ_predicted,0.3333333333333333,2,2,TAGCCAGCGATATGAGCTTG,0,4995612
yjbJ_predicted,0.3333333333333333,2,2,TAGATTCAGCTTACGCGCGC,0,5013962
yjbJ_predicted,0.3333333333333333,2,2,TAGATCGGAAAGGATTCGGG,0,5007017
yjbJ_predicted,0.3333333333333333,2,2,TAGATAACGCCTTCCGGCAA,0,5017941
yjbJ_predicted,0.3333333333333333,2,2,TAGAGTCTTAAAGCGGGTAT,0,5000358
yjbJ_predicted,0.3333333333333333,2,2,TAGACGTCTCGATAGGGAGG,0,4999967
yjbJ_predicted,0.3333333333333333,2,2,TAGACCCCTCTCTATTCGTC,0,5006913
yjbJ_predicted,0.3333333333333333,2,2,TACTTCCTATCTTGTCCGGG,0,5006936
yjbJ_predicted,0.3333333333333333,2,2,TACTATACAGCTCCAAGACG,0,5008154
yjbJ_predicted,0.3333333333333333,2,2,TACTAATTAGACTCACGCCC,0,5030579
yjbJ_predicted,0.3333333333333333,2,2,TACGTTTGGGTACTTGCTGC,0,5000718
yjbJ_predicted,0.3333333333333333,2,2,TACGTTAACGTTGCATAAGA,0,5020214
yjbJ_predicted,0.3333333333333333,2,2,TACGGCCAATTGTTCAGCAA,0,5004849
yjbJ_predicted,0.3333333333333333,2,2,TACCCAGGCGACTGAAATGC,0,4995428
yjbJ_predicted,0.3333333333333333,2,2,TACATGTGAACTGGGAGGAT,0,5026488
yjbJ_predicted,0.3333333333333333,2,2,TACAGGGGTGTTACGTACAG,0,5022251
yjbJ_predicted,0.3333333333333333,2,2,TACACTAATTCAGTAAAATA,0,5014464
yjbJ_predicted,0.3333333333333333,2,2,TACACGCCCGGTGAAGGTAG,0,5004599
yjbJ_predicted,0.3333333333333333,2,2,TACACCACCAGACTTGAGAC,0,5002109
yjbJ_predicted,0.3333333333333333,2,2,TACAAGGTAGTTCTCCTCAG,0,5022039
yjbJ_predicted,0.3333333333333333,2,2,TAATGTTCGCGGCAATTCCG,0,5019510
yjbJ_predicted,0.3333333333333333,2,2,TAATGACTTGAATAGTGGAA,0,5026737
yjbJ_predicted,0.3333333333333333,2,2,TAAGCGAATTGCGTGTTTTG,0,5025903
yjbJ_predicted,0.3333333333333333,2,2,TAAGAGATTCAATTCACTTC,0,5021571
yjbJ_predicted,0.3333333333333333,2,2,TAACTAGCAGCTCCGTGGTG,0,5030630
yjbJ_predicted,0.3333333333333333,2,2,TAACGTCTCACCGTAGGACA,0,5023987
yjbJ_predicted,0.3333333333333333,2,2,TAACGACCCGCGCGGCCTAT,0,5023434
yjbJ_predicted,0.3333333333333333,2,2,TAACCAGCATCCAAACTTTG,0,5028512
yjbJ_predicted,0.3333333333333333,2,2,TAAAGTTAGCCATGCCACCT,0,5021080
yjbJ_predicted,0.3333333333333333,2,2,TAAAGTCCGTCGTTCGGATC,0,5026812
yjbJ_predicted,0.3333333333333333,2,2,TAAAGAAAAAACCAGGGCGT,0,5000756
yjbJ_predicted,0.3333333333333333,2,2,TAAACGGTTGACCTAGTGAA,0,4997958
yjbJ_predicted,0.3333333333333333,2,2,TAAAAGACGGGTTTCGACAC,0,5006380
yjbJ_predicted,0.3333333333333333,2,2,TAAAACTTAACCGGGCGAGG,0,5017688
yjbJ_predicted,0.3333333333333333,2,2,GTTTTGTGTTCTTAAGGGCG,0,5002659
yjbJ_predicted,0.3333333333333333,2,2,GTTTTGAGAACGTACTCACC,0,5019404
yjbJ_predicted,0.3333333333333333,2,2,GTTTTAGATTTACTCTCTGT,0,5001766
yjbJ_predicted,0.3333333333333333,2,2,GTTTGGCCCCTCCGGCCAGC,0,5030704
yjbJ_predicted,0.3333333333333333,2,2,GTTTCTCCCCGAATAAATCA,0,4998998
yjbJ_predicted,0.3333333333333333,2,2,GTTTCAACCGGGGATAAATG,0,5014297
yjbJ_predicted,0.3333333333333333,2,2,GTTTATCTATCGGTTTTACC,0,5019022
yjbJ_predicted,0.3333333333333333,2,2,GTTGTGAACGCTCAGACGTG,0,5008581
yjbJ_predicted,0.3333333333333333,2,2,GTTGTACAGTTGCTGGCCGA,0,5025720
yjbJ_predicted,0.3333333333333333,2,2,GTTGGTAAGCTTGGAAACAG,0,5018311
yjbJ_predicted,0.3333333333333333,2,2,GTTGGCGCAACATTAACTGT,0,5000929
yjbJ_predicted,0.3333333333333333,2,2,GTTGGACGGCTAAAGTCGAG,0,5006100
yjbJ_predicted,0.3333333333333333,2,2,GTTGCTAGAGGTAAGGTAAG,0,5019431
yjbJ_predicted,0.3333333333333333,2,2,GTTGCCCGTCACCTTCTGTC,0,5026947
yjbJ_predicted,0.3333333333333333,2,2,GTTGAGCAATAATATGACAG,0,5014984
yjbJ_predicted,0.3333333333333333,2,2,GTTCGTCGATTCTCTCTGGG,0,5028767
yjbJ_predicted,0.3333333333333333,2,2,GTTCGCGTAATTCGGTTTGC,0,5005258
yjbJ_predicted,0.3333333333333333,2,2,GTTCCTACTGCGCTCGTCGA,0,5019434
yjbJ_predicted,0.3333333333333333,2,2,GTTCCAGGGAATACTATATA,0,5006937
yjbJ_predicted,0.3333333333333333,2,2,GTTCATTATAGTGTGAGTCC,0,5029516
yjbJ_predicted,0.3333333333333333,2,2,GTTCACTTGCGAAGGCTGGA,0,5002579
yjbJ_predicted,0.3333333333333333,2,2,GTTCAAGGGGAGTAACCTGG,0,5003937
yjbJ_predicted,0.3333333333333333,2,2,GTGTTGAATGCATTTAGGTG,0,5017993
yjbJ_predicted,0.3333333333333333,2,2,GTGTGCCTCCTAAGCGTTCG,0,5026781
yjbJ_predicted,0.3333333333333333,2,2,GTGTAGCTCCCAGCTATTAA,0,5025021
yjbJ_predicted,0.3333333333333333,2,2,GTGGTAGCGTCTTAGCGTTC,0,5030547
yjbJ_predicted,0.3333333333333333,2,2,GTGGGCAATAAGAGCTGCTT,0,5022449
yjbJ_predicted,0.3333333333333333,2,2,GTGGCTATTTTCCCAGAGTC,0,4999332
yjbJ_predicted,0.3333333333333333,2,2,GTGGCGTTGTCGGGCGTGCG,0,5018544
yjbJ_predicted,0.3333333333333333,2,2,GTGGCCTATCCCTGCCAATG,0,4999767
yjbJ_predicted,0.3333333333333333,2,2,GTGGACATGCTGAGAATCCT,0,4999244
yjbJ_predicted,0.3333333333333333,2,2,GTGGAATCAATTAAGCGTCG,0,5014544
yjbJ_predicted,0.3333333333333333,2,2,GTGCTCGCGCGTGAATACTC,0,5005731
yjbJ_predicted,0.3333333333333333,2,2,GTGCTAATAGCTTTAGAGTT,0,5027971
yjbJ_predicted,0.3333333333333333,2,2,GTGCGTTTGGCGACAAAGGA,0,4997741
yjbJ_predicted,0.3333333333333333,2,2,GTGCCTCGTATGTGAAGACG,0,5026022
yjbJ_predicted,0.3333333333333333,2,2,GTGCCCTCTTTCATTCATTC,0,5028950
yjbJ_predicted,0.3333333333333333,2,2,GTGAATAGATCATGGGCGCA,0,5011794
yjbJ_predicted,0.3333333333333333,2,2,GTCTCGTTAGTGGCCAACTA,0,4996088
yjbJ_predicted,0.3333333333333333,2,2,GTCGTCTGTCAGATGCACAA,0,5027141
yjbJ_predicted,0.3333333333333333,2,2,GTCGGATCGCGACGACAGTT,0,5017836
yjbJ_predicted,0.3333333333333333,2,2,GTCGGACTGACTACTTTGAT,0,5008064
yjbJ_predicted,0.3333333333333333,2,2,GTCGCTCTAACCAATTGACT,0,5004442
yjbJ_predicted,0.3333333333333333,2,2,GTCGAAGCGCTCTGTCGTTT,0,5029343
yjbJ_predicted,0.3333333333333333,2,2,GTCCTGAGGCACAGGTGATC,0,5006262
yjbJ_predicted,0.3333333333333333,2,2,GTCCGGTCTCTGGCTCGCCA,0,4995139
yjbJ_predicted,0.3333333333333333,2,2,GTCCCCCAATGCCTCGATTA,0,5002636
yjbJ_predicted,0.3333333333333333,2,2,GTCCAGAATACGGCCTCCCA,0,4999436
yjbJ_predicted,0.3333333333333333,2,2,GTCCAGAACAACTGCCATCC,0,5028623
yjbJ_predicted,0.3333333333333333,2,2,GTCCACGGGATAGCGTCCAG,0,4996004
yjbJ_predicted,0.3333333333333333,2,2,GTATTGTATATTAGGCCGAC,0,5026945
yjbJ_predicted,0.3333333333333333,2,2,GTATGTTAAATATATCCTCA,0,5018270
yjbJ_predicted,0.3333333333333333,2,2,GTATGGGATCTCAGTTAAGT,0,4999605
yjbJ_predicted,0.3333333333333333,2,2,GTAGTCAACCCAAATTGGTG,0,5018641
yjbJ_predicted,0.3333333333333333,2,2,GTAGGTGGATTTATGGTACA,0,5029993
yjbJ_predicted,0.3333333333333333,2,2,GTAGGGATATGTATCAACAA,0,5018622
yjbJ_predicted,0.3333333333333333,2,2,GTACGTAGACAGTAAGTTCC,0,5010464
yjbJ_predicted,0.3333333333333333,2,2,GTACCGAGGTCTGAGCACGT,0,5026507
yjbJ_predicted,0.3333333333333333,2,2,GTACAGGGCGGGATTGTGTG,0,5026883
yjbJ_predicted,0.3333333333333333,2,2,GTACACCTTGCGTAGCCGCA,0,5000509
yjbJ_predicted,0.3333333333333333,2,2,GTAAGGCCATAGGTCCCAGA,0,5011642
yjbJ_predicted,0.3333333333333333,2,2,GTAACGGGTTATTTTATTTA,0,4995006
yjbJ_predicted,0.3333333333333333,2,2,GTAAACACCTTAGACGTCTA,0,5024222
yjbJ_predicted,0.3333333333333333,2,2,GGTTTTGCGTGCCGACACCT,0,5016924
yjbJ_predicted,0.3333333333333333,2,2,GGTTTGAAGCAATCCTCCAC,0,5008173
yjbJ_predicted,0.3333333333333333,2,2,GGTTGGGTGACACTCCGTGT,0,4997960
yjbJ_predicted,0.3333333333333333,2,2,GGTTGAGTATATTGAGTGAA,0,4996200
yjbJ_predicted,0.3333333333333333,2,2,GGTTAATTTACATCCCTTAA,0,5006431
yjbJ_predicted,0.3333333333333333,2,2,GGTGTTGTTCTGACACACCT,0,5007979
yjbJ_predicted,0.3333333333333333,2,2,GGTGGCGCATGGCACGGAGT,0,5002684
yjbJ_predicted,0.3333333333333333,2,2,GGTGAGGCACGGAGGGAACG,0,4999299
yjbJ_predicted,0.3333333333333333,2,2,GGTCTCTAACGGCCATCCGT,0,5023023
yjbJ_predicted,0.3333333333333333,2,2,GGTCGCCAAATGCAGGCGGC,0,5027202
yjbJ_predicted,0.3333333333333333,2,2,GGTCCACTTGGGCTGCGTAG,0,5008691
yjbJ_predicted,0.3333333333333333,2,2,GGTATCTAGCACGGTCAGTA,0,5006064
yjbJ_predicted,0.3333333333333333,2,2,GGTATAGAACGGTAGGGGAC,0,5000698
yjbJ_predicted,0.3333333333333333,2,2,GGTAGAAGCTTGCGTAATGT,0,5014636
yjbJ_predicted,0.3333333333333333,2,2,GGTACTTGAGCCAGAGCTAA,0,5029630
yjbJ_predicted,0.3333333333333333,2,2,GGTACCCGGTACCCTTGCCC,0,5011895
yjbJ_predicted,0.3333333333333333,2,2,GGTACAGCAGGGTATTATAG,0,5020336
yjbJ_predicted,0.3333333333333333,2,2,GGTAAATTTGGATGGACGAT,0,4998276
yjbJ_predicted,0.3333333333333333,2,2,GGGTTTTGCGTGGCACTTGA,0,4996946
yjbJ_predicted,0.3333333333333333,2,2,GGGTTGAAAGTGTTTCGGTA,0,5029151
yjbJ_predicted,0.3333333333333333,2,2,GGGTACTCATATACTGTGCG,0,5006847
yjbJ_predicted,0.3333333333333333,2,2,GGGTAAGCATGCGCCGGGTA,0,4995736
yjbJ_predicted,0.3333333333333333,2,2,GGGGTTGGGAGGAGGGCCTC,0,5017771
yjbJ_predicted,0.3333333333333333,2,2,GGGGTGGCGTTGTAATGAAA,0,5018775
yjbJ_predicted,0.3333333333333333,2,2,GGGGTGCAAGGTGTCTCGGA,0,5017260
yjbJ_predicted,0.3333333333333333,2,2,GGGGTCGCACGCAGGTTCTG,0,5019937
yjbJ_predicted,0.3333333333333333,2,2,GGGGTCACATGTCAGCTTAT,0,5007937
yjbJ_predicted,0.3333333333333333,2,2,GGGGTACCGCGCTCATAATG,0,5025472
yjbJ_predicted,0.3333333333333333,2,2,GGGCTTGCAACCTTTTTAGG,0,5000177
yjbJ_predicted,0.3333333333333333,2,2,GGGATTCCTCGAAGGGAGCA,0,5023094
yjbJ_predicted,0.3333333333333333,2,2,GGGATGGAATTCGGGTAGCG,0,5028069
yjbJ_predicted,0.3333333333333333,2,2,GGGAGTTGACAGCTTATTAA,0,5006604
yjbJ_predicted,0.3333333333333333,2,2,GGGACTACCTAGCAGGGATC,0,5018297
yjbJ_predicted,0.3333333333333333,2,2,GGGAATTGGATTCGTGAAAT,0,5007185
yjbJ_predicted,0.3333333333333333,2,2,GGCTGATATTAACTAGATTA,0,5030477
yjbJ_predicted,0.3333333333333333,2,2,GGCGTTTACAGCTTTCACAC,0,5023903
yjbJ_predicted,0.3333333333333333,2,2,GGCGTCCAACGGGCTCCAAC,0,5003412
yjbJ_predicted,0.3333333333333333,2,2,GGCGCGGGATGGGAGGCGGA,0,5009993
yjbJ_predicted,0.3333333333333333,2,2,GGCGAGCACGGGCCATTCTA,0,4998853
yjbJ_predicted,0.3333333333333333,2,2,GGCCTTGCACATTGGTTACG,0,5011272
yjbJ_predicted,0.3333333333333333,2,2,GGCCGGGCTTAGTCATACAT,0,5005782
yjbJ_predicted,0.3333333333333333,2,2,GGCCGGGCAGCTGTTGTCTC,0,5028274
yjbJ_predicted,0.3333333333333333,2,2,GGCCGGGATCGCCACATGTA,0,5027176
yjbJ_predicted,0.3333333333333333,2,2,GGCCCGCCACATATGATTAA,0,5008490
yjbJ_predicted,0.3333333333333333,2,2,GGCATGTGCATGGCTTCACA,0,5018771
yjbJ_predicted,0.3333333333333333,2,2,GGCATCAAGCAGACTCGAAG,0,5003393
yjbJ_predicted,0.3333333333333333,2,2,GGCATACGGAAGATGCACTA,0,5025917
yjbJ_predicted,0.3333333333333333,2,2,GGCATAAGGAGTTCTATCAT,0,5002990
yjbJ_predicted,0.3333333333333333,2,2,GGCAGCGCCTGTATTGACTT,0,5004475
yjbJ_predicted,0.3333333333333333,2,2,GGCAGCGACAGTGGAGCAAA,0,5016741
yjbJ_predicted,0.3333333333333333,2,2,GGCACACAATCTAATAAGTT,0,5000146
yjbJ_predicted,0.3333333333333333,2,2,GGCAAGGTGCCCCAGATCGA,0,4996833
yjbJ_predicted,0.3333333333333333,2,2,GGATTTCCATCTGCTATGCG,0,5014011
yjbJ_predicted,0.3333333333333333,2,2,GGATTTATGCTCCCGGATTG,0,5025141
yjbJ_predicted,0.3333333333333333,2,2,GGATGGAGATTAGGCAAGAA,0,5011210
yjbJ_predicted,0.3333333333333333,2,2,GGAGGCGCCATGATACGAAA,0,5013607
yjbJ_predicted,0.3333333333333333,2,2,GGAGGAAGTTTTCAAGTTTA,0,5010502
yjbJ_predicted,0.3333333333333333,2,2,GGAGCCATAGCATGCCCGCC,0,5004952
yjbJ_predicted,0.3333333333333333,2,2,GGACGAATGATGCTCCCTCT,0,5021020
yjbJ_predicted,0.3333333333333333,2,2,GGACCCCTTCACATCTGGGT,0,5006081
yjbJ_predicted,0.3333333333333333,2,2,GGACATCGATGTTAACGTTC,0,5010139
yjbJ_predicted,0.3333333333333333,2,2,GGAAGTTAGGACATCGCCTC,0,5026966
yjbJ_predicted,0.3333333333333333,2,2,GGAAGATTATATCGGCTGTA,0,5011653
yjbJ_predicted,0.3333333333333333,2,2,GGAACGGCGAGTCAGGGCGC,0,4999559
yjbJ_predicted,0.3333333333333333,2,2,GGAACCTGGGGGCCAGAACT,0,5024951
yjbJ_predicted,0.3333333333333333,2,2,GGAAACGAGACAACGGTAGA,0,5030424
yjbJ_predicted,0.3333333333333333,2,2,GGAAACAGTTTCTGGGTTAA,0,5015849
yjbJ_predicted,0.3333333333333333,2,2,GCTTTTTAAACAATAAGGCC,0,5000528
yjbJ_predicted,0.3333333333333333,2,2,GCTTGTGTCTTAAAAACAAC,0,5028029
yjbJ_predicted,0.3333333333333333,2,2,GCTTATGATTGTATTGCACT,0,5026679
yjbJ_predicted,0.3333333333333333,2,2,GCTGTCGTTCATGCTATGAT,0,4995593
yjbJ_predicted,0.3333333333333333,2,2,GCTGTCCTCCTACATATTTC,0,5008245
yjbJ_predicted,0.3333333333333333,2,2,GCTGATGGCCCTACTGAACA,0,5030705
yjbJ_predicted,0.3333333333333333,2,2,GCTGATATAGCGCAAGTACC,0,5010654
yjbJ_predicted,0.3333333333333333,2,2,GCTCTCTAACGTAGTTATGT,0,5016675
yjbJ_predicted,0.3333333333333333,2,2,GCTCGAGGGCGATAAACTGT,0,5000008
yjbJ_predicted,0.3333333333333333,2,2,GCTCATTGGCTGGCGCCTCA,0,5027703
yjbJ_predicted,0.3333333333333333,2,2,GCTCAATCAGCTCGAACTTC,0,5013374
yjbJ_predicted,0.3333333333333333,2,2,GCTAGCAGTGAAAAGCGAAG,0,5024674
yjbJ_predicted,0.3333333333333333,2,2,GCTAGAGTGATTGTAGGATT,0,5026168
yjbJ_predicted,0.3333333333333333,2,2,GCTAGACAGTGTTGACTATT,0,5003878
yjbJ_predicted,0.3333333333333333,2,2,GCTACTTCGGAGGCTTAGTA,0,5000020
yjbJ_predicted,0.3333333333333333,2,2,GCTAATGGGTTGTCCTCTGA,0,5004990
yjbJ_predicted,0.3333333333333333,2,2,GCGTGGGCAATGCCGAGCAC,0,4996802
yjbJ_predicted,0.3333333333333333,2,2,GCGTGGCCCCCCTGTACGAC,0,5015095
yjbJ_predicted,0.3333333333333333,2,2,GCGTCTTTCAGTGTTAAACG,0,5018698
yjbJ_predicted,0.3333333333333333,2,2,GCGGGTTAACAAGTCAGACC,0,4995854
yjbJ_predicted,0.3333333333333333,2,2,GCGGCATAATTTAGAAACGC,0,5001150
yjbJ_predicted,0.3333333333333333,2,2,GCGCTTAGGATCGGGGGTGT,0,5028275
yjbJ_predicted,0.3333333333333333,2,2,GCGCTAGCTCGTATTCAAGT,0,5017872
yjbJ_predicted,0.3333333333333333,2,2,GCGCATAGGAGCCACGCGTC,0,5010034
yjbJ_predicted,0.3333333333333333,2,2,GCGCAAGTCATGGTAACGGA,0,5020408
yjbJ_predicted,0.3333333333333333,2,2,GCGATTGGCAACGGGCGTCA,0,5029844
yjbJ_predicted,0.3333333333333333,2,2,GCGATCGAAGCGTTACATAC,0,5028650
yjbJ_predicted,0.3333333333333333,2,2,GCGATAATATGATTACACCA,0,5029932
yjbJ_predicted,0.3333333333333333,2,2,GCGAGCGTCCCCTATAATTG,0,5002038
yjbJ_predicted,0.3333333333333333,2,2,GCGAGCCCACTCTGACTGTA,0,5014852
yjbJ_predicted,0.3333333333333333,2,2,GCGACGGCGTCATCCGCAGA,0,5025343
yjbJ_predicted,0.3333333333333333,2,2,GCGAAGAAGGAATCATACGA,0,5016089
yjbJ_predicted,0.3333333333333333,2,2,GCCTCTGCCTCTCATGGCGG,0,5018262
yjbJ_predicted,0.3333333333333333,2,2,GCCGCTCATTGAAGACACGG,0,5022761
yjbJ_predicted,0.3333333333333333,2,2,GCCGAGCCACAGGCGTATGA,0,5021171
yjbJ_predicted,0.3333333333333333,2,2,GCCGAAGCGTATTGACACGC,0,5027054
yjbJ_predicted,0.3333333333333333,2,2,GCCCTTGAGCGGGCGAGGTT,0,5013398
yjbJ_predicted,0.3333333333333333,2,2,GCCCGTTTTCTCTTGTCCAG,0,5005090
yjbJ_predicted,0.3333333333333333,2,2,GCCCGTACGGACTCCGAGCC,0,5025847
yjbJ_predicted,0.3333333333333333,2,2,GCCCGCGCAAGCCATACACT,0,5009597
yjbJ_predicted,0.3333333333333333,2,2,GCCCGAACTTAACAGGGCCG,0,5022773
yjbJ_predicted,0.3333333333333333,2,2,GCCCAGTGTAGGAGCGAGCT,0,4996671
yjbJ_predicted,0.3333333333333333,2,2,GCCATCGATGCGCAGGGGGT,0,5002352
yjbJ_predicted,0.3333333333333333,2,2,GCCAGTATTCTTAGGTCCGA,0,5029106
yjbJ_predicted,0.3333333333333333,2,2,GCCACAAATAAGGTTCGACA,0,5005779
yjbJ_predicted,0.3333333333333333,2,2,GCATTCCCCAGGGTAATTGT,0,5019500
yjbJ_predicted,0.3333333333333333,2,2,GCATGAAGGTCGGGGGTATC,0,5008168
yjbJ_predicted,0.3333333333333333,2,2,GCATCGGATAAGCACACGGA,0,5012102
yjbJ_predicted,0.3333333333333333,2,2,GCATCGCGCATTCTTGCCCC,0,5002160
yjbJ_predicted,0.3333333333333333,2,2,GCATCATGTTCACTAATCAA,0,5002054
yjbJ_predicted,0.3333333333333333,2,2,GCATAGGACTCAGCCGAATC,0,4997516
yjbJ_predicted,0.3333333333333333,2,2,GCAGTGATCGTAATCCGTAC,0,5005449
yjbJ_predicted,0.3333333333333333,2,2,GCAGGAGGGCTAATCCACGT,0,5016243
yjbJ_predicted,0.3333333333333333,2,2,GCAGCTCCGTCCCTGGCGAA,0,5008798
yjbJ_predicted,0.3333333333333333,2,2,GCAGCGTCTCATTCAAATCT,0,5026039
yjbJ_predicted,0.3333333333333333,2,2,GCAGCCTCCACTCTATGCTT,0,5007340
yjbJ_predicted,0.3333333333333333,2,2,GCACTCCTAAACCTTATTAT,0,5023348
yjbJ_predicted,0.3333333333333333,2,2,GCACCTGATGGGGGTCTAGT,0,5005313
yjbJ_predicted,0.3333333333333333,2,2,GCAATCATAACCTTCTGGGT,0,4999285
yjbJ_predicted,0.3333333333333333,2,2,GCAAGACGGCGGGTGAACAG,0,4998946
yjbJ_predicted,0.3333333333333333,2,2,GCAAGAAGTGAGTGCGGCCA,0,5009779
yjbJ_predicted,0.3333333333333333,2,2,GATTGTCGAGATTTGCGCTA,0,4998483
yjbJ_predicted,0.3333333333333333,2,2,GATTGACAATTGCGCTTTGT,0,5008889
yjbJ_predicted,0.3333333333333333,2,2,GATTAGGGGCAGACCAGTAC,0,5008605
yjbJ_predicted,0.3333333333333333,2,2,GATGTAGACATGCTGCGCTT,0,5017300
yjbJ_predicted,0.3333333333333333,2,2,GATGGTGGCGCAGACACGGC,0,5007135
yjbJ_predicted,0.3333333333333333,2,2,GATGGATGTACGGTCACTCA,0,5023568
yjbJ_predicted,0.3333333333333333,2,2,GATCTCTTTGTTCGTGGGAT,0,5029999
yjbJ_predicted,0.3333333333333333,2,2,GATCTCCCGGGGACTAGCAA,0,5012821
yjbJ_predicted,0.3333333333333333,2,2,GATCCTAAGATCTTTCGTCG,0,4998114
yjbJ_predicted,0.3333333333333333,2,2,GATCCGCTTAATCCGTTTCG,0,5024053
yjbJ_predicted,0.3333333333333333,2,2,GATCCGCAGTTTCTATAGGC,0,5009126
yjbJ_predicted,0.3333333333333333,2,2,GATCCGAAGGCCACTGGAGC,0,5016168
yjbJ_predicted,0.3333333333333333,2,2,GATCAGGGACAAGTTGGTGA,0,5004469
yjbJ_predicted,0.3333333333333333,2,2,GATAGTGCCAGTGTCGGCTA,0,5009174
yjbJ_predicted,0.3333333333333333,2,2,GATAGCGTTCTGCTAGAAAT,0,5020563
yjbJ_predicted,0.3333333333333333,2,2,GATACTCTACAGCGATCTTG,0,5002023
yjbJ_predicted,0.3333333333333333,2,2,GATACGACAACAATGGATGT,0,5016834
yjbJ_predicted,0.3333333333333333,2,2,GAGTTTTACACTCAGGAATA,0,4999357
yjbJ_predicted,0.3333333333333333,2,2,GAGTTCGCCAGCATAAGAAT,0,5006993
yjbJ_predicted,0.3333333333333333,2,2,GAGTTAGTCAAGGGCAACTC,0,5026458
yjbJ_predicted,0.3333333333333333,2,2,GAGTGGTTTATTTGTTTAGA,0,5024207
yjbJ_predicted,0.3333333333333333,2,2,GAGTGCGGCCGACCCAGAAG,0,5006148
yjbJ_predicted,0.3333333333333333,2,2,GAGTGAACCTTGCGCTGACG,0,5009365
yjbJ_predicted,0.3333333333333333,2,2,GAGTCGGCCCTCTAGGTCGG,0,5005833
yjbJ_predicted,0.3333333333333333,2,2,GAGTCGCTCCGCGGTTATAA,0,5024149
yjbJ_predicted,0.3333333333333333,2,2,GAGTACCGCGTGATGTCCCA,0,5001532
yjbJ_predicted,0.3333333333333333,2,2,GAGGCTAGGGAGCAGTCGGC,0,4995614
yjbJ_predicted,0.3333333333333333,2,2,GAGGCGACCTTAAACCGTAC,0,5027734
yjbJ_predicted,0.3333333333333333,2,2,GAGCTTAGTGATTAATGAAT,0,5000662
yjbJ_predicted,0.3333333333333333,2,2,GAGCTGGAAAAATGATTGGC,0,5003278
yjbJ_predicted,0.3333333333333333,2,2,GAGCTAAACAACGCGGGATA,0,5003639
yjbJ_predicted,0.3333333333333333,2,2,GAGCGTGTGTAAAGTACCCT,0,4998161
yjbJ_predicted,0.3333333333333333,2,2,GAGCGCTGAATATTTACACG,0,5019819
yjbJ_predicted,0.3333333333333333,2,2,GAGCCGTCGGGCAAAGTCAG,0,5024680
yjbJ_predicted,0.3333333333333333,2,2,GAGCCACCAGGAGTTACCTC,0,4998163
yjbJ_predicted,0.3333333333333333,2,2,GAGAATAGGAGAGAACGATC,0,5012152
yjbJ_predicted,0.3333333333333333,2,2,GAGAAGCCCTGTGTGTCGGG,0,5014097
yjbJ_predicted,0.3333333333333333,2,2,GACTTGCAGTGATTTGCATC,0,5006285
yjbJ_predicted,0.3333333333333333,2,2,GACTTGCAGGCCGGAAGGCA,0,5019507
yjbJ_predicted,0.3333333333333333,2,2,GACTTCCTCAACAGCGGGCA,0,5000675
yjbJ_predicted,0.3333333333333333,2,2,GACTACAGGCCGTACGCGTG,0,5022561
yjbJ_predicted,0.3333333333333333,2,2,GACGTTTTGCCAGCCTAACG,0,5012359
yjbJ_predicted,0.3333333333333333,2,2,GACGGTACGTGGCGTAAGCT,0,5027086
yjbJ_predicted,0.3333333333333333,2,2,GACGGGTCAGCGGAAGTCGG,0,5018450
yjbJ_predicted,0.3333333333333333,2,2,GACGCTTCGGCGATGGCGGG,0,5014465
yjbJ_predicted,0.3333333333333333,2,2,GACGCGCGTCTTAGTGGGGT,0,4999122
yjbJ_predicted,0.3333333333333333,2,2,GACCTACCCGACGGACTCCG,0,5001776
yjbJ_predicted,0.3333333333333333,2,2,GACCACCCAGCGGAAGCATT,0,5013110
yjbJ_predicted,0.3333333333333333,2,2,GACATATTACCTGATTGATG,0,5014164
yjbJ_predicted,0.3333333333333333,2,2,GAATTAGGGATTGCACGTTA,0,5002859
yjbJ_predicted,0.3333333333333333,2,2,GAATTAAGCGGCCCCACGTT,0,5008878
yjbJ_predicted,0.3333333333333333,2,2,GAATCAACACGAGAGGCGGA,0,5021469
yjbJ_predicted,0.3333333333333333,2,2,GAATAGGTGCGGCAGTCGGC,0,5026105
yjbJ_predicted,0.3333333333333333,2,2,GAATACGGTCGGCACTAGCC,0,5014850
yjbJ_predicted,0.3333333333333333,2,2,GAATACCACCCAGTGACGGT,0,4997995
yjbJ_predicted,0.3333333333333333,2,2,GAATAACATCCAGGGGCAGT,0,5028643
yjbJ_predicted,0.3333333333333333,2,2,GAAGGCATGTGTTACTGTTT,0,5012819
yjbJ_predicted,0.3333333333333333,2,2,GAAGCGGTTGAGGTACGCTA,0,5020138
yjbJ_predicted,0.3333333333333333,2,2,GAAGCCGATACCTGAGGAGA,0,5008952
yjbJ_predicted,0.3333333333333333,2,2,GAAGAGAAGAACACTGAGGT,0,5014921
yjbJ_predicted,0.3333333333333333,2,2,GAACTGTGTGAAGCATGATT,0,5015774
yjbJ_predicted,0.3333333333333333,2,2,GAACGGAGCCGCACGTAGAC,0,5029972
yjbJ_predicted,0.3333333333333333,2,2,GAACAAACAGTTTATTTAGA,0,5004595
yjbJ_predicted,0.3333333333333333,2,2,GAAATGAGCGTTCCCGGCAC,0,5020236
yjbJ_predicted,0.3333333333333333,2,2,GAAATATAGGCGGGAGGGAG,0,4998697
yjbJ_predicted,0.3333333333333333,2,2,GAAAGACGGAAATTAGAAGA,0,5013914
yjbJ_predicted,0.3333333333333333,2,2,GAAAAGAAATCTGCTGCCGC,0,5023151
yjbJ_predicted,0.3333333333333333,2,2,GAAAAAGCGTCACGAATAGT,0,5006162
yjbJ_predicted,0.3333333333333333,2,2,CTTTTTCAGAGAGCATCAGT,0,5023565
yjbJ_predicted,0.3333333333333333,2,2,CTTTTTACTTGGACACTACG,0,5005518
yjbJ_predicted,0.3333333333333333,2,2,CTTTTGTGCATAAGTATCGG,0,5031249
yjbJ_predicted,0.3333333333333333,2,2,CTTTTCCAATTGAACGTAGG,0,4997575
yjbJ_predicted,0.3333333333333333,2,2,CTTTCTGTCAACAACCGTCC,0,5027153
yjbJ_predicted,0.3333333333333333,2,2,CTTTAGTGACATAACTTTCC,0,5026665
yjbJ_predicted,0.3333333333333333,2,2,CTTTAATCCGCTGCCCTACT,0,4997011
yjbJ_predicted,0.3333333333333333,2,2,CTTGTAAGCCGTAGCACCAG,0,5027653
yjbJ_predicted,0.3333333333333333,2,2,CTTGCTGGGAATACCTGTCA,0,5013924
yjbJ_predicted,0.3333333333333333,2,2,CTTGATGAGCGCACACTCAA,0,5010794
yjbJ_predicted,0.3333333333333333,2,2,CTTCTGCGGCCAAACGCCAA,0,5025232
yjbJ_predicted,0.3333333333333333,2,2,CTTCTCGCGGGCGGCTGGTA,0,5004513
yjbJ_predicted,0.3333333333333333,2,2,CTTCAGAGCACTAAGTGCAA,0,5001025
yjbJ_predicted,0.3333333333333333,2,2,CTTATGTGTATTTCAGTGCC,0,5011095
yjbJ_predicted,0.3333333333333333,2,2,CTTAGCACTGCTTTATTTGA,0,5017007
yjbJ_predicted,0.3333333333333333,2,2,CTTACCCCGTAGCATCATTA,0,5004947
yjbJ_predicted,0.3333333333333333,2,2,CTTAACTAAGAGTTACTCAA,0,5005228
yjbJ_predicted,0.3333333333333333,2,2,CTTAACCCCCAACCCGATTT,0,5030657
yjbJ_predicted,0.3333333333333333,2,2,CTTAAAGTGGTGCTACACCA,0,5016976
yjbJ_predicted,0.3333333333333333,2,2,CTGTCTGCTCTTGGAGTACA,0,5015770
yjbJ_predicted,0.3333333333333333,2,2,CTGTCTCACGGAGCCCCAGG,0,5015863
yjbJ_predicted,0.3333333333333333,2,2,CTGTCGAGGTATTTGAGGAA,0,4997929
yjbJ_predicted,0.3333333333333333,2,2,CTGTCCTACGATGACAGATC,0,4997899
yjbJ_predicted,0.3333333333333333,2,2,CTGTACCGGGAATGTGATAT,0,5005964
yjbJ_predicted,0.3333333333333333,2,2,CTGGCACGAAAAGACACGGG,0,5029738
yjbJ_predicted,0.3333333333333333,2,2,CTGCGGGAGACTCAACCATA,0,5013088
yjbJ_predicted,0.3333333333333333,2,2,CTGCCCAGGTGGCCAAGCCC,0,5017165
yjbJ_predicted,0.3333333333333333,2,2,CTGCATAACCCACGGCTGTG,0,5015913
yjbJ_predicted,0.3333333333333333,2,2,CTGCAAGCATTACGCCTAGA,0,5027204
yjbJ_predicted,0.3333333333333333,2,2,CTGAGCTTGCTACCCCTAAC,0,5022187
yjbJ_predicted,0.3333333333333333,2,2,CTCTTGTTGGTTTTTGTAAC,0,5023531
yjbJ_predicted,0.3333333333333333,2,2,CTCTTAAACGTGCGTTACGG,0,5017021
yjbJ_predicted,0.3333333333333333,2,2,CTCTGCAAGTTGGCCCAAAG,0,5026545
yjbJ_predicted,0.3333333333333333,2,2,CTCTCTAGATTGACGTGAGA,0,5024303
yjbJ_predicted,0.3333333333333333,2,2,CTCTCATTCGTGGGAACGCA,0,5023114
yjbJ_predicted,0.3333333333333333,2,2,CTCGTTCCCGAGGTTCAGCA,0,5025918
yjbJ_predicted,0.3333333333333333,2,2,CTCGAAATCATTAATGCTGC,0,5029432
yjbJ_predicted,0.3333333333333333,2,2,CTCCGTTGGAGCCTCAAAAA,0,4995254
yjbJ_predicted,0.3333333333333333,2,2,CTCCATAGTTCAGACAGTAA,0,5029458
yjbJ_predicted,0.3333333333333333,2,2,CTCCAGTCACCTCATAAGGT,0,5008487
yjbJ_predicted,0.3333333333333333,2,2,CTCCAGCGTTGTCACCAGGC,0,5017192
yjbJ_predicted,0.3333333333333333,2,2,CTCCACACACCTAGATACGG,0,5021429
yjbJ_predicted,0.3333333333333333,2,2,CTCATCCACGATCAGGAAGG,0,5023570
yjbJ_predicted,0.3333333333333333,2,2,CTCAGCCGTAGCGTCATAAT,0,5023782
yjbJ_predicted,0.3333333333333333,2,2,CTCAGAGCATTTTCTTCGTG,0,5024939
yjbJ_predicted,0.3333333333333333,2,2,CTATTGTTGTATGATGAAGC,0,5009975
yjbJ_predicted,0.3333333333333333,2,2,CTATTATGTGTTCTTGCGAT,0,5018873
yjbJ_predicted,0.3333333333333333,2,2,CTATCCTAGAATTTAGATGG,0,5020847
yjbJ_predicted,0.3333333333333333,2,2,CTATCCAGACTTGCCTAAGC,0,5006089
yjbJ_predicted,0.3333333333333333,2,2,CTATCATCGCATCGTATATT,0,5011997
yjbJ_predicted,0.3333333333333333,2,2,CTATAGATTCGGCCTAAACG,0,5003262
yjbJ_predicted,0.3333333333333333,2,2,CTATAACATAAGATTTAAAT,0,5026546
yjbJ_predicted,0.3333333333333333,2,2,CTAGGCGTCAATTCATGCTA,0,5026703
yjbJ_predicted,0.3333333333333333,2,2,CTAGGAATATGAGGGCTTGA,0,5024901
yjbJ_predicted,0.3333333333333333,2,2,CTAGCGTTACGAAAGCCGTA,0,5003379
yjbJ_predicted,0.3333333333333333,2,2,CTAGCACGCGGTCCACTTAT,0,5002177
yjbJ_predicted,0.3333333333333333,2,2,CTAGCAACTAGCCCCTTCCA,0,5004471
yjbJ_predicted,0.3333333333333333,2,2,CTAGACTACTGCTGTGGCTC,0,5005130
yjbJ_predicted,0.3333333333333333,2,2,CTACTCCAGATAGTTTCCCT,0,5029585
yjbJ_predicted,0.3333333333333333,2,2,CTACGGTCCCCTCTGCGTGA,0,5022566
yjbJ_predicted,0.3333333333333333,2,2,CTACCTCCAACCCCCCACCC,0,4996127
yjbJ_predicted,0.3333333333333333,2,2,CTACCCCCGCTCGCAGCGGT,0,5002392
yjbJ_predicted,0.3333333333333333,2,2,CTACAAAGAGCCGATTCTAT,0,5018307
yjbJ_predicted,0.3333333333333333,2,2,CTAATAGCTTTTCGCTGTAC,0,5029687
yjbJ_predicted,0.3333333333333333,2,2,CTAAGCTTATCGTGGTTCAC,0,5006579
yjbJ_predicted,0.3333333333333333,2,2,CTAACAGATGTCACTCTCCC,0,4997452
yjbJ_predicted,0.3333333333333333,2,2,CTAAATGATGCCAAGGTTAA,0,5010027
yjbJ_predicted,0.3333333333333333,2,2,CGTTTTGAAGCGTACTACAC,0,5001944
yjbJ_predicted,0.3333333333333333,2,2,CGTTGTTGGTAACAGGGACC,0,5018065
yjbJ_predicted,0.3333333333333333,2,2,CGTTGAGTAAATCAACCCAA,0,5030162
yjbJ_predicted,0.3333333333333333,2,2,CGTTAGGGTACCGCACGGAA,0,5015980
yjbJ_predicted,0.3333333333333333,2,2,CGTTAGATGCGATGGATCTC,0,5004370
yjbJ_predicted,0.3333333333333333,2,2,CGTGTCTCTGCGGGAGGCCC,0,5024663
yjbJ_predicted,0.3333333333333333,2,2,CGTGTAGATGGGGCGAGGGA,0,5011871
yjbJ_predicted,0.3333333333333333,2,2,CGTGGCTTGCGTAATATAGA,0,4996861
yjbJ_predicted,0.3333333333333333,2,2,CGTGCCGTTGTAGTCCCGAA,0,5010630
yjbJ_predicted,0.3333333333333333,2,2,CGTGCATCCGATTAGGTCAG,0,5014523
yjbJ_predicted,0.3333333333333333,2,2,CGTCTACTCTAAGAAGTAAT,0,4995757
yjbJ_predicted,0.3333333333333333,2,2,CGTCTAAGTTGCGTCCTTTT,0,5019106
yjbJ_predicted,0.3333333333333333,2,2,CGTCGTTTCAACCTGCACCA,0,5005142
yjbJ_predicted,0.3333333333333333,2,2,CGTATGCGCATAAGTTCCAA,0,5002409
yjbJ_predicted,0.3333333333333333,2,2,CGTAGTGTATTTCGTCGCGA,0,5000386
yjbJ_predicted,0.3333333333333333,2,2,CGTACGCGCCGGCCAAGATC,0,5014015
yjbJ_predicted,0.3333333333333333,2,2,CGTAATCTATTGCAAACTAC,0,5007511
yjbJ_predicted,0.3333333333333333,2,2,CGTAAGCTATTCTTTACAAT,0,5028430
yjbJ_predicted,0.3333333333333333,2,2,CGTAAGCCCCTCTACCGACG,0,5024639
yjbJ_predicted,0.3333333333333333,2,2,CGGTGGTCGTCTGACGACAG,0,5013792
yjbJ_predicted,0.3333333333333333,2,2,CGGTGCTAAGTGTAATGTTA,0,5000343
yjbJ_predicted,0.3333333333333333,2,2,CGGTCTGGCCGCGGGATCTT,0,5013685
yjbJ_predicted,0.3333333333333333,2,2,CGGTCTCCAACGGCTTGCCG,0,4995857
yjbJ_predicted,0.3333333333333333,2,2,CGGTAGACATGTACAAGACA,0,5005310
yjbJ_predicted,0.3333333333333333,2,2,CGGGCCGGGTCGTTGTGAGG,0,5015412
yjbJ_predicted,0.3333333333333333,2,2,CGGGCATGCGCAACGGTTAC,0,5026754
yjbJ_predicted,0.3333333333333333,2,2,CGGGAGTTGAAAGAAGGAGA,0,5007246
yjbJ_predicted,0.3333333333333333,2,2,CGGCGGACGAAACTCAGCGG,0,4999247
yjbJ_predicted,0.3333333333333333,2,2,CGGATGGGACAAGGTGTGAA,0,5004493
yjbJ_predicted,0.3333333333333333,2,2,CGGACACTCTGGCCAGTCAT,0,5015635
yjbJ_predicted,0.3333333333333333,2,2,CGGAAGCGTTATGTTAGGGT,0,5006226
yjbJ_predicted,0.3333333333333333,2,2,CGGAAAAAAGGAGTGCGTGT,0,5028590
yjbJ_predicted,0.3333333333333333,2,2,CGCTCGAAGGTCTCATTGGA,0,5018807
yjbJ_predicted,0.3333333333333333,2,2,CGCGTTCACGGGCCTTTTAT,0,4996578
yjbJ_predicted,0.3333333333333333,2,2,CGCGCGTCTCTCATTCCTAC,0,5016445
yjbJ_predicted,0.3333333333333333,2,2,CGCGCCTGTCCGCAGCAAGG,0,5027799
yjbJ_predicted,0.3333333333333333,2,2,CGCGATCTACGGTGAGACGT,0,5017725
yjbJ_predicted,0.3333333333333333,2,2,CGCCTCCGAGCTAGGAATAC,0,5010879
yjbJ_predicted,0.3333333333333333,2,2,CGCCTATTTAAGTAAGCGTA,0,5023861
yjbJ_predicted,0.3333333333333333,2,2,CGCCGCTGTCGAAGACAGTG,0,5025570
yjbJ_predicted,0.3333333333333333,2,2,CGCCCCGGGACTTGCAAAAG,0,5007977
yjbJ_predicted,0.3333333333333333,2,2,CGCCCACTCGGACCAGTGAC,0,5029673
yjbJ_predicted,0.3333333333333333,2,2,CGCCAGCTCATAAAGTCCAG,0,5028680
yjbJ_predicted,0.3333333333333333,2,2,CGCCAGAACCTGAGACCTCA,0,5026958
yjbJ_predicted,0.3333333333333333,2,2,CGCCAACGACGCAAGTGGCT,0,5017563
yjbJ_predicted,0.3333333333333333,2,2,CGCATGCCACCGCATTCGAC,0,5025184
yjbJ_predicted,0.3333333333333333,2,2,CGCATACGAGCTAAATGAAC,0,5020180
yjbJ_predicted,0.3333333333333333,2,2,CGCACTAATATCACAATAGT,0,5013237
yjbJ_predicted,0.3333333333333333,2,2,CGCAAAAATAACGGGCTGAT,0,5024344
yjbJ_predicted,0.3333333333333333,2,2,CGATCGGTAAGGTTCAAGGT,0,5011589
yjbJ_predicted,0.3333333333333333,2,2,CGATCCCCTAACGTCGAGGG,0,5024911
yjbJ_predicted,0.3333333333333333,2,2,CGATCAGCAAGGCTTCCAGT,0,5022308
yjbJ_predicted,0.3333333333333333,2,2,CGAGTTCTCTATATCCGTGA,0,5012171
yjbJ_predicted,0.3333333333333333,2,2,CGAGGGTATCAAAAGACGGG,0,5029768
yjbJ_predicted,0.3333333333333333,2,2,CGAGGCAGTGTTAAAATATT,0,4997851
yjbJ_predicted,0.3333333333333333,2,2,CGAGGCACCCTCTACCCAGG,0,5019335
yjbJ_predicted,0.3333333333333333,2,2,CGAGCATAGGGACTAGAGGT,0,5008563
yjbJ_predicted,0.3333333333333333,2,2,CGACTCAAACAACCGGGGTC,0,5001959
yjbJ_predicted,0.3333333333333333,2,2,CGACCCCAGAGTAAGGACGA,0,5007085
yjbJ_predicted,0.3333333333333333,2,2,CGACACGATACATCTCTCTC,0,4998977
yjbJ_predicted,0.3333333333333333,2,2,CGAATTAGGATTTAAGAACC,0,4997974
yjbJ_predicted,0.3333333333333333,2,2,CGAAAGCAACCGGAATGGTA,0,5018080
yjbJ_predicted,0.3333333333333333,2,2,CCTTTGGTCCGCGAGTTCTA,0,5023084
yjbJ_predicted,0.3333333333333333,2,2,CCTTTGGAAAGTCAATCAAC,0,5018939
yjbJ_predicted,0.3333333333333333,2,2,CCTTTGATATGTCCTAGACA,0,5001576
yjbJ_predicted,0.3333333333333333,2,2,CCTTTAGGCTGTTAGCGGGG,0,5022180
yjbJ_predicted,0.3333333333333333,2,2,CCTTTACAACCGGGAGAATT,0,5022559
yjbJ_predicted,0.3333333333333333,2,2,CCTTGCGTTAACTCATCGTC,0,5026440
yjbJ_predicted,0.3333333333333333,2,2,CCTTCTTCCCTGCCGTTGCA,0,5012316
yjbJ_predicted,0.3333333333333333,2,2,CCTTCAGCAGCAAGTGCGGC,0,5030929
yjbJ_predicted,0.3333333333333333,2,2,CCTGGATGCCGCTTGCCAAA,0,5003770
yjbJ_predicted,0.3333333333333333,2,2,CCTGCTACCCCAGGACCCAT,0,5009354
yjbJ_predicted,0.3333333333333333,2,2,CCTGATTCGATGGACGCAGT,0,5000124
yjbJ_predicted,0.3333333333333333,2,2,CCTGACGAGCCACTTTAAAG,0,5000625
yjbJ_predicted,0.3333333333333333,2,2,CCTCGGCTCCTAATGGCTAA,0,5022632
yjbJ_predicted,0.3333333333333333,2,2,CCTCGCGTCTGTGATCAGTC,0,5003357
yjbJ_predicted,0.3333333333333333,2,2,CCTCGAGCCCCTGCCGAAAG,0,5001146
yjbJ_predicted,0.3333333333333333,2,2,CCTCCCGAATAGTTCCGTGA,0,4998691
yjbJ_predicted,0.3333333333333333,2,2,CCTCCAGCAACGCAGCTTTG,0,4995498
yjbJ_predicted,0.3333333333333333,2,2,CCTACATTTGGGTTGCACAT,0,5026544
yjbJ_predicted,0.3333333333333333,2,2,CCTAAGGATCATGAAATGCA,0,5013118
yjbJ_predicted,0.3333333333333333,2,2,CCTAAATTTTTACTTAGTGA,0,5026843
yjbJ_predicted,0.3333333333333333,2,2,CCGTTTGTTCGATTCCGACG,0,5031000
yjbJ_predicted,0.3333333333333333,2,2,CCGTTGGATTAGTAGGGTAC,0,5004190
yjbJ_predicted,0.3333333333333333,2,2,CCGTGCGCCAACTAAAAACT,0,5012741
yjbJ_predicted,0.3333333333333333,2,2,CCGTGAGATGTCGAATGACT,0,5006186
yjbJ_predicted,0.3333333333333333,2,2,CCGTCCTATTGGGCAGGCTA,0,5030054
yjbJ_predicted,0.3333333333333333,2,2,CCGTCACGGAGTTTGGAGTA,0,5014158
yjbJ_predicted,0.3333333333333333,2,2,CCGGGCATTCAGGTAGTGTC,0,4999484
yjbJ_predicted,0.3333333333333333,2,2,CCGGCTTAGGAATTGCGAGT,0,5016295
yjbJ_predicted,0.3333333333333333,2,2,CCGGCCAAGGTGCCCAATCG,0,4996307
yjbJ_predicted,0.3333333333333333,2,2,CCGCCGCAACGCATTGTAAT,0,5009164
yjbJ_predicted,0.3333333333333333,2,2,CCGCCGACGCATAACATTAA,0,5020172
yjbJ_predicted,0.3333333333333333,2,2,CCGCCCATGCGTTCGCTTTG,0,5016538
yjbJ_predicted,0.3333333333333333,2,2,CCGCCAGAGAGATAACACTC,0,5017309
yjbJ_predicted,0.3333333333333333,2,2,CCGCAAGACGCGCACGTCCC,0,5010121
yjbJ_predicted,0.3333333333333333,2,2,CCGATTGTATGGGCTTTCCC,0,5013898
yjbJ_predicted,0.3333333333333333,2,2,CCGACCCCGGCTGAGCCGGG,0,5026992
yjbJ_predicted,0.3333333333333333,2,2,CCGAAGAGGAGTAAGTCAAA,0,5011030
yjbJ_predicted,0.3333333333333333,2,2,CCCTGGCGGCCCACTTTGGG,0,5015017
yjbJ_predicted,0.3333333333333333,2,2,CCCTCCATTCGAAGGAATCA,0,5013385
yjbJ_predicted,0.3333333333333333,2,2,CCCGTGTGGCTACGTGACTC,0,4999146
yjbJ_predicted,0.3333333333333333,2,2,CCCGTCCGGCCCGCTGAATA,0,5015154
yjbJ_predicted,0.3333333333333333,2,2,CCCGGCCACCCTACTACATA,0,4996704
yjbJ_predicted,0.3333333333333333,2,2,CCCGGATCAGGCGTCTCTTT,0,5010002
yjbJ_predicted,0.3333333333333333,2,2,CCCGCGGGCCGTGGCACGGT,0,5005123
yjbJ_predicted,0.3333333333333333,2,2,CCCGCCAGATGGAACCCGAG,0,5024029
yjbJ_predicted,0.3333333333333333,2,2,CCCGACCAGCCGAATTTGGG,0,5013988
yjbJ_predicted,0.3333333333333333,2,2,CCCCGTATCTCACTGGCCCC,0,5011456
yjbJ_predicted,0.3333333333333333,2,2,CCCCCGTCACCAGTATATCA,0,4996918
yjbJ_predicted,0.3333333333333333,2,2,CCCCAGGCCAGCCCCTTTAT,0,5000566
yjbJ_predicted,0.3333333333333333,2,2,CCCAGGTCCATTTATGCAGT,0,5023560
yjbJ_predicted,0.3333333333333333,2,2,CCCAGAGACTCAGCGCGACG,0,5014046
yjbJ_predicted,0.3333333333333333,2,2,CCATTCGCGTCGGACGTCTA,0,4996632
yjbJ_predicted,0.3333333333333333,2,2,CCATGGATCTGTCTCTCTTG,0,5001779
yjbJ_predicted,0.3333333333333333,2,2,CCATGCGGTGTACTGCTGCA,0,5014244
yjbJ_predicted,0.3333333333333333,2,2,CCATCGCAATCAATAGAAGA,0,5013074
yjbJ_predicted,0.3333333333333333,2,2,CCAGTGGCGCAATGTAACTT,0,5015656
yjbJ_predicted,0.3333333333333333,2,2,CCAGTCTAGTGTGGGACCAT,0,5029281
yjbJ_predicted,0.3333333333333333,2,2,CCAGGTTAGTTCAGTTATAG,0,5024721
yjbJ_predicted,0.3333333333333333,2,2,CCAGGTAAAGCGCCTAACAA,0,5002220
yjbJ_predicted,0.3333333333333333,2,2,CCAGCTCCCAACCAAGTCCA,0,5030560
yjbJ_predicted,0.3333333333333333,2,2,CCAGCCCTGATAAGGTCATA,0,5028273
yjbJ_predicted,0.3333333333333333,2,2,CCAGAGCAATGCAGTTATGT,0,5027175
yjbJ_predicted,0.3333333333333333,2,2,CCAGACGCTCTGCGCATGGT,0,5000777
yjbJ_predicted,0.3333333333333333,2,2,CCAGACAAGTGGATCGGAGG,0,5026976
yjbJ_predicted,0.3333333333333333,2,2,CCAGAAGACTCGAGTGTGCG,0,5031057
yjbJ_predicted,0.3333333333333333,2,2,CCACTTACCTACTGGGAATT,0,5009349
yjbJ_predicted,0.3333333333333333,2,2,CCACGTTGGAGTAGGTCAGA,0,5003978
yjbJ_predicted,0.3333333333333333,2,2,CCACGCTTCCTACTCAAGCA,0,5021021
yjbJ_predicted,0.3333333333333333,2,2,CCACGAATTAGGCATGACGC,0,5027306
yjbJ_predicted,0.3333333333333333,2,2,CCACCCTCCAACAACTGGCA,0,5000327
yjbJ_predicted,0.3333333333333333,2,2,CCACCAGCATGGGCAGCCGA,0,5013490
yjbJ_predicted,0.3333333333333333,2,2,CCACAAATGCCTCCGTGAGG,0,5012795
yjbJ_predicted,0.3333333333333333,2,2,CCAATTATGGGCTTGTCCGC,0,5027854
yjbJ_predicted,0.3333333333333333,2,2,CCAATAAGTAGGATTAAGGA,0,5026060
yjbJ_predicted,0.3333333333333333,2,2,CCAAGGACATGTTAGGTACG,0,5014804
yjbJ_predicted,0.3333333333333333,2,2,CCAACGCCGAAGTACTATCC,0,5013377
yjbJ_predicted,0.3333333333333333,2,2,CCAACCTCCGTGTACAGGGT,0,5023099
yjbJ_predicted,0.3333333333333333,2,2,CCAAATCCCACTAGGCTGTA,0,4999713
yjbJ_predicted,0.3333333333333333,2,2,CCAAAGTGCCGGTGTATTCC,0,4999970
yjbJ_predicted,0.3333333333333333,2,2,CCAAAGCAAACCAGCCGAGA,0,5012936
yjbJ_predicted,0.3333333333333333,2,2,CCAAACGTCATTTCTCGCGT,0,5018908
yjbJ_predicted,0.3333333333333333,2,2,CATTTTGTTTTTATAGCAAT,0,5005087
yjbJ_predicted,0.3333333333333333,2,2,CATTTGAACATATGTTAGTC,0,5019062
yjbJ_predicted,0.3333333333333333,2,2,CATTGGGTCACGCATCAATG,0,5001311
yjbJ_predicted,0.3333333333333333,2,2,CATTGACGGACGCCAGAATC,0,5018332
yjbJ_predicted,0.3333333333333333,2,2,CATTCTATTCTCCTTTCGGT,0,4998077
yjbJ_predicted,0.3333333333333333,2,2,CATTATTCGTGGAATGTCTC,0,5005632
yjbJ_predicted,0.3333333333333333,2,2,CATTAGTGTTGATGCCTTTC,0,4997143
yjbJ_predicted,0.3333333333333333,2,2,CATTACCGGAGCGCCTACGC,0,5021869
yjbJ_predicted,0.3333333333333333,2,2,CATGTTGCCTGTCGAAAAAC,0,5003341
yjbJ_predicted,0.3333333333333333,2,2,CATGTCCCACTCCGGCGATC,0,5021900
yjbJ_predicted,0.3333333333333333,2,2,CATGCTAACAACACAAAGAT,0,5013335
yjbJ_predicted,0.3333333333333333,2,2,CATGCGTACCAAGGATATAC,0,5019041
yjbJ_predicted,0.3333333333333333,2,2,CATGCATTTCCGATTCCCTA,0,5015825
yjbJ_predicted,0.3333333333333333,2,2,CATCGTTAATGACAAGAATG,0,5006862
yjbJ_predicted,0.3333333333333333,2,2,CATCAACATTGACACCCGGA,0,5019204
yjbJ_predicted,0.3333333333333333,2,2,CATAGGGTTTTGTTTCCAGG,0,5005542
yjbJ_predicted,0.3333333333333333,2,2,CATACCCCCCTTTTCTTGTA,0,5007083
yjbJ_predicted,0.3333333333333333,2,2,CATACAGCAGGCCTCTGCAC,0,5010575
yjbJ_predicted,0.3333333333333333,2,2,CATAACCCTAAAATCTGTTT,0,5022276
yjbJ_predicted,0.3333333333333333,2,2,CAGTTTACTCCAGGGTCGAT,0,4998465
yjbJ_predicted,0.3333333333333333,2,2,CAGTTCGTTGAAAGACACCG,0,5018798
yjbJ_predicted,0.3333333333333333,2,2,CAGTTAAGTGATAAGGACTA,0,5030034
yjbJ_predicted,0.3333333333333333,2,2,CAGTGTTACCCAGCCCCGCC,0,5017732
yjbJ_predicted,0.3333333333333333,2,2,CAGTGTGGTGTTGTCAGAAG,0,5014100
yjbJ_predicted,0.3333333333333333,2,2,CAGTCGCGTATAGGGTGTGA,0,5012437
yjbJ_predicted,0.3333333333333333,2,2,CAGTCCTGCATGCCCATCTA,0,5029770
yjbJ_predicted,0.3333333333333333,2,2,CAGGTTCTAAACACGATATT,0,5010694
yjbJ_predicted,0.3333333333333333,2,2,CAGGTGCGGGGGCTTGTCGA,0,5020190
yjbJ_predicted,0.3333333333333333,2,2,CAGGTAGCATGTGTGGAGCC,0,5001919
yjbJ_predicted,0.3333333333333333,2,2,CAGGGCCTTGGGCGTGCACT,0,5022695
yjbJ_predicted,0.3333333333333333,2,2,CAGCTCACCTTTTGATGAGG,0,5004021
yjbJ_predicted,0.3333333333333333,2,2,CAGCGTCGAGTAGTATTTGT,0,5014032
yjbJ_predicted,0.3333333333333333,2,2,CAGCGGCGAATCATTCCTGG,0,5009681
yjbJ_predicted,0.3333333333333333,2,2,CAGCCTAGCCCCCCTACTAC,0,5005414
yjbJ_predicted,0.3333333333333333,2,2,CAGCATAGAAGATGCCCGTC,0,5022389
yjbJ_predicted,0.3333333333333333,2,2,CAGCATACTGATGGTATAAT,0,5022492
yjbJ_predicted,0.3333333333333333,2,2,CAGCACCGCCCAGTGTTTAT,0,5008767
yjbJ_predicted,0.3333333333333333,2,2,CAGCAACGATTCCTCAGCGT,0,5009796
yjbJ_predicted,0.3333333333333333,2,2,CAGACCGGTGTGCTAACTTA,0,5009705
yjbJ_predicted,0.3333333333333333,2,2,CAGAACCCGGGGCGCAAACG,0,5001219
yjbJ_predicted,0.3333333333333333,2,2,CACTGTTTGCGCAGCATAAT,0,5013709
yjbJ_predicted,0.3333333333333333,2,2,CACTGTCGCAGCGACGGCAT,0,5010384
yjbJ_predicted,0.3333333333333333,2,2,CACTCGTTGTCAGTGCCCAC,0,5005380
yjbJ_predicted,0.3333333333333333,2,2,CACTCATACGTCAGCTACAG,0,5015506
yjbJ_predicted,0.3333333333333333,2,2,CACGTACGTACATGATATAC,0,5027505
yjbJ_predicted,0.3333333333333333,2,2,CACGGAGCACTGCCGACGCG,0,5025501
yjbJ_predicted,0.3333333333333333,2,2,CACCTGACTGGTTCCGGAGA,0,5022618
yjbJ_predicted,0.3333333333333333,2,2,CACCGACATGGTGTCAATGT,0,4996803
yjbJ_predicted,0.3333333333333333,2,2,CACCCCCTACCCCATGGATG,0,5016027
yjbJ_predicted,0.3333333333333333,2,2,CACCACCGGAACCCGGTTCA,0,5011660
yjbJ_predicted,0.3333333333333333,2,2,CACCAATCATTATCGACTTC,0,5005321
yjbJ_predicted,0.3333333333333333,2,2,CACATTGCCACGTGCCTCGT,0,5018509
yjbJ_predicted,0.3333333333333333,2,2,CACAGGGGTATGCTTTCTCG,0,4997901
yjbJ_predicted,0.3333333333333333,2,2,CACAGGATGACTACGTAGAC,0,5019369
yjbJ_predicted,0.3333333333333333,2,2,CACACTTATGTGGGAAGAGG,0,4994783
yjbJ_predicted,0.3333333333333333,2,2,CAATTTCCAGCCTGCTCAAG,0,5014407
yjbJ_predicted,0.3333333333333333,2,2,CAATGTTCAGTACGCGCTAA,0,5022508
yjbJ_predicted,0.3333333333333333,2,2,CAATAGTTCCCAAGCTAACT,0,5003488
yjbJ_predicted,0.3333333333333333,2,2,CAAGGCGGCCTTATTCCCTT,0,5009273
yjbJ_predicted,0.3333333333333333,2,2,CAAGGCAACGGAAATTACAG,0,5006263
yjbJ_predicted,0.3333333333333333,2,2,CAAGGATGCTGGTCACGGGA,0,5018655
yjbJ_predicted,0.3333333333333333,2,2,CAAGGAATGACAGACCCAGA,0,5022106
yjbJ_predicted,0.3333333333333333,2,2,CAACTGCAATATACAAGTCG,0,5028996
yjbJ_predicted,0.3333333333333333,2,2,CAACTAAGGAGCACCGGTAG,0,5002777
yjbJ_predicted,0.3333333333333333,2,2,CAACGGGACCTATTTCACTG,0,4999705
yjbJ_predicted,0.3333333333333333,2,2,CAACATTAAACTGCGACCCT,0,5020179
yjbJ_predicted,0.3333333333333333,2,2,CAAACTTCGTTTCTCTGCAA,0,5027707
yjbJ_predicted,0.3333333333333333,2,2,CAAAATTCGTTTGTTCATCT,0,5013722
yjbJ_predicted,0.3333333333333333,2,2,ATTTGCCTGAGCACGCCTGT,0,4996753
yjbJ_predicted,0.3333333333333333,2,2,ATTTCGTCAAGCGAAAGACG,0,5014705
yjbJ_predicted,0.3333333333333333,2,2,ATTTAAAAGTTCTACGCAGT,0,4995073
yjbJ_predicted,0.3333333333333333,2,2,ATTGTGTTGGCACCCCGCTG,0,5012860
yjbJ_predicted,0.3333333333333333,2,2,ATTGTAGGACCCTTGCTGTA,0,4995306
yjbJ_predicted,0.3333333333333333,2,2,ATTGTACCACCACATCCTGA,0,5001982
yjbJ_predicted,0.3333333333333333,2,2,ATTGTACACATTCGCCACGG,0,5008444
yjbJ_predicted,0.3333333333333333,2,2,ATTGGATAACCGCACCGCTC,0,4999277
yjbJ_predicted,0.3333333333333333,2,2,ATTGAGGCAGTTCTAGCTGT,0,5006039
yjbJ_predicted,0.3333333333333333,2,2,ATTGAGGAATACAACAGTTT,0,5013604
yjbJ_predicted,0.3333333333333333,2,2,ATTCTGAGATCCGGTTTACA,0,4998795
yjbJ_predicted,0.3333333333333333,2,2,ATTCCTCTTTAGATACTGGG,0,5023743
yjbJ_predicted,0.3333333333333333,2,2,ATTCAGCTTGTTAGTGTACA,0,5002819
yjbJ_predicted,0.3333333333333333,2,2,ATTCACGCGCCAGAGGATCA,0,4996176
yjbJ_predicted,0.3333333333333333,2,2,ATTATACCTTCCAGCACCCT,0,5003178
yjbJ_predicted,0.3333333333333333,2,2,ATTAGGTTTAGCCATGGCTC,0,5007859
yjbJ_predicted,0.3333333333333333,2,2,ATGTGCCGAACCGTGTTCTA,0,5025969
yjbJ_predicted,0.3333333333333333,2,2,ATGTCGCATTTGGACATAGT,0,5013491
yjbJ_predicted,0.3333333333333333,2,2,ATGTCATAGATGACTGGCGC,0,5030817
yjbJ_predicted,0.3333333333333333,2,2,ATGTCAGCCTTAGCAAAGGC,0,5005021
yjbJ_predicted,0.3333333333333333,2,2,ATGTAACATACCTCAGATGC,0,5014234
yjbJ_predicted,0.3333333333333333,2,2,ATGGTGATAGTATGTTCTAT,0,5029659
yjbJ_predicted,0.3333333333333333,2,2,ATGGTCAACTTAATCCTAGG,0,5026223
yjbJ_predicted,0.3333333333333333,2,2,ATGGCACAGCCAGATGCCAT,0,5018736
yjbJ_predicted,0.3333333333333333,2,2,ATGCCACAACACGATTTCGC,0,4998695
yjbJ_predicted,0.3333333333333333,2,2,ATGATGTTTACCGCCTCTCG,0,4999218
yjbJ_predicted,0.3333333333333333,2,2,ATGAGAGCCACGCGGTATTT,0,5005811
yjbJ_predicted,0.3333333333333333,2,2,ATGAGACTTACGCGAGGTTC,0,5011755
yjbJ_predicted,0.3333333333333333,2,2,ATGAATGTTGACAGGAAGGT,0,5019756
yjbJ_predicted,0.3333333333333333,2,2,ATCTGTACTATTTCAAGGAC,0,5029982
yjbJ_predicted,0.3333333333333333,2,2,ATCTGGAGGTAGTAAGTTGC,0,5010461
yjbJ_predicted,0.3333333333333333,2,2,ATCTCTTATAAATAGTGCGC,0,5001673
yjbJ_predicted,0.3333333333333333,2,2,ATCTCTATCAGCTGATTCAC,0,5025067
yjbJ_predicted,0.3333333333333333,2,2,ATCTATTCTGTCGCTGGCGA,0,5021933
yjbJ_predicted,0.3333333333333333,2,2,ATCGTGTTTGCCAGCGTCGT,0,5021044
yjbJ_predicted,0.3333333333333333,2,2,ATCGTGTTTATGGCCGCACT,0,5004540
yjbJ_predicted,0.3333333333333333,2,2,ATCGTGGGGCTTGCGTTGTT,0,5019743
yjbJ_predicted,0.3333333333333333,2,2,ATCGCTAGGTACTATGGGCC,0,4997984
yjbJ_predicted,0.3333333333333333,2,2,ATCGCACATGACTACACTTC,0,5003204
yjbJ_predicted,0.3333333333333333,2,2,ATCGACTCATGCGGACGGTT,0,5012886
yjbJ_predicted,0.3333333333333333,2,2,ATCCTTCGTTCCCCTAGTCA,0,4995776
yjbJ_predicted,0.3333333333333333,2,2,ATCCCTCTACCGAATTCCGG,0,5014095
yjbJ_predicted,0.3333333333333333,2,2,ATCCCCGACTTCACACAATC,0,5019747
yjbJ_predicted,0.3333333333333333,2,2,ATCATGTTCATCCAGCTTAC,0,5016270
yjbJ_predicted,0.3333333333333333,2,2,ATCATACTACAGGTTCAGTT,0,4998210
yjbJ_predicted,0.3333333333333333,2,2,ATCACTGGGGTAGCTAATGC,0,5012065
yjbJ_predicted,0.3333333333333333,2,2,ATCAATCAGCGGTTCAAGCA,0,5014960
yjbJ_predicted,0.3333333333333333,2,2,ATATTCGAGTTATTACCGCT,0,5004014
yjbJ_predicted,0.3333333333333333,2,2,ATATTACACAGTACTGTCTG,0,5005460
yjbJ_predicted,0.3333333333333333,2,2,ATATCAGGTCTTTTGATATG,0,5003927
yjbJ_predicted,0.3333333333333333,2,2,ATATATTTCCAAGGTGGAAT,0,5009897
yjbJ_predicted,0.3333333333333333,2,2,ATATATGAGATCCTTTTAAA,0,5012151
yjbJ_predicted,0.3333333333333333,2,2,ATATACATTCTTTAGTAACC,0,5014179
yjbJ_predicted,0.3333333333333333,2,2,ATAGTAGTGCAAGTTATTCA,0,5010868
yjbJ_predicted,0.3333333333333333,2,2,ATAGATTGGAGGCCACGAGG,0,5004985
yjbJ_predicted,0.3333333333333333,2,2,ATAGAGTTGAAAAGATCGGC,0,5027931
yjbJ_predicted,0.3333333333333333,2,2,ATAGAGGGACAATCGTTGAT,0,5017128
yjbJ_predicted,0.3333333333333333,2,2,ATACTTATTGCTGTGAGTAT,0,5010012
yjbJ_predicted,0.3333333333333333,2,2,ATACTGTTCTCCAGTGTACA,0,4996474
yjbJ_predicted,0.3333333333333333,2,2,ATACGCAAAGGCAAGTAGCT,0,5024180
yjbJ_predicted,0.3333333333333333,2,2,ATACATTGACGGTCCTGATC,0,5012433
yjbJ_predicted,0.3333333333333333,2,2,ATACACGTTGAGGCTGCCAT,0,5012406
yjbJ_predicted,0.3333333333333333,2,2,ATAATGAATGCCATCTCAAC,0,5014702
yjbJ_predicted,0.3333333333333333,2,2,ATAATCAAGCTTTCACATGC,0,5013205
yjbJ_predicted,0.3333333333333333,2,2,ATAAGGGGTATTACGGGAAA,0,5012401
yjbJ_predicted,0.3333333333333333,2,2,ATAAGCCTTTGTCTCGTTGA,0,5021884
yjbJ_predicted,0.3333333333333333,2,2,ATAACGTACATGGCATAGAG,0,5027015
yjbJ_predicted,0.3333333333333333,2,2,ATAAAGAACGGAATAGACTG,0,5014765
yjbJ_predicted,0.3333333333333333,2,2,AGTTTCATTCCTTCTACTAG,0,5016890
yjbJ_predicted,0.3333333333333333,2,2,AGTTGAGATAGTGGGCCAGA,0,5016573
yjbJ_predicted,0.3333333333333333,2,2,AGTTGAACCATACGTTTTTA,0,5014484
yjbJ_predicted,0.3333333333333333,2,2,AGTTCAGCGCGGAGCAAGGT,0,5011132
yjbJ_predicted,0.3333333333333333,2,2,AGTGTTTATAGTTACTGAAT,0,5019454
yjbJ_predicted,0.3333333333333333,2,2,AGTGTCTAAATTTGCAATTA,0,5028785
yjbJ_predicted,0.3333333333333333,2,2,AGTGATAAGAACGTGGAACA,0,4994686
yjbJ_predicted,0.3333333333333333,2,2,AGTCGTTAACTGCTACAAAA,0,5007507
yjbJ_predicted,0.3333333333333333,2,2,AGTCGGTAAGTGCATTGTGG,0,5024269
yjbJ_predicted,0.3333333333333333,2,2,AGTCGCCCATCCAATTGTCA,0,5018371
yjbJ_predicted,0.3333333333333333,2,2,AGTATGCAAGCATCGACGAG,0,5024136
yjbJ_predicted,0.3333333333333333,2,2,AGTAGGTCTCCCCCTGAAGT,0,5005752
yjbJ_predicted,0.3333333333333333,2,2,AGTAGGCCAGCCCGTCACGC,0,5001812
yjbJ_predicted,0.3333333333333333,2,2,AGTAGCGCATGGGATATACG,0,5005179
yjbJ_predicted,0.3333333333333333,2,2,AGTAGCATTTCGGCCCGTCT,0,5004379
yjbJ_predicted,0.3333333333333333,2,2,AGTAAATGTTTGAAACGGTC,0,5001028
yjbJ_predicted,0.3333333333333333,2,2,AGGTTGTTAGTGCCATTCGA,0,4994877
yjbJ_predicted,0.3333333333333333,2,2,AGGTTGATACGGCCGCGGAA,0,5024073
yjbJ_predicted,0.3333333333333333,2,2,AGGTGTATTTTGTTCCATAC,0,5014339
yjbJ_predicted,0.3333333333333333,2,2,AGGTGCGGACCCGTCTGTCC,0,5019017
yjbJ_predicted,0.3333333333333333,2,2,AGGTGAAACCCAGATCTGGC,0,5005800
yjbJ_predicted,0.3333333333333333,2,2,AGGTAGCGCTTTCACTAAAT,0,5028052
yjbJ_predicted,0.3333333333333333,2,2,AGGTACATGATTTTTAAGCC,0,5013258
yjbJ_predicted,0.3333333333333333,2,2,AGGTAACGGCCGGCACGCGA,0,5023676
yjbJ_predicted,0.3333333333333333,2,2,AGGGTGGTTTATGAACGCAT,0,5010613
yjbJ_predicted,0.3333333333333333,2,2,AGGGGTTACTGGCACCTTAC,0,5017361
yjbJ_predicted,0.3333333333333333,2,2,AGGGAGCCCTTGCTAACGGC,0,5012537
yjbJ_predicted,0.3333333333333333,2,2,AGGGAGAGGGTAGCGCGTCA,0,5011328
yjbJ_predicted,0.3333333333333333,2,2,AGGGACGACGTATATGGCCA,0,4998791
yjbJ_predicted,0.3333333333333333,2,2,AGGGAATGCTTTGCCACAGT,0,5020534
yjbJ_predicted,0.3333333333333333,2,2,AGGCTAACCGCCGGTCTGCA,0,5019980
yjbJ_predicted,0.3333333333333333,2,2,AGGCCTGTAGGACTGTGAAT,0,5016618
yjbJ_predicted,0.3333333333333333,2,2,AGGCATAACCCCTAGTGCTT,0,5001027
yjbJ_predicted,0.3333333333333333,2,2,AGGCACGTGCGGGGTACACT,0,4999837
yjbJ_predicted,0.3333333333333333,2,2,AGGATAGCCCTTCGCGAATC,0,5019950
yjbJ_predicted,0.3333333333333333,2,2,AGCTGTTTTCACTTGCAGTT,0,5018108
yjbJ_predicted,0.3333333333333333,2,2,AGCTGTCAAGCCCATGCGGC,0,5020834
yjbJ_predicted,0.3333333333333333,2,2,AGCTGGCCATTTTACAAGGA,0,5025104
yjbJ_predicted,0.3333333333333333,2,2,AGCTAAGTACAGTGGACGCC,0,5009058
yjbJ_predicted,0.3333333333333333,2,2,AGCGTGTGAGACGAGCTCTA,0,5022321
yjbJ_predicted,0.3333333333333333,2,2,AGCGCGAAGACTTCTCCTTT,0,5029596
yjbJ_predicted,0.3333333333333333,2,2,AGCGCAAAGCGGGGGCAAGC,0,5017583
yjbJ_predicted,0.3333333333333333,2,2,AGCGATCAAGAGTGCCTGTG,0,5002964
yjbJ_predicted,0.3333333333333333,2,2,AGCGAGTATATTCAGTATCT,0,5018953
yjbJ_predicted,0.3333333333333333,2,2,AGCGAGCCGGGTATACGGAT,0,5004088
yjbJ_predicted,0.3333333333333333,2,2,AGCGACTTGGCTCGTGGCTA,0,5012613
yjbJ_predicted,0.3333333333333333,2,2,AGCCTGGTCATTGGGATCAG,0,5002429
yjbJ_predicted,0.3333333333333333,2,2,AGCCGTACACTAGGAGAGAG,0,5021233
yjbJ_predicted,0.3333333333333333,2,2,AGCCGCTCAGCGCTTGCCAG,0,5013466
yjbJ_predicted,0.3333333333333333,2,2,AGCCGCACCAAACTAACGCA,0,5001408
yjbJ_predicted,0.3333333333333333,2,2,AGCCGAAGCCAATTACTGTG,0,5023448
yjbJ_predicted,0.3333333333333333,2,2,AGCATGGATTCACGGTAGGA,0,5022948
yjbJ_predicted,0.3333333333333333,2,2,AGCATAGGAGGCTGTTTTGC,0,5000206
yjbJ_predicted,0.3333333333333333,2,2,AGCACTACGGACGCTGCAGT,0,5000820
yjbJ_predicted,0.3333333333333333,2,2,AGCACAGGACCGTACTCGAT,0,5017097
yjbJ_predicted,0.3333333333333333,2,2,AGCAATGAAAATTCGAGAGC,0,5018067
yjbJ_predicted,0.3333333333333333,2,2,AGCAAGTCTGGTGCCAGGGG,0,4999888
yjbJ_predicted,0.3333333333333333,2,2,AGCAAAAACACCAGACCGGA,0,4996388
yjbJ_predicted,0.3333333333333333,2,2,AGATTATTTGCTCCGCTCGC,0,5029017
yjbJ_predicted,0.3333333333333333,2,2,AGATGCCACATGGATATCAC,0,5020383
yjbJ_predicted,0.3333333333333333,2,2,AGATCGGCAGGTTAGCCTTC,0,5011915
yjbJ_predicted,0.3333333333333333,2,2,AGATAACTAACAGGCTCTGT,0,4997009
yjbJ_predicted,0.3333333333333333,2,2,AGAGGCACGCCATTCGCGGC,0,5000170
yjbJ_predicted,0.3333333333333333,2,2,AGAGCGAACAACGGAGGAAA,0,4998185
yjbJ_predicted,0.3333333333333333,2,2,AGAGCCAGGGGTTGAAGATA,0,5010308
yjbJ_predicted,0.3333333333333333,2,2,AGACTTTGAAACTCTGATTC,0,5026814
yjbJ_predicted,0.3333333333333333,2,2,AGACTTCTTTTCATGCTTGT,0,4997480
yjbJ_predicted,0.3333333333333333,2,2,AGACGCCTAATTATGTTTCG,0,5017215
yjbJ_predicted,0.3333333333333333,2,2,AGACCTGTGTAGGGCTACAG,0,5009567
yjbJ_predicted,0.3333333333333333,2,2,AGACAATGTCATTAGTCTAG,0,5020684
yjbJ_predicted,0.3333333333333333,2,2,AGAATGGCTCAGCCAGCCCA,0,5028578
yjbJ_predicted,0.3333333333333333,2,2,AGAAGGAGTCTCCTAATGTG,0,5022951
yjbJ_predicted,0.3333333333333333,2,2,AGAAGATGTGTCTTGATTCT,0,5026095
yjbJ_predicted,0.3333333333333333,2,2,AGAAACAGCGTCCGACCGGG,0,5015279
yjbJ_predicted,0.3333333333333333,2,2,ACTTTGGCATTGACGCGATA,0,5014941
yjbJ_predicted,0.3333333333333333,2,2,ACTTGTATCGGTTCGGTCCA,0,5010363
yjbJ_predicted,0.3333333333333333,2,2,ACTTGGAGGCTCACGTAAAA,0,5008122
yjbJ_predicted,0.3333333333333333,2,2,ACTTGCCGACGTCGAGAACG,0,4994694
yjbJ_predicted,0.3333333333333333,2,2,ACTTGATTGGTATCACCACA,0,5015637
yjbJ_predicted,0.3333333333333333,2,2,ACTTATATGAAATGACCATG,0,5005517
yjbJ_predicted,0.3333333333333333,2,2,ACTTAGACACGTTAATTGCT,0,5024101
yjbJ_predicted,0.3333333333333333,2,2,ACTTACCTGATTGCAATATG,0,4995729
yjbJ_predicted,0.3333333333333333,2,2,ACTGTGTTTATATGGCGGGG,0,5018298
yjbJ_predicted,0.3333333333333333,2,2,ACTGTCTAAGCGTCAAGCCC,0,5015344
yjbJ_predicted,0.3333333333333333,2,2,ACTGTCCTGTGGTATCTCAA,0,5016448
yjbJ_predicted,0.3333333333333333,2,2,ACTCTGCGGGCTCGTGCTGT,0,5019566
yjbJ_predicted,0.3333333333333333,2,2,ACTCTAAGTTAATGAAACTG,0,5001315
yjbJ_predicted,0.3333333333333333,2,2,ACTCGGAACCGAATAGTTAC,0,5017808
yjbJ_predicted,0.3333333333333333,2,2,ACTCCTGCAGACCGGGAGAT,0,4994779
yjbJ_predicted,0.3333333333333333,2,2,ACTATCGTCCGGGGTCATGT,0,5024535
yjbJ_predicted,0.3333333333333333,2,2,ACTATCCACGTTCACACTCT,0,5022554
yjbJ_predicted,0.3333333333333333,2,2,ACTAGGTCGAGCTAGGCCAT,0,5023210
yjbJ_predicted,0.3333333333333333,2,2,ACGTTGTCTTCTCAACCTCT,0,5021058
yjbJ_predicted,0.3333333333333333,2,2,ACGTGACGTAAGTATCTCGC,0,4998903
yjbJ_predicted,0.3333333333333333,2,2,ACGTCTTCAACTGGGCCGGA,0,5001309
yjbJ_predicted,0.3333333333333333,2,2,ACGTATTTATGGCGCTTAGA,0,5023158
yjbJ_predicted,0.3333333333333333,2,2,ACGTAGTGGTCGGGAACTCC,0,5023341
yjbJ_predicted,0.3333333333333333,2,2,ACGGGATAGGGACGTACAAG,0,5002551
yjbJ_predicted,0.3333333333333333,2,2,ACGGCTTAGCACAACCGCGC,0,5003179
yjbJ_predicted,0.3333333333333333,2,2,ACGGCGCAGGTAAGGCACGA,0,5030728
yjbJ_predicted,0.3333333333333333,2,2,ACGGACAGGGCCGTAGAGTA,0,5015394
yjbJ_predicted,0.3333333333333333,2,2,ACGCTATGTCCCACAGACAG,0,5029498
yjbJ_predicted,0.3333333333333333,2,2,ACGCTAGGTCGGCCCTCCCA,0,5016227
yjbJ_predicted,0.3333333333333333,2,2,ACGCGGACGTCGGGAAGTTG,0,5006749
yjbJ_predicted,0.3333333333333333,2,2,ACGATGCGAATATCTGTTTG,0,5017510
yjbJ_predicted,0.3333333333333333,2,2,ACGAGGACACCACAGTAGCT,0,5031160
yjbJ_predicted,0.3333333333333333,2,2,ACGACAAGGGTCGGGTATAT,0,5001635
yjbJ_predicted,0.3333333333333333,2,2,ACGAAAGTCTATTTTACGTA,0,5027461
yjbJ_predicted,0.3333333333333333,2,2,ACCTCAGCAGGGGGTACAAA,0,5018313
yjbJ_predicted,0.3333333333333333,2,2,ACCTAATCCGCGCATTCATT,0,5014333
yjbJ_predicted,0.3333333333333333,2,2,ACCGGTTTAGTACTCAGGAG,0,5015783
yjbJ_predicted,0.3333333333333333,2,2,ACCGAGGCCTCAGACGCAAT,0,5005587
yjbJ_predicted,0.3333333333333333,2,2,ACCCTTCAGCAGAGGTTCGG,0,4995997
yjbJ_predicted,0.3333333333333333,2,2,ACCCGCTAACCACTCTTCGG,0,5020149
yjbJ_predicted,0.3333333333333333,2,2,ACCCAGAAGACTTGTATCTC,0,5011892
yjbJ_predicted,0.3333333333333333,2,2,ACCATATCCTCGTAAGGAAT,0,5007985
yjbJ_predicted,0.3333333333333333,2,2,ACCATACAAGCGCGTATCAC,0,5022487
yjbJ_predicted,0.3333333333333333,2,2,ACCAGGGAGGGGTGTAAGTC,0,5020035
yjbJ_predicted,0.3333333333333333,2,2,ACCAGCCCTTACCAGTCACT,0,5028903
yjbJ_predicted,0.3333333333333333,2,2,ACCACTGCGGTGGTTAGATC,0,5021773
yjbJ_predicted,0.3333333333333333,2,2,ACCAACCTCCGGCAGCTCTA,0,4999123
yjbJ_predicted,0.3333333333333333,2,2,ACATTACCCCGCAGTACGCG,0,5008946
yjbJ_predicted,0.3333333333333333,2,2,ACATGGGAGCGATTGTGACT,0,5013692
yjbJ_predicted,0.3333333333333333,2,2,ACATGATCGCCTGGGAATCT,0,5009810
yjbJ_predicted,0.3333333333333333,2,2,ACATCGGAAGAAGCAGCCGT,0,5010001
yjbJ_predicted,0.3333333333333333,2,2,ACATCCATAGCTAAAGAGTT,0,5026588
yjbJ_predicted,0.3333333333333333,2,2,ACATATGCACCAGGGTAGTG,0,5020921
yjbJ_predicted,0.3333333333333333,2,2,ACATAGAAAGTGATTCTTAG,0,5020509
yjbJ_predicted,0.3333333333333333,2,2,ACAGTTCTCGCAAGAAGGGG,0,5017045
yjbJ_predicted,0.3333333333333333,2,2,ACAGGTGGCTTTTCTCAGCA,0,5016000
yjbJ_predicted,0.3333333333333333,2,2,ACAGCAGCCAATATAGGAGA,0,5011837
yjbJ_predicted,0.3333333333333333,2,2,ACAGAGGGCTGCGAATGAGG,0,5020859
yjbJ_predicted,0.3333333333333333,2,2,ACAGAGCAGACCAATCCGGA,0,4996491
yjbJ_predicted,0.3333333333333333,2,2,ACACGGTTTCTAACACCGGC,0,5013017
yjbJ_predicted,0.3333333333333333,2,2,ACAATAACTAGAGGATGCCC,0,5013479
yjbJ_predicted,0.3333333333333333,2,2,ACAACGGGTAGAAGCCTGTC,0,5001154
yjbJ_predicted,0.3333333333333333,2,2,ACAACGAGCACAAAAAGAAT,0,5019951
yjbJ_predicted,0.3333333333333333,2,2,AATTTCTTATATCGTTACGG,0,5006611
yjbJ_predicted,0.3333333333333333,2,2,AATTTACGCTCAATTGTTAA,0,5003655
yjbJ_predicted,0.3333333333333333,2,2,AATTGTTAACAAGGGCGAAT,0,5030824
yjbJ_predicted,0.3333333333333333,2,2,AATTCGGCTCTTTGGTAAAC,0,5011205
yjbJ_predicted,0.3333333333333333,2,2,AATTCGAAATCGACGGAATA,0,5010759
yjbJ_predicted,0.3333333333333333,2,2,AATTATGGAAAACATGGAAA,0,5022435
yjbJ_predicted,0.3333333333333333,2,2,AATGTTCTATTCCCTGATCC,0,5031196
yjbJ_predicted,0.3333333333333333,2,2,AATGGTTGCCCTTTTTCTTG,0,5002605
yjbJ_predicted,0.3333333333333333,2,2,AATGAGGCGCTCGCATTAGT,0,4995620
yjbJ_predicted,0.3333333333333333,2,2,AATGAGCCTTTGTGGATTGG,0,5023332
yjbJ_predicted,0.3333333333333333,2,2,AATCTGCCGTGACATCACAC,0,5013419
yjbJ_predicted,0.3333333333333333,2,2,AATCGCAGCCTAAACGTTGT,0,5004510
yjbJ_predicted,0.3333333333333333,2,2,AATCCCGTATACCCCCCTGT,0,5000515
yjbJ_predicted,0.3333333333333333,2,2,AATAGCTCGTCTGATCTGTG,0,5011291
yjbJ_predicted,0.3333333333333333,2,2,AATAGCGCCGCCAGTTATGA,0,5005267
yjbJ_predicted,0.3333333333333333,2,2,AATAAAGTATTACGACTGTT,0,5016195
yjbJ_predicted,0.3333333333333333,2,2,AAGTGGTGTATCCTACGGAC,0,5006249
yjbJ_predicted,0.3333333333333333,2,2,AAGTCTTAAGGTGTGGATGG,0,5002992
yjbJ_predicted,0.3333333333333333,2,2,AAGGTTTAGGCGCAGATTGA,0,5014101
yjbJ_predicted,0.3333333333333333,2,2,AAGGTTAAGGAAATGGGCTT,0,5012943
yjbJ_predicted,0.3333333333333333,2,2,AAGGTGTGATTTGATGCCCT,0,5026270
yjbJ_predicted,0.3333333333333333,2,2,AAGGGTGCATATATCGTGAA,0,5026430
yjbJ_predicted,0.3333333333333333,2,2,AAGGCGAGTTACTGACCCGC,0,5029522
yjbJ_predicted,0.3333333333333333,2,2,AAGGACTTACCCGATACTAC,0,5013086
yjbJ_predicted,0.3333333333333333,2,2,AAGGAATGCACGTGACTGAG,0,4997387
yjbJ_predicted,0.3333333333333333,2,2,AAGGAAAGCCCCGCCGGGCT,0,5016249
yjbJ_predicted,0.3333333333333333,2,2,AAGCGGTGCAGCCTATAAAG,0,5031124
yjbJ_predicted,0.3333333333333333,2,2,AAGCGAGCGTGGCACGGAGC,0,5020687
yjbJ_predicted,0.3333333333333333,2,2,AAGCCCGTCGATTGAGTTTA,0,5012757
yjbJ_predicted,0.3333333333333333,2,2,AAGCATTCCGTTCCCGCTTA,0,5019342
yjbJ_predicted,0.3333333333333333,2,2,AAGCATGGTCAGCACACTGG,0,5000424
yjbJ_predicted,0.3333333333333333,2,2,AAGATTTCGTTGGGTTAGGA,0,5027936
yjbJ_predicted,0.3333333333333333,2,2,AAGAGTAATACCTTGGTCTA,0,4998422
yjbJ_predicted,0.3333333333333333,2,2,AAGAGGGGAAGTCCGTGTTA,0,4996044
yjbJ_predicted,0.3333333333333333,2,2,AAGAGGAAGCATGGAGGCTG,0,5011907
yjbJ_predicted,0.3333333333333333,2,2,AAGACTAAGTGAAGGTCACA,0,5019978
yjbJ_predicted,0.3333333333333333,2,2,AACTTGTCACCCTACTCGGG,0,5026485
yjbJ_predicted,0.3333333333333333,2,2,AACTCATTCAATTGCACGGA,0,5013822
yjbJ_predicted,0.3333333333333333,2,2,AACTCACTGGGTGGTTTGCC,0,5019580
yjbJ_predicted,0.3333333333333333,2,2,AACGTATGACGATCGTTGTT,0,4998495
yjbJ_predicted,0.3333333333333333,2,2,AACCTGTATCATTAGGGGTC,0,4995744
yjbJ_predicted,0.3333333333333333,2,2,AACCTGTAGCAACGGGAGAA,0,5025992
yjbJ_predicted,0.3333333333333333,2,2,AACCGGGAATTAACGAAAGG,0,5017451
yjbJ_predicted,0.3333333333333333,2,2,AACCCAGATAAGCTGATTAA,0,5008896
yjbJ_predicted,0.3333333333333333,2,2,AACCACAGTCAGTCAGTTAT,0,5002432
yjbJ_predicted,0.3333333333333333,2,2,AACAGGTCTAACTCCGACGG,0,5011494
yjbJ_predicted,0.3333333333333333,2,2,AAATGGCATGTGATCTAGCG,0,5024593
yjbJ_predicted,0.3333333333333333,2,2,AAATGCGTGGCTTAGCAAGC,0,5021404
yjbJ_predicted,0.3333333333333333,2,2,AAATCCGTATCAATTCATCA,0,5010559
yjbJ_predicted,0.3333333333333333,2,2,AAATAAAAACATCTTTTACT,0,4999040
yjbJ_predicted,0.3333333333333333,2,2,AAAGTGGGCTGAGTCGCGCA,0,5022702
yjbJ_predicted,0.3333333333333333,2,2,AAAGTATGAGTGGATGTTGG,0,5003675
yjbJ_predicted,0.3333333333333333,2,2,AAAGTAATTGTTTTCACTCG,0,5013664
yjbJ_predicted,0.3333333333333333,2,2,AAAGGGGTAGTGAAGGAGGT,0,5024111
yjbJ_predicted,0.3333333333333333,2,2,AAAGGGCACCGAGAGGAGCC,0,5015897
yjbJ_predicted,0.3333333333333333,2,2,AAAGCGTCTCTGCAGACATA,0,5009369
yjbJ_predicted,0.3333333333333333,2,2,AAAGACGGCCTCAAAAGGCT,0,5005508
yjbJ_predicted,0.3333333333333333,2,2,AAAATGGCTTAAATCTCTAT,0,4998557
yjbJ_predicted,0.3333333333333333,2,2,AAAATGCCGGCCCGAAAAAT,0,5014786
yjbJ_predicted,0.3333333333333333,2,2,AAAATCTGTGGAGGCAGTTT,0,5006938
yjbJ_predicted,0.3333333333333333,2,2,AAAAGTAGTACCGGCTTATG,0,5008799
yjbJ_predicted,0.3333333333333333,2,2,AAAAGAATTGAAATAGGAAC,0,5007509
yjbJ_predicted,0.3333333333333333,2,2,AAAACTTATAGTACACGCGT,0,5017540
yjbJ_predicted,0.3333333333333333,2,2,AAAACTAGCCAGTGCCGTCC,0,5001628
yjbJ_predicted,0.3333333333333333,2,2,AAAACGGGGGTAATCTGGGC,0,5017203
yjbJ_predicted,0.3333333333333333,2,2,AAAAAGGTTAGTAGACACTA,0,5007087
yjbJ_predicted,0.5,1,1,TTTTTTGTCTGCCATCAGGG,0,5001879
yjbJ_predicted,0.5,1,1,TTTTTTGGCTATGTGTTGCT,0,5009082
yjbJ_predicted,0.5,1,1,TTTTTGGGCCGGGTGCGAGG,0,5022968
yjbJ_predicted,0.5,1,1,TTTTTCCCTACGCAGTCTTC,0,5004891
yjbJ_predicted,0.5,1,1,TTTTGTCAAGGCTAAACTGT,0,5005917
yjbJ_predicted,0.5,1,1,TTTTGTACAGTCCCTTCCCA,0,5007767
yjbJ_predicted,0.5,1,1,TTTTGAGCCACACGTTGATC,0,5028951
yjbJ_predicted,0.5,1,1,TTTTCGACACACGTCTACTC,0,5004042
yjbJ_predicted,0.5,1,1,TTTTCACCAGGCACCGGACT,0,5006803
yjbJ_predicted,0.5,1,1,TTTTATCGCGACTCGTCCGA,0,5028936
yjbJ_predicted,0.5,1,1,TTTGTGTAGAATCCATGTCA,0,5017028
yjbJ_predicted,0.5,1,1,TTTGGTTTGCTAGGGTCGAG,0,5030152
yjbJ_predicted,0.5,1,1,TTTGATGCTGGAACCACGTT,0,5009134
yjbJ_predicted,0.5,1,1,TTTGATAGGGATTAGATAAT,0,5022543
yjbJ_predicted,0.5,1,1,TTTGAGATGGCCAGACTATC,0,5005579
yjbJ_predicted,0.5,1,1,TTTCGGAGAGCGCTCTATCG,0,5008585
yjbJ_predicted,0.5,1,1,TTTCGCTGATTTCCCTCTTT,0,5002702
yjbJ_predicted,0.5,1,1,TTTCGAAGCGGTCTTACTAC,0,5006605
yjbJ_predicted,0.5,1,1,TTTCAAATGTGTATTCAAAG,0,4994844
yjbJ_predicted,0.5,1,1,TTTATCGACGGTACGAAGTC,0,4999465
yjbJ_predicted,0.5,1,1,TTTATACGCAGGTGCGGAGT,0,5015187
yjbJ_predicted,0.5,1,1,TTTACCAGATGGCCTTGGAT,0,4997903
yjbJ_predicted,0.5,1,1,TTTAACTTAAAGGTTTGTGG,0,4997729
yjbJ_predicted,0.5,1,1,TTTAAATAACGACTAACCGT,0,5005623
yjbJ_predicted,0.5,1,1,TTGTTGTGATCCTGGACATT,0,5030881
yjbJ_predicted,0.5,1,1,TTGTGGACTGTTCTCCAATT,0,5016943
yjbJ_predicted,0.5,1,1,TTGTCTTGTAGTGTTCTGGG,0,5023264
yjbJ_predicted,0.5,1,1,TTGTCGATTCAAGTATATCA,0,5019243
yjbJ_predicted,0.5,1,1,TTGTCCAAAAGCACAAGAGG,0,5010537
yjbJ_predicted,0.5,1,1,TTGTACTCTGGCTGAATACA,0,5001069
yjbJ_predicted,0.5,1,1,TTGGTGCCGGCTAAAGGCGT,0,5013536
yjbJ_predicted,0.5,1,1,TTGGGCGGTCAATCTTCGGG,0,5027529
yjbJ_predicted,0.5,1,1,TTGGGCGGCTACACTGCCTA,0,5023219
yjbJ_predicted,0.5,1,1,TTGGGATAGAGCTACGTGGC,0,5012043
yjbJ_predicted,0.5,1,1,TTGGAGTCTAGTTGGAGGGA,0,5016186
yjbJ_predicted,0.5,1,1,TTGGACCCATAAAGCAAAAT,0,5020733
yjbJ_predicted,0.5,1,1,TTGCTTCGGCTCCAAAAAGA,0,5029946
yjbJ_predicted,0.5,1,1,TTGCGCGGTTTGAGGAGCGG,0,5029171
yjbJ_predicted,0.5,1,1,TTGCATAGCGTACACGAGCA,0,5027966
yjbJ_predicted,0.5,1,1,TTGCAGAGTTCTTAGGTGTT,0,5002350
yjbJ_predicted,0.5,1,1,TTGCACGTCTGTGGCTCGCC,0,4997632
yjbJ_predicted,0.5,1,1,TTGATTTCCCCATCGTACAT,0,5031264
yjbJ_predicted,0.5,1,1,TTGATATTTGGGTAATTACT,0,5017453
yjbJ_predicted,0.5,1,1,TTGAGTTCCGTAAAGAGGAT,0,5018088
yjbJ_predicted,0.5,1,1,TTGAGCGTGGTCTATCGGGG,0,5021949
yjbJ_predicted,0.5,1,1,TTGACTCATTCCCTACGTAG,0,5000416
yjbJ_predicted,0.5,1,1,TTGACAAGTTAGTGGATGAC,0,5006718
yjbJ_predicted,0.5,1,1,TTGAATAACCGGAGAGCCTT,0,5018843
yjbJ_predicted,0.5,1,1,TTCTTAATAAACATACAGTA,0,4996779
yjbJ_predicted,0.5,1,1,TTCTAGTTTTCCCTGCTGGG,0,5023957
yjbJ_predicted,0.5,1,1,TTCGTCTATGCCCCGCCATG,0,5002179
yjbJ_predicted,0.5,1,1,TTCGACGTAATTGGACCTTA,0,5018849
yjbJ_predicted,0.5,1,1,TTCGACCCTGCCTGGGTGGT,0,5007669
yjbJ_predicted,0.5,1,1,TTCCTCGGCACTGCAAGTTC,0,5029706
yjbJ_predicted,0.5,1,1,TTCCGGCGAAACTGGGTCCC,0,5021766
yjbJ_predicted,0.5,1,1,TTCCAGAACATTCACAAAAT,0,5015263
yjbJ_predicted,0.5,1,1,TTCATGAATAATTTATACGA,0,5015737
yjbJ_predicted,0.5,1,1,TTCATCCTAGCCGCTAGTTA,0,5001911
yjbJ_predicted,0.5,1,1,TTCAGTCGGGAACGGCTGGC,0,5024609
yjbJ_predicted,0.5,1,1,TTCAGATTGAACTTTCGCGC,0,5015768
yjbJ_predicted,0.5,1,1,TTCAAGCGTAACGTGTATAG,0,5021210
yjbJ_predicted,0.5,1,1,TTATTATGCTTCAGATGTAA,0,5028653
yjbJ_predicted,0.5,1,1,TTATAAGCAGCGTGTGCCAT,0,5012187
yjbJ_predicted,0.5,1,1,TTAGTTCAGTAGATCTTGGT,0,4998192
yjbJ_predicted,0.5,1,1,TTAGTGTGCCCGTAGACAAC,0,5016621
yjbJ_predicted,0.5,1,1,TTAGGTCGCTTGAGCCGTGG,0,5020890
yjbJ_predicted,0.5,1,1,TTAGCTAGTTCCAGCTAGGC,0,5007699
yjbJ_predicted,0.5,1,1,TTAGCGTCAGATTTTACGTA,0,5025354
yjbJ_predicted,0.5,1,1,TTAGCCAATTTTACAGGATC,0,5004303
yjbJ_predicted,0.5,1,1,TTAGAGTAGGGTAACACACT,0,5013435
yjbJ_predicted,0.5,1,1,TTAGAAGATTAAGTGTATCC,0,5013257
yjbJ_predicted,0.5,1,1,TTAGAACTGAGGTCATGGGT,0,5030931
yjbJ_predicted,0.5,1,1,TTACTTATAAAGATGCTCGC,0,5022555
yjbJ_predicted,0.5,1,1,TTACTCTACATGATAAATCT,0,5020872
yjbJ_predicted,0.5,1,1,TTACGGGTTCTCTTTCCAAC,0,5027421
yjbJ_predicted,0.5,1,1,TGTTGGACCGAAACGCGGCG,0,4997755
yjbJ_predicted,0.5,1,1,TGTTCCGAGTCTCGGGACTA,0,5009904
yjbJ_predicted,0.5,1,1,TGTTCCATCGTACATTAGCT,0,5013301
yjbJ_predicted,0.5,1,1,TGTTATCCATTTCGGCTTCA,0,5015581
yjbJ_predicted,0.5,1,1,TGTTAGCCATACGCTCAGGG,0,4996717
yjbJ_predicted,0.5,1,1,TGTTACTCTGCCGAGGTGTC,0,5002172
yjbJ_predicted,0.5,1,1,TGTGTCAGCAAGCCAGTAAT,0,5021229
yjbJ_predicted,0.5,1,1,TGTGTATCCCCCGCGGTGCC,0,5016447
yjbJ_predicted,0.5,1,1,TGTGCTCATAACTGGGGCGT,0,5028970
yjbJ_predicted,0.5,1,1,TGTCTTTCCCGTCAGTCGTT,0,5011404
yjbJ_predicted,0.5,1,1,TGTCTTGGGCACACTCTCTC,0,4995766
yjbJ_predicted,0.5,1,1,TGTCGGCGTGATGAAAGTTA,0,4995105
yjbJ_predicted,0.5,1,1,TGTCAATGTGATTTTTGAGA,0,5006985
yjbJ_predicted,0.5,1,1,TGTATGGGATTTCACAACTG,0,5029126
yjbJ_predicted,0.5,1,1,TGTATCCTTTGTCAGAAACG,0,5017079
yjbJ_predicted,0.5,1,1,TGTACGCACCACAAGACACT,0,5010562
yjbJ_predicted,0.5,1,1,TGTACCGTCGCTGCTTCGTA,0,5007708
yjbJ_predicted,0.5,1,1,TGTACAATAGGTGTATCAGT,0,5017916
yjbJ_predicted,0.5,1,1,TGTAATTCCGCTAGGAAATG,0,5023042
yjbJ_predicted,0.5,1,1,TGTAAAATGGATGAACTAAT,0,5029389
yjbJ_predicted,0.5,1,1,TGTAAAAGACCCCGTAGGCG,0,5011167
yjbJ_predicted,0.5,1,1,TGGTTTCGTGTTCTCGAACT,0,5030114
yjbJ_predicted,0.5,1,1,TGGTTTCGCTCGGTGGGTAA,0,5013825
yjbJ_predicted,0.5,1,1,TGGTTCGCAGCACAATCTAA,0,5007194
yjbJ_predicted,0.5,1,1,TGGTGGGCTGTTTACGGTAG,0,5014650
yjbJ_predicted,0.5,1,1,TGGTGAGTGAGCCCACGCAT,0,4995050
yjbJ_predicted,0.5,1,1,TGGTCTATCAGGACGCCTTC,0,5000533
yjbJ_predicted,0.5,1,1,TGGTCGCTTCCCGCTACATC,0,5020018
yjbJ_predicted,0.5,1,1,TGGGTTCTTGTAATTACCAG,0,5011610
yjbJ_predicted,0.5,1,1,TGGGTATCTCGAGAAAGAGG,0,4998241
yjbJ_predicted,0.5,1,1,TGGGGACATATGTGAGGGTA,0,5013015
yjbJ_predicted,0.5,1,1,TGGGCGCGCCACAACCGGGG,0,5012643
yjbJ_predicted,0.5,1,1,TGGGCCCGTGACATGCTCTG,0,5007583
yjbJ_predicted,0.5,1,1,TGGCTGTACTCTCTCTCTAG,0,5006497
yjbJ_predicted,0.5,1,1,TGGCTAATGCTGTATCCAAG,0,5020876
yjbJ_predicted,0.5,1,1,TGGCGGGCCTAGTGACATTT,0,5005960
yjbJ_predicted,0.5,1,1,TGGCGCAGGGTACGCTAGCG,0,5027329
yjbJ_predicted,0.5,1,1,TGGCCCTCGCCCCCCCGTTT,0,5008790
yjbJ_predicted,0.5,1,1,TGGCAAGCACTCGGGCTGCC,0,5026127
yjbJ_predicted,0.5,1,1,TGGATACGTGAACTTAGCGT,0,5013797
yjbJ_predicted,0.5,1,1,TGGAGCAGGTAAAGGCGAAC,0,5021775
yjbJ_predicted,0.5,1,1,TGGACTCAGAGTAGCTTGAA,0,5019849
yjbJ_predicted,0.5,1,1,TGCTTGCGGGAACTGGGGTG,0,4996977
yjbJ_predicted,0.5,1,1,TGCTTCGCGTGCGGGGAGCT,0,5017246
yjbJ_predicted,0.5,1,1,TGCTGCCACTCTGAAGCGCA,0,5012602
yjbJ_predicted,0.5,1,1,TGCTGAAGACATTTGACAAC,0,5027696
yjbJ_predicted,0.5,1,1,TGCTATATGTAGTTTAGCTG,0,5012682
yjbJ_predicted,0.5,1,1,TGCTATAGCAAGTCATAGAC,0,5012681
yjbJ_predicted,0.5,1,1,TGCTAGATAGTCTGTACGTT,0,4999441
yjbJ_predicted,0.5,1,1,TGCGGTACGACAATAGATTA,0,5017685
yjbJ_predicted,0.5,1,1,TGCGGCCCCACGATCACATG,0,5023935
yjbJ_predicted,0.5,1,1,TGCGCAGCATCGACGTTGCG,0,5004547
yjbJ_predicted,0.5,1,1,TGCGAACTTGAAATAAGAGC,0,5002462
yjbJ_predicted,0.5,1,1,TGCGAAAGGTAATCGGATAT,0,5001831
yjbJ_predicted,0.5,1,1,TGCCGCCTAGCACACTTTTT,0,5022648
yjbJ_predicted,0.5,1,1,TGCCAATGCTTAACACCGGC,0,5017609
yjbJ_predicted,0.5,1,1,TGCATTACCCAGTTTTCGAT,0,5009214
yjbJ_predicted,0.5,1,1,TGCATCTTCCAGGCTTCTCG,0,5018735
yjbJ_predicted,0.5,1,1,TGCATCGTATAGCAACCGTA,0,4996490
yjbJ_predicted,0.5,1,1,TGCATAGGCGTCCCTGGTCT,0,5003968
yjbJ_predicted,0.5,1,1,TGCAGTTGGGCAAATAACCG,0,5020309
yjbJ_predicted,0.5,1,1,TGCAGGAAGGAGACAGATGA,0,5008800
yjbJ_predicted,0.5,1,1,TGCAGCGGTTTCGTTCTTAG,0,5010166
yjbJ_predicted,0.5,1,1,TGCACGACAGGACCGCTCTA,0,5030975
yjbJ_predicted,0.5,1,1,TGCACCCAGTAAAAATCGGC,0,5025748
yjbJ_predicted,0.5,1,1,TGCAAAACAGCGTGAGAGAC,0,5025140
yjbJ_predicted,0.5,1,1,TGATTATACATCTCGGGTCG,0,5020616
yjbJ_predicted,0.5,1,1,TGATGTGGTCCCGGGCTCCC,0,5018498
yjbJ_predicted,0.5,1,1,TGATGGGAGCAAGTCTTCGT,0,5009836
yjbJ_predicted,0.5,1,1,TGATATCTACGCAACGTCCC,0,5030694
yjbJ_predicted,0.5,1,1,TGATACAAGCTTTACTGGTT,0,5023723
yjbJ_predicted,0.5,1,1,TGAGCGGGTAGGGGAATAAT,0,5009414
yjbJ_predicted,0.5,1,1,TGACTGAAGTTTTATCAGCT,0,5002834
yjbJ_predicted,0.5,1,1,TGACTAGATTGCGGTTCCTA,0,5005406
yjbJ_predicted,0.5,1,1,TGACCACGCCTAATCGGGTT,0,5026757
yjbJ_predicted,0.5,1,1,TGACAGGATTCTGGTCGTAC,0,5010374
yjbJ_predicted,0.5,1,1,TGACAGATATACAGACTGAA,0,5003172
yjbJ_predicted,0.5,1,1,TGAATTGTGAGAAGTAATGA,0,5002781
yjbJ_predicted,0.5,1,1,TGAATCTCGATTAACTTTCC,0,5022943
yjbJ_predicted,0.5,1,1,TGAAGTGACACATACGGCTC,0,5006190
yjbJ_predicted,0.5,1,1,TGAAGTCTCGCGCGAGTCGT,0,5021003
yjbJ_predicted,0.5,1,1,TGAACCCTTGAATTTTTCGG,0,5013030
yjbJ_predicted,0.5,1,1,TGAACCAGTCATTTTGGACA,0,5022670
yjbJ_predicted,0.5,1,1,TGAAATACCTTTAAGCAGTG,0,5028615
yjbJ_predicted,0.5,1,1,TGAAAACGAGGTAGTTCAGT,0,5006759
yjbJ_predicted,0.5,1,1,TGAAAAAAGGCGAGGGCGAA,0,4999258
yjbJ_predicted,0.5,1,1,TCTTCGGGGAAAAATATGGA,0,4996899
yjbJ_predicted,0.5,1,1,TCTTAGGGAAAAGTGTACCA,0,5001128
yjbJ_predicted,0.5,1,1,TCTGTGTCACAAATGGAGCA,0,5014578
yjbJ_predicted,0.5,1,1,TCTGTAGCCGAGGTGTAGTA,0,5028740
yjbJ_predicted,0.5,1,1,TCTGGGGTAGCAAGGTACCA,0,5018627
yjbJ_predicted,0.5,1,1,TCTCGCTAAAAAACTCTGGG,0,5003360
yjbJ_predicted,0.5,1,1,TCTCCCGAGACGACCTGAAG,0,5016908
yjbJ_predicted,0.5,1,1,TCTATGGCCCATCTCCTATC,0,4996901
yjbJ_predicted,0.5,1,1,TCTATATCCTCACCATGAGG,0,5013545
yjbJ_predicted,0.5,1,1,TCTAGTAGTTTACGCTGAAC,0,5026071
yjbJ_predicted,0.5,1,1,TCTAGGAGGCTGGGAATAAC,0,5026457
yjbJ_predicted,0.5,1,1,TCGTATCTGGTCCGACACGT,0,5029882
yjbJ_predicted,0.5,1,1,TCGGTTCATGGCTAATCCGT,0,4996323
yjbJ_predicted,0.5,1,1,TCGGTCAGTTCCAACGTGAG,0,5018950
yjbJ_predicted,0.5,1,1,TCGGTAATCACCATTGCAGG,0,5015119
yjbJ_predicted,0.5,1,1,TCGGGTCGTTGCACACATGT,0,5015060
yjbJ_predicted,0.5,1,1,TCGGGCAGGAACCATTAGGA,0,5024151
yjbJ_predicted,0.5,1,1,TCGGCATATCGGACTACCAT,0,5019601
yjbJ_predicted,0.5,1,1,TCGGATTCCAGACTTCAATA,0,4999379
yjbJ_predicted,0.5,1,1,TCGGAGGCCACGACAATTTG,0,5024028
yjbJ_predicted,0.5,1,1,TCGGACTTAAGACACTGATC,0,5016586
yjbJ_predicted,0.5,1,1,TCGCTGTCTCGGCCGCAGTA,0,5023631
yjbJ_predicted,0.5,1,1,TCGCGGGACTCCATAGTGAG,0,4995861
yjbJ_predicted,0.5,1,1,TCGCGAGTTCAGTTGCCTTT,0,5024396
yjbJ_predicted,0.5,1,1,TCGCCATTGCATGATTGCCC,0,5011365
yjbJ_predicted,0.5,1,1,TCGCAGGTCATCCGACGGGA,0,5020825
yjbJ_predicted,0.5,1,1,TCGATTCGTGTTAGACCAGC,0,5004948
yjbJ_predicted,0.5,1,1,TCGATCTGTGAAGATGACGT,0,5026799
yjbJ_predicted,0.5,1,1,TCGAGCCGTATCTCATCTAA,0,5010201
yjbJ_predicted,0.5,1,1,TCGAATTACATTTGGCTCGA,0,5007830
yjbJ_predicted,0.5,1,1,TCCTGGTGACTCCAGTGGAG,0,5023150
yjbJ_predicted,0.5,1,1,TCCTGAGATTTGCTGTCGGA,0,5021283
yjbJ_predicted,0.5,1,1,TCCTGACACTTGAACCACTC,0,4997657
yjbJ_predicted,0.5,1,1,TCCTCATAGCGTTATGCTTT,0,5002761
yjbJ_predicted,0.5,1,1,TCCGTCGTCTCTCCAGGAGT,0,5002668
yjbJ_predicted,0.5,1,1,TCCGCGGGGAAGTTCTCCAT,0,5028894
yjbJ_predicted,0.5,1,1,TCCGAGAGTGTCGCAACTAT,0,5027532
yjbJ_predicted,0.5,1,1,TCCGACGGCTTTCCCTTTAC,0,5004446
yjbJ_predicted,0.5,1,1,TCCCTTTGTGCATGGAGGAA,0,5027747
yjbJ_predicted,0.5,1,1,TCCCTATCCTTCTCAGCGAC,0,5001185
yjbJ_predicted,0.5,1,1,TCCCGATCTTTCTTATCTTC,0,5024353
yjbJ_predicted,0.5,1,1,TCCCCTGTCTATACCGGGTT,0,5014041
yjbJ_predicted,0.5,1,1,TCCCAGTTCCATACCAGTAG,0,5010831
yjbJ_predicted,0.5,1,1,TCCCAACAGGCGTAGCCTCA,0,5007199
yjbJ_predicted,0.5,1,1,TCCATAGCTGGAGGGCTTAT,0,5002443
yjbJ_predicted,0.5,1,1,TCATCTGTAGTCCTGTTGGC,0,5007738
yjbJ_predicted,0.5,1,1,TCATAGGTGATACAGTTAGC,0,5030025
yjbJ_predicted,0.5,1,1,TCATACGTGGATTTATGTGT,0,5030022
yjbJ_predicted,0.5,1,1,TCAGGGGACACGTTACATAC,0,5007342
yjbJ_predicted,0.5,1,1,TCAGATGGGGGAAGAGCACA,0,5028969
yjbJ_predicted,0.5,1,1,TCAGAGTTCAGCCGTAGCCG,0,5023412
yjbJ_predicted,0.5,1,1,TCACGACCGCGTTGTTAGTA,0,5030546
yjbJ_predicted,0.5,1,1,TCACCTTATTTATGGGGAAA,0,5005173
yjbJ_predicted,0.5,1,1,TCACCTGGCACTCCACTCAG,0,5028757
yjbJ_predicted,0.5,1,1,TCACCGGTGAACTTTCGAAA,0,5015319
yjbJ_predicted,0.5,1,1,TCACCCTGTCATAAGTTCTG,0,4999777
yjbJ_predicted,0.5,1,1,TCACAGATCCCCCACCATTG,0,5024717
yjbJ_predicted,0.5,1,1,TCAATTATACCCGGTAGGCA,0,5023510
yjbJ_predicted,0.5,1,1,TCAATCAGTTTTTCGTGAAT,0,5007375
yjbJ_predicted,0.5,1,1,TCAATAATGCTTACTTCTGG,0,5010389
yjbJ_predicted,0.5,1,1,TCAAGGGCTCTAACATTTGC,0,5006477
yjbJ_predicted,0.5,1,1,TCAAGCACAAACATGCAAGT,0,5000748
yjbJ_predicted,0.5,1,1,TCAACTTGCCAAGATTGCGG,0,5027046
yjbJ_predicted,0.5,1,1,TCAACCGCGCGGAACGTAGA,0,5004254
yjbJ_predicted,0.5,1,1,TATTTGTGACGGCATGTCGG,0,5027636
yjbJ_predicted,0.5,1,1,TATTTCTTCACACCAGACCG,0,5028957
yjbJ_predicted,0.5,1,1,TATTTATCGTAATGGAAAGA,0,5000917
yjbJ_predicted,0.5,1,1,TATTGGATGTCTGGGACTCT,0,4999936
yjbJ_predicted,0.5,1,1,TATTGCCGCACCATGCAAGG,0,5030826
yjbJ_predicted,0.5,1,1,TATTGAGTAGGCAGAGGCCA,0,5012666
yjbJ_predicted,0.5,1,1,TATTCTCCATTCGGCCACGG,0,5014934
yjbJ_predicted,0.5,1,1,TATTCTACTGGATTCCGGCT,0,5014190
yjbJ_predicted,0.5,1,1,TATTATGACATTGGTTAGCT,0,5031100
yjbJ_predicted,0.5,1,1,TATTAAGTCTGACTCGCGCT,0,5018335
yjbJ_predicted,0.5,1,1,TATGTTATGGGTTTGGAAAT,0,5004750
yjbJ_predicted,0.5,1,1,TATGTCCCTTCAGCACTTTT,0,5013500
yjbJ_predicted,0.5,1,1,TATGTAAGTAAACCTCGAAC,0,5010862
yjbJ_predicted,0.5,1,1,TATGGTTATCCCTCCCGCGA,0,5024050
yjbJ_predicted,0.5,1,1,TATGCTGTCGATTAATTTCT,0,5005233
yjbJ_predicted,0.5,1,1,TATGCCGTTCATGATTTGTC,0,5013198
yjbJ_predicted,0.5,1,1,TATGCAATAAACTTTCAGGT,0,5008038
yjbJ_predicted,0.5,1,1,TATGATTGTGAGAATAGTAT,0,5015314
yjbJ_predicted,0.5,1,1,TATCGTCGTAGGACATTACC,0,5003339
yjbJ_predicted,0.5,1,1,TATCCTTTGGTATGACAGTT,0,5027211
yjbJ_predicted,0.5,1,1,TATATGGAAATCTCCCGTAT,0,5024415
yjbJ_predicted,0.5,1,1,TATATCGGGGCACGTGTACG,0,5024326
yjbJ_predicted,0.5,1,1,TATAGGTATATGCCTTTACA,0,4996201
yjbJ_predicted,0.5,1,1,TAGGTTATGTGGCTGTCCTG,0,5010642
yjbJ_predicted,0.5,1,1,TAGGTTAATCTGTCAAACTC,0,5029995
yjbJ_predicted,0.5,1,1,TAGGTACGGAACGGCCGAGC,0,4995853
yjbJ_predicted,0.5,1,1,TAGGGTGAGCTTGGACGGAC,0,5006934
yjbJ_predicted,0.5,1,1,TAGGGATTGAGTAACGGGCC,0,5001822
yjbJ_predicted,0.5,1,1,TAGGATCGGCATTCCCCCAA,0,5010392
yjbJ_predicted,0.5,1,1,TAGCTGAATTGGCTGACGTT,0,5016927
yjbJ_predicted,0.5,1,1,TAGCGCTCTGCAAAGAGGTT,0,5019999
yjbJ_predicted,0.5,1,1,TAGCACGGGGCGCACCATCT,0,5013062
yjbJ_predicted,0.5,1,1,TAGATGTTTAAATTCGGACC,0,4999716
yjbJ_predicted,0.5,1,1,TAGAGCCATGAGGGGGAGCA,0,5021179
yjbJ_predicted,0.5,1,1,TAGACCCTGGCGTCGAGAGG,0,5002478
yjbJ_predicted,0.5,1,1,TAGAAAAAGGAGTTAAGGAA,0,5024637
yjbJ_predicted,0.5,1,1,TACTCGCGGTAAACTCACCC,0,4997366
yjbJ_predicted,0.5,1,1,TACTCGATTCTCAATGAGCG,0,5023044
yjbJ_predicted,0.5,1,1,TACGTGGCGCAAAGGACAAG,0,5027535
yjbJ_predicted,0.5,1,1,TACGTCTCGGCTCGCATCCA,0,5026971
yjbJ_predicted,0.5,1,1,TACGTCACCGAAGCTTATCA,0,5003529
yjbJ_predicted,0.5,1,1,TACGGGGGGCCTTTTGTATG,0,5028988
yjbJ_predicted,0.5,1,1,TACGGGCCATAAACAGTTAC,0,5009269
yjbJ_predicted,0.5,1,1,TACGCTTGTGGCGGCCAAGA,0,5007510
yjbJ_predicted,0.5,1,1,TACGCAGATCATTATCACGT,0,5019153
yjbJ_predicted,0.5,1,1,TACCTAAGCACGATAAGTCT,0,5004224
yjbJ_predicted,0.5,1,1,TACCGTCCACTATCGGTATT,0,4997647
yjbJ_predicted,0.5,1,1,TACCGGGGGGGTGGTATTGC,0,5019247
yjbJ_predicted,0.5,1,1,TACATCAGTGGTGCGCTGTC,0,5019955
yjbJ_predicted,0.5,1,1,TACAGTTGTTTGTTTCTAGC,0,5020671
yjbJ_predicted,0.5,1,1,TACAGGAGGCGGCTAGGCTA,0,4999055
yjbJ_predicted,0.5,1,1,TACAGATTTTTTGAGTAGGA,0,5025674
yjbJ_predicted,0.5,1,1,TACACAGCTACTCAGTGCAC,0,5018693
yjbJ_predicted,0.5,1,1,TACAAACATACATACCTCGT,0,5025068
yjbJ_predicted,0.5,1,1,TAATTCTGCACTTAAATCAT,0,4997935
yjbJ_predicted,0.5,1,1,TAATCTTGTTGGCGGAGGGT,0,5030782
yjbJ_predicted,0.5,1,1,TAATCATATGTCATCGCGGC,0,5018363
yjbJ_predicted,0.5,1,1,TAAGTTCCCTGCGAATTGGT,0,5014698
yjbJ_predicted,0.5,1,1,TAAGCACATCTAGACGACTC,0,5013437
yjbJ_predicted,0.5,1,1,TAACTTCCGTGAATAGCGCA,0,5007587
yjbJ_predicted,0.5,1,1,TAACTGTTTTCGCATTTCGG,0,5010076
yjbJ_predicted,0.5,1,1,TAACGGGGTCAAGCATGCAG,0,5020532
yjbJ_predicted,0.5,1,1,TAACCAACGGGCCAGTATTG,0,5030720
yjbJ_predicted,0.5,1,1,TAACATGTAGTAAACTCACT,0,5017168
yjbJ_predicted,0.5,1,1,TAACAGACTGTGCATCAAAA,0,5012504
yjbJ_predicted,0.5,1,1,TAACACCTCGCTGATACGTT,0,5009092
yjbJ_predicted,0.5,1,1,TAAATGCCTTTCATAATTGG,0,5010197
yjbJ_predicted,0.5,1,1,TAAATCATTATAGGCGTATC,0,5020673
yjbJ_predicted,0.5,1,1,TAAAAATTGGAGCCCTTATT,0,4998167
yjbJ_predicted,0.5,1,1,GTTTGGAAGTGAGCATTGTA,0,5000839
yjbJ_predicted,0.5,1,1,GTTTCTTCACCTGGTCCGTA,0,5000784
yjbJ_predicted,0.5,1,1,GTTTCTGTTTTCTGGATTTA,0,4999198
yjbJ_predicted,0.5,1,1,GTTTCCCGTAGACGGTGTCG,0,5016636
yjbJ_predicted,0.5,1,1,GTTTCATCGCGGGGCTCGCC,0,5007306
yjbJ_predicted,0.5,1,1,GTTTACTAGGAATTGATGGG,0,5001171
yjbJ_predicted,0.5,1,1,GTTTAAGGTCATGACTGTGT,0,5012402
yjbJ_predicted,0.5,1,1,GTTGTTTAGCGGCCGGGGGA,0,5021306
yjbJ_predicted,0.5,1,1,GTTGTTGTTTCCATTAACGG,0,4994824
yjbJ_predicted,0.5,1,1,GTTGGTTTTAAGTACAAGGA,0,5023464
yjbJ_predicted,0.5,1,1,GTTGGCATCCTGCTAAAATA,0,5000741
yjbJ_predicted,0.5,1,1,GTTGGACCCGGTATCTATTC,0,5004737
yjbJ_predicted,0.5,1,1,GTTGCTCACGCCCATTTCGT,0,5025863
yjbJ_predicted,0.5,1,1,GTTGCCGGCTACGCGGAGCA,0,5003205
yjbJ_predicted,0.5,1,1,GTTGCAATGATTGACCGGGG,0,5016339
yjbJ_predicted,0.5,1,1,GTTGACCTCATTAGAAAGTC,0,4999910
yjbJ_predicted,0.5,1,1,GTTGACCGTTAATTGGTGGT,0,5030286
yjbJ_predicted,0.5,1,1,GTTCTACTGCATTACTTCCT,0,4996252
yjbJ_predicted,0.5,1,1,GTTCGGCCGCCTCACAGCGA,0,5013035
yjbJ_predicted,0.5,1,1,GTTCCTGAACTTTGTGGGGG,0,5009339
yjbJ_predicted,0.5,1,1,GTTCCACGTGTATGTGACGC,0,5017324
yjbJ_predicted,0.5,1,1,GTTCAGTACCTAATACAGGG,0,5023085
yjbJ_predicted,0.5,1,1,GTTCACCACCGTGCTTTCCT,0,5011950
yjbJ_predicted,0.5,1,1,GTTCAATTAGAAGATGCATC,0,5006705
yjbJ_predicted,0.5,1,1,GTTATACGCAATAACCCTTA,0,5013688
yjbJ_predicted,0.5,1,1,GTTACGTTCATGATGGTAGA,0,5005736
yjbJ_predicted,0.5,1,1,GTTACAGGAGACGAACAAGT,0,5006058
yjbJ_predicted,0.5,1,1,GTGTTGTTATATACCGCAAC,0,5021039
yjbJ_predicted,0.5,1,1,GTGTTAGTAGAATCACCATT,0,5028444
yjbJ_predicted,0.5,1,1,GTGTGTAGAATAGTTGCGAC,0,5004776
yjbJ_predicted,0.5,1,1,GTGTGCCCGTTAGTGGTAAA,0,5000730
yjbJ_predicted,0.5,1,1,GTGTCAGGGGCTAAGGTCGC,0,5022489
yjbJ_predicted,0.5,1,1,GTGTATGGTCCATTGGGGGG,0,5003351
yjbJ_predicted,0.5,1,1,GTGTACTGTGTCGTTCTCTG,0,5017592
yjbJ_predicted,0.5,1,1,GTGGTCCCAGTGGTTCTGAC,0,5005018
yjbJ_predicted,0.5,1,1,GTGGTATCAAGTTTATGCAT,0,5024075
yjbJ_predicted,0.5,1,1,GTGGTAAGGTCTCCAATGCC,0,5012376
yjbJ_predicted,0.5,1,1,GTGGGTGCCACGTAGAAATA,0,5000878
yjbJ_predicted,0.5,1,1,GTGGGACCGTATCCGTAACG,0,5030096
yjbJ_predicted,0.5,1,1,GTGGCTCGGGCACCATTGTG,0,4996428
yjbJ_predicted,0.5,1,1,GTGGCTACGCAGGACGTGTC,0,5005874
yjbJ_predicted,0.5,1,1,GTGCTTATCTATCGTCCTGA,0,5009417
yjbJ_predicted,0.5,1,1,GTGCTACAAGTGGGGCGGGG,0,5007670
yjbJ_predicted,0.5,1,1,GTGCCCGTACCAGAGGGTGC,0,5017549
yjbJ_predicted,0.5,1,1,GTGCCAGTGTAATAATAGTT,0,5021398
yjbJ_predicted,0.5,1,1,GTGCATGTGGAGCCTGAAAA,0,5019191
yjbJ_predicted,0.5,1,1,GTGCAACATATCAAGAAATG,0,5005042
yjbJ_predicted,0.5,1,1,GTGATTCAGGGCACTACTGA,0,5023416
yjbJ_predicted,0.5,1,1,GTGATGTTTCACGTCGCGTG,0,5008506
yjbJ_predicted,0.5,1,1,GTGATGTGTCGCCACTGCCT,0,4994870
yjbJ_predicted,0.5,1,1,GTGATCCCTAGTAAGACTAC,0,4994863
yjbJ_predicted,0.5,1,1,GTGATAAATATTTCCTGAAC,0,5011840
yjbJ_predicted,0.5,1,1,GTGAGGCCCGTCTCGGAGTA,0,5011201
yjbJ_predicted,0.5,1,1,GTGAGGCACAATAGTTGCAG,0,5007321
yjbJ_predicted,0.5,1,1,GTGAATTCTCGCATACCCGC,0,5017577
yjbJ_predicted,0.5,1,1,GTGAAAATTACAGCAGTGAG,0,4998945
yjbJ_predicted,0.5,1,1,GTCTGTCTCCGGGCCTAGGC,0,5023432
yjbJ_predicted,0.5,1,1,GTCTGTAATGAAGCCGATAT,0,5023139
yjbJ_predicted,0.5,1,1,GTCTGACTCGGCTTAACACG,0,5029358
yjbJ_predicted,0.5,1,1,GTCTCAGAGGACAGAATCAG,0,4995311
yjbJ_predicted,0.5,1,1,GTCTAACATATCCTAAGTAG,0,5008007
yjbJ_predicted,0.5,1,1,GTCGTGTTATCCTCTTTACA,0,5016728
yjbJ_predicted,0.5,1,1,GTCGGTTTTGACGTCTTGGT,0,5026904
yjbJ_predicted,0.5,1,1,GTCGCACATGTGCCTCTTCG,0,5013679
yjbJ_predicted,0.5,1,1,GTCGAACTGACTCTATGGCC,0,5015866
yjbJ_predicted,0.5,1,1,GTCCTTTGAGGCAAGCATAT,0,5019559
yjbJ_predicted,0.5,1,1,GTCCTGAATCCTCATCCAGC,0,5002563
yjbJ_predicted,0.5,1,1,GTCCTCTTACCCACACAATT,0,5017654
yjbJ_predicted,0.5,1,1,GTCCTAACCGGCGTTATAAG,0,5004501
yjbJ_predicted,0.5,1,1,GTCCCTCGGACCAGCGGCGA,0,5029189
yjbJ_predicted,0.5,1,1,GTCCATTCTCACCCCGGCCA,0,5026326
yjbJ_predicted,0.5,1,1,GTCCAGAAGACCAAAAAGAG,0,5000441
yjbJ_predicted,0.5,1,1,GTCCACATTTTTTCCACTTT,0,5000585
yjbJ_predicted,0.5,1,1,GTCATAGTGAAATCACCACC,0,4996796
yjbJ_predicted,0.5,1,1,GTCAGTCTCTATCTGGAGAG,0,5017628
yjbJ_predicted,0.5,1,1,GTCAGTCAGAGCTGCAGCAT,0,5015515
yjbJ_predicted,0.5,1,1,GTCAGGTCTATGTCTCCTGA,0,5012790
yjbJ_predicted,0.5,1,1,GTCAGGGCGTTGGGCGCGCT,0,5006678
yjbJ_predicted,0.5,1,1,GTCAGGCTGTAACTAGCTAC,0,5004041
yjbJ_predicted,0.5,1,1,GTCAGAGTCGTTGGTGTATT,0,5023497
yjbJ_predicted,0.5,1,1,GTCACGGTAAGCATGAAGGC,0,5015818
yjbJ_predicted,0.5,1,1,GTCACAATGGGCCAACCAAA,0,5031210
yjbJ_predicted,0.5,1,1,GTCAATAGGTTCACTCAGGT,0,5007711
yjbJ_predicted,0.5,1,1,GTCAAACGTGGCTGGGCTGT,0,5025536
yjbJ_predicted,0.5,1,1,GTCAAAATAAGATTAGGTAC,0,5003810
yjbJ_predicted,0.5,1,1,GTCAAAAGATCCCTATCGAA,0,5003917
yjbJ_predicted,0.5,1,1,GTATTTGCCGATCACACACG,0,5011877
yjbJ_predicted,0.5,1,1,GTATTGTAACTTTGGAGAGC,0,4996117
yjbJ_predicted,0.5,1,1,GTATTCGATAAACCGTTGAA,0,5027217
yjbJ_predicted,0.5,1,1,GTATAGTTCTACCTAATACA,0,5027772
yjbJ_predicted,0.5,1,1,GTAGGCCCCGGAAGTTTATC,0,4996382
yjbJ_predicted,0.5,1,1,GTAGGAGGATCTCGACGGTA,0,5008653
yjbJ_predicted,0.5,1,1,GTAGGACATCACATGGACCA,0,5021655
yjbJ_predicted,0.5,1,1,GTAGCGGGGTGCATGTCATC,0,5019887
yjbJ_predicted,0.5,1,1,GTAGAAGCCGGGTTATTCAT,0,5001029
yjbJ_predicted,0.5,1,1,GTAGAAAGACGTACCCGTGC,0,5021258
yjbJ_predicted,0.5,1,1,GTACTCCAAGACCAAATAAT,0,5030249
yjbJ_predicted,0.5,1,1,GTACGCACTCCGGTATAGCT,0,5009317
yjbJ_predicted,0.5,1,1,GTACGAGTCCTATTTCTTAG,0,5005870
yjbJ_predicted,0.5,1,1,GTACCATCATTGGATACTGC,0,5020936
yjbJ_predicted,0.5,1,1,GTACATTCTCCCGCATTTGT,0,5013403
yjbJ_predicted,0.5,1,1,GTACAGTTGCTTCAGGCATG,0,5000989
yjbJ_predicted,0.5,1,1,GTAATCATAGGTGAAGCGCC,0,5020943
yjbJ_predicted,0.5,1,1,GTAATCATAATTGTGCTCAT,0,5009709
yjbJ_predicted,0.5,1,1,GTAACTACAAACCCCTCGGA,0,5007335
yjbJ_predicted,0.5,1,1,GGTTTTGGATATCTAGTATT,0,5001229
yjbJ_predicted,0.5,1,1,GGTTTGAAAATGTTGTATAA,0,5015470
yjbJ_predicted,0.5,1,1,GGTTTAGATGGTCATTCTGG,0,5030514
yjbJ_predicted,0.5,1,1,GGTTTAATTTAGTAACATGG,0,4997989
yjbJ_predicted,0.5,1,1,GGTTCGGCATCTACGGGCTG,0,5001348
yjbJ_predicted,0.5,1,1,GGTTAAGTATGATGTGTGTA,0,5024510
yjbJ_predicted,0.5,1,1,GGTGTTTCATTCCGGGTCAA,0,5018724
yjbJ_predicted,0.5,1,1,GGTGTCTGTCGCTGGGGTAC,0,5004479
yjbJ_predicted,0.5,1,1,GGTGGTGTGGCTACATGGAG,0,4999598
yjbJ_predicted,0.5,1,1,GGTGGGTAAGTCCCGAACTG,0,5020927
yjbJ_predicted,0.5,1,1,GGTGGCCAGGCGTCTCAGTC,0,5024235
yjbJ_predicted,0.5,1,1,GGTCCTGAAAAGCAGAGAAT,0,5011548
yjbJ_predicted,0.5,1,1,GGTCATTTGCATAGTGCAGG,0,5020090
yjbJ_predicted,0.5,1,1,GGTCATTTCTAACCAGCATG,0,4994836
yjbJ_predicted,0.5,1,1,GGTCAGCTGAGATAGTTAGG,0,4998187
yjbJ_predicted,0.5,1,1,GGTATGACTTCTTCGCTTAG,0,5026845
yjbJ_predicted,0.5,1,1,GGTATCGGCGATCTATCTCA,0,5030385
yjbJ_predicted,0.5,1,1,GGTATAGCATACAACCTGTG,0,5031251
yjbJ_predicted,0.5,1,1,GGTACGACTGCCCTAGGCCT,0,5008647
yjbJ_predicted,0.5,1,1,GGTACATATTGGGTATAAAG,0,5015346
yjbJ_predicted,0.5,1,1,GGTAACCTTGCGGTACATAT,0,5020109
yjbJ_predicted,0.5,1,1,GGGTTGACCGTACCAGCAAG,0,5017530
yjbJ_predicted,0.5,1,1,GGGTTAAGGTGAATCTAGTC,0,5012844
yjbJ_predicted,0.5,1,1,GGGTGTCATTCCTTACGATT,0,5024204
yjbJ_predicted,0.5,1,1,GGGTGAGAGTTCGAGATGTA,0,5030163
yjbJ_predicted,0.5,1,1,GGGTACGCCACACTTTAGCA,0,5002858
yjbJ_predicted,0.5,1,1,GGGTACCGAGGTGATCTATG,0,5024950
yjbJ_predicted,0.5,1,1,GGGGTTAGGTCTGCGCAAAC,0,5029120
yjbJ_predicted,0.5,1,1,GGGGGGGTTTGGAGGAGTTT,0,5005850
yjbJ_predicted,0.5,1,1,GGGGGGGAGTTTTTTTCATG,0,5016240
yjbJ_predicted,0.5,1,1,GGGGGAGCTCACGAACGTTA,0,5000257
yjbJ_predicted,0.5,1,1,GGGGCATGTTTCCCGGTAAG,0,5026207
yjbJ_predicted,0.5,1,1,GGGGATCACAATGTTGAAAA,0,5029592
yjbJ_predicted,0.5,1,1,GGGGAGGGTTAGCCTACTTA,0,5002111
yjbJ_predicted,0.5,1,1,GGGCTTTCGGATATGTCGAT,0,5006088
yjbJ_predicted,0.5,1,1,GGGCTAAAAGAGGAATCTGT,0,5010491
yjbJ_predicted,0.5,1,1,GGGCGGAGTTCTCCCTGTCG,0,4998069
yjbJ_predicted,0.5,1,1,GGGCGCTCCTGGTTGGCCTG,0,5018405
yjbJ_predicted,0.5,1,1,GGGCGACACGAGGATTCAAA,0,5013843
yjbJ_predicted,0.5,1,1,GGGCACCGTCCGCGGGCTCC,0,5015824
yjbJ_predicted,0.5,1,1,GGGATTTCTACGACTCTAGT,0,4995683
yjbJ_predicted,0.5,1,1,GGGAGGCGGTGCACGTATAA,0,4999514
yjbJ_predicted,0.5,1,1,GGGAGAGGACACAGTGGCCT,0,5006215
yjbJ_predicted,0.5,1,1,GGGACGCGGGGTACTCGACC,0,5027277
yjbJ_predicted,0.5,1,1,GGCTGACTTAGCATCCCTGA,0,5018924
yjbJ_predicted,0.5,1,1,GGCTCGCACGTTAGCCCTTC,0,5019903
yjbJ_predicted,0.5,1,1,GGCTCAAGGAATGACGCGAC,0,5008503
yjbJ_predicted,0.5,1,1,GGCGTGGGGGCTAAAAGCAT,0,4998667
yjbJ_predicted,0.5,1,1,GGCGTGGACCGGGATGGATG,0,5012856
yjbJ_predicted,0.5,1,1,GGCGTCCCCCGCCCTACGAC,0,5017491
yjbJ_predicted,0.5,1,1,GGCGGGGAATGGTTAGAAAC,0,5022230
yjbJ_predicted,0.5,1,1,GGCGGGATTATTGGCTTAAA,0,5019512
yjbJ_predicted,0.5,1,1,GGCGCAATCACGAAAAAACT,0,5000508
yjbJ_predicted,0.5,1,1,GGCGAGCCGTGTTTGGAGCT,0,4999025
yjbJ_predicted,0.5,1,1,GGCCTGAGTCAGAGAGAATA,0,4998237
yjbJ_predicted,0.5,1,1,GGCCGCGGACTTAGCGAGAA,0,5000445
yjbJ_predicted,0.5,1,1,GGCCCGGACGTGTGGCGACG,0,5004148
yjbJ_predicted,0.5,1,1,GGCCCCGATGCCTCTTTCGT,0,5023141
yjbJ_predicted,0.5,1,1,GGCCCAGTCACCACGTGCTG,0,5017749
yjbJ_predicted,0.5,1,1,GGCCACTGTACGTTTGCGAT,0,5009436
yjbJ_predicted,0.5,1,1,GGCATGGTGCATAAGAAACC,0,5020984
yjbJ_predicted,0.5,1,1,GGCATCCGAATAGTCAGCGG,0,5003203
yjbJ_predicted,0.5,1,1,GGCAGCGACTGACAGACAAA,0,5000235
yjbJ_predicted,0.5,1,1,GGCACGGTTTGTCTCTTCGC,0,5015023
yjbJ_predicted,0.5,1,1,GGCACGGGCGCGGCATTAGC,0,5003876
yjbJ_predicted,0.5,1,1,GGATTAACGCTGAGACCCAG,0,5013124
yjbJ_predicted,0.5,1,1,GGATGTAATATCCGGTCGAA,0,5005008
yjbJ_predicted,0.5,1,1,GGATGGATCGTCTGTGCTAC,0,5023168
yjbJ_predicted,0.5,1,1,GGATGATCTCACCGGGCCTC,0,5012035
yjbJ_predicted,0.5,1,1,GGATCACGATTGGCGACTGC,0,5023376
yjbJ_predicted,0.5,1,1,GGAGTCAAGCTTCGAAGCAA,0,5001449
yjbJ_predicted,0.5,1,1,GGAGGACAATATTGAGGATT,0,5009985
yjbJ_predicted,0.5,1,1,GGAGCTCAATTACTGAGTGT,0,5018245
yjbJ_predicted,0.5,1,1,GGAGCGGACGGGATGAGTGT,0,5024752
yjbJ_predicted,0.5,1,1,GGACTCTCAATCAATCTATC,0,5000436
yjbJ_predicted,0.5,1,1,GGACGTACAGGTTCAGCTGA,0,5028121
yjbJ_predicted,0.5,1,1,GGACGCCGCCAAGGTCCTAA,0,5017487
yjbJ_predicted,0.5,1,1,GGACCGCTCAGAGAAGACTT,0,5000351
yjbJ_predicted,0.5,1,1,GGACCACCATTCGTGGACGG,0,5014798
yjbJ_predicted,0.5,1,1,GGACCAACAAGTATACCAAC,0,5003751
yjbJ_predicted,0.5,1,1,GGAATTTATAACGTCTTCCG,0,5005068
yjbJ_predicted,0.5,1,1,GGAAGGTAGTCTTTCAAAAA,0,5005690
yjbJ_predicted,0.5,1,1,GGAAAGTTGGCCTAAACAGC,0,5025832
yjbJ_predicted,0.5,1,1,GCTTTTCGCCTCGGCCTGGA,0,5010347
yjbJ_predicted,0.5,1,1,GCTTTCGGGGCAGAAGCGGT,0,5018961
yjbJ_predicted,0.5,1,1,GCTTTAGCATCAATCTTCCA,0,5016104
yjbJ_predicted,0.5,1,1,GCTTGGATTTAAAGGTTGTG,0,5010672
yjbJ_predicted,0.5,1,1,GCTTCTGTTTATAATCTGCA,0,4996513
yjbJ_predicted,0.5,1,1,GCTTCTGCGTGGTCCCGGGC,0,5001833
yjbJ_predicted,0.5,1,1,GCTTAGGTTATGGAAAGGTA,0,5021353
yjbJ_predicted,0.5,1,1,GCTGTGTCTATAAGTATTCT,0,5021095
yjbJ_predicted,0.5,1,1,GCTGGTGTATTGTGTAGAAA,0,5008762
yjbJ_predicted,0.5,1,1,GCTGGCTACCTAGCGAGGAC,0,5008277
yjbJ_predicted,0.5,1,1,GCTGCCCAGTAGGTAGGTGT,0,5018144
yjbJ_predicted,0.5,1,1,GCTCTCTTACTGCGAGCATA,0,5014948
yjbJ_predicted,0.5,1,1,GCTCGAACAATAGTGAAATG,0,5001285
yjbJ_predicted,0.5,1,1,GCTCATTAGTACTCGGTTAC,0,5012722
yjbJ_predicted,0.5,1,1,GCTCACTTGTTTGAGCCCCG,0,5011063
yjbJ_predicted,0.5,1,1,GCTATTTGCTGGTCGTTAAA,0,5016416
yjbJ_predicted,0.5,1,1,GCTATCGGGACAGATGTATG,0,5005617
yjbJ_predicted,0.5,1,1,GCTATAGCTATCTGTGTGTT,0,5030086
yjbJ_predicted,0.5,1,1,GCTAGTTGTAATATGCATCT,0,5009570
yjbJ_predicted,0.5,1,1,GCTACGACCGATCGCGCCCT,0,5031212
yjbJ_predicted,0.5,1,1,GCTAAGGGCTTAGCGATCAC,0,5008125
yjbJ_predicted,0.5,1,1,GCGTTCACAAGTGGAACTCC,0,5013361
yjbJ_predicted,0.5,1,1,GCGTTATTGACGGATATTGG,0,5027877
yjbJ_predicted,0.5,1,1,GCGTTAGAAACGAAGACAAA,0,5002021
yjbJ_predicted,0.5,1,1,GCGTGGGACCGGTACCCTTC,0,5021433
yjbJ_predicted,0.5,1,1,GCGTGCATACGCTCTCCGGC,0,5030373
yjbJ_predicted,0.5,1,1,GCGTCCATAGAGTGGAGGTT,0,5013105
yjbJ_predicted,0.5,1,1,GCGTCACCGATATCAGGATT,0,5008077
yjbJ_predicted,0.5,1,1,GCGTCAAAAGTACTCGAGGC,0,5027288
yjbJ_predicted,0.5,1,1,GCGTAAACGGGGAATTCTGG,0,5023921
yjbJ_predicted,0.5,1,1,GCGGTTAGTGGGCTGTTATG,0,5013634
yjbJ_predicted,0.5,1,1,GCGGGGCTATGTATCCTTAG,0,4996355
yjbJ_predicted,0.5,1,1,GCGGCGGCGAACCAAGGGCG,0,5026398
yjbJ_predicted,0.5,1,1,GCGGAGGTTCTTTCATATCG,0,5014780
yjbJ_predicted,0.5,1,1,GCGGAGGATAGCGGCCCCTG,0,4995106
yjbJ_predicted,0.5,1,1,GCGCTCCGCGGGGGTGTAAT,0,5029181
yjbJ_predicted,0.5,1,1,GCGCCTCATCGCTGCTGGAG,0,5015135
yjbJ_predicted,0.5,1,1,GCGCCGGTCCATACGCAAAC,0,5026604
yjbJ_predicted,0.5,1,1,GCGCCATCCATACCTCGGAC,0,5025236
yjbJ_predicted,0.5,1,1,GCGATTGGATGTGCAGCGGC,0,4999557
yjbJ_predicted,0.5,1,1,GCGATGTATAGGTTGTGGTT,0,4998760
yjbJ_predicted,0.5,1,1,GCGATCAATTATTGAGTGAC,0,5015032
yjbJ_predicted,0.5,1,1,GCGATATTGATGAGATCTTT,0,5005394
yjbJ_predicted,0.5,1,1,GCGAGTGATCTAGGTCCACA,0,4998748
yjbJ_predicted,0.5,1,1,GCGAGACGCAGTAATAGGGA,0,5021273
yjbJ_predicted,0.5,1,1,GCGAGAATCGTGATACTTCA,0,5007939
yjbJ_predicted,0.5,1,1,GCCTTTAGGCTTGATGCGGC,0,5029300
yjbJ_predicted,0.5,1,1,GCCTTGCCGGGGATCATGAA,0,5005902
yjbJ_predicted,0.5,1,1,GCCTTCACGGGCAGAACTGC,0,5007058
yjbJ_predicted,0.5,1,1,GCCTACCTACACACAAGATA,0,5027596
yjbJ_predicted,0.5,1,1,GCCGTACATCCTGTACCATC,0,5017586
yjbJ_predicted,0.5,1,1,GCCGGTCTCCGTCCATAGCT,0,5026480
yjbJ_predicted,0.5,1,1,GCCGGCTGTGGGTGTTGAGT,0,5026443
yjbJ_predicted,0.5,1,1,GCCGGCTAGCTCAACTTCCA,0,5030706
yjbJ_predicted,0.5,1,1,GCCGGAGGATTTGAACACGA,0,5005062
yjbJ_predicted,0.5,1,1,GCCGATTCCTTGTGCACGCA,0,5004072
yjbJ_predicted,0.5,1,1,GCCCTTAGCTGGGAGCGGTA,0,5000853
yjbJ_predicted,0.5,1,1,GCCCGGCACCTTCGGTGTCC,0,5030398
yjbJ_predicted,0.5,1,1,GCCCGCGGATTATTCGGGTG,0,5021174
yjbJ_predicted,0.5,1,1,GCCCAATTTTTCCAGTGAAT,0,5020802
yjbJ_predicted,0.5,1,1,GCCATTTACCGATCATTTAG,0,4996752
yjbJ_predicted,0.5,1,1,GCCAGTCCAGTATGCCACAG,0,5019381
yjbJ_predicted,0.5,1,1,GCCACTTCCATCGTTTGATT,0,4995230
yjbJ_predicted,0.5,1,1,GCCACGAGTAAACTCGTCGG,0,5024506
yjbJ_predicted,0.5,1,1,GCCACCGGAAACTGGGCCAG,0,5015281
yjbJ_predicted,0.5,1,1,GCCACCCAAATAAGTCTATG,0,5018729
yjbJ_predicted,0.5,1,1,GCATTTCCGCCTAAAGACGC,0,5000758
yjbJ_predicted,0.5,1,1,GCATTCATGGCGACACCTAT,0,5025585
yjbJ_predicted,0.5,1,1,GCATTAGGCTGCAGTGCCGG,0,5028979
yjbJ_predicted,0.5,1,1,GCAGCTTGACATTGGGCAAA,0,5006470
yjbJ_predicted,0.5,1,1,GCAGCTAGTGGCAATAATTG,0,5005140
yjbJ_predicted,0.5,1,1,GCAGCGCTCTTTGGTCTATC,0,5026635
yjbJ_predicted,0.5,1,1,GCAGCCTTAGTATATGATGT,0,5011002
yjbJ_predicted,0.5,1,1,GCAGCCTCCCTTTTTGTGTC,0,5006266
yjbJ_predicted,0.5,1,1,GCAGCACATATAGGGCTTGA,0,5030063
yjbJ_predicted,0.5,1,1,GCAGATTTCGATGGGCAGTA,0,5009767
yjbJ_predicted,0.5,1,1,GCAGACGGTGCGGTACTAAC,0,5000039
yjbJ_predicted,0.5,1,1,GCAGAAATTTCAGCGAAATT,0,5010470
yjbJ_predicted,0.5,1,1,GCACCTAGCGTACTTATGCT,0,5023996
yjbJ_predicted,0.5,1,1,GCACATTGCTCACGTGCTTG,0,5018497
yjbJ_predicted,0.5,1,1,GCACACCGCTTCAATTGTCT,0,4998922
yjbJ_predicted,0.5,1,1,GCAATTAAAGGCGTTATGCC,0,5015972
yjbJ_predicted,0.5,1,1,GCAATGGACCCTACTTCATG,0,5008742
yjbJ_predicted,0.5,1,1,GCAAGCTCAATTCCTGAACC,0,5005515
yjbJ_predicted,0.5,1,1,GCAAGCAAATCATGTGTTAA,0,4999930
yjbJ_predicted,0.5,1,1,GCAACTACGTGAACGGCCTA,0,5021037
yjbJ_predicted,0.5,1,1,GCAACCTCCTTGGGTTATCT,0,5009375
yjbJ_predicted,0.5,1,1,GCAACACGGAACTAAGTCAC,0,5005871
yjbJ_predicted,0.5,1,1,GCAAACAGGCCCAATCGCAT,0,4998191
yjbJ_predicted,0.5,1,1,GCAAAAACGCGGTTCGCCGT,0,5027788
yjbJ_predicted,0.5,1,1,GATTTTGTTGATCATCGATA,0,5029933
yjbJ_predicted,0.5,1,1,GATTTTACGGTGGTTGTATG,0,5021073
yjbJ_predicted,0.5,1,1,GATTTGAACCCTCTCTACTT,0,5008842
yjbJ_predicted,0.5,1,1,GATTGTAGACCGTAAAGGAG,0,5024814
yjbJ_predicted,0.5,1,1,GATTGGCGGCCGCGTAGTTC,0,5005168
yjbJ_predicted,0.5,1,1,GATTCTCTACTTTCAAGAAG,0,5029959
yjbJ_predicted,0.5,1,1,GATTCGAATGCAAATGGAGT,0,5009700
yjbJ_predicted,0.5,1,1,GATTATGGACGCTACACGCT,0,5031053
yjbJ_predicted,0.5,1,1,GATGGAGTCTTGAACCGTCA,0,5021275
yjbJ_predicted,0.5,1,1,GATGATCTATTCCAAATACA,0,5018810
yjbJ_predicted,0.5,1,1,GATGACCCTGGCGGTTAGTC,0,5016305
yjbJ_predicted,0.5,1,1,GATGACACCAGGACCTGATT,0,5027621
yjbJ_predicted,0.5,1,1,GATGAAAGGAGCGTAGTGAT,0,4996838
yjbJ_predicted,0.5,1,1,GATCTCACCCTCAGGGGGAC,0,5023032
yjbJ_predicted,0.5,1,1,GATCCTGTCATCCATGAGGG,0,5022731
yjbJ_predicted,0.5,1,1,GATCCACGCCACTTCTGATA,0,5028349
yjbJ_predicted,0.5,1,1,GATCAACAAGAGTGGCTGGG,0,5024236
yjbJ_predicted,0.5,1,1,GATATTTTCGAGTGCGACCC,0,5025456
yjbJ_predicted,0.5,1,1,GATATATATCTGCAACTACT,0,5024618
yjbJ_predicted,0.5,1,1,GATACTCTATGTGAAGGTGT,0,5003800
yjbJ_predicted,0.5,1,1,GATACCTTGCATCGGCTAAG,0,5002310
yjbJ_predicted,0.5,1,1,GATAAACGTAGGCGATTAGT,0,5009550
yjbJ_predicted,0.5,1,1,GATAAAATACGTGCCTAGCC,0,5025848
yjbJ_predicted,0.5,1,1,GAGTTCCGTGTGCGACATTG,0,4999564
yjbJ_predicted,0.5,1,1,GAGTAGCGAGTCTATAGTAG,0,5017439
yjbJ_predicted,0.5,1,1,GAGGTTCCGCTTACCGCGCG,0,4999138
yjbJ_predicted,0.5,1,1,GAGGGTCGCCATGGGGAACG,0,4999574
yjbJ_predicted,0.5,1,1,GAGGGCAGGCATTTCCACAT,0,5023493
yjbJ_predicted,0.5,1,1,GAGGCGCATGTTCCTATAAT,0,4995607
yjbJ_predicted,0.5,1,1,GAGGCATTTTTTCAGGTTGG,0,5002816
yjbJ_predicted,0.5,1,1,GAGGCATTCGGCATCTATGT,0,4997746
yjbJ_predicted,0.5,1,1,GAGGCATCGACCACGAGAAA,0,4998728
yjbJ_predicted,0.5,1,1,GAGGACTTTTTCCCATCTAA,0,5013682
yjbJ_predicted,0.5,1,1,GAGGACTCCTCTTCAGACCT,0,5017303
yjbJ_predicted,0.5,1,1,GAGCTAAAGTTATAGGACTT,0,5012975
yjbJ_predicted,0.5,1,1,GAGCGGGCCTACATGAATCT,0,5016979
yjbJ_predicted,0.5,1,1,GAGATATGATGTAATCGTTC,0,5015365
yjbJ_predicted,0.5,1,1,GAGACTAACAATTAAGGGAA,0,5026980
yjbJ_predicted,0.5,1,1,GACTTCGCATCCTCCGGGTC,0,5007620
yjbJ_predicted,0.5,1,1,GACTGTATATTGCGTACAAA,0,5005433
yjbJ_predicted,0.5,1,1,GACTATTTACCCATGCATGT,0,5025508
yjbJ_predicted,0.5,1,1,GACTAACCACTCGCATTAAT,0,5024970
yjbJ_predicted,0.5,1,1,GACGTATCGTTCAAGGGGAG,0,5020356
yjbJ_predicted,0.5,1,1,GACGGTCCGTATCTAACACA,0,5007400
yjbJ_predicted,0.5,1,1,GACGCCAGTTGTATCATCAC,0,5031149
yjbJ_predicted,0.5,1,1,GACCTCATGGTCCTTCGTGT,0,5012560
yjbJ_predicted,0.5,1,1,GACCGAAGAACAGGGATAAT,0,5002306
yjbJ_predicted,0.5,1,1,GACCCTGCGTCACAGAGAAC,0,4994900
yjbJ_predicted,0.5,1,1,GACCCTCCTGGTTCTCAGTG,0,5006758
yjbJ_predicted,0.5,1,1,GACCCGGTTTAAGCGTCTAA,0,5000303
yjbJ_predicted,0.5,1,1,GACCAGCCAAAGATCGCGAA,0,5005675
yjbJ_predicted,0.5,1,1,GACCACGTCTAAAGAGTCCG,0,5011896
yjbJ_predicted,0.5,1,1,GACATCATTCAATCGGGATA,0,5021770
yjbJ_predicted,0.5,1,1,GACAGTACGTCGGTTTGTTG,0,5007195
yjbJ_predicted,0.5,1,1,GACAGCTGTTCAAACAAAGT,0,4999069
yjbJ_predicted,0.5,1,1,GACACTGTGAGCGCGAGAAG,0,4997862
yjbJ_predicted,0.5,1,1,GACACCAGTCAGCATGCCAG,0,5023612
yjbJ_predicted,0.5,1,1,GACAAGCTCGCGTCGGCAGA,0,5029660
yjbJ_predicted,0.5,1,1,GACAAATATTGGGGCCAAGT,0,5008272
yjbJ_predicted,0.5,1,1,GACAAAGCGTCACGGCCGGT,0,4997003
yjbJ_predicted,0.5,1,1,GACAAAGACTTCACAAATGG,0,5013199
yjbJ_predicted,0.5,1,1,GAATGCGGAACCGCTCGGTT,0,5012400
yjbJ_predicted,0.5,1,1,GAATGAACTGACCCGTAGAG,0,5019117
yjbJ_predicted,0.5,1,1,GAATCCATTTTACCTAATAC,0,5001240
yjbJ_predicted,0.5,1,1,GAATACAGTCTTTGTAGATA,0,5020382
yjbJ_predicted,0.5,1,1,GAAGTGCCGGGCCAGTCGGA,0,5003514
yjbJ_predicted,0.5,1,1,GAAGTGCAAATTACGACCTT,0,5017814
yjbJ_predicted,0.5,1,1,GAAGTCGCAATTTTCTAGCG,0,4998554
yjbJ_predicted,0.5,1,1,GAAGGTAGCCTCGTCTCCCA,0,5021813
yjbJ_predicted,0.5,1,1,GAAGCTGGGTATGCTTGTTT,0,5025949
yjbJ_predicted,0.5,1,1,GAAGCAGGGGGATCTCCCTT,0,4997228
yjbJ_predicted,0.5,1,1,GAAGAGCGATCCGCGTATAT,0,5028399
yjbJ_predicted,0.5,1,1,GAACGTATAAGTCGCCTCAT,0,5000280
yjbJ_predicted,0.5,1,1,GAACGTAGAACCATCTGTTA,0,5031250
yjbJ_predicted,0.5,1,1,GAACGCTTCCTCTCGCACCT,0,5017962
yjbJ_predicted,0.5,1,1,GAACCCCCACGAACCAACGG,0,5024894
yjbJ_predicted,0.5,1,1,GAACCACGAGGGGATCTACC,0,5009939
yjbJ_predicted,0.5,1,1,GAAAGTCATACACTAACCGC,0,5008976
yjbJ_predicted,0.5,1,1,GAAAGCATGTGCATTCATCC,0,5008668
yjbJ_predicted,0.5,1,1,GAAAGAGCTTCCCGGGCACA,0,5013904
yjbJ_predicted,0.5,1,1,GAAAAGTATACACGCAATTT,0,4996958
yjbJ_predicted,0.5,1,1,GAAAACTATGGGACACGGTT,0,5013065
yjbJ_predicted,0.5,1,1,GAAAAACATCTAAACCTTAT,0,4995674
yjbJ_predicted,0.5,1,1,CTTTTAGTCTTAAATCTACT,0,5003894
yjbJ_predicted,0.5,1,1,CTTTGCAGTGTGAGGCACGG,0,5004278
yjbJ_predicted,0.5,1,1,CTTTGATCCTATCTTCATTA,0,5003749
yjbJ_predicted,0.5,1,1,CTTTGAGTTTAATGCGCTCG,0,5007469
yjbJ_predicted,0.5,1,1,CTTTCTACTCCGGGGTATAA,0,5021660
yjbJ_predicted,0.5,1,1,CTTTATGGGTATCGCGCAAC,0,5030976
yjbJ_predicted,0.5,1,1,CTTTAAACCATGGACACAAT,0,5031174
yjbJ_predicted,0.5,1,1,CTTGTGTAGTACTATTCATC,0,5004391
yjbJ_predicted,0.5,1,1,CTTGGGTTTGTGGATGGTTT,0,5004369
yjbJ_predicted,0.5,1,1,CTTGGCCCAGCGACTCTCTG,0,5000401
yjbJ_predicted,0.5,1,1,CTTGCTCGTATTCGTGGGTA,0,5021150
yjbJ_predicted,0.5,1,1,CTTGCGACCTTAGCTCCCCT,0,5021534
yjbJ_predicted,0.5,1,1,CTTGATATGGCCATAGGGTA,0,5007445
yjbJ_predicted,0.5,1,1,CTTGACTGAAGGGACCGCAT,0,5001407
yjbJ_predicted,0.5,1,1,CTTGACCATAGGCCTACGTA,0,4994702
yjbJ_predicted,0.5,1,1,CTTGACCAGTTCCAGCATAT,0,5000051
yjbJ_predicted,0.5,1,1,CTTCTGCTCAAATGAGTGAC,0,5030716
yjbJ_predicted,0.5,1,1,CTTCTACGGGGATCCGGGTC,0,5004215
yjbJ_predicted,0.5,1,1,CTTCGCGCCACAGAACTTTG,0,5025600
yjbJ_predicted,0.5,1,1,CTTCCCAGTTTGTACCTCGT,0,5017731
yjbJ_predicted,0.5,1,1,CTTCATGGGTAACGGGACTT,0,5007390
yjbJ_predicted,0.5,1,1,CTTAGTACAACCTCTTAGGG,0,5021356
yjbJ_predicted,0.5,1,1,CTTAGGCCGTGGACTCACCA,0,5011136
yjbJ_predicted,0.5,1,1,CTTAGGATGTAAGTATTTAT,0,5016307
yjbJ_predicted,0.5,1,1,CTTAGGAGCAAGCAAGTCTC,0,5009189
yjbJ_predicted,0.5,1,1,CTTAGCGTTCTTCTCTCTTC,0,5003300
yjbJ_predicted,0.5,1,1,CTTAGCCATTGACCACCTAG,0,5014684
yjbJ_predicted,0.5,1,1,CTTACTACTATTTATGGTTG,0,5022287
yjbJ_predicted,0.5,1,1,CTTACCGTCGAGATGTCAGC,0,5014869
yjbJ_predicted,0.5,1,1,CTTACAAGAACTTCCGGGGT,0,5009359
yjbJ_predicted,0.5,1,1,CTTAATACCATAATTGTCGT,0,5000872
yjbJ_predicted,0.5,1,1,CTTAAGTCACTGATGCGTTG,0,5026275
yjbJ_predicted,0.5,1,1,CTGTTCACGCCCGAGGGCCA,0,4995961
yjbJ_predicted,0.5,1,1,CTGTGTATTTAGTGCGTGAC,0,5012239
yjbJ_predicted,0.5,1,1,CTGTGTATATAGTTGTGCGG,0,5012572
yjbJ_predicted,0.5,1,1,CTGTGTAGACAATGCCCCTA,0,5025967
yjbJ_predicted,0.5,1,1,CTGTCCCAATGGCGTTCGAT,0,5016948
yjbJ_predicted,0.5,1,1,CTGTCATGTATCAGGCGGGC,0,5023870
yjbJ_predicted,0.5,1,1,CTGTAAAACATCCGTTATGA,0,5021107
yjbJ_predicted,0.5,1,1,CTGGTACGGTCCCGACAAAG,0,5006427
yjbJ_predicted,0.5,1,1,CTGGGGATTGGGCCACACAG,0,5000933
yjbJ_predicted,0.5,1,1,CTGGGCGCTGAGCCTATCCT,0,5000951
yjbJ_predicted,0.5,1,1,CTGGCCCCGGGTACTGACTC,0,5015125
yjbJ_predicted,0.5,1,1,CTGGCAATACGAATTTTTCT,0,5021046
yjbJ_predicted,0.5,1,1,CTGGAACCCACTGTGGCCAG,0,4999963
yjbJ_predicted,0.5,1,1,CTGCTCCAGAAAAAAAGGTG,0,5006284
yjbJ_predicted,0.5,1,1,CTGCGATCCGATCCGCTTGA,0,5007329
yjbJ_predicted,0.5,1,1,CTGCCGACTGCGACCACGAG,0,5009059
yjbJ_predicted,0.5,1,1,CTGCCGACGATGCCCCGAGT,0,5012037
yjbJ_predicted,0.5,1,1,CTGCATCAGTATTGTGTGAT,0,5004810
yjbJ_predicted,0.5,1,1,CTGCATCAGGACCACCACGA,0,5001752
yjbJ_predicted,0.5,1,1,CTGCATACGTCGAATCAGAT,0,5020907
yjbJ_predicted,0.5,1,1,CTGAGCTTTACGAGGTTGTC,0,5016204
yjbJ_predicted,0.5,1,1,CTGACGCTGTGCCCCGACTC,0,5020946
yjbJ_predicted,0.5,1,1,CTGACCGTGAAGCTGTTTAG,0,5009446
yjbJ_predicted,0.5,1,1,CTGACAGGGCTTGGTGATCA,0,5024853
yjbJ_predicted,0.5,1,1,CTGAACTTAGCCTCTGCATG,0,5011551
yjbJ_predicted,0.5,1,1,CTCTTGGACGCAGGTCTACT,0,5024442
yjbJ_predicted,0.5,1,1,CTCTGGTCATGCTGAGGGGG,0,5022080
yjbJ_predicted,0.5,1,1,CTCTCTGCCACGAAGCGATG,0,5029359
yjbJ_predicted,0.5,1,1,CTCTAGACCAGACCGTGGAC,0,5011303
yjbJ_predicted,0.5,1,1,CTCTAAATGTGGTGAATTTT,0,5026277
yjbJ_predicted,0.5,1,1,CTCGTAGATTACAGTGTGAT,0,5010227
yjbJ_predicted,0.5,1,1,CTCGGGATTAGCGTAATTTA,0,5030112
yjbJ_predicted,0.5,1,1,CTCGGAGAAAAGACCATACA,0,4995137
yjbJ_predicted,0.5,1,1,CTCGAAATTGATACTAGACA,0,5018918
yjbJ_predicted,0.5,1,1,CTCGAAACCGCCCCGCTGTC,0,5010132
yjbJ_predicted,0.5,1,1,CTCCTTCCGGTGTGCCGAGT,0,5007492
yjbJ_predicted,0.5,1,1,CTCCTCTTCCCCTGGATCGA,0,5020491
yjbJ_predicted,0.5,1,1,CTCCGATGACTACTTGTAGT,0,5029275
yjbJ_predicted,0.5,1,1,CTCCGAATTCAGCGCGCCAT,0,5009216
yjbJ_predicted,0.5,1,1,CTCCCAACACAAGAGAGCGG,0,5018076
yjbJ_predicted,0.5,1,1,CTCCAGCGGCCAGAGCGAGG,0,5014408
yjbJ_predicted,0.5,1,1,CTCATGACAAAGGGGTGGTC,0,5015076
yjbJ_predicted,0.5,1,1,CTCATCTGTTCTTTACGGTT,0,5020902
yjbJ_predicted,0.5,1,1,CTCAGAGCTTAATCGAGCGC,0,5000746
yjbJ_predicted,0.5,1,1,CTCACGAGCACGAACGTTGC,0,5000195
yjbJ_predicted,0.5,1,1,CTCAACATGAGTACTCGGGC,0,5007765
yjbJ_predicted,0.5,1,1,CTCAACAACGTGGGAACCGG,0,4996846
yjbJ_predicted,0.5,1,1,CTATTGAGCAACGAGCCTTG,0,5001835
yjbJ_predicted,0.5,1,1,CTATTCTGAGTTTTATCCTA,0,5009272
yjbJ_predicted,0.5,1,1,CTATGGTTCGCCGCGGCCCA,0,5015126
yjbJ_predicted,0.5,1,1,CTATGAGCCTCTGAATCGAT,0,5026644
yjbJ_predicted,0.5,1,1,CTATCGCACTAATTGAGGTC,0,5025317
yjbJ_predicted,0.5,1,1,CTATATCTTGCAATGATCTC,0,5020771
yjbJ_predicted,0.5,1,1,CTATATCCCAGAACAAATTA,0,5017339
yjbJ_predicted,0.5,1,1,CTACGGCGTGCTGGTTGGCC,0,5007835
yjbJ_predicted,0.5,1,1,CTACGGCAATAGGGTGGACA,0,5015432
yjbJ_predicted,0.5,1,1,CTACGGATCGCGGATGTACT,0,5018392
yjbJ_predicted,0.5,1,1,CTACGAGAACACTCGTGGAA,0,5028592
yjbJ_predicted,0.5,1,1,CTACCGTGAAACCAGGCGCT,0,5030754
yjbJ_predicted,0.5,1,1,CTAATGGGGGCTCGGCATCA,0,5013102
yjbJ_predicted,0.5,1,1,CTAATATCACACGCCCGCAT,0,4999415
yjbJ_predicted,0.5,1,1,CTAAGCTGTCGGATGAAGTA,0,5011993
yjbJ_predicted,0.5,1,1,CTAAGCTCTCATGGTTGCAG,0,5005157
yjbJ_predicted,0.5,1,1,CTAAGCGGATGAGCAAGTAC,0,5017709
yjbJ_predicted,0.5,1,1,CTAACTTGGTTCACGACCTA,0,5030644
yjbJ_predicted,0.5,1,1,CTAACCGATAAATCCCCCCC,0,5003907
yjbJ_predicted,0.5,1,1,CTAACATAGTTTAGAGGCTC,0,5011391
yjbJ_predicted,0.5,1,1,CTAAATGCTATGAGGCCCGT,0,5006755
yjbJ_predicted,0.5,1,1,CTAAACCGAATAGATACCGA,0,5017336
yjbJ_predicted,0.5,1,1,CGTTTCAGACTTCGAATTGA,0,5020730
yjbJ_predicted,0.5,1,1,CGTTGCGTTTTGGTCCATAG,0,5014039
yjbJ_predicted,0.5,1,1,CGTTCGGCTCTTGCTACTTC,0,4996015
yjbJ_predicted,0.5,1,1,CGTTATGATGTAACTGTTAG,0,5000631
yjbJ_predicted,0.5,1,1,CGTGTGTTCGATGCAAACGT,0,5010683
yjbJ_predicted,0.5,1,1,CGTGTGACGGGGGAGGAGTC,0,4996841
yjbJ_predicted,0.5,1,1,CGTGCAGTCATTAAGCAACA,0,5025285
yjbJ_predicted,0.5,1,1,CGTGACTGAAGTAGTGGCCG,0,5030508
yjbJ_predicted,0.5,1,1,CGTGAATCCCCATAATATTC,0,5018382
yjbJ_predicted,0.5,1,1,CGTCTGGCCCACAGTAGGAT,0,5006416
yjbJ_predicted,0.5,1,1,CGTCTGACGATTTTGCTGGA,0,5024692
yjbJ_predicted,0.5,1,1,CGTCTCTGCTGAAATGCAGA,0,4996688
yjbJ_predicted,0.5,1,1,CGTCGTGGATGTGGAGGTTC,0,4995845
yjbJ_predicted,0.5,1,1,CGTCGGAGTGGTCTAACCGG,0,5011613
yjbJ_predicted,0.5,1,1,CGTCGGACCATGAGGGGTCC,0,5003038
yjbJ_predicted,0.5,1,1,CGTCGAGGTACTCTTTGGCA,0,5022326
yjbJ_predicted,0.5,1,1,CGTCCTGTGCTCACCTTACT,0,4994847
yjbJ_predicted,0.5,1,1,CGTCCTCTGTATAATGTGGC,0,5001286
yjbJ_predicted,0.5,1,1,CGTCACGCCAACTAGGCAAA,0,5014130
yjbJ_predicted,0.5,1,1,CGTATTAATCATAAAAGTAC,0,5007630
yjbJ_predicted,0.5,1,1,CGTATGACGGCTTTCTTACC,0,5027218
yjbJ_predicted,0.5,1,1,CGTATCCATCGTTTCTTCCT,0,5018099
yjbJ_predicted,0.5,1,1,CGTAGTGTAACTCAATTAAT,0,5014413
yjbJ_predicted,0.5,1,1,CGTAGGTATGTCGTTCGGTG,0,4995453
yjbJ_predicted,0.5,1,1,CGTAGGGCGAAGTGTATAGG,0,4995977
yjbJ_predicted,0.5,1,1,CGTAGCCCGGCTGGAAACGG,0,4995788
yjbJ_predicted,0.5,1,1,CGTAGCAGCAAATGTGGGCT,0,5005291
yjbJ_predicted,0.5,1,1,CGTAGCAACGGGCCATACCT,0,5022403
yjbJ_predicted,0.5,1,1,CGTAAGATCTGTTTGATCCC,0,5025325
yjbJ_predicted,0.5,1,1,CGGTTGTTCACTCGGAAAAG,0,5013644
yjbJ_predicted,0.5,1,1,CGGTTGCGCAACCTATCATT,0,5008510
yjbJ_predicted,0.5,1,1,CGGTTCTATGGCGATCTATA,0,5021642
yjbJ_predicted,0.5,1,1,CGGTTAGCAACATTGCAGCC,0,5009064
yjbJ_predicted,0.5,1,1,CGGTGCGGCCTAGTGCGCGA,0,5004615
yjbJ_predicted,0.5,1,1,CGGTGCCAATGAACACCGAG,0,5004100
yjbJ_predicted,0.5,1,1,CGGTGACTGCATTTGACTCG,0,5014825
yjbJ_predicted,0.5,1,1,CGGTCGGCAGTCCCGGCGTT,0,5021993
yjbJ_predicted,0.5,1,1,CGGTACTCGAACTCAGCGTA,0,5018211
yjbJ_predicted,0.5,1,1,CGGGTATAGGCTGGTAAAGG,0,4998901
yjbJ_predicted,0.5,1,1,CGGGTAAACGTTATTGCGAA,0,5027968
yjbJ_predicted,0.5,1,1,CGGGGAATAAGTTTGTCAGT,0,5023267
yjbJ_predicted,0.5,1,1,CGGGCGATCTTTACTCATGG,0,5027158
yjbJ_predicted,0.5,1,1,CGGGCCATTCTGCCGACATT,0,5008006
yjbJ_predicted,0.5,1,1,CGGGAGGGGTCACAACAACT,0,5025314
yjbJ_predicted,0.5,1,1,CGGGAGAGAGACTAGATTAA,0,5010832
yjbJ_predicted,0.5,1,1,CGGGACCTGCATGGGGAGAC,0,5015937
yjbJ_predicted,0.5,1,1,CGGGACAACCCTTAAAACCC,0,4995990
yjbJ_predicted,0.5,1,1,CGGCTAAGTGATTCAGCACC,0,5015851
yjbJ_predicted,0.5,1,1,CGGCGTAGCGTACTCAGATT,0,5030615
yjbJ_predicted,0.5,1,1,CGGCGAAGTTTTGTACGGGT,0,5004016
yjbJ_predicted,0.5,1,1,CGGCCTCTCTTTTGCATCGG,0,5019047
yjbJ_predicted,0.5,1,1,CGGCATACTAGTCGCCCAGA,0,5005311
yjbJ_predicted,0.5,1,1,CGGCAGCTAATCAACCATGG,0,5017223
yjbJ_predicted,0.5,1,1,CGGATAACTGTCCTCTAATT,0,5019019
yjbJ_predicted,0.5,1,1,CGGACTCAAGACTAGACTTA,0,5007479
yjbJ_predicted,0.5,1,1,CGGACCTCAGTGGCCTGGCA,0,5012667
yjbJ_predicted,0.5,1,1,CGGACCGGACCTCCGCGTCA,0,5016482
yjbJ_predicted,0.5,1,1,CGGACAGAGTGGACGGTCTC,0,4995305
yjbJ_predicted,0.5,1,1,CGCTGTCGCCCGGTTCAGGG,0,5019252
yjbJ_predicted,0.5,1,1,CGCTCGATTTGTTTACCAAT,0,5021099
yjbJ_predicted,0.5,1,1,CGCTATATAAGGCAAGGCAA,0,4997186
yjbJ_predicted,0.5,1,1,CGCTAACTTCATGCCCGGTT,0,5002063
yjbJ_predicted,0.5,1,1,CGCGTAGACGCACGGCCCAT,0,5024057
yjbJ_predicted,0.5,1,1,CGCGGTTGATCCGACTACGA,0,5028188
yjbJ_predicted,0.5,1,1,CGCGGGGGCGAGTTTAATGT,0,5026496
yjbJ_predicted,0.5,1,1,CGCGGGAAGTTTGGAAGTTT,0,5022300
yjbJ_predicted,0.5,1,1,CGCCTTTGACTAGAATCTCA,0,4996019
yjbJ_predicted,0.5,1,1,CGCCTTTAATTTAGCGCGGG,0,5001481
yjbJ_predicted,0.5,1,1,CGCCTGTCGATCCCTACATA,0,5027821
yjbJ_predicted,0.5,1,1,CGCCGTGTGACCACAATGAA,0,5024270
yjbJ_predicted,0.5,1,1,CGCCATATATCGTAGTTGCG,0,5011661
yjbJ_predicted,0.5,1,1,CGCAGTATGGTAAGTGGTGA,0,5023946
yjbJ_predicted,0.5,1,1,CGCAGGTCTTGTTGGGAATT,0,5023880
yjbJ_predicted,0.5,1,1,CGCACTCGAGGGATTAGCTG,0,5030241
yjbJ_predicted,0.5,1,1,CGCACTATATCATCATAAAC,0,4999266
yjbJ_predicted,0.5,1,1,CGCAATAATAGCAAGCCAGA,0,5015372
yjbJ_predicted,0.5,1,1,CGCAATAAGCATCAAATTTA,0,5015771
yjbJ_predicted,0.5,1,1,CGCAAATATCGAAGGGATAT,0,5007569
yjbJ_predicted,0.5,1,1,CGCAAATACGATGGGACCGT,0,5020761
yjbJ_predicted,0.5,1,1,CGCAAAGGTGTGTTAGTTTG,0,4999387
yjbJ_predicted,0.5,1,1,CGCAAACAGGTCGCGCCGTG,0,5000420
yjbJ_predicted,0.5,1,1,CGATTTATCCGAACTACCTG,0,4995837
yjbJ_predicted,0.5,1,1,CGATTGTCACCCAGTGAGCT,0,5009452
yjbJ_predicted,0.5,1,1,CGATGGTCTCTGCTCGAACA,0,4999506
yjbJ_predicted,0.5,1,1,CGATGCTAATAACATGCACC,0,5013990
yjbJ_predicted,0.5,1,1,CGATGCCCAACTATGCCTCT,0,5009630
yjbJ_predicted,0.5,1,1,CGATCTTCGGACCTTGATAT,0,5029538
yjbJ_predicted,0.5,1,1,CGATCGATGGACACCGCAGG,0,5026860
yjbJ_predicted,0.5,1,1,CGATCCGGATTTAACGCCAT,0,5019687
yjbJ_predicted,0.5,1,1,CGACTCATTAGCGGCTTACG,0,4998983
yjbJ_predicted,0.5,1,1,CGACCTGACGGACTATGGAA,0,5025621
yjbJ_predicted,0.5,1,1,CGACCCTTCTACAGTGTATT,0,5023132
yjbJ_predicted,0.5,1,1,CGACCATGTGGTGCCAGAGT,0,5011860
yjbJ_predicted,0.5,1,1,CGAATTCCCTTTTGAAGTCA,0,5026836
yjbJ_predicted,0.5,1,1,CGAATGGTCTAGAATACGCA,0,5008253
yjbJ_predicted,0.5,1,1,CGAATACAGCCGACGTGGCG,0,5001904
yjbJ_predicted,0.5,1,1,CGAATAAATGCATCAGTTGT,0,5005713
yjbJ_predicted,0.5,1,1,CGAAGTTACGTTTGTTGCTC,0,5026661
yjbJ_predicted,0.5,1,1,CGAAATTGCCGCGCGGCAAA,0,5014990
yjbJ_predicted,0.5,1,1,CGAAACGGGACCAGGCGCCT,0,5003775
yjbJ_predicted,0.5,1,1,CGAAACAAGTCTACTTGCCC,0,4994995
yjbJ_predicted,0.5,1,1,CGAAAAAGTAATACAGGCCC,0,5010605
yjbJ_predicted,0.5,1,1,CCTTTCATAACCATTTCTGA,0,5020103
yjbJ_predicted,0.5,1,1,CCTTGTCAGGAGGCCGTAAG,0,5020337
yjbJ_predicted,0.5,1,1,CCTTCTGTAAGCATGGTGAC,0,5011636
yjbJ_predicted,0.5,1,1,CCTTCTCCTACAGCATGGGA,0,5029274
yjbJ_predicted,0.5,1,1,CCTTCGGAAGGCAGCCCCAG,0,5007531
yjbJ_predicted,0.5,1,1,CCTTAGTGATCTCTGCTCTA,0,5007453
yjbJ_predicted,0.5,1,1,CCTGGTGACAAGTCCACGAT,0,5011169
yjbJ_predicted,0.5,1,1,CCTGGATTCCTACTTCTTAG,0,4996590
yjbJ_predicted,0.5,1,1,CCTGAGTTTTTTTCCATTGC,0,5025171
yjbJ_predicted,0.5,1,1,CCTGAAGATGCACATGGAGA,0,5022488
yjbJ_predicted,0.5,1,1,CCTCTTTCAGATTTATAGTG,0,5018569
yjbJ_predicted,0.5,1,1,CCTCGGGGTTACATAAACGA,0,5025948
yjbJ_predicted,0.5,1,1,CCTCGGGCTACGTTGATAGT,0,5012149
yjbJ_predicted,0.5,1,1,CCTCGCTGCAGCCCCCGGGG,0,4994771
yjbJ_predicted,0.5,1,1,CCTCACAATACCTTAGGCAA,0,5009229
yjbJ_predicted,0.5,1,1,CCTATTTTGTTACGCACGTG,0,5023981
yjbJ_predicted,0.5,1,1,CCTATGAGTACTACTGGATG,0,5027072
yjbJ_predicted,0.5,1,1,CCTATGAACTGTCCCTAGTG,0,5027700
yjbJ_predicted,0.5,1,1,CCTATCTCAGAAGGAGCTTT,0,5018011
yjbJ_predicted,0.5,1,1,CCTATAGTGATGGGGCGGCT,0,5008402
yjbJ_predicted,0.5,1,1,CCTAGCGGGAGTTGGTTTGC,0,5006683
yjbJ_predicted,0.5,1,1,CCTAGACCCTCTGGCTGTAT,0,4994774
yjbJ_predicted,0.5,1,1,CCTACCCTCTTGTGAACACT,0,5011510
yjbJ_predicted,0.5,1,1,CCTAATTCGGCACTTGCAGA,0,5022024
yjbJ_predicted,0.5,1,1,CCTAAGATGATAAGGACTCG,0,5021121
yjbJ_predicted,0.5,1,1,CCGTGAGTCCAAACGTGTGA,0,5030762
yjbJ_predicted,0.5,1,1,CCGTCAACCAATGGTGCCAC,0,5024829
yjbJ_predicted,0.5,1,1,CCGTAGGGATGCCTGCGCAA,0,4997331
yjbJ_predicted,0.5,1,1,CCGGTGGCCGTAATCAGCTT,0,5030789
yjbJ_predicted,0.5,1,1,CCGGTGCTTTACGCTGTGAA,0,5016219
yjbJ_predicted,0.5,1,1,CCGGGTTTTGGTTGGAGGTG,0,5013170
yjbJ_predicted,0.5,1,1,CCGGCTGGTGGTATGTATGC,0,5030695
yjbJ_predicted,0.5,1,1,CCGGCGGGGCCTGCTTTTAA,0,5007541
yjbJ_predicted,0.5,1,1,CCGGCAGAAATTAGAAAAAC,0,5016542
yjbJ_predicted,0.5,1,1,CCGGATTAATTAATGACCTT,0,5020222
yjbJ_predicted,0.5,1,1,CCGGAAGAATGACATGGGGA,0,5026441
yjbJ_predicted,0.5,1,1,CCGCTTGTGAAATTCTTAAT,0,4998820
yjbJ_predicted,0.5,1,1,CCGCTGCGTTAGGCTCTCAC,0,5025626
yjbJ_predicted,0.5,1,1,CCGCTACGCAGGTCTCATAT,0,5013384
yjbJ_predicted,0.5,1,1,CCGCGTGGAGATGGAGTAAT,0,5025063
yjbJ_predicted,0.5,1,1,CCGCGGACAAGGGTTTGGTG,0,5006457
yjbJ_predicted,0.5,1,1,CCGCGCTGTAATATTATGGG,0,5017964
yjbJ_predicted,0.5,1,1,CCGCGCATCTTTTTGTCAAA,0,5000076
yjbJ_predicted,0.5,1,1,CCGCGATCTGGGCGTGAGCT,0,5004031
yjbJ_predicted,0.5,1,1,CCGCGACACGGCGCCCTACA,0,5031254
yjbJ_predicted,0.5,1,1,CCGCCGTCTTAACGGGAGTG,0,5015955
yjbJ_predicted,0.5,1,1,CCGCAGCTGTTGAGCTGCGA,0,5019969
yjbJ_predicted,0.5,1,1,CCGCAGAGAGCTATTATTTA,0,5001848
yjbJ_predicted,0.5,1,1,CCGATTTCAGGGAGGCGCTG,0,4996487
yjbJ_predicted,0.5,1,1,CCGATGGAACAGATATGATA,0,4999534
yjbJ_predicted,0.5,1,1,CCGATGCGTTCAGGGTGTAG,0,5025876
yjbJ_predicted,0.5,1,1,CCGATGACCCCGTTTTAGGT,0,5004568
yjbJ_predicted,0.5,1,1,CCGAGGCCTGCGACCTGCGG,0,5012759
yjbJ_predicted,0.5,1,1,CCGAGATCTTGCTTGAAAGG,0,4994999
yjbJ_predicted,0.5,1,1,CCGAACCTGTCCGCGTGAGA,0,5009949
yjbJ_predicted,0.5,1,1,CCGAAATGTTTGTACGTAGG,0,5015605
yjbJ_predicted,0.5,1,1,CCGAAACGAGGGATTTCTTC,0,5013034
yjbJ_predicted,0.5,1,1,CCCTTACGGTACTCGGTAGA,0,4996284
yjbJ_predicted,0.5,1,1,CCCTGTAGCATGATGGCAGA,0,5022684
yjbJ_predicted,0.5,1,1,CCCTGCATCTCATGAACGGG,0,5007724
yjbJ_predicted,0.5,1,1,CCCTCGTCTTTATTATGGAA,0,5015250
yjbJ_predicted,0.5,1,1,CCCTCGATAGAATATGGAGA,0,5028079
yjbJ_predicted,0.5,1,1,CCCTCCAAAAACGGTTCATG,0,5014084
yjbJ_predicted,0.5,1,1,CCCGTGTGGGGGGAAGATGA,0,5022291
yjbJ_predicted,0.5,1,1,CCCGTAGTTACGACAACATA,0,5011366
yjbJ_predicted,0.5,1,1,CCCGGTTGAAGAAGCTGGGC,0,5019780
yjbJ_predicted,0.5,1,1,CCCGGCACTTTTCACAGGTG,0,5022870
yjbJ_predicted,0.5,1,1,CCCGGACCGCTTTTTGATTA,0,5024032
yjbJ_predicted,0.5,1,1,CCCGGAAGAGCCTCGCCGTG,0,5002833
yjbJ_predicted,0.5,1,1,CCCGCGGTAGATGTTATGCT,0,5017334
yjbJ_predicted,0.5,1,1,CCCGCACCCCTGCCGAGCGT,0,5019634
yjbJ_predicted,0.5,1,1,CCCGATGAGACTCCTGCGCA,0,5028232
yjbJ_predicted,0.5,1,1,CCCCGTGGTTCTTGGTGGCT,0,5006136
yjbJ_predicted,0.5,1,1,CCCCAGTGTTTGTTGGTCCA,0,5012159
yjbJ_predicted,0.5,1,1,CCCCACTGGGTCCGATTATT,0,4999219
yjbJ_predicted,0.5,1,1,CCCATGATACGCAGCGGCAG,0,5018100
yjbJ_predicted,0.5,1,1,CCCATCAACACGATGTAGCT,0,5023900
yjbJ_predicted,0.5,1,1,CCCAGTCTTCAGCCGCCGAG,0,5007874
yjbJ_predicted,0.5,1,1,CCCAGACTATGGCTGTGAAC,0,5015935
yjbJ_predicted,0.5,1,1,CCCACATTTTTGGCTAGGTC,0,4999001
yjbJ_predicted,0.5,1,1,CCCACAGAGCTTCTTAATTG,0,4996381
yjbJ_predicted,0.5,1,1,CCCAATTTAAGAGACGCCCC,0,5009593
yjbJ_predicted,0.5,1,1,CCCAATTATTCGATATGAGA,0,4997436
yjbJ_predicted,0.5,1,1,CCCAACAGTACATTATTCAT,0,5029058
yjbJ_predicted,0.5,1,1,CCATGTCTAGTGAGCGTTGG,0,5006396
yjbJ_predicted,0.5,1,1,CCATGCTTCTAGGGGAAAAG,0,4995702
yjbJ_predicted,0.5,1,1,CCATCTACGGATAATCACGG,0,5017766
yjbJ_predicted,0.5,1,1,CCATCGATGCCAATCCTGTT,0,5011452
yjbJ_predicted,0.5,1,1,CCATCGACTATGGCTGTGCC,0,5009382
yjbJ_predicted,0.5,1,1,CCATCACGGGTTCTAACGAT,0,5021446
yjbJ_predicted,0.5,1,1,CCAGTGCTGGATCCACCCAA,0,5012057
yjbJ_predicted,0.5,1,1,CCAGTCCTCTTCCGGGAGGC,0,4997069
yjbJ_predicted,0.5,1,1,CCAGGTCCAATGCTCGAAAC,0,4995071
yjbJ_predicted,0.5,1,1,CCAGGGTGCTCAGGGCTAGA,0,5000992
yjbJ_predicted,0.5,1,1,CCAGCTCTTATATTCAAGGA,0,5026348
yjbJ_predicted,0.5,1,1,CCAGCTATTAACGAGAGTTC,0,5001945
yjbJ_predicted,0.5,1,1,CCAGCGTTAGTGTATACCAT,0,5015638
yjbJ_predicted,0.5,1,1,CCAGCCAGCGGATATACGCG,0,5023638
yjbJ_predicted,0.5,1,1,CCAGAAAAGGGGTTAGAGCT,0,4995755
yjbJ_predicted,0.5,1,1,CCACGTGTCGCGACACGGTC,0,5021355
yjbJ_predicted,0.5,1,1,CCACGGCTCGCCGAGCGCAG,0,4995369
yjbJ_predicted,0.5,1,1,CCACGGATTGCAATAGGTGA,0,5025587
yjbJ_predicted,0.5,1,1,CCACCTGCATTTTGTTGGGG,0,5011859
yjbJ_predicted,0.5,1,1,CCACCGGCGGAGTAGGGGAT,0,5002916
yjbJ_predicted,0.5,1,1,CCACATTAATACCTTGCGAT,0,5027890
yjbJ_predicted,0.5,1,1,CCACACAGACAAACTATCTA,0,5010006
yjbJ_predicted,0.5,1,1,CCAATCGCCGCTCAGATTAC,0,5027254
yjbJ_predicted,0.5,1,1,CCAAGTCGATAGAGAGACAC,0,5025821
yjbJ_predicted,0.5,1,1,CCAACTACCCGTTTAGCCCT,0,5029494
yjbJ_predicted,0.5,1,1,CATTGGTGATTTCGTTCCGA,0,5011232
yjbJ_predicted,0.5,1,1,CATTGGACGCGGCATTACTA,0,5010390
yjbJ_predicted,0.5,1,1,CATTATGGCACACACCAAAG,0,5013426
yjbJ_predicted,0.5,1,1,CATTAGAAGGTATAGATTGG,0,4999585
yjbJ_predicted,0.5,1,1,CATTACCCTCTTACTACTCT,0,5025915
yjbJ_predicted,0.5,1,1,CATGTGCCTAAACACGTCAA,0,5016836
yjbJ_predicted,0.5,1,1,CATGTCCGGGTTCATTAGGA,0,5018158
yjbJ_predicted,0.5,1,1,CATGGGTTTAATGAGCCGCG,0,5007754
yjbJ_predicted,0.5,1,1,CATGGCTCATAAGGCTCCAT,0,4996557
yjbJ_predicted,0.5,1,1,CATGGCCTATGACGGTATCA,0,5008933
yjbJ_predicted,0.5,1,1,CATGCGCTAAGACACAAGAG,0,5017876
yjbJ_predicted,0.5,1,1,CATGAGAAGAGGGGTGTTCC,0,5005384
yjbJ_predicted,0.5,1,1,CATCTTCAAGCTGGCCGGCA,0,4995150
yjbJ_predicted,0.5,1,1,CATCTGGGATCGCCATCTGT,0,5007686
yjbJ_predicted,0.5,1,1,CATCGCCCAGCAGCCTAGAT,0,5013599
yjbJ_predicted,0.5,1,1,CATCGAGTGATATGAAGTCG,0,5002249
yjbJ_predicted,0.5,1,1,CATCGACAAGACGTCCCAAC,0,4995096
yjbJ_predicted,0.5,1,1,CATCCTTTATATACCAGAAA,0,5007037
yjbJ_predicted,0.5,1,1,CATCAATTTCAACCATTATA,0,5026562
yjbJ_predicted,0.5,1,1,CATAGGGGTGTTGGTGCTGC,0,5006047
yjbJ_predicted,0.5,1,1,CATAGGCACGCGCAGACAGA,0,5013987
yjbJ_predicted,0.5,1,1,CATAGCGTCGTGTTTTTTTT,0,4999820
yjbJ_predicted,0.5,1,1,CATAGCGTCGTGGTTTTTTT,0,4999816
yjbJ_predicted,0.5,1,1,CATAGAATAAGCGTCTCGTC,0,5008235
yjbJ_predicted,0.5,1,1,CATACTTCTCTGGCGATCTT,0,5019372
yjbJ_predicted,0.5,1,1,CATACTCACTAATACTGCAA,0,5021411
yjbJ_predicted,0.5,1,1,CATACTAGAATAATTCCGTT,0,4998959
yjbJ_predicted,0.5,1,1,CATACGTCATTCGGCCGTTT,0,4997084
yjbJ_predicted,0.5,1,1,CAGTTTATTATGTCGGACGT,0,5030661
yjbJ_predicted,0.5,1,1,CAGTTAACGCATGATATTTC,0,5018003
yjbJ_predicted,0.5,1,1,CAGTGGTCAGCCGCAGTTAA,0,4996268
yjbJ_predicted,0.5,1,1,CAGGTTAGATAAACTAGATA,0,5024968
yjbJ_predicted,0.5,1,1,CAGGTGCTGGCAGAAGCCCC,0,5003478
yjbJ_predicted,0.5,1,1,CAGGTCCCAATCAACTCGGA,0,5004792
yjbJ_predicted,0.5,1,1,CAGGGCTTGCCCTCGCCCCT,0,5003244
yjbJ_predicted,0.5,1,1,CAGGGCTGGTGTTTGAAGTC,0,5029989
yjbJ_predicted,0.5,1,1,CAGGCTGTAACGGGTAATGG,0,5018493
yjbJ_predicted,0.5,1,1,CAGGCTACCCGACGGAGTTG,0,5013242
yjbJ_predicted,0.5,1,1,CAGGCGGACCAGAAGCGCGG,0,5029122
yjbJ_predicted,0.5,1,1,CAGGCGAATCGCGCTCCGGG,0,4994931
yjbJ_predicted,0.5,1,1,CAGGACACAAGGTTTCACCG,0,5014337
yjbJ_predicted,0.5,1,1,CAGCTAAGTAATCAGTTTGA,0,5012498
yjbJ_predicted,0.5,1,1,CAGCGTCAAGCCAGAGCAAT,0,5022263
yjbJ_predicted,0.5,1,1,CAGCACGCGCGGCTGGAGGG,0,5005106
yjbJ_predicted,0.5,1,1,CAGCAACGTTGCTGTAGTAG,0,5024332
yjbJ_predicted,0.5,1,1,CAGATATACCTACCTCTACT,0,5015431
yjbJ_predicted,0.5,1,1,CAGAGAAGAGTTGAGTAGAG,0,5007278
yjbJ_predicted,0.5,1,1,CAGACTCCTGTGCGCTATTA,0,5003335
yjbJ_predicted,0.5,1,1,CAGACTAAGTATAGCATGCT,0,5025670
yjbJ_predicted,0.5,1,1,CAGACGGTCAGTATGCGAGT,0,5007436
yjbJ_predicted,0.5,1,1,CAGACGACCCATTCGATATG,0,5006364
yjbJ_predicted,0.5,1,1,CAGAAGTCTAACTCCTCCGG,0,5003235
yjbJ_predicted,0.5,1,1,CACTCATTTGCATCTGATGC,0,5018009
yjbJ_predicted,0.5,1,1,CACTCATAATGTCTTCCGGG,0,5006137
yjbJ_predicted,0.5,1,1,CACTAGGTATCACTTCGGGT,0,5028203
yjbJ_predicted,0.5,1,1,CACTACCGTCTTAAGGTCTT,0,5023442
yjbJ_predicted,0.5,1,1,CACGTAGGCTCTTATGCACG,0,5008072
yjbJ_predicted,0.5,1,1,CACGGTCCCCTCAGCAATGT,0,4997158
yjbJ_predicted,0.5,1,1,CACGGTAGAGGGTCACGAAC,0,5024857
yjbJ_predicted,0.5,1,1,CACGAACCTATTTAAGTCTA,0,5007444
yjbJ_predicted,0.5,1,1,CACCTCGGGGGAGGCTCATC,0,5006879
yjbJ_predicted,0.5,1,1,CACCGTACTTGGGGGTAACG,0,5023477
yjbJ_predicted,0.5,1,1,CACCCATAACAAGCAACCCC,0,5003593
yjbJ_predicted,0.5,1,1,CACATGCGTGTAACGGTCCC,0,5010735
yjbJ_predicted,0.5,1,1,CACAGGATGTTGGTCAGTAA,0,5022053
yjbJ_predicted,0.5,1,1,CACAGCGAGCATGGACGATG,0,5020649
yjbJ_predicted,0.5,1,1,CACACTATCAAAATAGAAGT,0,5020435
yjbJ_predicted,0.5,1,1,CACAACTTGGATTCTGCCAA,0,5021665
yjbJ_predicted,0.5,1,1,CAATTCGTAAATCACAAACA,0,5025006
yjbJ_predicted,0.5,1,1,CAATCCTCTCACTGGCCAAT,0,5015315
yjbJ_predicted,0.5,1,1,CAATCCGTGCAAAAGGGAGT,0,5008046
yjbJ_predicted,0.5,1,1,CAATATCGTACAATCTTAGA,0,5022065
yjbJ_predicted,0.5,1,1,CAAGTTTGGTTTGGTATTTA,0,5029170
yjbJ_predicted,0.5,1,1,CAAGTTTAAGCCCTGGCGTG,0,5000931
yjbJ_predicted,0.5,1,1,CAAGTTCAACTGCAGTGAAT,0,5002686
yjbJ_predicted,0.5,1,1,CAAGGCGTTAGCTAACACCT,0,5027582
yjbJ_predicted,0.5,1,1,CAAGGCGTGTACTTGTCTAC,0,5029871
yjbJ_predicted,0.5,1,1,CAAGGCGGGAAGGGTCTTTG,0,5010628
yjbJ_predicted,0.5,1,1,CAAGGATTCACTCGGTATCC,0,5010886
yjbJ_predicted,0.5,1,1,CAAGCCGCTCAGCAGGCCCG,0,5020144
yjbJ_predicted,0.5,1,1,CAAGCAAAGGGTCCCTACCG,0,4995778
yjbJ_predicted,0.5,1,1,CAAGAATATAATGCTTTCCC,0,5005714
yjbJ_predicted,0.5,1,1,CAACTCACTACTGGGTCGTT,0,5020607
yjbJ_predicted,0.5,1,1,CAACTACTTTAGCGGCAAAA,0,5021467
yjbJ_predicted,0.5,1,1,CAACCGCTGAGTTCGGGCGA,0,5014036
yjbJ_predicted,0.5,1,1,CAACCAGCGCCAGTCCACTA,0,5026601
yjbJ_predicted,0.5,1,1,CAACAGATCTCTCGAGCACT,0,5011022
yjbJ_predicted,0.5,1,1,CAACAAGGCCGGCGGCCTCT,0,5015172
yjbJ_predicted,0.5,1,1,CAAATTTTGGGAAACGAGTC,0,5007426
yjbJ_predicted,0.5,1,1,CAAATAAGTACTGCTTTGAA,0,5000679
yjbJ_predicted,0.5,1,1,CAAAGTTACCCGGCTAAGAC,0,5024340
yjbJ_predicted,0.5,1,1,CAAAGCACTTTCTGGTATAT,0,5013646
yjbJ_predicted,0.5,1,1,ATTTTGGCGATTATTTCTGC,0,5017824
yjbJ_predicted,0.5,1,1,ATTTGCTTTATCAGCGTACT,0,4995370
yjbJ_predicted,0.5,1,1,ATTTCTCGGAACAAAACATT,0,5027011
yjbJ_predicted,0.5,1,1,ATTTCACATTTCGAGGACTC,0,5020000
yjbJ_predicted,0.5,1,1,ATTGTAGGGAGACTGTCAGA,0,5023075
yjbJ_predicted,0.5,1,1,ATTGGCACCCGGTGTTCAAG,0,5024296
yjbJ_predicted,0.5,1,1,ATTGCGTCACGATATGATCC,0,5024423
yjbJ_predicted,0.5,1,1,ATTGCCTTAGGGGCTTCAAC,0,5029062
yjbJ_predicted,0.5,1,1,ATTGCAGGATCGAGGGCATA,0,5019901
yjbJ_predicted,0.5,1,1,ATTGCAGCCGGAGACGAAGT,0,5001099
yjbJ_predicted,0.5,1,1,ATTGAGAGACGTTCCGTTGT,0,5001149
yjbJ_predicted,0.5,1,1,ATTCTGTGTTGAGTACAACG,0,5009432
yjbJ_predicted,0.5,1,1,ATTCGTGCCACAATAATGTT,0,5024610
yjbJ_predicted,0.5,1,1,ATTCGGGGTGAAACCAGCTG,0,5010267
yjbJ_predicted,0.5,1,1,ATTCCGTTATATACGATCCA,0,4999353
yjbJ_predicted,0.5,1,1,ATTCCCCACCCCTTGTTAGC,0,5007532
yjbJ_predicted,0.5,1,1,ATTCATGTTATGGTCGGAAG,0,4998446
yjbJ_predicted,0.5,1,1,ATTATTTAGCCTTTACACTT,0,5006029
yjbJ_predicted,0.5,1,1,ATTATGAGGCCGGGTCCGAT,0,5000489
yjbJ_predicted,0.5,1,1,ATTAGAGGAACGTCTGCCCT,0,5014511
yjbJ_predicted,0.5,1,1,ATTAATAAAGTCAGCGATCC,0,5006981
yjbJ_predicted,0.5,1,1,ATGTTTTGAAGGAGGAGCCA,0,4996976
yjbJ_predicted,0.5,1,1,ATGTTCACACATGAGCAATA,0,5003428
yjbJ_predicted,0.5,1,1,ATGTTAACATGGTGTAGTTT,0,5018054
yjbJ_predicted,0.5,1,1,ATGTCGTCCGTGTGCAGGAG,0,4997324
yjbJ_predicted,0.5,1,1,ATGTATCGGGTATGACAGGT,0,5011251
yjbJ_predicted,0.5,1,1,ATGTAGCCGGGCAGCGAGAG,0,5022849
yjbJ_predicted,0.5,1,1,ATGTACCGCCCTACCTGGGT,0,5002896
yjbJ_predicted,0.5,1,1,ATGGTTATGTGATGAGCAAC,0,5002085
yjbJ_predicted,0.5,1,1,ATGGTGGATATCCGCACTTG,0,5017547
yjbJ_predicted,0.5,1,1,ATGGGTTGAGAACTCATACA,0,4994815
yjbJ_predicted,0.5,1,1,ATGGGTCGCAGCGTCTCACC,0,5013507
yjbJ_predicted,0.5,1,1,ATGGCTGAACTAACGTTTTA,0,5006891
yjbJ_predicted,0.5,1,1,ATGGATAAGGCCTTTCCGGG,0,4998275
yjbJ_predicted,0.5,1,1,ATGGAGTGTGTTATGCCCGA,0,5001499
yjbJ_predicted,0.5,1,1,ATGGAACCTAGCTGGTGACC,0,5021403
yjbJ_predicted,0.5,1,1,ATGCGTTGGACTCGGTGTAG,0,5030278
yjbJ_predicted,0.5,1,1,ATGCGGTCGGTCCCCGGAGG,0,5006036
yjbJ_predicted,0.5,1,1,ATGCCACACTCACGTAGCAA,0,5004520
yjbJ_predicted,0.5,1,1,ATGAAGGTTCCAAGATCCGA,0,5000665
yjbJ_predicted,0.5,1,1,ATGAACGCACTGCTAGCCCC,0,4999000
yjbJ_predicted,0.5,1,1,ATGAAAAGGGGGTGAATACG,0,5008807
yjbJ_predicted,0.5,1,1,ATCTTGGAGAAGCTAGGCGG,0,5027909
yjbJ_predicted,0.5,1,1,ATCTTACAATGTTTAGTCCC,0,5024960
yjbJ_predicted,0.5,1,1,ATCTGTCGGGAGTTTAGAAT,0,4995431
yjbJ_predicted,0.5,1,1,ATCTGCGGTAACCACCCATT,0,5024542
yjbJ_predicted,0.5,1,1,ATCTAGGTCTCTCGGAGCAG,0,5016389
yjbJ_predicted,0.5,1,1,ATCGTTGCCATCTTATACGT,0,5006250
yjbJ_predicted,0.5,1,1,ATCGTAATTATGATCGCTTC,0,5026564
yjbJ_predicted,0.5,1,1,ATCGTAACTGTACTGCCTGC,0,5011939
yjbJ_predicted,0.5,1,1,ATCGGACCCGAGTCGCGTCA,0,4999033
yjbJ_predicted,0.5,1,1,ATCGCACTTCTGCTACAGGT,0,5021545
yjbJ_predicted,0.5,1,1,ATCGATAATCGAGCCTTGTC,0,5026306
yjbJ_predicted,0.5,1,1,ATCGAGCGCCTTATCTCCAG,0,5010297
yjbJ_predicted,0.5,1,1,ATCCTATTCACAATGCCTTT,0,5019447
yjbJ_predicted,0.5,1,1,ATCCTAGACACTAGTACGTT,0,5029744
yjbJ_predicted,0.5,1,1,ATCCGTTCTAGAATAACCTT,0,4996348
yjbJ_predicted,0.5,1,1,ATCCGAGTTTTCGGGGCTTT,0,5022110
yjbJ_predicted,0.5,1,1,ATCCCCTTGAGGAAGAGTGC,0,5030499
yjbJ_predicted,0.5,1,1,ATCCAGCACTGCGTGTGACC,0,4996680
yjbJ_predicted,0.5,1,1,ATCATTTCAAGTGATCCATG,0,5019308
yjbJ_predicted,0.5,1,1,ATCATTGTAACTATTGCCGG,0,5020712
yjbJ_predicted,0.5,1,1,ATCATACGCTTCCTTAGTAC,0,5022030
yjbJ_predicted,0.5,1,1,ATCAGGTGTCTTTGCGAGAC,0,5006712
yjbJ_predicted,0.5,1,1,ATCAGGCCAAAGTACTTTCA,0,4995197
yjbJ_predicted,0.5,1,1,ATCACATCGGTTTGACCCAT,0,5003233
yjbJ_predicted,0.5,1,1,ATCAATGATGCCCGCGAGGA,0,5000939
yjbJ_predicted,0.5,1,1,ATATTCGCTTCTACCTGACT,0,5003711
yjbJ_predicted,0.5,1,1,ATATGGAGTTAAGAGGACGA,0,5030030
yjbJ_predicted,0.5,1,1,ATATGCCACTCCCTCCCAAG,0,5030338
yjbJ_predicted,0.5,1,1,ATATGACCTGGCTCGGACGA,0,5002421
yjbJ_predicted,0.5,1,1,ATAGTTTCTTCCCATCTGAG,0,4998712
yjbJ_predicted,0.5,1,1,ATAGTGACGGGACGCCTTAA,0,5021035
yjbJ_predicted,0.5,1,1,ATAGGCGGGGGGGCATGATT,0,5023741
yjbJ_predicted,0.5,1,1,ATAGCTGAGTACATCCACGG,0,5002677
yjbJ_predicted,0.5,1,1,ATAGCGCTCTGGGGATTGCT,0,5018608
yjbJ_predicted,0.5,1,1,ATAGCGATTTTCTCAAATGG,0,5007613
yjbJ_predicted,0.5,1,1,ATAGCCATCAGCCTATCGTT,0,5001675
yjbJ_predicted,0.5,1,1,ATAGAGCCGGGCCGTTGCGG,0,5024117
yjbJ_predicted,0.5,1,1,ATAGACAGTGAGGCGTTTTA,0,5021479
yjbJ_predicted,0.5,1,1,ATAGACAATTGGTGACGGTC,0,5011611
yjbJ_predicted,0.5,1,1,ATACTGTAGGCAGTACGATA,0,5017593
yjbJ_predicted,0.5,1,1,ATACGTATCTGCTTAAACCT,0,5015607
yjbJ_predicted,0.5,1,1,ATACGGCTGCACGGGTACTG,0,5005842
yjbJ_predicted,0.5,1,1,ATACCGTTAGGAGGTTCACA,0,5028025
yjbJ_predicted,0.5,1,1,ATACAAGGCTCCGGTGCGCT,0,5002584
yjbJ_predicted,0.5,1,1,ATAATGAGCGCCCGTCAGTG,0,5008736
yjbJ_predicted,0.5,1,1,ATAATAAAGGATCGATTTTC,0,4994750
yjbJ_predicted,0.5,1,1,ATAACCGCGATCGGCTTAAC,0,5013809
yjbJ_predicted,0.5,1,1,ATAACAGTAGAAAAGGAGAT,0,5006458
yjbJ_predicted,0.5,1,1,ATAAACGGCTTCACGCCAGC,0,4996963
yjbJ_predicted,0.5,1,1,AGTTTTTTGGTCGGGTGTCG,0,5011462
yjbJ_predicted,0.5,1,1,AGTTTGTCTCCTTTGCAGTG,0,5005262
yjbJ_predicted,0.5,1,1,AGTTTGCTCCCGCACATGCT,0,5015752
yjbJ_predicted,0.5,1,1,AGTTTGAGGCATTTTTTGAT,0,5002866
yjbJ_predicted,0.5,1,1,AGTTTACGCCCGAGGAAACA,0,5005720
yjbJ_predicted,0.5,1,1,AGTTGCTCGAAGCCTTGGCT,0,5024476
yjbJ_predicted,0.5,1,1,AGTTGATTAACAGCACAACG,0,5006311
yjbJ_predicted,0.5,1,1,AGTTGATGTTACGAACCGAT,0,5025248
yjbJ_predicted,0.5,1,1,AGTTAAGCGTACGTAAACCA,0,5011174
yjbJ_predicted,0.5,1,1,AGTGTTACGGTTCACGCCGT,0,5009838
yjbJ_predicted,0.5,1,1,AGTGGGTTGGTCTTTGCCAA,0,5026310
yjbJ_predicted,0.5,1,1,AGTGGCCCGTGTTCACCAGT,0,5031116
yjbJ_predicted,0.5,1,1,AGTGCTCAACTGGCCCCGCA,0,5003032
yjbJ_predicted,0.5,1,1,AGTGCGGAACCATGGCTCGC,0,5014217
yjbJ_predicted,0.5,1,1,AGTCTTTCATGTGGAATTGA,0,5002515
yjbJ_predicted,0.5,1,1,AGTCTTTATTTAGGCGCAGC,0,5013677
yjbJ_predicted,0.5,1,1,AGTCTCTTACCCGTCAGGAA,0,5008792
yjbJ_predicted,0.5,1,1,AGTCGTCCAACGACCTCTGG,0,5027660
yjbJ_predicted,0.5,1,1,AGTCGTACGACATACTTGGG,0,5023436
yjbJ_predicted,0.5,1,1,AGTCGAATGGTTGGTCGCTT,0,5026512
yjbJ_predicted,0.5,1,1,AGTCCAGCTTATAACCGGCA,0,4999028
yjbJ_predicted,0.5,1,1,AGTCAATCTACGTGACTGTG,0,5026898
yjbJ_predicted,0.5,1,1,AGTATGGGCACGCAGAGCAA,0,5015512
yjbJ_predicted,0.5,1,1,AGTATGGGAAGGACTAAGCA,0,5003666
yjbJ_predicted,0.5,1,1,AGTAGTAAGATACAGCTTCA,0,5001087
yjbJ_predicted,0.5,1,1,AGTAGGTGCTACCTTCCCCC,0,5018840
yjbJ_predicted,0.5,1,1,AGTAGAGGAGGTTATTCAGC,0,4998617
yjbJ_predicted,0.5,1,1,AGTAGAACGGCGAGTTCGCC,0,5024839
yjbJ_predicted,0.5,1,1,AGTACTTGTACACGCAACCC,0,5003836
yjbJ_predicted,0.5,1,1,AGTACCTAGTGTAACATCCA,0,5015886
yjbJ_predicted,0.5,1,1,AGTAATCTCAGGAAGCCAGG,0,5006358
yjbJ_predicted,0.5,1,1,AGTAAATAGGGCGCCAACCA,0,5004198
yjbJ_predicted,0.5,1,1,AGTAAAACAGTAATGGGCTG,0,5017481
yjbJ_predicted,0.5,1,1,AGGTTGACCACTCCGGACGT,0,4996374
yjbJ_predicted,0.5,1,1,AGGTTCTAGGCGGAGTCATA,0,5011433
yjbJ_predicted,0.5,1,1,AGGTTATTATCTGGTTAGGC,0,5027845
yjbJ_predicted,0.5,1,1,AGGTGGCAGATTTAGTTTGG,0,4999901
yjbJ_predicted,0.5,1,1,AGGTGCGGACAGCGGTCCTA,0,5026255
yjbJ_predicted,0.5,1,1,AGGTCCCGCGTACCCTCTTA,0,5009036
yjbJ_predicted,0.5,1,1,AGGTATGTTGGTCCGGCCCA,0,5018414
yjbJ_predicted,0.5,1,1,AGGTAGTCGTTAGCATTAGT,0,5017180
yjbJ_predicted,0.5,1,1,AGGTAGGCTGATGGGATATT,0,5005801
yjbJ_predicted,0.5,1,1,AGGTAGATACCGCTATTTTT,0,5012368
yjbJ_predicted,0.5,1,1,AGGGTTAGTCCATCGTTTTA,0,5007865
yjbJ_predicted,0.5,1,1,AGGGGGAGTATGGACTCGAC,0,5013467
yjbJ_predicted,0.5,1,1,AGGGATGGGGTCAGGGCAAC,0,5019785
yjbJ_predicted,0.5,1,1,AGGGATCGCATTGAAGGGAA,0,5002080
yjbJ_predicted,0.5,1,1,AGGCTGAGCCGTTTCGAACC,0,5018179
yjbJ_predicted,0.5,1,1,AGGCGGTGGCGGTGGAGAAC,0,5009628
yjbJ_predicted,0.5,1,1,AGGCGCAATGTGTCTCTGTC,0,5019777
yjbJ_predicted,0.5,1,1,AGGCGAAAGATATTTATTAC,0,5023781
yjbJ_predicted,0.5,1,1,AGGCCGTGACAGTCCTGCTG,0,5022201
yjbJ_predicted,0.5,1,1,AGGCCATATACACAGGCATG,0,5015878
yjbJ_predicted,0.5,1,1,AGGCATTCCTCATCTAGCCT,0,5012446
yjbJ_predicted,0.5,1,1,AGGCATTACCTTGTGGGTCT,0,5014395
yjbJ_predicted,0.5,1,1,AGGCACGTCTGCGGGCAATA,0,5017649
yjbJ_predicted,0.5,1,1,AGGACCCTCGTATGTTTATA,0,5005809
yjbJ_predicted,0.5,1,1,AGGAACGACAAACTGGATGT,0,4998744
yjbJ_predicted,0.5,1,1,AGCTTGGGATATACAATGCC,0,5014553
yjbJ_predicted,0.5,1,1,AGCTGGGGGTTATACGTAAC,0,5008687
yjbJ_predicted,0.5,1,1,AGCTCTCTTTTTACCGTGAT,0,5016590
yjbJ_predicted,0.5,1,1,AGCTCCGGATAGGCCCCACT,0,5015155
yjbJ_predicted,0.5,1,1,AGCTAGCAGATAATAGTAGA,0,5015439
yjbJ_predicted,0.5,1,1,AGCTACAGGTGAAGGGGCCT,0,5017842
yjbJ_predicted,0.5,1,1,AGCTAACTCTGCGGGTTATT,0,5017502
yjbJ_predicted,0.5,1,1,AGCGTCTTTTAGCCTCGATA,0,5006810
yjbJ_predicted,0.5,1,1,AGCGGAGGCTCAGTGGCGAC,0,5007206
yjbJ_predicted,0.5,1,1,AGCGCTTGGACCCGCGATGC,0,4998347
yjbJ_predicted,0.5,1,1,AGCGCTCACAGACTCCTAAG,0,5022367
yjbJ_predicted,0.5,1,1,AGCGACCAACGGTCGTTGTG,0,5014810
yjbJ_predicted,0.5,1,1,AGCCTAACCGCGCTCATCAA,0,4999375
yjbJ_predicted,0.5,1,1,AGCCGGGTACGGAAATCCAA,0,5028861
yjbJ_predicted,0.5,1,1,AGCCACACGCGGGTAGAGTG,0,5027105
yjbJ_predicted,0.5,1,1,AGCCAACATGTTTGTTGTAG,0,4998672
yjbJ_predicted,0.5,1,1,AGCATAGGCCTAACACCACT,0,5007161
yjbJ_predicted,0.5,1,1,AGCATAATTAGGGTAGAGAG,0,5010866
yjbJ_predicted,0.5,1,1,AGCAGCCCCGCAGGCCCGTC,0,5013796
yjbJ_predicted,0.5,1,1,AGATTCTCGTTAGAGTACGC,0,5003739
yjbJ_predicted,0.5,1,1,AGATTCCTCTCACGAATGCT,0,5008891
yjbJ_predicted,0.5,1,1,AGATTACAACGAAAATGCCA,0,5024139
yjbJ_predicted,0.5,1,1,AGAGTTATACACGAACCTTT,0,4998862
yjbJ_predicted,0.5,1,1,AGAGTGTCCGACAGGTGGCT,0,5001838
yjbJ_predicted,0.5,1,1,AGAGGGTCAGCGAGCAATCT,0,5021603
yjbJ_predicted,0.5,1,1,AGAGGCGCTCAAGTAACCTG,0,5008650
yjbJ_predicted,0.5,1,1,AGAGATCACCTTCGGTTATG,0,5013427
yjbJ_predicted,0.5,1,1,AGAGAGTTGAGGACAGATCG,0,5005355
yjbJ_predicted,0.5,1,1,AGAGACAATCGAGTCGAATA,0,5012716
yjbJ_predicted,0.5,1,1,AGACTTGACCAAAATCAGGA,0,5013196
yjbJ_predicted,0.5,1,1,AGACTGGGACCTGTAAGGCT,0,5021511
yjbJ_predicted,0.5,1,1,AGACGGTCGAACCCGATCGT,0,5019248
yjbJ_predicted,0.5,1,1,AGACCTAACGACGGTAATGG,0,5005020
yjbJ_predicted,0.5,1,1,AGACATTCTCGCGCCCGAAC,0,5012998
yjbJ_predicted,0.5,1,1,AGACAGGATTAACAGGGGGT,0,4999325
yjbJ_predicted,0.5,1,1,AGACAACACGCTAGATCGTA,0,5006295
yjbJ_predicted,0.5,1,1,AGAATTTATTTAGGATAAGA,0,5028665
yjbJ_predicted,0.5,1,1,AGAATTCGTTCTACGGTGAT,0,5004371
yjbJ_predicted,0.5,1,1,AGAATTCGTCATGTTTGACT,0,5005498
yjbJ_predicted,0.5,1,1,AGAATCTTTTGTCGTAGAAT,0,5014263
yjbJ_predicted,0.5,1,1,AGAATCTAGTCATCGTGTGC,0,5022401
yjbJ_predicted,0.5,1,1,AGAAGGATTTATTCCCTCCC,0,5019699
yjbJ_predicted,0.5,1,1,AGAACGGTCCGGACGAAAGT,0,4998856
yjbJ_predicted,0.5,1,1,ACTTTTGCTCTTTAATGTAT,0,5024311
yjbJ_predicted,0.5,1,1,ACTTTTAAGTCGTTCCAGAC,0,5023997
yjbJ_predicted,0.5,1,1,ACTTGTTGGGCTGTATGAAT,0,5023079
yjbJ_predicted,0.5,1,1,ACTTAGTCAGAGACTAAATC,0,5007944
yjbJ_predicted,0.5,1,1,ACTGTTCTTGTCGGGACTTC,0,5007692
yjbJ_predicted,0.5,1,1,ACTGTGGGCGCATTGAGGAG,0,5010103
yjbJ_predicted,0.5,1,1,ACTGTCGTGTACCCTTGGCC,0,5029140
yjbJ_predicted,0.5,1,1,ACTGGGTGGAGAAAGGGTGT,0,5016867
yjbJ_predicted,0.5,1,1,ACTGCGGACTCAACGATTAT,0,4998650
yjbJ_predicted,0.5,1,1,ACTGAGACATCGGTGGGCGA,0,5005962
yjbJ_predicted,0.5,1,1,ACTCTCATGGACTTAATCGG,0,4997162
yjbJ_predicted,0.5,1,1,ACTCGGAAGCACGTGCTGAG,0,5012937
yjbJ_predicted,0.5,1,1,ACTCGCTCCGGAAGATGAGT,0,5002390
yjbJ_predicted,0.5,1,1,ACTCGACGCAACCCAGTAGT,0,5018859
yjbJ_predicted,0.5,1,1,ACTCCACTAGCGGATGGTTA,0,5022143
yjbJ_predicted,0.5,1,1,ACTCACCTTGGGCGTATTTA,0,5027952
yjbJ_predicted,0.5,1,1,ACTCAAGTCTTAAACACAAC,0,5003670
yjbJ_predicted,0.5,1,1,ACTCAACGAGCCACCTAACT,0,5009884
yjbJ_predicted,0.5,1,1,ACTATACGAAAAATGGTGCC,0,4999372
yjbJ_predicted,0.5,1,1,ACTAGCGCACGTTCCATGAT,0,5027583
yjbJ_predicted,0.5,1,1,ACTAGCCGTTTATGGAAACG,0,5020330
yjbJ_predicted,0.5,1,1,ACTAGAAGTGCCCGCTTTGC,0,5011978
yjbJ_predicted,0.5,1,1,ACTACTGGCACAGGACTAAA,0,5010728
yjbJ_predicted,0.5,1,1,ACTACGTTCTCATAAATGGG,0,5011681
yjbJ_predicted,0.5,1,1,ACTACCATGACATGGTATAA,0,5018800
yjbJ_predicted,0.5,1,1,ACTAATTTTAGTTATCGGAA,0,5005722
yjbJ_predicted,0.5,1,1,ACTAAGTGGCACCCTCCAGA,0,5012264
yjbJ_predicted,0.5,1,1,ACGTGGACCAGAAGAAGAAC,0,5018685
yjbJ_predicted,0.5,1,1,ACGTGCTTGGCTCAAACAAC,0,4995902
yjbJ_predicted,0.5,1,1,ACGTGCTAACCAAAGGGCAT,0,4997531
yjbJ_predicted,0.5,1,1,ACGTCACTTTTTCTACTCTT,0,5014194
yjbJ_predicted,0.5,1,1,ACGTATTACTATAGGCCTAC,0,5021913
yjbJ_predicted,0.5,1,1,ACGGTTTCGGGCAGTGAATG,0,5004219
yjbJ_predicted,0.5,1,1,ACGGTTTACTTGTTCATACA,0,5008547
yjbJ_predicted,0.5,1,1,ACGGGTTACAAAATACAAGT,0,5008580
yjbJ_predicted,0.5,1,1,ACGGCGCCTTTTAGTTTGGG,0,5010421
yjbJ_predicted,0.5,1,1,ACGGATGGTTCTACTTTGTT,0,5009116
yjbJ_predicted,0.5,1,1,ACGGAAAAACGGTGTCAGTA,0,5022641
yjbJ_predicted,0.5,1,1,ACGCGCAGCTAACCTGGCGA,0,4995358
yjbJ_predicted,0.5,1,1,ACGCATGAATATAGCGAGCA,0,5000711
yjbJ_predicted,0.5,1,1,ACGCACTCTCCTAGCAGTTT,0,5011714
yjbJ_predicted,0.5,1,1,ACGCAATATTTCTGAATACT,0,5003871
yjbJ_predicted,0.5,1,1,ACGATACCGAGCGCTACAAG,0,5006904
yjbJ_predicted,0.5,1,1,ACGAGGTTCGCGAGGTCACT,0,5012570
yjbJ_predicted,0.5,1,1,ACGAGCATTTCTAGGTTTTC,0,5022257
yjbJ_predicted,0.5,1,1,ACGACGAGAATCCGTTACGG,0,5023606
yjbJ_predicted,0.5,1,1,ACGAACGGCAGTGCATCACA,0,5030614
yjbJ_predicted,0.5,1,1,ACGAAACCTATCTTTCGGTC,0,5012825
yjbJ_predicted,0.5,1,1,ACCTTTCTGCGAACTAATCT,0,5014477
yjbJ_predicted,0.5,1,1,ACCTTGGCCCCCGGTGCTCA,0,5012321
yjbJ_predicted,0.5,1,1,ACCTTACGGGCGTGCAGAGT,0,5002647
yjbJ_predicted,0.5,1,1,ACCTCTTTTTAGTTCTCCGG,0,5013359
yjbJ_predicted,0.5,1,1,ACCTCTCCCCCACTCATGGA,0,5018249
yjbJ_predicted,0.5,1,1,ACCTACATTCCATCATTTGT,0,5020875
yjbJ_predicted,0.5,1,1,ACCGTAATAATCATTAAATG,0,5000720
yjbJ_predicted,0.5,1,1,ACCGGTTGACGATGGGTATG,0,5010811
yjbJ_predicted,0.5,1,1,ACCGGTTATGCGTATATCGG,0,4996791
yjbJ_predicted,0.5,1,1,ACCGCCGTGCCCTCCGTAGG,0,4996350
yjbJ_predicted,0.5,1,1,ACCGCAGGCGGTGGCGTTGT,0,5001045
yjbJ_predicted,0.5,1,1,ACCGCAAATATCACGTGTAA,0,4996086
yjbJ_predicted,0.5,1,1,ACCGACCGCTAGTTACACGT,0,5001696
yjbJ_predicted,0.5,1,1,ACCCTTCACCGTGGGGTCAT,0,5029445
yjbJ_predicted,0.5,1,1,ACCATGTCCAGGGCTCAACT,0,5024190
yjbJ_predicted,0.5,1,1,ACCATGCGTTAGACGGAATG,0,5027255
yjbJ_predicted,0.5,1,1,ACCATGCCTTTTATCCGCAA,0,5017050
yjbJ_predicted,0.5,1,1,ACCATAGATTCGCCCGTTCG,0,5031265
yjbJ_predicted,0.5,1,1,ACCAGTAAACCAAAGGAAAT,0,5015400
yjbJ_predicted,0.5,1,1,ACCAGGTCGGTCTTGAGGTC,0,5016489
yjbJ_predicted,0.5,1,1,ACCACTTTCCCACATAATCA,0,5005673
yjbJ_predicted,0.5,1,1,ACCACATCTCAGTGTGAAAA,0,5008258
yjbJ_predicted,0.5,1,1,ACATTGAGGAGCATGGTGAG,0,5021911
yjbJ_predicted,0.5,1,1,ACATGTTGCTTGCCACACTC,0,4997483
yjbJ_predicted,0.5,1,1,ACATGTAGGTCACTTAACAA,0,5015646
yjbJ_predicted,0.5,1,1,ACATGGCTATGTTGAAATTT,0,4998762
yjbJ_predicted,0.5,1,1,ACATGCGGGATGACGTATTG,0,5015322
yjbJ_predicted,0.5,1,1,ACATGAGATTAATGCCGGTA,0,5025736
yjbJ_predicted,0.5,1,1,ACATGACAAGGTCACCCTTG,0,5017340
yjbJ_predicted,0.5,1,1,ACATCAATACGGACGAGATT,0,5004987
yjbJ_predicted,0.5,1,1,ACATATCTCCGCAATATTGT,0,5008872
yjbJ_predicted,0.5,1,1,ACATATATAAGAATCCAACC,0,5025956
yjbJ_predicted,0.5,1,1,ACATACCTCGTGTCACCACA,0,5026188
yjbJ_predicted,0.5,1,1,ACAGTTGCTTATATTGGCAT,0,5029677
yjbJ_predicted,0.5,1,1,ACAGGTTAATAATTCTGCCT,0,5022645
yjbJ_predicted,0.5,1,1,ACAGGTATTAACCAGCTCCG,0,5011945
yjbJ_predicted,0.5,1,1,ACAGGGCAATTGTGCGTGGT,0,5004080
yjbJ_predicted,0.5,1,1,ACAGGAAGGAAAATGAGTGA,0,5012976
yjbJ_predicted,0.5,1,1,ACAGCTCCGTGTCGTGGTCG,0,5009392
yjbJ_predicted,0.5,1,1,ACAGCAGTGTCTCGATCTAC,0,5000147
yjbJ_predicted,0.5,1,1,ACAGACTTGCTGCATAACAT,0,5022869
yjbJ_predicted,0.5,1,1,ACACGTGCTCAGTTTCGCAG,0,5029153
yjbJ_predicted,0.5,1,1,ACACCCCATTCGAGGTTATA,0,5003039
yjbJ_predicted,0.5,1,1,ACAATTATTCGTGTACAGGC,0,5015342
yjbJ_predicted,0.5,1,1,ACAATGGCGTAGGACGTTAT,0,5009590
yjbJ_predicted,0.5,1,1,ACAACGAGGGCAATATAGCC,0,5028326
yjbJ_predicted,0.5,1,1,AATTTTTCCGGCGACGACGG,0,5013862
yjbJ_predicted,0.5,1,1,AATTTTGGTGCGGCGCCTGT,0,5000178
yjbJ_predicted,0.5,1,1,AATTTGGCGGTATTCCGAAT,0,5002254
yjbJ_predicted,0.5,1,1,AATTTGGCGAGACACGGCTA,0,5025249
yjbJ_predicted,0.5,1,1,AATTTGGAAGCAAGTATACT,0,5006075
yjbJ_predicted,0.5,1,1,AATTGTTACTCGACGGAAAG,0,5012501
yjbJ_predicted,0.5,1,1,AATTCCCGGGAACTAAATTA,0,5024255
yjbJ_predicted,0.5,1,1,AATTACTGCGCTCTTTGAAG,0,5004480
yjbJ_predicted,0.5,1,1,AATTAAGCTCTCCGGCTGGA,0,4995676
yjbJ_predicted,0.5,1,1,AATTAACGCCACAATGTGAC,0,5028224
yjbJ_predicted,0.5,1,1,AATTAAACCAATGTGGGTTC,0,5005692
yjbJ_predicted,0.5,1,1,AATGTTAACGAAGTGTTCCC,0,5013166
yjbJ_predicted,0.5,1,1,AATGTAGGTCACTGGATCTG,0,5002126
yjbJ_predicted,0.5,1,1,AATGGGGCTCCGCCCGATTT,0,5019438
yjbJ_predicted,0.5,1,1,AATGGGGACTTTTTGCGGAT,0,5027780
yjbJ_predicted,0.5,1,1,AATGGCATCCAGGATGGATC,0,5022940
yjbJ_predicted,0.5,1,1,AATGCGTCCCTTGGAAAGGT,0,4998441
yjbJ_predicted,0.5,1,1,AATGAGGTGGCTCTAATGAG,0,5004421
yjbJ_predicted,0.5,1,1,AATCTGCGCGTGATATTTCT,0,5007745
yjbJ_predicted,0.5,1,1,AATCTCTAGGCTGCTCGCAA,0,5021311
yjbJ_predicted,0.5,1,1,AATCTCGAGTGTACAAGTGA,0,5028794
yjbJ_predicted,0.5,1,1,AATCTATCGGTGTCCATAAG,0,5019770
yjbJ_predicted,0.5,1,1,AATCGCCAGAGCGGGGAGCA,0,5018571
yjbJ_predicted,0.5,1,1,AATCATAAAACCGCCACCCG,0,5004967
yjbJ_predicted,0.5,1,1,AATCAAAGTCCAACACTTCG,0,5021596
yjbJ_predicted,0.5,1,1,AATATTTCTGCGGGAGTAAA,0,5022443
yjbJ_predicted,0.5,1,1,AATATTTAAACGATTTTGTA,0,5000322
yjbJ_predicted,0.5,1,1,AATATAGCTTCCATCCATAT,0,5026192
yjbJ_predicted,0.5,1,1,AATAGGTTCCATATCGTGTA,0,5028239
yjbJ_predicted,0.5,1,1,AATAAGGCAGCATCCATTTG,0,5023478
yjbJ_predicted,0.5,1,1,AAGTTTATATTACTACAAGG,0,5008427
yjbJ_predicted,0.5,1,1,AAGTGGGATCGCCAGGCTTA,0,5028931
yjbJ_predicted,0.5,1,1,AAGTCGCGTTTCGGTTTAAT,0,5017546
yjbJ_predicted,0.5,1,1,AAGTCACAGGTTCGTAGAGG,0,5007139
yjbJ_predicted,0.5,1,1,AAGTAAGGTGGCTAGTTGCT,0,5020288
yjbJ_predicted,0.5,1,1,AAGGTAAATCCAATGCATTA,0,5003904
yjbJ_predicted,0.5,1,1,AAGGGGTGAAATTCTACTCC,0,5015603
yjbJ_predicted,0.5,1,1,AAGCTTGTGCTTAGAGCGTT,0,5008036
yjbJ_predicted,0.5,1,1,AAGCGGTCGGGCTGTACCGT,0,5003317
yjbJ_predicted,0.5,1,1,AAGCGCTGGGTCGGCGATGG,0,4997902
yjbJ_predicted,0.5,1,1,AAGCGAACTCGCCACGGGGT,0,5030917
yjbJ_predicted,0.5,1,1,AAGCCTGGGGGGCACCCCGG,0,5018047
yjbJ_predicted,0.5,1,1,AAGATTGTACAAGGTGCATT,0,5004934
yjbJ_predicted,0.5,1,1,AAGATAGCAAGCCTTATGGT,0,5000014
yjbJ_predicted,0.5,1,1,AAGAGTAGGGTCCTTTCCCC,0,5022728
yjbJ_predicted,0.5,1,1,AAGAGCATCATATCGTTAGG,0,5012150
yjbJ_predicted,0.5,1,1,AACTTGGTTTTTCTGTTGGG,0,5018528
yjbJ_predicted,0.5,1,1,AACTTGGATTGTGCCAAAGC,0,4999044
yjbJ_predicted,0.5,1,1,AACGCCAATCTTCTAAAGAC,0,5003784
yjbJ_predicted,0.5,1,1,AACCTTGGGCTAAGGTTAGA,0,5007293
yjbJ_predicted,0.5,1,1,AACCTTATACAGTAGAGATC,0,5004297
yjbJ_predicted,0.5,1,1,AACCGTCTTGCGCGCAACCT,0,5006750
yjbJ_predicted,0.5,1,1,AACCGTATCATTACGCCATA,0,5009576
yjbJ_predicted,0.5,1,1,AACCGGTATCTCCGCAGGCA,0,5024562
yjbJ_predicted,0.5,1,1,AACCGACGTAGTAGCGACAC,0,4997723
yjbJ_predicted,0.5,1,1,AACCATTAGGGGCAATTTAT,0,5030761
yjbJ_predicted,0.5,1,1,AACATGACGCGCGGTTGTGG,0,5002802
yjbJ_predicted,0.5,1,1,AACATAAAAGATTACTGTTC,0,5018665
yjbJ_predicted,0.5,1,1,AACAGCCCGATTGGGTACAA,0,4996048
yjbJ_predicted,0.5,1,1,AACAAAAGCTTTAGGCCACT,0,5006490
yjbJ_predicted,0.5,1,1,AAATTAGAGGGTCAAAGGCC,0,4999088
yjbJ_predicted,0.5,1,1,AAATGCGCCAATCCGGCTAT,0,5004586
yjbJ_predicted,0.5,1,1,AAATGAAGTGTATGGTTAAA,0,5028982
yjbJ_predicted,0.5,1,1,AAATCATAACCGTGGTCAAA,0,5013800
yjbJ_predicted,0.5,1,1,AAATATAGTAGTAGATGTGC,0,4995711
yjbJ_predicted,0.5,1,1,AAATAGCGCAGCGGGTGAGA,0,5018422
yjbJ_predicted,0.5,1,1,AAATACGACCGAATGATATT,0,5004842
yjbJ_predicted,0.5,1,1,AAATACCAACTCCATTGGTA,0,4998602
yjbJ_predicted,0.5,1,1,AAAGTTGAGGCGGGGCAGAG,0,5024851
yjbJ_predicted,0.5,1,1,AAAGTCAAGTTTACCTACGA,0,5005877
yjbJ_predicted,0.5,1,1,AAAGTATCATGATATTTCGT,0,5005381
yjbJ_predicted,0.5,1,1,AAAGATTTCCTCTGGGATCA,0,5028948
yjbJ_predicted,0.5,1,1,AAACTTTTGAAGTGTATCCA,0,5022955
yjbJ_predicted,0.5,1,1,AAACTCTAGGTACCGCAAGA,0,5010462
yjbJ_predicted,0.5,1,1,AAACGGTAAAGTGTGGGGTA,0,5030185
yjbJ_predicted,0.5,1,1,AAACGAGATGGGCTAATTAT,0,5000857
yjbJ_predicted,0.5,1,1,AAACCTTAGAGGTCCACTGT,0,5019911
yjbJ_predicted,0.5,1,1,AAACACTTCTTTTGTTGACA,0,5008739
yjbJ_predicted,0.5,1,1,AAAATGATTGCCACCGCGCG,0,5027287
yjbJ_predicted,0.5,1,1,AAAAGTTCCACGCAAGCCTT,0,5030965
yjbJ_predicted,0.5,1,1,AAAAGTCGGTTCTTAGGAAC,0,5027787
yjbJ_predicted,0.5,1,1,AAAAGCTCTTTATAGTGCTA,0,5000115
yjbJ_predicted,117.0,116,0,ATGATCCGAACTGCCGGTCC,116,5015561
yjbJ_predicted,89.0,88,0,CTCTCGGTGGAAATGTGTCA,88,5031165
yjbJ_predicted,69.0,68,0,CTTTGTGTACTAAAGGGGGT,68,4999956
yjbJ_predicted,67.0,66,0,ATAGATAGGGTCCGGAGAAA,66,5014932
yjbJ_predicted,67.0,66,0,AATGACGGTTAGTGAAACAT,66,4996126
yjbJ_predicted,66.0,65,0,AATACTTCATCTCTCCTGCA,65,4999067
yjbJ_predicted,65.0,64,0,AGCGGGTTAAGTCAGGACAA,64,5016576
yjbJ_predicted,64.0,63,0,ATATATTCGCTTTTCAGTTT,63,4996975
yjbJ_predicted,61.0,60,0,GTGCCGTCTCCGGTAAGTGT,60,5005650
yjbJ_predicted,61.0,60,0,CCTCGCTCAAACCCTCTGTC,60,5017457
yjbJ_predicted,61.0,60,0,CCGTTAACCAGACCATGAAC,60,5012865
yjbJ_predicted,61.0,60,0,AACGCCACTGTGGACAAATT,60,5019623
yjbJ_predicted,56.0,55,0,TTCCCCCTCATGATACTATA,55,5014308
yjbJ_predicted,56.0,55,0,GGACTGCATTTTCCAAGGAT,55,4999607
yjbJ_predicted,56.0,55,0,CTATATGCTTCAGATCGTAT,55,4995999
yjbJ_predicted,55.0,54,0,GGTTACAAGTGGCGATATTT,54,5020738
yjbJ_predicted,54.0,53,0,GGCCGTCTAGTGGAGGAGTA,53,5024138
yjbJ_predicted,54.0,53,0,CTTGTAATGCGTAAAAGACT,53,5021326
yjbJ_predicted,53.0,52,0,TTGCCAGGAGTGACCGGATA,52,5028593
yjbJ_predicted,52.0,51,0,GACCAATGCTGCTAAGACAC,51,5006059
yjbJ_predicted,51.0,50,0,AAAAGCAGGAACGGTGTTGT,50,5026227
yjbJ_predicted,50.0,49,0,GACTAAAAGTGAGCCTGGCA,49,5002613
yjbJ_predicted,50.0,49,0,AATGCAAAGCCTTCGTGTGT,49,4998961
yjbJ_predicted,49.0,48,0,CTTGTTTAAAGCACATTGCC,48,5018420
yjbJ_predicted,49.0,48,0,ATTCACATGCCTGCCAGATT,48,4995245
yjbJ_predicted,49.0,48,0,AAGGCACCATAGTAATAGTT,48,5018010
yjbJ_predicted,48.0,47,0,CGCTGATGTCAATTAAAGGT,47,5015205
yjbJ_predicted,47.0,46,0,ATGAATTCTCTGTACAAAAA,46,5008515
yjbJ_predicted,47.0,46,0,AGCATATCTAATATCATAAA,46,5008496
yjbJ_predicted,46.0,45,0,TGGCACATATTTTGTAAAGG,45,5019125
yjbJ_predicted,46.0,45,0,GGGGGCGGAGGCCGATGCTG,45,5002580
yjbJ_predicted,46.0,45,0,CGATCGTAATAGAGAACGGT,45,5006805
yjbJ_predicted,45.0,44,0,CGTGAGAGCCGGAATAGCTT,44,5016635
yjbJ_predicted,44.0,43,0,GTACGCCTCCAAATAGCTAA,43,5019752
yjbJ_predicted,44.0,43,0,AGCTTAGGGTTTCTCGGCCA,43,5004506
yjbJ_predicted,44.0,43,0,AAATAAAGGCTCGCTTGTCA,43,5029809
yjbJ_predicted,43.0,42,0,GCCGGCTCTTCTCGCCTGGC,42,5006482
yjbJ_predicted,43.0,42,0,ATCCTATCCTGGTGTTGCTG,42,5014129
yjbJ_predicted,42.0,41,0,GGATCAACGCGACCTTGTGT,41,5025097
yjbJ_predicted,41.0,40,0,TTGGATGTACGGCTAATAAA,40,5013806
yjbJ_predicted,41.0,40,0,GTTGGGGCGATTAAGTGAAC,40,5001255
yjbJ_predicted,41.0,40,0,CCGCTAACGAAGAAATAAGC,40,5019739
yjbJ_predicted,41.0,40,0,ACTGTTAGAATGGTAGATTA,40,5017464
yjbJ_predicted,40.0,39,0,TGACCACGGCCTTTACTGGT,39,5018008
yjbJ_predicted,40.0,39,0,GCAAGTGGTTCCGGCTCGGG,39,5001723
yjbJ_predicted,40.0,39,0,AATCGCTTTATAGCTTCAGC,39,5021902
yjbJ_predicted,40.0,39,0,AAGCCCCTAGATAGTAGCCA,39,5000497
yjbJ_predicted,39.0,38,0,TTACCGCGCTGATCGTTACT,38,5031034
yjbJ_predicted,39.0,38,0,GCCTACAAACGGCACCTAAA,38,5030153
yjbJ_predicted,39.0,38,0,ATTGCCGACCTTGATGGGGG,38,5027232
yjbJ_predicted,38.0,37,0,TTTCGTCTGGTAAAACTCAG,37,5005904
yjbJ_predicted,38.0,37,0,TACACCATCGAGAAGGGTCG,37,5027013
yjbJ_predicted,38.0,37,0,GGTTGACGAGAGGGGGGTGT,37,5023959
yjbJ_predicted,38.0,37,0,CTGCGGTTAAGAAAGCCCAA,37,4998053
yjbJ_predicted,38.0,37,0,ATTCGTCGATTGCAATAATG,37,5009842
yjbJ_predicted,38.0,37,0,ACCGCTTGGATTAAGAGTTT,37,5031266
yjbJ_predicted,37.0,36,0,GCGGAGCACATCGAGGATGG,36,5025762
yjbJ_predicted,37.0,36,0,CTAGTTGAGAAGTGAGCGAC,36,5021405
yjbJ_predicted,37.0,36,0,CAACGGCCCGATGGGAGTTT,36,5022283
yjbJ_predicted,37.0,36,0,AGTCTCACTCGCCCCGTAGG,36,5004581
yjbJ_predicted,37.0,36,0,AGGTGGCGCGGGGATCAGTG,36,5026821
yjbJ_predicted,37.0,36,0,AAATGCCAGGGACCAGCGGA,36,5004209
yjbJ_predicted,36.0,35,0,ATTATCGCCATAAATCAATA,35,5030092
yjbJ_predicted,35.0,34,0,GGCACAGAGAAGATTAGAAT,34,5017828
yjbJ_predicted,35.0,34,0,CCTTGGGCGCAAGACCACCT,34,5024540
yjbJ_predicted,35.0,34,0,AGGTTTATGTTGTGGAAGAG,34,5004392
yjbJ_predicted,34.0,33,0,TCTCTAGGGACTTATGACCT,33,5011554
yjbJ_predicted,34.0,33,0,CTTGTGGCCGCCATTACAAG,33,5028438
yjbJ_predicted,32.0,31,0,TGAGTTGGTGCTGGTGGCTT,31,5028955
yjbJ_predicted,32.0,31,0,CAGACTAACGCTAAGGGATT,31,5028032
yjbJ_predicted,31.0,30,0,TCTAGTAGAGGCCCACGGGT,30,5009758
yjbJ_predicted,30.0,29,0,GCCAGATGTTTAGTTCAGCC,29,5011294
yjbJ_predicted,30.0,29,0,ACCATACGAGTCGCTGGACA,29,5017858
yjbJ_predicted,30.0,29,0,AAGGCTGAGGTACGTTGCCT,29,4998800
yjbJ_predicted,28.0,27,0,TTATGTTTCTTACTTTTCTG,27,5001075
yjbJ_predicted,28.0,27,0,TGGTGGGCGTCTCGAACGAT,27,4997920
yjbJ_predicted,28.0,27,0,TGGTCTCCGACGGGCCAATG,27,5011448
yjbJ_predicted,27.0,26,0,TGAGCCTTCGTTCATCTACA,26,5004844
yjbJ_predicted,27.0,26,0,GAAGGCATGAATGAAGCACA,26,5015502
yjbJ_predicted,26.0,25,0,GCCAATTCAACAGTCTGATT,25,5017051
yjbJ_predicted,26.0,25,0,CTACAACACTCAAGTGGGTT,25,4999641
yjbJ_predicted,25.0,24,0,TTGCAGGAACCCACCAATAA,24,4996433
yjbJ_predicted,24.0,23,0,TTTTCTCTTATTTCCGGGTA,23,5022710
yjbJ_predicted,23.0,22,0,GGTTAACGGTGCTGTTTCAT,22,5019439
yjbJ_predicted,23.0,22,0,GCGTTTTATGTCCCTTTGTA,22,4995592
yjbJ_predicted,22.0,21,0,ATTTTCCGTAAATCCTTCTT,21,4996469
yjbJ_predicted,21.0,20,0,TTAAGATCGTCAGTCGAAGT,20,5029877
yjbJ_predicted,20.0,19,0,GGACCACCGCACAAGATCGC,19,4994973
yjbJ_predicted,18.0,17,0,GCCTAAGGAGGGCGCCGCTA,17,5029124
yjbJ_predicted,17.0,16,0,ACCGGTCGAGGCGGGGCGCG,16,5009526
yjbJ_predicted,7.0,6,0,TGGGGCGCCTATTTATAACG,6,5017488
yjbJ_predicted,5.0,4,0,GGTGGACCACGTTAAACTGC,4,5015636
yjbJ_predicted,5.0,4,0,GGGTGTTATACACATGAGCC,4,5007533
yjbJ_predicted,3.0,2,0,TATTTCTGCGTCACGCTTGA,2,5022975
yjbJ_predicted,3.0,2,0,GTCAAGGACTGTGTCCCTTA,2,4999444
yjbJ_predicted,3.0,2,0,CGCGCATGCAGCGGGTCACG,2,5001834
yjbJ_predicted,3.0,2,0,CCACGTGATTTCTGTATTTC,2,5018945
yjbJ_predicted,3.0,2,0,ATTGTGTGAAGCAAGGAAAC,2,5022017
yjbJ_predicted,3.0,2,0,AGCGCCATTAGGACGGGTGA,2,4999540
yjbJ_predicted,2.0,1,0,TTTAGATCAAATATATCAAA,1,5011482
yjbJ_predicted,2.0,1,0,TTGCTAGCGTTTTACGCGAA,1,5018381
yjbJ_predicted,2.0,1,0,TTACCGCGTGTTACGGTCGT,1,5022484
yjbJ_predicted,2.0,1,0,TGTCTCTATATCTGAAAAAA,1,5030421
yjbJ_predicted,2.0,1,0,TGGAGGGTACTAAATGGATT,1,5002856
yjbJ_predicted,2.0,1,0,TGCTCGTCCTGCTAGTTAGA,1,5006747
yjbJ_predicted,2.0,1,0,TATGGTCTAGAGAGTGTTGA,1,5019821
yjbJ_predicted,2.0,1,0,TAACGGGACAAATAATCGGT,1,5006454
yjbJ_predicted,2.0,1,0,GTGTCCACGCAAAACAAGTC,1,5012686
yjbJ_predicted,2.0,1,0,GGTTCAATACTCGGACATTA,1,4995401
yjbJ_predicted,2.0,1,0,GGTGGCCCTCGCTTCTAAGG,1,4998963
yjbJ_predicted,2.0,1,0,GGGGTTGATGGAGTATATTA,1,5004942
yjbJ_predicted,2.0,1,0,GGCAATCAATCCCCAGGACC,1,5021189
yjbJ_predicted,2.0,1,0,GCGGGGGAGCACATCAAACC,1,4998116
yjbJ_predicted,2.0,1,0,GAGAAGGCCATTTCTTTAGG,1,5008061
yjbJ_predicted,2.0,1,0,GAATAACATTGTACTACTGG,1,5005413
yjbJ_predicted,2.0,1,0,GAACATTGACTATGATTTGT,1,5011798
yjbJ_predicted,2.0,1,0,CTTTGTGACGCCTAACCGGT,1,5029740
yjbJ_predicted,2.0,1,0,CTGACGAACGCTGGGTATTT,1,5027671
yjbJ_predicted,2.0,1,0,CGCGCACGCAGCCCATTTTA,1,5020086
yjbJ_predicted,2.0,1,0,CGCCATGGCAGGGTGATCTA,1,5016156
yjbJ_predicted,2.0,1,0,CGCACTCGAGTGTCGGCCGT,1,4997375
yjbJ_predicted,2.0,1,0,CAGGGACACTACGAGGACAG,1,5002049
yjbJ_predicted,2.0,1,0,CAGAGTACCCTTTTCTATTA,1,5003338
yjbJ_predicted,2.0,1,0,CAAGGAACTGGGTCCACCTG,1,5003641
yjbJ_predicted,2.0,1,0,CAACGCCCTTATAAGTATGA,1,5023765
yjbJ_predicted,2.0,1,0,ATTGTCGATTACTCGCGTAG,1,5027256
yjbJ_predicted,2.0,1,0,ATGTCGCGAATTTCCGCACC,1,5002446
yjbJ_predicted,2.0,1,0,ATCCCCCACTATCCTCTTTG,1,5021749
yjbJ_predicted,2.0,1,0,ATCATCTATATACTCGATCA,1,5002117
yjbJ_predicted,2.0,1,0,ATAGCGATCGGTATTAAGTA,1,5004280
yjbJ_predicted,2.0,1,0,ATAATTTAGCGAGTGGGCGC,1,5004227
yjbJ_predicted,2.0,1,0,AGTCCCGCAATGTCCACATA,1,5021247
yjbJ_predicted,2.0,1,0,AGCTAAAGCATATTGACCAT,1,5022472
yjbJ_predicted,2.0,1,0,ACTCGCTAACTCAATCATGC,1,5009959
yjbJ_predicted,2.0,1,0,ACTAGTTTAGGGCAGGTCAC,1,5013309
yjbJ_predicted,2.0,1,0,ACCCCCTTCGATCCTAGCCT,1,4998019
yjbJ_predicted,2.0,1,0,ACAGACATCTCGATTTAGCC,1,5024967
yjbJ_predicted,2.0,1,0,ACAAGGATGTATACCGCCGT,1,5021554
yjbJ_predicted,2.0,1,0,AACTTGCGGGGTTACGGCTC,1,5021617
yjbJ_predicted,2.0,1,0,AAAATTTGCAGGAAGACCAC,1,5025685
yjbJ_predicted,2.0,1,0,AAAAACCCGACGCGACTCGG,1,5010296
