name,relative_counts,ct,ct_0,barcode,ct_1,barcode_ind
icdC_predicted,0.23225806451612904,189,154,TCGTAACCAGGCTCGGTAAG,35,1906777
icdC_predicted,0.6434108527131783,210,128,CACTACCGAAGCCTTGCTGA,82,1878012
icdC_predicted,1.2178217821782178,222,100,GCCCACCGGGGCTCCTTATG,122,1877897
icdC_predicted,0.9156626506024096,157,82,GAGGGATGTAACTAGAGAGA,75,1885058
icdC_predicted,0.5061728395061729,120,80,TGACTAGTGTCACAGTTCGC,40,1879815
icdC_predicted,0.6875,133,79,TAACAGAAGTCGGGAAGGTT,54,1887798
icdC_predicted,0.5333333333333333,113,74,TCCGGTCATGCAGAAACCTG,39,1877946
icdC_predicted,0.02702702702702703,74,73,TGTAATCATGGGAAATCGAC,1,1887836
icdC_predicted,1.1081081081081081,154,73,TGCGGCGAGCCATTAACATT,81,1901896
icdC_predicted,0.4520547945205479,104,72,GGGTGCCAAGCGGGTAGGCT,32,1881688
icdC_predicted,1.408450704225352,169,70,TGGTTTAAACACCGCGTGAT,99,1892433
icdC_predicted,0.9142857142857143,132,69,GGGCGCCGTGATTTAAGCTT,63,1892124
icdC_predicted,1.0144927536231885,137,68,TCGATTCAAACAGGGCGCGA,69,1878868
icdC_predicted,0.7101449275362319,116,68,CCGCCGGTATGGCTGACTAT,48,1880583
icdC_predicted,0.6176470588235294,108,67,GACTCAAGTCGAGTACCAGA,41,1880528
icdC_predicted,0.5074626865671642,99,66,TATATCCCTGTGGGGATTGG,33,1882687
icdC_predicted,0.417910447761194,93,66,GGTCGAAGTGTCGAGGAGGA,27,1886681
icdC_predicted,0.9393939393939394,126,65,TACAAAACGATCATGCGTTG,61,1904612
icdC_predicted,1.4545454545454546,160,65,CCACGGAAACCGGACTCGAA,95,1890903
icdC_predicted,1.4615384615384615,158,64,ACCTACAAAATGCTTTGCAA,94,1878616
icdC_predicted,0.22580645161290322,74,61,GTTCGGGAAAGCGAGCTCCA,13,1884736
icdC_predicted,0.2903225806451613,78,61,CGGCGTGCCCGCTGATCGGT,17,1880879
icdC_predicted,0.1774193548387097,71,61,CCTTCAGAGTTCACATGGCT,10,1899659
icdC_predicted,3.8225806451612905,297,61,ATCTGCCCGTTGCCATCTGT,236,1907359
icdC_predicted,0.27419354838709675,77,61,ATCGCTATGCGGGCGCACGT,16,1884866
icdC_predicted,0.3442622950819672,80,60,TTTACTGCCAGCTGTCCGAA,20,1879536
icdC_predicted,0.03278688524590164,61,60,GTTACAGGCATGCTAAAACG,1,1902965
icdC_predicted,1.098360655737705,126,60,GTACCCAGGGATAGGCCGTA,66,1887676
icdC_predicted,0.4098360655737705,84,60,GATAGTGTTCTGGGCTTTGT,24,1891383
icdC_predicted,0.4426229508196721,86,60,CCGGTAGGCAACAATATCCA,26,1878774
icdC_predicted,0.48333333333333334,87,59,TCTATGAAAGGTGGTCACAG,28,1879370
icdC_predicted,0.3728813559322034,79,58,CCGAACTGAGACAGCGATAT,21,1881155
icdC_predicted,0.4827586206896552,84,57,GAATTCGGAGCAGTGGAAGA,27,1879469
icdC_predicted,0.8103448275862069,103,57,CGAGAAGAACCTCAATTCAA,46,1893235
icdC_predicted,0.5789473684210527,88,56,CAGAACCCCAAGGCAGAGAA,32,1881280
icdC_predicted,0.2631578947368421,70,56,AGCTCCGTGTTAACCAAGAT,14,1887861
icdC_predicted,0.5357142857142857,84,55,TGTCCCCAGCCCTGCCCGTT,29,1890025
icdC_predicted,0.03636363636363636,55,54,TCCTCCTTTCTCCCAGGGAA,1,1883914
icdC_predicted,0.38181818181818183,74,54,CGGGCACAAGCGTCAGCCTG,20,1896352
icdC_predicted,1.2777777777777777,121,53,TCAAAGCTTATGACTAACCA,68,1908797
icdC_predicted,0.5555555555555556,82,53,TATACAAGTGTAAGCCCATA,29,1892931
icdC_predicted,1.1111111111111112,112,53,GGCCTAAATCCGTCTAGGCA,59,1879272
icdC_predicted,0.25925925925925924,66,53,GAGCCTTGTAAAATTCCTAC,13,1883182
icdC_predicted,0.25925925925925924,66,53,CCTTTGAAAGGCGATCTCAG,13,1878368
icdC_predicted,0.037037037037037035,54,53,ATGTGTCATGATTGGATGAT,1,1882044
icdC_predicted,0.49056603773584906,77,52,TCGATTACCTGACTCGGTCT,25,1889937
icdC_predicted,0.5094339622641509,78,52,TCCGCTGTCCGGGTCGGTTT,26,1900216
icdC_predicted,0.7547169811320755,91,52,GACTAAAGACTGCTTAGCCC,39,1880912
icdC_predicted,1.8113207547169812,147,52,CCTACGGCACATGGCACTAC,95,1889457
icdC_predicted,0.49056603773584906,77,52,AATTAAATTTTTTGTACGAT,25,1893562
icdC_predicted,0.38461538461538464,70,51,CAATCATACGGTAGTGGTGA,19,1882404
icdC_predicted,0.23529411764705882,61,50,TACTGAAGTAGGGAAGTATT,11,1905700
icdC_predicted,0.8823529411764706,94,50,GTCTTATGGGTTGGCAAGCG,44,1885059
icdC_predicted,0.3333333333333333,66,50,GTCAGCTATTCATAGGTGGA,16,1880805
icdC_predicted,0.3137254901960784,65,50,CGTTGGTGACCTCGCTCCGA,15,1881136
icdC_predicted,0.47058823529411764,73,50,ATGAAACCATTCGGTTCATA,23,1884986
icdC_predicted,0.8627450980392157,93,50,ATCGAGGGAGTGGAAAACGA,43,1896616
icdC_predicted,0.48,72,49,TTTGCGGTTGGGTTGGTTCA,23,1883102
icdC_predicted,1.14,105,49,TGGAGATGGCGTACGTTGCA,56,1883607
icdC_predicted,0.72,84,49,TGCGTTCTTACATTCGAGGT,35,1903613
icdC_predicted,0.12,54,49,TATGACTACCTCTCTAAGTA,5,1905392
icdC_predicted,0.56,76,49,GTAGGTGCGCATTACATCAC,27,1897673
icdC_predicted,1.06,101,49,GAGCGTATCTAGGTTCAGGA,52,1899230
icdC_predicted,1.2448979591836735,108,48,TTACGCGAATCCATGTATGA,60,1891408
icdC_predicted,0.3469387755102041,64,48,TAACGTTATTGAACACCCTG,16,1901014
icdC_predicted,1.2244897959183674,107,48,ATAAGAGCTTTTGTTTCCCC,59,1901088
icdC_predicted,0.4375,67,47,GGAAGGCCGGATCTGCTTTA,20,1887155
icdC_predicted,0.6666666666666666,78,47,GCTCACCGCAGTTCTCACTT,31,1880360
icdC_predicted,0.041666666666666664,48,47,GAGTTCACCAATTCCTCGCT,1,1894004
icdC_predicted,0.5208333333333334,71,47,GAGGGGGATTATCTACACGT,24,1908649
icdC_predicted,0.5833333333333334,74,47,CGAGCAGACGGCAGAACTCA,27,1904305
icdC_predicted,0.4375,67,47,CAAAATGTACCATGCCCCTT,20,1885562
icdC_predicted,0.4166666666666667,66,47,ATTCAGAATTTCAGAGTCAG,19,1901306
icdC_predicted,0.75,82,47,AACCGATATCAGTCTTTCCG,35,1879157
icdC_predicted,1.2340425531914894,103,46,GACCAGACCTAGGGTCGGAG,57,1900746
icdC_predicted,0.425531914893617,65,46,CTTATATAGAATACACACTT,19,1883376
icdC_predicted,1.446808510638298,113,46,AATTGCTTAATTTAGGCCAA,67,1902175
icdC_predicted,2.130434782608696,142,45,TGCCGTGTCGATAAGCAGTA,97,1877877
icdC_predicted,0.8478260869565217,83,45,TGATGGACTACCGAGTCGAT,38,1882591
icdC_predicted,0.1956521739130435,53,45,ACCCCATCCTCTTAAGGGAA,8,1889402
icdC_predicted,0.06666666666666667,46,44,CGGGGGAATGTACCCCATCT,2,1904082
icdC_predicted,0.28888888888888886,56,44,CGATGGAGCATGGGGCTACT,12,1900805
icdC_predicted,1.2666666666666666,100,44,CCTATTGCCCTGTTGTGATG,56,1888989
icdC_predicted,1.488888888888889,110,44,AGCGCGCTTACATAGGTCCA,66,1889528
icdC_predicted,0.17777777777777778,51,44,AACTTGGGGTAGCGGTTGAG,7,1889821
icdC_predicted,1.1590909090909092,93,43,TGTACAGAGAAAGCCACGGA,50,1909437
icdC_predicted,0.045454545454545456,44,43,GGCTCCCCCAATGGTACTTA,1,1897211
icdC_predicted,1.75,119,43,GATACAAGCCACTAGAAGCT,76,1881336
icdC_predicted,1.8181818181818181,122,43,CACCATGATGTTAGCTATAA,79,1896296
icdC_predicted,0.9318181818181818,83,43,CAAGCTATAGAATAGCTCGG,40,1897619
icdC_predicted,0.36363636363636365,58,43,ATTCAGCGGGCCGCGATCGT,15,1883830
icdC_predicted,0.9772727272727273,85,43,AGGCCGTGGCGTGTAAAGTC,42,1906632
icdC_predicted,0.3409090909090909,57,43,ACACGAGGATCGCCCCGTCT,14,1881587
icdC_predicted,1.302325581395349,97,42,TCAAGTGACCTGTCGATAAC,55,1908551
icdC_predicted,0.3023255813953488,54,42,GATTTCGTCACGGGTGCAAG,12,1878601
icdC_predicted,0.46511627906976744,61,42,GATTCCCACTTTTCGACTGG,19,1880999
icdC_predicted,0.6046511627906976,67,42,CCGCGGATATCTCGGCTCGA,25,1904572
icdC_predicted,0.9767441860465116,83,42,CCATGGTGCATCGGTGCTCG,41,1904750
icdC_predicted,0.23255813953488372,51,42,AGTAAGGTAGCTAAGTTGGA,9,1881772
icdC_predicted,0.5581395348837209,65,42,AAAAAGAATTACTATATATG,23,1889480
icdC_predicted,0.7857142857142857,73,41,TGCGTTGCCAGATTCGCTAG,32,1899273
icdC_predicted,0.047619047619047616,42,41,GCGGCGCTCGACACGGTGAG,1,1889454
icdC_predicted,1.0,82,41,CTTTTGGGAGACCTTTGTAG,41,1885097
icdC_predicted,1.1219512195121952,85,40,TTTATAGTTCTTGTTATTGT,45,1885825
icdC_predicted,0.04878048780487805,41,40,TTGGAGTCTTATGTGCTGTA,1,1903856
icdC_predicted,0.4634146341463415,58,40,TCAGGCGCCTACTGATGTCG,18,1881457
icdC_predicted,0.12195121951219512,44,40,TAGCTTAGTCTATGCCCCAG,4,1897210
icdC_predicted,0.04878048780487805,41,40,GCACGGGCTCCAATGGAAGA,1,1898161
icdC_predicted,0.34146341463414637,53,40,CGCTAACGACGTTCCCGCAA,13,1890027
icdC_predicted,0.3170731707317073,52,40,CGCACATGTCAAACCCAATT,12,1878443
icdC_predicted,0.7804878048780488,71,40,CAGCGGCTATCAGTGGGCAG,31,1879519
icdC_predicted,0.04878048780487805,41,40,ATGCACTCGTGAACCGAACT,1,1909090
icdC_predicted,0.14634146341463414,45,40,AGTAGATTATGGGCCTTGCC,5,1882125
icdC_predicted,0.34146341463414637,53,40,ACAGATCGCACTTTGGTCAG,13,1894397
icdC_predicted,0.2926829268292683,51,40,AACATCTTCTCTTAGGTGAC,11,1883287
icdC_predicted,1.525,99,39,TCTCGAAGGTGCCGGAGTAG,60,1881259
icdC_predicted,0.425,55,39,TCGGTCAGGCTCCGGCCTCT,16,1895297
icdC_predicted,0.525,59,39,CTTGACCATGGCCTTGACTG,20,1879096
icdC_predicted,1.85,112,39,CTAACGATACTGAGGAACGT,73,1881459
icdC_predicted,2.425,135,39,CGACTGTAACCACTCGTGTA,96,1878086
icdC_predicted,0.375,53,39,CCGACCATGGCAGTCGCGTA,14,1886768
icdC_predicted,0.225,47,39,CACATTTCTTTGGCGGGAAA,8,1890436
icdC_predicted,0.35,52,39,CAAATCATGGAGGCAAACAA,13,1888129
icdC_predicted,0.2,46,39,AAAGTACACACGAGGGGGAA,7,1904820
icdC_predicted,0.05128205128205128,39,38,TTCCTAATGAACGAGGTAGA,1,1881226
icdC_predicted,0.05128205128205128,39,38,TACTTAATAGAGCATTTGTT,1,1901060
icdC_predicted,0.48717948717948717,56,38,TACGGTAGTGCAGAGTATAA,18,1898503
icdC_predicted,0.9487179487179487,74,38,GGTTGTTGCCTTAGAGCTGG,36,1898939
icdC_predicted,0.5384615384615384,58,38,GAGGTGAAGCAAATCGTAAG,20,1891094
icdC_predicted,0.05128205128205128,39,38,CTTTGGTGTAGTACTACCGT,1,1885355
icdC_predicted,0.10256410256410256,41,38,CTTAACAACGATACGGGCGG,3,1885687
icdC_predicted,0.8205128205128205,69,38,CGAACAGCGCTGTTTATTAT,31,1877927
icdC_predicted,0.6666666666666666,63,38,CCGACATCTGGTAACTGATA,25,1886080
icdC_predicted,0.5384615384615384,58,38,CATTAAGTCACCAGAGCTAA,20,1893521
icdC_predicted,0.6410256410256411,62,38,AATACGTAGTTATACATTGG,24,1904230
icdC_predicted,0.3333333333333333,50,38,AAAACCCTTCCATAAGAGCT,12,1891658
icdC_predicted,0.5,55,37,TTAAGAATATGCCTGGTTGA,18,1889739
icdC_predicted,0.13157894736842105,41,37,TTAACTACGGTTGATGCGGC,4,1880361
icdC_predicted,0.8157894736842105,67,37,TGAACGCTAGGGAACCCCGC,30,1878014
icdC_predicted,0.39473684210526316,51,37,TAAAATTAGCACCCCCGCCA,14,1879726
icdC_predicted,0.42105263157894735,52,37,GCAAACTGCCAAGATTATCT,15,1894375
icdC_predicted,0.7894736842105263,66,37,GATCGGCTATATCAGCTATG,29,1905691
icdC_predicted,0.07894736842105263,39,37,CTGAAGCCCGGTACTATAGC,2,1899048
icdC_predicted,0.23684210526315788,45,37,CGTTAACCTTTTAGGAACTA,8,1892792
icdC_predicted,0.34210526315789475,49,37,CGTGCCTGTTGTGGGCAATA,12,1890475
icdC_predicted,0.21052631578947367,44,37,CGACCTTCAGTCTGGAGCAG,7,1880780
icdC_predicted,0.47368421052631576,54,37,AGGCAACCCCGCCATGCGAT,17,1882662
icdC_predicted,0.3684210526315789,50,37,AGCGAGGGCAGTGGCGGTTG,13,1879012
icdC_predicted,0.3157894736842105,48,37,AGCCTATCTACGAGTTAAAA,11,1904649
icdC_predicted,0.47368421052631576,54,37,ACTATGTTGAACTGTGCTAT,17,1892880
icdC_predicted,0.07894736842105263,39,37,ACATATTCCAAGCCGCCGCA,2,1887654
icdC_predicted,0.7837837837837838,64,36,TTCCAGGGTAGACGGCCATG,28,1877913
icdC_predicted,0.24324324324324326,44,36,TGAAGCTATCCAGTCGCACA,8,1897380
icdC_predicted,0.5405405405405406,55,36,GGGTCCAGCCCAGCAACAGG,19,1897686
icdC_predicted,0.40540540540540543,50,36,GGGAGACACGATAAGTTGCT,14,1894151
icdC_predicted,0.05405405405405406,37,36,GGACAAGGTACCCTTCATGT,1,1889868
icdC_predicted,2.4324324324324325,125,36,CGTAGCTCCGAATTTTGTGG,89,1880337
icdC_predicted,1.2972972972972974,83,36,CCTGGGATGCATAAGGCTGT,47,1889525
icdC_predicted,1.0810810810810811,75,36,CCGTTTAACTAGAGCTCGGT,39,1895167
icdC_predicted,0.3783783783783784,49,36,CAATCATTAAGGTATTTTGA,13,1906803
icdC_predicted,0.972972972972973,71,36,CAAACTGGTTGGGTCCTCTG,35,1881390
icdC_predicted,0.6486486486486487,59,36,AGTAGAGGTGGATTTAAGCG,23,1896605
icdC_predicted,2.27027027027027,119,36,AGGATTCCTAACGTATATAG,83,1878750
icdC_predicted,2.6486486486486487,133,36,AGAGACTTTGTTGCACGCTT,97,1879246
icdC_predicted,0.5405405405405406,55,36,ACTCCATAACTTACAAGTAG,19,1898146
icdC_predicted,1.4324324324324325,88,36,ACATAATTCCGTCCGCTCAA,52,1888797
icdC_predicted,0.05405405405405406,37,36,AAGTCCTCCCTTAACATCCA,1,1892091
icdC_predicted,0.5277777777777778,53,35,TTTAACGGAATAACCAAGGG,18,1902834
icdC_predicted,0.3611111111111111,47,35,TCTCACGGCTTAGTAAAAAA,12,1878052
icdC_predicted,0.6111111111111112,56,35,TAAGGTACAGCGGCGTTCAT,21,1879574
icdC_predicted,0.4166666666666667,49,35,GTCATTTATAAAATCGTAAA,14,1896936
icdC_predicted,0.8333333333333334,64,35,GGTCATCGGATGTCATGCGG,29,1883603
icdC_predicted,0.8888888888888888,66,35,GCCCCAAAGGTTGTCTTCTT,31,1879822
icdC_predicted,0.7777777777777778,62,35,GATCGGTCGGAGCTCACCTA,27,1885192
icdC_predicted,0.5555555555555556,54,35,CGGTTCGGAATCCGTATATG,19,1891719
icdC_predicted,1.4444444444444444,86,35,CCATCTACCGCCGTGGCTAT,51,1883140
icdC_predicted,0.5277777777777778,53,35,CCAAAGAGGTAGGGATGAGA,18,1904639
icdC_predicted,2.7777777777777777,134,35,ATTTATATAGGATAAATGTG,99,1895545
icdC_predicted,0.7222222222222222,60,35,AGGATGGGAAAGTATGCCAT,25,1888532
icdC_predicted,0.6944444444444444,59,35,ACCGTGAGCCCTTTCAAATT,24,1881882
icdC_predicted,0.05714285714285714,35,34,TCGTGGGTAGGCGATTCGCA,1,1883086
icdC_predicted,0.3142857142857143,44,34,GTCAGACTTAGTGACGGTCT,10,1891231
icdC_predicted,0.2571428571428571,42,34,GCTGCACTTCCTAATCGTTA,8,1898940
icdC_predicted,1.0857142857142856,71,34,GCCTATCAGCAATCTGAGAC,37,1897154
icdC_predicted,0.2571428571428571,42,34,CCTGCGGCCTAGGTCCGTGA,8,1901355
icdC_predicted,0.42857142857142855,48,34,CATTGCGGCTGCTATAAGGT,14,1906846
icdC_predicted,1.0571428571428572,70,34,CATCCCCTCTTTTAAAGTGG,36,1900760
icdC_predicted,0.05714285714285714,35,34,CAACAAGTAGATACCTCACA,1,1879080
icdC_predicted,0.08571428571428572,36,34,ATGTCTTCAATCTGATGCCT,2,1906459
icdC_predicted,0.5714285714285714,53,34,AGGTCGTGCGGGAATTCAAG,19,1887974
icdC_predicted,0.6,54,34,AGAAATCGAATGTCAGACAT,20,1896544
icdC_predicted,0.7352941176470589,57,33,TGGTCCATGAACTGATGATC,24,1902731
icdC_predicted,0.38235294117647056,45,33,TGACAGCTTACCGGAACTAA,12,1894290
icdC_predicted,0.38235294117647056,45,33,TCTTGGCAATCGCGTAGACG,12,1880493
icdC_predicted,3.8529411764705883,163,33,TAGCTAAAGGGTTCAATGCC,130,1897542
icdC_predicted,0.8235294117647058,60,33,GTCGTGCCCCGCAGCTCAGC,27,1878331
icdC_predicted,0.7058823529411765,56,33,GCTGTACGTCCAGCGAGTTG,23,1879570
icdC_predicted,0.5588235294117647,51,33,GACCCCAGAAACAGGGAGGT,18,1886047
icdC_predicted,1.411764705882353,80,33,CTGAGCGCCTTTCACGCATT,47,1907451
icdC_predicted,0.17647058823529413,38,33,CTAACGGCTGCTCTCAGGAA,5,1895504
icdC_predicted,0.38235294117647056,45,33,CGTGACCGCAGGATCTCCTC,12,1890652
icdC_predicted,0.058823529411764705,34,33,CCACAATGCCACAGTGGATT,1,1881795
icdC_predicted,0.7058823529411765,56,33,CATCGCGAGGTGCAAGATTT,23,1896733
icdC_predicted,0.17647058823529413,38,33,ATTGTAAGCGTCCAGCCATC,5,1882697
icdC_predicted,2.1176470588235294,104,33,ATCTAGAGTGTTGGATACTG,71,1878222
icdC_predicted,1.7352941176470589,91,33,ATATTTTACTCTAACGTGGA,58,1892514
icdC_predicted,0.7941176470588235,59,33,ACGGAGTATCATTTGGCTCT,26,1894054
icdC_predicted,0.058823529411764705,34,33,ACACCTACCCTAATTGGATT,1,1891578
icdC_predicted,0.6470588235294118,54,33,AATACGTGTTTTTACAACGA,21,1888036
icdC_predicted,0.6764705882352942,55,33,AAGCTCGGACTTACTAGGAC,22,1891171
icdC_predicted,0.38235294117647056,45,33,AAATCGTTGCCATACGTTGT,12,1899843
icdC_predicted,0.058823529411764705,34,33,AAACCACAGGGCTTATCGCC,1,1881706
icdC_predicted,0.12121212121212122,35,32,TTATTCCGGGAAGAGGTGTA,3,1893985
icdC_predicted,0.42424242424242425,45,32,TGTAAGCCTTCTCGGATATC,13,1894665
icdC_predicted,0.7878787878787878,57,32,TGGAAGCAGGACATCTCCAT,25,1896187
icdC_predicted,0.5757575757575758,50,32,TCTGCCTCACCCAGACCAGA,18,1899891
icdC_predicted,0.696969696969697,54,32,TCGGTCCGTATTTCATGAGT,22,1888948
icdC_predicted,0.06060606060606061,33,32,TAATAGGCAAGTAGGAACCA,1,1883351
icdC_predicted,3.121212121212121,134,32,GTACGTGAGCGCTTACGCCA,102,1880158
icdC_predicted,0.06060606060606061,33,32,GGCGATCACAGGTTACCCCC,1,1905767
icdC_predicted,1.6363636363636365,85,32,GCTTGGGTACGGCATTTGGT,53,1907855
icdC_predicted,0.06060606060606061,33,32,GAACAGCCGGTTGGCGAAAG,1,1892726
icdC_predicted,0.42424242424242425,45,32,CTCGCCAGATCCTTTGCTTA,13,1906362
icdC_predicted,0.06060606060606061,33,32,CCCCGCCTGTTTGATTCCGG,1,1906711
icdC_predicted,0.09090909090909091,34,32,AGGCGGATACCGGTGATCTA,2,1890121
icdC_predicted,0.90625,59,31,TTTTGGTATCCCTCAGTTTT,28,1883728
icdC_predicted,1.9375,92,31,TGGTCTAGCACGTTGCACGT,61,1899602
icdC_predicted,0.65625,51,31,TCTTCGTAGCTTATCTGATA,20,1890433
icdC_predicted,0.9375,60,31,TCTTCCCGGCAGTCCGATAT,29,1893189
icdC_predicted,0.21875,37,31,GTTTGCCCTAAGAGCTGTTC,6,1880726
icdC_predicted,0.3125,40,31,GGTCCCAAATGATAGATCCT,9,1885056
icdC_predicted,1.3125,72,31,GGATAATGCGCAGTATGCGC,41,1893622
icdC_predicted,0.34375,41,31,GAACGGCGTGCGCTAACACA,10,1888216
icdC_predicted,0.375,42,31,CGCAATAGTGTCAGCAAGAA,11,1893013
icdC_predicted,0.78125,55,31,CCTAATTCGGTCCGTCAAGG,24,1889048
icdC_predicted,0.75,54,31,CAATGTAGCGGGTTTCTATA,23,1895548
icdC_predicted,0.5,46,31,ATATCAACCCCGCCTAGGTT,15,1905581
icdC_predicted,0.71875,53,31,AGTCATATCCCGTAATTCGG,22,1894235
icdC_predicted,0.0625,32,31,AGGTAAGAAGCGAGCCGTTC,1,1898705
icdC_predicted,1.5,78,31,AGCTGCGTCTAATGCCAGAA,47,1902699
icdC_predicted,0.75,54,31,ACTTCTCATGTGTCCACGAC,23,1886582
icdC_predicted,0.125,34,31,ACGTGTTCTCGAGTTATAAC,3,1890074
icdC_predicted,0.84375,57,31,ACAAGACAGGGTTTTCGAGT,26,1879393
icdC_predicted,0.06451612903225806,31,30,TTCGACGCGCTGAACGGTGG,1,1886398
icdC_predicted,0.6451612903225806,49,30,TGTCCCAAATAGAAACACGT,19,1892277
icdC_predicted,1.2903225806451613,69,30,TGGTAGTTCTCCCGGTACGA,39,1899261
icdC_predicted,0.06451612903225806,31,30,TGGCATCCGGCTAACAACTA,1,1888485
icdC_predicted,0.3548387096774194,40,30,TCTGAGACGAACCGTACCGA,10,1885386
icdC_predicted,0.45161290322580644,43,30,TACACTTCTCAACCAGAGAG,13,1904324
icdC_predicted,0.6774193548387096,50,30,TAACTTTGGGAGACATTGGG,20,1896188
icdC_predicted,0.7419354838709677,52,30,TAAATTGGCCTAGATAATGA,22,1903953
icdC_predicted,1.2580645161290323,68,30,GGCGCATTAGGGCCAAGAAC,38,1903447
icdC_predicted,1.2258064516129032,67,30,GCGGCAAAGATTGAGGCATT,37,1886648
icdC_predicted,0.8709677419354839,56,30,GATTAATTCGCGCAATTGCT,26,1897233
icdC_predicted,0.3870967741935484,41,30,GACGGTGTCTAGACTCATGA,11,1891840
icdC_predicted,0.3870967741935484,41,30,GAACGTGTGACCGACGGATT,11,1894115
icdC_predicted,0.41935483870967744,42,30,CGCCATTCGGACCGGCAACG,12,1891342
icdC_predicted,0.6129032258064516,48,30,CGATTGTCATGAGAGCTGCT,18,1903916
icdC_predicted,1.1612903225806452,65,30,CAATTGCTTCAGTCACCGTT,35,1884494
icdC_predicted,1.3870967741935485,72,30,ATTGCTAGGTACTTTACTTT,42,1903503
icdC_predicted,0.7741935483870968,53,30,ATAGACTGAGTCCTTAGACT,23,1884449
icdC_predicted,0.967741935483871,59,30,AGCTGCCGTACTTTCCGAGT,29,1882760
icdC_predicted,0.1935483870967742,35,30,ACGGAGTAGGTTCGAATGGA,5,1905099
icdC_predicted,1.903225806451613,88,30,ACGCGGCGCATCGGAAATCG,58,1903659
icdC_predicted,2.096774193548387,94,30,ACCTAAGTACGATCTTAGTG,64,1885225
icdC_predicted,1.3548387096774193,71,30,AATGGTACGGTCGAGGCGCC,41,1896281
icdC_predicted,1.3548387096774193,71,30,AATAACGGTTACTTAGCCTA,41,1899502
icdC_predicted,1.3,67,29,TTCATCGGGCCGGGGCCGTT,38,1879495
icdC_predicted,0.5333333333333333,44,29,TCTGTTAGCGGTCGTGTGCC,15,1909412
icdC_predicted,0.26666666666666666,36,29,TCCTCGTAAATTGAGTCTTA,7,1900957
icdC_predicted,0.5333333333333333,44,29,GGCTACGCTTTATTTAACTT,15,1878667
icdC_predicted,1.6333333333333333,77,29,GATTGCACACCATGGCCTAG,48,1886217
icdC_predicted,1.3666666666666667,69,29,GAACCCGGTACCAGGGGAAA,40,1898365
icdC_predicted,1.6333333333333333,77,29,CTAAGGTGAGGGCTCACATA,48,1900405
icdC_predicted,1.3666666666666667,69,29,CGGGTACCAAACGTCAGGTA,40,1897874
icdC_predicted,2.533333333333333,104,29,CGATTAAATCAGATTGAACT,75,1896896
icdC_predicted,3.1666666666666665,123,29,CCTATCTGCCCACGGGTTAT,94,1885422
icdC_predicted,0.4,40,29,ATCCTCTAGCGCTTTCGCAT,11,1899588
icdC_predicted,0.7,49,29,AGCTGGTTGTGTTGCCCTGC,20,1901301
icdC_predicted,0.3333333333333333,38,29,AGATAGGGAAGCTCTGACTA,9,1884541
icdC_predicted,0.6666666666666666,48,29,AATAAGTTGAACCGACTGTA,19,1907366
icdC_predicted,0.4482758620689655,40,28,TGTCTTGACATGCGCTTCGC,12,1883155
icdC_predicted,0.4827586206896552,41,28,TGGAGGGACACGGACCACGA,13,1884334
icdC_predicted,0.6896551724137931,47,28,TGATATTGATCTGTGATTCC,19,1886393
icdC_predicted,0.4482758620689655,40,28,TAATTTGTGTTGCGGACTGT,12,1880157
icdC_predicted,1.793103448275862,79,28,TAAGAGGCCTGCTTAGGAAG,51,1902739
icdC_predicted,0.3793103448275862,38,28,GTGATGTTGGGTAGAGGTCG,10,1881120
icdC_predicted,0.06896551724137931,29,28,GCGGTCTCCGGGTTTACCTG,1,1886347
icdC_predicted,0.7241379310344828,48,28,GCCTTTGCAACATTATGATT,20,1881413
icdC_predicted,0.6206896551724138,45,28,CGCCGCGTGTGAGAGAAAGG,17,1902645
icdC_predicted,3.3448275862068964,124,28,CCCAGGCATCCTCGCGGCAT,96,1878809
icdC_predicted,0.3448275862068966,37,28,ATGTGGGGGAATAGTATGTA,9,1884210
icdC_predicted,1.2758620689655173,64,28,ATGCCGTCAAAGATTCGCCT,36,1894710
icdC_predicted,1.6551724137931034,75,28,ATATGAACCGCATGTGACTT,47,1883272
icdC_predicted,0.3448275862068966,37,28,AGGTCCGATTGAGTAGCCAT,9,1906649
icdC_predicted,2.0344827586206895,86,28,ACTCAGTTGCGTGGAGTTGT,58,1889110
icdC_predicted,0.10344827586206896,30,28,ACTCACAGTCTACGTCTAAG,2,1882988
icdC_predicted,1.3793103448275863,67,28,AATTAAAGCGTAATTTGGTC,39,1889601
icdC_predicted,1.5172413793103448,71,28,AAAGTTACCACGATCCGGGT,43,1887248
icdC_predicted,0.06896551724137931,29,28,AAAACTGATGGAGGAGGACC,1,1880790
icdC_predicted,0.07142857142857142,28,27,TTTCGTAAGTTCTCTTATCC,1,1882841
icdC_predicted,0.6785714285714286,45,27,TTGGAACTCGAAGAGCGTGT,18,1903219
icdC_predicted,1.7142857142857142,74,27,TTGCAGGTTTGTGTAACCTT,47,1887136
icdC_predicted,0.07142857142857142,28,27,TTCGTTATATCTTTGGTGTG,1,1888483
icdC_predicted,0.4642857142857143,39,27,TCGTTTACTCTCAATATCAC,12,1883465
icdC_predicted,0.9642857142857143,53,27,TCAATAACGGCTGATAACCA,26,1904136
icdC_predicted,1.7857142857142858,76,27,GGGATGCCTCAATTTACGGA,49,1878221
icdC_predicted,1.0,54,27,GGGATATAATGCGCACGACC,27,1892331
icdC_predicted,2.2142857142857144,88,27,GCCCTATCGGCGTCGTATGT,61,1897788
icdC_predicted,2.0357142857142856,83,27,GAGTCACCGCATACCTTACA,56,1888311
icdC_predicted,0.9285714285714286,52,27,GAGGTAGAAACTATGTTGGA,25,1905127
icdC_predicted,0.8928571428571429,51,27,GAGGGACTGGTTATTAGCGA,24,1907252
icdC_predicted,0.07142857142857142,28,27,CTCTTAAGACAATACTAATG,1,1882510
icdC_predicted,2.107142857142857,85,27,CTCGACATGGCCCATCCGTT,58,1885644
icdC_predicted,0.5357142857142857,41,27,CGGGCTACGATAATAGTGGC,14,1885931
icdC_predicted,4.428571428571429,150,27,CGACGAGCCGTTAGATACTA,123,1903966
icdC_predicted,0.5357142857142857,41,27,CCCTCCTCCAAGATGGTAAA,14,1907936
icdC_predicted,0.7142857142857143,46,27,CACAAATCAATTGAATCGGT,19,1878440
icdC_predicted,0.39285714285714285,37,27,ATGTAAATGTAAGTCCCGTA,10,1895112
icdC_predicted,0.8928571428571429,51,27,ATCTTGTCGGTAAGTATATG,24,1883905
icdC_predicted,2.0,82,27,ATAGGATTTTTCGGTCAACA,55,1899124
icdC_predicted,0.07142857142857142,28,27,AGTTGGAACCAGCAGTGTGT,1,1895409
icdC_predicted,1.1428571428571428,58,27,ACGTATTCAACGAGCAAGCC,31,1894880
icdC_predicted,0.4642857142857143,39,27,ACAAAGTCTGTTTCTTTGCA,12,1897153
icdC_predicted,0.8214285714285714,49,27,AATCAGTACGAAGAGCTCGG,22,1899756
icdC_predicted,0.42857142857142855,38,27,AATAGGTGGATTGGGTCGAT,11,1902052
icdC_predicted,0.9642857142857143,53,27,AAGTTGGCCACCAGTATAGC,26,1904770
icdC_predicted,1.962962962962963,78,26,TTCTCATCGAGGCACCGCGA,52,1891126
icdC_predicted,1.6296296296296295,69,26,TTCGACCAGGGGACAAGAAG,43,1884988
icdC_predicted,1.2962962962962963,60,26,TTAGGGAATATTAGACTTTG,34,1889569
icdC_predicted,0.07407407407407407,27,26,TGTTTTACGACAATGCGCTA,1,1893412
icdC_predicted,0.5555555555555556,40,26,TGTTACCTGGACTAAGCTCA,14,1902822
icdC_predicted,0.7407407407407407,45,26,TGCGAATCGCTCTCAACCAC,19,1906372
icdC_predicted,1.7407407407407407,72,26,TCCGAGACATTTCGTAGCGC,46,1884949
icdC_predicted,1.4444444444444444,64,26,GTTTAAAAAAGTCGTCGTTA,38,1893086
icdC_predicted,0.8888888888888888,49,26,GGTACTGGAGGAATGTAAGT,23,1900383
icdC_predicted,1.5555555555555556,67,26,GGCGGGAGTAGCTCAAATAG,41,1884253
icdC_predicted,0.6666666666666666,43,26,GGAATTAAACGTCACACTTT,17,1878781
icdC_predicted,0.07407407407407407,27,26,GCTACGTAGGCGTGAGATTC,1,1886551
icdC_predicted,3.5555555555555554,121,26,GCGTTCTAGTCGGGCGTTTT,95,1889509
icdC_predicted,0.7777777777777778,46,26,GATCACGTGGCGTACCATAA,20,1879343
icdC_predicted,0.4444444444444444,37,26,GAGAAATCACCTATGAACTG,11,1885693
icdC_predicted,0.07407407407407407,27,26,GACTTGTTTATTAGTGATAA,1,1906571
icdC_predicted,0.6296296296296297,42,26,GAAGATGTTTGGCTTAAAAG,16,1893520
icdC_predicted,2.074074074074074,81,26,CGGCCCGTAAGATATATCTT,55,1897937
icdC_predicted,2.111111111111111,82,26,CGCGTAACCTTCACATTTGT,56,1882079
icdC_predicted,0.1111111111111111,28,26,CGAGTGCGTTTACAGCCTCA,2,1887491
icdC_predicted,2.6666666666666665,97,26,CATACATACCTTTGCAACTC,71,1907007
icdC_predicted,0.4074074074074074,36,26,CATAAAAACGGAGCACTCAG,10,1901417
icdC_predicted,8.518518518518519,255,26,CAACCACACGGACGGGTAAG,229,1888671
icdC_predicted,0.07407407407407407,27,26,ATTATCTTGTCAAAGCAACT,1,1889752
icdC_predicted,2.037037037037037,80,26,ATATACCGTAAGCGGCTCGC,54,1882124
icdC_predicted,0.4074074074074074,36,26,ACAAGTTCTGAGTGTCAAGA,10,1878115
icdC_predicted,1.4814814814814814,65,26,AACGTCTGAACAATGCTTAG,39,1886676
icdC_predicted,2.037037037037037,80,26,AAACCCGCGTCCCCGGTAGG,54,1901801
icdC_predicted,2.423076923076923,87,25,TTTACGTCAGGGCGGAACAT,62,1884409
icdC_predicted,2.269230769230769,83,25,TTGGCATTAGGCTACGCAGA,58,1886192
icdC_predicted,0.9615384615384616,49,25,TTATTGTGTCCAACTGGCAG,24,1887518
icdC_predicted,0.5769230769230769,39,25,TTATACCTTCCAAGGCGACA,14,1903579
icdC_predicted,0.5384615384615384,38,25,TGTGTGTTCTGGAGCAGCGT,13,1903965
icdC_predicted,0.4230769230769231,35,25,TGTACGCGTGTGATGGAAAA,10,1907274
icdC_predicted,0.2692307692307692,31,25,TGGGGGCACACAGCGTACAC,6,1907142
icdC_predicted,0.19230769230769232,29,25,TGGGAACCTTCGGGCGTGTG,4,1892908
icdC_predicted,1.3076923076923077,58,25,TCTCACTCATGACCTAGTCA,33,1884452
icdC_predicted,1.2692307692307692,57,25,TCGGAGTAGAGAAGTTCGAA,32,1880727
icdC_predicted,1.5769230769230769,65,25,TCGCATGTCACCGAAAGTAA,40,1884330
icdC_predicted,0.23076923076923078,30,25,TATTAGCTTTCGGCCAGCGG,5,1882889
icdC_predicted,0.07692307692307693,26,25,TATACGGGGCGGAAATTGAA,1,1882915
icdC_predicted,1.5384615384615385,64,25,TAGAAATGCGCGCCGGACTA,39,1897322
icdC_predicted,1.7692307692307692,70,25,GTGTCTGAACTGATTTGTAA,45,1886231
icdC_predicted,1.5,63,25,GGCTTCTCTTTAAAATCTGG,38,1894149
icdC_predicted,0.3076923076923077,32,25,GCTGGGCATGTGTAGGAGTA,7,1890516
icdC_predicted,0.11538461538461539,27,25,GATCGCAACCCGTGGACGCT,2,1894664
icdC_predicted,2.076923076923077,78,25,GAGTTCATGCTTATGGCCCT,53,1886424
icdC_predicted,0.38461538461538464,34,25,GAGTGTTCCTGTTATAGATA,9,1881570
icdC_predicted,2.8076923076923075,97,25,CTTTAGTGTTCGGCCGGCTT,72,1883426
icdC_predicted,1.3461538461538463,59,25,CTCGGGACATTGAGGGCAGA,34,1877968
icdC_predicted,0.5,37,25,CTATGGACCGCATGGATGAG,12,1883701
icdC_predicted,1.8846153846153846,73,25,CCTTCGCGGTGCAACCTCAT,48,1895761
icdC_predicted,0.8461538461538461,46,25,CCTCTAGTAACAGGAGCGAG,21,1879248
icdC_predicted,0.6923076923076923,42,25,CCGCCAGGCCATGAGAATTC,17,1888784
icdC_predicted,1.0384615384615385,51,25,CCAATATCGTGAGTGCTACT,26,1886918
icdC_predicted,0.34615384615384615,33,25,CATCGCATGTCACAGCCAAC,8,1904644
icdC_predicted,2.3846153846153846,86,25,CACTGGAACATTACCGGAGG,61,1899677
icdC_predicted,1.4615384615384615,62,25,ATCTCCTATCCAGCCGGAAA,37,1888289
icdC_predicted,0.8076923076923077,45,25,AGTTTGGATTAGCTGTCATG,20,1901528
icdC_predicted,0.38461538461538464,34,25,AGGGACTCCGCTAAATGTGG,9,1885526
icdC_predicted,2.0384615384615383,77,25,AGCGGCCCCGCCGTCCAGTG,52,1888190
icdC_predicted,2.230769230769231,82,25,AGCCGGGTTCGTGACGCCCG,57,1882454
icdC_predicted,0.7692307692307693,44,25,ACGTACCATCCGGGCTTCGT,19,1897408
icdC_predicted,2.269230769230769,83,25,ACCGCCGTTTAAACGCGTGC,58,1879835
icdC_predicted,2.576923076923077,91,25,ACCCCTGCAAATCACGGGGA,66,1907006
icdC_predicted,1.0384615384615385,51,25,ACATGAAAATGGCCCACAGT,26,1902765
icdC_predicted,1.6923076923076923,68,25,AAGACTCGTGCTGTAAGCTC,43,1884032
icdC_predicted,2.24,79,24,TTTTGCCGCTCCCTATAAAA,55,1894312
icdC_predicted,2.08,75,24,TTCTCTCACATCTCTTCGAG,51,1893072
icdC_predicted,1.64,64,24,TGCCGCATGCTAGAGACGCT,40,1890565
icdC_predicted,0.56,37,24,TCCTGCATACGGATGGGCGT,13,1896135
icdC_predicted,0.12,26,24,GTTTCAACACCACAGTTTGC,2,1884765
icdC_predicted,0.76,42,24,GTCATCTTTGTCCGTCCGAA,18,1883425
icdC_predicted,0.08,25,24,GGGTAGAACTGATCGGATGA,1,1888533
icdC_predicted,0.76,42,24,GGGCAAGTTTTATACGCTAA,18,1898439
icdC_predicted,1.6,63,24,GGGAAATGTGCCAACTGGCA,39,1903351
icdC_predicted,0.76,42,24,GGCCCCCCCACCGCACTAGA,18,1892075
icdC_predicted,0.44,34,24,GCCGTAACCAATACATTGGT,10,1881261
icdC_predicted,0.76,42,24,GACAGGTCACAGATGACATA,18,1898652
icdC_predicted,1.44,59,24,CTCCGTTGCGGCATGGGTGG,35,1880960
icdC_predicted,0.76,42,24,CTAGAGTGAGTGTTAAGCGA,18,1879300
icdC_predicted,2.2,78,24,CGAGATTTTCGAGCGTCGAA,54,1890542
icdC_predicted,0.88,45,24,CCTGGTAACCCGATTGCGAT,21,1892278
icdC_predicted,0.2,28,24,CCGAATTGGGGCATCATTCG,4,1885078
icdC_predicted,0.12,26,24,CCCCAGCCCCTAGCGTCCGT,2,1893536
icdC_predicted,17.56,462,24,CATGTAAATCTCAGCGCGTT,438,1896242
icdC_predicted,1.68,65,24,CACACGTCTTTGCATGGTGG,41,1896889
icdC_predicted,1.36,57,24,CAAGAAAAAGGTAGTCACGA,33,1900763
icdC_predicted,0.88,45,24,AGTTGTAGACGTTTGTCGGG,21,1881650
icdC_predicted,1.28,55,24,AGTTACTATTACGCAGGTTT,31,1904665
icdC_predicted,1.6,63,24,AGGATGCCGTGGGTCATTCG,39,1902037
icdC_predicted,1.0,48,24,AGCAAGAGTCGCAGCAGGTT,24,1896746
icdC_predicted,1.52,61,24,ACTGCCAGTAAGACCTTTAT,37,1901864
icdC_predicted,1.88,70,24,ACTCTATGGATTTGTAACAG,46,1895544
icdC_predicted,2.52,86,24,ACCTACTCTGGCACAGGTAG,62,1894085
icdC_predicted,1.44,59,24,ACCAATGGGTCATTAGGGCA,35,1894636
icdC_predicted,0.12,26,24,AAAGTGGAAGCGTACATCCT,2,1889996
icdC_predicted,1.7916666666666667,65,23,TTTTGCCTTGTATGGACTCG,42,1887708
icdC_predicted,1.4166666666666667,56,23,TTTAGGTGTGAGTTAATCTA,33,1886289
icdC_predicted,0.125,25,23,TTGTCTTTGCCTCCAGAGAT,2,1878451
icdC_predicted,0.2916666666666667,29,23,TTCTCCCTTCTCATTCAGGC,6,1899191
icdC_predicted,2.125,73,23,TTATCAGTTGTAGAGACTCT,50,1908816
icdC_predicted,0.2916666666666667,29,23,TGCATTTGATGATTAAATGC,6,1889098
icdC_predicted,0.9166666666666666,44,23,TGATCTATATTCGTATGGTT,21,1888210
icdC_predicted,1.0,46,23,TATTGTTGCTTGGAAGCGTT,23,1894121
icdC_predicted,1.0833333333333333,48,23,TAGAAGCTATCTACTGCGTC,25,1879227
icdC_predicted,1.8333333333333333,66,23,TAAGTGATCTGCCGTACATA,43,1883689
icdC_predicted,0.125,25,23,TAAGGCCCGCCATGCGCGAA,2,1885949
icdC_predicted,1.1666666666666667,50,23,TAACAACGGTCGATCGCACT,27,1878290
icdC_predicted,0.4166666666666667,32,23,GTTGGTGCGCCGGGCCAGCT,9,1884451
icdC_predicted,1.2083333333333333,51,23,GTAGCCTCCGGTTGATTGGT,28,1905342
icdC_predicted,1.7083333333333333,63,23,GTAATTTCTAGGCAGTGTAT,40,1892579
icdC_predicted,0.6666666666666666,38,23,GTAATGGAGAGCTATATGCA,15,1878508
icdC_predicted,1.125,49,23,GGTATAAATGGTCTAGTCCC,26,1896493
icdC_predicted,0.6666666666666666,38,23,GCTGCCTGTGAACCTTAGTG,15,1892659
icdC_predicted,2.125,73,23,GCTCGTCATCAGTTGCTTTA,50,1891498
icdC_predicted,0.5416666666666666,35,23,GCCTGCCGTTTCAACTTGTA,12,1886619
icdC_predicted,2.125,73,23,CTTTCAGTATCGAGACTTGT,50,1883393
icdC_predicted,0.125,25,23,CTTTAGGAGGGTGTTCGCGT,2,1882626
icdC_predicted,2.2083333333333335,75,23,CTTGTCTTACGATACGCTAC,52,1892298
icdC_predicted,0.5833333333333334,36,23,CTTGCTATGGATAGAGTAAC,13,1886219
icdC_predicted,0.875,43,23,CTCCAGGGAAATCAGGCGAA,20,1888319
icdC_predicted,1.375,55,23,CGTTGATGCTACCTTGTGAT,32,1886377
icdC_predicted,0.08333333333333333,24,23,CGTGCGTAGAGGAGCGCAAC,1,1878151
icdC_predicted,1.1666666666666667,50,23,CGGTGGCGTGACCTCGGGCC,27,1904746
icdC_predicted,0.9583333333333334,45,23,CGATGAGTAGCGCTTAGCGA,22,1907108
icdC_predicted,0.5833333333333334,36,23,CCTCCAAACTGCGACTCACT,13,1904974
icdC_predicted,2.125,73,23,CCCCGGAAGGATAGTTCCAA,50,1901913
icdC_predicted,0.75,40,23,CAGCATAAGGCAAATGTCTG,17,1905736
icdC_predicted,0.125,25,23,ATTGCGTGCATCCTGGCAAC,2,1881989
icdC_predicted,1.8333333333333333,66,23,ATCAGGCAGGTTTGAAGCCC,43,1877928
icdC_predicted,0.08333333333333333,24,23,ATAGCGGCCTGGTTTCCGAA,1,1895110
icdC_predicted,0.125,25,23,AGTCGGTTCCATTTCCCTTG,2,1897853
icdC_predicted,1.9166666666666667,68,23,AGGTTAAACGCTGGCTGTCT,45,1880829
icdC_predicted,1.3333333333333333,54,23,AGGTAAAACGGTACTAATTC,31,1889031
icdC_predicted,0.2916666666666667,29,23,AGGCAGTGTCTGAGTGGATT,6,1891443
icdC_predicted,0.4166666666666667,32,23,AGCACGTAAGGGGGCCTTTG,9,1883986
icdC_predicted,0.625,37,23,AGAGAGTAAGGGGAAAGGGA,14,1901320
icdC_predicted,0.3333333333333333,30,23,AGAGACGTATTCAACGGATT,7,1889871
icdC_predicted,1.875,67,23,AGAATATGGATGGACACCGA,44,1891819
icdC_predicted,1.5,58,23,ACACGAATACATGTCCTTAC,35,1892480
icdC_predicted,1.875,67,23,AACTCGGCTTGCTCCATAAG,44,1891831
icdC_predicted,0.08333333333333333,24,23,AACTCCCACACACCGATGAT,1,1888530
icdC_predicted,0.34782608695652173,29,22,TTTTTCGTTTCCTCCGACGC,7,1907752
icdC_predicted,1.5217391304347827,56,22,TTGTGGGGATTAGGGAAAAG,34,1895592
icdC_predicted,1.3478260869565217,52,22,TTGAAATCGAACCCGATATT,30,1879623
icdC_predicted,0.391304347826087,30,22,TTCTATCACGCTCTTGGGTA,8,1887074
icdC_predicted,2.1739130434782608,71,22,TGTTTGAACATCTCCTGACA,49,1884151
icdC_predicted,0.08695652173913043,23,22,TGGAGCCTAAATCCACAGAA,1,1882618
icdC_predicted,0.30434782608695654,28,22,TGCTTTATGGGTGACTGCCT,6,1881433
icdC_predicted,1.7391304347826086,61,22,TAGAGAGTTAGACAGTGTTA,39,1902058
icdC_predicted,0.9565217391304348,43,22,GTTTACAATCGAAAAGGGCT,21,1880182
icdC_predicted,0.6086956521739131,35,22,GTTCGCAGTGGTGGCTCTTG,13,1904172
icdC_predicted,1.0434782608695652,45,22,GTGCACCGACCGAGGGTGCG,23,1896836
icdC_predicted,4.739130434782608,130,22,GTATTGAGCCCACGCGTTAT,108,1899073
icdC_predicted,0.13043478260869565,24,22,GTAGTTCTCGTGTGACTTCC,2,1907381
icdC_predicted,2.260869565217391,73,22,GTAACCTGATTGAGATCTTA,51,1882955
icdC_predicted,3.0434782608695654,91,22,GGTCAGGCGTTCTCTATGTC,69,1895252
icdC_predicted,1.0869565217391304,46,22,GCCCCATGCAGGTATTGGCA,24,1905421
icdC_predicted,1.0869565217391304,46,22,GATCTCCCTCAATTTGACGA,24,1892362
icdC_predicted,0.6521739130434783,36,22,GAGTTTCCGGCGGTAGGTGG,14,1884940
icdC_predicted,0.8695652173913043,41,22,GAAGTTAGGTACTTTCGTAA,19,1888271
icdC_predicted,0.08695652173913043,23,22,GAACGTCCATGTCTTCGTGG,1,1888988
icdC_predicted,1.2173913043478262,49,22,CTTCAGTAAGAACAAAACTC,27,1903915
icdC_predicted,0.21739130434782608,26,22,CTGCTTCCTTATGATGCTGC,4,1895062
icdC_predicted,0.391304347826087,30,22,CTGAAGACCTTGGCGGGTTC,8,1897681
icdC_predicted,0.2608695652173913,27,22,CGGTCGGAGGAACATCCAGA,5,1890215
icdC_predicted,0.782608695652174,39,22,CGGGATGACGTTTCTCGTAC,17,1883614
icdC_predicted,0.8260869565217391,40,22,CGGAATGCGATGATCTCAAC,18,1881436
icdC_predicted,2.782608695652174,85,22,CGATAGCCTAGTGCTTATAC,63,1883584
icdC_predicted,0.5652173913043478,34,22,CAGTCCTGATTTAGACTGAG,12,1894058
icdC_predicted,0.6521739130434783,36,22,CAGGGGTTGATAGCTTATAA,14,1898203
icdC_predicted,0.7391304347826086,38,22,CAGGCCCTCAGTCCTGAATA,16,1897349
icdC_predicted,0.6086956521739131,35,22,CACACTGGGAGGCGTATTCG,13,1886086
icdC_predicted,2.608695652173913,81,22,ATTGTGTACGTATCGCGCGA,59,1900824
icdC_predicted,0.391304347826087,30,22,ATAACGCTGCGATCATGTGT,8,1883515
icdC_predicted,0.34782608695652173,29,22,AGTAAACGTTAATAGTGAGA,7,1878452
icdC_predicted,0.8695652173913043,41,22,AGATGCCACATTTGCCGGGT,19,1887595
icdC_predicted,0.8695652173913043,41,22,ACTCGTCTGGTTAGTTAGAA,19,1880699
icdC_predicted,1.0869565217391304,46,22,AAGGATTAAATTCTTGGCTT,24,1901815
icdC_predicted,1.6363636363636365,56,21,TTCGACGCAGTAACGGGTAT,35,1884750
icdC_predicted,0.22727272727272727,25,21,TGTAGCTATGCGTATTGGAC,4,1891223
icdC_predicted,0.2727272727272727,26,21,TGGTCTGTGATCGGTGCGTA,5,1892087
icdC_predicted,0.8636363636363636,39,21,TGGGAATCCAAATAGTCAAA,18,1894418
icdC_predicted,0.7272727272727273,36,21,TGGCTCGCATTGCTTTACCA,15,1882292
icdC_predicted,3.3636363636363638,94,21,TGCTAAGTAGGTGGGGTGAA,73,1883628
icdC_predicted,0.9545454545454546,41,21,TGCAATAGATTGCGTAAGCG,20,1894638
icdC_predicted,0.8181818181818182,38,21,TGACGGATCTGTCATGTCGC,17,1905989
icdC_predicted,0.8636363636363636,39,21,TCTTGGCCAAAAATACAGCT,18,1882102
icdC_predicted,1.1818181818181819,46,21,TCTAGTCGTACTCCACGATG,25,1879014
icdC_predicted,4.7727272727272725,125,21,TCCCTGACATAAGGGTATAT,104,1885005
icdC_predicted,1.0909090909090908,44,21,TAATATCAGAAATGCTTGTT,23,1880124
icdC_predicted,1.1363636363636365,45,21,GTTCCCTAGGAAACACAACA,24,1890404
icdC_predicted,2.227272727272727,69,21,GTGTTCCTTCTCGGATCCTC,48,1908684
icdC_predicted,4.2272727272727275,113,21,GTGGCCGCGCACTATGCACA,92,1888041
icdC_predicted,1.4090909090909092,51,21,GTATTTAGCGTAAGTTGATA,30,1896558
icdC_predicted,0.2727272727272727,26,21,GTATATCGTGCACGAGCAGA,5,1905988
icdC_predicted,0.6363636363636364,34,21,GGGCGTACTATGAAAAGGGT,13,1881270
icdC_predicted,1.0454545454545454,43,21,GGCTTGTCAGTTCGGTTCCT,22,1890487
icdC_predicted,2.1818181818181817,68,21,GGATGCTTATGCCAAAGTGT,47,1888940
icdC_predicted,1.8636363636363635,61,21,GGACGCTGGGTTATCGGCAT,40,1900975
icdC_predicted,0.6363636363636364,34,21,GCTGCTAGCGCTCAGGCGGG,13,1898855
icdC_predicted,0.8181818181818182,38,21,GCTAGATCATTGGTCAATTA,17,1882931
icdC_predicted,0.9545454545454546,41,21,GCCGGGTATCGAGAGATTCG,20,1887545
icdC_predicted,1.2727272727272727,48,21,GCATTTTTATACAGAGAGTG,27,1883474
icdC_predicted,1.2272727272727273,47,21,GATTTGGCACGAACGCAGCG,26,1906686
icdC_predicted,1.4545454545454546,52,21,GACCGTAGGCATGGAGATGC,31,1890033
icdC_predicted,1.4090909090909092,51,21,CTTGTCCCCAGCCAGTGTCT,30,1890531
icdC_predicted,0.6818181818181818,35,21,CTTGGAAAGGATCGCGGAGT,14,1902036
icdC_predicted,1.1363636363636365,45,21,CTCTCAATATGACTGGGCTA,24,1900335
icdC_predicted,0.09090909090909091,22,21,CTAAAGTTTCTAACCTGTGC,1,1885214
icdC_predicted,3.1818181818181817,90,21,CGGAACGGAAGTGAAGGCAG,69,1879182
icdC_predicted,0.4090909090909091,29,21,CGCATACATGCCCCGTGACT,8,1904105
icdC_predicted,1.2272727272727273,47,21,CGATTTGCATCGATTATCCT,26,1885277
icdC_predicted,0.22727272727272727,25,21,CGATAAGGTGTGATCCGCCC,4,1880643
icdC_predicted,1.8181818181818181,60,21,CCTGGCTGCCCTGCGCAGGT,39,1882594
icdC_predicted,0.4090909090909091,29,21,CCTCAGGCAATGGACCCTTT,8,1906667
icdC_predicted,0.6818181818181818,35,21,CCGCTAATGATTATGGGGGC,14,1903892
icdC_predicted,1.9090909090909092,62,21,CATTGGCAAACCATAAATCA,41,1891384
icdC_predicted,1.7272727272727273,58,21,CATCAACACGAACCTTGAGC,37,1895194
icdC_predicted,3.227272727272727,91,21,CATAAGTTTGTTTTAGGTCC,70,1883658
icdC_predicted,1.1818181818181819,46,21,CAGTATGTAGTTTTGTCATC,25,1881638
icdC_predicted,1.2272727272727273,47,21,CAGGCAAATCGTGGAGGGTT,26,1898639
icdC_predicted,0.5454545454545454,32,21,CACAGGTGGGGAAAAGTCTT,11,1878375
icdC_predicted,1.4090909090909092,51,21,CAAATTGGGACTGCACTCCA,30,1880120
icdC_predicted,0.7272727272727273,36,21,ATTCGGTTAACCGTGCGCGC,15,1878506
icdC_predicted,0.6818181818181818,35,21,AGTACATCTGAATGTAGGTC,14,1884193
icdC_predicted,0.09090909090909091,22,21,AGGATGCCACACCACCCCAT,1,1904162
icdC_predicted,1.3636363636363635,50,21,ACTATGGGATAAGTTCGCCC,29,1896524
icdC_predicted,3.0,86,21,AAGGTACCAGTAGGCCTGAG,65,1907121
icdC_predicted,1.8181818181818181,60,21,AAGGCTTCCGTTGAGTCGCA,39,1882733
icdC_predicted,4.285714285714286,109,20,TTGATGTTCATGCACGGTGA,89,1887280
icdC_predicted,1.6666666666666667,54,20,TTCGCCGGACTGGTATCTTC,34,1899419
icdC_predicted,0.5714285714285714,31,20,TGTACTATAGAGAGGATTTC,11,1891107
icdC_predicted,1.4761904761904763,50,20,TGGAACAAGTGATCCTTTCG,30,1879572
icdC_predicted,2.380952380952381,69,20,TGAGCACATTACCACCCAGG,49,1878985
icdC_predicted,0.47619047619047616,29,20,TCGCTGAATTGAAAGCGTAT,9,1883565
icdC_predicted,1.1428571428571428,43,20,TCCGCCATCACGCCAGGGGT,23,1904380
icdC_predicted,0.7619047619047619,35,20,TACCGGAGTTAATGCAGTAT,15,1896527
icdC_predicted,1.1428571428571428,43,20,TAATGATTTGTGGCTGGAAT,23,1891861
icdC_predicted,1.1904761904761905,44,20,TAAGCGACTAACTTGGCTTG,24,1884116
icdC_predicted,0.5714285714285714,31,20,TAAGAAACCACACGCCCTAC,11,1897648
icdC_predicted,0.7619047619047619,35,20,GTTTACGATGTCGTCATGGT,15,1903720
icdC_predicted,0.8095238095238095,36,20,GTAATGAGAACGAGAGCCCT,16,1884964
icdC_predicted,0.09523809523809523,21,20,GGGATGAACCCCAGACGCGG,1,1900286
icdC_predicted,0.14285714285714285,22,20,GGGAGCGTTCTCTACCCCAC,2,1895134
icdC_predicted,1.380952380952381,48,20,GGACCCACCTCAAGCTGAGA,28,1888237
icdC_predicted,0.14285714285714285,22,20,GCGCGGTCTTTACGAATGGT,2,1890036
icdC_predicted,1.2380952380952381,45,20,GATGGACTTGAGCATTCGGA,25,1879042
icdC_predicted,2.619047619047619,74,20,GAGTGTCTCACGCTGCAGTT,54,1894566
icdC_predicted,17.857142857142858,394,20,CTTGGCACAGGGCAATATCT,374,1885989
icdC_predicted,0.47619047619047616,29,20,CTCACTTCGTCTTTATCCAT,9,1888290
icdC_predicted,0.14285714285714285,22,20,CTCACGTGAAAGATTTGGGT,2,1884552
icdC_predicted,4.904761904761905,122,20,CTCAACCCCTCATGAGCATT,102,1879724
icdC_predicted,1.2857142857142858,46,20,CGTTCGTTTTGCATGCACTT,26,1909449
icdC_predicted,0.6190476190476191,32,20,CGTCCGACGGGATAGAGGGG,12,1879468
icdC_predicted,1.8095238095238095,57,20,CGCTTGGCCGTCGCCGAATC,37,1895763
icdC_predicted,0.8571428571428571,37,20,CGCTCTGTATGCGTTAACCG,17,1890147
icdC_predicted,0.09523809523809523,21,20,CGAGCAAGGTCGTAAACAGA,1,1886753
icdC_predicted,2.9523809523809526,81,20,CGAAACACATGTCTGCGGCC,61,1881060
icdC_predicted,3.619047619047619,95,20,CCTTCACTAGCTGGGATTAG,75,1896923
icdC_predicted,1.4285714285714286,49,20,CCGGATTGCAACGCAGCCGG,29,1879700
icdC_predicted,0.8095238095238095,36,20,CAGCTCGGTTTGCTAAATAG,16,1899749
icdC_predicted,0.5238095238095238,30,20,CAGCATGTGCCGGAGCTACC,10,1902047
icdC_predicted,0.47619047619047616,29,20,CACTCCTTGAAAGGGTGTGT,9,1906988
icdC_predicted,0.14285714285714285,22,20,CACTACACGTGCGTGGGCTA,2,1880496
icdC_predicted,1.2380952380952381,45,20,ATTGGTACCCTACTTTTGTA,25,1908253
icdC_predicted,1.0476190476190477,41,20,ATTATTCAATATCGTGGGTA,21,1890071
icdC_predicted,0.09523809523809523,21,20,ATTATCCGCGTAAGAAGCAG,1,1899163
icdC_predicted,0.23809523809523808,24,20,ATATAGGAGGTTTTATGCGA,4,1878400
icdC_predicted,1.1904761904761905,44,20,ATAACGTCTCTACATTGCTA,24,1897768
icdC_predicted,8.095238095238095,189,20,AGTTGGCCATTAGGTGAACA,169,1884278
icdC_predicted,0.09523809523809523,21,20,AGTCCAGAGGAGCTTCATCG,1,1893167
icdC_predicted,3.380952380952381,90,20,AGGTCTATCCCTGTGTTTGA,70,1887108
icdC_predicted,2.4285714285714284,70,20,AGGGGGTTTTCACAAGCGGA,50,1884314
icdC_predicted,2.238095238095238,66,20,AGCGATTGATGTACGAAAAT,46,1901095
icdC_predicted,4.619047619047619,116,20,ACTTCCGGATCTAGATAGAG,96,1882123
icdC_predicted,11.619047619047619,263,20,ACGCTGTGAGAGCACCGGCT,243,1888669
icdC_predicted,1.0476190476190477,41,20,ACATAATAGGATAATACAAC,21,1879373
icdC_predicted,0.14285714285714285,22,20,ACACGCGTGCCATCAAGAGT,2,1896308
icdC_predicted,0.09523809523809523,21,20,AAGTCTTTGATTCCGTGTGT,1,1888830
icdC_predicted,0.9523809523809523,39,20,AAGTAGCTGAAAAGGTCAAG,19,1901091
icdC_predicted,0.09523809523809523,21,20,AAGGGTACGCACCCTATTCT,1,1887186
icdC_predicted,1.1428571428571428,43,20,AACTAGCAATTACATTTTAA,23,1905347
icdC_predicted,0.8,34,19,TTGGAGTAGGTTCGACATGT,15,1902887
icdC_predicted,3.25,83,19,TTACCATGAAAATCCAAGTG,64,1899126
icdC_predicted,0.75,33,19,TGGCATATGGACCAAGCGTA,14,1896961
icdC_predicted,0.1,20,19,TGCTGGTTCCCAGTCTGCGC,1,1886465
icdC_predicted,0.15,21,19,TGCACCATCGTTCCGGAGGC,2,1877990
icdC_predicted,0.1,20,19,TGATTGCAGGGTAGATGCCG,1,1898115
icdC_predicted,0.6,30,19,TGAGCGTTGCGTTATAGTTA,11,1894604
icdC_predicted,0.9,36,19,TGAATAGGCCACGGATACGG,17,1884349
icdC_predicted,0.95,37,19,TCCTAAAAGCAATTCCTTTT,18,1895432
icdC_predicted,0.15,21,19,TCCAGTTTTCAGCGAGCAGT,2,1895500
icdC_predicted,0.15,21,19,TCCAAGTTGGGTTCTACGCG,2,1899889
icdC_predicted,4.15,101,19,TCACCTGAAGATCGATGGGA,82,1898885
icdC_predicted,0.15,21,19,TCAAGGTGTCTGCCTGTATT,2,1906590
icdC_predicted,0.8,34,19,TATAAGATGCAAGCAACGAT,15,1890310
icdC_predicted,2.3,64,19,TACACCTTAAATCAATCAGT,45,1892513
icdC_predicted,1.9,56,19,GTTCCTGTCGGACTCAGGAT,37,1901299
icdC_predicted,0.35,25,19,GTGCCGACGAAAGTCGGCCA,6,1881888
icdC_predicted,2.95,77,19,GTCGTGACGGATATGGGAAC,58,1892367
icdC_predicted,4.25,103,19,GCGAGAGTGGTAACATCGAG,84,1885445
icdC_predicted,0.95,37,19,GCCGCGTTTAGACTCAGCGC,18,1893019
icdC_predicted,0.75,33,19,GCACATCGCGAATTGCCAGT,14,1885006
icdC_predicted,2.05,59,19,GCACAGTTCCTGCAAGACGA,40,1888673
icdC_predicted,1.2,42,19,GATGGCGGAGCCCCGACGAA,23,1898187
icdC_predicted,1.4,46,19,GATAAGTCAGCGCGGGATTT,27,1887704
icdC_predicted,0.1,20,19,GAGTTTACGGGCTATTAGTT,1,1892034
icdC_predicted,0.1,20,19,GACATAGCTTTGGGTAGCAT,1,1902006
icdC_predicted,0.3,24,19,CTTCGGTCTGTCTAGGTAGG,5,1889365
icdC_predicted,0.7,32,19,CTTCATGCCTCCGCTATTCT,13,1894917
icdC_predicted,0.15,21,19,CTTATTGACCGGACTTAGCT,2,1888238
icdC_predicted,0.3,24,19,CTGTCGCGTCATCCAGGGTG,5,1897289
icdC_predicted,0.1,20,19,CTGGGGCAGAGACTAGAGAG,1,1885194
icdC_predicted,2.05,59,19,CTGCTCACTTGCGTATATAG,40,1889872
icdC_predicted,2.1,60,19,CTGACTCCCGTATATCTATG,41,1903094
icdC_predicted,0.15,21,19,CTCCATAAGTTGGGGGACTT,2,1895812
icdC_predicted,0.85,35,19,CTAGCGTTGCACAGGTAGAT,16,1894979
icdC_predicted,1.85,55,19,CGTGGAGTGGTTTAACTTGT,36,1906015
icdC_predicted,0.35,25,19,CGTAGTAGTCGTACTCTTAA,6,1890258
icdC_predicted,1.35,45,19,CGTAACACGAATCAGTATGC,26,1886835
icdC_predicted,1.45,47,19,CGGTATCCGACATAATCATG,28,1887888
icdC_predicted,1.35,45,19,CGATGCTTAATACAGGAATA,26,1895684
icdC_predicted,1.5,48,19,CCCCTCCTTGGTTACATATC,29,1880208
icdC_predicted,2.35,65,19,CATGTAGAGTGACTCCAAGA,46,1898645
icdC_predicted,1.45,47,19,CAGGGCAGATAGCAAGGTAA,28,1891711
icdC_predicted,0.4,26,19,CAACGTACAAAACATGTACG,7,1899245
icdC_predicted,0.65,31,19,CAAAGGGGGTACATCGCTAG,12,1889432
icdC_predicted,1.7,52,19,ATCGACCTGACTCCTTTATG,33,1901285
icdC_predicted,1.45,47,19,ATCCGTTAAGGGATTCTCTG,28,1882456
icdC_predicted,0.1,20,19,AGTTAATAAAAACGGGCACA,1,1882289
icdC_predicted,0.1,20,19,AGAGTCGGGCTTATTCAGGG,1,1893736
icdC_predicted,1.6,50,19,AGACTGCAATTAACGCGCCA,31,1889361
icdC_predicted,0.8,34,19,ACTTGCCTGCACGGTACGCC,15,1892556
icdC_predicted,0.65,31,19,ACTATGCGTCTTCGGAAAGA,12,1906702
icdC_predicted,1.75,53,19,ACTAGCGCGCTCGGTGACTC,34,1902730
icdC_predicted,2.95,77,19,ACTAGACAGTTGACACTCCT,58,1895679
icdC_predicted,1.2,42,19,ACCTGGAGCCGCAGCGGACG,23,1892669
icdC_predicted,1.7,52,19,ACAACCCATCTACGGGGGTA,33,1885522
icdC_predicted,2.3,64,19,AAGCAGTAGGATCAAGTGTG,45,1909347
icdC_predicted,0.15,21,19,AAGCAAATTTTCATAGGGGC,2,1887412
icdC_predicted,1.45,47,19,AAGACCCGTGGATCAACAAT,28,1897572
icdC_predicted,1.7,52,19,AACGTTTACCGGGAGTGCGT,33,1881987
icdC_predicted,0.1,20,19,AAATACGCACTCCACGAGCG,1,1899484
icdC_predicted,2.526315789473684,65,18,TTTCTTACTTGTAATGATGT,47,1881343
icdC_predicted,1.2105263157894737,40,18,TTTCCAAGGGTGAAAATCTG,22,1906633
icdC_predicted,0.10526315789473684,19,18,TTTAGTGACGATTACCGCTC,1,1905859
icdC_predicted,0.10526315789473684,19,18,TTGGTAGTCTATAATACGAT,1,1889486
icdC_predicted,0.42105263157894735,25,18,TTCTGGCATGTGCTCGTGGT,7,1882398
icdC_predicted,2.6842105263157894,68,18,TGTCGGATGCGAATCTGGTC,50,1895410
icdC_predicted,0.10526315789473684,19,18,TGTCGGAGAAACTGCAAAAC,1,1885900
icdC_predicted,0.6842105263157895,30,18,TGGATTTGGAGTAGGTCCCT,12,1881191
icdC_predicted,0.47368421052631576,26,18,TCTGACTGTCCTCCTTGTCT,8,1884191
icdC_predicted,0.7368421052631579,31,18,TCGTCTAACTACCCGCTAAA,13,1903139
icdC_predicted,4.894736842105263,110,18,TCGAGGGAACGTGATAAAAG,92,1891158
icdC_predicted,0.8421052631578947,33,18,TCCGTGACGCTTGTATACGT,15,1903793
icdC_predicted,1.5789473684210527,47,18,TATGATCGGGACCCGCAAGT,29,1882519
icdC_predicted,1.631578947368421,48,18,TACTACTATGGACGATCAAC,30,1903577
icdC_predicted,2.210526315789474,59,18,TAATCCCTTACGGGTGTCAG,41,1880081
icdC_predicted,2.1052631578947367,57,18,GTTTTTCAGTTGAGTTACCC,39,1891527
icdC_predicted,1.263157894736842,41,18,GTTGTCGTCGTCTGTACCTG,23,1895589
icdC_predicted,0.3684210526315789,24,18,GTTCCTTAGGCGTTGTAGGT,6,1900108
icdC_predicted,0.42105263157894735,25,18,GTCACGTCATACTTGCGGCG,7,1884953
icdC_predicted,1.631578947368421,48,18,GTATGTCCGGCCGAAAAATC,30,1891695
icdC_predicted,0.6842105263157895,30,18,GGGGCTTCGAACACTTCTAC,12,1887912
icdC_predicted,0.7894736842105263,32,18,GGGACTTGATCAAGGGGTAT,14,1890744
icdC_predicted,1.5789473684210527,47,18,GGCCCTGCTACGATATGATT,29,1896959
icdC_predicted,1.105263157894737,38,18,GGCCCGCCATCTCGCCGAGA,20,1898451
icdC_predicted,3.1052631578947367,76,18,GGCACGCCGTTAAGATCAGT,58,1905084
icdC_predicted,1.1578947368421053,39,18,GCTGCTATTCTCGTAGGTGC,21,1894148
icdC_predicted,1.4736842105263157,45,18,GCCTGTCAACCACCTGTTCG,27,1885174
icdC_predicted,3.5789473684210527,85,18,GCATGGGCCGTTTTGGAATG,67,1896844
icdC_predicted,1.105263157894737,38,18,GATTCCAAATGATGCACAAC,20,1898544
icdC_predicted,0.15789473684210525,20,18,GATCAGAAGGTGTACTGCGT,2,1893119
icdC_predicted,1.8421052631578947,52,18,GACTCCACTACATTCGGCCT,34,1885716
icdC_predicted,1.0,36,18,GACTACACAGCCACGTGGGG,18,1879099
icdC_predicted,0.3684210526315789,24,18,GACACGCGGCAATTCACAAA,6,1879838
icdC_predicted,1.5263157894736843,46,18,GAACTCCACAAAAGGCACTA,28,1902955
icdC_predicted,1.8421052631578947,52,18,CTTCCCTTATGACTGGCTTA,34,1883833
icdC_predicted,0.3157894736842105,23,18,CTGATAGTATTCAACAGACA,5,1892364
icdC_predicted,0.10526315789473684,19,18,CTCATACTTCTCGGCCCATC,1,1899455
icdC_predicted,3.526315789473684,84,18,CTATAACAGCAAACTGTGTG,66,1889809
icdC_predicted,2.8421052631578947,71,18,CGGTCTATCTTGAAGAGAGG,53,1898883
icdC_predicted,0.9473684210526315,35,18,CGGAGCGGGTCCGAACACAA,17,1901042
icdC_predicted,1.105263157894737,38,18,CGGACTAGGATCAACACGCT,20,1880365
icdC_predicted,0.631578947368421,29,18,CGCCTACCGGCGGAACTACA,11,1883906
icdC_predicted,0.21052631578947367,21,18,CGACGGTTAACCCCCTCTGA,3,1885823
icdC_predicted,1.631578947368421,48,18,CCTTTTGTGCAAGTGCGGAC,30,1902132
icdC_predicted,1.6842105263157894,49,18,CCTTTCTATCGTCTGGCTGA,31,1886500
icdC_predicted,1.2105263157894737,40,18,CCTGACGAACTGGAAAAGTA,22,1878699
icdC_predicted,0.6842105263157895,30,18,CCTAATCAGATGAGTTAGAT,12,1908320
icdC_predicted,1.105263157894737,38,18,CCCGTCACTTATGGTCGTCT,20,1888217
icdC_predicted,1.736842105263158,50,18,CCACGGCAGTCACTGTTAGA,32,1890725
icdC_predicted,1.105263157894737,38,18,CATGGTGATGACGAAAGTCA,20,1887558
icdC_predicted,0.9473684210526315,35,18,CACTGTATAGGTGCACTAAT,17,1905010
icdC_predicted,1.2105263157894737,40,18,CAATCGGACAGGACGGGAAA,22,1901898
icdC_predicted,0.2631578947368421,22,18,CAAGGAAATCGGATAAAGAT,4,1889097
icdC_predicted,1.4736842105263157,45,18,ATTTGGGTAATTGCCAGAAG,27,1885889
icdC_predicted,1.0,36,18,ATGCGGCACCCAGAGATTCA,18,1878284
icdC_predicted,1.263157894736842,41,18,ATGAGTTCCCTACTCACGGA,23,1890740
icdC_predicted,1.6842105263157894,49,18,ATAAGCGTTCTCGACGATAT,31,1889226
icdC_predicted,0.8947368421052632,34,18,AGCCTGGTAACCTCACTTGT,16,1893130
icdC_predicted,1.631578947368421,48,18,AGCCGCGGGAGGGGTCTCCC,30,1878281
icdC_predicted,0.3684210526315789,24,18,AGCAGGGAAAGTTTAGGTCA,6,1889664
icdC_predicted,0.10526315789473684,19,18,AGCAAGTGCAAGAGGTGATC,1,1889487
icdC_predicted,0.10526315789473684,19,18,AGCAAGCTTAGAACGCACAG,1,1892500
icdC_predicted,1.1578947368421053,39,18,ACCGAGTCGATAAATCGTAT,21,1879160
icdC_predicted,3.8421052631578947,90,18,ACCCGCCGTTCTTTCGTTTT,72,1890907
icdC_predicted,0.9473684210526315,35,18,ACACCACCTTACCCGTATAC,17,1900218
icdC_predicted,0.8947368421052632,34,18,ACACAGGGGAGAATATAGTA,16,1879398
icdC_predicted,0.631578947368421,29,18,AATTACCCTGAGCTAGGCCA,11,1898776
icdC_predicted,0.631578947368421,29,18,AATAAGATCAAGACCTAGGT,11,1879994
icdC_predicted,1.2105263157894737,40,18,AAGGCATCACCTGGGATGTA,22,1884551
icdC_predicted,0.8421052631578947,33,18,AAGCGGGGTTTAATAAGGAC,15,1892584
icdC_predicted,0.10526315789473684,19,18,AAGACCTCGCTCTACAGACT,1,1880342
icdC_predicted,1.2105263157894737,40,18,AACTGTGGTCTCAAGATTGC,22,1902734
icdC_predicted,0.6842105263157895,30,18,AAAAACCCTTCTCCCTTAAG,12,1899650
icdC_predicted,2.2222222222222223,56,17,TTTTAGAGGCATGCTCACGT,39,1879183
icdC_predicted,0.7777777777777778,30,17,TTTGAACAGGAACGTGGGCA,13,1878588
icdC_predicted,1.2777777777777777,39,17,TTGATTAGGTCCCTTGGGGT,22,1899127
icdC_predicted,1.4444444444444444,42,17,TTAAGTTTAGGGCGTTAGTA,25,1884472
icdC_predicted,0.16666666666666666,19,17,TTAAGGCCCGGCGCACTCAA,2,1881287
icdC_predicted,1.9444444444444444,51,17,TTAACGTCGGGCGTAGGGTA,34,1894219
icdC_predicted,0.1111111111111111,18,17,TGTCCCGGTCACCTGTTTCT,1,1905346
icdC_predicted,0.5555555555555556,26,17,TGGGATTTGAAACTAAACAT,9,1882555
icdC_predicted,1.1666666666666667,37,17,TGCGGAGTAACAAGAGGTTA,20,1879211
icdC_predicted,0.4444444444444444,24,17,TGCCCGTGTCAAGGCTAAAG,7,1897719
icdC_predicted,0.8333333333333334,31,17,TGCAGTAGCATGCAGTTAAG,14,1888025
icdC_predicted,2.4444444444444446,60,17,TCTGTAGGACGGCATTTGAG,43,1889721
icdC_predicted,1.1666666666666667,37,17,TCTGGGCAGATATATGGAGC,20,1907418
icdC_predicted,1.7222222222222223,47,17,TCTAAATGTTTCTTGTTTAA,30,1878231
icdC_predicted,2.1666666666666665,55,17,TCGGTATGAAGGGAATACCC,38,1890741
icdC_predicted,1.8888888888888888,50,17,TATTGCAAGGTGATCCAAGA,33,1896119
icdC_predicted,1.3333333333333333,40,17,TATGGTGAAGCCATCCGGTC,23,1884584
icdC_predicted,0.5555555555555556,26,17,TATACAATTTCGACCGTGGG,9,1883775
icdC_predicted,0.8888888888888888,32,17,TAGCGAGGCAGGCGTTCGTC,15,1903794
icdC_predicted,0.6111111111111112,27,17,TAGCCGATCTGCTAATACTA,10,1886244
icdC_predicted,0.1111111111111111,18,17,TACACTGAAGTAGGTTATAA,1,1899462
icdC_predicted,0.1111111111111111,18,17,TAATCATTATGCAGTATTAG,1,1882550
icdC_predicted,0.5,25,17,GTGTCGTTATGGAGACATTG,8,1905359
icdC_predicted,0.7222222222222222,29,17,GTCGCAATGCCTCAGCGCGG,12,1880089
icdC_predicted,2.6666666666666665,64,17,GTATCATGAGATCCCCGACT,47,1883933
icdC_predicted,1.0555555555555556,35,17,GTACAAGTGCTGCTCAGGTT,18,1897774
icdC_predicted,0.7222222222222222,29,17,GGTGCGATGCGACCGTTGCG,12,1903795
icdC_predicted,0.8333333333333334,31,17,GGGGGTATGAGCCCTCGGGC,14,1894751
icdC_predicted,1.3333333333333333,40,17,GGGCCTCATCCAGCGCCGAT,23,1902800
icdC_predicted,2.0555555555555554,53,17,GGGAAGACCTGGAGGTGCCT,36,1892898
icdC_predicted,0.2222222222222222,20,17,GGCGAAAGGTTGAGAGACAT,3,1891434
icdC_predicted,0.9444444444444444,33,17,GGACCGGGTCCGGGATTAGA,16,1894708
icdC_predicted,3.388888888888889,77,17,GCGTGACTGGCCAGCCCGTT,60,1892727
icdC_predicted,0.1111111111111111,18,17,GCCTCTTCCGCGCCGTTGCG,1,1882962
icdC_predicted,1.1111111111111112,36,17,GCCATTCAGTACATGCGCTG,19,1903419
icdC_predicted,0.9444444444444444,33,17,GATCGAAAGGAAGTAATACA,16,1894003
icdC_predicted,0.8888888888888888,32,17,GAACCCATCAAAGTCATCCT,15,1891141
icdC_predicted,1.1666666666666667,37,17,CTCGCTTAGTGGTCGGCCTA,20,1880049
icdC_predicted,0.6666666666666666,28,17,CGGTGAAGGGATCGGTTCGT,11,1882948
icdC_predicted,0.6666666666666666,28,17,CGGGTTCCATTCTTCAAGAG,11,1888720
icdC_predicted,3.3333333333333335,76,17,CGCGCGCGTCGAGGATCGTC,59,1885967
icdC_predicted,1.1111111111111112,36,17,CCTTGATTGGAACTTAACGA,19,1882467
icdC_predicted,3.0555555555555554,71,17,CCGGTGCTAGGCGAGTATCA,54,1882261
icdC_predicted,1.0,34,17,CCCGCGGAGCGCGATTAGAA,17,1879247
icdC_predicted,0.4444444444444444,24,17,CCCCGTCGTAGATTACAAGA,7,1890184
icdC_predicted,0.7222222222222222,29,17,CAACCAAAGCTAGCAGTAAT,12,1877878
icdC_predicted,2.1666666666666665,55,17,ATCAACAATCGCCCCGGCAT,38,1887103
icdC_predicted,3.3333333333333335,76,17,ATAGCTGCTGTCTCTAGTCT,59,1893417
icdC_predicted,2.111111111111111,54,17,AGGTCTGAGGGGTAGGATCA,37,1880677
icdC_predicted,0.8333333333333334,31,17,AGGCTAAGAGGAATGTACAA,14,1883716
icdC_predicted,2.3333333333333335,58,17,AGGAGTACTCGGTGTCATGC,41,1889711
icdC_predicted,1.0555555555555556,35,17,AGCCCAGCGAAGACTGTGTA,18,1889651
icdC_predicted,0.5555555555555556,26,17,AGCAACTGTCGAGACATGTA,9,1898899
icdC_predicted,0.16666666666666666,19,17,ACGCCATGCGATGCCGTAGG,2,1891741
icdC_predicted,1.2777777777777777,39,17,ACCTGCAGCTCACATATAAT,22,1898184
icdC_predicted,2.111111111111111,54,17,ACCGTGTACAGCACGTCAGA,37,1904801
icdC_predicted,0.5,25,17,AATTCGGGAACGACCGATAT,8,1899853
icdC_predicted,0.8333333333333334,31,17,AATCGTTCAAGACCGCACGT,14,1893250
icdC_predicted,0.3888888888888889,23,17,AAGGCAACTGGCCCGCCAGT,6,1898838
icdC_predicted,1.7777777777777777,48,17,AAGCAAAACATACAAGGTAC,31,1894633
icdC_predicted,0.1111111111111111,18,17,AACCCACAGGAAGCTCTCAA,1,1877929
icdC_predicted,0.8823529411764706,30,16,TTTCCAGAGAAAAGCCTCGG,14,1891136
icdC_predicted,1.8235294117647058,46,16,TTTCAAAGGTGTGAGCAGCC,30,1890962
icdC_predicted,2.235294117647059,53,16,TTTAGCAGTACGTGGAGGAC,37,1884407
icdC_predicted,1.411764705882353,39,16,TTGTGTCGGAGCTTAGAGTG,23,1903900
icdC_predicted,0.23529411764705882,19,16,TTGGACCGATGGCCGCGGGA,3,1900702
icdC_predicted,0.9411764705882353,31,16,TTCCGAGGTATGGCGCTGGC,15,1891345
icdC_predicted,1.2352941176470589,36,16,TTAGGCACCTGACGCCGTGA,20,1899241
icdC_predicted,0.6470588235294118,26,16,TGGTTAGACCCGGTTAAGAT,10,1881857
icdC_predicted,2.588235294117647,59,16,TGGGCCACTGCCAGGAGAGT,43,1879097
icdC_predicted,9.058823529411764,169,16,TGGATGTGGAAAAGTGTTAG,153,1885466
icdC_predicted,1.2941176470588236,37,16,TGCACCGGGTCGTGCATTCT,21,1882240
icdC_predicted,1.8823529411764706,47,16,TGATATAAATTCATATTGAA,31,1894589
icdC_predicted,0.17647058823529413,18,16,TCGCGTAAGAGGTGGTCAGT,2,1896359
icdC_predicted,0.17647058823529413,18,16,TCCGGACTGACCTCAACTCT,2,1901799
icdC_predicted,0.23529411764705882,19,16,TCAGTAGAATAACCGTAGAT,3,1879573
icdC_predicted,1.8823529411764706,47,16,TCAGCTAAGGGTGTACCTGA,31,1893816
icdC_predicted,0.7647058823529411,28,16,GTGACAGGATATGAAACAAT,12,1893809
icdC_predicted,0.11764705882352941,17,16,GTGAAAGGCACTCCATGATG,1,1887161
icdC_predicted,2.0588235294117645,50,16,GTCAGTTGGGGTAGTAATCT,34,1884620
icdC_predicted,0.7647058823529411,28,16,GTATCCTCACGTTAGGTCAA,12,1906392
icdC_predicted,0.8823529411764706,30,16,GTACTGAGGATAGTGTGAGA,14,1908886
icdC_predicted,1.2352941176470589,36,16,GTACGCGACCTCCAACGAAA,20,1891441
icdC_predicted,1.0,32,16,GTACCACGGGTAACGGATAG,16,1907124
icdC_predicted,0.11764705882352941,17,16,GGTCAGGCAGTGACCTTATT,1,1903113
icdC_predicted,0.6470588235294118,26,16,GGACGGGAAGGGAGTAAACG,10,1903984
icdC_predicted,0.11764705882352941,17,16,GGACGACATTGGCTTCTATG,1,1900034
icdC_predicted,0.4117647058823529,22,16,GCCTCGCAACATTCCGTTGA,6,1898257
icdC_predicted,0.8235294117647058,29,16,GATTCGTTTGCGAGGATGTA,13,1896956
icdC_predicted,0.4117647058823529,22,16,GATAACTAAAGGGTAGAGAA,6,1902673
icdC_predicted,2.0,49,16,CTTAACACCTCAGCCAGCGG,33,1885669
icdC_predicted,2.0588235294117645,50,16,CGACTAATATAACGTGTGGC,34,1878557
icdC_predicted,0.9411764705882353,31,16,CCTTGAACGTCGCCTTATGT,15,1894447
icdC_predicted,1.9411764705882353,48,16,CCTCACTTGGCCTTCACCTA,32,1896918
icdC_predicted,0.11764705882352941,17,16,CCGCTCCCCATCACCAGAGT,1,1904819
icdC_predicted,0.6470588235294118,26,16,CCCTATCAAAGTTGGAAGAC,10,1899700
icdC_predicted,1.0,32,16,CAGGGGCTTAACCAGATGTA,16,1882255
icdC_predicted,0.11764705882352941,17,16,CAGCCTGAATCGTGTTTCAG,1,1898487
icdC_predicted,0.17647058823529413,18,16,CACTGGTGTCTTTTGTCACT,2,1888753
icdC_predicted,1.6470588235294117,43,16,ATTCGTGAACCAAGAGTTCG,27,1884645
icdC_predicted,0.5294117647058824,24,16,ATGAAGTTGGGAAGACCGGA,8,1884350
icdC_predicted,0.5882352941176471,25,16,ATCTGATTCTTCCCTTTGTG,9,1883038
icdC_predicted,1.0588235294117647,33,16,ATCCTGAGGGCACGTAAAGA,17,1882051
icdC_predicted,1.1764705882352942,35,16,ATCCCGTGAGCTGAGGCATC,19,1881953
icdC_predicted,0.6470588235294118,26,16,ATACCCTAACCTATGGATAG,10,1883759
icdC_predicted,0.8235294117647058,29,16,AGCTTTGGAGTAGACTCGTG,13,1902324
icdC_predicted,0.11764705882352941,17,16,AGAAAGTCCTTTTAATCTTT,1,1882637
icdC_predicted,1.2941176470588236,37,16,ACTCTAATGGACATTACCAT,21,1904188
icdC_predicted,1.6470588235294117,43,16,ACGCGGCTTCGAGCCCGGCT,27,1890320
icdC_predicted,0.5882352941176471,25,16,ACCGATTACGCTGCGGGGAG,9,1883520
icdC_predicted,1.3529411764705883,38,16,ACACTATTCCCATGCACAAT,22,1881067
icdC_predicted,1.2941176470588236,37,16,ACAAATCGATGGAGGCGTTG,21,1898165
icdC_predicted,1.3529411764705883,38,16,AATGAACGCATAACGCGGGG,22,1907824
icdC_predicted,1.25,34,15,TTTCGTAACTGCTATATTAC,19,1889024
icdC_predicted,1.1875,33,15,TTTCCGCATTTCCTGCCTAA,18,1888012
icdC_predicted,0.1875,17,15,TTGTGGGAATCTTCGTCCCC,2,1883700
icdC_predicted,0.125,16,15,TTGATATGTTCCCGGAGGAA,1,1888221
icdC_predicted,1.5625,39,15,TTAGGAATTTTGTAAACTGT,24,1887803
icdC_predicted,0.4375,21,15,TGTTGAAGAGCCAGCGTGCA,6,1897001
icdC_predicted,1.75,42,15,TGCGTTTCATTAAGCTGGAC,27,1896358
icdC_predicted,1.625,40,15,TGCGAAAAAGCACACAACTT,25,1890113
icdC_predicted,0.8125,27,15,TGAGGTGCTGAGATAAGACG,12,1894606
icdC_predicted,1.125,32,15,TCGTGAGGTTTTAGGCAAAT,17,1891210
icdC_predicted,0.875,28,15,TCAATTCCTATTTCGTATCT,13,1905759
icdC_predicted,3.125,64,15,TAGAGCGATGCACAACTGCA,49,1893022
icdC_predicted,2.0,46,15,TACTTTTCAAACCGTTGAGT,31,1898024
icdC_predicted,2.25,50,15,TAAAATGGCACTCCAATCGT,35,1898394
icdC_predicted,0.125,16,15,GTTGGTCATCTGACATTTCG,1,1892106
icdC_predicted,1.75,42,15,GTTCAGGTGTCAGGTTGGAG,27,1887159
icdC_predicted,4.4375,85,15,GTTAGCCAATGGGTCAATTG,70,1895619
icdC_predicted,2.25,50,15,GTGCGGCCGCGTTTGCAAGT,35,1879197
icdC_predicted,0.125,16,15,GTCTTTGTTCTCTTGCAATG,1,1898126
icdC_predicted,0.4375,21,15,GTCCTCGTGGTGATCAGGGC,6,1888033
icdC_predicted,2.0625,47,15,GTATGTGGTCCAGGCAGCGG,32,1889094
icdC_predicted,0.875,28,15,GGGTTACGCTCCTACTTATC,13,1901734
icdC_predicted,0.125,16,15,GGGGTTATGGAACGAGTTTA,1,1902838
icdC_predicted,0.875,28,15,GCCCCATCGGTTCAACTAAA,13,1891240
icdC_predicted,1.25,34,15,GCACTCAAGTCTCACCGAGC,19,1878288
icdC_predicted,0.5625,23,15,GATTTAAACCATGTAACCAC,8,1889095
icdC_predicted,1.125,32,15,GATGGGAGCCGTAAAAATCC,17,1883813
icdC_predicted,0.125,16,15,GATATATAAGGGCATACGGT,1,1888375
icdC_predicted,0.3125,19,15,GAGAACATCCAGGCTCATCT,4,1879622
icdC_predicted,1.9375,45,15,CTGCTCCTCCGAGTGCCGGT,30,1905622
icdC_predicted,1.875,44,15,CTGAGGGCCTAGAGGTTCAT,29,1880288
icdC_predicted,0.375,20,15,CGTAGATAGTTCTTAAGAAT,5,1908811
icdC_predicted,1.0,30,15,CGGCGTGATAGGACTTAGTA,15,1893326
icdC_predicted,3.125,64,15,CGCTTCATTATTGGCGCGAA,49,1879011
icdC_predicted,1.1875,33,15,CGAACCCTGGGGTCGTGTAC,18,1891808
icdC_predicted,1.375,36,15,CCTTAGCCGCTTTGCTTTAC,21,1888902
icdC_predicted,0.6875,25,15,CCGCATTAAGCATGTTTCTG,10,1899464
icdC_predicted,1.5625,39,15,CCGCACTTGAGGTCCGAATG,24,1903465
icdC_predicted,1.625,40,15,CCCTCAACAACATGGCGTGC,25,1903535
icdC_predicted,0.3125,19,15,CCCGCTTCACGTTGAACAAC,4,1885572
icdC_predicted,0.25,18,15,CCCCGTGAACAGGAATTTGT,3,1895195
icdC_predicted,1.875,44,15,CCCATTCGATAGCGGGTTGA,29,1883626
icdC_predicted,6.8125,123,15,CCCAAGGCTCGACGAACATT,108,1890243
icdC_predicted,3.0,62,15,CCAGGTGCAGGAGAATAGTA,47,1878816
icdC_predicted,0.125,16,15,CCACGTGGCACAATTCCCCG,1,1889967
icdC_predicted,5.125,96,15,CCACCAACCTATACTTTATC,81,1888894
icdC_predicted,0.1875,17,15,CATGGTCAAGGCGTCAGGCT,2,1899841
icdC_predicted,3.8125,75,15,CATGGAAGCAGGGCATTGTT,60,1886144
icdC_predicted,1.25,34,15,CACGACCTCAATCGTTATTT,19,1884310
icdC_predicted,0.5625,23,15,CAAAAGTCCTAGTTTGACAG,8,1893129
icdC_predicted,0.125,16,15,ATTCGGGGGTGGCAGAAGGC,1,1878815
icdC_predicted,4.4375,85,15,ATTACCCAACTGGACTATCA,70,1885930
icdC_predicted,0.125,16,15,ATTAATCTTATGGAGGCGAC,1,1899914
icdC_predicted,4.5,86,15,ATGAAATACCCTAGACGACA,71,1890199
icdC_predicted,0.125,16,15,ATGAAAAATCTTGCCCAAAT,1,1896488
icdC_predicted,0.3125,19,15,ATCGTGATCATCGAAGCCCT,4,1886832
icdC_predicted,4.125,80,15,ATAAGTACGTGGGTGGGAAG,65,1885667
icdC_predicted,0.4375,21,15,AGGCCGACCCCGGTGCCGTA,6,1903178
icdC_predicted,0.1875,17,15,AGGATTTCCGTATCATCCAA,2,1904251
icdC_predicted,1.5625,39,15,ACTTTCGACAGGATCTAAAA,24,1881491
icdC_predicted,2.1875,49,15,ACTCTAGAGATGAAATGGTA,34,1886553
icdC_predicted,0.5,22,15,ACGTCCAAAAGTATGCTCAC,7,1901904
icdC_predicted,0.875,28,15,ACCGACGTTAATGTTGATAG,13,1890626
icdC_predicted,2.1875,49,15,ACATTTACTGGCTCACGAAA,34,1900663
icdC_predicted,1.9375,45,15,ACATGATAATATTAGAACTT,30,1901609
icdC_predicted,0.6875,25,15,ACAGGCCTCGGGTACTGTTA,10,1887796
icdC_predicted,1.3125,35,15,ACAGATTTACTTCTAGGGTG,20,1893583
icdC_predicted,2.0625,47,15,AATCACTCGGGCTTCCCACT,32,1884459
icdC_predicted,0.9375,29,15,AATATAGCCTGGTGCGGATG,14,1892200
icdC_predicted,1.4375,37,15,AAGTCAGCTACTGCCTAAAG,22,1896455
icdC_predicted,1.5,38,15,AAGGCGCTGGTACCAAGGAT,23,1884477
icdC_predicted,1.3125,35,15,AAGCGTTATCCGGTCTCCAT,20,1882593
icdC_predicted,1.5625,39,15,AACGTCCGCCGAAAAAAAGA,24,1887079
icdC_predicted,1.9375,45,15,AAATGGGACCAGATACGCGT,30,1903304
icdC_predicted,2.6875,57,15,AAAAAGTGGCCATGCGATAT,42,1902039
icdC_predicted,2.2,46,14,TTGTTTACCATCCTGGCGGT,32,1895143
icdC_predicted,1.2666666666666666,32,14,TTGTGGGGAAGCGCACGACT,18,1904701
icdC_predicted,0.2,16,14,TTGGATATAACTGAGATTGT,2,1908172
icdC_predicted,1.1333333333333333,30,14,TTCGTACGGTCTGCGAAGAC,16,1882080
icdC_predicted,0.4,19,14,TTCGGACTCGAGTCTTAATA,5,1897368
icdC_predicted,1.7333333333333334,39,14,TGTCGCAGAGACGGCCAGGT,25,1902438
icdC_predicted,0.2,16,14,TGTAAGTATCTTGCAGCATT,2,1890486
icdC_predicted,0.26666666666666666,17,14,TGAATCGAACAATAACAGTG,3,1900223
icdC_predicted,1.8666666666666667,41,14,TCTTTTTGAAAGACACTAGC,27,1878728
icdC_predicted,0.9333333333333333,27,14,TCTGGAATGCGTTGGCACTC,13,1898925
icdC_predicted,1.4666666666666666,35,14,TCGCTATATGTTACAGTAGT,21,1891173
icdC_predicted,1.3333333333333333,33,14,TCACGCCTGGACAGCCCCTT,19,1893946
icdC_predicted,0.2,16,14,TAGGAATGGAATGACCTCGT,2,1880433
icdC_predicted,5.0,88,14,TACTGGCGTTCTGCCCTGAC,74,1906100
icdC_predicted,4.133333333333334,75,14,TACCAAAGGCCGTCCGTCCT,61,1892107
icdC_predicted,1.8666666666666667,41,14,TAAGGATCGTACACAGAAGG,27,1897155
icdC_predicted,0.4666666666666667,20,14,GTTGGCTACCATTCATCGAG,6,1898926
icdC_predicted,1.0,28,14,GGTTAATCAGGTATTGTGCT,14,1900535
icdC_predicted,1.2,31,14,GGTGCCGTGTCGGACGGCTT,17,1896038
icdC_predicted,1.4,34,14,GGGTGTTTCTTCGCTGCGTC,20,1883103
icdC_predicted,0.13333333333333333,15,14,GGGACGGGACATCGCAACCT,1,1891482
icdC_predicted,0.13333333333333333,15,14,GGCTCTTAGGGCGCACCTGT,1,1880729
icdC_predicted,0.13333333333333333,15,14,GGATGTGGTTCCGTGTATAC,1,1905004
icdC_predicted,0.5333333333333333,21,14,GGATCGCTGCGATAGTTGAA,7,1892226
icdC_predicted,2.066666666666667,44,14,GGAGAGACGTTCCCATCATA,30,1879581
icdC_predicted,0.26666666666666666,17,14,GCAGTGGTGCCTGTTAGTGG,3,1909217
icdC_predicted,0.7333333333333333,24,14,GCAGTCATCACTCCTCGTCC,10,1899114
icdC_predicted,0.8666666666666667,26,14,GATCGCCTTTAGCAGATGAC,12,1894681
icdC_predicted,8.333333333333334,138,14,GAGGCACCTTGACAGCGCTC,124,1885442
icdC_predicted,0.2,16,14,GACTTTATTTTATCGGTACC,2,1881430
icdC_predicted,1.6,37,14,GACTGTAGCTACGGGTCCTT,23,1891432
icdC_predicted,0.26666666666666666,17,14,GACCGGCCTATCGCGGGTGG,3,1883816
icdC_predicted,0.2,16,14,GACATCTATGTGGGGCGGTA,2,1900195
icdC_predicted,1.7333333333333334,39,14,CTTTGCATTGGGGTACCAAA,25,1898076
icdC_predicted,1.8,40,14,CTCATCGCGAAAGTACTCCT,26,1889088
icdC_predicted,1.8,40,14,CTAATACGGTCCCGGGCTAC,26,1898367
icdC_predicted,0.4,19,14,CGTTAGATGCTGCCATCTAG,5,1881631
icdC_predicted,1.1333333333333333,30,14,CGGTGACCGCGGCTGGAAAA,16,1907153
icdC_predicted,0.8,25,14,CGAGTGCAAAGACGAATGAC,11,1883451
icdC_predicted,1.2666666666666666,32,14,CGAGAGGAATGCCAGTGGGG,18,1882251
icdC_predicted,1.4,34,14,CGAAGGCCACTGGTGACATA,20,1904125
icdC_predicted,1.0,28,14,CCTGGAAGACAAGCCTGAAA,14,1895686
icdC_predicted,1.7333333333333334,39,14,CCTCTCCAGCGGCCGCTACG,25,1885964
icdC_predicted,2.2666666666666666,47,14,CCCAGGCGCGGGAAGACTGG,33,1878140
icdC_predicted,1.1333333333333333,30,14,CATGTTCAACGTATACATTC,16,1909202
icdC_predicted,0.6,22,14,CATCAACGTTCGGGACTTTC,8,1905890
icdC_predicted,2.2666666666666666,47,14,CAATGGTAGGCTCGCACACG,33,1902480
icdC_predicted,1.0,28,14,CAAGAATTGTACATGATTTA,14,1896975
icdC_predicted,0.9333333333333333,27,14,CAACTTATGCGGCCATTTGT,13,1881190
icdC_predicted,1.6666666666666667,38,14,CAAATTTTTACCCGTGTGGC,24,1889281
icdC_predicted,0.13333333333333333,15,14,CAAATGGCTACGGTCGGATT,1,1888312
icdC_predicted,3.466666666666667,65,14,CAAATCTCGAGGTAGACCTT,51,1896231
icdC_predicted,2.066666666666667,44,14,ATTTTAACTCTTTCAGCTTG,30,1904021
icdC_predicted,1.0,28,14,ATTCTTTTTCCGAGACGCTA,14,1879544
icdC_predicted,1.9333333333333333,42,14,ATGTTATCCGCACGGTTTAA,28,1881224
icdC_predicted,1.7333333333333334,39,14,ATAACCGCCGCAAAATATAA,25,1898543
icdC_predicted,1.8,40,14,AGGGCTCCGCCACGGGCCAT,26,1899275
icdC_predicted,1.2,31,14,AGGGAACATTTCCGGCGGAG,17,1891852
icdC_predicted,0.13333333333333333,15,14,AGGCCGGCGAGAGCCCTTCT,1,1905129
icdC_predicted,1.4666666666666666,35,14,ACTGATCATAGTAACGGCCG,21,1883296
icdC_predicted,1.3333333333333333,33,14,ACTCGCGAAGATGGCAGGAG,19,1893322
icdC_predicted,1.0,28,14,ACTATACAAGGCGGACTGGG,14,1898942
icdC_predicted,4.6,82,14,ACCCGATGCCGTATTCATAT,68,1892624
icdC_predicted,2.066666666666667,44,14,ACATGACCGTGATAAGGATG,30,1895984
icdC_predicted,0.9333333333333333,27,14,ACACGGGCAATAGAAGGTTC,13,1887278
icdC_predicted,0.4666666666666667,20,14,AATTCGTTCAGGGCGCGACG,6,1890872
icdC_predicted,1.8,40,14,AATTCAAGGTACTAATAGCA,26,1881954
icdC_predicted,6.6,112,14,AAGCGAACGCTTTAAGTTCT,98,1890553
icdC_predicted,0.5333333333333333,21,14,AAGAGCGGTGTCTATCATAG,7,1879635
icdC_predicted,4.2,76,14,AACCCGTACATTTCGGGTAC,62,1894356
icdC_predicted,2.3333333333333335,48,14,AACAACGGTCATACTGTGTC,34,1895038
icdC_predicted,2.4,49,14,AAATCTAAGGCACGGGCGGT,35,1901841
icdC_predicted,0.2,16,14,AAAGCATGTACACGGGGGCT,2,1880435
icdC_predicted,2.5,47,13,TTTGGAGCCTAGTATGTAAG,34,1879146
icdC_predicted,2.5,47,13,TTTCTACGCTATCGGACAAG,34,1894039
icdC_predicted,1.5,33,13,TTTCCGGTACTTGCGCGGTT,20,1901847
icdC_predicted,0.6428571428571429,21,13,TTGGGCGAAACCCGCGCACA,8,1878055
icdC_predicted,2.2857142857142856,44,13,TTCCAGTGCTCGGTACGGGT,31,1886437
icdC_predicted,1.9285714285714286,39,13,TGTTCTAAGGTTTACTACGC,26,1882262
icdC_predicted,0.14285714285714285,14,13,TGTGACCCACGGTACCGCAG,1,1882522
icdC_predicted,0.42857142857142855,18,13,TGGCATTACTCGTGTGGATG,5,1899761
icdC_predicted,0.9285714285714286,25,13,TGCCTGTCATCCCCTTTCCA,12,1884421
icdC_predicted,4.571428571428571,76,13,TGAGGCAGCATGTAAGGTAC,63,1907067
icdC_predicted,0.9285714285714286,25,13,TGAAACGGCCTAATGCGGTT,12,1893563
icdC_predicted,0.2857142857142857,16,13,TCTTGGTCACGCTCGCCAGT,3,1884926
icdC_predicted,3.0,54,13,TCTCGTACCGTAGAACGCAG,41,1891945
icdC_predicted,1.5714285714285714,34,13,TCTAGCAAACCACGGGACTT,21,1894455
icdC_predicted,1.7142857142857142,36,13,TCGTTCTCACCGGGGACTCA,23,1908446
icdC_predicted,1.6428571428571428,35,13,TCGATGCGTTGGCAGCGATG,22,1894112
icdC_predicted,0.7142857142857143,22,13,TCGACTCTCTCTGCGTTATG,9,1901679
icdC_predicted,0.21428571428571427,15,13,TCCGCTTGTACAGACACGTT,2,1890881
icdC_predicted,1.2142857142857142,29,13,TCCCTTACCGCCACGTTTCT,16,1884992
icdC_predicted,1.6428571428571428,35,13,TCATAGCCCCCAACCAAGCG,22,1894717
icdC_predicted,0.7142857142857143,22,13,TATCGCCAGGGACTGTTTTT,9,1902389
icdC_predicted,1.5,33,13,TAGGACCGGCTGCAAGTGTC,20,1907492
icdC_predicted,0.7142857142857143,22,13,TAGCGAGGTTCCCACGGTCC,9,1890602
icdC_predicted,0.21428571428571427,15,13,TAGAACCACCGGCCGTCGGC,2,1882390
icdC_predicted,1.7142857142857142,36,13,TACGCCCTTGACCGAGCATG,23,1898253
icdC_predicted,2.2142857142857144,43,13,TACCGTTCCAGTGCGGGTTA,30,1908519
icdC_predicted,0.14285714285714285,14,13,GTTTTTCCAGTGATAATCGG,1,1878648
icdC_predicted,1.0714285714285714,27,13,GTGTTTCGGTGTATAATCAT,14,1901083
icdC_predicted,0.2857142857142857,16,13,GTGGACTGTCCGGCCGCAAA,3,1883401
icdC_predicted,2.9285714285714284,53,13,GTCTCTGACAATTTTTCTTC,40,1899323
icdC_predicted,0.7142857142857143,22,13,GTCTCATAAAGCACAACTAC,9,1880849
icdC_predicted,0.14285714285714285,14,13,GTCATATCCCAGCTACTCCA,1,1902848
icdC_predicted,1.7857142857142858,37,13,GGTCGTTTCCCATGAACGGC,24,1879436
icdC_predicted,1.0,26,13,GGGGGGTTCTAGTGTATCAG,13,1895159
icdC_predicted,1.4285714285714286,32,13,GGGCTCAGCTATGGCTAGTG,19,1882499
icdC_predicted,5.428571428571429,88,13,GGGACAAGTGGCCACTGAAG,75,1891155
icdC_predicted,0.6428571428571429,21,13,GGCTACTGGACCACTGGCCC,8,1908445
icdC_predicted,0.2857142857142857,16,13,GGACAACGGACGCAGATAAG,3,1893454
icdC_predicted,0.7142857142857143,22,13,GCTCTTGAATCAAAGACTCC,9,1900807
icdC_predicted,1.4285714285714286,32,13,GCCTCCGAATGTCTTCCACT,19,1908269
icdC_predicted,2.7142857142857144,50,13,GCCGAGGACAGCGCACAAGA,37,1899760
icdC_predicted,2.857142857142857,52,13,GCCCGGAAATTATTAGACTT,39,1881279
icdC_predicted,2.2857142857142856,44,13,GCCCAAAAGCTGGCGCACAT,31,1894551
icdC_predicted,3.2142857142857144,57,13,GCAAAACGAGTTGGTCAAGG,44,1908444
icdC_predicted,0.14285714285714285,14,13,GATGACTTTTCAGGCTTCGT,1,1885915
icdC_predicted,1.5,33,13,GATCCGCTATCTACCCCGCA,20,1901058
icdC_predicted,5.0,82,13,GAAATAGCTATGGTCGCATG,69,1899950
icdC_predicted,1.5714285714285714,34,13,CTTTACTACCCAGCGACTAG,21,1880125
icdC_predicted,0.21428571428571427,15,13,CTGTAGTATTGCTTCCACGA,2,1890994
icdC_predicted,1.0714285714285714,27,13,CTATCGGGCATATCTCTCAA,14,1908624
icdC_predicted,0.14285714285714285,14,13,CTACTCCGTATGAACATACT,1,1904307
icdC_predicted,2.2857142857142856,44,13,CTACCGCATGAAGAAGTGCA,31,1884563
icdC_predicted,1.1428571428571428,28,13,CTAAAGCGAGCTTAACCGTT,15,1889280
icdC_predicted,1.6428571428571428,35,13,CGGGGTGCTAGATTCCGTTC,22,1898806
icdC_predicted,1.2142857142857142,29,13,CGGGATATATTCTCATCTTG,16,1884856
icdC_predicted,0.14285714285714285,14,13,CGAGCGGTGAGGAAGACAAG,1,1886020
icdC_predicted,4.5,75,13,CGAATACGTACATGTACTCC,62,1885990
icdC_predicted,1.5714285714285714,34,13,CCTTCAGTCTTGAACAACAC,21,1886159
icdC_predicted,0.21428571428571427,15,13,CCTTAGATCCGCAACTCGCT,2,1882110
icdC_predicted,1.8571428571428572,38,13,CCGGTAACTACGGCTTTCAC,25,1891804
icdC_predicted,0.21428571428571427,15,13,CCGCGTCCATACATCCCCAT,2,1877999
icdC_predicted,0.14285714285714285,14,13,CCATATTAAGGGCAGCAGAC,1,1890644
icdC_predicted,2.357142857142857,45,13,CCAAGAGCCGCCTAGGTAAA,32,1893450
icdC_predicted,3.0714285714285716,55,13,CATTGATTAGGCCAGGGAAT,42,1885965
icdC_predicted,1.5,33,13,CATGGCTGTTGCAAGACGGT,20,1890589
icdC_predicted,1.7142857142857142,36,13,CATAAAGTAGGACTATCTGA,23,1905467
icdC_predicted,1.8571428571428572,38,13,CAGAAATCGGCAATTAATGA,25,1895817
icdC_predicted,2.5714285714285716,48,13,CACTCTGGGCGATCCCCATG,35,1879100
icdC_predicted,1.5,33,13,CACCTAACGGATGACACTAG,20,1894757
icdC_predicted,0.7857142857142857,23,13,CACCGGGGTCTTCGAGACGG,10,1896877
icdC_predicted,0.14285714285714285,14,13,CAAGTCTCGGCAGGTGAGGG,1,1879657
icdC_predicted,2.2142857142857144,43,13,ATTTTGCGTCTGCTCGGTAA,30,1896919
icdC_predicted,2.0714285714285716,41,13,ATTCTTCCAGTAAAGGACTT,28,1902909
icdC_predicted,1.4285714285714286,32,13,ATTAGTATCTACAGCGGCAA,19,1909112
icdC_predicted,0.14285714285714285,14,13,ATTAAGGGTGCTGCCACGAG,1,1909201
icdC_predicted,2.0,40,13,ATGCCCTTTTCGTGCCGCAG,27,1885076
icdC_predicted,0.5,19,13,ATCTCTACATCCCGGGTCGC,6,1883834
icdC_predicted,0.9285714285714286,25,13,ATCCGAAATCTAGCCTTCTT,12,1888212
icdC_predicted,0.7142857142857143,22,13,ATATCCGAGAGGAATACCGG,9,1900098
icdC_predicted,0.14285714285714285,14,13,ATAAGTTTTTTCTCAATTCC,1,1880908
icdC_predicted,1.7142857142857142,36,13,AGTTCCGTCGCGTCCTTGAA,23,1891227
icdC_predicted,2.0,40,13,AGGTGCGGGAGGTATTCATA,27,1893406
icdC_predicted,0.7142857142857143,22,13,AGGTGACGCCTATCTCCGTG,9,1908806
icdC_predicted,0.14285714285714285,14,13,AGGATAAGCTAGGACCGTAA,1,1900043
icdC_predicted,0.6428571428571429,21,13,AGGAGGGCCAACCGCTCTCA,8,1883951
icdC_predicted,0.5,19,13,AGCCACACGCACGTTCAGTT,6,1890482
icdC_predicted,1.4285714285714286,32,13,AGATCCCAGGCCAGTCCCAA,19,1908064
icdC_predicted,2.0,40,13,ACTTAGTTTACCCTCGGCCT,27,1887710
icdC_predicted,0.7857142857142857,23,13,ACTCTGCTTATTGCAGGTCG,10,1878869
icdC_predicted,0.8571428571428571,24,13,ACCAGAGACGCACTGCAGAC,11,1900789
icdC_predicted,0.7857142857142857,23,13,ACAGAAGTAGCCAGCATAGA,10,1880843
icdC_predicted,3.357142857142857,59,13,AATCCCGTATGGGAGTGCTA,46,1899541
icdC_predicted,2.4285714285714284,46,13,AATATACCTCCCGGCGGTGT,33,1899420
icdC_predicted,1.4285714285714286,32,13,AATAAAGCCTCACCACTAAA,19,1896324
icdC_predicted,0.14285714285714285,14,13,AAGTTGTCTAGACAATGTGA,1,1901354
icdC_predicted,4.142857142857143,70,13,AAGCGTCACAGTTTTACATT,57,1907615
icdC_predicted,5.214285714285714,85,13,AAAAAGTTGGTAGTGATATG,72,1898186
icdC_predicted,0.3076923076923077,15,12,TTTTATTTGTATACAGCGCA,3,1884346
icdC_predicted,0.8461538461538461,22,12,TTTCTATTTCGGACTTCTGG,10,1887450
icdC_predicted,0.8461538461538461,22,12,TTTAAGTTACAGAGATTCGA,10,1907365
icdC_predicted,0.15384615384615385,13,12,TTGGGCGCATACGGCAGTTC,1,1882736
icdC_predicted,0.15384615384615385,13,12,TTCGGTTGCCGGGGCATGGA,1,1905525
icdC_predicted,1.3076923076923077,28,12,TTCCAGGGGGACACCGCTTT,16,1902644
icdC_predicted,2.3846153846153846,42,12,TTCATGCAGTATTACTATGA,30,1904257
icdC_predicted,0.8461538461538461,22,12,TGTTTGTTTACATTCGCCTT,10,1904124
icdC_predicted,2.230769230769231,40,12,TGTATCAGTCTAGTCCACAT,28,1879198
icdC_predicted,1.4615384615384615,30,12,TGCCGGACAAACTCCGGTGT,18,1882816
icdC_predicted,0.3076923076923077,15,12,TGCCAGCGCTTCGTTGTGCA,3,1882193
icdC_predicted,3.923076923076923,62,12,TGAGGTCCTGTGGGATGCGA,50,1908094
icdC_predicted,0.6923076923076923,20,12,TGAAAACAAGTAAGATGCCA,8,1886458
icdC_predicted,0.15384615384615385,13,12,TCTGGTGACCCGCAGTAAAA,1,1905797
icdC_predicted,1.5384615384615385,31,12,TCGGGACTACAGGCTCAAGG,19,1896941
icdC_predicted,1.1538461538461537,26,12,TCCTTTGGGCTATCCCCTTT,14,1885160
icdC_predicted,1.8461538461538463,35,12,TCCTGTCCTCACAGTGTAAC,23,1898021
icdC_predicted,1.3076923076923077,28,12,TCCTACAGTTTCCTCCTTAT,16,1885735
icdC_predicted,1.2307692307692308,27,12,TCCAGCTTCTCCTATTTTCC,15,1896018
icdC_predicted,1.0769230769230769,25,12,TCATCAAAGCTCTGCAGACA,13,1905565
icdC_predicted,0.15384615384615385,13,12,TATGGAGGGGCAGCGAATTA,1,1884794
icdC_predicted,0.15384615384615385,13,12,TATCCGAACACGTAGCATAG,1,1886170
icdC_predicted,1.4615384615384615,30,12,TAGGATGGTCGAATACCATC,18,1903921
icdC_predicted,0.3076923076923077,15,12,TAGCGGCTTGAATCGTCCGA,3,1902245
icdC_predicted,1.7692307692307692,34,12,TACTCTGGCGGGCGATGTAC,22,1891608
icdC_predicted,0.7692307692307693,21,12,TACGATCGATACATACTAGA,9,1892136
icdC_predicted,0.15384615384615385,13,12,TAAGAGGCCTTGGGACTTGT,1,1886288
icdC_predicted,1.3846153846153846,29,12,TAACGATCACATCGGACGCT,17,1887837
icdC_predicted,0.15384615384615385,13,12,TAAAGCATGCTTACAGAGTA,1,1896078
icdC_predicted,0.8461538461538461,22,12,GTTTTGATTCTGCCTGGTCG,10,1905167
icdC_predicted,0.46153846153846156,17,12,GTTATCGGTCTAACTTTATT,5,1909384
icdC_predicted,1.3076923076923077,28,12,GTGGGCACATTGAGTTGCGT,16,1904336
icdC_predicted,1.3846153846153846,29,12,GTGCGCACAATAGATCCAAA,17,1905474
icdC_predicted,2.1538461538461537,39,12,GTCGCTGATACGGGTGTCCC,27,1897121
icdC_predicted,2.0,37,12,GTATGGTATGAGATTCAGGC,25,1881897
icdC_predicted,2.3076923076923075,41,12,GTAGGTTCGTAAACTGGCTA,29,1897855
icdC_predicted,1.0,24,12,GTAATGTTATTGGCAGTGTA,12,1905925
icdC_predicted,0.6153846153846154,19,12,GTAAATGTTAGAAACCCTTT,7,1885008
icdC_predicted,1.4615384615384615,30,12,GGTGTTTAGAAGGTCCCTGC,18,1879863
icdC_predicted,5.769230769230769,86,12,GGTCAGACGACGCCATCAAG,74,1897682
icdC_predicted,0.6923076923076923,20,12,GGGGGCAAAGAGTAGGTAAT,8,1885936
icdC_predicted,1.7692307692307692,34,12,GGCACGCGTTGTTTTCCGAG,22,1879964
icdC_predicted,0.6153846153846154,19,12,GCTGTCTAAATCCGACCGCA,7,1898080
icdC_predicted,0.6923076923076923,20,12,GCTCGGGTACGCACGGTGCC,8,1885181
icdC_predicted,0.15384615384615385,13,12,GCTAGACTGTACTCGGAGAA,1,1901870
icdC_predicted,1.0769230769230769,25,12,GCGTTCGCGCGGAGTGACAC,13,1900435
icdC_predicted,1.5384615384615385,31,12,GCGGATCATCTGAGCGTTCT,19,1895965
icdC_predicted,0.7692307692307693,21,12,GCCCCTGGACCAGGTGATTC,9,1899168
icdC_predicted,0.3076923076923077,15,12,GATTGGTTAGGTTGTCCATC,3,1885636
icdC_predicted,10.846153846153847,152,12,GATGCGAGCTCTTCTGTGTT,140,1905637
icdC_predicted,1.3846153846153846,29,12,GATCTTCCGTAAACACTGAT,17,1904064
icdC_predicted,0.15384615384615385,13,12,GATACTCGGCGTCAAGAAGA,1,1890567
icdC_predicted,5.384615384615385,81,12,GACCTAAGCCAGAAACGCAA,69,1895107
icdC_predicted,0.8461538461538461,22,12,GACCAACTCGAAAGGCTAAG,10,1879161
icdC_predicted,2.076923076923077,38,12,CTTGGTCTCACTCGAGTCGC,26,1889838
icdC_predicted,2.3076923076923075,41,12,CTGTCTCAATGCTGATACTG,29,1902543
icdC_predicted,1.3846153846153846,29,12,CTGGCCTGGATTACTCCCGG,17,1898861
icdC_predicted,1.2307692307692308,27,12,CTGGCCGTTCAACATTACGG,15,1905794
icdC_predicted,1.0,24,12,CTCTTTCACACATTTATGTC,12,1878355
icdC_predicted,1.0769230769230769,25,12,CTCTAACGCTGTTCTGACTA,13,1896600
icdC_predicted,1.2307692307692308,27,12,CTCGGGGGAATTAAATCCAG,15,1893067
icdC_predicted,0.15384615384615385,13,12,CTATAACTTATACCTATAGT,1,1884279
icdC_predicted,1.6923076923076923,33,12,CTAGAAAGTTGGGTTCCGCA,21,1882552
icdC_predicted,2.230769230769231,40,12,CTAAATGGGCGGCCAGGTAA,28,1888432
icdC_predicted,1.4615384615384615,30,12,CGGGCGGGGGCCGGGAAACG,18,1907659
icdC_predicted,0.46153846153846156,17,12,CGGGAACGTTCGGTCGGGCA,5,1878446
icdC_predicted,1.6923076923076923,33,12,CGACTTGCCTTATTTGTGAC,21,1893413
icdC_predicted,0.15384615384615385,13,12,CGAAAGCGCCCGGAATTGCG,1,1881195
icdC_predicted,2.3076923076923075,41,12,CCTGTCCGGATGGCATGGAT,29,1901650
icdC_predicted,0.15384615384615385,13,12,CCGGGTCACGTTTTCTAGCG,1,1906349
icdC_predicted,0.15384615384615385,13,12,CCGGAGGGGTGATACCTAAC,1,1902215
icdC_predicted,0.8461538461538461,22,12,CCCTATGTTGCGAGAGGTGG,10,1879526
icdC_predicted,1.1538461538461537,26,12,CCCATCCGCAGGTTCGTCGC,14,1897020
icdC_predicted,2.769230769230769,47,12,CCCAACTCAGCCAAAGATGC,35,1886555
icdC_predicted,1.9230769230769231,36,12,CATTTCCTGGGCTGTGTATC,24,1900823
icdC_predicted,1.3076923076923077,28,12,CATGTCCCCGCTCCCGGGAG,16,1903181
icdC_predicted,2.769230769230769,47,12,CAGAAAATTCGGTGATTGGA,35,1906387
icdC_predicted,1.9230769230769231,36,12,CACAGATCGTGCCAGGGGAG,24,1884505
icdC_predicted,0.6923076923076923,20,12,CAAAGTCAGACATTAGTCGC,8,1885516
icdC_predicted,1.4615384615384615,30,12,ATTGTACTCTCGCCGTTTTG,18,1901914
icdC_predicted,0.15384615384615385,13,12,ATGGCACCCTTCCTCACCTC,1,1898234
icdC_predicted,0.15384615384615385,13,12,ATGCGGCATTAAACTGATGA,1,1889050
icdC_predicted,1.4615384615384615,30,12,ATCGTGGGTGCCCTAGTCCG,18,1890135
icdC_predicted,0.6153846153846154,19,12,ATCCCTTGATCACCATAGGA,7,1891293
icdC_predicted,2.6923076923076925,46,12,ATCAACCGTTTGCCGACAAC,34,1880584
icdC_predicted,0.46153846153846156,17,12,ATATCGTCATTTTCCCAGGA,5,1908318
icdC_predicted,1.4615384615384615,30,12,ATATCAAACATGTGGACGAA,18,1894549
icdC_predicted,5.384615384615385,81,12,ATAAGTAGCTCAAAAGACTG,69,1887220
icdC_predicted,1.1538461538461537,26,12,ATAAGCGTCCCCCGCAGATG,14,1880059
icdC_predicted,2.076923076923077,38,12,AGGTTTATTACTTCTGACCA,26,1892560
icdC_predicted,3.6153846153846154,58,12,AGGACGCGGCTCTATTATTT,46,1908370
icdC_predicted,4.0,63,12,AGCAGCGATATTTACCGTGG,51,1886822
icdC_predicted,0.8461538461538461,22,12,AGCACCATATGCAACAAACT,10,1891544
icdC_predicted,0.46153846153846156,17,12,AGACGCTTGTACTCGCGGCG,5,1904187
icdC_predicted,6.538461538461538,96,12,ACTACATGTGTACACATGTG,84,1896225
icdC_predicted,1.2307692307692308,27,12,ACGTTGCGAGGTCTATCCTG,15,1878899
icdC_predicted,1.1538461538461537,26,12,ACCTCCATATTAAGTGCTCG,14,1883817
icdC_predicted,0.6923076923076923,20,12,ACCCCTCATTCTTCAGTGGG,8,1887767
icdC_predicted,0.3076923076923077,15,12,ACCAATACCGCTCACTCGAA,3,1892535
icdC_predicted,1.3846153846153846,29,12,ACAGGTGGTGGAGGGGCTCT,17,1892873
icdC_predicted,0.6153846153846154,19,12,AATTCACGGTACGTTCACCG,7,1895569
icdC_predicted,7.923076923076923,114,12,AAGTTGGCTCTATCAGCAGA,102,1888668
icdC_predicted,0.16666666666666666,12,11,TTTTTAAGATCCGGGGAAGC,1,1884055
icdC_predicted,5.333333333333333,74,11,TTTTCTGGAATCGTCCGTCC,63,1894631
icdC_predicted,1.3333333333333333,26,11,TTTTCGTGTCTCTGTAGCTG,15,1902789
icdC_predicted,1.8333333333333333,32,11,TTTGGCCGAAACTACGAACA,21,1908987
icdC_predicted,0.4166666666666667,15,11,TTTCCAGGCATTTCGAGCCT,4,1886467
icdC_predicted,2.0833333333333335,35,11,TTTATGGTCAGAGCCCCTAT,24,1899023
icdC_predicted,0.16666666666666666,12,11,TTTATAGCACTTATGCCAGC,1,1878847
icdC_predicted,2.1666666666666665,36,11,TTCAGTTTAATTTAAACTTC,25,1884712
icdC_predicted,2.5,40,11,TGTCGGAATATAAAAGTGAT,29,1882661
icdC_predicted,0.3333333333333333,14,11,TGTCGCTCAGGGAAAGAGCC,3,1907414
icdC_predicted,3.25,49,11,TGGGTTTGTCCCAACTGGGA,38,1880807
icdC_predicted,0.16666666666666666,12,11,TGGACAAGCAAGCGAGGAAT,1,1882551
icdC_predicted,1.0,22,11,TGAGAGCCACCCTGTGCAGC,11,1901436
icdC_predicted,3.0833333333333335,47,11,TCGTTACGTTCTGTTCTCTT,36,1881858
icdC_predicted,0.3333333333333333,14,11,TCGGTTTATCAACTATCGAT,3,1891033
icdC_predicted,2.8333333333333335,44,11,TCGGTGCATGGCTGACAGAA,33,1901994
icdC_predicted,0.16666666666666666,12,11,TCGCTTCGGCAATCATCAGA,1,1879730
icdC_predicted,2.1666666666666665,36,11,TCCTCCCATTAAACTGTCAG,25,1895577
icdC_predicted,0.16666666666666666,12,11,TCATGTAGGACCGGACCTGT,1,1879768
icdC_predicted,1.9166666666666667,33,11,TCACCATTGAAGGCGTAGAC,22,1895498
icdC_predicted,0.16666666666666666,12,11,TCAAGCGAGTTAACGTCCTA,1,1900633
icdC_predicted,0.16666666666666666,12,11,TATTTCCAAGTGCCTTCTGT,1,1892043
icdC_predicted,1.9166666666666667,33,11,TATGCAGCCAGGACCTTCCA,22,1879857
icdC_predicted,2.0833333333333335,35,11,TATCATAAAGTCGATCGACA,24,1889599
icdC_predicted,0.16666666666666666,12,11,TACCTAGTGTCGCCTGCCGA,1,1889522
icdC_predicted,0.16666666666666666,12,11,TACAGCCCTCATAACCCCGG,1,1891298
icdC_predicted,11.833333333333334,152,11,TAACTAACCATGGGCCTTAG,141,1888873
icdC_predicted,1.0833333333333333,23,11,TAAAAGTAAAGCGGAGGTTC,12,1895621
icdC_predicted,4.5,64,11,GTTTGCTTATTACCTCAAGG,53,1903326
icdC_predicted,1.25,25,11,GTTCGGTCGTGGTCCAGGTA,14,1888780
icdC_predicted,2.6666666666666665,42,11,GTTCAAGTGATTGCCGGGTA,31,1891724
icdC_predicted,1.8333333333333333,32,11,GTGTTCATTGAAGTACGTTC,21,1896275
icdC_predicted,0.9166666666666666,21,11,GTGCCTTTTCGGCACCAGCC,10,1897530
icdC_predicted,1.6666666666666667,30,11,GTCCTACTTGTGCTGCACAA,19,1880831
icdC_predicted,3.5,52,11,GTCCGACATCTGTATACACA,41,1905237
icdC_predicted,4.0,58,11,GTATCGCCGATACTGATTGA,47,1906870
icdC_predicted,2.3333333333333335,38,11,GGTGTCAAGACAATGCAAGA,27,1885366
icdC_predicted,2.0833333333333335,35,11,GGGTTTTAGGGCTGGTAAGC,24,1893068
icdC_predicted,0.16666666666666666,12,11,GGGTTGGCGTCTTAGAATCT,1,1878863
icdC_predicted,0.16666666666666666,12,11,GGGTGGTTTGAGCGCGAGAT,1,1894377
icdC_predicted,1.1666666666666667,24,11,GGCGCGTTTCCCCCATTTAA,13,1879112
icdC_predicted,1.9166666666666667,33,11,GGAGTTCGTATGATTTTATG,22,1878199
icdC_predicted,0.25,13,11,GCTACAATGTTCGCGGAATA,2,1898900
icdC_predicted,1.25,25,11,GCGGGGTCTCTGCAATCTTT,14,1896888
icdC_predicted,0.8333333333333334,20,11,GCGGGGGAAAAGGGCTAGTT,9,1884596
icdC_predicted,1.8333333333333333,32,11,GCGGCAATAATGAAAGTACT,21,1883224
icdC_predicted,3.0,46,11,GCCTGAGGCTGGCGCTCGAT,35,1899955
icdC_predicted,1.1666666666666667,24,11,GCCTAATTTGCGGCCGGATT,13,1894718
icdC_predicted,1.5833333333333333,29,11,GCCGGGCCTGGGGATCACAG,18,1901391
icdC_predicted,2.5,40,11,GCCGACTTGGCGCTGTCTAT,29,1890653
icdC_predicted,1.0,22,11,GCCAGGGAATCTGCTAGTCA,11,1905037
icdC_predicted,1.8333333333333333,32,11,GAGGGAACGTACTCGCCGAA,21,1899069
icdC_predicted,1.75,31,11,GAGCATTAGCCTGCGACAGT,20,1896503
icdC_predicted,1.0,22,11,GAGATGTTCGCCTTGTTAAG,11,1889461
icdC_predicted,0.16666666666666666,12,11,GACTAACTCTCAGTGCACAT,1,1883900
icdC_predicted,0.25,13,11,GACAGTCATGCATTCCTCTC,2,1889318
icdC_predicted,2.25,37,11,GACAGTAAGTAGCGCCAGAT,26,1906133
icdC_predicted,1.3333333333333333,26,11,GAACCACGCGTCACGAGCTT,15,1887251
icdC_predicted,0.3333333333333333,14,11,CTTGTCCTTCCATAAACGTA,3,1902251
icdC_predicted,2.3333333333333335,38,11,CTTGCCAACTTATCCAGCAT,27,1896563
icdC_predicted,0.5,16,11,CTGCAAATACTGGGTATTCG,5,1889954
icdC_predicted,3.1666666666666665,48,11,CTCTCCTGATCAGTCATGAA,37,1884715
icdC_predicted,1.9166666666666667,33,11,CTCCTGTAGTTTCATTTCGT,22,1882670
icdC_predicted,2.4166666666666665,39,11,CTCATGCGCTGTCGTCCGGA,28,1890342
icdC_predicted,0.25,13,11,CTCAATTGTTTTCCTCATAA,2,1884351
icdC_predicted,2.0,34,11,CTACGAATGGACCTTACGTA,23,1887852
icdC_predicted,4.166666666666667,60,11,CTACAACTGCGGCGTTCGAA,49,1896711
icdC_predicted,1.9166666666666667,33,11,CGTTACAGTCCGGAAACTTA,22,1894952
icdC_predicted,1.0,22,11,CGTATGGACATGACAGAGCG,11,1882331
icdC_predicted,1.0,22,11,CGGTTGTTCTTTGGTACAAA,11,1889101
icdC_predicted,0.16666666666666666,12,11,CGGGATAGCGTAGACAAGGA,1,1909142
icdC_predicted,6.25,85,11,CGCCGTCACTGAGGCTTTCA,74,1908192
icdC_predicted,2.1666666666666665,36,11,CGATTGACAGAGGGTGAATC,25,1897290
icdC_predicted,0.16666666666666666,12,11,CGATCTGCATGGTAGTTTGT,1,1896311
icdC_predicted,4.416666666666667,63,11,CCTTTCGGGTTTGGGACAAT,52,1893617
icdC_predicted,2.5833333333333335,41,11,CCTCTGGGTTACGGGGTATC,30,1879499
icdC_predicted,2.9166666666666665,45,11,CCTCGGCAGCCCAAAAGACT,34,1898258
icdC_predicted,2.3333333333333335,38,11,CCTACGGGATACACCCCTTT,27,1907742
icdC_predicted,1.1666666666666667,24,11,CCGTAACTTCGGCGTCACAA,13,1909210
icdC_predicted,2.75,43,11,CCCCCCCGGCTCTCAGGCGC,32,1887012
icdC_predicted,0.3333333333333333,14,11,CCCCATGATTTCCTACATTA,3,1902304
icdC_predicted,2.0,34,11,CCATTCCATGCAGACCCTGA,23,1881251
icdC_predicted,0.25,13,11,CATGTCCCCGAATGGCACAT,2,1888856
icdC_predicted,0.3333333333333333,14,11,CATGCTTGTGAGTATAGGTA,3,1878473
icdC_predicted,2.8333333333333335,44,11,CATGAGCTGTTAAGAGTCAG,33,1879969
icdC_predicted,2.25,37,11,CATCAGTGATCCAAGTCCGA,26,1896890
icdC_predicted,0.5,16,11,CATAATTTTGCGTTACCCAC,5,1879599
icdC_predicted,1.3333333333333333,26,11,CAGCCCCCTCAGTAGGCCCT,15,1897468
icdC_predicted,0.8333333333333334,20,11,CACAACAGGTGCCCTCTTAT,9,1886751
icdC_predicted,9.083333333333334,119,11,ATTACATTGCATGCGCTGCA,108,1896079
icdC_predicted,2.0,34,11,ATGCCAACTTGCGGGTTCAA,23,1898019
icdC_predicted,1.75,31,11,ATCCCTGTACCTGTTCACGC,20,1882840
icdC_predicted,0.3333333333333333,14,11,ATATCACGATCTTTGTCCTG,3,1878954
icdC_predicted,2.4166666666666665,39,11,ATAGGAACCGCACATGCCTA,28,1882497
icdC_predicted,3.5833333333333335,53,11,AGTAGTCGTTCCGGAACCGA,42,1901500
icdC_predicted,4.083333333333333,59,11,AGGTTCCAATTTACGAAGAC,48,1882010
icdC_predicted,0.4166666666666667,15,11,AGGGTCATAATTCGCGCCGG,4,1899067
icdC_predicted,1.4166666666666667,27,11,AGGCTTGTTGAGATTCAATA,16,1880012
icdC_predicted,0.16666666666666666,12,11,AGGCTGAACGCTCTGCATCC,1,1903551
icdC_predicted,1.1666666666666667,24,11,AGCTTTAGCTTAGTGCGGCT,13,1879522
icdC_predicted,2.9166666666666665,45,11,AGCGACAGTAATAGGCGTCC,34,1882425
icdC_predicted,4.833333333333333,68,11,AGAGCATTAGGGTCTCCTAT,57,1886166
icdC_predicted,2.3333333333333335,38,11,ACGTCGGGAGTATGTAAAAA,27,1894384
icdC_predicted,0.4166666666666667,15,11,ACGCGGTCATGTGATGGCCA,4,1907501
icdC_predicted,0.25,13,11,ACAGGTCAAGACCTTCTGGT,2,1883563
icdC_predicted,0.16666666666666666,12,11,ACAGATAGCGGCCGTCTCGA,1,1899317
icdC_predicted,1.75,31,11,AAGTGCAGCGAGGGCTTACA,20,1888972
icdC_predicted,5.083333333333333,71,11,AAGGGGGATGGAAGATCACA,60,1907173
icdC_predicted,1.5833333333333333,29,11,AAGACACATGTAAATCGCGC,18,1892296
icdC_predicted,2.9166666666666665,45,11,AACTAGGGCAAAGGGTTGTT,34,1892111
icdC_predicted,0.25,13,11,AACCTAAGGGCGTGGACGTT,2,1884594
icdC_predicted,2.0,34,11,AAATGGAATTTAGGTGCAGA,23,1899863
icdC_predicted,1.9166666666666667,33,11,AAAGTGTGCAAACCTCGTAG,22,1881903
icdC_predicted,4.0,53,10,TTTGTCTAGGCGTAGTAGTT,43,1879342
icdC_predicted,1.8181818181818181,29,10,TTTCGCAGATTAAGAGCTGT,19,1903183
icdC_predicted,1.6363636363636365,27,10,TTTATACCGCCAGTTTTGCA,17,1879577
icdC_predicted,2.8181818181818183,40,10,TTGTTGCGAAATGGGTGAGA,30,1906354
icdC_predicted,4.454545454545454,58,10,TTGGGTGCTATATGTCCCGA,48,1885010
icdC_predicted,0.45454545454545453,14,10,TTGCGGGGAACTTGATTCCG,4,1904614
icdC_predicted,2.0,31,10,TTCTTTTCTAGACTAACGAG,21,1894091
icdC_predicted,6.0,75,10,TTAGATCGAGTCCTTTATAT,65,1896227
icdC_predicted,1.4545454545454546,25,10,TTAACACCGAGATCCCGTGG,15,1896781
icdC_predicted,2.5454545454545454,37,10,TGGTTAGTCCTGGCTCTGGT,27,1907193
icdC_predicted,1.0,20,10,TGGGGCATGTCAGGTCGCTT,10,1907198
icdC_predicted,1.6363636363636365,27,10,TGGAGGTGCAAAGTATACCT,17,1902497
icdC_predicted,0.8181818181818182,18,10,TGGACGACAAGTAGAAAGGC,8,1899338
icdC_predicted,1.9090909090909092,30,10,TGGAATAACGCCTCCAACAT,20,1893422
icdC_predicted,1.9090909090909092,30,10,TGCCGCTTGTAATATCGCCC,20,1890233
icdC_predicted,0.6363636363636364,16,10,TCTGGCCACTCAGTGCTTCT,6,1889440
icdC_predicted,2.5454545454545454,37,10,TCTCTAAGAATTGGTGTGCA,27,1881500
icdC_predicted,0.8181818181818182,18,10,TCTCCTCAGGCGAATCGACA,8,1884398
icdC_predicted,1.1818181818181819,22,10,TCGCGAAGTTCACACTCAGA,12,1879563
icdC_predicted,1.3636363636363635,24,10,TCCGCTAACATGGAGAAAGA,14,1884737
icdC_predicted,1.9090909090909092,30,10,TCCATGAATGCAGAACGCCC,20,1895145
icdC_predicted,0.18181818181818182,11,10,TCACTAAGGCCCTGCAAAGT,1,1880547
icdC_predicted,2.6363636363636362,38,10,TCAAGGCAAAGCGAACCACC,28,1909489
icdC_predicted,1.0,20,10,TATCAACTATGATTTTATCA,10,1886897
icdC_predicted,0.9090909090909091,19,10,TACAGCCGGGGAGGGGCTCA,9,1890645
icdC_predicted,0.8181818181818182,18,10,TAATGCAGTTTAAGGGATTA,8,1886422
icdC_predicted,3.090909090909091,43,10,TAACGTATGAAAGATTTCGA,33,1904992
icdC_predicted,1.0909090909090908,21,10,TAAATCCTCAGAAAACCGAT,11,1888047
icdC_predicted,2.6363636363636362,38,10,GTTGTAGGTTAATACCTCGT,28,1890974
icdC_predicted,1.0,20,10,GTTCCACGGTGAGCATCATT,10,1891164
icdC_predicted,0.9090909090909091,19,10,GGTGTTATTATCAGCGCAAC,9,1884208
icdC_predicted,0.18181818181818182,11,10,GGTCTCGACAATCATATCTG,1,1888187
icdC_predicted,2.090909090909091,32,10,GGGTTCAGAGGCGATGTGGT,22,1903118
icdC_predicted,2.5454545454545454,37,10,GGGGGCACGGGGAAAATGCA,27,1903663
icdC_predicted,3.727272727272727,50,10,GGGGCTCCCCACGGGGCTGA,40,1897215
icdC_predicted,3.8181818181818183,51,10,GGGGCGAATATTAGGGAGCA,41,1901456
icdC_predicted,0.18181818181818182,11,10,GGGGCAATACGCTTATTCCT,1,1890509
icdC_predicted,2.090909090909091,32,10,GGCTATGGTGTAAATCGTGC,22,1882410
icdC_predicted,0.18181818181818182,11,10,GGCGCCCTCTTGCTGATGTG,1,1882284
icdC_predicted,0.18181818181818182,11,10,GCTTGATGGGGTTGTACCTA,1,1885018
icdC_predicted,0.18181818181818182,11,10,GCTCAGAGGTGTCAGCTAAA,1,1908748
icdC_predicted,1.0,20,10,GCGTATTAAGGTCTAACCCG,10,1907463
icdC_predicted,2.909090909090909,41,10,GCAGCCCTCACGCTACTCCA,31,1880986
icdC_predicted,1.0909090909090908,21,10,GATATATGCAAGACAGTGTA,11,1898233
icdC_predicted,0.9090909090909091,19,10,GAGGTGACAACCCTGCGGTC,9,1891932
icdC_predicted,0.7272727272727273,17,10,GACGGGGAAAGGCTGCGATC,7,1888546
icdC_predicted,0.45454545454545453,14,10,GACCGCTTCTTCGAATGCTG,4,1893612
icdC_predicted,1.4545454545454546,25,10,GACAAAAGCCCGAGCAAAAG,15,1903027
icdC_predicted,2.909090909090909,41,10,CTTATCCGCTCTCTCGCACC,31,1896663
icdC_predicted,1.0,20,10,CTGATCAGGCCTTGGTTGTA,10,1907215
icdC_predicted,2.272727272727273,34,10,CTCTATGGCAACATCATCTA,24,1902053
icdC_predicted,1.0909090909090908,21,10,CTCACATGGTAGGGTTTACT,11,1903282
icdC_predicted,0.18181818181818182,11,10,CGTCTTTTCACGTGATGGCT,1,1886932
icdC_predicted,1.8181818181818181,29,10,CGTACTTTTATAGCTGATAT,19,1891776
icdC_predicted,0.18181818181818182,11,10,CGGGTCGTGCTCAGCAAGAC,1,1893236
icdC_predicted,0.7272727272727273,17,10,CGATGGTAATACAAGTAGCA,7,1893664
icdC_predicted,2.3636363636363638,35,10,CCTCTAGCTATTTTTGGGTA,25,1907484
icdC_predicted,1.2727272727272727,23,10,CCGTTCATACCCATCCCTCA,13,1906157
icdC_predicted,2.8181818181818183,40,10,CCGTGTGTACGTAGGAGAGT,30,1906538
icdC_predicted,2.090909090909091,32,10,CCGCGTGTCTGCAAACTAGC,22,1896163
icdC_predicted,1.1818181818181819,22,10,CCCTTGATGCCGGGTAAGTG,12,1886900
icdC_predicted,4.454545454545454,58,10,CCCCGCGGGCAACGGTTATG,48,1881142
icdC_predicted,1.4545454545454546,25,10,CCCAACACGTCGTTTTTATT,15,1907347
icdC_predicted,1.6363636363636365,27,10,CCACCTCCCTTCATCAGACG,17,1888837
icdC_predicted,2.0,31,10,CATCTCACCGGATCTATACA,21,1884816
icdC_predicted,1.5454545454545454,26,10,CATACTGCCGGAATTTCATA,16,1908550
icdC_predicted,1.7272727272727273,28,10,CAGTGCCCATAGCGGACACA,18,1891718
icdC_predicted,3.8181818181818183,51,10,CAGTGAAGAACTCGACGCCA,41,1891042
icdC_predicted,1.2727272727272727,23,10,CAGCCGGATTAGAGCACTAC,13,1889719
icdC_predicted,0.45454545454545453,14,10,CAACTCCTTCCCGTTACCCA,4,1909450
icdC_predicted,5.818181818181818,73,10,ATTGGTAGTTGTCTAGTACT,63,1878777
icdC_predicted,0.36363636363636365,13,10,ATGGGCCTAATTATTGCGAA,3,1887647
icdC_predicted,5.818181818181818,73,10,ATGGACACAGGAACGGAGCG,63,1885996
icdC_predicted,1.8181818181818181,29,10,ATGAGGTACGAATCTCCCGG,19,1902799
icdC_predicted,1.0,20,10,ATCTAACCAAATTCGCCATG,10,1880889
icdC_predicted,1.0909090909090908,21,10,ATCGTTAGGCCGCTGGATAT,11,1895269
icdC_predicted,2.5454545454545454,37,10,ATCGGAATAGGAAGAAAGTT,27,1897355
icdC_predicted,2.090909090909091,32,10,ATCCGTACTCGGGGAACTCA,22,1888787
icdC_predicted,1.0,20,10,ATCCGCGTCACTGTGTAATA,10,1879531
icdC_predicted,3.272727272727273,45,10,ATCCAAAGCACCGTCCCAAT,35,1896904
icdC_predicted,1.6363636363636365,27,10,ATAAAGCACCGATGACCAGA,17,1884288
icdC_predicted,0.18181818181818182,11,10,AGTGGAGGCTCGTATCCCCT,1,1891391
icdC_predicted,1.0,20,10,AGTCGATAGTGCATGGTCGC,10,1900029
icdC_predicted,0.2727272727272727,12,10,AGTCAGTCTACTCTGAAGCC,2,1892851
icdC_predicted,0.18181818181818182,11,10,AGGTCCTGACCACTGGTCGG,1,1882282
icdC_predicted,0.18181818181818182,11,10,AGCTAAGATTCAGCCGTCCC,1,1887743
icdC_predicted,0.2727272727272727,12,10,AGCCAGGAGCCTTGAAGCGT,2,1900348
icdC_predicted,0.18181818181818182,11,10,AGAGCTCCTTCCAGGCTATC,1,1886935
icdC_predicted,2.3636363636363638,35,10,ACTTTGGTTTGTTTGACACT,25,1883514
icdC_predicted,5.636363636363637,71,10,ACTGCGTGGGTCACAGGGGT,61,1882181
icdC_predicted,5.090909090909091,65,10,ACGTGGAGGTTGCGACCATG,55,1892332
icdC_predicted,2.0,31,10,ACCTTGCCCTGTTATCATAG,21,1880880
icdC_predicted,3.727272727272727,50,10,ACCTATAGTCAGAAGGTAGT,40,1886746
icdC_predicted,1.2727272727272727,23,10,ACAAGCACAGTAACATCACA,13,1891271
icdC_predicted,3.909090909090909,52,10,AAGTGACTAATATCGATCAG,42,1879741
icdC_predicted,0.8181818181818182,18,10,AAGGAGAAAGCTACAGATAT,8,1890318
icdC_predicted,3.1818181818181817,44,10,AAGCAGTGACTGCTGAGATG,34,1905082
icdC_predicted,1.3636363636363635,24,10,AACGCACCGTGATTTCGACA,14,1891036
icdC_predicted,0.2727272727272727,12,10,AAATGCCCCCCGTCACCCCT,2,1887913
icdC_predicted,0.18181818181818182,11,10,AAATAAGCGCGCCTGGTCCG,1,1885191
icdC_predicted,2.1818181818181817,33,10,AAACTGTATTACTCAGTTAA,23,1887425
icdC_predicted,0.9090909090909091,19,10,AAACAAACATTTTTACCCTG,9,1894605
icdC_predicted,2.2,30,9,TTTTCCCCGCTTTAAATCCT,21,1890134
icdC_predicted,1.4,22,9,TTTCCGACCTCGTCGAAGCC,13,1889025
icdC_predicted,0.2,10,9,TTTCATCACGCGCCTAAGAA,1,1895947
icdC_predicted,0.8,16,9,TTTCACTTATGGGCTTCACT,7,1887659
icdC_predicted,0.4,12,9,TTGGCCATGTCGAACGACGG,3,1894320
icdC_predicted,1.0,18,9,TTGCTTATATGTGCCAGTCT,9,1878371
icdC_predicted,1.2,20,9,TTGCATCGAACGAGCATACC,11,1890014
icdC_predicted,0.2,10,9,TTATTATGCGATGTTTAAAC,1,1890669
icdC_predicted,1.4,22,9,TTAGGCACGGGGAACTGGTT,13,1908255
icdC_predicted,4.5,53,9,TGTTTATCAAAATCAGAAGG,44,1886498
icdC_predicted,4.7,55,9,TGTCGGGTAGGTCTGCGGAA,46,1908244
icdC_predicted,3.1,39,9,TGTCAATAATGCAATTACAA,30,1897002
icdC_predicted,4.8,56,9,TGTAGGTGCACATATGCTCG,47,1894488
icdC_predicted,5.5,63,9,TGTAGCAAGGTCGGCGCACC,54,1892169
icdC_predicted,2.9,37,9,TGGTCCGTTTCTCGTAGAGG,28,1906447
icdC_predicted,1.5,23,9,TGGGCTCGACGCGTAGATAA,14,1879169
icdC_predicted,1.9,27,9,TGGGCGGGGACAGGGACCAT,18,1902416
icdC_predicted,9.2,100,9,TGGACAATAAAGGACAATGG,91,1885446
icdC_predicted,1.8,26,9,TGCTTGGGACATTCGAGGCC,17,1898440
icdC_predicted,1.1,19,9,TGCGTTGTCGTGTGATATTG,10,1878126
icdC_predicted,1.2,20,9,TGCGTTATTCCGTGTAGCGT,11,1892633
icdC_predicted,6.0,68,9,TGATTTCAGAAATCAGGGCA,59,1907673
icdC_predicted,5.2,60,9,TGAAAGCTAAAACGAGTTCA,51,1893402
icdC_predicted,2.4,32,9,TCGAGGGGGATGGGTGCCCC,23,1897885
icdC_predicted,4.9,57,9,TCCGGTGAACTCATCACATG,48,1901803
icdC_predicted,2.2,30,9,TCCCTCTTTATGTCCTCTCA,21,1878282
icdC_predicted,1.8,26,9,TCCCCGCTGCCACGTGGGGT,17,1902812
icdC_predicted,3.0,38,9,TCCCCCATATTTGTGGTAGA,29,1908664
icdC_predicted,0.2,10,9,TCCAACAACTTATCGATGGG,1,1888949
icdC_predicted,4.6,54,9,TCATCCTCCCGCCAGCGCCC,45,1879893
icdC_predicted,5.4,62,9,TCACTAATTGGGCCATCATA,53,1904161
icdC_predicted,2.9,37,9,TCAAGTCTTCGTGTCGTGGC,28,1882592
icdC_predicted,0.5,13,9,TATGCTCCGGGCATCAGAAG,4,1890461
icdC_predicted,0.9,17,9,TATGCAGGGGGGCATTGACA,8,1890541
icdC_predicted,1.4,22,9,TATCCGCGTTTATGCCTGTA,13,1879527
icdC_predicted,1.7,25,9,TATCCCTGCTTAATTGACAC,16,1881771
icdC_predicted,8.3,91,9,TATACCTACACAGAGGGCTA,82,1895983
icdC_predicted,1.5,23,9,TAGGGCGCTTTCACAGCGTG,14,1888917
icdC_predicted,3.8,46,9,TAGCCGTGCCCTGTGCCAGA,37,1888658
icdC_predicted,0.2,10,9,TAGCATTTGTGCTGCTTTGA,1,1905020
icdC_predicted,2.3,31,9,TAATGAGCGTAGCAGCAGTA,22,1896132
icdC_predicted,1.8,26,9,TAATCAATGGGGAGATTTTG,17,1882108
icdC_predicted,1.9,27,9,TAAATATCGAGTCTATTGCA,18,1904587
icdC_predicted,1.8,26,9,TAAACGCGGGGTAAAAGGTT,17,1906045
icdC_predicted,0.9,17,9,GTTCTAGAGAGAATAGGCAA,8,1900776
icdC_predicted,0.7,15,9,GTTCAATAACGGTACGACTT,6,1882045
icdC_predicted,1.5,23,9,GTGTCGGGCGTAATCCATGG,14,1886339
icdC_predicted,1.5,23,9,GTGCTTCTATTGTCACGTGT,14,1893192
icdC_predicted,1.0,18,9,GTGCATAACTCTGAGGGAGC,9,1904053
icdC_predicted,0.8,16,9,GTGACAGAGCTCGGGTGTAA,7,1884904
icdC_predicted,0.2,10,9,GTCCTCATAGCAATCTATAG,1,1879506
icdC_predicted,2.1,29,9,GTCCGATCGAGAGTACAAAG,20,1897793
icdC_predicted,0.2,10,9,GTCATATCGAACAACGTATT,1,1907802
icdC_predicted,2.0,28,9,GTAGGGTTGTGGACGTAAAA,19,1885563
icdC_predicted,0.2,10,9,GGTTCGGGACCAATCGAGCA,1,1902498
icdC_predicted,0.2,10,9,GGTTAGCTCCATTTATGCTT,1,1905128
icdC_predicted,1.7,25,9,GGTAGCCATAGTTGGACCAG,16,1897767
icdC_predicted,0.3,11,9,GGTAACTTCAGACGGAACTG,2,1884886
icdC_predicted,1.6,24,9,GGGTGGCCATGCCACCGTTC,15,1892289
icdC_predicted,1.7,25,9,GGGTGAACATACGACAGAAC,16,1904940
icdC_predicted,2.9,37,9,GGGAGATGTGATGAGACTCA,28,1891251
icdC_predicted,1.8,26,9,GGAATGGAGGACGGCTGGCT,17,1905791
icdC_predicted,2.7,35,9,GCTTCAGACGTCGTCGATTC,26,1898027
icdC_predicted,0.2,10,9,GCTTAAGTCTGTTATAGAGG,1,1886744
icdC_predicted,0.2,10,9,GCTCTCAGCTCACTTCGGCA,1,1880560
icdC_predicted,0.2,10,9,GCTAGTAATGGGTGTCTACA,1,1878024
icdC_predicted,1.1,19,9,GCGTGTAGTCATGCTCTGAC,10,1888934
icdC_predicted,1.1,19,9,GCGTGTACCAGCGGATGAAG,10,1893927
icdC_predicted,11.0,118,9,GCCCGTGTGTCTTGCAATCA,109,1888680
icdC_predicted,0.5,13,9,GCCCCGCCTCGGGAAGTAGT,4,1888467
icdC_predicted,2.0,28,9,GCAAGATAGCCCTCGGACTG,19,1886546
icdC_predicted,0.9,17,9,GATTTGGCCCGGGGGAGCTT,8,1885675
icdC_predicted,1.5,23,9,GATTGGCTCACCCATCTGGT,14,1878160
icdC_predicted,2.2,30,9,GATTCTTCGGAGAATACGTT,21,1889096
icdC_predicted,2.4,32,9,GATCGGGAACTACGTCCCGT,23,1905751
icdC_predicted,2.7,35,9,GATAGGAATATTTAGGGCGA,26,1882360
icdC_predicted,2.2,30,9,GATACTTTGCAAAAATGCTA,21,1899568
icdC_predicted,4.0,48,9,GATAACCCAGACCGTGGTTA,39,1897827
icdC_predicted,0.2,10,9,GAGGATATGACCTTATGGGT,1,1882364
icdC_predicted,1.5,23,9,GAGAAACTCAGAAAAAAGGC,14,1906452
icdC_predicted,1.0,18,9,GACTTGGGCCTCTGGACAGC,9,1880102
icdC_predicted,0.5,13,9,GAAGTACAATACCGGTTGAT,4,1882623
icdC_predicted,2.6,34,9,GAAGGCGCGAGCCCGCACGT,25,1894957
icdC_predicted,3.7,45,9,CTTTCCTGGGCTTACTAACC,36,1882714
icdC_predicted,7.3,81,9,CTTTACGAGATTAAAGAGAT,72,1900428
icdC_predicted,6.1,69,9,CTTGTCATCGGCACGTTCTG,60,1903840
icdC_predicted,1.7,25,9,CTCGTGAGGTCAACACAAAA,16,1895456
icdC_predicted,0.4,12,9,CTCCAGGACAATTAAGTCAA,3,1901406
icdC_predicted,1.6,24,9,CGTTTAGTCATTCGGTGCGT,15,1881800
icdC_predicted,2.0,28,9,CGTTCGTGGGAACTGGCCCT,19,1895770
icdC_predicted,1.0,18,9,CGTGCGATTAAACATAATTC,9,1898884
icdC_predicted,2.7,35,9,CGTATGGTTTGCTGTATACT,26,1890964
icdC_predicted,1.5,23,9,CGGTCTTAGAGACCAACTTC,14,1893721
icdC_predicted,0.8,16,9,CGCTTGAAGCCCGCGCGCGG,7,1907377
icdC_predicted,2.1,29,9,CGCTCATGAGACAAGACATG,20,1882484
icdC_predicted,2.0,28,9,CGATTACTAGATGTTACCCT,19,1880910
icdC_predicted,0.2,10,9,CGAGTTTTTGTGTACATGTG,1,1904191
icdC_predicted,0.3,11,9,CGACTTGGGGCTGCCGCGAG,2,1891728
icdC_predicted,1.5,23,9,CGAAATTAGCTCAAATGCTC,14,1882321
icdC_predicted,2.7,35,9,CCTCAGGTTTGGGAGAATCC,26,1880082
icdC_predicted,7.5,83,9,CCGGACGTAAACATTCTCTA,74,1883988
icdC_predicted,2.2,30,9,CCGATCATTTACTCTTGCTT,21,1889182
icdC_predicted,3.6,44,9,CCAGCGTACTGCATCCGTAT,35,1904643
icdC_predicted,2.6,34,9,CCAACGGTCGCTCGCCTAAC,25,1907091
icdC_predicted,0.3,11,9,CCAACCTGGGGTAATCATCA,2,1883611
icdC_predicted,1.3,21,9,CCAAATATGACCGTCGTTCA,12,1885459
icdC_predicted,0.2,10,9,CAGTCAACCATTTCCGGCTT,1,1903114
icdC_predicted,0.8,16,9,CAGTACGGCGTCTCCGCAAA,7,1904850
icdC_predicted,1.7,25,9,CAGTACAATATTCAGGGTTA,16,1895543
icdC_predicted,1.1,19,9,CAGCTATTCGCAAATTGTAT,10,1905659
icdC_predicted,9.6,104,9,CAGCCTCTAAAGTGGAGACC,95,1897043
icdC_predicted,0.7,15,9,CAGATATGCTCAGCAGCAAG,6,1897410
icdC_predicted,2.6,34,9,CACTCCTGGAGTAGTAACGC,25,1881501
icdC_predicted,3.2,40,9,CACTAGTCGATTATGGTAGT,31,1902770
icdC_predicted,0.2,10,9,CAAGTCACATCTTGAATCGC,1,1897245
icdC_predicted,0.6,14,9,ATTTCCTCCCAAAGCGGCGA,5,1886234
icdC_predicted,6.6,74,9,ATTTCACTAAACCATCATTA,65,1886205
icdC_predicted,0.7,15,9,ATTCCCCGGGGCAGGGTTTG,6,1905062
icdC_predicted,0.8,16,9,ATGAAGACTGCAGATATTCA,7,1887542
icdC_predicted,4.7,55,9,ATCGGTTCGTGCCGAATCAT,46,1901543
icdC_predicted,3.7,45,9,ATCGCTAAGATTATCGTTGA,36,1903767
icdC_predicted,0.2,10,9,ATCGCACTCCTACCGTTCAT,1,1888569
icdC_predicted,14.8,156,9,ATACCGTTGCCGAGCTAGGA,147,1886004
icdC_predicted,0.2,10,9,ATACAAGCGAGTGCTTTACG,1,1884408
icdC_predicted,2.3,31,9,AGTTCCCAAAGTGGAAAGTG,22,1879633
icdC_predicted,1.9,27,9,AGTAATTCACTTTAACGTGG,18,1891100
icdC_predicted,1.1,19,9,AGGTCCATTGCACTCGTTTC,10,1879593
icdC_predicted,0.3,11,9,AGGGGACTGAAAGGGAATGA,2,1899869
icdC_predicted,6.5,73,9,AGGCGTTTTACACGACTGAG,64,1897047
icdC_predicted,3.8,46,9,AGCTGGGGATCTCATTCCTT,37,1893356
icdC_predicted,6.8,76,9,AGCATATATACCCGCGGCCA,67,1902860
icdC_predicted,2.5,33,9,AGAGTATTGGTTAGTCCGAC,24,1899911
icdC_predicted,1.3,21,9,AGAGCTATGTCCCTGTATAT,12,1896147
icdC_predicted,0.8,16,9,ACGGGCAACGCCGTGTGTCA,7,1902038
icdC_predicted,2.4,32,9,ACCAGGCTACAAAAACTAAA,23,1881156
icdC_predicted,1.7,25,9,ACCAATTTGTCGCACGCAGG,16,1908716
icdC_predicted,2.5,33,9,AATTGGAACTTGGCTCCCGA,24,1885266
icdC_predicted,3.8,46,9,AATGGCCAAGCTTAAATGGG,37,1901545
icdC_predicted,0.4,12,9,AAGGTTCGCCTCGGTTCGGT,3,1878266
icdC_predicted,0.8,16,9,AACGCTTTCCCCGTGCTTGG,7,1904994
icdC_predicted,0.2,10,9,AAAGAAGCTCTCTCTACGGT,1,1905443
icdC_predicted,2.7,35,9,AAACTCGCTGTAGCGGTATC,26,1893637
icdC_predicted,7.888888888888889,78,8,TTTGCGAGCTTCATGCTTTG,70,1890649
icdC_predicted,2.6666666666666665,31,8,TTTACATGCCGAAACTCCGG,23,1878819
icdC_predicted,1.7777777777777777,23,8,TTGTGGGCCATAAGAAGGTC,15,1890871
icdC_predicted,0.2222222222222222,9,8,TTGGATGCTACACGCTTAGC,1,1907813
icdC_predicted,2.111111111111111,26,8,TTGAGCAGGGGTACTAATTT,18,1880085
icdC_predicted,0.5555555555555556,12,8,TTGACAGGGGATCCCGACAA,4,1890965
icdC_predicted,1.2222222222222223,18,8,TTCTTTGGTTTTGAATTTTC,10,1897189
icdC_predicted,0.3333333333333333,10,8,TGTTGATGATTGGCCCTACT,2,1896329
icdC_predicted,2.2222222222222223,27,8,TGTGTATTATATGTTAAAAA,19,1901844
icdC_predicted,0.2222222222222222,9,8,TGTAGAAGCTGAATATCGCG,1,1897041
icdC_predicted,2.3333333333333335,28,8,TGGTGCCCAATAGGTTCTAA,20,1892339
icdC_predicted,1.4444444444444444,20,8,TGGTAGTAGATGGGGTTAAA,12,1908151
icdC_predicted,5.111111111111111,53,8,TGGCTATTAGCCGGTGGTAT,45,1897044
icdC_predicted,3.7777777777777777,41,8,TGCTAAACGCCATGTCAAAT,33,1888590
icdC_predicted,0.8888888888888888,15,8,TGATTGTACACGAAGTTTTA,7,1900704
icdC_predicted,0.6666666666666666,13,8,TGAGACATTTCTTTTTAGCA,5,1885104
icdC_predicted,4.222222222222222,45,8,TGAAGATAAGGGGCGGAAGC,37,1894446
icdC_predicted,2.7777777777777777,32,8,TCTTAGAGGTCAAGAGCCCA,24,1881246
icdC_predicted,2.7777777777777777,32,8,TCTAATGGATGCGCAACTTC,24,1883932
icdC_predicted,0.7777777777777778,14,8,TCTAAGCTTATATCGCGCTC,6,1893933
icdC_predicted,3.111111111111111,35,8,TCGCGAGCCTGCAATGTCCC,27,1893537
icdC_predicted,6.333333333333333,64,8,TCGATAGTTGAGTTATCCGG,56,1889524
icdC_predicted,1.6666666666666667,22,8,TCCGTGCCTCCCCTATAGCA,14,1881590
icdC_predicted,2.2222222222222223,27,8,TCCGGAGGGGAGGAAAGCCT,19,1880998
icdC_predicted,1.3333333333333333,19,8,TATTTATTTGATCAATGGAC,11,1891388
icdC_predicted,3.0,34,8,TATCTGTGATGTATATCGCA,26,1907462
icdC_predicted,1.2222222222222223,18,8,TATCTCTGTGGTGCTCCCGC,10,1897493
icdC_predicted,2.4444444444444446,29,8,TATAGTCGGAAAGGCAACGT,21,1899390
icdC_predicted,5.666666666666667,58,8,TAGCCACAGCGCACAATAAG,50,1882643
icdC_predicted,2.6666666666666665,31,8,TAGACTACGGATAGTAGCGG,23,1883731
icdC_predicted,2.7777777777777777,32,8,TAATTAAGTTTCGGTGCATA,24,1897120
icdC_predicted,4.444444444444445,47,8,TAAACGTTGGTAGCCTTTAA,39,1882774
icdC_predicted,3.6666666666666665,40,8,TAAAACCTCATGATGGTAAG,32,1885328
icdC_predicted,0.7777777777777778,14,8,GTTTCCGGTCACACGTGTAA,6,1884237
icdC_predicted,1.1111111111111112,17,8,GTTATAATTCAAATATAGAA,9,1908930
icdC_predicted,2.888888888888889,33,8,GTGCTAAATTGAACTCCTAA,25,1896220
icdC_predicted,2.2222222222222223,27,8,GTGCAGACTCTTCATTAGCA,19,1898576
icdC_predicted,7.777777777777778,77,8,GTGAGTTGACGTAAACATGC,69,1890646
icdC_predicted,1.3333333333333333,19,8,GTCAACTGCAGACTAGGGTA,11,1893452
icdC_predicted,0.3333333333333333,10,8,GTAGGGCATTGCAAGACGTT,2,1896330
icdC_predicted,3.3333333333333335,37,8,GTAGACCAGACCTTCGGTTT,29,1890343
icdC_predicted,1.8888888888888888,24,8,GTAAAAGACAAATCATACAG,16,1903007
icdC_predicted,5.333333333333333,55,8,GTAAAAAGCTGCTATCTAGG,47,1896872
icdC_predicted,1.3333333333333333,19,8,GGTTGACTTCCTGCACGGCT,11,1901267
icdC_predicted,0.8888888888888888,15,8,GGTGTTTAGACGGTGCACCC,7,1900462
icdC_predicted,0.3333333333333333,10,8,GGGTGCCGACACTTATAGGT,2,1888145
icdC_predicted,0.6666666666666666,13,8,GGGTACGGCACCCTTAGAGC,5,1889529
icdC_predicted,1.4444444444444444,20,8,GGGGGCTGTAGCACGCTGCA,12,1894210
icdC_predicted,0.2222222222222222,9,8,GGGCGGGCCTCGGGCTCACG,1,1878831
icdC_predicted,3.4444444444444446,38,8,GGGATGCCGGCGGGTGGGAG,30,1903959
icdC_predicted,1.5555555555555556,21,8,GGGAGCCATGAAACACACTG,13,1893723
icdC_predicted,0.4444444444444444,11,8,GGCTCGTCTCAGTCACAGAC,3,1899242
icdC_predicted,3.7777777777777777,41,8,GGCCGACCATCGTGGTCACA,33,1881613
icdC_predicted,0.5555555555555556,12,8,GGATTAGGAACTGCTCAATG,4,1888460
icdC_predicted,2.5555555555555554,30,8,GGATCCTGGAGTGCTAGTAG,22,1892079
icdC_predicted,0.4444444444444444,11,8,GCGTAATGCGAGGCGTCGTT,3,1886775
icdC_predicted,0.8888888888888888,15,8,GCGGTACTCCGCAGGGATAT,7,1898314
icdC_predicted,0.2222222222222222,9,8,GCGGCCATGTCCTCAAACCA,1,1892611
icdC_predicted,2.2222222222222223,27,8,GCCGTAATTGTGGTCAGACT,19,1899894
icdC_predicted,3.6666666666666665,40,8,GCCGAAGGTATACAGCATCT,32,1893913
icdC_predicted,6.555555555555555,66,8,GCATCAATTCCATGGAGGCC,58,1893996
icdC_predicted,0.3333333333333333,10,8,GCACTTTGACCTATCTAGTT,2,1886556
icdC_predicted,1.0,16,8,GCAAGGTGCACTCTCTTCAT,8,1884847
icdC_predicted,1.2222222222222223,18,8,GATTGCAATGTCACACTTCT,10,1902048
icdC_predicted,2.4444444444444446,29,8,GATCTTCCAGGGCAAGCGGT,21,1899505
icdC_predicted,2.3333333333333335,28,8,GATACCGACAACAGACATGG,20,1901094
icdC_predicted,1.7777777777777777,23,8,GATAATGCTCCAACGTAAGC,15,1907325
icdC_predicted,3.111111111111111,35,8,GATAAACAAGAAAGGGAGTT,27,1888802
icdC_predicted,1.6666666666666667,22,8,GAGTGAGTGAATCTCACACA,14,1896494
icdC_predicted,0.8888888888888888,15,8,GAGCAGCTATTTTGCGCCGA,7,1897868
icdC_predicted,1.7777777777777777,23,8,GAGCAACTGTTTGTCTGTCA,15,1878414
icdC_predicted,1.6666666666666667,22,8,GAGAGAGGATAGGGTCACCT,14,1907429
icdC_predicted,1.4444444444444444,20,8,GACCGCTATGGTTTTTCCGA,12,1885625
icdC_predicted,2.5555555555555554,30,8,GAAGGGTAGCGGCTCATGGG,22,1887617
icdC_predicted,4.555555555555555,48,8,GAAGATAGTTCATAGTGTAC,40,1897428
icdC_predicted,2.4444444444444446,29,8,CTTGCTGGTTTGTTGTTTGA,21,1898097
icdC_predicted,1.3333333333333333,19,8,CTTCGAGAGTGCCCTGGGGT,11,1887004
icdC_predicted,3.111111111111111,35,8,CTGTTTATAAACGTCTGGAT,27,1892355
icdC_predicted,2.6666666666666665,31,8,CTGGATAACAGTTGAGCTGA,23,1903103
icdC_predicted,3.7777777777777777,41,8,CTGGACGGGACGCGTGGGTT,33,1892904
icdC_predicted,1.7777777777777777,23,8,CTGGAAGGGTGATCCGATAT,15,1895887
icdC_predicted,7.222222222222222,72,8,CTGCTTGTGCTGGCTCTGTT,64,1902711
icdC_predicted,6.444444444444445,65,8,CTGCGTTACCGCCCTACCCC,57,1878563
icdC_predicted,0.2222222222222222,9,8,CTGACGAATAGATGTTTGGT,1,1906244
icdC_predicted,2.7777777777777777,32,8,CGCCTATAGAGGGAGGACTT,24,1885695
icdC_predicted,0.2222222222222222,9,8,CGCCCTGCCGATCGTTAACG,1,1901667
icdC_predicted,0.2222222222222222,9,8,CGCAATACTGAAACCTACTC,1,1878251
icdC_predicted,0.3333333333333333,10,8,CGCAAGGCGCTGCAGAGGGC,2,1892516
icdC_predicted,3.7777777777777777,41,8,CGACGATCTGTGTCATTCGC,33,1882166
icdC_predicted,2.4444444444444446,29,8,CCTTCATACTAACGCCCAGG,21,1888625
icdC_predicted,1.4444444444444444,20,8,CCTAAGCCTGCTTTGTCTGG,12,1882852
icdC_predicted,1.1111111111111112,17,8,CCCAACGAGTACAACACTCC,9,1891935
icdC_predicted,1.4444444444444444,20,8,CCATTCAGCGAACGCCGACA,12,1907127
icdC_predicted,0.2222222222222222,9,8,CCATTAATCAAGCGTTAGAT,1,1899648
icdC_predicted,3.2222222222222223,36,8,CATTTGGGCAGTACTAACAG,28,1892109
icdC_predicted,1.4444444444444444,20,8,CATTACTAATTCATCCCTGA,12,1896853
icdC_predicted,2.888888888888889,33,8,CATCCAAATTTATTAAATCC,25,1900534
icdC_predicted,2.3333333333333335,28,8,CAGTTGCGTATGGCGATTGT,20,1894420
icdC_predicted,0.2222222222222222,9,8,CAGCTACTATCCGATACTCA,1,1881099
icdC_predicted,8.222222222222221,81,8,CAGCATCCTTTATAAATCAC,73,1892472
icdC_predicted,1.2222222222222223,18,8,CAGCAGACGGAGAGAGTAAT,10,1881588
icdC_predicted,3.0,34,8,CAAAGACGTCCGCCGCCAAA,26,1908657
icdC_predicted,3.2222222222222223,36,8,ATTTTTGGGTTCATCATGTA,28,1900144
icdC_predicted,1.4444444444444444,20,8,ATTTCCAGCGTGTGCCGCGG,12,1893644
icdC_predicted,1.5555555555555556,21,8,ATTTAACGACGTCCCCCGTG,13,1886715
icdC_predicted,2.0,25,8,ATTCAACTGTGCCTCGTCCA,17,1878775
icdC_predicted,0.2222222222222222,9,8,ATCTTAGGGGCAAGACGGGT,1,1888768
icdC_predicted,10.222222222222221,99,8,ATCTAACCAGCAGTTAAGAC,91,1892811
icdC_predicted,0.3333333333333333,10,8,ATCGAAGTAGGGGCGGTAGG,2,1880225
icdC_predicted,1.8888888888888888,24,8,ATCCCAAACATAAGCAGACA,16,1893375
icdC_predicted,2.2222222222222223,27,8,ATCAGGTTAACCCTTGCCAT,19,1891886
icdC_predicted,7.444444444444445,74,8,ATATCTTTCTTAAAAATCAA,66,1885471
icdC_predicted,3.2222222222222223,36,8,ATAAATAACCCATGCTGAAC,28,1894082
icdC_predicted,1.8888888888888888,24,8,AGTCGTACCATCCCAAACCT,16,1882844
icdC_predicted,8.88888888888889,87,8,AGTAGTCCGGCTGGGACGGT,79,1898880
icdC_predicted,1.8888888888888888,24,8,AGTAGGCGAAGAGCCTTTGC,16,1905201
icdC_predicted,3.0,34,8,AGGCGAGTGGATCGCAAGAC,26,1908739
icdC_predicted,6.888888888888889,69,8,AGGAGTGATCGACGAGACTA,61,1896013
icdC_predicted,0.8888888888888888,15,8,AGACCTCATACCAAGCTTCG,7,1908655
icdC_predicted,1.2222222222222223,18,8,ACTCGCGTCCAGTATGTGGA,10,1882145
icdC_predicted,0.4444444444444444,11,8,ACTCATTAGCAACGCCGCCT,3,1898362
icdC_predicted,2.2222222222222223,27,8,ACGTTGTGGCGCTATCTTTG,19,1908276
icdC_predicted,1.5555555555555556,21,8,ACGGACAAGGGGAGCATGTG,13,1878963
icdC_predicted,1.1111111111111112,17,8,ACGCCGCAAGTGTGTTTCTG,9,1896080
icdC_predicted,0.5555555555555556,12,8,ACGACTGGCTGTTGCACCGG,4,1897277
icdC_predicted,1.0,16,8,ACCGTGGGACTGCCTCGAGT,8,1892951
icdC_predicted,0.2222222222222222,9,8,ACCGCCGGATAACGGCATAC,1,1878668
icdC_predicted,2.0,25,8,ACATGTGCGCTGATTTTTTA,17,1886928
icdC_predicted,2.5555555555555554,30,8,ACACTTAACGTCGATCGTAC,22,1903796
icdC_predicted,0.2222222222222222,9,8,ACACATATTGGCGAGCGTTC,1,1902148
icdC_predicted,2.2222222222222223,27,8,AAGAGCGGGGTAAATCTTGT,19,1878448
icdC_predicted,0.2222222222222222,9,8,AAGAAGACCTTTAAACTCGT,1,1894374
icdC_predicted,2.0,25,8,AACCAGCTCAGGTTTAGCGT,17,1901394
icdC_predicted,2.7777777777777777,32,8,AAAATGTTCGCCCAACGAAA,24,1879947
icdC_predicted,2.0,25,8,AAAACAGAGGGTGTTTCTGT,17,1890066
icdC_predicted,2.125,23,7,TTTCGGATTTACAGAAGTCT,16,1881202
icdC_predicted,2.125,23,7,TTGGTAACCACCCTCAACGT,16,1899819
icdC_predicted,3.5,34,7,TTGGGTGAACCTGGCGATGT,27,1880844
icdC_predicted,3.0,30,7,TTGATTATACTCGGTGATCC,23,1882656
icdC_predicted,1.625,19,7,TTGATGCGCGATCCGTAAAT,12,1892497
icdC_predicted,1.875,21,7,TTCTCCGCCCTACTCACCAG,14,1879114
icdC_predicted,1.5,18,7,TTAGGATTGTCCGTTGGCGA,11,1881505
icdC_predicted,2.625,27,7,TTACCGTACTGTACGGCCAA,20,1908454
icdC_predicted,0.25,8,7,TGTTAGTCGATAACGCATGT,1,1890146
icdC_predicted,1.625,19,7,TGTAGCGAGGAAAGGTCGGA,12,1896032
icdC_predicted,6.125,55,7,TGGCTACCCGTCATAGAGCA,48,1897090
icdC_predicted,0.625,11,7,TGCGTGGTCAAAGGCAACAC,4,1908829
icdC_predicted,5.75,52,7,TGCGTCTTCCGATTTATGTG,45,1900864
icdC_predicted,2.625,27,7,TGCGGCTGCATTAGCAATTT,20,1909063
icdC_predicted,12.625,107,7,TGCCACGTTAAACGGTGCTG,100,1897791
icdC_predicted,3.625,35,7,TGAATAAATGTCATCGGACC,28,1894472
icdC_predicted,2.25,24,7,TCTTTGACATACAGTTCATG,17,1890095
icdC_predicted,3.0,30,7,TCTTGGTTACGGCGCAAACC,23,1889469
icdC_predicted,0.25,8,7,TCTCTCGAGTAGGCATGTTA,1,1906057
icdC_predicted,1.375,17,7,TCTATGTGAACGGCACACTG,10,1881697
icdC_predicted,1.5,18,7,TCGGTTACGTTATAGTCCTT,11,1880793
icdC_predicted,5.5,50,7,TCGGATTATATCTGATGCCT,43,1883934
icdC_predicted,5.375,49,7,TCCATTCTTTAAGTTCCCCC,42,1889521
icdC_predicted,2.625,27,7,TCAGCACGGGCCGAGGCAGC,20,1879679
icdC_predicted,5.875,53,7,TCAAGTATCCGTCGAGACTT,46,1887002
icdC_predicted,0.25,8,7,TCAAACTTGACTTGTAATAC,1,1889992
icdC_predicted,1.875,21,7,TATTGAGGTGACTCTGGTTT,14,1908016
icdC_predicted,3.75,36,7,TATTGACCCACCCCTTACCT,29,1885666
icdC_predicted,2.375,25,7,TATGCAACTGAGTCCACCGT,18,1895081
icdC_predicted,0.25,8,7,TAGCATAGATAAGGCAAAAT,1,1887678
icdC_predicted,0.375,9,7,TAATGGCGTGTTGCCTTTTT,2,1904196
icdC_predicted,2.125,23,7,TAACGCTTGCTGAACTCAGA,16,1894396
icdC_predicted,3.625,35,7,TAAACTAATTCATGTCATCC,28,1894548
icdC_predicted,4.25,40,7,GTGGTAACGGCGGTAGCTGG,33,1893503
icdC_predicted,3.5,34,7,GTCCGTTGGTCTGTGGTAAT,27,1882165
icdC_predicted,2.125,23,7,GTAATACACACCGTCCAACT,16,1908393
icdC_predicted,4.75,44,7,GTAAACCGTAGCCTAGGGGC,37,1901264
icdC_predicted,9.0,78,7,GGTTTTCTGGGGGGCCGTGT,71,1890657
icdC_predicted,0.25,8,7,GGTGGGGTACCACGGGTGCT,1,1884870
icdC_predicted,0.25,8,7,GGTAATCCCGGTGCCGGAGC,1,1892733
icdC_predicted,3.25,32,7,GGGTGCAGGTTACACTAAGA,25,1901279
icdC_predicted,0.25,8,7,GGGAGGCGCTGGGGTTATTA,1,1885254
icdC_predicted,2.875,29,7,GGCCGGAGCTGACCCCATCG,22,1889678
icdC_predicted,1.625,19,7,GGATCGTTGTATTAGGCGTA,12,1892537
icdC_predicted,2.75,28,7,GGATACATGCAGTTTCTGCG,21,1884461
icdC_predicted,0.25,8,7,GGACAGCATGTTCAAGAACT,1,1901424
icdC_predicted,1.75,20,7,GGAAGGTCGGTCGGTGGTAT,13,1906002
icdC_predicted,0.25,8,7,GCTTCATAACTGTCTATTAG,1,1908681
icdC_predicted,0.875,13,7,GCTTAATGATACTAGGTCTC,6,1901120
icdC_predicted,3.375,33,7,GCTGGAGCCGCATACCTCGG,26,1887842
icdC_predicted,0.25,8,7,GCACCCGATCATCTGGAACT,1,1896457
icdC_predicted,2.5,26,7,GCAAAGTCCTACACCGGTCG,19,1886172
icdC_predicted,5.0,46,7,GACTGGTTACGGCGTTTGAC,39,1879903
icdC_predicted,1.5,18,7,CTTTTGTTCACGGACATCGG,11,1886856
icdC_predicted,5.375,49,7,CTTAATTTCAGCGGCCCGCA,42,1901114
icdC_predicted,2.75,28,7,CTGTGACTTTAGTATGTGCT,21,1896866
icdC_predicted,18.625,155,7,CTGGAGCCGGCATAGGCGGG,148,1907065
icdC_predicted,2.375,25,7,CTGCTTAGGGCAGATAGCGT,18,1907680
icdC_predicted,1.625,19,7,CTGACGGTTGCGCATGGATA,12,1894764
icdC_predicted,2.25,24,7,CTGAATTTATCAATCAATAA,17,1886614
icdC_predicted,4.625,43,7,CTCTGAAATTTGACTAGGCA,36,1900762
icdC_predicted,3.5,34,7,CTCCACGCGTAACTTTCGGA,27,1882860
icdC_predicted,1.875,21,7,CTAATCAAGTTGGCGTGTAC,14,1906460
icdC_predicted,1.25,16,7,CGTGGGGCGGACACCCCCCT,9,1892240
icdC_predicted,12.25,104,7,CGTATCTTATGTTATCTCTG,97,1877900
icdC_predicted,2.5,26,7,CGGCTTTTTCTATACTCAGA,19,1890824
icdC_predicted,4.5,42,7,CGCTAGCAAATCCAGGAATA,35,1891807
icdC_predicted,1.5,18,7,CGCCTTTAGGCCTTGAGATA,11,1902042
icdC_predicted,2.25,24,7,CGCCGCACTAATATTGCCGT,17,1885062
icdC_predicted,2.625,27,7,CGACTCCTTATTAAAGGCGG,20,1889677
icdC_predicted,0.875,13,7,CCTCGTTATTAATGAGTCCT,6,1893519
icdC_predicted,0.5,10,7,CCTCACCCTGGTCCACGTCT,3,1906429
icdC_predicted,2.625,27,7,CCGTACGGCCGGGATACGTA,20,1901987
icdC_predicted,2.125,23,7,CCCCCTCGGCGCATTTTTGA,16,1901015
icdC_predicted,0.5,10,7,CCCACTCAGGAGGCATTTTG,3,1891344
icdC_predicted,2.625,27,7,CCAGACATCATCACTATAAC,20,1885984
icdC_predicted,2.5,26,7,CCACTGGCAAACAATCTCTT,19,1878037
icdC_predicted,0.25,8,7,CCACCGGTGGTTAGGTTATG,1,1889550
icdC_predicted,1.875,21,7,CCAATATGGTGTCGGCTAAG,14,1902391
icdC_predicted,0.625,11,7,CATTATTGATACGGCTTAAG,4,1884717
icdC_predicted,3.0,30,7,CATGAAAGTGCAATCTCCAT,23,1884424
icdC_predicted,1.625,19,7,CAGGCGGGTTAGGGTAAAGC,12,1884460
icdC_predicted,0.5,10,7,CAGCTCGTCGTCTGCGTACG,3,1878152
icdC_predicted,3.125,31,7,CAGCACAAGCAATAGAAATT,24,1903633
icdC_predicted,0.25,8,7,CACCCCCGCGGCGTTAAATT,1,1892521
icdC_predicted,0.625,11,7,CAAGTTGGACAGTTCGGGAC,4,1893576
icdC_predicted,5.25,48,7,CAACATCGCTCCGCCACATG,41,1885481
icdC_predicted,1.125,15,7,CAAAGGCCGGTATAGTCACG,8,1893616
icdC_predicted,0.25,8,7,ATTTAAATTTCCGATAACAA,1,1908971
icdC_predicted,0.25,8,7,ATTCGTGGTGTTTTTAACAC,1,1899079
icdC_predicted,2.75,28,7,ATTAGGACAGGCGGATCGAT,21,1884759
icdC_predicted,2.25,24,7,ATTAGGAAGTCCGGTATGAC,17,1894393
icdC_predicted,3.75,36,7,ATGTGGATCCTAATGTACGC,29,1879923
icdC_predicted,5.75,52,7,ATGTGAACATCACCAATTTG,45,1879889
icdC_predicted,2.375,25,7,ATGTAATCGCCCTCTGGCCA,18,1897222
icdC_predicted,1.625,19,7,ATGAACTAAATTCCCGGTCT,12,1908644
icdC_predicted,1.5,18,7,ATCCTTTGAGTCGAATCTAG,11,1883439
icdC_predicted,0.25,8,7,ATATCGGTCAACCGCACGTC,1,1896090
icdC_predicted,1.625,19,7,ATAGTCGGACGTCACCGCTT,12,1889681
icdC_predicted,5.875,53,7,ATAGGGAATATCCCAAATTT,46,1878363
icdC_predicted,1.0,14,7,ATAACCACGACTGGAAGAAG,7,1885515
icdC_predicted,4.625,43,7,AGTGGACTGGCATCAACCCT,36,1880341
icdC_predicted,4.875,45,7,AGTCCGAGTCCGCCAATGGG,38,1898960
icdC_predicted,7.125,63,7,AGGTTTTGCAATTATGTCCA,56,1892157
icdC_predicted,2.25,24,7,AGCCGCCCCACGCTACCCGT,17,1888677
icdC_predicted,2.5,26,7,AGATGTGGTAGAATGGGCCT,19,1886104
icdC_predicted,3.75,36,7,AGATCCCAGACTGTATACAT,29,1878198
icdC_predicted,9.0,78,7,AGAGCGGCTATACCATAGGC,71,1890724
icdC_predicted,4.75,44,7,AGAATTAACGCGCAGGGCAG,37,1884905
icdC_predicted,0.25,8,7,ACTTATCTGGCGCATTGGTG,1,1895045
icdC_predicted,2.5,26,7,ACTGTTTTCACATGACATAA,19,1878180
icdC_predicted,1.25,16,7,ACTCGCGTGGAATTGACAGA,9,1889483
icdC_predicted,0.25,8,7,ACGTGTGTATTGCATATATA,1,1882820
icdC_predicted,2.75,28,7,ACAGAATATCACTGGCTAAA,21,1893243
icdC_predicted,5.875,53,7,ACAAAACCGTGACGTTGAGT,46,1888890
icdC_predicted,2.25,24,7,AATGAACCGGCTAGTCACTA,17,1881388
icdC_predicted,0.25,8,7,AATCCGCACATCTGATGCTC,1,1886533
icdC_predicted,1.25,16,7,AAGTGCGCCAGGGGCAGACC,9,1878623
icdC_predicted,1.75,20,7,AAGCCACGCTGAGTGAACCT,13,1878662
icdC_predicted,1.0,14,7,AAGACGGAAGTACGTGACCA,7,1902180
icdC_predicted,2.25,24,7,AAAGTTCGTATGACTCGGCA,17,1892067
icdC_predicted,2.375,25,7,AAAGGCAGTCAGGGCGGGCA,18,1907101
icdC_predicted,1.75,20,7,AAAGACCGGGTACCAGACAG,13,1904067
icdC_predicted,0.375,9,7,AAAGAACGCGGAACGAAAAT,2,1884714
icdC_predicted,4.285714285714286,35,6,TTTTATAGCATCCAGCGGCT,29,1902705
icdC_predicted,5.0,40,6,TTTCTTCACCCAGGTGAGTG,34,1888672
icdC_predicted,2.857142857142857,25,6,TTGCAGCGTGATGTTCAGAT,19,1904751
icdC_predicted,0.2857142857142857,7,6,TTGATTCGTTGCCTTGAGCA,1,1892402
icdC_predicted,5.142857142857143,41,6,TTCACAGATACAATCCGTAA,35,1894477
icdC_predicted,2.7142857142857144,24,6,TTATAGTTCAGCTAAATCAA,18,1904766
icdC_predicted,1.2857142857142858,14,6,TTACGTCCAAGTATATATTC,8,1893170
icdC_predicted,0.7142857142857143,10,6,TTAAGTGTAGATCTTGATAT,4,1906675
icdC_predicted,0.2857142857142857,7,6,TTAACATATTGGGGGTTTTC,1,1882954
icdC_predicted,1.7142857142857142,17,6,TGTTGAGTCATACCTCGGTT,11,1903532
icdC_predicted,3.142857142857143,27,6,TGTGTGGTTCCCACTCAAAA,21,1901972
icdC_predicted,3.0,26,6,TGTGGCCATCTCGGGCGGAT,20,1882046
icdC_predicted,1.2857142857142858,14,6,TGCGTAGTCAAGGTGGAAAA,8,1878359
icdC_predicted,2.5714285714285716,23,6,TGATCCGCGGCCGTGCTTTC,17,1893194
icdC_predicted,4.428571428571429,36,6,TCTTGCCAAGTTGCTGGTCA,30,1883838
icdC_predicted,0.2857142857142857,7,6,TCTTCTGCGTTAGGAGTAAT,1,1900087
icdC_predicted,3.7142857142857144,31,6,TCTTAGGAAATCCTAAGGAA,25,1888349
icdC_predicted,0.2857142857142857,7,6,TCTTAAAGGAAACAATTTGT,1,1887687
icdC_predicted,3.2857142857142856,28,6,TCTGGAATCATAACAAAAGG,22,1884023
icdC_predicted,5.857142857142857,46,6,TCTCGATCGCCGCGTCGTCT,40,1900960
icdC_predicted,1.8571428571428572,18,6,TCTAAAGATAGAGCGCGCAA,12,1893898
icdC_predicted,1.4285714285714286,15,6,TCGTGCCCACTAACCCAATT,9,1896924
icdC_predicted,0.8571428571428571,11,6,TCGTCCTGCGTCACATCCCA,5,1884702
icdC_predicted,4.285714285714286,35,6,TCGGGATCTGTGGCAGGTAC,29,1891754
icdC_predicted,2.0,19,6,TCGCGACCGTCTTGAGCAGA,13,1902593
icdC_predicted,3.2857142857142856,28,6,TCGACTTTCACCTCAAGATC,22,1890835
icdC_predicted,1.0,12,6,TCCCTATTATTATTTATATC,6,1885581
icdC_predicted,3.2857142857142856,28,6,TATTGTCTCGGCAATGTCAT,22,1892387
icdC_predicted,2.5714285714285716,23,6,TATGTCGAAGCAAATCGCCC,17,1899920
icdC_predicted,1.0,12,6,TATCTGATCTTGGATTTAAA,6,1884061
icdC_predicted,3.0,26,6,TAGGATTATCTCGTTATCGC,20,1887397
icdC_predicted,0.2857142857142857,7,6,TAATTCGTGGGAGGGGCGAT,1,1904516
icdC_predicted,5.142857142857143,41,6,TAATAGCTCAAGTGCAACTT,35,1888908
icdC_predicted,0.8571428571428571,11,6,TAAGGGTAGCACTATGTCCG,5,1889843
icdC_predicted,0.2857142857142857,7,6,TAAGAATAGTTAACAGACCT,1,1895436
icdC_predicted,0.42857142857142855,8,6,TAACTGGCCTCATACGCTCC,2,1895478
icdC_predicted,3.4285714285714284,29,6,TAACTCTCGCCCTTGAAGGT,23,1909274
icdC_predicted,3.7142857142857144,31,6,TAACAGGGTAACATTCAGAA,25,1879445
icdC_predicted,1.4285714285714286,15,6,GTGCGTATAACAATTACATT,9,1905427
icdC_predicted,0.2857142857142857,7,6,GTGCCAGGCGGAAATCCAAT,1,1887199
icdC_predicted,0.2857142857142857,7,6,GTGAGTGAGAGAGATCTGGT,1,1884602
icdC_predicted,3.2857142857142856,28,6,GTCTTGAGTAAGACCCTGAA,22,1879797
icdC_predicted,2.2857142857142856,21,6,GTCTGCCACGGAGATTGTTA,15,1893734
icdC_predicted,1.8571428571428572,18,6,GTCGCCCAGAAGTTGAACGT,12,1897957
icdC_predicted,4.714285714285714,38,6,GTCCTCTTCTCGACGTATTC,32,1907071
icdC_predicted,0.2857142857142857,7,6,GTCCGCCTTCTCGCCGCCAT,1,1890129
icdC_predicted,1.8571428571428572,18,6,GTCACCATGTAATGTCCGCC,12,1909377
icdC_predicted,0.2857142857142857,7,6,GTAGTAGTTATTCTCTAGAC,1,1895362
icdC_predicted,0.42857142857142855,8,6,GGTGACTCCTCTTCCGCGTG,2,1898335
icdC_predicted,2.7142857142857144,24,6,GGGTACGGTACTTGTGTGGG,18,1881504
icdC_predicted,1.4285714285714286,15,6,GGGGCTACGTGACACATGTT,9,1891740
icdC_predicted,9.714285714285714,73,6,GGGATGGTATAATAGTCGCT,67,1905101
icdC_predicted,3.2857142857142856,28,6,GGGAGCAGCTGGAATACTGA,22,1887043
icdC_predicted,3.857142857142857,32,6,GGCGTTATTATTTGATCAAA,26,1908849
icdC_predicted,0.8571428571428571,11,6,GGCATCGTCGAAACCGGACC,5,1883380
icdC_predicted,1.0,12,6,GGATTTAGCACAGTTGCATA,6,1880091
icdC_predicted,2.2857142857142856,21,6,GGATAGAAGGCTGCGATGAT,15,1891633
icdC_predicted,2.0,19,6,GGAGCAAGCAATAAGATAGC,13,1887722
icdC_predicted,0.5714285714285714,9,6,GCTGGGCTGGGCGTCGTGGC,3,1901370
icdC_predicted,4.714285714285714,38,6,GCTGAATCAGGTCTTACTCT,32,1883783
icdC_predicted,1.7142857142857142,17,6,GCTCCGGTTCAAAGCGCACT,11,1905860
icdC_predicted,0.7142857142857143,10,6,GCTATTCGTCCCTAGTAAAC,4,1908903
icdC_predicted,8.857142857142858,67,6,GCGTAGCCCGATACCAGGGG,61,1888877
icdC_predicted,1.5714285714285714,16,6,GCGGCTACAAGTTGAGAGTT,10,1885503
icdC_predicted,3.857142857142857,32,6,GCGCTAACGTGTTGAATTTA,26,1908369
icdC_predicted,3.142857142857143,27,6,GCGAACCCCGTGACAGTATC,21,1892300
icdC_predicted,1.0,12,6,GCATTTCTTCGTCCGAGCAG,6,1904474
icdC_predicted,3.142857142857143,27,6,GCATCAACTAATAACACAAA,21,1882433
icdC_predicted,5.285714285714286,42,6,GCATACTCACGAAATAACCC,36,1890723
icdC_predicted,1.1428571428571428,13,6,GATGTTTCTGTGCCGCTCAT,7,1891369
icdC_predicted,2.5714285714285716,23,6,GAGTCGTGCCTAACGGGAAC,17,1908937
icdC_predicted,0.2857142857142857,7,6,GAGTCCAGACTTCGTCGAGG,1,1878093
icdC_predicted,0.42857142857142855,8,6,GACCGTGACCCTTGTCTGGG,2,1902390
icdC_predicted,5.571428571428571,44,6,GACAGGCTAGGAAGTTTTTT,38,1892373
icdC_predicted,3.142857142857143,27,6,GAACGCTTGTGGGAACCAAA,21,1896978
icdC_predicted,4.142857142857143,34,6,GAAATTAATAACAGAACTTT,28,1900827
icdC_predicted,3.4285714285714284,29,6,CTTCCATTATGGTGGTCGAA,23,1906288
icdC_predicted,4.571428571428571,37,6,CTTACAGAAGTTAGGCGAGA,31,1878036
icdC_predicted,3.7142857142857144,31,6,CTGTCCAAATCTAGAATCAG,25,1895999
icdC_predicted,0.2857142857142857,7,6,CTGGTGCATGCCGCTGGAAT,1,1894945
icdC_predicted,4.142857142857143,34,6,CTGGCGGCCATTATTTATAC,28,1904247
icdC_predicted,3.142857142857143,27,6,CTGGACCCGGCTGGGCCTTA,21,1898409
icdC_predicted,2.2857142857142856,21,6,CTGCATTCTAGAACGTAATG,15,1883777
icdC_predicted,9.285714285714286,70,6,CTACGATCGTCTCTCGTTTT,64,1908573
icdC_predicted,0.2857142857142857,7,6,CGTGTAACAAATAGGTTATT,1,1887923
icdC_predicted,1.8571428571428572,18,6,CGTCGTTCCGTGCGCTTTAG,12,1880938
icdC_predicted,0.2857142857142857,7,6,CGGGCTAGACCTTCGCTGTA,1,1891772
icdC_predicted,0.2857142857142857,7,6,CGGGAAGGCGTGGAATGGAA,1,1899507
icdC_predicted,1.4285714285714286,15,6,CGGCATTACCCAATAGTCTG,9,1905807
icdC_predicted,3.5714285714285716,30,6,CGATCGGAAGGGGTAGGGAT,24,1901846
icdC_predicted,5.0,40,6,CGACACGCGCATTTTGAGTA,34,1882894
icdC_predicted,3.4285714285714284,29,6,CGAATACGCTATTAGACAGT,23,1901057
icdC_predicted,3.857142857142857,32,6,CGAACAGCTTGAACGGGTAT,26,1903734
icdC_predicted,2.4285714285714284,22,6,CCTTTCCGCGCCCCGCTCAT,16,1897179
icdC_predicted,3.142857142857143,27,6,CCTCCGAGCTACCGTAGGTA,21,1883928
icdC_predicted,8.428571428571429,64,6,CCGAATTCAGCGCGTTCCAA,58,1887877
icdC_predicted,1.8571428571428572,18,6,CCCAGATAGATCCGGATGGA,12,1904342
icdC_predicted,1.7142857142857142,17,6,CCACGTATTGTAACGGTGAC,11,1897723
icdC_predicted,1.4285714285714286,15,6,CCAAGCATTTCTGGGCCACC,9,1882084
icdC_predicted,0.42857142857142855,8,6,CATTGCAATCATTAGATTAC,2,1888567
icdC_predicted,0.42857142857142855,8,6,CATGCTTAGGGAGCAACAGA,2,1904551
icdC_predicted,3.4285714285714284,29,6,CATCGTAAGATGGGCTTCGC,23,1897616
icdC_predicted,7.428571428571429,57,6,CAGGGTATACGCTCCCCAAC,51,1888451
icdC_predicted,3.2857142857142856,28,6,CACTTTCGATAATCGACTCA,22,1884218
icdC_predicted,1.0,12,6,CACGTTTCTCGGGTCTTCAA,6,1899753
icdC_predicted,2.5714285714285716,23,6,CACCTACCAGGGCGGGCTTG,17,1907842
icdC_predicted,4.285714285714286,35,6,CACCCGGACCTGTCTCCACA,29,1893761
icdC_predicted,4.714285714285714,38,6,CAACTCCTAAACGTATTGTG,32,1886021
icdC_predicted,3.5714285714285716,30,6,CAAACCACCCGGTCTGAAGC,24,1890892
icdC_predicted,3.5714285714285716,30,6,ATTGATCGGATTGACAGGCA,24,1883714
icdC_predicted,3.2857142857142856,28,6,ATTCGCGCAATTCTTAAGGG,22,1882306
icdC_predicted,8.857142857142858,67,6,ATTAGATTGCCAGATAGAGG,61,1898042
icdC_predicted,0.8571428571428571,11,6,ATGTAACAATGTAGCAAGAT,5,1908066
icdC_predicted,0.8571428571428571,11,6,ATGCGATGGCGCTTTACTCC,5,1896310
icdC_predicted,0.2857142857142857,7,6,ATCGGGGAGCAATAGGGACA,1,1891580
icdC_predicted,2.0,19,6,ATCGGAAACCCGACACTATG,13,1883288
icdC_predicted,0.2857142857142857,7,6,ATCCGACATAGATGGGTTGT,1,1902758
icdC_predicted,1.2857142857142858,14,6,ATAGTTTCTACAGGTAGTAC,8,1878584
icdC_predicted,2.142857142857143,20,6,ATAAGGGCTACCGATAGGCG,14,1908081
icdC_predicted,4.142857142857143,34,6,AGTGGAGGATAGATAGCGCC,28,1879913
icdC_predicted,5.571428571428571,44,6,AGTGAGTGAGGTTCCGAGGT,38,1890126
icdC_predicted,2.5714285714285716,23,6,AGTCGTAAGCCACTCATACT,17,1886896
icdC_predicted,1.7142857142857142,17,6,AGTCACGCGGGCTATCTGCA,11,1906783
icdC_predicted,0.8571428571428571,11,6,AGTCAAGCCTTTTTCCGAAA,5,1887230
icdC_predicted,2.2857142857142856,21,6,AGGGTAAACCTTGGGTTCTT,15,1908698
icdC_predicted,0.7142857142857143,10,6,AGGGCAGCTGGTGGACTGTG,4,1900000
icdC_predicted,9.571428571428571,72,6,AGCAACGCATCGCAGAGATT,66,1892177
icdC_predicted,2.7142857142857144,24,6,AGAGTCCTTTCCTTAACGCA,18,1888428
icdC_predicted,0.2857142857142857,7,6,AGAGCTGCAGTCAGGAAGGC,1,1891720
icdC_predicted,1.8571428571428572,18,6,ACGGTCACACACGGAAGGAG,12,1887601
icdC_predicted,14.428571428571429,106,6,ACGACTGGAGCCGTAGGGGA,100,1888881
icdC_predicted,0.2857142857142857,7,6,ACGAAGTAAGTGGTTGAGCT,1,1896115
icdC_predicted,1.2857142857142858,14,6,ACCCCAGATTAAGGGAAATA,8,1884520
icdC_predicted,4.142857142857143,34,6,ACATTGAATTGCCGTAGGCA,28,1905758
icdC_predicted,0.2857142857142857,7,6,AATGCTCAAAAGATGAGGCT,1,1884989
icdC_predicted,4.0,33,6,AATGCCGCGATAGAGTACAA,27,1900645
icdC_predicted,1.4285714285714286,15,6,AATATTGCATGACAGACAGA,9,1897451
icdC_predicted,1.5714285714285714,16,6,AACTCAGGGTTGGCAAATCT,10,1896920
icdC_predicted,0.2857142857142857,7,6,AACAGTTATCGGAACTCAGT,1,1899646
icdC_predicted,2.0,19,6,AAATGTACGATTAGCTGAGA,13,1881145
icdC_predicted,0.7142857142857143,10,6,AAAGGACCGAGACCAATCTC,4,1906859
icdC_predicted,9.833333333333334,63,5,TTTTTTCATCGCACTTCTGG,58,1883500
icdC_predicted,2.1666666666666665,17,5,TTTCCCTTTAAAGTACCCGC,12,1901171
icdC_predicted,0.3333333333333333,6,5,TTTATGAACGGAGTTCATGT,1,1898473
icdC_predicted,4.166666666666667,29,5,TTTACAGGTTTTTTCAAGCC,24,1886894
icdC_predicted,1.6666666666666667,14,5,TTGGATTACATGGACAAGTT,9,1899080
icdC_predicted,4.333333333333333,30,5,TTGCTAGGAGCATTGTCCTC,25,1884048
icdC_predicted,4.833333333333333,33,5,TTCAAGTGGTCCGTTTCTGT,28,1878425
icdC_predicted,3.3333333333333335,24,5,TTACTACTTATACCATGCAT,19,1878454
icdC_predicted,9.0,58,5,TTACCTTCGGGTACGAGTAC,53,1887951
icdC_predicted,7.0,46,5,TTAATAAAGGAACAAAGGTA,41,1902487
icdC_predicted,5.166666666666667,35,5,TGTCGATAAGCAGGTGTCAG,30,1894759
icdC_predicted,3.5,25,5,TGTACAATAGCTTCTTAAGG,20,1898901
icdC_predicted,5.333333333333333,36,5,TGCTTAGGGGCAGCCCCAGA,31,1892202
icdC_predicted,0.5,7,5,TGCGGTTTTTTAATGTGAGG,2,1888534
icdC_predicted,5.833333333333333,39,5,TGCACTTATTACCGAATGCG,34,1885780
icdC_predicted,0.8333333333333334,9,5,TGACGGGCTAACAGCAGGGT,4,1905879
icdC_predicted,0.8333333333333334,9,5,TGACAGTTTGTCGTCCAGCA,4,1882564
icdC_predicted,4.833333333333333,33,5,TGAAAACGTATTAGGGATTG,28,1885329
icdC_predicted,1.3333333333333333,12,5,TCTTTCCAGGCCGGACAGGC,7,1893854
icdC_predicted,2.1666666666666665,17,5,TCTGGGCATGCTAGACCTGG,12,1886142
icdC_predicted,0.8333333333333334,9,5,TCTCGCGAAATTTGCCTAGT,4,1906622
icdC_predicted,17.333333333333332,108,5,TCTCACGTGTAGCTTGGAGA,103,1909279
icdC_predicted,1.1666666666666667,11,5,TCTATAGTGCAAGTATCCCT,6,1907807
icdC_predicted,1.3333333333333333,12,5,TCGTTGGTCAGTTACTCGGA,7,1893912
icdC_predicted,3.5,25,5,TCGCCCCGCACTGTGTAAGA,20,1892165
icdC_predicted,3.1666666666666665,23,5,TCGAAAGGGGGCGATTAAAC,18,1879743
icdC_predicted,2.5,19,5,TCCCTACATGAAAGAAGTGG,14,1891628
icdC_predicted,0.5,7,5,TCCCACGCGGCGTGGGTTAC,2,1880863
icdC_predicted,2.6666666666666665,20,5,TATAGTTTAGGACGAGACGT,15,1899873
icdC_predicted,0.3333333333333333,6,5,TAGATTTAAGATGCCAATTA,1,1886278
icdC_predicted,22.166666666666668,137,5,TACTAGAATGTCAGCCGGTT,132,1883925
icdC_predicted,3.1666666666666665,23,5,TAATCCGCGCAGGTAATGCT,18,1883268
icdC_predicted,11.333333333333334,72,5,TAAGCATGCATTTCAAGAAA,67,1907496
icdC_predicted,0.3333333333333333,6,5,TAACAGACTATTTTAGGGTG,1,1903121
icdC_predicted,0.3333333333333333,6,5,TAACAATTTAATATGTTCAG,1,1890419
icdC_predicted,0.3333333333333333,6,5,TAAATCGGGAAATCATTGTA,1,1879629
icdC_predicted,2.5,19,5,TAAAACGGTATCGAGACGAC,14,1900649
icdC_predicted,2.1666666666666665,17,5,GTTTTCACATATAGGCCATG,12,1887050
icdC_predicted,2.1666666666666665,17,5,GTTTCTGTGGGTTAGCCGTT,12,1887831
icdC_predicted,3.1666666666666665,23,5,GTTTCATGGCACTATGTAGG,18,1879484
icdC_predicted,4.833333333333333,33,5,GTTGTGTCCCATCTAGGACG,28,1886143
icdC_predicted,0.6666666666666666,8,5,GTTGCCCTGTATACAGTTAC,3,1889089
icdC_predicted,2.6666666666666665,20,5,GTTAGAGTCTGGACACCAGT,15,1900786
icdC_predicted,4.166666666666667,29,5,GTGTAAGGAGTACCTTTCGA,24,1897213
icdC_predicted,4.333333333333333,30,5,GTGGCGATCATGGAAGTGAG,25,1882078
icdC_predicted,3.6666666666666665,26,5,GTGAAAAAGGCATAGTAATT,21,1877991
icdC_predicted,3.5,25,5,GTCGGCGACTCGTCGGAGTC,20,1897023
icdC_predicted,1.6666666666666667,14,5,GTCCTAATCGACCAAGCGTC,9,1902217
icdC_predicted,1.3333333333333333,12,5,GTCAGCGAATTGGCGGCATG,7,1887086
icdC_predicted,8.333333333333334,54,5,GTACGCTAATGATTTGGGCT,49,1906781
icdC_predicted,1.6666666666666667,14,5,GGTCTTTATAGACCAGCGCA,9,1908439
icdC_predicted,2.1666666666666665,17,5,GGTCTTGGCGCGACCAATAA,12,1908349
icdC_predicted,0.3333333333333333,6,5,GGTACTGTCCGCCGCTAGTA,1,1886536
icdC_predicted,5.5,37,5,GGGTTTGTGGGCATAGGTCT,32,1889394
icdC_predicted,3.1666666666666665,23,5,GGGCTACCGCCGCTCACATT,18,1878620
icdC_predicted,2.8333333333333335,21,5,GGGCGCAGGTATAGTAAATG,16,1897209
icdC_predicted,2.5,19,5,GGGCAACCGAGTCCCCATTT,14,1900477
icdC_predicted,5.5,37,5,GGGACTCTACACCACTGTAC,32,1881764
icdC_predicted,3.3333333333333335,24,5,GGCCTTGTCCCTAGTACGCC,19,1900890
icdC_predicted,3.0,22,5,GGAGGCCACAACGCTCCTTC,17,1888874
icdC_predicted,4.0,28,5,GGACAGCGGCGAGTTGGTGA,23,1884127
icdC_predicted,3.0,22,5,GCTTATTTTCTGTTTGGATC,17,1900468
icdC_predicted,1.6666666666666667,14,5,GCTCTAGCTCCGTGTGTTCT,9,1886059
icdC_predicted,7.333333333333333,48,5,GCTAAATCAGCTAATTACAG,43,1902862
icdC_predicted,5.166666666666667,35,5,GCGTAGCTACTGGAGCCGTC,30,1880553
icdC_predicted,4.333333333333333,30,5,GCGTAAACAGAGGTAATTAC,25,1887143
icdC_predicted,4.5,31,5,GCGGAATCGGAGATGACTGG,26,1883066
icdC_predicted,3.8333333333333335,27,5,GCGCGCTGAGTAGAATCGAG,22,1900924
icdC_predicted,3.0,22,5,GCCGTCTAAAATGATATCTT,17,1889325
icdC_predicted,5.0,34,5,GCATCTTTAATAGAGGAGAT,29,1879749
icdC_predicted,2.6666666666666665,20,5,GCACCGGTGCGACAATGCGT,15,1882529
icdC_predicted,6.0,40,5,GATGCCGCACCTTAATTTAC,35,1891855
icdC_predicted,2.0,16,5,GATACGTTGTCCATACTGAG,11,1891767
icdC_predicted,8.166666666666666,53,5,GACTCCCGCCCGCGAGGAGT,48,1882128
icdC_predicted,2.3333333333333335,18,5,GACGATGGGACTCCGACGGC,13,1878432
icdC_predicted,2.8333333333333335,21,5,GACAGGGATTGGTAGTGGGT,16,1885268
icdC_predicted,3.0,22,5,GACAGAGAAGGGCGAACTCA,17,1893814
icdC_predicted,1.1666666666666667,11,5,GAACGCTTTAATTCGAGAAA,6,1880707
icdC_predicted,2.5,19,5,GAACGACCCGACGACTGTCA,14,1904061
icdC_predicted,1.1666666666666667,11,5,GAACCGGTTCACGGTCAAGG,6,1882401
icdC_predicted,6.833333333333333,45,5,CTTTGCACAGCGACAGAGAC,40,1880680
icdC_predicted,3.5,25,5,CTTGGCGTGGGCTTTGCAGG,20,1878732
icdC_predicted,1.8333333333333333,15,5,CTTGGCGGCGTGCATGAGCA,10,1888399
icdC_predicted,1.8333333333333333,15,5,CTTGGAGCTAGACGATTGCT,10,1885496
icdC_predicted,5.5,37,5,CTTACCAAGGATTCACGGAG,32,1891787
icdC_predicted,3.6666666666666665,26,5,CTGTATCTAGGCAAGAAAGT,21,1897609
icdC_predicted,6.166666666666667,41,5,CTGGCCTACTGAGGTTGTCT,36,1884443
icdC_predicted,9.333333333333334,60,5,CTGATCTGAGCCGGGTGTTG,55,1895591
icdC_predicted,3.6666666666666665,26,5,CTCTTCCTCAACATGTTGGT,21,1903100
icdC_predicted,3.6666666666666665,26,5,CTCTACAGAAGCGGGCAGAC,21,1885117
icdC_predicted,0.3333333333333333,6,5,CTCCTCATTGTGCTCCATCA,1,1903736
icdC_predicted,0.3333333333333333,6,5,CTCATGCGCGCACCGACTTG,1,1893574
icdC_predicted,4.166666666666667,29,5,CTATGGGGACCCTTGACGAT,24,1889156
icdC_predicted,2.6666666666666665,20,5,CTAGGCCGGGAATTCATAGT,15,1902803
icdC_predicted,4.0,28,5,CTACACTAGCACAGCCGTTT,23,1896362
icdC_predicted,0.3333333333333333,6,5,CTAACTACGTTTGGAAAGCT,1,1899640
icdC_predicted,6.333333333333333,42,5,CGTTCGCTCACAAAGCATCG,37,1885030
icdC_predicted,3.6666666666666665,26,5,CGTTATCGCGCCTGGGTATT,21,1900511
icdC_predicted,1.3333333333333333,12,5,CGTGGCCGTCATCGACCGTC,7,1894316
icdC_predicted,1.6666666666666667,14,5,CGTCTTTTAGATCTCTGTGG,9,1901708
icdC_predicted,3.0,22,5,CGGGCACTGCCATACGGAGA,17,1902399
icdC_predicted,5.833333333333333,39,5,CGGCTGGACTGTGTGTTCAA,34,1902733
icdC_predicted,6.0,40,5,CGCGTGGTCTGAGTACACCT,35,1894630
icdC_predicted,5.0,34,5,CGCGAACCGTTGACGGACAG,29,1897944
icdC_predicted,3.0,22,5,CGCCTGAGTTAGGCCTTTGA,17,1898092
icdC_predicted,1.8333333333333333,15,5,CGATGGGATCGGAGGCTCAA,10,1883690
icdC_predicted,9.0,58,5,CGATACTGGTTCGACGCGGA,53,1898298
icdC_predicted,0.3333333333333333,6,5,CGAGTCTCTGCCGGTTACTC,1,1886767
icdC_predicted,0.3333333333333333,6,5,CGAGCTACCAGATGACCAGT,1,1885060
icdC_predicted,3.6666666666666665,26,5,CGACTCGACCACCCATCAGG,21,1890514
icdC_predicted,3.0,22,5,CCTGCGATAGTAGTTCCATT,17,1878988
icdC_predicted,1.3333333333333333,12,5,CCTGAGAGAAGACAGGAGCG,7,1894086
icdC_predicted,2.5,19,5,CCGTGTGTTGCTTAATCATT,14,1897303
icdC_predicted,2.6666666666666665,20,5,CCGATCCGCGGCGCTCGGGC,15,1888107
icdC_predicted,0.3333333333333333,6,5,CCCTGCTATGTCGCCGTTTC,1,1893891
icdC_predicted,5.166666666666667,35,5,CCAAGGTACCGGGAAACAAC,30,1886820
icdC_predicted,0.3333333333333333,6,5,CCAAATCTAAAGGACTGGCC,1,1894949
icdC_predicted,2.0,16,5,CATTTCGGGTCTAGGTAGAG,11,1882356
icdC_predicted,3.3333333333333335,24,5,CATTTCACCTGGTTATAACA,19,1899305
icdC_predicted,2.5,19,5,CATTCTACAAAGGTACCGTG,14,1884903
icdC_predicted,0.3333333333333333,6,5,CATGGAGTGATGGTAGGCTT,1,1894634
icdC_predicted,2.0,16,5,CATGCTTGACAATCCCGTGA,11,1893971
icdC_predicted,0.5,7,5,CATGCAAGGCGTGGCTCCGT,2,1896232
icdC_predicted,2.0,16,5,CATCTCGGATGCGTGTGCGT,11,1891348
icdC_predicted,0.6666666666666666,8,5,CATCCCTGGGGTTCGCATTC,3,1901405
icdC_predicted,4.166666666666667,29,5,CAGTGGTCGGCCAGGTAATA,24,1886505
icdC_predicted,5.666666666666667,38,5,CAGGAGCGTATGATATCTTT,33,1898475
icdC_predicted,2.3333333333333335,18,5,CAGCTCATCGCCAACGTCTT,13,1885094
icdC_predicted,2.5,19,5,CACGCCGCATGGGAGTGTAA,14,1884474
icdC_predicted,4.0,28,5,CACAGTTACGCAAGCCCACT,23,1885607
icdC_predicted,2.1666666666666665,17,5,CAAGCACCGGTTTCAATGGC,12,1889439
icdC_predicted,5.666666666666667,38,5,CAAATAGCCTCAGCACACGC,33,1899985
icdC_predicted,2.0,16,5,ATTTCCATGCCATTGTCTCT,11,1884453
icdC_predicted,3.0,22,5,ATTCCTATTAAGGTAATGAA,17,1879041
icdC_predicted,2.1666666666666665,17,5,ATTCATCACCAGGTCGACTG,12,1878485
icdC_predicted,2.0,16,5,ATGCTGAATGTGAGGGCATT,11,1896325
icdC_predicted,0.3333333333333333,6,5,ATGATCTCTCAACAGAGCCT,1,1890002
icdC_predicted,4.0,28,5,ATGACAAGAGTCTCCTAGGG,23,1880159
icdC_predicted,0.3333333333333333,6,5,ATCGGTAGCCAAAGTCCAGG,1,1900229
icdC_predicted,0.5,7,5,ATCCCGCGAGAAACTCGCCC,2,1882691
icdC_predicted,0.3333333333333333,6,5,ATCAGTTGGCTCAGGAAGAC,1,1895816
icdC_predicted,1.3333333333333333,12,5,ATATGACCGTCCGGAATTTT,7,1890886
icdC_predicted,2.1666666666666665,17,5,ATATCATCTATAGCGGTATT,12,1902046
icdC_predicted,1.3333333333333333,12,5,ATATATACATATGGATGAGG,7,1889818
icdC_predicted,4.666666666666667,32,5,ATAGTTCGCGATTACAATCA,27,1890401
icdC_predicted,0.3333333333333333,6,5,ATAATCGTACAAGGAGGCTC,1,1899097
icdC_predicted,0.6666666666666666,8,5,AGTTGTCCGGAGTATAATGA,3,1903726
icdC_predicted,4.333333333333333,30,5,AGTTCAGTTAGCCCTGAGTA,25,1904295
icdC_predicted,4.166666666666667,29,5,AGGTAGAATCTACTTTCCTT,24,1880873
icdC_predicted,2.0,16,5,AGGACCATAAGTGTCTGGCT,11,1902703
icdC_predicted,2.3333333333333335,18,5,AGCTAGCCCTGCATGCACAA,13,1888243
icdC_predicted,4.0,28,5,AGCGGCTACAGCCGGCATAG,23,1901140
icdC_predicted,0.3333333333333333,6,5,AGCCCGTTAGAAGATCATAA,1,1885158
icdC_predicted,0.5,7,5,AGATGATGTCCCCCCCGGCT,2,1901945
icdC_predicted,31.666666666666668,194,5,AGAGCCAAAAAAATATTACC,189,1908371
icdC_predicted,2.5,19,5,ACGGTATGTGCAAGCGTTGC,14,1881958
icdC_predicted,1.8333333333333333,15,5,ACGGCGTACTTGGTTAACCT,10,1893166
icdC_predicted,3.6666666666666665,26,5,ACCTCAGTTGACCCGTAGAG,21,1903944
icdC_predicted,1.5,13,5,ACCTAATCAGACCTCGACTG,8,1903973
icdC_predicted,1.8333333333333333,15,5,ACCGTCCGGCTTGGTCAGGA,10,1900171
icdC_predicted,2.8333333333333335,21,5,ACCCAACAGGGGCTGGAACA,16,1896592
icdC_predicted,3.6666666666666665,26,5,ACAAGTACTGATACCGACAA,21,1896823
icdC_predicted,4.0,28,5,AATTAAGACTGTGTGGCTGA,23,1900076
icdC_predicted,0.8333333333333334,9,5,AATGGCGTCTCTCGGCTTAG,4,1889284
icdC_predicted,0.8333333333333334,9,5,AATGGATCATAGTACGATGA,4,1903609
icdC_predicted,14.833333333333334,93,5,AATCTCCCTAAGCCATAGAC,88,1892816
icdC_predicted,0.3333333333333333,6,5,AATCGTGTACTGGACACGTG,1,1899457
icdC_predicted,2.3333333333333335,18,5,AAGTCATCACGACGTCCAGA,13,1896160
icdC_predicted,3.3333333333333335,24,5,AAGAGTCCCTCCCTGACCTA,19,1887337
icdC_predicted,2.1666666666666665,17,5,AAATAAATATTAAGTGTGCC,12,1901040
icdC_predicted,3.5,25,5,AAAGAATAACGGTCTGAAAA,20,1902184
icdC_predicted,5.666666666666667,38,5,AAACCCGCTTCCTTTTAACC,33,1882480
icdC_predicted,0.4,5,4,TTTGTCATGACAAGAGTACA,1,1885912
icdC_predicted,0.4,5,4,TTGTTTGACAGCGGGCTTGA,1,1899806
icdC_predicted,0.4,5,4,TTGTGCATCCCAACCTACTC,1,1892258
icdC_predicted,0.4,5,4,TTGTGAGATCTCATTATACG,1,1893911
icdC_predicted,3.8,22,4,TTGCTCGTCAATAGCGATTT,18,1887266
icdC_predicted,5.4,30,4,TTCGACAAGTTACGTGTCCC,26,1896860
icdC_predicted,2.0,13,4,TTCACTCAATTCTACAAATC,9,1890850
icdC_predicted,4.4,25,4,TTAGGACAATAAAACTGAAA,21,1897769
icdC_predicted,0.4,5,4,TTAGAGCTAGGAGCACCCAG,1,1882633
icdC_predicted,4.4,25,4,TTAATAGGTACCGTCAGTTA,21,1885112
icdC_predicted,0.4,5,4,TGTTGGGGGCTCCGAACCCT,1,1885826
icdC_predicted,7.0,38,4,TGTACTCCATAGCGGCAAGC,34,1878617
icdC_predicted,0.4,5,4,TGGCGAGCCTGGGAAACCCA,1,1895008
icdC_predicted,9.8,52,4,TGGAGTCACAATGGCGGCGA,48,1903038
icdC_predicted,0.6,6,4,TGGAGACGACGATATCTGTA,2,1900883
icdC_predicted,2.4,15,4,TGCTCATAAAGCATCAACTT,11,1899489
icdC_predicted,3.6,21,4,TGATCCGAGCCTCGCTTCCT,17,1908063
icdC_predicted,7.8,42,4,TGATATTGTGCCAATGGGAA,38,1895258
icdC_predicted,4.4,25,4,TGACCACGGAGAAAAGGTAA,21,1885028
icdC_predicted,5.4,30,4,TGAATCGGCAGGGTGGAGGT,26,1889109
icdC_predicted,2.6,16,4,TCTGCGCGCGGAAAAAACTA,12,1893017
icdC_predicted,8.2,44,4,TCTCTCGGATATAGCCGTTA,40,1879579
icdC_predicted,1.4,10,4,TCGTCGAGACTTCCTATATC,6,1879774
icdC_predicted,2.8,17,4,TCGCTGCCTCAACGTTGTAT,13,1890714
icdC_predicted,1.2,9,4,TCGAATCTTCCATCATCATC,5,1891729
icdC_predicted,0.4,5,4,TCGAACGCGATGGCAGGGTT,1,1895133
icdC_predicted,3.0,18,4,TCCACACAGGATAGGTGCCT,14,1908017
icdC_predicted,3.0,18,4,TATGCCGTATTACGTTTCAA,14,1879437
icdC_predicted,7.2,39,4,TATCCATAGTTGTAGATAAT,35,1899984
icdC_predicted,2.6,16,4,TATCACTCTACGGCACAATT,12,1879594
icdC_predicted,1.4,10,4,TAGAGTTTCAAAGGCATTTT,6,1884749
icdC_predicted,2.8,17,4,TAGAATTAGATCCGATTCAA,13,1892060
icdC_predicted,7.0,38,4,TAACGCGTACAGTTGTGATG,34,1908607
icdC_predicted,0.6,6,4,GTTGTTCTTAACTACTGCCT,2,1905618
icdC_predicted,0.4,5,4,GTTCCGACAGCCTGGCATCC,1,1893874
icdC_predicted,4.6,26,4,GTTCCCAGACGGGTTCTGTT,22,1905543
icdC_predicted,4.4,25,4,GTTCAAGTTGGGTTTTCGAT,21,1904835
icdC_predicted,6.0,33,4,GTGTTGGTCTTCGATGCTAT,29,1879703
icdC_predicted,3.0,18,4,GTGTGCCGGTGTCGGAACAT,14,1898013
icdC_predicted,4.0,23,4,GTGGTCTGCCCTTGTAGGAT,19,1882049
icdC_predicted,2.8,17,4,GTGCGTGGTTATGTAGGACC,13,1888378
icdC_predicted,0.4,5,4,GTAACTGTTTACAATAAGCG,1,1902040
icdC_predicted,2.2,14,4,GGTTCAAGATCCACCTCATT,10,1893298
icdC_predicted,0.6,6,4,GGTACGTCTGAGGGGATGCT,2,1896237
icdC_predicted,3.2,19,4,GGCTGGGGATTGTCTAAGGT,15,1886243
icdC_predicted,8.2,44,4,GGCCCAAACGCTATACGCTT,40,1902940
icdC_predicted,3.4,20,4,GGCATCCCGAGGAAGGGAGT,16,1900701
icdC_predicted,2.4,15,4,GGATTTCGAAATACCAGGAC,11,1889154
icdC_predicted,4.4,25,4,GGATGTTCATTGTGTTCAAC,21,1901289
icdC_predicted,8.0,43,4,GGATCAATGCTCCTAACGTC,39,1883159
icdC_predicted,1.6,11,4,GGACGTGATAACGTTTGCGT,7,1904610
icdC_predicted,2.6,16,4,GGACCAAACCTCAAGTTAGC,12,1892901
icdC_predicted,4.0,23,4,GGACATAGTTGAAAAAAGGC,19,1900264
icdC_predicted,2.0,13,4,GCTGGGGCAGTATCACCGGC,9,1894120
icdC_predicted,6.6,36,4,GCTCGGATATATCTGCTTAG,32,1907089
icdC_predicted,1.6,11,4,GCTCCAAAACCGTCAGATAA,7,1886099
icdC_predicted,6.0,33,4,GCTACCTTTCTTAATCGGAG,29,1883152
icdC_predicted,1.8,12,4,GCGTTTGGTTTCTGGCTCAA,8,1882130
icdC_predicted,3.4,20,4,GCGTATCCGGTGTCATGATT,16,1888592
icdC_predicted,0.6,6,4,GCGTAGTAGTAATCAGGTTT,2,1890201
icdC_predicted,11.4,60,4,GCGATGTTAGCGATTACAGT,56,1883399
icdC_predicted,2.2,14,4,GCCCTCAACTGTGTGTATGG,10,1896008
icdC_predicted,9.4,50,4,GCACTGACGTCTAGAATGGA,46,1899958
icdC_predicted,2.4,15,4,GCACACTGCGAATCAAAGGT,11,1895558
icdC_predicted,4.0,23,4,GAGGGGGTATCTTCTGCTCT,19,1878651
icdC_predicted,1.6,11,4,GAGCACAGTGTACTCTAGGG,7,1897580
icdC_predicted,2.6,16,4,GACTGGTACACAAATGGATG,12,1905109
icdC_predicted,3.0,18,4,GACGGTATGTAGTTGAGCGC,14,1894233
icdC_predicted,0.4,5,4,GACACTTTGAAGCGATCAAG,1,1901193
icdC_predicted,4.0,23,4,GAATACACTGAAAAAGCGCG,19,1895517
icdC_predicted,2.8,17,4,GAATAATGAAGGGGAGACAA,13,1908496
icdC_predicted,0.4,5,4,CTTATTAATCCACTTCTCGG,1,1902421
icdC_predicted,0.8,7,4,CTGTGTGGAATGGGAGCCTC,3,1895980
icdC_predicted,6.2,34,4,CTGTGTGAAGATTCTGTCCC,30,1899976
icdC_predicted,3.4,20,4,CTGTGTAATACGATATTGAT,16,1889738
icdC_predicted,3.8,22,4,CTGGTTGCCCGGCAGATTTG,18,1878848
icdC_predicted,3.8,22,4,CTGGCAGTTGGTCCCGGGAC,18,1896149
icdC_predicted,10.0,53,4,CTGGATAACTCTCGTAATCA,49,1886290
icdC_predicted,4.2,24,4,CTGCAGCCAATCTTGCCCCC,20,1882333
icdC_predicted,1.6,11,4,CTCCGAGCAACCTTGCTAAA,7,1893815
icdC_predicted,4.2,24,4,CTATTTCACGGATCTCTAAA,20,1909309
icdC_predicted,0.4,5,4,CTATCTCTGAGGGTTATTTT,1,1903748
icdC_predicted,2.8,17,4,CTACGGACCGCATCGTCTCT,13,1881556
icdC_predicted,0.8,7,4,CTAAACGGGGAGCTGGGCAG,3,1894920
icdC_predicted,0.4,5,4,CGGCGTTCAGGGGTTGTCAA,1,1883868
icdC_predicted,3.4,20,4,CGGATTCTCTTTTGATTGCC,16,1897797
icdC_predicted,1.0,8,4,CGATCAGTTTACCGATAGAT,4,1895040
icdC_predicted,3.4,20,4,CGAGATTGCTTAAAATTCAG,16,1884993
icdC_predicted,9.6,51,4,CGAAGTATCGAAGTCCCAAA,47,1897449
icdC_predicted,3.2,19,4,CCTCTCCCGCAGGGAGTCTT,15,1896276
icdC_predicted,6.0,33,4,CCGTGTTAGTCGAGGTCTCA,29,1890880
icdC_predicted,1.2,9,4,CCGGCACACGTCCCTCTCGG,5,1902916
icdC_predicted,3.0,18,4,CCGGATTCAACATCGGCGCT,14,1886718
icdC_predicted,6.6,36,4,CCGCGGCAACCAACTGGGAA,32,1887519
icdC_predicted,0.4,5,4,CCGAAACAGGACGGCAGTAT,1,1878422
icdC_predicted,4.0,23,4,CCCAGGCTTCATGCGGTTTT,19,1885227
icdC_predicted,0.4,5,4,CCAGCCGCTCTTTGAAGTAG,1,1885932
icdC_predicted,7.8,42,4,CCACGCTTAAATCTTTTTGT,38,1903723
icdC_predicted,0.4,5,4,CCAAGCAAGATCGCTTGAGG,1,1888039
icdC_predicted,0.4,5,4,CATCAGTGCTCACCCGCAAC,1,1903541
icdC_predicted,13.0,68,4,CATATCCGTGGGCTGTAGCA,64,1885037
icdC_predicted,1.6,11,4,CAGTGCGCGATGGGTCGTAT,7,1890202
icdC_predicted,1.6,11,4,CAGGTTATCATCGTAGGAGT,7,1898641
icdC_predicted,2.6,16,4,CACTGTACTTAACCCCTCGG,12,1888088
icdC_predicted,2.6,16,4,CACTGCTTTCCGGGGTTAGG,12,1884826
icdC_predicted,2.6,16,4,CACTACTTCACCCTGCGGAA,12,1909327
icdC_predicted,5.8,32,4,CAATTGTGGCACGTATGCCC,28,1884410
icdC_predicted,3.2,19,4,CAACTTCTTCTGAGGGGTTA,15,1890235
icdC_predicted,2.8,17,4,CAACTAGGTAACGAAAATCC,13,1891351
icdC_predicted,2.2,14,4,CAAATCGCGTGTGTTTCGTT,10,1905301
icdC_predicted,3.2,19,4,CAAAGTTAGGAGTTGCTACT,15,1909269
icdC_predicted,3.0,18,4,ATTTTGAGCTGGCAAGACGG,14,1900648
icdC_predicted,5.4,30,4,ATTTGGGTTGGTCTTAGCCT,26,1881575
icdC_predicted,5.0,28,4,ATTTCCATTAAGCGGGCTAT,24,1886599
icdC_predicted,4.0,23,4,ATTGAAACGTTTTTAGCCAT,19,1900652
icdC_predicted,2.2,14,4,ATTACCTTATCATTGTAGGG,10,1878783
icdC_predicted,5.6,31,4,ATTAACTCCGCCCCAGGGAT,27,1879259
icdC_predicted,5.8,32,4,ATGTTAAGACAAGATGGGGA,28,1888241
icdC_predicted,0.4,5,4,ATGTCACGTCCGGGAAAACA,1,1904306
icdC_predicted,8.0,43,4,ATGGATATGGTACCCATCCC,39,1887195
icdC_predicted,10.8,57,4,ATGCGAGTGGGTAGGGTATT,53,1886814
icdC_predicted,5.8,32,4,ATCTGAATTTAGAGCCCTTG,28,1902662
icdC_predicted,0.8,7,4,ATCTCTCGACAACCCCATCG,3,1889079
icdC_predicted,12.2,64,4,ATCGTACGCCGGGGCAAGCA,60,1884562
icdC_predicted,1.6,11,4,ATCATCAGTCTTGGGGACGG,7,1879212
icdC_predicted,3.2,19,4,ATCACCAAGATAGCAGCGGC,15,1897829
icdC_predicted,7.8,42,4,ATAATTGCTAGGAGACATTC,38,1880003
icdC_predicted,1.0,8,4,AGTACAAATGCTTGAGAGTT,4,1885338
icdC_predicted,2.8,17,4,AGCTGTAACCATGTAGTTTT,13,1908943
icdC_predicted,4.8,27,4,AGATAATAGTGACATACTGG,23,1893324
icdC_predicted,6.6,36,4,AGACATGCGTGAGGCCTGCA,32,1886613
icdC_predicted,10.8,57,4,ACTTTGGACCCATGTGAAAA,53,1900068
icdC_predicted,3.6,21,4,ACTTCATGACCACGATAATA,17,1880047
icdC_predicted,7.4,40,4,ACTCGAGCGCTACACCCTTA,36,1885141
icdC_predicted,8.0,43,4,ACTACTGTGGATATAGCGTA,39,1878307
icdC_predicted,3.2,19,4,ACGGCGAGTTTATCCGTGAA,15,1886487
icdC_predicted,1.8,12,4,ACGCTTCAGTGAAACCGATC,8,1891209
icdC_predicted,1.6,11,4,ACGCCAATTGCGGTCTGGGT,7,1885099
icdC_predicted,3.0,18,4,ACGCAGGAAAAACGCAGTAT,14,1878519
icdC_predicted,1.6,11,4,ACCGCCGCACAACTCTCCTG,7,1888535
icdC_predicted,4.0,23,4,ACCCAGTGTGGGTACATCTC,19,1899162
icdC_predicted,2.4,15,4,ACATGGGGAAACACATGAAC,11,1883273
icdC_predicted,4.4,25,4,ACATAATTGACGCAGGGGAT,21,1885527
icdC_predicted,5.2,29,4,ACACCCAACAGACCAAACCT,25,1896016
icdC_predicted,0.6,6,4,AATTGTCTAGTCAAGCCGTC,2,1906910
icdC_predicted,0.4,5,4,AATTAAGTATACGTCCGCGC,1,1902952
icdC_predicted,3.8,22,4,AAGGTTGATTGGGTATTAAG,18,1905504
icdC_predicted,1.4,10,4,AAGGTTCGCCCACCGGATTT,6,1891287
icdC_predicted,0.6,6,4,AAGGTAACTGCGTACGCGTG,2,1889099
icdC_predicted,1.8,12,4,AAGGCGGAGTGACTTCGGGA,8,1888694
icdC_predicted,2.8,17,4,AAGATAGCGTAGTATGCTTA,13,1896495
icdC_predicted,3.2,19,4,AAGAGCGAATAGACATCCTT,15,1891435
icdC_predicted,1.2,9,4,AAGAATGACTCATACTGAGA,5,1897727
icdC_predicted,7.2,39,4,AACGTCTCCTGAGGTTACCT,35,1895338
icdC_predicted,9.2,49,4,AACGGAAAGGAGACCACCGT,45,1883942
icdC_predicted,7.8,42,4,AAACGCAGCGCCTCCGACTT,38,1886801
icdC_predicted,2.75,13,3,TTTAATGATGGGTCATAAGG,10,1899864
icdC_predicted,2.25,11,3,TTCGAGTGTTTTCTTTGTGC,8,1893947
icdC_predicted,4.75,21,3,TTCCTAACGGTCCCACTAAA,18,1880864
icdC_predicted,4.5,20,3,TTCAAAGCGGTGAGTTTCCT,17,1899434
icdC_predicted,3.0,14,3,TTAGACAGTCGGTATCTGTA,11,1896166
icdC_predicted,5.75,25,3,TTACTGGGTGTATTTGACTT,22,1903724
icdC_predicted,5.5,24,3,TGTGCTCGAGTGTCATAAGC,21,1885467
icdC_predicted,21.25,87,3,TGTGCGAGAGTTGGGGTCGT,84,1880410
icdC_predicted,1.5,8,3,TGTCTTCCCGGGCTTACTTT,5,1879321
icdC_predicted,3.75,17,3,TGTAGGCGGGTCACTCTAGG,14,1887286
icdC_predicted,4.0,18,3,TGGTAAATTCCTAAAGGGAC,15,1882493
icdC_predicted,1.25,7,3,TGGACGCAAATATTAACGTC,4,1887171
icdC_predicted,4.25,19,3,TGGAACTTAAAGCGAGCGAC,16,1899243
icdC_predicted,0.5,4,3,TGCTTTTGACGGTAAGTACC,1,1898853
icdC_predicted,2.5,12,3,TGCTTTCGCTGGGCGAATCA,9,1887409
icdC_predicted,4.0,18,3,TGCTCGACCCCTGGTAGCCT,15,1908275
icdC_predicted,11.0,46,3,TGCCAGCGACTCACTAATCG,43,1890772
icdC_predicted,5.0,22,3,TGCAACCATTGCGGCGGAAA,19,1883218
icdC_predicted,16.25,67,3,TGATACTTGCTCATCGTTCG,64,1902475
icdC_predicted,0.5,4,3,TGAGTTGCGCTAGAATGGAA,1,1881245
icdC_predicted,2.75,13,3,TGACAAGCACATACTTGCCG,10,1880530
icdC_predicted,0.75,5,3,TCTTACCCGGCAATGCGTTG,2,1905041
icdC_predicted,6.5,28,3,TCTCTGAAGCTCAATGCGTC,25,1900198
icdC_predicted,10.75,45,3,TCTACGGAGGATTTTTAGTG,42,1899426
icdC_predicted,0.75,5,3,TCGTCATCGGTCATCCTTCG,2,1889030
icdC_predicted,1.25,7,3,TCGCGGGGTGGACTTCGGTC,4,1880018
icdC_predicted,3.75,17,3,TCCTCTGTAATCGCAGTCAT,14,1887462
icdC_predicted,6.75,29,3,TCCGGTTATTGGGTACGCGA,26,1891135
icdC_predicted,11.0,46,3,TCCGAGGCTGTCACCGTCTG,43,1899820
icdC_predicted,3.5,16,3,TCCCTGTACCTTCGCCAGGT,13,1892386
icdC_predicted,6.75,29,3,TCCATCTGGCCGCAAAAACA,26,1889688
icdC_predicted,0.5,4,3,TCCAACTGAAGAGATGAACA,1,1907636
icdC_predicted,5.25,23,3,TCATACCCGTTCTACTTGGT,20,1882973
icdC_predicted,9.0,38,3,TATAGGTACCGCAGCCATAG,35,1903395
icdC_predicted,0.75,5,3,TAGGAGTTAATAGCATTTCG,2,1897411
icdC_predicted,2.0,10,3,TAGCGTCTCATCGTAGTCAT,7,1902806
icdC_predicted,3.75,17,3,TAACAGTTACAGGACAGAAA,14,1886370
icdC_predicted,3.75,17,3,TAAAACGTCCCTTGACGGAC,14,1882164
icdC_predicted,4.25,19,3,GTTCTGGCCGTGTTTGTATC,16,1885626
icdC_predicted,0.5,4,3,GTTAGGTCATTATGTTTCAC,1,1889695
icdC_predicted,0.5,4,3,GTGTGGGCTAGCACGGCGAA,1,1883368
icdC_predicted,5.0,22,3,GTGTAGTCGGCCCGTACGAG,19,1898237
icdC_predicted,1.75,9,3,GTGCACCTAACGAATAAGCT,6,1883055
icdC_predicted,1.25,7,3,GTCGGTTCGCAGCAAATCGC,4,1887427
icdC_predicted,0.5,4,3,GTCACAGCGCAGCCGTGAAC,1,1902474
icdC_predicted,4.75,21,3,GTAGTCTGGTGGTTCAGCTC,18,1895166
icdC_predicted,1.5,8,3,GTACAGTACAGCTTCTCCTT,5,1891134
icdC_predicted,2.75,13,3,GTAATCCTAGGTAATCTAGT,10,1881399
icdC_predicted,31.5,128,3,GGTACCTGTCACGCGCGTGT,125,1903389
icdC_predicted,2.25,11,3,GGTACAGGCGCGTCTAGGAT,8,1880339
icdC_predicted,3.0,14,3,GGGTGACCTTGGCTCCAGAC,11,1878734
icdC_predicted,20.0,82,3,GGGTAGTACATTAGCTTGGA,79,1903386
icdC_predicted,2.25,11,3,GGGCTTTCGGTATGACGGTG,8,1881175
icdC_predicted,1.75,9,3,GGGCCAGAGTGCGAAACGCT,6,1887953
icdC_predicted,1.25,7,3,GGCGGTAACGTCTAGCGGCA,4,1903721
icdC_predicted,4.75,21,3,GGCGGCCACTTCAGATTCAG,18,1885347
icdC_predicted,8.0,34,3,GGCGACGCTTCGAGTCCCCC,31,1891034
icdC_predicted,0.5,4,3,GGCCATTTCCGACTGCGGTT,1,1897920
icdC_predicted,6.5,28,3,GGCAGAGTGGCCAGCAAAGT,25,1878956
icdC_predicted,10.0,42,3,GGATATTCGATGTCCTTCTT,39,1885463
icdC_predicted,3.25,15,3,GGAGTTAATAGGGTGATCAG,12,1887514
icdC_predicted,7.75,33,3,GGAGCACGCAAGCATATCTA,30,1878959
icdC_predicted,6.5,28,3,GGAGCACATATTTGGCGTCT,25,1884241
icdC_predicted,2.5,12,3,GGAGACTGGCTATGACCGAG,9,1908746
icdC_predicted,3.75,17,3,GGACTGATACTTATCCGAAA,14,1883712
icdC_predicted,0.5,4,3,GGACGTAAACTGAAGTCACG,1,1903329
icdC_predicted,2.5,12,3,GCTCTCTGCGTTTACGTGGT,9,1903550
icdC_predicted,4.5,20,3,GCTCTCGTAACTTATTCCAA,17,1895701
icdC_predicted,0.75,5,3,GCTCCGTGTAGCTCATACAG,2,1902414
icdC_predicted,3.75,17,3,GCGGGACGTGCGTGTCGGCA,14,1884517
icdC_predicted,4.5,20,3,GCGCTGGTCAGGGACGCAAT,17,1903387
icdC_predicted,7.25,31,3,GCGATCGCTCAAGAGCCGGA,28,1908771
icdC_predicted,0.5,4,3,GCCTGGCGTGCTTGTCACAT,1,1888429
icdC_predicted,8.0,34,3,GCCTAATTCGGGGCAGAGCC,31,1893160
icdC_predicted,3.0,14,3,GCCGTCCTAACCTGCTTATC,11,1892462
icdC_predicted,2.25,11,3,GCCATTCTGCCCGGAGTCGT,8,1879773
icdC_predicted,1.0,6,3,GCCAAGGACTGAGGGTATGT,3,1881005
icdC_predicted,0.5,4,3,GCATGCCTTGGGAATTACAA,1,1897051
icdC_predicted,2.75,13,3,GATGTGTGTATTTAGTGACG,10,1905586
icdC_predicted,3.75,17,3,GATCCAGGCACCTCAGTAAG,14,1905218
icdC_predicted,3.75,17,3,GAGTCTTAGACCAATCGCCT,14,1893107
icdC_predicted,3.25,15,3,GACGCGGTTCATTAAGTCTC,12,1895639
icdC_predicted,0.5,4,3,GACCCAAAGGAGAAATTTGG,1,1906423
icdC_predicted,2.25,11,3,GACCAACAACATCGCGCCTA,8,1902191
icdC_predicted,5.25,23,3,GACATCATATGAGGAGAAAT,20,1903626
icdC_predicted,5.0,22,3,GAATCTGTATTCAACGGACC,19,1909149
icdC_predicted,3.75,17,3,GAACCGACCCATCCCGAACA,14,1902772
icdC_predicted,0.5,4,3,GAACCCTTGAGGCCGAAGAT,1,1889396
icdC_predicted,6.0,26,3,GAACATATTATATTCCATGT,23,1886949
icdC_predicted,8.25,35,3,GAAAAGATTTAAATAGGGGA,32,1888846
icdC_predicted,7.75,33,3,CTGAGGGAAATAGACAGCAT,30,1906480
icdC_predicted,5.0,22,3,CTGACGAGGTCAGGAGGAGA,19,1888769
icdC_predicted,2.5,12,3,CTAGTACGACACTTATACAT,9,1892730
icdC_predicted,4.0,18,3,CTAATGTGTCTATTGTCCGG,15,1881678
icdC_predicted,0.5,4,3,CGGTGTACTTCGTATACGTG,1,1887193
icdC_predicted,3.0,14,3,CGGGAGTCTCTTATGATCAC,11,1900287
icdC_predicted,0.75,5,3,CGGAAGGGCTCATGAACTCG,2,1884177
icdC_predicted,5.0,22,3,CGCGACCTCGACTGAGAATG,19,1884958
icdC_predicted,3.75,17,3,CGCAGAGGGGCTGCGTCGTA,14,1881733
icdC_predicted,0.5,4,3,CGCACCTTGCAACTATATGT,1,1897264
icdC_predicted,4.0,18,3,CGAATCAGAGCGTATTCTCT,15,1890918
icdC_predicted,6.5,28,3,CCTTTCGAGGCGGCTGATAA,25,1887182
icdC_predicted,3.0,14,3,CCTATTTCTACGAGAGCTGT,11,1879525
icdC_predicted,0.5,4,3,CCGCATCCATCTAGATAGAA,1,1906961
icdC_predicted,9.25,39,3,CCGCACAACGGCTTAGTCCA,36,1890109
icdC_predicted,0.5,4,3,CCGATGATGCCCGTTAGAAG,1,1905658
icdC_predicted,2.0,10,3,CCGAATGTTCAAGGAGATTA,7,1890682
icdC_predicted,7.5,32,3,CCGAAGCAATCCGGTTTGAG,29,1901745
icdC_predicted,2.0,10,3,CCCTATATTTTCCTACAATT,7,1880598
icdC_predicted,3.25,15,3,CCCGGATACAACTAAAAAGC,12,1886337
icdC_predicted,5.25,23,3,CCATAGACTCCAATCGGTAA,20,1895906
icdC_predicted,5.75,25,3,CCAGTTGCCCCGTTACGATG,22,1895607
icdC_predicted,5.25,23,3,CCAGTACTATCAGACTAGGA,20,1881902
icdC_predicted,4.25,19,3,CCAGGAGTCCACGGGCGCGG,16,1898836
icdC_predicted,3.25,15,3,CCACATGCACACAGAGCGAT,12,1897646
icdC_predicted,1.0,6,3,CCAAACAAAGCCCGTGCCTC,3,1897858
icdC_predicted,2.75,13,3,CATGTGATCGATGCGGCTCA,10,1885204
icdC_predicted,4.5,20,3,CAGTGCGAAAAGATCGAACT,17,1896525
icdC_predicted,6.0,26,3,CAGCACTGCCCTAATACGTT,23,1902466
icdC_predicted,3.0,14,3,CACGGGGACTCGGGGCAAGG,11,1904243
icdC_predicted,4.25,19,3,CACGCTCCGCCCAGTGTAGT,16,1878932
icdC_predicted,4.5,20,3,CACATCTCGGGCGAGCAGAG,17,1900219
icdC_predicted,0.5,4,3,CAATAGGAATTTAGTTTTCT,1,1889121
icdC_predicted,0.5,4,3,ATTTGTCTGGGGTCGTCCCC,1,1887175
icdC_predicted,4.5,20,3,ATTGATGAATTTCAGACAAC,17,1902108
icdC_predicted,0.5,4,3,ATTCAGAAACTACGATATGA,1,1901865
icdC_predicted,3.5,16,3,ATTACGGGTCCCATATTTAT,13,1899978
icdC_predicted,10.75,45,3,ATGTTCTCTGTCATCTGTAA,42,1902147
icdC_predicted,0.5,4,3,ATGTACCGATCGGTGCATAC,1,1892133
icdC_predicted,3.5,16,3,ATCCATGGTACGCGCTCGAA,13,1906389
icdC_predicted,3.75,17,3,ATCAGCTGGGGGGAGCAAAA,14,1881956
icdC_predicted,18.5,76,3,ATACGGATGGTAAACGGCAA,73,1891151
icdC_predicted,9.0,38,3,AGTGCTCAGGTCGCCAATCA,35,1886647
icdC_predicted,1.25,7,3,AGTCTGTTCCCTGGCCTGGT,4,1879200
icdC_predicted,6.5,28,3,AGGCCCTGTGCTAAGGACGG,25,1900661
icdC_predicted,0.5,4,3,AGGCCCCGGGCTGGGATCTT,1,1888108
icdC_predicted,1.75,9,3,AGCCCAATAGTATGAATTGT,6,1896257
icdC_predicted,5.0,22,3,AGCATACGTGAATATTACAG,19,1898341
icdC_predicted,1.0,6,3,AGACGACCCGGTCAAGTGAG,3,1892829
icdC_predicted,3.75,17,3,ACTGCGCCAGCACCCGCTTT,14,1891823
icdC_predicted,4.75,21,3,ACTCGTTCACTAGGACTGCC,18,1883204
icdC_predicted,2.25,11,3,ACTATGACCCTTTTCCAACA,8,1880023
icdC_predicted,0.5,4,3,ACGTTGTTGTGGGAACAATC,1,1907452
icdC_predicted,1.5,8,3,ACGGGGAAGGAACCGGCCCT,5,1897484
icdC_predicted,1.25,7,3,ACGGCTTTTTTCATAACGTT,4,1887228
icdC_predicted,6.25,27,3,ACCTTGAGCGTAGCGCGCCA,24,1892176
icdC_predicted,4.0,18,3,ACCTATTCGTGAACCCATTA,15,1897569
icdC_predicted,8.5,36,3,ACCGGTGTGCATTCATAAGG,33,1893165
icdC_predicted,2.0,10,3,ACCGAGGTATTGTCCACAAT,7,1880670
icdC_predicted,7.25,31,3,ACCCACGTCGGTACGCCAGG,28,1905644
icdC_predicted,5.75,25,3,ACCCAACTGGAACTGCCATG,22,1880554
icdC_predicted,2.75,13,3,AATCCCGCGATGGTTTCTCA,10,1879033
icdC_predicted,14.75,61,3,AAGGTTATTAGGTCGGTCTA,58,1900605
icdC_predicted,5.5,24,3,AAGGCCGCGAGACAGTCAAA,21,1889697
icdC_predicted,4.75,21,3,AAGCGCTGGTAGGCCTAGTC,18,1887525
icdC_predicted,11.25,47,3,AAGATTTTATGGGAGGCCGT,44,1894092
icdC_predicted,7.0,30,3,AACTCGCGGAATAAGGTACG,27,1901062
icdC_predicted,19.75,81,3,AACGAAGTGTGAATTTGTCG,78,1885710
icdC_predicted,5.5,24,3,AACATCAATGCTAACGTATA,21,1906987
icdC_predicted,3.0,14,3,AAAACGTGTCCCTGCGCGCA,11,1888182
icdC_predicted,5.0,16,2,TTTGCCTCCGTTCTCTCCGG,14,1880798
icdC_predicted,2.0,7,2,TTTCTTACCATGTACCGCTC,5,1905078
icdC_predicted,5.666666666666667,18,2,TTTCTCTCATCTGTTGACCC,16,1879745
icdC_predicted,9.0,28,2,TTTCCCCGAAGCGAGTGCTG,26,1908270
icdC_predicted,0.6666666666666666,3,2,TTGTTTGCCAAGCTACTCGT,1,1908604
icdC_predicted,0.6666666666666666,3,2,TTGGCGCGAGGAGGATAGAT,1,1889389
icdC_predicted,0.6666666666666666,3,2,TTGCTCAATCAAGTCATAAC,1,1898499
icdC_predicted,7.0,22,2,TTGCCACTAGCTGTCATGCG,20,1896722
icdC_predicted,14.666666666666666,45,2,TTGAACCACAGCTACACTGC,43,1906932
icdC_predicted,17.333333333333332,53,2,TTACTTCCCCGTTACATAAC,51,1889742
icdC_predicted,0.6666666666666666,3,2,TTACTTAATTGAGCGAGCTT,1,1877899
icdC_predicted,10.333333333333334,32,2,TTACGGGGGGAAAGTCCGTT,30,1907216
icdC_predicted,2.6666666666666665,9,2,TTAACAACCCCAGTACGCTT,7,1899200
icdC_predicted,3.3333333333333335,11,2,TGTAATCTAAAACTTTCTGC,9,1905535
icdC_predicted,6.666666666666667,21,2,TGGGTTACGAGGGGGCGCTG,19,1900307
icdC_predicted,0.6666666666666666,3,2,TGGCGCGAACCAAGTAATCA,1,1904451
icdC_predicted,5.333333333333333,17,2,TGGCAGAGGTGTCAGTGCTG,15,1905202
icdC_predicted,8.666666666666666,27,2,TGGAGGTAAATACTGATCGG,25,1904775
icdC_predicted,13.333333333333334,41,2,TGCGTATTGGGAGCCGGACG,39,1879895
icdC_predicted,0.6666666666666666,3,2,TGCGGGGAAGGCGGTACGGT,1,1886824
icdC_predicted,25.333333333333332,77,2,TGCAATGGCTGCAGTTTCGT,75,1888676
icdC_predicted,2.0,7,2,TGAGTTTTCCAGTGGTTCCA,5,1879226
icdC_predicted,0.6666666666666666,3,2,TCTTAACACCTCCGAATGTC,1,1894466
icdC_predicted,7.0,22,2,TCGAGCCTTACGTTTATATC,20,1880104
icdC_predicted,0.6666666666666666,3,2,TCGAGATGCGCCGTCAAGCT,1,1887492
icdC_predicted,0.6666666666666666,3,2,TCGACAGAGGTGGGGATCTA,1,1891112
icdC_predicted,18.0,55,2,TCCTATACGGAAAGAGAATA,53,1904641
icdC_predicted,2.0,7,2,TCCCACTGAGGCAAAGCTGG,5,1883862
icdC_predicted,1.3333333333333333,5,2,TCAGCGCACTTGTAAGTGTT,3,1902839
icdC_predicted,4.333333333333333,14,2,TCACGGCTAGCTTATTCCCT,12,1898192
icdC_predicted,3.6666666666666665,12,2,TATTTTGCATTGCGTAATTT,10,1888521
icdC_predicted,5.333333333333333,17,2,TATTGATTGGGCGGGCATCC,15,1902413
icdC_predicted,7.0,22,2,TAGGTCGCCAGATTTTCAAT,20,1908826
icdC_predicted,11.333333333333334,35,2,TAGGCAGCGCTAGTTTGTCT,33,1891934
icdC_predicted,11.666666666666666,36,2,TAGCTAGGGAGATTGGGCGA,34,1879820
icdC_predicted,8.333333333333334,26,2,TAGCCATAGTAACCGATAAC,24,1905411
icdC_predicted,8.333333333333334,26,2,TACTCCCAGTTTATCGTGGT,24,1887078
icdC_predicted,4.0,13,2,TACTACGTCCCATCATAATT,11,1901435
icdC_predicted,7.0,22,2,TACGTGGGGACAAGGAATAC,20,1879678
icdC_predicted,6.0,19,2,TACCGCGGTCGCCAGCCCTG,17,1890152
icdC_predicted,12.333333333333334,38,2,TACATGGTCCGTATACGTAT,36,1893018
icdC_predicted,3.6666666666666665,12,2,TAACGTGGGTGTATTGGACT,10,1901431
icdC_predicted,5.0,16,2,TAAAGGAGGTAGACCTTCAG,14,1897735
icdC_predicted,2.0,7,2,GTGTTACCCCAGCCCCAGGG,5,1898663
icdC_predicted,5.333333333333333,17,2,GTGTCCTACGCGGTCGTCGC,15,1904220
icdC_predicted,0.6666666666666666,3,2,GTGGATCTGTGGTCTTTTCT,1,1892626
icdC_predicted,1.0,4,2,GTGAAACTGGATCCTAGTGC,2,1897500
icdC_predicted,1.3333333333333333,5,2,GTCTTTGTACGTGTATTACT,3,1895922
icdC_predicted,14.666666666666666,45,2,GTATTCTGACTTATTTAGCG,43,1898757
icdC_predicted,7.666666666666667,24,2,GTAGAATGTTCCAACTATTC,22,1908218
icdC_predicted,0.6666666666666666,3,2,GGTTAATTCGGCCTACGCTT,1,1888682
icdC_predicted,11.333333333333334,35,2,GGTGTTCGTTAATGCGCCTC,33,1892646
icdC_predicted,4.0,13,2,GGTCGATCAGCTATAGAGGC,11,1881337
icdC_predicted,0.6666666666666666,3,2,GGTCACCGTAAATAATGGCC,1,1908394
icdC_predicted,3.0,10,2,GGTATTCAACAGGACCTCAA,8,1899189
icdC_predicted,1.0,4,2,GGGTGTAGTCTTGATTAGTG,2,1902364
icdC_predicted,18.0,55,2,GGGCGCTAAGGAGGCTGGAG,53,1896643
icdC_predicted,0.6666666666666666,3,2,GGGAAAGATTGAAGCCATCT,1,1883861
icdC_predicted,7.0,22,2,GGCTTAAATCACACGTTGTT,20,1904063
icdC_predicted,18.0,55,2,GGCTAGGCTGCCCATGGTCC,53,1885043
icdC_predicted,7.666666666666667,24,2,GGCCTTCTGTGCTAAGGGTT,22,1893524
icdC_predicted,8.0,25,2,GGCCAACTTCACGGGTCCCT,23,1897756
icdC_predicted,8.333333333333334,26,2,GGACACTGGTCATGTGCCTT,24,1902539
icdC_predicted,9.0,28,2,GGACACTCTTGAGTATCACT,26,1879255
icdC_predicted,29.666666666666668,90,2,GGAAGCTGTGTAAGTGGAAG,88,1905640
icdC_predicted,10.666666666666666,33,2,GCTCTCTCGACACCCTTCAC,31,1896969
icdC_predicted,0.6666666666666666,3,2,GCTCAAAGGTAACACCGGGC,1,1887173
icdC_predicted,6.0,19,2,GCTACCAGCTCGAGACGGCC,17,1897790
icdC_predicted,0.6666666666666666,3,2,GCGTGGATAGGGGCTAAAAC,1,1883859
icdC_predicted,2.3333333333333335,8,2,GCCGCGGGTACCATCCAGAG,6,1885427
icdC_predicted,8.333333333333334,26,2,GCCCCGAGTCTGGTGCACCA,24,1883960
icdC_predicted,4.666666666666667,15,2,GCCAACCCCGTCTATCGCGT,13,1888331
icdC_predicted,6.666666666666667,21,2,GCATGTGGCAATTGACCCAG,19,1886051
icdC_predicted,3.0,10,2,GCAGAACCTTTAAAGTTGGT,8,1896177
icdC_predicted,1.0,4,2,GATCATTGTTCGGAAAGTCC,2,1895773
icdC_predicted,9.666666666666666,30,2,GATAGATCGACGCAGCTAAG,28,1892599
icdC_predicted,3.3333333333333335,11,2,GAGTCAGAAGGTAATTTTGC,9,1897413
icdC_predicted,7.666666666666667,24,2,GAGGGCATTGGTTCAGACGA,22,1893572
icdC_predicted,5.666666666666667,18,2,GACGAGTAGTAGTGTCTGTA,16,1895113
icdC_predicted,5.0,16,2,GAATGAGCGCCTTTTAGGCT,14,1880474
icdC_predicted,6.666666666666667,21,2,GAATCCAGGTCTGTTACGAA,19,1883028
icdC_predicted,7.333333333333333,23,2,GAACACGTCGGAATGTACAT,21,1888309
icdC_predicted,0.6666666666666666,3,2,CTTCTCCCAGCTACTGGTTA,1,1895790
icdC_predicted,0.6666666666666666,3,2,CTTAATTTATTGTAGCGTTT,1,1899211
icdC_predicted,12.666666666666666,39,2,CTGTCCGCATGGGCTTACGA,37,1898460
icdC_predicted,1.0,4,2,CTGACTAACACGGTGGGTGC,2,1907068
icdC_predicted,3.3333333333333335,11,2,CTCTCGCCATCCTCGAATTT,9,1897441
icdC_predicted,6.666666666666667,21,2,CTCTAGTCAAGCCCGCGGGC,19,1878333
icdC_predicted,0.6666666666666666,3,2,CTCCCAAGCTATCTGCCTGA,1,1893416
icdC_predicted,1.0,4,2,CTCCATCCTCCGCTTTCCTC,2,1909160
icdC_predicted,14.666666666666666,45,2,CTCATCCGGGAAGTAGTATA,43,1901848
icdC_predicted,2.6666666666666665,9,2,CTCACACCTCTCGTGCTGGC,7,1898988
icdC_predicted,3.3333333333333335,11,2,CTAACCTAGGCACGGATCGC,9,1894045
icdC_predicted,15.0,46,2,CGTTACCTTCAGGTTGGGGT,44,1878825
icdC_predicted,4.666666666666667,15,2,CGTGTCAACGGGCACCGTGG,13,1908561
icdC_predicted,2.0,7,2,CGGTGGTGCATGGCTACTGT,5,1886048
icdC_predicted,8.666666666666666,27,2,CGGTGCCATACTAGATCCTT,25,1899397
icdC_predicted,7.666666666666667,24,2,CGGGTAGGTAGAGGATTCAA,22,1895197
icdC_predicted,0.6666666666666666,3,2,CGGGCCGGGTGTCTTGAGGC,1,1887792
icdC_predicted,0.6666666666666666,3,2,CGGCCTGGGACATGTCGTAC,1,1885036
icdC_predicted,0.6666666666666666,3,2,CGCTCCGAGGTTTTGTTTTT,1,1887774
icdC_predicted,0.6666666666666666,3,2,CGCAGGACGCGTAATCATTT,1,1885609
icdC_predicted,3.3333333333333335,11,2,CGATCCCACGTCTAATGTAG,9,1899258
icdC_predicted,5.333333333333333,17,2,CCTTAGACACATTTGGACTC,15,1884445
icdC_predicted,8.666666666666666,27,2,CCTCTCTTTTAAACCTGCCA,25,1887005
icdC_predicted,0.6666666666666666,3,2,CCTACCTTACACGGTTGAAC,1,1884183
icdC_predicted,3.0,10,2,CCGTGCTGGTGGTCTTGCTA,8,1887752
icdC_predicted,2.3333333333333335,8,2,CCGCCATAGCTGGGGGTCGC,6,1881765
icdC_predicted,2.0,7,2,CCGATCGTATCACTAATATT,5,1904321
icdC_predicted,12.333333333333334,38,2,CCGACAAACGTCCACAACTA,36,1892093
icdC_predicted,6.0,19,2,CCGAATCTGACTGAAATTCT,17,1885804
icdC_predicted,9.0,28,2,CCCTTGTGGCCATTAGCCTG,26,1884975
icdC_predicted,4.666666666666667,15,2,CCCCCTCCCAATCGCTTGAG,13,1904492
icdC_predicted,13.333333333333334,41,2,CCATCAGAAGGCGATAGGCA,39,1900313
icdC_predicted,5.333333333333333,17,2,CCACTACAGGGCCACTTACG,15,1893808
icdC_predicted,4.333333333333333,14,2,CCACCTTGTACTCTCTACCA,12,1894975
icdC_predicted,0.6666666666666666,3,2,CATCAAGCGCTCACCAGCGA,1,1896842
icdC_predicted,3.0,10,2,CACGTTCTGCCAGTGGGGTG,8,1888698
icdC_predicted,7.666666666666667,24,2,CACGGGGGTTGGTCTGGTGC,22,1895858
icdC_predicted,6.666666666666667,21,2,CACGAGACTCGCTAGCCCGT,19,1904563
icdC_predicted,9.333333333333334,29,2,CACCACGTTCGGTTCAATAA,27,1883860
icdC_predicted,1.0,4,2,CACATAGAGCCGATAACCAA,2,1882183
icdC_predicted,11.0,34,2,CAAGATCGTAGGATGGGCGA,32,1900761
icdC_predicted,10.666666666666666,33,2,ATTCCCAGTCAAAGGTGGGA,31,1893076
icdC_predicted,4.0,13,2,ATGTCGAGTCGTTCTATGGT,11,1904975
icdC_predicted,0.6666666666666666,3,2,ATGGTAATCGGGAAAGAAAT,1,1881460
icdC_predicted,0.6666666666666666,3,2,ATGGGGGCCGCTGCCAGGTT,1,1902101
icdC_predicted,9.0,28,2,ATGGATGGAACGTGTACCGG,26,1896714
icdC_predicted,4.333333333333333,14,2,ATGCGCCGGTCTTTGTTGCG,12,1905367
icdC_predicted,9.0,28,2,ATCTTCATGTTTGCCCGCTA,26,1880939
icdC_predicted,2.0,7,2,ATCGCTGGGGGTTCCTTATG,5,1907758
icdC_predicted,10.333333333333334,32,2,ATCATAGCTCATGATTGCAG,30,1883243
icdC_predicted,11.333333333333334,35,2,ATCAGACTGACAATGTGGCA,33,1878285
icdC_predicted,14.666666666666666,45,2,ATCACATAACCCTTGAGATG,43,1889021
icdC_predicted,0.6666666666666666,3,2,ATCACAGTGCCGGACACGAA,1,1887083
icdC_predicted,0.6666666666666666,3,2,ATATTACATCCACCCTGGTC,1,1897127
icdC_predicted,11.333333333333334,35,2,ATAGTCAGGACTCCCCTATG,33,1904977
icdC_predicted,3.3333333333333335,11,2,ATAGACATCACGTTAGACGC,9,1905395
icdC_predicted,18.0,55,2,ATACCAGCATATGAAATACA,53,1893191
icdC_predicted,9.666666666666666,30,2,AGTTTAGGTTGGACACAAGC,28,1904537
icdC_predicted,5.333333333333333,17,2,AGTGTGTGACATCATTATAA,15,1886722
icdC_predicted,6.666666666666667,21,2,AGTGGAGTATGATTCCTGCG,19,1896035
icdC_predicted,0.6666666666666666,3,2,AGTGCGAGCGTAGCCTAAAG,1,1899970
icdC_predicted,0.6666666666666666,3,2,AGTGATGTGTATCCCAGACG,1,1883935
icdC_predicted,0.6666666666666666,3,2,AGTCTCTAACATCATAGAAT,1,1890628
icdC_predicted,16.0,49,2,AGTAGGGGTAAGCTCGACTA,47,1900356
icdC_predicted,3.0,10,2,AGTAGCTATTTGTATACTCC,8,1882495
icdC_predicted,8.0,25,2,AGGTTTGGTTAACAAGGCTT,23,1904615
icdC_predicted,5.0,16,2,AGGTGATATCTCCACGGGAC,14,1901277
icdC_predicted,0.6666666666666666,3,2,AGCTCCAGGGTAAGCAGGCT,1,1894351
icdC_predicted,11.333333333333334,35,2,AGCGGCTCAGATTCAACGAC,33,1889366
icdC_predicted,5.666666666666667,18,2,AGCCGCATATACGGGTCAAA,16,1882597
icdC_predicted,0.6666666666666666,3,2,AGCACTTTGGAACCAAGTTT,1,1892335
icdC_predicted,7.0,22,2,AGATTCCGCGTCCGCTGGGG,20,1898371
icdC_predicted,3.0,10,2,AGACATGTGTCGTAACGTTA,8,1897721
icdC_predicted,4.666666666666667,15,2,ACGTGCCAGTAGTGAGATCA,13,1886326
icdC_predicted,1.6666666666666667,6,2,ACCTCCTGGAATGACACCAC,4,1880972
icdC_predicted,11.333333333333334,35,2,ACCCCCTTTACGCGCTTCAC,33,1882513
icdC_predicted,4.333333333333333,14,2,ACATCTTGCTACGTATAGTG,12,1892831
icdC_predicted,12.333333333333334,38,2,ACATACAAGAAGGCAGCGCT,36,1895623
icdC_predicted,7.666666666666667,24,2,AATGGCCACTCACGTTTCTT,22,1896034
icdC_predicted,14.666666666666666,45,2,AACGTTTTCTCGTTCCGGGG,43,1899728
icdC_predicted,1.0,2,1,TTTTTTGCGACTCTGGTACT,1,1882073
icdC_predicted,5.5,11,1,TTTTTCCTGAGAAGCCTTTA,10,1892434
icdC_predicted,14.5,29,1,TTTGATGGTATAACCAAATC,28,1892520
icdC_predicted,15.5,31,1,TTTACCAAGTCGTTTGGTGT,30,1892257
icdC_predicted,7.0,14,1,TTGGGGGGCGCTGGTCCGGC,13,1909261
icdC_predicted,7.5,15,1,TTGCATGTATGTGGCGCCTC,14,1905374
icdC_predicted,19.0,38,1,TTAGGTCGGGCTATGAGAGT,37,1905669
icdC_predicted,1.0,2,1,TGTTTGTAGCTACGGTCCCG,1,1893064
icdC_predicted,1.0,2,1,TGTCCTTAAAAACGTATGGT,1,1897588
icdC_predicted,6.5,13,1,TGGTTCAGGATAGGGCACCT,12,1893366
icdC_predicted,7.5,15,1,TGCGGCTTATAAATAAAGAT,14,1895821
icdC_predicted,8.0,16,1,TGACGGATATGCCACGTCAA,15,1890650
icdC_predicted,12.5,25,1,TGACACTTCGTTTACTCAAC,24,1889772
icdC_predicted,10.0,20,1,TGACAATTCGTTCCGGAACT,19,1879206
icdC_predicted,7.5,15,1,TGAACGAGGACGTTCGGAGT,14,1878512
icdC_predicted,4.5,9,1,TCTTCTGAAAGGGGGTCAAA,8,1888034
icdC_predicted,6.5,13,1,TCTGTTTCGAGTTAGCGCGT,12,1879524
icdC_predicted,2.5,5,1,TCTGACCCGCGGATCAATCT,4,1880668
icdC_predicted,14.5,29,1,TCGTGTGCTACTGCGCGGCC,28,1893361
icdC_predicted,1.0,2,1,TCGGGTAACTTACCAATCAC,1,1890456
icdC_predicted,6.0,12,1,TCGCCCCGAATATCGGCAAT,11,1896287
icdC_predicted,5.5,11,1,TCCGTGCGCGCCTTACCATT,10,1899468
icdC_predicted,57.5,115,1,TCCCGGTACCAGGGCACCCG,114,1892151
icdC_predicted,4.5,9,1,TCCAGAACACCTGGCAAGTG,8,1889023
icdC_predicted,1.0,2,1,TCAGGTCCGCCGGCGACTTT,1,1901308
icdC_predicted,6.0,12,1,TCAGGAGCGTCGTAAGGACG,11,1901110
icdC_predicted,1.0,2,1,TCAGGAAGGGACTTACCTGA,1,1896302
icdC_predicted,9.0,18,1,TCAGATAGTCCAACGTGAGC,17,1900105
icdC_predicted,13.5,27,1,TCACGTCTTTTCTCTTCTCG,26,1880438
icdC_predicted,5.5,11,1,TCAAAAGCCTAGGTGTAGCT,10,1908372
icdC_predicted,11.0,22,1,TATCAGGCTCGTTGACTCGT,21,1878807
icdC_predicted,1.0,2,1,TATATTATGCTGTTTCTTGA,1,1898018
icdC_predicted,13.0,26,1,TAGATAGACCCGGACTACTG,25,1896456
icdC_predicted,16.5,33,1,TACTCCACGTTAACAAGACG,32,1900365
icdC_predicted,8.0,16,1,TACTAAGAAGTGTGAGAGCT,15,1900394
icdC_predicted,1.0,2,1,TACCGTTCAGATCGAGAAAA,1,1899917
icdC_predicted,1.0,2,1,TAACCAGCGAGCGGGGTGGA,1,1891707
icdC_predicted,13.5,27,1,TAAAATGGAGTATAATGCAA,26,1892334
icdC_predicted,4.5,9,1,GTTTAATGGCCGGTCCTCTC,8,1899316
icdC_predicted,1.0,2,1,GTTGGGATTCGGGGCTATGG,1,1899010
icdC_predicted,18.0,36,1,GTTGCTAATCACAATATCCG,35,1891791
icdC_predicted,1.5,3,1,GTTGCCGAGCACCACAGTAC,2,1887109
icdC_predicted,13.0,26,1,GTTAGGGGAGGTCGCCTCCA,25,1906964
icdC_predicted,7.5,15,1,GTCTCCAGCACAGGGGTTAT,14,1887407
icdC_predicted,11.0,22,1,GTCGTGTTACAGTCTTAGGA,21,1889873
icdC_predicted,1.5,3,1,GTCGCATCGTAATCGTCACG,2,1891712
icdC_predicted,11.0,22,1,GTACGGTCTCATATATGTAT,21,1884577
icdC_predicted,1.0,2,1,GTACCATCAAGATAGAATTG,1,1884028
icdC_predicted,19.5,39,1,GGTTATACTTCCTTCGGTTA,38,1905625
icdC_predicted,1.5,3,1,GGGCACCCACATTATAGTTG,2,1909506
icdC_predicted,16.5,33,1,GGGACCCCAAATGGCTTTGG,32,1894682
icdC_predicted,10.0,20,1,GGCCTACGAGGCTAAGACGG,19,1909281
icdC_predicted,9.5,19,1,GGCAACCTGGAGGCTCCTAA,18,1898166
icdC_predicted,2.5,5,1,GGAGCTACGTCTTTCTGCGC,4,1885007
icdC_predicted,1.0,2,1,GCTCTACTACACTGTTACAT,1,1897095
icdC_predicted,6.0,12,1,GCTCGGCACCGGCGTTGGTG,11,1906768
icdC_predicted,17.0,34,1,GCTCGAAACGCTGACTGGTT,33,1885739
icdC_predicted,6.0,12,1,GCGTTATTAGTTGAAAGAGA,11,1886438
icdC_predicted,5.5,11,1,GCGTGGCCCAGAGTCGCAAG,10,1893823
icdC_predicted,7.5,15,1,GCGTATCTTGGCCGTCGAAT,14,1887449
icdC_predicted,12.0,24,1,GCGCGCTCCAGTGGGTAGCC,23,1897825
icdC_predicted,15.5,31,1,GCGCAGGCCGTTGAAGAGAT,30,1883356
icdC_predicted,2.5,5,1,GCGCACCGACAGTGAGTGTA,4,1902189
icdC_predicted,8.5,17,1,GCGACAACCTTGTGCAAAAA,16,1879071
icdC_predicted,10.0,20,1,GCGAAAGACAATAGCGGTCG,19,1878340
icdC_predicted,1.0,2,1,GCGAAAATGGCGCAGACTTT,1,1888653
icdC_predicted,1.5,3,1,GCCGAACGGACTGTCGTGGC,2,1904213
icdC_predicted,2.5,5,1,GCCCGCCCCCAATCACCTTT,4,1888767
icdC_predicted,15.5,31,1,GCAGTGCGATCAGCCTCCGA,30,1893929
icdC_predicted,1.0,2,1,GATTCTTCGTTAGAAGAGGT,1,1895017
icdC_predicted,9.5,19,1,GATAGTGTGAATCTGTCCGG,18,1891139
icdC_predicted,4.5,9,1,GAGGTTGGCGGCCACTCTGC,8,1888322
icdC_predicted,11.0,22,1,GACTACCTACGGCCTAGGCA,21,1879549
icdC_predicted,9.5,19,1,GACGGCCAGTCCGAAGCGGT,18,1899395
icdC_predicted,11.0,22,1,GACCGGTAATCATACTTTCT,21,1892740
icdC_predicted,1.0,2,1,GACATATCGTATTCCTGTCA,1,1888211
icdC_predicted,6.5,13,1,GACAGGTATGTTAGCCTCAT,12,1883378
icdC_predicted,5.5,11,1,GAAGCTCCTCTCTGAGTATA,10,1903611
icdC_predicted,6.0,12,1,CTTTTAGTCATGGCTTCTTT,11,1883252
icdC_predicted,9.0,18,1,CTTGGAGTTGACAATAACAA,17,1889812
icdC_predicted,1.0,2,1,CTTGCCGAAAGACCTTAAGC,1,1890123
icdC_predicted,1.0,2,1,CTTATGCCGTAGTACTCAGG,1,1897703
icdC_predicted,1.0,2,1,CTCTCAACAGTAGTGTTGTA,1,1891152
icdC_predicted,17.0,34,1,CTCGTTTCACTGTAGTACGC,33,1880105
icdC_predicted,9.0,18,1,CTCGAGATTATCGCATTTCT,17,1883089
icdC_predicted,4.5,9,1,CTACCGTTGTATTGAACTGT,8,1897555
icdC_predicted,2.5,5,1,CGTTGAACAAGATACACGAG,4,1900990
icdC_predicted,2.5,5,1,CGTCACCGCGTAAGATCGGG,4,1879571
icdC_predicted,18.5,37,1,CGGCTAAAGATACTCAGTGG,36,1879908
icdC_predicted,14.0,28,1,CGCGATATTTACGGGAACAC,27,1878155
icdC_predicted,11.5,23,1,CGCCGGTTTCGGTAGTATTT,22,1897654
icdC_predicted,1.5,3,1,CGAGTGTGCATTTATAGCAG,2,1897119
icdC_predicted,5.0,10,1,CGAATCGAGGTGTATGATAA,9,1893978
icdC_predicted,6.5,13,1,CGAACTCAAAGTCGGGGAAC,12,1889507
icdC_predicted,7.0,14,1,CCTAGCCCCACTGGTTAGCA,13,1904169
icdC_predicted,10.5,21,1,CCGTCCCGTGAGCCGGCGGC,20,1903413
icdC_predicted,3.5,7,1,CCGTAAGCGACTTTTGTGAA,6,1891797
icdC_predicted,26.0,52,1,CCGGGAGCAATAAGGGTGTC,51,1905473
icdC_predicted,11.0,22,1,CCGGAGCCCGAGGTCATCCT,21,1887107
icdC_predicted,18.5,37,1,CCCGTGGGTATGCACCCTTG,36,1898676
icdC_predicted,6.5,13,1,CCCACGTAGGGCCGCGGCTC,12,1907705
icdC_predicted,15.0,30,1,CCATTTTCAAAGTCGCGCTT,29,1885985
icdC_predicted,1.0,2,1,CCAATGAACCCACAGATGGT,1,1906778
icdC_predicted,6.5,13,1,CCAAGGTGTTATCGTTGGTC,12,1905661
icdC_predicted,2.5,5,1,CATGTAGATTACAGGTAGCT,4,1886054
icdC_predicted,17.5,35,1,CAGGTAGCGCGGTCGTACCA,34,1886106
icdC_predicted,6.0,12,1,CAGAACAAGCAGCTGCTACT,11,1882768
icdC_predicted,23.5,47,1,CAGAAAGCCGTGAAGAACTA,46,1890696
icdC_predicted,7.5,15,1,CACTAGCAGCGCAATACCTA,14,1907227
icdC_predicted,8.5,17,1,CACTACATTCCCCGCAACGC,16,1883669
icdC_predicted,4.5,9,1,CACGAGACGCTTCTTGGACT,8,1908545
icdC_predicted,5.0,10,1,CACGACACCAGTCTAGGTTA,9,1890145
icdC_predicted,2.0,4,1,CACCATCATGTCTATTTTGA,3,1897601
icdC_predicted,1.0,2,1,CACCAAACTACGGGAAATCA,1,1879173
icdC_predicted,1.0,2,1,CACATCGCTACTCGAGACTA,1,1899544
icdC_predicted,3.0,6,1,CACATCAACTGGTCCAAAAT,5,1879911
icdC_predicted,9.5,19,1,CACAAAGCCGATAACCGTGT,18,1878782
icdC_predicted,13.0,26,1,CAATTGAAGTGGGACTGCGT,25,1894663
icdC_predicted,12.0,24,1,CAATGCGATTGCGTGGCACG,23,1883245
icdC_predicted,1.0,2,1,CAAAGTGGTCAATTACAACA,1,1900831
icdC_predicted,17.5,35,1,CAAAGACTGCTCCTAATCCT,34,1908292
icdC_predicted,3.5,7,1,ATTGCCGTCCGTGCTAACTG,6,1894234
icdC_predicted,8.0,16,1,ATTCTTGGAATTTGAGAGGT,15,1878749
icdC_predicted,30.0,60,1,ATTCATACTAGGTGCTTGGA,59,1909035
icdC_predicted,7.5,15,1,ATGGCGGTTAGCACTCGGGT,14,1902704
icdC_predicted,12.0,24,1,ATGGCGCGGAACGGACGCTT,23,1881975
icdC_predicted,8.5,17,1,ATGGCAAGGGTTGACAGTGA,16,1899660
icdC_predicted,11.0,22,1,ATGCTAGAGTCATGCAGGTT,21,1896260
icdC_predicted,5.5,11,1,ATGCAACAACGGGGGTGGTC,10,1895547
icdC_predicted,1.0,2,1,ATGACTGGGGGACAGGTGGG,1,1898111
icdC_predicted,7.0,14,1,ATCTCATTAAACAGGGTACA,13,1900322
icdC_predicted,6.5,13,1,ATCTAACGTTACGCGGCCGA,12,1900950
icdC_predicted,5.0,10,1,ATCAAGACATCGCTCTGGTC,9,1898470
icdC_predicted,2.5,5,1,ATATCTGGCTTCTCCTCTGC,4,1887513
icdC_predicted,11.0,22,1,ATATCGTGTGGGTGCTAATA,21,1895776
icdC_predicted,12.5,25,1,ATATCCTCTTGGGCTCTGAT,24,1902404
icdC_predicted,10.5,21,1,ATAGCCATCGGACCGCAAAA,20,1895988
icdC_predicted,15.5,31,1,ATAGCAAAGAGGAGTGTCCA,30,1900119
icdC_predicted,10.0,20,1,ATAATCGAGGATACATATCC,19,1877995
icdC_predicted,6.5,13,1,ATAACCCGTGGGTCCTGATG,12,1888922
icdC_predicted,1.0,2,1,AGTTTGTTTAATTGGTTGTG,1,1889313
icdC_predicted,10.5,21,1,AGTCCAACTAGCGGACTCAT,20,1902441
icdC_predicted,21.0,42,1,AGGTGTAAGGGCAAGAGCTA,41,1901590
icdC_predicted,1.0,2,1,AGGGCTGGCGACGAAGGTTT,1,1879995
icdC_predicted,3.0,6,1,AGGCCAGTATGCGCCGATGC,5,1879292
icdC_predicted,7.0,14,1,AGGCACCTCGGGATTGCAAT,13,1884798
icdC_predicted,12.5,25,1,AGGATCGACCATAGGCTGGC,24,1881553
icdC_predicted,5.0,10,1,AGGAAGGTCTAAGTCATCTA,9,1888147
icdC_predicted,6.0,12,1,AGCTGCCTCGTACGCCCTAT,11,1908458
icdC_predicted,12.0,24,1,AGCCAACGTTGGAGAGTCCC,23,1891534
icdC_predicted,8.0,16,1,AGATAGCTGTCGGTCATCGT,15,1907119
icdC_predicted,18.0,36,1,AGAACGAAAATTTGAGGTGT,35,1902153
icdC_predicted,14.5,29,1,ACTAGGATGATATATTACAC,28,1883165
icdC_predicted,6.5,13,1,ACGTCATTTCAGTTTGTACA,12,1898008
icdC_predicted,4.0,8,1,ACGGCATGCATCCATAGGAT,7,1895846
icdC_predicted,8.0,16,1,ACGGCAGGTTTCCCGACCCT,15,1882790
icdC_predicted,1.0,2,1,ACGGATCTCAAGAGCTAATC,1,1886483
icdC_predicted,13.5,27,1,ACCGTCGCGGCACTCTCGAC,26,1885564
icdC_predicted,1.0,2,1,ACCGGCAGGCTCAACCAGCA,1,1902068
icdC_predicted,5.0,10,1,ACCAGGGAGATTAGGGTGAA,9,1901742
icdC_predicted,20.0,40,1,ACCAGACCCCGGGATTATGG,39,1886007
icdC_predicted,18.5,37,1,ACCAAATCTCGTACCATGGT,36,1902477
icdC_predicted,10.5,21,1,ACATTACATACGGATAATGA,20,1900247
icdC_predicted,7.0,14,1,ACAGGACTTAACGCTTGATT,13,1887287
icdC_predicted,22.0,44,1,ACAGACTAGGCCGCGGGTCT,43,1880088
icdC_predicted,3.0,6,1,AATTGGCGATCAGGGTTGGA,5,1882715
icdC_predicted,12.5,25,1,AATGTTTTAGCCACGCTTCG,24,1904771
icdC_predicted,6.0,12,1,AATCTCGCTTTATATACATA,11,1902411
icdC_predicted,20.5,41,1,AATACTGATTAGGAAGGTGT,40,1893880
icdC_predicted,9.0,18,1,AATACGCCGTATGGGGCGGA,17,1908182
icdC_predicted,1.0,2,1,AAGTGATACCAGAGGCCGAC,1,1884484
icdC_predicted,6.0,12,1,AAGAAGAGACACCCCGGACG,11,1896226
icdC_predicted,10.0,20,1,AACTAATGATGCAAGCTTGG,19,1893484
icdC_predicted,13.0,26,1,AACCTATCATCGCTGATCAG,25,1881679
icdC_predicted,4.5,9,1,AACCATTTTGGAGTGCACCT,8,1898762
icdC_predicted,0.011627906976744186,85,85,GAGTAGACAACGTTAGGTGA,0,1877966
icdC_predicted,0.015625,63,63,CCCCAAACTAAATTCAATTG,0,1880770
icdC_predicted,0.016666666666666666,59,59,AGGAGTGATAGCATGGGCGG,0,1878421
icdC_predicted,0.018518518518518517,53,53,ACAAGTCCTCGTCCATGAGA,0,1883499
icdC_predicted,0.018867924528301886,52,52,TTAACTGGGTCAGCGGTGGT,0,1878013
icdC_predicted,0.018867924528301886,52,52,CAAGGGGTAGTTATGTTTCT,0,1887191
icdC_predicted,0.019230769230769232,51,51,CGCAGGCCTTTAATAGCACA,0,1893591
icdC_predicted,0.0196078431372549,50,50,AGGGGTATAATGACCGCTCT,0,1903903
icdC_predicted,0.02,49,49,ACTGATACTTACCTATTCAC,0,1880582
icdC_predicted,0.02,49,49,AATTCAGTTCTCGGGATCAC,0,1885800
icdC_predicted,0.02040816326530612,48,48,AAACGCTCAAAGGGTGACCC,0,1900298
icdC_predicted,0.020833333333333332,47,47,CCCCGAGTCGAATCAAGGAC,0,1902114
icdC_predicted,0.020833333333333332,47,47,ATGCATCACCCCGCAGAAGC,0,1898049
icdC_predicted,0.022222222222222223,44,44,TTTTCGATAAGCCCCGCTTA,0,1909204
icdC_predicted,0.022727272727272728,43,43,TCCAGTCACCAATTTCCTAG,0,1881312
icdC_predicted,0.023255813953488372,42,42,GACTAGAGACAGTGCAGTCG,0,1879925
icdC_predicted,0.023809523809523808,41,41,TATTTTAAACGGACGAACTC,0,1896560
icdC_predicted,0.023809523809523808,41,41,GCAACTCTCTTAGAGTGAGC,0,1878186
icdC_predicted,0.023809523809523808,41,41,CGTGGGAAATATACGGTTGT,0,1905335
icdC_predicted,0.023809523809523808,41,41,CGAGTGGGGCCACATCTTCA,0,1880906
icdC_predicted,0.023809523809523808,41,41,CAATATAAACTAATACGTGA,0,1884296
icdC_predicted,0.024390243902439025,40,40,TGGAGAGTTCGTTTTGGGTT,0,1883767
icdC_predicted,0.024390243902439025,40,40,TAATAAGTCAGTACTCATCT,0,1879767
icdC_predicted,0.024390243902439025,40,40,GGCAGGACGGACTCAGTAAT,0,1890984
icdC_predicted,0.024390243902439025,40,40,CGGTCCGCGATCTTCGAGCT,0,1893354
icdC_predicted,0.025,39,39,TTCAACTAATCCGGTTGCAA,0,1897385
icdC_predicted,0.025,39,39,GTGCTCACGAAGGGGTTTAT,0,1886534
icdC_predicted,0.025,39,39,GCGCCTGCTTGAGTCCGTAA,0,1878976
icdC_predicted,0.025,39,39,GATAGGTATGGAATCGCTCA,0,1887862
icdC_predicted,0.02564102564102564,38,38,AAAGGAAAAAATCTAAAAAG,0,1899264
icdC_predicted,0.02631578947368421,37,37,TTCGTTCGAGATACCTTCCT,0,1906960
icdC_predicted,0.02631578947368421,37,37,TGATTTGCAACGGCCGTGGG,0,1887594
icdC_predicted,0.02631578947368421,37,37,GTCGCTATATTTAGAAGCAG,0,1885806
icdC_predicted,0.02631578947368421,37,37,GCCCAATAGGAGACGAGGTG,0,1879992
icdC_predicted,0.02631578947368421,37,37,CGAGCGGAAACGGCAATGAA,0,1886100
icdC_predicted,0.02702702702702703,36,36,GGGTAGCCCTTCGCTCAACC,0,1878663
icdC_predicted,0.02702702702702703,36,36,CAGTTCGGGATCCGGCGTCC,0,1881262
icdC_predicted,0.02702702702702703,36,36,CAGCAGCCACGGTGATATCA,0,1902615
icdC_predicted,0.02702702702702703,36,36,CAAGCAGGTTATAGTACGAT,0,1882437
icdC_predicted,0.02702702702702703,36,36,ATCCCCGGAAGGGGACTCAA,0,1889905
icdC_predicted,0.027777777777777776,35,35,TTAGGCCGTAGCAGTTCGAC,0,1909021
icdC_predicted,0.027777777777777776,35,35,TGCTGTAGCATTGACAGTCA,0,1891790
icdC_predicted,0.027777777777777776,35,35,TGAGCTATAATGTTCTCTCC,0,1891551
icdC_predicted,0.027777777777777776,35,35,ATGGGCAAAGAACCTATATA,0,1899511
icdC_predicted,0.02857142857142857,34,34,GTGTCATAAATTACTGAAGC,0,1898113
icdC_predicted,0.02857142857142857,34,34,GGGCGCACAGATGCAACTGT,0,1883564
icdC_predicted,0.02857142857142857,34,34,CGTGCGACCTATTCAATTTC,0,1888853
icdC_predicted,0.02857142857142857,34,34,CGGACGAGATGCCCATTTCT,0,1889936
icdC_predicted,0.02857142857142857,34,34,CGAGCGGTGTCTAGCGATTG,0,1884450
icdC_predicted,0.02857142857142857,34,34,CCCCGGATAGCCGGAGAGGT,0,1884053
icdC_predicted,0.029411764705882353,33,33,TTCGATGTGGAGGTGTTGGT,0,1878680
icdC_predicted,0.029411764705882353,33,33,TGGCACCACGACTTATGAGT,0,1901113
icdC_predicted,0.029411764705882353,33,33,TGGAAGCCGCTGTGTTAATT,0,1892413
icdC_predicted,0.029411764705882353,33,33,TGCACTCCGGATCTGGGAAA,0,1891768
icdC_predicted,0.029411764705882353,33,33,TCTACAGCTGAGTCTGCAGT,0,1905931
icdC_predicted,0.029411764705882353,33,33,TACCGCCACCCCCGAGATAT,0,1896546
icdC_predicted,0.029411764705882353,33,33,GATAGTCCCCGACTTCACAT,0,1882041
icdC_predicted,0.029411764705882353,33,33,CTCCCTGGAGAGAAGAATAT,0,1879056
icdC_predicted,0.029411764705882353,33,33,CATGGTTATTGTTCGCGCGT,0,1887082
icdC_predicted,0.029411764705882353,33,33,ACCAGAGCATGTCGATTCAA,0,1888540
icdC_predicted,0.030303030303030304,32,32,TTGGTCCTAGTAAAACGCTA,0,1894209
icdC_predicted,0.030303030303030304,32,32,TTAAGCGGCAGATCCACGTT,0,1886114
icdC_predicted,0.030303030303030304,32,32,TACGTATAAGCCGCGGCGAA,0,1906210
icdC_predicted,0.030303030303030304,32,32,GTTAGGGAGATAGTTCTGGT,0,1880587
icdC_predicted,0.030303030303030304,32,32,GTGTACGCGGCTTACCCGGA,0,1895913
icdC_predicted,0.030303030303030304,32,32,GGCACAGCGCCCCTCCCTGT,0,1902342
icdC_predicted,0.030303030303030304,32,32,CAGTCGAGCAACAGTTGAGG,0,1890307
icdC_predicted,0.030303030303030304,32,32,ACCGCATCTCAGATGTAGAA,0,1883222
icdC_predicted,0.030303030303030304,32,32,AACCTATGAATAAATGAGAC,0,1897680
icdC_predicted,0.03125,31,31,GTTCCCCTGCGCGTCAGACT,0,1883627
icdC_predicted,0.03125,31,31,GTGTAATCCATCGTCATCAT,0,1896213
icdC_predicted,0.03125,31,31,GCTAGGCCACCGCCTGGACA,0,1906911
icdC_predicted,0.03125,31,31,ATTTCATCCTGAGAGGACGT,0,1891049
icdC_predicted,0.03125,31,31,ACCTTGTGCATAGCGATGCC,0,1878252
icdC_predicted,0.03125,31,31,ACATGCTAGGGGGGCGGAAT,0,1895361
icdC_predicted,0.03125,31,31,AAGCTGAGCCGATAGTTTCG,0,1887137
icdC_predicted,0.03225806451612903,30,30,TTAGCCCTGTTCAGAAGTAG,0,1891625
icdC_predicted,0.03225806451612903,30,30,TACAACGGCAGGTCTCTAGT,0,1903096
icdC_predicted,0.03225806451612903,30,30,CCGAGGATTGGAATCATTAA,0,1880209
icdC_predicted,0.03225806451612903,30,30,ATCACCTATACCACTATGTG,0,1890488
icdC_predicted,0.03225806451612903,30,30,AATTGCTAGTATCCTAGACG,0,1881001
icdC_predicted,0.03333333333333333,29,29,TGTGACGCGAAGAAGCCTAT,0,1892125
icdC_predicted,0.03333333333333333,29,29,TCCAACAAGGTACTCTGCGC,0,1902222
icdC_predicted,0.03333333333333333,29,29,TAGGAAAATTTCGTTGGCGA,0,1903155
icdC_predicted,0.03333333333333333,29,29,GTCGGGTGGTACAATCAGCC,0,1894147
icdC_predicted,0.03333333333333333,29,29,GCAGATAAGGGCAGCCCTCT,0,1878600
icdC_predicted,0.03333333333333333,29,29,GATCGGGTAGCATCCGGCGA,0,1890441
icdC_predicted,0.03333333333333333,29,29,CTCTCTCACTCTCGGATGAA,0,1882389
icdC_predicted,0.03333333333333333,29,29,CTATGATCGGGGAAATAGTC,0,1890742
icdC_predicted,0.03333333333333333,29,29,CCTAGAGAATCCGCAGGAAA,0,1893152
icdC_predicted,0.03333333333333333,29,29,CATTGTTTTAGTTTGGGCGA,0,1883027
icdC_predicted,0.03333333333333333,29,29,ATAGGCCTAGCTCCAGGGAC,0,1881628
icdC_predicted,0.03333333333333333,29,29,AACATTTAGAGGTGGCCGCT,0,1879280
icdC_predicted,0.034482758620689655,28,28,TTCGATTAGGCCTAGTGACG,0,1893447
icdC_predicted,0.034482758620689655,28,28,TTAAGCTGATAGTCTTACTT,0,1894881
icdC_predicted,0.034482758620689655,28,28,TCGAGGTGGCGTATGGTCCG,0,1905451
icdC_predicted,0.034482758620689655,28,28,TATGCCCTGCGTAGATAGGC,0,1903163
icdC_predicted,0.034482758620689655,28,28,GTTGTTGTCTAGAGCAAGAT,0,1891928
icdC_predicted,0.034482758620689655,28,28,GGAGTGGGGCAACAATATGG,0,1896618
icdC_predicted,0.034482758620689655,28,28,CGGCGGCGAGGCGAGAGAAA,0,1886594
icdC_predicted,0.034482758620689655,28,28,AGCACCGACGACATACTTAG,0,1902967
icdC_predicted,0.034482758620689655,28,28,AAGGGCTCGGGCTTGACTTC,0,1907803
icdC_predicted,0.03571428571428571,27,27,TGGCACTATATTTGGGAATA,0,1890028
icdC_predicted,0.03571428571428571,27,27,TCCGGAGTGTCTTGGCTTGG,0,1886369
icdC_predicted,0.03571428571428571,27,27,TAGGAACGTCCATTGTCAAT,0,1883967
icdC_predicted,0.03571428571428571,27,27,GCATATCTAGTTCCTTACCA,0,1904769
icdC_predicted,0.03571428571428571,27,27,GAGCCCGAGCGCGCGTGCGA,0,1889245
icdC_predicted,0.03571428571428571,27,27,CGTGAGAATGGACACATTGT,0,1894289
icdC_predicted,0.03571428571428571,27,27,CCGCTTCGGTATAGTGAGCT,0,1897177
icdC_predicted,0.03571428571428571,27,27,CATATAGCCGTTTGCTAAGT,0,1887221
icdC_predicted,0.03571428571428571,27,27,AGGCGCCACTCAAGATGATT,0,1885093
icdC_predicted,0.03571428571428571,27,27,AGATCGAGTGTCAGTAGGTG,0,1878471
icdC_predicted,0.03571428571428571,27,27,ACGCCACAACTGGTTATTTC,0,1881094
icdC_predicted,0.03571428571428571,27,27,AATTTAACCAACATCGGATC,0,1897008
icdC_predicted,0.03571428571428571,27,27,AAGAAAGCGCCTAGGAGAGC,0,1893731
icdC_predicted,0.03571428571428571,27,27,AAAGGAGATACGGGTTCGGT,0,1897720
icdC_predicted,0.037037037037037035,26,26,TTTCGCGTTCATTGGCGCAG,0,1885911
icdC_predicted,0.037037037037037035,26,26,TTGAAGTGCAGCGGCCAAGA,0,1892526
icdC_predicted,0.037037037037037035,26,26,TTGAAGCGCTCTCGACATGT,0,1889844
icdC_predicted,0.037037037037037035,26,26,TTCCCAAGGTTGAGTTACTA,0,1896368
icdC_predicted,0.037037037037037035,26,26,TTCAACGGATACATGGTAAG,0,1888719
icdC_predicted,0.037037037037037035,26,26,TGTGTTTCATGCGGCCGTAC,0,1886516
icdC_predicted,0.037037037037037035,26,26,TGCTCTACGGACCTGAACAA,0,1899803
icdC_predicted,0.037037037037037035,26,26,TACGCCCGGAGACGTAGCCC,0,1882994
icdC_predicted,0.037037037037037035,26,26,GTCAAGTGTGACGCGCGGAC,0,1882763
icdC_predicted,0.037037037037037035,26,26,GGTACAGGACGAGGGGGACA,0,1899595
icdC_predicted,0.037037037037037035,26,26,GGGGCGTAACATACGGACCA,0,1909492
icdC_predicted,0.037037037037037035,26,26,GCCCAGAATGAACAGCAAGC,0,1878035
icdC_predicted,0.037037037037037035,26,26,CTCACACTTTGTGTCGGTTC,0,1897683
icdC_predicted,0.037037037037037035,26,26,CGAATGTAACCTCTCTCAGC,0,1899449
icdC_predicted,0.037037037037037035,26,26,CATCGTCTACGAAAGAAAAG,0,1879084
icdC_predicted,0.037037037037037035,26,26,CATCAATGGGCATCATGCAA,0,1890712
icdC_predicted,0.037037037037037035,26,26,CAAACGATGAGACGCATCCA,0,1895300
icdC_predicted,0.037037037037037035,26,26,ATCATACCGGCTAGTTTTGC,0,1893196
icdC_predicted,0.037037037037037035,26,26,ACGTGCCGTCCCCTATTCAC,0,1908106
icdC_predicted,0.037037037037037035,26,26,AAATCTACGCATGCTCGAGA,0,1898658
icdC_predicted,0.037037037037037035,26,26,AAATCATCGCACGCCTATAT,0,1882815
icdC_predicted,0.037037037037037035,26,26,AAAACTTGGTGTTTTTGTCT,0,1900061
icdC_predicted,0.038461538461538464,25,25,TGTCGCTAGAGTGACTGGGT,0,1883789
icdC_predicted,0.038461538461538464,25,25,TGGAGAATACTGACTCATTA,0,1878476
icdC_predicted,0.038461538461538464,25,25,TCGATGGCCACCTGCATGTC,0,1886977
icdC_predicted,0.038461538461538464,25,25,TCAGCTATTACGGTGGGCCT,0,1890341
icdC_predicted,0.038461538461538464,25,25,TAGATCTCTCAGAGTGAGAT,0,1887628
icdC_predicted,0.038461538461538464,25,25,GCGGGATTACTAGACACGTG,0,1884175
icdC_predicted,0.038461538461538464,25,25,CTCTTGTCTTATCTAGAAAC,0,1884261
icdC_predicted,0.038461538461538464,25,25,CTCTTCGTAATGAGGGGCAA,0,1885583
icdC_predicted,0.038461538461538464,25,25,CGACCACAAATGTCTACCGA,0,1899922
icdC_predicted,0.038461538461538464,25,25,CATAGAAAAATACCCGAATT,0,1881290
icdC_predicted,0.038461538461538464,25,25,AGTTAAAACTTAATTACCAA,0,1893329
icdC_predicted,0.038461538461538464,25,25,AGTGACGCGATTCCGGGGTA,0,1908868
icdC_predicted,0.038461538461538464,25,25,AGCAAACGTCAATGAGTGAT,0,1883790
icdC_predicted,0.038461538461538464,25,25,ACTTACAGGACCTGGCTTAT,0,1889908
icdC_predicted,0.038461538461538464,25,25,ACGACAACACGATACAAATT,0,1888430
icdC_predicted,0.038461538461538464,25,25,AACCACGGATCATGCAAATA,0,1886195
icdC_predicted,0.038461538461538464,25,25,AAACGGGGCAAATTGACACG,0,1887515
icdC_predicted,0.04,24,24,TTCAAAGCGGCTTCTCTCGT,0,1894145
icdC_predicted,0.04,24,24,TGTCGTCGGGTACGGGAGGG,0,1885262
icdC_predicted,0.04,24,24,TGTCAAAGGGGCTCTTCGTA,0,1909314
icdC_predicted,0.04,24,24,TAGGATCGTCTTTCAGCAAT,0,1893353
icdC_predicted,0.04,24,24,TAAGTTTTCCGGGCGTTGGC,0,1883138
icdC_predicted,0.04,24,24,GTAACATTGCAGCACTCGAT,0,1879477
icdC_predicted,0.04,24,24,GCTCACGTAATTGTGGAGAT,0,1878997
icdC_predicted,0.04,24,24,GCCCAGACTTCCGAGTAAAC,0,1891247
icdC_predicted,0.04,24,24,GATCTTCGGAAGACTCCCAA,0,1906685
icdC_predicted,0.04,24,24,CTACATAACCCTCGTACCTG,0,1907976
icdC_predicted,0.04,24,24,CGGCTGGGACATTACGACAT,0,1888855
icdC_predicted,0.04,24,24,CCATTCCGGTGCGGTGTACG,0,1907618
icdC_predicted,0.04,24,24,ATTGCTGTGAACAGGTCTAT,0,1896891
icdC_predicted,0.04,24,24,ATCGACCAAACTAATCGGGC,0,1884506
icdC_predicted,0.04,24,24,AAGTGCTGCTTGTTCTTATT,0,1887356
icdC_predicted,0.041666666666666664,23,23,TTTCGGTATTTAGACGTTAC,0,1885494
icdC_predicted,0.041666666666666664,23,23,TTGTCTGTCTGTGCCGGTCG,0,1908636
icdC_predicted,0.041666666666666664,23,23,TGAGAGTTGCGCAGGAGCTA,0,1903531
icdC_predicted,0.041666666666666664,23,23,TGAAGGCGGCGCGGCCATGA,0,1908364
icdC_predicted,0.041666666666666664,23,23,TCTGTCAGGGCATCGGGGGT,0,1894307
icdC_predicted,0.041666666666666664,23,23,TCCGGGCATCGGCGTGACTA,0,1883402
icdC_predicted,0.041666666666666664,23,23,TCAACTCAATTAAATAAGCA,0,1908762
icdC_predicted,0.041666666666666664,23,23,TAACAACCATGGAGCTATGA,0,1883952
icdC_predicted,0.041666666666666664,23,23,GTATATCATTAGGGCTCAAA,0,1887973
icdC_predicted,0.041666666666666664,23,23,GTAGTGTGAGAGGTAAGGAG,0,1882065
icdC_predicted,0.041666666666666664,23,23,GGGTCGTCCGGTAGTAGTGT,0,1888703
icdC_predicted,0.041666666666666664,23,23,GAGTCAGATCTCACTAAGTT,0,1884201
icdC_predicted,0.041666666666666664,23,23,GAGACGCAGCAAAGGAGGGT,0,1907970
icdC_predicted,0.041666666666666664,23,23,CTCAAAGGTACTTTGCTAAG,0,1886045
icdC_predicted,0.041666666666666664,23,23,CTAGACCGGGAGAGATCATT,0,1909389
icdC_predicted,0.041666666666666664,23,23,CTACAAGTGTTTACCAAGGT,0,1896218
icdC_predicted,0.041666666666666664,23,23,CGGGGCAATCTCGCCTGGAC,0,1895357
icdC_predicted,0.041666666666666664,23,23,CGCACGAGGGTTGAATCTGT,0,1885385
icdC_predicted,0.041666666666666664,23,23,CCCGTTGTTTTGTGGCGCTT,0,1888348
icdC_predicted,0.041666666666666664,23,23,CCCGATGAGTAAACTAGCAG,0,1907029
icdC_predicted,0.041666666666666664,23,23,ATCCGTGAGATAGTCAAAAG,0,1889916
icdC_predicted,0.041666666666666664,23,23,ATCATAGAGCTCGGACATGT,0,1889270
icdC_predicted,0.041666666666666664,23,23,ACATGACTGAATCATTGCTC,0,1901570
icdC_predicted,0.041666666666666664,23,23,AAACACTGATTTGACCGGCT,0,1903454
icdC_predicted,0.043478260869565216,22,22,TTATCCGTCTTAATTGATGT,0,1888308
icdC_predicted,0.043478260869565216,22,22,TGTAACGACGACTTTACATT,0,1900602
icdC_predicted,0.043478260869565216,22,22,TGGCGCTTGCCCCCAGTAGC,0,1904331
icdC_predicted,0.043478260869565216,22,22,TCCTCGCGGGGATTATCCCT,0,1889645
icdC_predicted,0.043478260869565216,22,22,TCCCCCACGTCGGAAGCGGG,0,1897372
icdC_predicted,0.043478260869565216,22,22,TAGGCTGACCGCCTATGGAT,0,1893480
icdC_predicted,0.043478260869565216,22,22,TAGGCAAACGTTATGATGAT,0,1895386
icdC_predicted,0.043478260869565216,22,22,TAGACTTATCAAGATAAGTG,0,1895462
icdC_predicted,0.043478260869565216,22,22,GTGTGCACTTTAAAACACAA,0,1908262
icdC_predicted,0.043478260869565216,22,22,GTAGGTCCTTGGCGTAAGGA,0,1891929
icdC_predicted,0.043478260869565216,22,22,GGGCGAGTGGGAGGGGCCAA,0,1897718
icdC_predicted,0.043478260869565216,22,22,GGCTTATCGAAGCGAAGTTG,0,1883294
icdC_predicted,0.043478260869565216,22,22,GGAACATGCACGGGCAATCT,0,1890985
icdC_predicted,0.043478260869565216,22,22,GGAACACGGCCCTCCGGGCG,0,1901438
icdC_predicted,0.043478260869565216,22,22,GCTTGTTTAGAATACAGCCT,0,1897220
icdC_predicted,0.043478260869565216,22,22,CGTGGGCTGGCCGGGGGCTT,0,1900616
icdC_predicted,0.043478260869565216,22,22,CGTCTGTAGAAGCATTAGCA,0,1894692
icdC_predicted,0.043478260869565216,22,22,CGCGCGAAAAGGACCCGGAT,0,1909317
icdC_predicted,0.043478260869565216,22,22,CGCACACCTAAATGAGCCTA,0,1894985
icdC_predicted,0.043478260869565216,22,22,CCGTCATTTCTGATAAGTCC,0,1885224
icdC_predicted,0.043478260869565216,22,22,CCAAGTATACCGGACACGCC,0,1890986
icdC_predicted,0.043478260869565216,22,22,CATTCCGCACTGTCAACGTT,0,1883125
icdC_predicted,0.043478260869565216,22,22,ATTGGCACCTAGCTGCAAGC,0,1888112
icdC_predicted,0.043478260869565216,22,22,ATGTGTCGCACTTTTTGAAG,0,1878441
icdC_predicted,0.043478260869565216,22,22,ATCATCAGATCACGGGTAAA,0,1894449
icdC_predicted,0.043478260869565216,22,22,AGTTCTCTTCACCGCGGTCC,0,1906535
icdC_predicted,0.043478260869565216,22,22,AGAAGCATACCGCCCTCTCT,0,1895296
icdC_predicted,0.043478260869565216,22,22,ACTTCTAAGTGAACCGTCCA,0,1892661
icdC_predicted,0.043478260869565216,22,22,ACGGATGCCTGACATGAAGC,0,1904060
icdC_predicted,0.043478260869565216,22,22,AAGCTAAAATCCTCACGCCC,0,1882112
icdC_predicted,0.043478260869565216,22,22,AAATGCGGCTGCAGCATAAC,0,1902089
icdC_predicted,0.043478260869565216,22,22,AAAAGTACCCCACACGATTA,0,1906651
icdC_predicted,0.043478260869565216,22,22,AAAACATGGTTCCAGCTTCC,0,1902713
icdC_predicted,0.045454545454545456,21,21,TTGCTCCGCGCTTGGCGAGA,0,1891851
icdC_predicted,0.045454545454545456,21,21,TTGCGGTCCGCGGGCTTAGC,0,1894885
icdC_predicted,0.045454545454545456,21,21,TTGAAACCCGACTTTACCAA,0,1887915
icdC_predicted,0.045454545454545456,21,21,TTAGGAGTCTTAAAGGAGAA,0,1885279
icdC_predicted,0.045454545454545456,21,21,TGCTCGCGCGTTTTGGGAAG,0,1882012
icdC_predicted,0.045454545454545456,21,21,TGCGCCGCATGGGGACATCA,0,1891942
icdC_predicted,0.045454545454545456,21,21,TGCAACGGGTTTTCCCTCCA,0,1894754
icdC_predicted,0.045454545454545456,21,21,TCGTGAGGTCATTTGATTAT,0,1904859
icdC_predicted,0.045454545454545456,21,21,TCAGGTGACTAGACAGCAGG,0,1878401
icdC_predicted,0.045454545454545456,21,21,TAATTATTCCTTGTATGCAT,0,1888706
icdC_predicted,0.045454545454545456,21,21,TAACAGTAATCGCGAGTTTG,0,1882878
icdC_predicted,0.045454545454545456,21,21,GTCCCCTGGGGCGAATATAG,0,1891888
icdC_predicted,0.045454545454545456,21,21,GGCGCACCAGCATACCTGAC,0,1895301
icdC_predicted,0.045454545454545456,21,21,GCTGGTTCCATAAACGCAAA,0,1885159
icdC_predicted,0.045454545454545456,21,21,GCTATCTGATATAAAGCCGT,0,1900038
icdC_predicted,0.045454545454545456,21,21,GCGTATTGGTCCCCAGGAGA,0,1901675
icdC_predicted,0.045454545454545456,21,21,GCGAGCGTTTCCCTATCAGG,0,1890434
icdC_predicted,0.045454545454545456,21,21,GACTCCCGAATTGGTGGCGG,0,1882512
icdC_predicted,0.045454545454545456,21,21,CTCACTTTTGTTAGTCGAAA,0,1900927
icdC_predicted,0.045454545454545456,21,21,CGCGCAAGCCCGACAATATG,0,1902735
icdC_predicted,0.045454545454545456,21,21,CGAAGCTAAACTGCTAGCAT,0,1882789
icdC_predicted,0.045454545454545456,21,21,CCGCTCGAAATCTACCAAAA,0,1898665
icdC_predicted,0.045454545454545456,21,21,CCGAGATTGGGGAAATTGGT,0,1887378
icdC_predicted,0.045454545454545456,21,21,CATTGGAATCTACGGATTTA,0,1879558
icdC_predicted,0.045454545454545456,21,21,ATCTACGTCCCGCCAGAGCA,0,1888636
icdC_predicted,0.045454545454545456,21,21,AGTACCCAAGCTGATATTCA,0,1892284
icdC_predicted,0.045454545454545456,21,21,AGACTAAATGGGCATCAGTC,0,1898835
icdC_predicted,0.045454545454545456,21,21,ACTTCGGTCCGTTGTGGGTC,0,1908894
icdC_predicted,0.045454545454545456,21,21,ACGGCATGAATGCTACCTTG,0,1893698
icdC_predicted,0.045454545454545456,21,21,AAGGCAAATAACAAACGAGA,0,1885280
icdC_predicted,0.045454545454545456,21,21,AACGTCGGTGGAACGAGCTC,0,1887772
icdC_predicted,0.045454545454545456,21,21,AAAATTCGGCCACTAAATCG,0,1880641
icdC_predicted,0.047619047619047616,20,20,TTTCAGGAGCTCGTATGTTG,0,1907175
icdC_predicted,0.047619047619047616,20,20,TGCGGTTTACTTACGAAGTC,0,1893969
icdC_predicted,0.047619047619047616,20,20,TGCGGTTCCTTTGTAATTTG,0,1897643
icdC_predicted,0.047619047619047616,20,20,TCGGCTGCTTAAACAGGCGT,0,1906899
icdC_predicted,0.047619047619047616,20,20,TCGATGGCGTGGCGAGGAAA,0,1887596
icdC_predicted,0.047619047619047616,20,20,TCATAATTAATCAACGCGAT,0,1899651
icdC_predicted,0.047619047619047616,20,20,TAATAAAGCGAAGTGATGTT,0,1880045
icdC_predicted,0.047619047619047616,20,20,GTTGCCGGGTTCAATCTCGC,0,1884254
icdC_predicted,0.047619047619047616,20,20,GTTGACAGTTAATAGGCAGT,0,1899357
icdC_predicted,0.047619047619047616,20,20,GTGTGTGACTGATATCGGGT,0,1881065
icdC_predicted,0.047619047619047616,20,20,GGCTCTAGTGCGGTTATGTG,0,1895434
icdC_predicted,0.047619047619047616,20,20,GGCCTGGGGACATCTCGCTC,0,1888213
icdC_predicted,0.047619047619047616,20,20,GGAATTTCAGAGGTGGAGTT,0,1903231
icdC_predicted,0.047619047619047616,20,20,GCTAGCGAAGAGGAATCGAG,0,1887381
icdC_predicted,0.047619047619047616,20,20,GCGAGTTTTATGGCGTCCTC,0,1881119
icdC_predicted,0.047619047619047616,20,20,GCGAACTGGTGAAGATGTGA,0,1883349
icdC_predicted,0.047619047619047616,20,20,GATCATTGTGCCATGTTGTC,0,1881796
icdC_predicted,0.047619047619047616,20,20,GAGGAGACTTAGGGTACACA,0,1887634
icdC_predicted,0.047619047619047616,20,20,GAGAATTTACGGATCTCCAC,0,1884802
icdC_predicted,0.047619047619047616,20,20,GACCGACAATTCCTGACTCA,0,1889261
icdC_predicted,0.047619047619047616,20,20,CTTTTATGGTGGCGTCGAGA,0,1909078
icdC_predicted,0.047619047619047616,20,20,CTTCAGGCTGTGTTCGCTAA,0,1884087
icdC_predicted,0.047619047619047616,20,20,CTGTGCTTACCAGGCTCGTA,0,1897614
icdC_predicted,0.047619047619047616,20,20,CTCTTGTTGTAAAAGCTGTA,0,1886349
icdC_predicted,0.047619047619047616,20,20,CTCCAGTCTTAAAAGGAGTC,0,1902152
icdC_predicted,0.047619047619047616,20,20,CGTATCGCTTAAAGTGTAAT,0,1887945
icdC_predicted,0.047619047619047616,20,20,CGGCATCATACACGTCGGGA,0,1893458
icdC_predicted,0.047619047619047616,20,20,CGGCAGTGCTGGTTCTTTAA,0,1884933
icdC_predicted,0.047619047619047616,20,20,CCGAATTTTTCGAATCCCTC,0,1893863
icdC_predicted,0.047619047619047616,20,20,CCAAACCCAGGGAACTGCCT,0,1886655
icdC_predicted,0.047619047619047616,20,20,CATCTAGTTGCGAGTTGCAG,0,1883242
icdC_predicted,0.047619047619047616,20,20,CAGTGTCATGGCAGCCAACA,0,1897837
icdC_predicted,0.047619047619047616,20,20,CACGCAAGCAATTGTCATGC,0,1906728
icdC_predicted,0.047619047619047616,20,20,CAACAGGGACTCTTTTACTA,0,1904379
icdC_predicted,0.047619047619047616,20,20,ATTCTAATCATCCAATACAT,0,1878188
icdC_predicted,0.047619047619047616,20,20,AGTTGTGTAATACTTAGCTG,0,1899859
icdC_predicted,0.047619047619047616,20,20,AGTTAAGAGACGACTTTTTA,0,1897460
icdC_predicted,0.047619047619047616,20,20,AGGGTCGATAGTTGAATATT,0,1902950
icdC_predicted,0.047619047619047616,20,20,AGGCGGTTAAGCCTGTTAGA,0,1898438
icdC_predicted,0.047619047619047616,20,20,AGATACACAGTTATTAATGT,0,1885404
icdC_predicted,0.047619047619047616,20,20,ACCTATGACGGCAAACCCTT,0,1908009
icdC_predicted,0.047619047619047616,20,20,AAGTTTAGACGGACATAAGG,0,1883053
icdC_predicted,0.05,19,19,TTTTCACGGGGGAGTGGTGA,0,1883907
icdC_predicted,0.05,19,19,TTGGCTTCTTACCGAATCGG,0,1890149
icdC_predicted,0.05,19,19,TTGATTTTTTCGTCCCGTAT,0,1887680
icdC_predicted,0.05,19,19,TTCGTGGCATGATGAGATGC,0,1907895
icdC_predicted,0.05,19,19,TTCGTCCTTAGGGACAGCCA,0,1891547
icdC_predicted,0.05,19,19,TTCCAGTGTCGGCTATTATA,0,1884595
icdC_predicted,0.05,19,19,TTCAGTGTCAGGTTGTAAGA,0,1896199
icdC_predicted,0.05,19,19,TTACCGTCCAATATAAGGAT,0,1879119
icdC_predicted,0.05,19,19,TGGTAACTCGTGCTCATTGA,0,1880806
icdC_predicted,0.05,19,19,TGGGCGTTTTGAATAAGATA,0,1906477
icdC_predicted,0.05,19,19,TGGATGGAATGTAGGTAGAA,0,1891277
icdC_predicted,0.05,19,19,TGCTATGCACTGTAATCAGG,0,1896496
icdC_predicted,0.05,19,19,TGATTTTAAGTACGTGAAAT,0,1906753
icdC_predicted,0.05,19,19,TGACAGGCAACTTAAAATAT,0,1904493
icdC_predicted,0.05,19,19,TCTGTAATAGACTCCAAGGT,0,1878038
icdC_predicted,0.05,19,19,TCTAGTGCCGAGTATAGACA,0,1905156
icdC_predicted,0.05,19,19,TCGGTTTCACTACGCCCAGT,0,1881071
icdC_predicted,0.05,19,19,TCATCGCGCCATTTGAAGCA,0,1901475
icdC_predicted,0.05,19,19,TAGTCTATAGTGGGTGATAG,0,1895904
icdC_predicted,0.05,19,19,GTTTGCGCGCATCTGGCGCC,0,1887975
icdC_predicted,0.05,19,19,GTGTATAGTTTTAAACAGGA,0,1892871
icdC_predicted,0.05,19,19,GTGAGTGAGGTAAAAGTAAT,0,1901244
icdC_predicted,0.05,19,19,GGTAGTCGCGCGCATTGTGA,0,1879070
icdC_predicted,0.05,19,19,GGGGAAAGCATTACTTACCA,0,1893836
icdC_predicted,0.05,19,19,GGGCCTAGAGTAGGGCGTCA,0,1880771
icdC_predicted,0.05,19,19,GGCTGTCTCTTTATACGGCT,0,1883452
icdC_predicted,0.05,19,19,GCTTGTACAACCGGACGCTA,0,1899799
icdC_predicted,0.05,19,19,GCGCTGCCAACAATCACTCT,0,1886552
icdC_predicted,0.05,19,19,GCGAAAACTATTGATGGTAT,0,1896406
icdC_predicted,0.05,19,19,GCCAAGCGGATTCGAATCTT,0,1903207
icdC_predicted,0.05,19,19,GAGGGGACAGGATGATGTAA,0,1879953
icdC_predicted,0.05,19,19,GACTATAATCTGTAAACTCA,0,1900255
icdC_predicted,0.05,19,19,GAAGAAAAGAACCTCGCTTT,0,1902325
icdC_predicted,0.05,19,19,CTTGGGTGGGGGGTATGCCT,0,1903964
icdC_predicted,0.05,19,19,CTTCCGTCCCTGAACGTGAT,0,1881744
icdC_predicted,0.05,19,19,CTTACTACGGCTATATCGAC,0,1902361
icdC_predicted,0.05,19,19,CTGTCCGAGGATGCTGCATG,0,1900094
icdC_predicted,0.05,19,19,CTAAGTTTGGTGACCGACAT,0,1888011
icdC_predicted,0.05,19,19,CGTGTGCGGCTCCTAGGAGG,0,1881586
icdC_predicted,0.05,19,19,CGGCCGGTCCTGAATATTTC,0,1879931
icdC_predicted,0.05,19,19,CGCTGCAATGTTCGTCGAGC,0,1884956
icdC_predicted,0.05,19,19,CGCCCTCCCGAAGGCTGAAC,0,1884851
icdC_predicted,0.05,19,19,CGCCCGCAGCAAAAGGGTGA,0,1903899
icdC_predicted,0.05,19,19,CGAAGTGCTCGTCCGATAAT,0,1879199
icdC_predicted,0.05,19,19,CCTCCATCCCCGTACGGCCA,0,1879341
icdC_predicted,0.05,19,19,CCGGGAATAAATGTTAGACA,0,1893079
icdC_predicted,0.05,19,19,CCGCTCCGCCAGCGCACTCT,0,1900654
icdC_predicted,0.05,19,19,CCCGAATCACTGGGAGGTTG,0,1884621
icdC_predicted,0.05,19,19,CAGGACAAAGGTGGTGCGAT,0,1884206
icdC_predicted,0.05,19,19,ATTCCCAATATGTTAACAGA,0,1887946
icdC_predicted,0.05,19,19,ATGGCTGAGAGATGCACACG,0,1891461
icdC_predicted,0.05,19,19,ATGCACGTGCTATCCCGAGA,0,1905216
icdC_predicted,0.05,19,19,ATCAAGCGTGCATATTCTAC,0,1896100
icdC_predicted,0.05,19,19,AGGTGAAGCACTGCCCCGAT,0,1889225
icdC_predicted,0.05,19,19,AAGTTTCAGCAAAACCGGTC,0,1901092
icdC_predicted,0.05,19,19,AAGACATGAGTGTCCAGCGC,0,1888377
icdC_predicted,0.05,19,19,AAAAGCTTTACCGTGGAACT,0,1886934
icdC_predicted,0.05263157894736842,18,18,TTTCTATTCGCATTTTTAGC,0,1880783
icdC_predicted,0.05263157894736842,18,18,TTTCCGGTTCAACAGGGTAG,0,1909123
icdC_predicted,0.05263157894736842,18,18,TTGTGCGCCCTTCTTATCTC,0,1878098
icdC_predicted,0.05263157894736842,18,18,TTGAGTCTCGTGGTAGGCTG,0,1881732
icdC_predicted,0.05263157894736842,18,18,TTAAGTTTCGGCTAAAATGG,0,1880694
icdC_predicted,0.05263157894736842,18,18,TGGGAGCTTGTGCTAGTGAA,0,1891216
icdC_predicted,0.05263157894736842,18,18,TGGACAACGGAAAGCGTTTT,0,1904482
icdC_predicted,0.05263157894736842,18,18,TGGAATCCTGTCTATAGGGT,0,1908257
icdC_predicted,0.05263157894736842,18,18,TGCTTCCGTATAAGCAGGGT,0,1882007
icdC_predicted,0.05263157894736842,18,18,TGCTAACGTCTAGGTCACCG,0,1881415
icdC_predicted,0.05263157894736842,18,18,TGCGGTTACCGTTCGGCTTT,0,1891663
icdC_predicted,0.05263157894736842,18,18,TGAACAAAATCGGTTACGTG,0,1884769
icdC_predicted,0.05263157894736842,18,18,TCTACTCATACTGTGCGATG,0,1907410
icdC_predicted,0.05263157894736842,18,18,TCAGGCAAGCGATTGGTAAT,0,1900058
icdC_predicted,0.05263157894736842,18,18,TATTTGAAGCAATACTATTA,0,1896650
icdC_predicted,0.05263157894736842,18,18,TATAGCGCTAGTCCCGCACC,0,1905884
icdC_predicted,0.05263157894736842,18,18,GTCGCCACTAGGTGGTGCTG,0,1879467
icdC_predicted,0.05263157894736842,18,18,GTCCAAACCCCACAGCGCAT,0,1897184
icdC_predicted,0.05263157894736842,18,18,GGTGGAGGCTTCCCTTTCCA,0,1879698
icdC_predicted,0.05263157894736842,18,18,GGGTTAGCGTGCGTTCAAGG,0,1905488
icdC_predicted,0.05263157894736842,18,18,GGGGCTACGTTAGGTCTTAT,0,1890952
icdC_predicted,0.05263157894736842,18,18,GGGAATTTCGGTAGCCCCAC,0,1888725
icdC_predicted,0.05263157894736842,18,18,GGCTATTGTAGCTATCGCTA,0,1879855
icdC_predicted,0.05263157894736842,18,18,GGCGTCGTTCCGCCCTCGGG,0,1879816
icdC_predicted,0.05263157894736842,18,18,GGAGCTAATTACTCCGCGGG,0,1904613
icdC_predicted,0.05263157894736842,18,18,GGACAAGTGTGCCAGAAGGC,0,1904637
icdC_predicted,0.05263157894736842,18,18,GCATGGAGTGCAGCCGTTCT,0,1888193
icdC_predicted,0.05263157894736842,18,18,GCAATGCTACAAGTCATCAT,0,1881860
icdC_predicted,0.05263157894736842,18,18,GAGTCCCGCACCAGAACAAT,0,1890987
icdC_predicted,0.05263157894736842,18,18,GAGGGTAAAGCGATGAAATA,0,1908906
icdC_predicted,0.05263157894736842,18,18,GAGGGGCTATGGGTTAGTCC,0,1902106
icdC_predicted,0.05263157894736842,18,18,GAGGGCGTTTGCGAAGACGT,0,1900958
icdC_predicted,0.05263157894736842,18,18,GAGCGTACACTGCTTACTTT,0,1883048
icdC_predicted,0.05263157894736842,18,18,CTGCTCCAAATGCAAGCATG,0,1881201
icdC_predicted,0.05263157894736842,18,18,CTCAGTGATTTATCGGTCAT,0,1898536
icdC_predicted,0.05263157894736842,18,18,CGTTTCAGTACCACTGGTAT,0,1892565
icdC_predicted,0.05263157894736842,18,18,CGTTCGTCAACAGACCAACA,0,1885523
icdC_predicted,0.05263157894736842,18,18,CGCGGGGATCAGAAAGTTGA,0,1887901
icdC_predicted,0.05263157894736842,18,18,CGATATTAAGCCCAGGTAAA,0,1877908
icdC_predicted,0.05263157894736842,18,18,CGATATCACAGTTGAAGTTC,0,1887625
icdC_predicted,0.05263157894736842,18,18,CGACGCCGTAATCCGTGTGT,0,1906787
icdC_predicted,0.05263157894736842,18,18,CCTGTGACTTGAAATTGCGC,0,1886711
icdC_predicted,0.05263157894736842,18,18,CAGGGCGAAACTCCTGAGGA,0,1896048
icdC_predicted,0.05263157894736842,18,18,CACTGCCACTGGTAGTCGCG,0,1892912
icdC_predicted,0.05263157894736842,18,18,CAACCACGTTAGGAGTCGTT,0,1889935
icdC_predicted,0.05263157894736842,18,18,CAAAAATCACTTCGTTGGGG,0,1886819
icdC_predicted,0.05263157894736842,18,18,ATTGCACTTGTCTGCGGGTC,0,1900719
icdC_predicted,0.05263157894736842,18,18,ATGTCCATTGAGTGGGTCTT,0,1902616
icdC_predicted,0.05263157894736842,18,18,ATGGGCGCATTCCCCCTAAC,0,1902971
icdC_predicted,0.05263157894736842,18,18,ATCTATACCATAACCCCAAG,0,1885202
icdC_predicted,0.05263157894736842,18,18,ATCCGGCGGGACCCGGCGAC,0,1905577
icdC_predicted,0.05263157894736842,18,18,ATCCGCCGCGCCCCACGCAA,0,1888242
icdC_predicted,0.05263157894736842,18,18,AGTACGTGCTAAGGAAAGCA,0,1889435
icdC_predicted,0.05263157894736842,18,18,AGCGGTCGTAAGTGTATCGA,0,1887170
icdC_predicted,0.05263157894736842,18,18,AGCACCCACGTGCGCAACTG,0,1899012
icdC_predicted,0.05263157894736842,18,18,AGAATGCAAGAACAACAGAA,0,1878862
icdC_predicted,0.05263157894736842,18,18,ACTGAGCAGTTTAATTTCCC,0,1884673
icdC_predicted,0.05263157894736842,18,18,ACCTGGGGTTGGCACGTCGC,0,1892895
icdC_predicted,0.05263157894736842,18,18,AATGCTGTCAACAATCTGGT,0,1894886
icdC_predicted,0.05263157894736842,18,18,AAGGAACCAATATGGCATCC,0,1899506
icdC_predicted,0.05263157894736842,18,18,AACGTATTCACTTCGCGCTA,0,1904589
icdC_predicted,0.05263157894736842,18,18,AAAGGAGGGTCGTGCGAATA,0,1908388
icdC_predicted,0.05555555555555555,17,17,TTTTCCGTCGAATGGACCTT,0,1888214
icdC_predicted,0.05555555555555555,17,17,TTGTTAGGCCCGCATAAGTT,0,1906948
icdC_predicted,0.05555555555555555,17,17,TTGTCGACGTGCACGACCAG,0,1888722
icdC_predicted,0.05555555555555555,17,17,TTCTCCTGAGCTAGTCGGAC,0,1899868
icdC_predicted,0.05555555555555555,17,17,TTCTAAAATAAAGCTCGAAC,0,1884404
icdC_predicted,0.05555555555555555,17,17,TTCCATAGTACTAGAGTCAG,0,1878955
icdC_predicted,0.05555555555555555,17,17,TGTTTGGGTGCAGTCTTCTG,0,1895315
icdC_predicted,0.05555555555555555,17,17,TGTCTATGTCGTTTTAGTTG,0,1882835
icdC_predicted,0.05555555555555555,17,17,TGGGGTGCTCTTCCGAGAGT,0,1888647
icdC_predicted,0.05555555555555555,17,17,TCTAGCTGCGAAGGTCCCGT,0,1885356
icdC_predicted,0.05555555555555555,17,17,TCGGTATTCTACGCTAGGTT,0,1890851
icdC_predicted,0.05555555555555555,17,17,TAACGGGTAACCACCGTTCA,0,1894419
icdC_predicted,0.05555555555555555,17,17,GTTTGGCTACCATGGAGGGA,0,1889066
icdC_predicted,0.05555555555555555,17,17,GTTAGAACTAACGGTGAGAG,0,1902322
icdC_predicted,0.05555555555555555,17,17,GTGAACTGGGGAGCGGTCCA,0,1890578
icdC_predicted,0.05555555555555555,17,17,GTATATGAGTGCGGCACAAT,0,1884150
icdC_predicted,0.05555555555555555,17,17,GTAGAGGTAACCGGCTTAAG,0,1882008
icdC_predicted,0.05555555555555555,17,17,GGTATTACGGCGATAGTGCA,0,1884096
icdC_predicted,0.05555555555555555,17,17,GGGTCTTACGGTGGCCGTAC,0,1908954
icdC_predicted,0.05555555555555555,17,17,GGGGCACAGACAGCACAACT,0,1908865
icdC_predicted,0.05555555555555555,17,17,GGAGTTGCAGTGTGGGCTAG,0,1886224
icdC_predicted,0.05555555555555555,17,17,GGAAGTAATTTCTTTTATCA,0,1905430
icdC_predicted,0.05555555555555555,17,17,GATATACCGACCTGCCAATT,0,1886209
icdC_predicted,0.05555555555555555,17,17,GAGTCATTAGTACTACCGCG,0,1895905
icdC_predicted,0.05555555555555555,17,17,GAGATAGTTGCGTAATATGT,0,1899586
icdC_predicted,0.05555555555555555,17,17,CTTTCTTTGAAGATATGGCA,0,1909451
icdC_predicted,0.05555555555555555,17,17,CTTTATTGCTGGTAGTCATC,0,1904293
icdC_predicted,0.05555555555555555,17,17,CTTCTGGGGCTAGATACATA,0,1901505
icdC_predicted,0.05555555555555555,17,17,CTCTAGCGCCACAGTGGGGA,0,1908565
icdC_predicted,0.05555555555555555,17,17,CTATGACCTTGCCGCCATAT,0,1889901
icdC_predicted,0.05555555555555555,17,17,CTAATCTTCCACTGAAAATG,0,1907556
icdC_predicted,0.05555555555555555,17,17,CGGGTCTCTTCAGCGATTCA,0,1885513
icdC_predicted,0.05555555555555555,17,17,CGGCACTAGAGGGCGTGTAA,0,1884888
icdC_predicted,0.05555555555555555,17,17,CGGACGAGACATTACGAAGG,0,1908969
icdC_predicted,0.05555555555555555,17,17,CGCGGGATAGAGGGCTCACT,0,1902524
icdC_predicted,0.05555555555555555,17,17,CGAGCGCTACGGCCTTGGAC,0,1883111
icdC_predicted,0.05555555555555555,17,17,CGACTCTATGTGCTTAGGAG,0,1897998
icdC_predicted,0.05555555555555555,17,17,CATGGTCTGTCCTGGAGGCG,0,1892342
icdC_predicted,0.05555555555555555,17,17,CATACTGGCATGGGCAATAC,0,1892952
icdC_predicted,0.05555555555555555,17,17,ATGCGATTGCAAGCGCAAAT,0,1886173
icdC_predicted,0.05555555555555555,17,17,ATGAGGTCTTCATGTTAGGT,0,1898528
icdC_predicted,0.05555555555555555,17,17,ATCCTTGGGCGGCGTCCCAG,0,1897178
icdC_predicted,0.05555555555555555,17,17,AGTGGGGTGTTGTATTTGCA,0,1905058
icdC_predicted,0.05555555555555555,17,17,AGGAGAGACATGACCGGACG,0,1889051
icdC_predicted,0.05555555555555555,17,17,AGCCGTGCCATGGACGTCTA,0,1884768
icdC_predicted,0.05555555555555555,17,17,AGCAGGTACACTGCATCTAC,0,1879886
icdC_predicted,0.05555555555555555,17,17,AGAGGCTCCGAGCCTCTCTA,0,1896459
icdC_predicted,0.05555555555555555,17,17,ACTTTTATGGGGTGTTATAA,0,1886375
icdC_predicted,0.05555555555555555,17,17,ACCTACCGTACCACCCCGTC,0,1889195
icdC_predicted,0.05555555555555555,17,17,ACATGCTTTACCGGGGCGAA,0,1898397
icdC_predicted,0.05555555555555555,17,17,ACACGAGGATTAAAGCGACT,0,1906391
icdC_predicted,0.05555555555555555,17,17,ACAAGGCCCGAGGAAGAGTT,0,1901379
icdC_predicted,0.05555555555555555,17,17,AAGGCATACGGGATAAGAAG,0,1903777
icdC_predicted,0.05555555555555555,17,17,AAGAGCATGGCACCTAAAGT,0,1878087
icdC_predicted,0.05555555555555555,17,17,AACGAAAATTGTCACGTTCT,0,1881078
icdC_predicted,0.05555555555555555,17,17,AAAACTCTAAAGGTTTGGAA,0,1896569
icdC_predicted,0.058823529411764705,16,16,TTTTTTGGGCTCACGCTGAC,0,1892757
icdC_predicted,0.058823529411764705,16,16,TTTTACACGAGGTCCAAGAT,0,1879592
icdC_predicted,0.058823529411764705,16,16,TTTCCTTACGTGCGAACTGC,0,1879076
icdC_predicted,0.058823529411764705,16,16,TTTCAGGCTCGGCTTGCATC,0,1903367
icdC_predicted,0.058823529411764705,16,16,TTGTTACTCCCAATCCGGTA,0,1881652
icdC_predicted,0.058823529411764705,16,16,TTGCTTATCTGTTCCTCGGG,0,1878203
icdC_predicted,0.058823529411764705,16,16,TTGCGAGTAGGAACCGAGGA,0,1879717
icdC_predicted,0.058823529411764705,16,16,TTGAGTTACCCCACGGGGAT,0,1885738
icdC_predicted,0.058823529411764705,16,16,TTCTACCCCTGGGTGTATAC,0,1900668
icdC_predicted,0.058823529411764705,16,16,TTCGAACTAGCGCTTCGTCG,0,1904753
icdC_predicted,0.058823529411764705,16,16,TTCAATCGGCTTAGTGCTGA,0,1890101
icdC_predicted,0.058823529411764705,16,16,TTAAGTAACGCCAGGAAAAT,0,1879472
icdC_predicted,0.058823529411764705,16,16,TGTTTGAAATCTTCCTCGAT,0,1893772
icdC_predicted,0.058823529411764705,16,16,TGTTATGTCCATGTTCCATT,0,1883855
icdC_predicted,0.058823529411764705,16,16,TGCCGTAAGACGCTAGCCCG,0,1882953
icdC_predicted,0.058823529411764705,16,16,TGCAAGTCGATCAACGTCTT,0,1893547
icdC_predicted,0.058823529411764705,16,16,TGAGGTAAACTCGAACGCGC,0,1892881
icdC_predicted,0.058823529411764705,16,16,TGACTTGGGAACTGTAAGTT,0,1892469
icdC_predicted,0.058823529411764705,16,16,TGACCGTTTGCATAGGGGAA,0,1909388
icdC_predicted,0.058823529411764705,16,16,TCGTAGCCCCGGTACATATA,0,1906371
icdC_predicted,0.058823529411764705,16,16,TCACATCCTCCCGCATATGT,0,1904365
icdC_predicted,0.058823529411764705,16,16,TATGCCGTATTGTGTGGGTG,0,1897996
icdC_predicted,0.058823529411764705,16,16,TATAGGTGGACGGGATCCAC,0,1881194
icdC_predicted,0.058823529411764705,16,16,TAGCCCGTCCATGCGGCGGC,0,1890564
icdC_predicted,0.058823529411764705,16,16,TACGGTTCGCTTGGGCACCA,0,1885740
icdC_predicted,0.058823529411764705,16,16,TACCATACTACGCGCGCCCA,0,1879699
icdC_predicted,0.058823529411764705,16,16,TAAGTTACTATTCAGAGTAA,0,1897613
icdC_predicted,0.058823529411764705,16,16,TAACAGTTTCTACATATCTT,0,1905991
icdC_predicted,0.058823529411764705,16,16,GTGCACGCTCAACGCCGCTG,0,1894758
icdC_predicted,0.058823529411764705,16,16,GTCGTGCTTGTAGACATTGT,0,1906393
icdC_predicted,0.058823529411764705,16,16,GTCAATGCGCCTACACCGGT,0,1880940
icdC_predicted,0.058823529411764705,16,16,GTAGCTAAACGAGAGGTCGG,0,1905130
icdC_predicted,0.058823529411764705,16,16,GGTTTTATAGGTTGGGGGAT,0,1891197
icdC_predicted,0.058823529411764705,16,16,GGTATAATGTTGACTTACAG,0,1885859
icdC_predicted,0.058823529411764705,16,16,GGGTCACAGCGAAGAGGCTG,0,1900246
icdC_predicted,0.058823529411764705,16,16,GGCTATAATTCATTTTCCTT,0,1898755
icdC_predicted,0.058823529411764705,16,16,GGCATGTTCTTAGCCTTACA,0,1903024
icdC_predicted,0.058823529411764705,16,16,GCTGGTTGGGCACAGGCGCA,0,1893221
icdC_predicted,0.058823529411764705,16,16,GCTAGATAGAGTATTAGTTC,0,1902388
icdC_predicted,0.058823529411764705,16,16,GCCGAATTTGACTTGCCTTA,0,1892457
icdC_predicted,0.058823529411764705,16,16,GCAAACGTTATAGACATATC,0,1908736
icdC_predicted,0.058823529411764705,16,16,GAGTTAAGGCCGGACAGCGA,0,1909404
icdC_predicted,0.058823529411764705,16,16,GAGCGGGGAAATAGTGAACA,0,1904942
icdC_predicted,0.058823529411764705,16,16,GAATAGTCTCCTGTTAAAAG,0,1901567
icdC_predicted,0.058823529411764705,16,16,CTTACTTTAGGGATTAGGCC,0,1886327
icdC_predicted,0.058823529411764705,16,16,CTCTCTAATCTCTTGTCCAA,0,1891297
icdC_predicted,0.058823529411764705,16,16,CTATCAAGTCAGTTTCCCAT,0,1889397
icdC_predicted,0.058823529411764705,16,16,CTACACATACCAGGGTTGAC,0,1885013
icdC_predicted,0.058823529411764705,16,16,CGTGGCGCTTAATTAGCGTC,0,1880431
icdC_predicted,0.058823529411764705,16,16,CGTCGTCGGAGCGTTAGGTT,0,1903451
icdC_predicted,0.058823529411764705,16,16,CGGTGCCAACCCTGTGGCAT,0,1879231
icdC_predicted,0.058823529411764705,16,16,CGCTGGTGGGCGCATCGTCA,0,1877903
icdC_predicted,0.058823529411764705,16,16,CGCTCTTGGGAGTGCGTAAA,0,1891832
icdC_predicted,0.058823529411764705,16,16,CCTAGACCGACGGCTGCTTA,0,1896507
icdC_predicted,0.058823529411764705,16,16,CCCTTTACACCACCGGACCT,0,1890814
icdC_predicted,0.058823529411764705,16,16,CATGCTATAGACGTAACCAT,0,1905817
icdC_predicted,0.058823529411764705,16,16,CATGCAACATAAAGCCCTCA,0,1900983
icdC_predicted,0.058823529411764705,16,16,CAATGGCGCCCGCCGAAGAC,0,1900060
icdC_predicted,0.058823529411764705,16,16,CAAGCACCTCCAGGATTACA,0,1901949
icdC_predicted,0.058823529411764705,16,16,ATTGTAGGGTATCCTCAATG,0,1909399
icdC_predicted,0.058823529411764705,16,16,ATGGCTAGACGGTCAACAAA,0,1902028
icdC_predicted,0.058823529411764705,16,16,ATCTTAGTCATTGGGTGCCC,0,1890950
icdC_predicted,0.058823529411764705,16,16,ATCTGTCGGGCTGCTTGAAT,0,1882990
icdC_predicted,0.058823529411764705,16,16,AGGGGATTAGCTCCGTCCCT,0,1908763
icdC_predicted,0.058823529411764705,16,16,AGGGAGAGTGACCAGTAATT,0,1890515
icdC_predicted,0.058823529411764705,16,16,AGGAAAGACAGGATATACTA,0,1901643
icdC_predicted,0.058823529411764705,16,16,AGCGAAAGCGTTTGCCCTGT,0,1893058
icdC_predicted,0.058823529411764705,16,16,AGCCCACGGCAGATAAGCCC,0,1888833
icdC_predicted,0.058823529411764705,16,16,AGAGCTATGCGCCGACGAAG,0,1892747
icdC_predicted,0.058823529411764705,16,16,ACTACTAAGGTAGACTTAAA,0,1884119
icdC_predicted,0.058823529411764705,16,16,ACCTGGTCATCTATCGCCCA,0,1888440
icdC_predicted,0.058823529411764705,16,16,AATCAGGAAGGATCGTGGAT,0,1880716
icdC_predicted,0.058823529411764705,16,16,AACGGGAGGCGAGAGGATGA,0,1882352
icdC_predicted,0.058823529411764705,16,16,AACCCGTGAGGGTTCTCTAT,0,1889148
icdC_predicted,0.0625,15,15,TTTTACGACTGTAACGTCGC,0,1902783
icdC_predicted,0.0625,15,15,TTTTAACAGCCCTTTGGTTT,0,1900143
icdC_predicted,0.0625,15,15,TTGGTTGGCAGTCCTAAGCA,0,1887633
icdC_predicted,0.0625,15,15,TTGCCGCACTCAGACAATGT,0,1880819
icdC_predicted,0.0625,15,15,TTCCGGTAGACTTTGTGTGT,0,1890386
icdC_predicted,0.0625,15,15,TTCACAAGATACCCCTTCGT,0,1881777
icdC_predicted,0.0625,15,15,TGGTTGGCAAGCTCCGGGTG,0,1898321
icdC_predicted,0.0625,15,15,TGGGAAGGGTCACCTCTTCA,0,1881636
icdC_predicted,0.0625,15,15,TGGACGATAGGTTCTACACG,0,1901018
icdC_predicted,0.0625,15,15,TCTAGCACCTCGCGCATCCA,0,1900612
icdC_predicted,0.0625,15,15,TCGGTTACATAAAGTTCATT,0,1883998
icdC_predicted,0.0625,15,15,TCGGATGTGGCAAGTGACGT,0,1904568
icdC_predicted,0.0625,15,15,TCCTACTGGATGCGGTATAA,0,1897831
icdC_predicted,0.0625,15,15,TCCGAGCATTAGAAAAGTGT,0,1888573
icdC_predicted,0.0625,15,15,TCCAGTTTTTGATGCGTATA,0,1887176
icdC_predicted,0.0625,15,15,TCATTGAACAAGCGAAAGCA,0,1898733
icdC_predicted,0.0625,15,15,TCAAGATGCGCTATTACCGT,0,1898095
icdC_predicted,0.0625,15,15,TATGTACTCTGGAATGGTGT,0,1891224
icdC_predicted,0.0625,15,15,TATGGCGTCAATCGGAGAGA,0,1884960
icdC_predicted,0.0625,15,15,TATGATGTGCGGGGCCACGA,0,1888623
icdC_predicted,0.0625,15,15,TACGGTATAGTCGAGGCATG,0,1882549
icdC_predicted,0.0625,15,15,TACGCCAAGGATCGTATATG,0,1885843
icdC_predicted,0.0625,15,15,TACAACGGGAGTATCGTAAG,0,1882628
icdC_predicted,0.0625,15,15,TAATTCCTCGGCAGGAGAGT,0,1878253
icdC_predicted,0.0625,15,15,TAAACTCCTAAGGTCGGGTG,0,1906027
icdC_predicted,0.0625,15,15,TAAAATGGGAAATCTAGATC,0,1879890
icdC_predicted,0.0625,15,15,GTTGTAGCTCCTCTCTCTTG,0,1902489
icdC_predicted,0.0625,15,15,GTTACGGAAGGGTCATGGGT,0,1878358
icdC_predicted,0.0625,15,15,GTTACGAAATGTCCAATCAT,0,1884064
icdC_predicted,0.0625,15,15,GTAGCACAATGCTTAGACGA,0,1882371
icdC_predicted,0.0625,15,15,GGTTAACCGTTAGGGAGCGG,0,1903072
icdC_predicted,0.0625,15,15,GGGGCGAAGCAACGCCGCAT,0,1880967
icdC_predicted,0.0625,15,15,GGGAAATTCTCCATAGAAGT,0,1898029
icdC_predicted,0.0625,15,15,GGCTCGATGACTGACTGGAG,0,1884222
icdC_predicted,0.0625,15,15,GGCTATGAGCCCACTTTCTC,0,1882042
icdC_predicted,0.0625,15,15,GGCATTAGGCTTATTGGAGC,0,1907475
icdC_predicted,0.0625,15,15,GGATTGTAGAGTGGACCCAT,0,1881554
icdC_predicted,0.0625,15,15,GGATTCTTAGTATCTGAAGC,0,1880454
icdC_predicted,0.0625,15,15,GCCCGCTACTGACTAATAAC,0,1905318
icdC_predicted,0.0625,15,15,GCAGATCCTACGATGTATCG,0,1881798
icdC_predicted,0.0625,15,15,GATCGCGCTCGCCCCAGCTA,0,1880684
icdC_predicted,0.0625,15,15,GATATACGTCTCCAGACATG,0,1887299
icdC_predicted,0.0625,15,15,GATACAAGCTTATCTTCATG,0,1890259
icdC_predicted,0.0625,15,15,GAGGCGGCAGGCAACCCCAA,0,1905297
icdC_predicted,0.0625,15,15,GAGCACCGGCGTAGCTCATA,0,1888020
icdC_predicted,0.0625,15,15,GACGATGGATGCCCACAACG,0,1906081
icdC_predicted,0.0625,15,15,GACCGTGTAACCCGTGCTGT,0,1900647
icdC_predicted,0.0625,15,15,GACCCGATTACATCTTGGCA,0,1905453
icdC_predicted,0.0625,15,15,GAATTCATTCTAAGGCTGGT,0,1907568
icdC_predicted,0.0625,15,15,GAATAAGCCGAAGGGGGGAC,0,1903209
icdC_predicted,0.0625,15,15,GAACTAGCGTATTACAATGG,0,1898145
icdC_predicted,0.0625,15,15,GAAACTCCTCGTCCTGAGGT,0,1884623
icdC_predicted,0.0625,15,15,CTTTGGGTTGGCACTAAGGC,0,1894065
icdC_predicted,0.0625,15,15,CTTAAGTTGGCGTCTCAGCT,0,1885400
icdC_predicted,0.0625,15,15,CTGTCAATCCCTGACTTATA,0,1889841
icdC_predicted,0.0625,15,15,CTGTACTCTCGCGTAATGAG,0,1898700
icdC_predicted,0.0625,15,15,CTCGGTACATCCGCTAACTC,0,1901946
icdC_predicted,0.0625,15,15,CTCCTTTTAGAGGAATTCTT,0,1889549
icdC_predicted,0.0625,15,15,CTATTAACGGCATCACGCAT,0,1895807
icdC_predicted,0.0625,15,15,CGTGTGGATAATATAGTTGG,0,1900736
icdC_predicted,0.0625,15,15,CGGGAAGGAAAGGACTTGAC,0,1880585
icdC_predicted,0.0625,15,15,CGGCCGACCAGGAACTGTCA,0,1902154
icdC_predicted,0.0625,15,15,CGGACTGATAGATCGTCGAA,0,1908901
icdC_predicted,0.0625,15,15,CGCATGCTATAATAGAGTAT,0,1885375
icdC_predicted,0.0625,15,15,CGAGGAAGCCGTAGATCGCG,0,1900629
icdC_predicted,0.0625,15,15,CCTTTAACTGTCATAAGATT,0,1907084
icdC_predicted,0.0625,15,15,CCTTCAAGGCTTCGGGGAAA,0,1885193
icdC_predicted,0.0625,15,15,CCCACAAGGTTACATCACCA,0,1909223
icdC_predicted,0.0625,15,15,CACCGCGGTTTTAATTAGTC,0,1898664
icdC_predicted,0.0625,15,15,CAATTCGAACTTAACGGAAT,0,1896336
icdC_predicted,0.0625,15,15,CAACTGTCTCCAGGTATTAG,0,1879625
icdC_predicted,0.0625,15,15,ATTCGGCCCGATTTCGACGA,0,1900059
icdC_predicted,0.0625,15,15,ATGTGTGTATGGCCATCTAG,0,1899748
icdC_predicted,0.0625,15,15,ATGTCAGCTGGCTCAAGGCG,0,1902978
icdC_predicted,0.0625,15,15,ATCGGTGCTTCCAGTGCAAA,0,1884872
icdC_predicted,0.0625,15,15,ATCATGAAAATTGTGTGATA,0,1903002
icdC_predicted,0.0625,15,15,ATATATATGGGTGCTGGTAC,0,1883251
icdC_predicted,0.0625,15,15,AGTTTCAGGTCGGGGCGGGT,0,1904499
icdC_predicted,0.0625,15,15,AGGCCAGTGAAAGGTTGAAG,0,1898138
icdC_predicted,0.0625,15,15,AGAGCTACAGCCCACAGAAA,0,1889946
icdC_predicted,0.0625,15,15,ACTTCCATACGACTGCGGGT,0,1909225
icdC_predicted,0.0625,15,15,ACGAAGGCCCGTCAACCTTT,0,1894924
icdC_predicted,0.0625,15,15,ACCCGACTTAGTAGACCGAA,0,1901833
icdC_predicted,0.0625,15,15,ACCATTTGTTGACGGAGGAG,0,1885839
icdC_predicted,0.0625,15,15,AATCCGGGATGAAGTCACTA,0,1905389
icdC_predicted,0.0625,15,15,AAAGACGCTACACCCCGTTC,0,1882823
icdC_predicted,0.06666666666666667,14,14,TTGCGTTGCATTCAGTCATA,0,1889773
icdC_predicted,0.06666666666666667,14,14,TTGACGTAGGCCGCGACGGA,0,1907806
icdC_predicted,0.06666666666666667,14,14,TTCGCGCAAATCCTCGTCAG,0,1897541
icdC_predicted,0.06666666666666667,14,14,TTATGTTCATCGTGCTGCTG,0,1878059
icdC_predicted,0.06666666666666667,14,14,TTAAGTGTGTCACCATCGAT,0,1905888
icdC_predicted,0.06666666666666667,14,14,TGTGAGGATGAAGGCTCGTA,0,1906811
icdC_predicted,0.06666666666666667,14,14,TGGTTTTTACTTTGCCTTCT,0,1906097
icdC_predicted,0.06666666666666667,14,14,TGGAGTTATAGATCTTTTTG,0,1879229
icdC_predicted,0.06666666666666667,14,14,TGCGAGCCTTGGATTTGTTA,0,1893445
icdC_predicted,0.06666666666666667,14,14,TGACTCCACTTGGACCGCTA,0,1885699
icdC_predicted,0.06666666666666667,14,14,TCTCTTCCTTTCTCGCAGAA,0,1881137
icdC_predicted,0.06666666666666667,14,14,TCCCCTTAAAATCTGTCGGC,0,1906736
icdC_predicted,0.06666666666666667,14,14,TCATCACCACAAGGGCAGAT,0,1880674
icdC_predicted,0.06666666666666667,14,14,TCAGAGGTGGAACTGTTTTG,0,1896029
icdC_predicted,0.06666666666666667,14,14,TCACAGCGGGTCGGGGGAAG,0,1879067
icdC_predicted,0.06666666666666667,14,14,TATGCATTGAGTTACAGGCA,0,1878521
icdC_predicted,0.06666666666666667,14,14,TATACGTTGCCTTGTAATGC,0,1886950
icdC_predicted,0.06666666666666667,14,14,TAGCTTATGTACAGAGCTCT,0,1907984
icdC_predicted,0.06666666666666667,14,14,TACATAAGTAAAACGTGCAG,0,1882163
icdC_predicted,0.06666666666666667,14,14,TAAGTTCCCACGTGGTCTAA,0,1900775
icdC_predicted,0.06666666666666667,14,14,TAAGGAGTTCTACAAGGTGA,0,1883297
icdC_predicted,0.06666666666666667,14,14,GTTGCTTCCCGTGTTCTTAT,0,1896623
icdC_predicted,0.06666666666666667,14,14,GTTGACCAATTAAAACCAGA,0,1899260
icdC_predicted,0.06666666666666667,14,14,GTTCTTTTCGGGGTTTATGA,0,1892476
icdC_predicted,0.06666666666666667,14,14,GTTCTCGCCTAGGGTGATTT,0,1903101
icdC_predicted,0.06666666666666667,14,14,GTTATATTAATTGGGGCGCG,0,1894034
icdC_predicted,0.06666666666666667,14,14,GTGATGGCGAGACCTGCAAG,0,1889367
icdC_predicted,0.06666666666666667,14,14,GTCGTCCTTACCAGCGTAAG,0,1907988
icdC_predicted,0.06666666666666667,14,14,GTAGTGCAGCACAGGGCCAA,0,1880747
icdC_predicted,0.06666666666666667,14,14,GGCTGTGTTCTAGGTGACTG,0,1898114
icdC_predicted,0.06666666666666667,14,14,GGCGCCGACGACTTGAGGGA,0,1900572
icdC_predicted,0.06666666666666667,14,14,GGCAACGCATGAGTACTCAG,0,1906516
icdC_predicted,0.06666666666666667,14,14,GGAGCTCCAGGCGGCATTAG,0,1902782
icdC_predicted,0.06666666666666667,14,14,GGAGCCAGCATACGCTTATT,0,1886712
icdC_predicted,0.06666666666666667,14,14,GCTTACGATCCGAGGATCGG,0,1907687
icdC_predicted,0.06666666666666667,14,14,GCTGACGTGTTCCCGGGTGT,0,1893148
icdC_predicted,0.06666666666666667,14,14,GCTCGAAATAATTGCGATGG,0,1905104
icdC_predicted,0.06666666666666667,14,14,GCTAGCATGCCTGTATCTTC,0,1908882
icdC_predicted,0.06666666666666667,14,14,GCCCTAATACTGAGCGACGT,0,1906091
icdC_predicted,0.06666666666666667,14,14,GCAATCGTTAGCCCTAGCGT,0,1879973
icdC_predicted,0.06666666666666667,14,14,GCAATAGCAAAGTCGTTGAT,0,1897082
icdC_predicted,0.06666666666666667,14,14,GAGGCACCAGGTGGAAAGCT,0,1889572
icdC_predicted,0.06666666666666667,14,14,GAGACATTTGCGACCTGGCC,0,1881986
icdC_predicted,0.06666666666666667,14,14,GAAGCTACATGATTCGACTT,0,1906732
icdC_predicted,0.06666666666666667,14,14,GAACTAGACGTCGCCAAGCA,0,1887044
icdC_predicted,0.06666666666666667,14,14,GAACGACTTCCGCCAATCCG,0,1909307
icdC_predicted,0.06666666666666667,14,14,CTTACCACGCCCGCGATGCT,0,1880296
icdC_predicted,0.06666666666666667,14,14,CTGTCACTAAGTTGTGACAA,0,1903747
icdC_predicted,0.06666666666666667,14,14,CTGAGGAAGTGGCTAACTAT,0,1882571
icdC_predicted,0.06666666666666667,14,14,CTCGATAGTCATTCCCTAGA,0,1904642
icdC_predicted,0.06666666666666667,14,14,CTCCATGAAGTGAGCCTGCA,0,1882888
icdC_predicted,0.06666666666666667,14,14,CTCCAGGGTTCCGTCCCACT,0,1880841
icdC_predicted,0.06666666666666667,14,14,CGTTTATTAGACATTGCTTC,0,1898055
icdC_predicted,0.06666666666666667,14,14,CGTGTCACCTCTTTGCTTCA,0,1898185
icdC_predicted,0.06666666666666667,14,14,CGGGAAGCCCACTGGCCGGA,0,1909401
icdC_predicted,0.06666666666666667,14,14,CGGCAACACGAAGCCGCATA,0,1898392
icdC_predicted,0.06666666666666667,14,14,CGCGTAGCGTCGAGGAATTG,0,1892028
icdC_predicted,0.06666666666666667,14,14,CGCAGCTCGATGTCTTCTGA,0,1883992
icdC_predicted,0.06666666666666667,14,14,CGCAGCACCGGGAGAGTGAC,0,1897326
icdC_predicted,0.06666666666666667,14,14,CGAGTTAGGATTCCGTGGTT,0,1905726
icdC_predicted,0.06666666666666667,14,14,CCTAATCTTGCGGTGAGAGG,0,1887674
icdC_predicted,0.06666666666666667,14,14,CCGGGTCGCACCCGGCGTAT,0,1906543
icdC_predicted,0.06666666666666667,14,14,CCGGGTACGAGCTCCGAGTG,0,1883092
icdC_predicted,0.06666666666666667,14,14,CCATAGCCTTAGACTCTCCA,0,1908898
icdC_predicted,0.06666666666666667,14,14,CCAGCTATAGGTGATCCAGG,0,1887250
icdC_predicted,0.06666666666666667,14,14,CATTCACAGTCGGCGTCATG,0,1886506
icdC_predicted,0.06666666666666667,14,14,CACTACTTATAACTAAGTTT,0,1881879
icdC_predicted,0.06666666666666667,14,14,CACGTGTCTTCGCCCGACAG,0,1889842
icdC_predicted,0.06666666666666667,14,14,CACGGTCCCCGTAGTTTGTG,0,1907969
icdC_predicted,0.06666666666666667,14,14,CACCTTATAGGCAACTATAT,0,1890001
icdC_predicted,0.06666666666666667,14,14,CAAATGCTCCCGACAGAATC,0,1885111
icdC_predicted,0.06666666666666667,14,14,CAAAATCAAGTGAATTGAGA,0,1887771
icdC_predicted,0.06666666666666667,14,14,ATTGGCTCCTACAAGCTCAG,0,1895883
icdC_predicted,0.06666666666666667,14,14,ATTCGACGTCCGAAAATCCT,0,1887192
icdC_predicted,0.06666666666666667,14,14,ATATTCATTCGCTTTTGTCA,0,1884543
icdC_predicted,0.06666666666666667,14,14,ATATCAGGTACATGAGGATA,0,1882814
icdC_predicted,0.06666666666666667,14,14,ATAGCGCCTTGCCGGAAACC,0,1907035
icdC_predicted,0.06666666666666667,14,14,AGTCCAAACCCGGTAGCCGT,0,1891497
icdC_predicted,0.06666666666666667,14,14,AGTATTTGCCTTGAGTATGT,0,1902966
icdC_predicted,0.06666666666666667,14,14,AGGACCAACGGGATGCATCA,0,1886194
icdC_predicted,0.06666666666666667,14,14,AGCGAGCTAGCGCCTCTTGT,0,1879029
icdC_predicted,0.06666666666666667,14,14,AGCGACAAAGGAACGCAGAT,0,1880678
icdC_predicted,0.06666666666666667,14,14,ACTCTAAGAACGATAGTAAA,0,1897777
icdC_predicted,0.06666666666666667,14,14,ACGTTATATTAAGTTTGGGT,0,1895406
icdC_predicted,0.06666666666666667,14,14,ACGTGTGGTGGTACGCCGGT,0,1895588
icdC_predicted,0.06666666666666667,14,14,ACGACTTCCAATTAGGGAGT,0,1878999
icdC_predicted,0.06666666666666667,14,14,AATTCCTTATAACCGTTTTA,0,1888398
icdC_predicted,0.06666666666666667,14,14,AAGGCATATATGCCACATGG,0,1899750
icdC_predicted,0.06666666666666667,14,14,AAGGACATAGACGGGTAACT,0,1894866
icdC_predicted,0.06666666666666667,14,14,AAGATTTTTGTAGGTATATG,0,1895018
icdC_predicted,0.06666666666666667,14,14,AACAGTTTTCTCCGCACTCT,0,1892658
icdC_predicted,0.06666666666666667,14,14,AACAACGGATATCCACCTAA,0,1909424
icdC_predicted,0.07142857142857142,13,13,TTTTTCACCGGGGGCCTGAG,0,1881571
icdC_predicted,0.07142857142857142,13,13,TTTGAAATCATCTTTTTGAC,0,1892453
icdC_predicted,0.07142857142857142,13,13,TTTCGCCCTTCCTTGGAAAG,0,1882567
icdC_predicted,0.07142857142857142,13,13,TTCTTTGTCGCGTGGGGTTC,0,1884606
icdC_predicted,0.07142857142857142,13,13,TTCTAAGAGCGAGAAAGAGT,0,1896315
icdC_predicted,0.07142857142857142,13,13,TTACGACTTAGTTCTGTGAT,0,1893568
icdC_predicted,0.07142857142857142,13,13,TGTTAATGCGGTCTTCAACG,0,1900925
icdC_predicted,0.07142857142857142,13,13,TGGTGGCCAGCACAGGAGAT,0,1909316
icdC_predicted,0.07142857142857142,13,13,TGCCATCGCTAGCCTTCAGT,0,1894652
icdC_predicted,0.07142857142857142,13,13,TGATCTTTAGACCATATGAT,0,1885880
icdC_predicted,0.07142857142857142,13,13,TGAATGAACTAGAACACCAT,0,1906462
icdC_predicted,0.07142857142857142,13,13,TCTTGCGCAGGACTCTGATC,0,1902365
icdC_predicted,0.07142857142857142,13,13,TCTGTGGTCACTGTGAGTTC,0,1893325
icdC_predicted,0.07142857142857142,13,13,TCTGTCGCGTACCTGAGATT,0,1881484
icdC_predicted,0.07142857142857142,13,13,TCGTGGAAGCCTCCCTGCCT,0,1905045
icdC_predicted,0.07142857142857142,13,13,TCGTCGTTTGTGGGATAAGG,0,1894680
icdC_predicted,0.07142857142857142,13,13,TCGGGATGCTAGGCCGCGGG,0,1895692
icdC_predicted,0.07142857142857142,13,13,TCGAGGGTCGTCCTAATTGC,0,1878846
icdC_predicted,0.07142857142857142,13,13,TCCTTGTGGGTCTTGTTTGG,0,1896906
icdC_predicted,0.07142857142857142,13,13,TCCGGGCGCTCATGGGTCTT,0,1908953
icdC_predicted,0.07142857142857142,13,13,TCCGCGGGCCGCTAGGGCGA,0,1908401
icdC_predicted,0.07142857142857142,13,13,TCAGCTCCAATAACAGATTG,0,1884399
icdC_predicted,0.07142857142857142,13,13,TCAACGACACAGGAGTCGGA,0,1902625
icdC_predicted,0.07142857142857142,13,13,TATACTCCCCCAGACGAGAT,0,1890699
icdC_predicted,0.07142857142857142,13,13,TAGTGCGAAGGTCGTTCATG,0,1882828
icdC_predicted,0.07142857142857142,13,13,TAGCACTTAACAGTCGTTGT,0,1895939
icdC_predicted,0.07142857142857142,13,13,TAGAAGTCTATGGCTTGGAT,0,1904473
icdC_predicted,0.07142857142857142,13,13,TACTTATGTGTAGTCGGGGG,0,1905492
icdC_predicted,0.07142857142857142,13,13,TACACGCGCAGGCTGTGTAT,0,1882349
icdC_predicted,0.07142857142857142,13,13,TAAGGGCGTCGAGTCCACGT,0,1879997
icdC_predicted,0.07142857142857142,13,13,TAAAATCTCTTGAGACCATA,0,1886901
icdC_predicted,0.07142857142857142,13,13,GTTGCGTATCCGGACAGTAG,0,1887223
icdC_predicted,0.07142857142857142,13,13,GTTCGGTCTCAATCCGACGG,0,1903361
icdC_predicted,0.07142857142857142,13,13,GTGTCAACATGAGTTGGGTA,0,1902515
icdC_predicted,0.07142857142857142,13,13,GTGCTTACAACATGACCAAG,0,1878369
icdC_predicted,0.07142857142857142,13,13,GTCTGTAACGCTAATCCTCG,0,1884496
icdC_predicted,0.07142857142857142,13,13,GTCGGACCAAACGGACGCCG,0,1908917
icdC_predicted,0.07142857142857142,13,13,GTACCGGTGGTACGGTTTAT,0,1894156
icdC_predicted,0.07142857142857142,13,13,GGTTCTCTCCATATGGCGTT,0,1881121
icdC_predicted,0.07142857142857142,13,13,GGTATCCTGGAGAACCGGAT,0,1905149
icdC_predicted,0.07142857142857142,13,13,GGGTTCCACATTTCATGGTT,0,1893502
icdC_predicted,0.07142857142857142,13,13,GGCCTAGTTAAAGTCTAGCC,0,1907363
icdC_predicted,0.07142857142857142,13,13,GCGCGATCCGATCGACCATT,0,1908853
icdC_predicted,0.07142857142857142,13,13,GCCAGACTAGCAGTCATAGA,0,1881079
icdC_predicted,0.07142857142857142,13,13,GATGAACACTCTGCTTCTCG,0,1879859
icdC_predicted,0.07142857142857142,13,13,GATCTTAGCACGAACAGTTA,0,1891474
icdC_predicted,0.07142857142857142,13,13,GATCATTTTAGGGCGTTTCT,0,1898535
icdC_predicted,0.07142857142857142,13,13,GAGGTTTCGTAGAGATCGTT,0,1885119
icdC_predicted,0.07142857142857142,13,13,GAGGTAGGGCATCCGACGGG,0,1887484
icdC_predicted,0.07142857142857142,13,13,GAGCCGTCTGTTAGTAGGAC,0,1881417
icdC_predicted,0.07142857142857142,13,13,GACGATAATCTCAAATTTTA,0,1905067
icdC_predicted,0.07142857142857142,13,13,GACCGACGTATCTGCTGGGA,0,1887141
icdC_predicted,0.07142857142857142,13,13,GACATTAAGTCGCAATTAGC,0,1895476
icdC_predicted,0.07142857142857142,13,13,GAAGGGCGCGTCGCGACGCA,0,1900811
icdC_predicted,0.07142857142857142,13,13,GAACTAATTTCAATTAACAA,0,1881932
icdC_predicted,0.07142857142857142,13,13,GAAACCCTAGCGCTAAGTTA,0,1888926
icdC_predicted,0.07142857142857142,13,13,CTGCTGGTACCCGTGGAGTG,0,1905605
icdC_predicted,0.07142857142857142,13,13,CTGCTGCCAGATCAATGGAG,0,1883888
icdC_predicted,0.07142857142857142,13,13,CTGCGTGTATGTGGGCTCGA,0,1907143
icdC_predicted,0.07142857142857142,13,13,CTGATAGCTGGCGTGGAAGA,0,1885737
icdC_predicted,0.07142857142857142,13,13,CTCTTATTGGATACTATGGA,0,1890763
icdC_predicted,0.07142857142857142,13,13,CTCTCTCCCGAAATCCGCAA,0,1880390
icdC_predicted,0.07142857142857142,13,13,CTCGGGGCAGGGAGATGGGA,0,1883031
icdC_predicted,0.07142857142857142,13,13,CTCGGCCATCTAGTTAAGGT,0,1883147
icdC_predicted,0.07142857142857142,13,13,CTCGCTAAAGCTCAACGCCA,0,1883355
icdC_predicted,0.07142857142857142,13,13,CTATTGTGTTAGATAGTATT,0,1900793
icdC_predicted,0.07142857142857142,13,13,CTAGCACGGGCAGTATGACA,0,1881841
icdC_predicted,0.07142857142857142,13,13,CGTTGGTAGTCCAGGCTACG,0,1908956
icdC_predicted,0.07142857142857142,13,13,CGTTCCGAGAAACTGTATGA,0,1884207
icdC_predicted,0.07142857142857142,13,13,CGGTGCCCCGCTTGTAGGGC,0,1880650
icdC_predicted,0.07142857142857142,13,13,CGGGACTTAGCCCTCACGAC,0,1886030
icdC_predicted,0.07142857142857142,13,13,CGGCGTGCGTCCTTACCATA,0,1888520
icdC_predicted,0.07142857142857142,13,13,CGGCCCGCGCATCCGTGTCA,0,1880065
icdC_predicted,0.07142857142857142,13,13,CGCGAGTTTTAACATTCCGA,0,1907382
icdC_predicted,0.07142857142857142,13,13,CGCCACAATAATTATACTGA,0,1900193
icdC_predicted,0.07142857142857142,13,13,CGACATGAGTCGAAACGGCA,0,1891460
icdC_predicted,0.07142857142857142,13,13,CCTTAGAGTGAAAAATCGTT,0,1889745
icdC_predicted,0.07142857142857142,13,13,CCTCGACAGTTCCCCGAGCA,0,1885362
icdC_predicted,0.07142857142857142,13,13,CCGTTTGTAGGAGAGCCTTC,0,1887288
icdC_predicted,0.07142857142857142,13,13,CCGGCTCAGAGTCGGTTATA,0,1894116
icdC_predicted,0.07142857142857142,13,13,CCGGCCTAATAGGGGAGGCT,0,1878861
icdC_predicted,0.07142857142857142,13,13,CCGAGCAGACGCAAGCTCGT,0,1880290
icdC_predicted,0.07142857142857142,13,13,CCCCCAAAGTGAGGAGGCAG,0,1879345
icdC_predicted,0.07142857142857142,13,13,CCAGCCCGGTACTGACTTAC,0,1893392
icdC_predicted,0.07142857142857142,13,13,CCAAGGTCGGCTCGACTTTG,0,1899257
icdC_predicted,0.07142857142857142,13,13,CCAAATACAATATGGAGGAT,0,1901523
icdC_predicted,0.07142857142857142,13,13,CCAAACGTCACCCGTTGTAT,0,1889328
icdC_predicted,0.07142857142857142,13,13,CATGACCCAGGCTATGACCT,0,1890313
icdC_predicted,0.07142857142857142,13,13,CAGAGTAAAACTTCGCGCTC,0,1891175
icdC_predicted,0.07142857142857142,13,13,CACAACAGCGGCACATGCAG,0,1881375
icdC_predicted,0.07142857142857142,13,13,CAAGAATTTACTAAGACGCC,0,1901782
icdC_predicted,0.07142857142857142,13,13,ATGGCCATCTGTGTTTTTGC,0,1899800
icdC_predicted,0.07142857142857142,13,13,ATGGAGCGCTGTAAAGAAGA,0,1886305
icdC_predicted,0.07142857142857142,13,13,ATCCGCGGATGGTTAGGGTC,0,1887282
icdC_predicted,0.07142857142857142,13,13,ATCAATCTTGGCGGCGCCTA,0,1887105
icdC_predicted,0.07142857142857142,13,13,ATATTTTCTGGGAATGGTCA,0,1897936
icdC_predicted,0.07142857142857142,13,13,ATAGTCTGCGCAGGCATTTA,0,1909062
icdC_predicted,0.07142857142857142,13,13,ATAGTAGGACGCCGCCTAAG,0,1891296
icdC_predicted,0.07142857142857142,13,13,ATACCTTTTGGAGGATCAAG,0,1897970
icdC_predicted,0.07142857142857142,13,13,ATACCCGATCGGCTTGGTAG,0,1907684
icdC_predicted,0.07142857142857142,13,13,ATACACGTGGCTGCAGTGAA,0,1906314
icdC_predicted,0.07142857142857142,13,13,AGTTTACACCGAAGACCGAA,0,1877911
icdC_predicted,0.07142857142857142,13,13,AGTCTTACTTTCGTACGCGC,0,1883354
icdC_predicted,0.07142857142857142,13,13,AGTATGGAACTTGGGTGATT,0,1882408
icdC_predicted,0.07142857142857142,13,13,AGTATCCTGCGCGACTGTCT,0,1880997
icdC_predicted,0.07142857142857142,13,13,AGGATATACGTGAGGGGCTA,0,1902638
icdC_predicted,0.07142857142857142,13,13,AGCTCGAGTCACAGATGTCC,0,1900008
icdC_predicted,0.07142857142857142,13,13,AGCGTTAGCCCATATACCTA,0,1883730
icdC_predicted,0.07142857142857142,13,13,AGCGGGAAACGGACCACATC,0,1879926
icdC_predicted,0.07142857142857142,13,13,AGCAAGGCTTGAGTACTACA,0,1878558
icdC_predicted,0.07142857142857142,13,13,ACTTCATGGTCCGGCCCTGG,0,1881432
icdC_predicted,0.07142857142857142,13,13,ACTAATCCGGACTTACAATT,0,1899027
icdC_predicted,0.07142857142857142,13,13,ACTAACTCCGGCGCAGACTG,0,1903308
icdC_predicted,0.07142857142857142,13,13,ACCGGATGTGAGGGTCACAG,0,1888858
icdC_predicted,0.07142857142857142,13,13,ACATAGAATATTTGCGACTC,0,1906609
icdC_predicted,0.07142857142857142,13,13,ACAGGCTTCGTCGATGTTTA,0,1891053
icdC_predicted,0.07142857142857142,13,13,ACACCCACGGTATCAAGGTC,0,1888862
icdC_predicted,0.07142857142857142,13,13,ACAACCCCACTTATTACTTA,0,1881580
icdC_predicted,0.07142857142857142,13,13,AATGCTATATCTCGAGTCTG,0,1886716
icdC_predicted,0.07142857142857142,13,13,AATGCGATTAGACTTATAAA,0,1898540
icdC_predicted,0.07142857142857142,13,13,AATGCCTTCAACAGTCAACT,0,1884050
icdC_predicted,0.07142857142857142,13,13,AATGCCTGTTTGGTTGGCCC,0,1885711
icdC_predicted,0.07142857142857142,13,13,AAGTTCCTAAGGTTCGGTAA,0,1905774
icdC_predicted,0.07142857142857142,13,13,AAGGATGTGTCAGCCTAAGT,0,1903737
icdC_predicted,0.07142857142857142,13,13,AAGCCTTTCGCGCTGCATAG,0,1901863
icdC_predicted,0.07142857142857142,13,13,AAGCCTTCACTCTATTCTAT,0,1886917
icdC_predicted,0.07142857142857142,13,13,AACGAATGGTACCTAGTCAA,0,1885075
icdC_predicted,0.07142857142857142,13,13,AACATAAGTAAGAGCAGCTG,0,1879681
icdC_predicted,0.07142857142857142,13,13,AACACGGCAATAGCGCGTCT,0,1907036
icdC_predicted,0.07692307692307693,12,12,TTGTTGGGCAGGGCGAATAC,0,1886745
icdC_predicted,0.07692307692307693,12,12,TTGTCATGAATAGGTTCTGA,0,1882627
icdC_predicted,0.07692307692307693,12,12,TTGAGGGCTTGGCTCTGGCG,0,1891462
icdC_predicted,0.07692307692307693,12,12,TTCCGAAAGTTAAACCGGTA,0,1882541
icdC_predicted,0.07692307692307693,12,12,TTATACCGGAGCTGCCCGGG,0,1893208
icdC_predicted,0.07692307692307693,12,12,TTAGGACGTGCGGTTCACAT,0,1880313
icdC_predicted,0.07692307692307693,12,12,TTAAGTGGTACCGTGGATAC,0,1901802
icdC_predicted,0.07692307692307693,12,12,TGTTGGCTTTTCGCTCAGTT,0,1907562
icdC_predicted,0.07692307692307693,12,12,TGTATTGAGAGGCATCACAG,0,1890003
icdC_predicted,0.07692307692307693,12,12,TGGGTGTTCACATGAAGAAG,0,1898260
icdC_predicted,0.07692307692307693,12,12,TGGATACGTAAGGCTGTTTT,0,1882867
icdC_predicted,0.07692307692307693,12,12,TGGAATCCATGCGTTTTCGT,0,1882836
icdC_predicted,0.07692307692307693,12,12,TGCAAGGGGTAGTGTAAGGC,0,1880135
icdC_predicted,0.07692307692307693,12,12,TCTGTGGTCTGAATAACTGA,0,1902982
icdC_predicted,0.07692307692307693,12,12,TCTATGGCGCTTGAGGGGTT,0,1895819
icdC_predicted,0.07692307692307693,12,12,TCGTAATTTAGCCAGAAAAC,0,1899092
icdC_predicted,0.07692307692307693,12,12,TCGGGATAGAGGTTGAGTCA,0,1883167
icdC_predicted,0.07692307692307693,12,12,TCCTTGACATCCTTTTGTGA,0,1893696
icdC_predicted,0.07692307692307693,12,12,TCCGGGGACAGCAGCCGTGC,0,1890000
icdC_predicted,0.07692307692307693,12,12,TCCGCCAGCTCTTGGGAACG,0,1878356
icdC_predicted,0.07692307692307693,12,12,TATGCCGATCATAAGGTTAT,0,1899592
icdC_predicted,0.07692307692307693,12,12,GTTTGGGTCCATCGACGGGT,0,1880772
icdC_predicted,0.07692307692307693,12,12,GTTGTTTATCGCCATAAGCA,0,1905514
icdC_predicted,0.07692307692307693,12,12,GTTGGGTATAGGCAGGTCTA,0,1896830
icdC_predicted,0.07692307692307693,12,12,GTTGACCTAGCTTTATGTTT,0,1908311
icdC_predicted,0.07692307692307693,12,12,GTTCCGAGGCCATCTAGATG,0,1893172
icdC_predicted,0.07692307692307693,12,12,GTTAGCTCACTCCGCGGCTG,0,1890913
icdC_predicted,0.07692307692307693,12,12,GTTAAGACCCAGGTCTTACG,0,1905836
icdC_predicted,0.07692307692307693,12,12,GTGTGTTGGCTTGAGATCTT,0,1887541
icdC_predicted,0.07692307692307693,12,12,GTGCGGCTGCAAGCCTTACG,0,1883884
icdC_predicted,0.07692307692307693,12,12,GTCCTGAATATAAGATGCCT,0,1889494
icdC_predicted,0.07692307692307693,12,12,GTATTACGAATCGTAATACT,0,1881267
icdC_predicted,0.07692307692307693,12,12,GTACTCGCCTGTGTCCTATT,0,1887805
icdC_predicted,0.07692307692307693,12,12,GGTTTGCAATGGGGTGTAGA,0,1897443
icdC_predicted,0.07692307692307693,12,12,GGTTGTCTCGAGGAGCGGCT,0,1877959
icdC_predicted,0.07692307692307693,12,12,GGGGGACGTAGTATTCGAGG,0,1884626
icdC_predicted,0.07692307692307693,12,12,GGCTAGCTACCAGCAATTAA,0,1888746
icdC_predicted,0.07692307692307693,12,12,GGCGACTTGCTGCAGGTGGT,0,1884335
icdC_predicted,0.07692307692307693,12,12,GGATTCTGTGGTGTTCTTGT,0,1886948
icdC_predicted,0.07692307692307693,12,12,GGACCCATGCAGGATTTAGA,0,1903599
icdC_predicted,0.07692307692307693,12,12,GGACACTTCGATTATTCCAT,0,1882966
icdC_predicted,0.07692307692307693,12,12,GGAACCTCTGAATTAAGCTA,0,1878961
icdC_predicted,0.07692307692307693,12,12,GCTTTTGCGTCCCTTCCGAC,0,1890265
icdC_predicted,0.07692307692307693,12,12,GCTTGGTGGTTTTCTGGTTA,0,1902176
icdC_predicted,0.07692307692307693,12,12,GCGGTGATTATCCTCGCAGA,0,1893224
icdC_predicted,0.07692307692307693,12,12,GCGCGTTGTATACCTAATGT,0,1897003
icdC_predicted,0.07692307692307693,12,12,GCGCGGCAATGTTGTGCCAC,0,1893069
icdC_predicted,0.07692307692307693,12,12,GCAGGCTCCAGCCGCGACAG,0,1884338
icdC_predicted,0.07692307692307693,12,12,GCAGCTTAGAACTACACGTG,0,1895693
icdC_predicted,0.07692307692307693,12,12,GATTTTCCTAGCTCACGTCC,0,1898426
icdC_predicted,0.07692307692307693,12,12,GATTATGGAAGGGTACAAGG,0,1885278
icdC_predicted,0.07692307692307693,12,12,GAGTGTTTGGGTTCCGATTA,0,1887741
icdC_predicted,0.07692307692307693,12,12,GAGGGTCTTTTTTGTTCAAG,0,1888576
icdC_predicted,0.07692307692307693,12,12,GAGCGGGATGGTAGGCGTGA,0,1894567
icdC_predicted,0.07692307692307693,12,12,GACTGCCAACGTGGTTTGCC,0,1905304
icdC_predicted,0.07692307692307693,12,12,GACCGCCACATGGCTCTGTA,0,1903467
icdC_predicted,0.07692307692307693,12,12,GACATGCACACTACATCGAT,0,1893371
icdC_predicted,0.07692307692307693,12,12,GACAGGGTAGCGAATCACGT,0,1904068
icdC_predicted,0.07692307692307693,12,12,GAATGATTGCTCCTACATAC,0,1902323
icdC_predicted,0.07692307692307693,12,12,GAAGGACACTGAGTTTTCAA,0,1897336
icdC_predicted,0.07692307692307693,12,12,GAACTTCGACTCTCCCCTAT,0,1881047
icdC_predicted,0.07692307692307693,12,12,CTTGGATAACGCGTGTCTCA,0,1899821
icdC_predicted,0.07692307692307693,12,12,CTTCATGGTTCAACAGGCTT,0,1887292
icdC_predicted,0.07692307692307693,12,12,CTCGGTCAACTATAGAAAAG,0,1896136
icdC_predicted,0.07692307692307693,12,12,CTCGGTAGCGCACCATCGGG,0,1885489
icdC_predicted,0.07692307692307693,12,12,CTCCAACGCCCCGAGCGCTA,0,1882696
icdC_predicted,0.07692307692307693,12,12,CTCACTCTGCACGATGCAGA,0,1885267
icdC_predicted,0.07692307692307693,12,12,CTAGAGCGTTGGTCCCAGCA,0,1894124
icdC_predicted,0.07692307692307693,12,12,CTAGACTCCGGTCGCCTCTG,0,1889147
icdC_predicted,0.07692307692307693,12,12,CTAACAGGACGGAATTATGA,0,1896003
icdC_predicted,0.07692307692307693,12,12,CGTCGGATTTATCATCGTAT,0,1888268
icdC_predicted,0.07692307692307693,12,12,CGGTGGATCTGTCCTAGCAT,0,1906751
icdC_predicted,0.07692307692307693,12,12,CGGGTTTGTAAGTTAAACCA,0,1892415
icdC_predicted,0.07692307692307693,12,12,CGGGATTGGTAGCCCAATGC,0,1906373
icdC_predicted,0.07692307692307693,12,12,CGGGAGATTTCTACAGCCCC,0,1905761
icdC_predicted,0.07692307692307693,12,12,CGGAGGCCTAAGAGAGTCGG,0,1893635
icdC_predicted,0.07692307692307693,12,12,CGCTATAATTACGGTACCTT,0,1879958
icdC_predicted,0.07692307692307693,12,12,CGCCGACACCGAAACGGTAA,0,1886710
icdC_predicted,0.07692307692307693,12,12,CGCAGAGAGATTATCGCGGA,0,1906551
icdC_predicted,0.07692307692307693,12,12,CGCAACCTAATTGACGGCTT,0,1898920
icdC_predicted,0.07692307692307693,12,12,CGATTTGTATGCTCCATACA,0,1894971
icdC_predicted,0.07692307692307693,12,12,CGAGGAATGCTGAAGCAAGA,0,1890159
icdC_predicted,0.07692307692307693,12,12,CGAGCACTCAAGAGAAGTTC,0,1891518
icdC_predicted,0.07692307692307693,12,12,CGACCCCTTTCCATTGGCTT,0,1893244
icdC_predicted,0.07692307692307693,12,12,CCTGAGTAAACTTTGTCTTG,0,1907745
icdC_predicted,0.07692307692307693,12,12,CCTCCCTTGGTTGTCTCGGT,0,1897698
icdC_predicted,0.07692307692307693,12,12,CCTCATTGCCCGAATGTTAA,0,1886537
icdC_predicted,0.07692307692307693,12,12,CCTAACGATGTACATTTCAA,0,1905454
icdC_predicted,0.07692307692307693,12,12,CCGTAGGGGCGTTAAATCTA,0,1903079
icdC_predicted,0.07692307692307693,12,12,CCGGCGTCAGGCTGATAGAC,0,1878603
icdC_predicted,0.07692307692307693,12,12,CCGGCCTACGGTCTCCCTTG,0,1896598
icdC_predicted,0.07692307692307693,12,12,CCCCTGCAAGGCTAGGCCGG,0,1888538
icdC_predicted,0.07692307692307693,12,12,CCCCTCCAGATATTAGCGCT,0,1899777
icdC_predicted,0.07692307692307693,12,12,CCCATCTGCGAAGGCGGCCC,0,1892874
icdC_predicted,0.07692307692307693,12,12,CCAGTATCCCGGGCTAATGC,0,1880978
icdC_predicted,0.07692307692307693,12,12,CCAGGCGAGATATCTAACTC,0,1883271
icdC_predicted,0.07692307692307693,12,12,CCACTCAATAACTTTCGGGT,0,1903871
icdC_predicted,0.07692307692307693,12,12,CCACGTCAAAGCTCATAGCA,0,1889067
icdC_predicted,0.07692307692307693,12,12,CACTTTAATCGTCCGGGCCG,0,1890655
icdC_predicted,0.07692307692307693,12,12,CACTATGATAGCGGCGGAGA,0,1900962
icdC_predicted,0.07692307692307693,12,12,CACGTGTACCCGAACATCCA,0,1893665
icdC_predicted,0.07692307692307693,12,12,CACGCGGGCTAGGCCGCTAC,0,1879113
icdC_predicted,0.07692307692307693,12,12,CAATTCTAGCCACGATAGCA,0,1901310
icdC_predicted,0.07692307692307693,12,12,CAAAGGTTCAGCACCGCACT,0,1904349
icdC_predicted,0.07692307692307693,12,12,ATTCAGCAGAGGCCTTCAAA,0,1907599
icdC_predicted,0.07692307692307693,12,12,ATTCACCGACTCGTCCCAGT,0,1905030
icdC_predicted,0.07692307692307693,12,12,ATTAGCGTTCGACGCAGGCT,0,1900650
icdC_predicted,0.07692307692307693,12,12,ATGTTTTTTGACTCCTACTA,0,1906284
icdC_predicted,0.07692307692307693,12,12,ATGACGGGATGTAAACGGGC,0,1883082
icdC_predicted,0.07692307692307693,12,12,ATCCTACTGATGCTGAAAAA,0,1884800
icdC_predicted,0.07692307692307693,12,12,ATCAGCGACCCCGCTGCGCC,0,1902706
icdC_predicted,0.07692307692307693,12,12,ATATAAGGCTCAATACCCTG,0,1895981
icdC_predicted,0.07692307692307693,12,12,AGGGCAACGTGAAGTAAGCC,0,1892515
icdC_predicted,0.07692307692307693,12,12,AGGATGCCGTCAGATTCATA,0,1893368
icdC_predicted,0.07692307692307693,12,12,AGGATCATGCAGTAAATTCA,0,1880549
icdC_predicted,0.07692307692307693,12,12,AGGAGGGGGAGGTTCACGCC,0,1897544
icdC_predicted,0.07692307692307693,12,12,AGCGGGCAAATTGACACAGA,0,1898369
icdC_predicted,0.07692307692307693,12,12,AGCGGCTGACTGATGGCTGC,0,1889265
icdC_predicted,0.07692307692307693,12,12,AGCGCGCAACAACCACGACA,0,1877898
icdC_predicted,0.07692307692307693,12,12,AGAGCAGGTCATCTGCATCT,0,1908435
icdC_predicted,0.07692307692307693,12,12,AGACGTCTGCTATACTAAGA,0,1889490
icdC_predicted,0.07692307692307693,12,12,AGAAGAATAATGATTAGCTA,0,1879282
icdC_predicted,0.07692307692307693,12,12,ACTTTATCAGGTTGTAGGGT,0,1878995
icdC_predicted,0.07692307692307693,12,12,ACTGCTTCAGCAAAATTGTA,0,1885531
icdC_predicted,0.07692307692307693,12,12,ACTGCGACGGCATCTGACTG,0,1877904
icdC_predicted,0.07692307692307693,12,12,ACTCCAAAAGCGTGAGGCAT,0,1907645
icdC_predicted,0.07692307692307693,12,12,ACTAGGTTAGAGATTACGGT,0,1878664
icdC_predicted,0.07692307692307693,12,12,ACGTCTCGTAGCAGTACCTA,0,1888695
icdC_predicted,0.07692307692307693,12,12,ACGGATCGGAATGCCCGTCT,0,1890868
icdC_predicted,0.07692307692307693,12,12,ACGATAGACCAGGTGGTCAC,0,1879785
icdC_predicted,0.07692307692307693,12,12,ACGAGCCGGACCATAACGGA,0,1890298
icdC_predicted,0.07692307692307693,12,12,ACCTTCTAAGCGGATATACA,0,1903435
icdC_predicted,0.07692307692307693,12,12,ACCTGCAGTTTCGTCTAAGG,0,1898278
icdC_predicted,0.07692307692307693,12,12,ACCTCGAAGTTGGTATACGG,0,1898777
icdC_predicted,0.07692307692307693,12,12,ACCGTGGCGCGTGCGGCCGT,0,1903417
icdC_predicted,0.07692307692307693,12,12,ACATTGCTTTAGATGCGCTC,0,1886145
icdC_predicted,0.07692307692307693,12,12,ACATACACCGTGAACTGAGT,0,1896778
icdC_predicted,0.07692307692307693,12,12,ACAGCTGTATGCAAGCTAAG,0,1879955
icdC_predicted,0.07692307692307693,12,12,ACACCGCGTCTCGCCGAAGG,0,1887339
icdC_predicted,0.07692307692307693,12,12,AATTCTACGTCACAAGAGGT,0,1885925
icdC_predicted,0.07692307692307693,12,12,AATATTAATTGGGTTACACC,0,1882821
icdC_predicted,0.07692307692307693,12,12,AAGTGATATGGTTCTGGTTA,0,1884259
icdC_predicted,0.07692307692307693,12,12,AAGGTGCCTACTACAGTTGT,0,1889320
icdC_predicted,0.07692307692307693,12,12,AAGCATTGCTTAGGCGTATC,0,1897236
icdC_predicted,0.07692307692307693,12,12,AACCGTTCCCTTTCATGCTG,0,1893683
icdC_predicted,0.07692307692307693,12,12,AACAGGTGCACAGCGGTGAT,0,1894469
icdC_predicted,0.07692307692307693,12,12,AACAATGAGCGGTGTGTGTC,0,1886848
icdC_predicted,0.07692307692307693,12,12,AAATTAGAATTAAGGGTGCT,0,1889166
icdC_predicted,0.07692307692307693,12,12,AAAGGCCATAGAGCTCTGGA,0,1890283
icdC_predicted,0.08333333333333333,11,11,TTGTGGCGGCGGGAATTTCG,0,1894753
icdC_predicted,0.08333333333333333,11,11,TTGGGTACCCCCCCATAGCC,0,1897442
icdC_predicted,0.08333333333333333,11,11,TTGGGCAACGACGATCCCGC,0,1891054
icdC_predicted,0.08333333333333333,11,11,TTGAGTTCGGTAAACACAGT,0,1886595
icdC_predicted,0.08333333333333333,11,11,TTCAACCCGGAACCAAGCAA,0,1899056
icdC_predicted,0.08333333333333333,11,11,TTACCCAGCGTCATGGCCGC,0,1885392
icdC_predicted,0.08333333333333333,11,11,TGTGCCGGTCTGGCAGACCT,0,1894246
icdC_predicted,0.08333333333333333,11,11,TGTGACCTGTTATTTGCTTA,0,1887209
icdC_predicted,0.08333333333333333,11,11,TGCTTCGTCGTGTGGTATAA,0,1906052
icdC_predicted,0.08333333333333333,11,11,TGCCGTTTTCAAATAGCTGA,0,1888297
icdC_predicted,0.08333333333333333,11,11,TGCCACCGCGACGGTGTCCT,0,1881809
icdC_predicted,0.08333333333333333,11,11,TGCAACTGTGGGTCAAGTTC,0,1886395
icdC_predicted,0.08333333333333333,11,11,TGCAACATATGGGGACCGGT,0,1886309
icdC_predicted,0.08333333333333333,11,11,TGACTAGAACCTCCGTATAG,0,1903005
icdC_predicted,0.08333333333333333,11,11,TGAACTCGCGAAATACTAGC,0,1888256
icdC_predicted,0.08333333333333333,11,11,TGAAATATCGCTTACCTTAC,0,1904636
icdC_predicted,0.08333333333333333,11,11,TCGTTCACTTGGGGACTGGT,0,1890834
icdC_predicted,0.08333333333333333,11,11,TCGTGAGGTACATACAATTT,0,1906714
icdC_predicted,0.08333333333333333,11,11,TCGTGACTATGTGGTAAGCT,0,1909415
icdC_predicted,0.08333333333333333,11,11,TCGGGATTAAAGGGGGTGGA,0,1889796
icdC_predicted,0.08333333333333333,11,11,TCGAAAGCTTCCCTTACGTC,0,1909238
icdC_predicted,0.08333333333333333,11,11,TCCACTAGCAAGTAAGGACG,0,1878224
icdC_predicted,0.08333333333333333,11,11,TCATGTTAAAGGTGGCAGCC,0,1888086
icdC_predicted,0.08333333333333333,11,11,TCAGCGCTCCGGGTGCCACA,0,1903311
icdC_predicted,0.08333333333333333,11,11,TATTTGACCGCGAGAAACTG,0,1893647
icdC_predicted,0.08333333333333333,11,11,TATTGGGTCGCAGGCCACTT,0,1906348
icdC_predicted,0.08333333333333333,11,11,TATGTAACTTGGACCAACGG,0,1897814
icdC_predicted,0.08333333333333333,11,11,TATATGTCTGCAAGCTCGTA,0,1881050
icdC_predicted,0.08333333333333333,11,11,TAGGGTCTATGTAGTGTAAT,0,1903283
icdC_predicted,0.08333333333333333,11,11,TAGGCTATTTTGCGAGTTCG,0,1886930
icdC_predicted,0.08333333333333333,11,11,TAGCGCGCATATCAAGATTT,0,1888179
icdC_predicted,0.08333333333333333,11,11,TAGAGTTACGTTTGAGTATT,0,1896962
icdC_predicted,0.08333333333333333,11,11,TAGACGAAGATGCACCGGGA,0,1902555
icdC_predicted,0.08333333333333333,11,11,TACGGACACACGTGGAGCTG,0,1880338
icdC_predicted,0.08333333333333333,11,11,TACCGTTATAAACTTCCCAA,0,1891500
icdC_predicted,0.08333333333333333,11,11,TACAGAGTCGAATGAAGATA,0,1883183
icdC_predicted,0.08333333333333333,11,11,TAATTTATGCCTCATGGTTT,0,1897959
icdC_predicted,0.08333333333333333,11,11,TAATACGAGAATTGCGAAAT,0,1903301
icdC_predicted,0.08333333333333333,11,11,TAACCGGTATGAATTATCGA,0,1886740
icdC_predicted,0.08333333333333333,11,11,TAACAGTGTATAGGCCGCGC,0,1900103
icdC_predicted,0.08333333333333333,11,11,TAACAGGAGGTCCTATTTAA,0,1900012
icdC_predicted,0.08333333333333333,11,11,TAAAATCAAATCTGAAGTTT,0,1889517
icdC_predicted,0.08333333333333333,11,11,GTTTCTGTCCACATCGAGTC,0,1888953
icdC_predicted,0.08333333333333333,11,11,GTTGCGGGACCCTTACCTTA,0,1881199
icdC_predicted,0.08333333333333333,11,11,GTTCTGTTGGACCGATTCCG,0,1905815
icdC_predicted,0.08333333333333333,11,11,GTGCGGGTGATCTCTAGGCA,0,1899328
icdC_predicted,0.08333333333333333,11,11,GTGAGTCCCGAGCAATAAGA,0,1892228
icdC_predicted,0.08333333333333333,11,11,GTCCAAGGTTGCTACTCGGC,0,1893021
icdC_predicted,0.08333333333333333,11,11,GTACTGTACATCCCTCTCGG,0,1882614
icdC_predicted,0.08333333333333333,11,11,GTACTATGAAAGCGGTTGTA,0,1888850
icdC_predicted,0.08333333333333333,11,11,GTAAATATCTCAGTTGGTAC,0,1882770
icdC_predicted,0.08333333333333333,11,11,GGTTCCGGCTCACGGAGCTT,0,1903179
icdC_predicted,0.08333333333333333,11,11,GGTCCCCGACTTTTCGATGT,0,1908946
icdC_predicted,0.08333333333333333,11,11,GGGTGGCCTAGTTTACTTCC,0,1888015
icdC_predicted,0.08333333333333333,11,11,GGGGGCACCACATATAGTCA,0,1899492
icdC_predicted,0.08333333333333333,11,11,GGCTGAGATTCACGTGCCGT,0,1878096
icdC_predicted,0.08333333333333333,11,11,GGCTACCGGAACATCTTCCT,0,1881223
icdC_predicted,0.08333333333333333,11,11,GGCGATGAGCCTGTTGTTGA,0,1878810
icdC_predicted,0.08333333333333333,11,11,GGCCCAAACTGTGCACCGGG,0,1882144
icdC_predicted,0.08333333333333333,11,11,GGAGTAACGTCTTGGTGAAT,0,1901360
icdC_predicted,0.08333333333333333,11,11,GGACTCCCTCTACACTTTGT,0,1888372
icdC_predicted,0.08333333333333333,11,11,GGAAAATATTCTGCCGCCAC,0,1885736
icdC_predicted,0.08333333333333333,11,11,GCTGTTTAGCGTCCGGTTAG,0,1889889
icdC_predicted,0.08333333333333333,11,11,GCTAGCACGCTCCTCTAACT,0,1888198
icdC_predicted,0.08333333333333333,11,11,GCTACCAGGCTCATTCACTC,0,1895141
icdC_predicted,0.08333333333333333,11,11,GCGTCTCAGAGTCTACATAG,0,1907721
icdC_predicted,0.08333333333333333,11,11,GCGCTGAAGCCTGAACATAT,0,1893866
icdC_predicted,0.08333333333333333,11,11,GCGCGCCCCTAATAGCCTTC,0,1896103
icdC_predicted,0.08333333333333333,11,11,GCCTCTGACGCAAGCTACAT,0,1893091
icdC_predicted,0.08333333333333333,11,11,GCCGGTAATCAATATATAAA,0,1906804
icdC_predicted,0.08333333333333333,11,11,GCCGGGGGAGAAGATGCATC,0,1892761
icdC_predicted,0.08333333333333333,11,11,GCCACGATCGCTCACATTGG,0,1889376
icdC_predicted,0.08333333333333333,11,11,GATGGTCCGCAGACGCTGCG,0,1889279
icdC_predicted,0.08333333333333333,11,11,GATCGAATAGAGCTCGTCAA,0,1879539
icdC_predicted,0.08333333333333333,11,11,GAGTTGCGGAATATCGTGCG,0,1887202
icdC_predicted,0.08333333333333333,11,11,GAGTCTCCGAAGGAGAGATG,0,1896976
icdC_predicted,0.08333333333333333,11,11,GAGACGAGTTGCAGCACCAG,0,1896180
icdC_predicted,0.08333333333333333,11,11,GACTGACGAATGGTCCACTT,0,1886890
icdC_predicted,0.08333333333333333,11,11,GACGTATTATGTCTGACTTG,0,1895653
icdC_predicted,0.08333333333333333,11,11,GACCTTACCCTTATTCCACG,0,1889513
icdC_predicted,0.08333333333333333,11,11,GACCGTGCCATAATCTCTTC,0,1889514
icdC_predicted,0.08333333333333333,11,11,GACCGGCGCCACTGGGCCCT,0,1902192
icdC_predicted,0.08333333333333333,11,11,GAATCTCCGCCTCTCTAAGT,0,1903540
icdC_predicted,0.08333333333333333,11,11,GAAGTGACCTGTGAGATTAA,0,1889573
icdC_predicted,0.08333333333333333,11,11,GAAGGATCTTCCAGCAGGCC,0,1901221
icdC_predicted,0.08333333333333333,11,11,GAACTGACCTCGGTATATAA,0,1885933
icdC_predicted,0.08333333333333333,11,11,CTTTACTTGGCTATTGAATA,0,1901026
icdC_predicted,0.08333333333333333,11,11,CTTTAAAATATTTAGTTATT,0,1897387
icdC_predicted,0.08333333333333333,11,11,CTTGCTTTGGTTATGACAGC,0,1902612
icdC_predicted,0.08333333333333333,11,11,CTTGAATATATTTCTGTATT,0,1907700
icdC_predicted,0.08333333333333333,11,11,CTTCCGCGGGCAGTCTCGGG,0,1879137
icdC_predicted,0.08333333333333333,11,11,CTTACTAGGCTGTGGTAATT,0,1907973
icdC_predicted,0.08333333333333333,11,11,CTGTAGACATCTCGTTGTAC,0,1901089
icdC_predicted,0.08333333333333333,11,11,CTGGACCTCTCACGGTGTCA,0,1897401
icdC_predicted,0.08333333333333333,11,11,CTCCGTGCTGGAGGCCGTTA,0,1895550
icdC_predicted,0.08333333333333333,11,11,CTCCCCTGCTTGACGTTCTC,0,1891050
icdC_predicted,0.08333333333333333,11,11,CTACGACTCCTACAGTATAA,0,1881822
icdC_predicted,0.08333333333333333,11,11,CTACCTAACATCCCTAAAGT,0,1879044
icdC_predicted,0.08333333333333333,11,11,CTACCCTGGGGACACTACAC,0,1885759
icdC_predicted,0.08333333333333333,11,11,CTAACGAGGATTCTCCCAGA,0,1884113
icdC_predicted,0.08333333333333333,11,11,CGTTCTTAGAAATAGATTCT,0,1881158
icdC_predicted,0.08333333333333333,11,11,CGTTAGTCGCAGGGTGGGGA,0,1893304
icdC_predicted,0.08333333333333333,11,11,CGTGTCGGTGGGGCGTCGTA,0,1893500
icdC_predicted,0.08333333333333333,11,11,CGGCAAACAATCTACACGCT,0,1888863
icdC_predicted,0.08333333333333333,11,11,CGCGGGCCATCAGCTCTATT,0,1885309
icdC_predicted,0.08333333333333333,11,11,CGCGGCCTAATTGCAGTTCT,0,1903979
icdC_predicted,0.08333333333333333,11,11,CGCGCGGGTGTATATTTGGC,0,1898405
icdC_predicted,0.08333333333333333,11,11,CGCATTGTTGGAATGTTCAG,0,1892979
icdC_predicted,0.08333333333333333,11,11,CGCATAGATCTAGTCAACTA,0,1899279
icdC_predicted,0.08333333333333333,11,11,CGCACTGCACCAAGGGGTAA,0,1883246
icdC_predicted,0.08333333333333333,11,11,CGACGATGATCGTTTCTTAC,0,1884846
icdC_predicted,0.08333333333333333,11,11,CGACCTTGATTGTAAGAAGC,0,1883519
icdC_predicted,0.08333333333333333,11,11,CGAATCTGAGAAGGCATTCA,0,1902997
icdC_predicted,0.08333333333333333,11,11,CCTTCGATACACAGAGTTTA,0,1881166
icdC_predicted,0.08333333333333333,11,11,CCGTGTTAGTGGCTGTTGGA,0,1881063
icdC_predicted,0.08333333333333333,11,11,CCGTCCCTACGTCCAACGAG,0,1878342
icdC_predicted,0.08333333333333333,11,11,CCCTGTGTTCTTCTGGGCTC,0,1897327
icdC_predicted,0.08333333333333333,11,11,CCCTACGTGCCAGCCGAAGC,0,1886160
icdC_predicted,0.08333333333333333,11,11,CCCTACGGTTGCTTTGATTG,0,1904086
icdC_predicted,0.08333333333333333,11,11,CCCGACTAAGTTCCATCAGG,0,1882351
icdC_predicted,0.08333333333333333,11,11,CCCGAAGGTTATCTCGCACC,0,1885095
icdC_predicted,0.08333333333333333,11,11,CCCCGCTATTCTTTTGCCAC,0,1894061
icdC_predicted,0.08333333333333333,11,11,CCCAAAAACCTGAGGCTAGT,0,1888306
icdC_predicted,0.08333333333333333,11,11,CCACACGGGACAGGTGGGCT,0,1894253
icdC_predicted,0.08333333333333333,11,11,CCAATTTCGCTGTAAAGTTA,0,1902264
icdC_predicted,0.08333333333333333,11,11,CATCAAAATCATCTCAGCAT,0,1891519
icdC_predicted,0.08333333333333333,11,11,CAGGCATTTTTTAGCACATC,0,1893181
icdC_predicted,0.08333333333333333,11,11,CACGATTTAGCTGAAAAGGT,0,1905387
icdC_predicted,0.08333333333333333,11,11,CACCGCGTCGGATGGTATAT,0,1879431
icdC_predicted,0.08333333333333333,11,11,CACCAGAAAGAACTTGCAAA,0,1885902
icdC_predicted,0.08333333333333333,11,11,CACATACCATCATAGGCTAT,0,1889532
icdC_predicted,0.08333333333333333,11,11,CACAGCAGTCAACCAAACAG,0,1902095
icdC_predicted,0.08333333333333333,11,11,CACACAATAACAATGACGTC,0,1888239
icdC_predicted,0.08333333333333333,11,11,CACAACCGTTATCATTATCT,0,1906847
icdC_predicted,0.08333333333333333,11,11,CACAAAAAGGTATCTACGGT,0,1880640
icdC_predicted,0.08333333333333333,11,11,CAAGTAACACTGCCATAGGC,0,1884002
icdC_predicted,0.08333333333333333,11,11,CAACTGGCCGTGATCACCGT,0,1879521
icdC_predicted,0.08333333333333333,11,11,CAACGTAGACCCGATGCGAC,0,1878618
icdC_predicted,0.08333333333333333,11,11,CAACACGCCCGTTCTTATCG,0,1898058
icdC_predicted,0.08333333333333333,11,11,ATTCTTAGCTATGGGGCTTT,0,1892164
icdC_predicted,0.08333333333333333,11,11,ATGATCCGTATGGGAAAATG,0,1878698
icdC_predicted,0.08333333333333333,11,11,ATCTGAGGGCGCATCGTTCA,0,1895516
icdC_predicted,0.08333333333333333,11,11,ATCTCTCCAGATCTACGCGT,0,1893303
icdC_predicted,0.08333333333333333,11,11,ATCTATTCAGTTGAAGTGGG,0,1881016
icdC_predicted,0.08333333333333333,11,11,ATCGGAATTGACCTATCATC,0,1904266
icdC_predicted,0.08333333333333333,11,11,ATCGCGCCTCATATTGGGCA,0,1904961
icdC_predicted,0.08333333333333333,11,11,ATCGATCATTGACAAGTCAT,0,1878665
icdC_predicted,0.08333333333333333,11,11,ATCCTGGTGGTCACGGATGT,0,1895460
icdC_predicted,0.08333333333333333,11,11,ATCCTGGTAGTCGAACTAGA,0,1892049
icdC_predicted,0.08333333333333333,11,11,ATCCCCCTATGACTCTGCAA,0,1902692
icdC_predicted,0.08333333333333333,11,11,ATATGCTGTCTCATTAGATA,0,1890809
icdC_predicted,0.08333333333333333,11,11,ATACGGAGTAAACTTGAGAC,0,1881247
icdC_predicted,0.08333333333333333,11,11,ATACACTGTCCGGTGCGGCC,0,1903446
icdC_predicted,0.08333333333333333,11,11,AGTCTTTTTTCCTTCGTTTC,0,1894763
icdC_predicted,0.08333333333333333,11,11,AGTCAGATGCCGAGTCTCCT,0,1889455
icdC_predicted,0.08333333333333333,11,11,AGGTAGTTCGCCGCGAATGC,0,1888813
icdC_predicted,0.08333333333333333,11,11,AGGGCGCCTTTGCTCCTTAG,0,1881096
icdC_predicted,0.08333333333333333,11,11,AGGCTATGGGCACTCGTTGA,0,1882014
icdC_predicted,0.08333333333333333,11,11,AGGAGCTGGGATAACGATTG,0,1898936
icdC_predicted,0.08333333333333333,11,11,AGGACCACGGGGTGCAAATG,0,1879993
icdC_predicted,0.08333333333333333,11,11,AGCTCGTAGCTAGCCGCCGA,0,1897913
icdC_predicted,0.08333333333333333,11,11,AGCCACGCGCCCGAGTTCAG,0,1903300
icdC_predicted,0.08333333333333333,11,11,AGAGTTGGCTAATGCGAGTC,0,1888937
icdC_predicted,0.08333333333333333,11,11,AGAACAGCAGGCAACTCCAA,0,1901021
icdC_predicted,0.08333333333333333,11,11,AGAACACTGTGTCCAAGTGG,0,1904333
icdC_predicted,0.08333333333333333,11,11,ACTTGTGTAGGCGCTGGGTG,0,1881212
icdC_predicted,0.08333333333333333,11,11,ACTTAGACAAGGCGAGTAGC,0,1884092
icdC_predicted,0.08333333333333333,11,11,ACGCAGTGACAACTAACCCT,0,1882104
icdC_predicted,0.08333333333333333,11,11,ACGCACTCTCACCCGAGGTA,0,1897941
icdC_predicted,0.08333333333333333,11,11,ACCCTTGACACGGACGGAAG,0,1896674
icdC_predicted,0.08333333333333333,11,11,ACCAAAGGCTATAATTCGCT,0,1891833
icdC_predicted,0.08333333333333333,11,11,ACAGTTCCAGCCTTTTTATT,0,1879350
icdC_predicted,0.08333333333333333,11,11,ACAGTGATTGGTCACGTATC,0,1905021
icdC_predicted,0.08333333333333333,11,11,ACAAGGCTCATATAGCACTT,0,1889906
icdC_predicted,0.08333333333333333,11,11,AATATCTATGAACAAGGCGG,0,1882930
icdC_predicted,0.08333333333333333,11,11,AATAGGAATCTAGGATTCTT,0,1888403
icdC_predicted,0.08333333333333333,11,11,AAGTCGCCTGGCAGTTTATT,0,1889552
icdC_predicted,0.08333333333333333,11,11,AAGGGGTCCGGGAGGCTCGT,0,1901993
icdC_predicted,0.08333333333333333,11,11,AAGACTTTTCACAAGGGCAA,0,1906748
icdC_predicted,0.08333333333333333,11,11,AACTTTAATATGCGGCACTC,0,1908652
icdC_predicted,0.08333333333333333,11,11,AACTACCCCGGCTCATGTTA,0,1879929
icdC_predicted,0.08333333333333333,11,11,AACGGCGCGAAATCCCGGCG,0,1888723
icdC_predicted,0.09090909090909091,10,10,TTTCGACGCTCTTGGAAAAC,0,1896099
icdC_predicted,0.09090909090909091,10,10,TTGTTTATCCAACGCGACTA,0,1903376
icdC_predicted,0.09090909090909091,10,10,TTGTCTGCCTCTCACCAATG,0,1908187
icdC_predicted,0.09090909090909091,10,10,TTGGTCTATTGGCGCCATCG,0,1895503
icdC_predicted,0.09090909090909091,10,10,TTGCGAAGCAGCAGTGCTTG,0,1899274
icdC_predicted,0.09090909090909091,10,10,TTGAAACGTACATTTGTGTT,0,1902317
icdC_predicted,0.09090909090909091,10,10,TTCTTATACTATAAAATTAC,0,1899476
icdC_predicted,0.09090909090909091,10,10,TTCCTGTTTTCGTTAAACGA,0,1893339
icdC_predicted,0.09090909090909091,10,10,TTATCGATATTGTGTAGTTG,0,1896871
icdC_predicted,0.09090909090909091,10,10,TGTCGATTTACCTGTTTCGA,0,1881443
icdC_predicted,0.09090909090909091,10,10,TGTATCAATAAGATTAGTGG,0,1880087
icdC_predicted,0.09090909090909091,10,10,TGTAAGGTGGACTTTAATTC,0,1888444
icdC_predicted,0.09090909090909091,10,10,TGTAACTGTGCTGCACGACT,0,1896579
icdC_predicted,0.09090909090909091,10,10,TGCTTGCGTGCGAGAGTCAA,0,1889774
icdC_predicted,0.09090909090909091,10,10,TGCGTCTTGTCATACATCAC,0,1893297
icdC_predicted,0.09090909090909091,10,10,TGCGCTAACTCAAGACAGCA,0,1887892
icdC_predicted,0.09090909090909091,10,10,TGCGAGGTGTTACAGCTGCT,0,1904348
icdC_predicted,0.09090909090909091,10,10,TGCAGTCGAGTACAGCTCCC,0,1883290
icdC_predicted,0.09090909090909091,10,10,TGACTAAAGTATCGCTACCC,0,1890677
icdC_predicted,0.09090909090909091,10,10,TGACGCTCAGTCTCATATCA,0,1881824
icdC_predicted,0.09090909090909091,10,10,TCTTTACGGGAACCGTATAT,0,1892576
icdC_predicted,0.09090909090909091,10,10,TCTACCCTAGACGCTCGGAC,0,1879659
icdC_predicted,0.09090909090909091,10,10,TCGTGTTTAGAATAGGCTTA,0,1883307
icdC_predicted,0.09090909090909091,10,10,TCGTGCATATAGCGCCTTCA,0,1893558
icdC_predicted,0.09090909090909091,10,10,TCGTCCGGCGGCGTGCTTCC,0,1887485
icdC_predicted,0.09090909090909091,10,10,TCGTCAAAGGCCCCTTTGGC,0,1904968
icdC_predicted,0.09090909090909091,10,10,TCGGCTATACTCATAAAACA,0,1878100
icdC_predicted,0.09090909090909091,10,10,TCGGAGTTAGTATTGTATCA,0,1884566
icdC_predicted,0.09090909090909091,10,10,TCCTGCCGGGGCCTGTTTTG,0,1884176
icdC_predicted,0.09090909090909091,10,10,TCCAATCAAGACAACGCAGC,0,1893409
icdC_predicted,0.09090909090909091,10,10,TCATAGGGTCGTTATTAGTC,0,1883286
icdC_predicted,0.09090909090909091,10,10,TCACCATGGCAGTCAGGAAC,0,1892242
icdC_predicted,0.09090909090909091,10,10,TCAACGCGGCCACCTGCTGC,0,1896834
icdC_predicted,0.09090909090909091,10,10,TAGGAGTACTGTTGAATATC,0,1902309
icdC_predicted,0.09090909090909091,10,10,TAGAGCTCTTTTTCTCGCAA,0,1896502
icdC_predicted,0.09090909090909091,10,10,TAGACGTAACCTACACGCCT,0,1895090
icdC_predicted,0.09090909090909091,10,10,TACCGCAAAAGAACGAAGCC,0,1889219
icdC_predicted,0.09090909090909091,10,10,TACCCTCGATGGAGACCTAC,0,1904540
icdC_predicted,0.09090909090909091,10,10,TACCATGATAGCGCATAAGG,0,1886677
icdC_predicted,0.09090909090909091,10,10,TACATCGCAAAGTGTTCATG,0,1879728
icdC_predicted,0.09090909090909091,10,10,TAATTCGAGTTCAAATTCAT,0,1884209
icdC_predicted,0.09090909090909091,10,10,GTTTGCAGCGGCGTTCACAT,0,1895493
icdC_predicted,0.09090909090909091,10,10,GTGTCACTTGCCGCTCGCCA,0,1885712
icdC_predicted,0.09090909090909091,10,10,GTGTAAATGGCTCGGGCCTT,0,1891567
icdC_predicted,0.09090909090909091,10,10,GTGGTCTCGAAGAGCCACCT,0,1893648
icdC_predicted,0.09090909090909091,10,10,GTGGGGCGAGCCTGGCGGCT,0,1905708
icdC_predicted,0.09090909090909091,10,10,GTGCAACTGACATTGGGCGA,0,1904318
icdC_predicted,0.09090909090909091,10,10,GTCTATCTAGTAGAATTTGA,0,1901311
icdC_predicted,0.09090909090909091,10,10,GTCGTCAACTCGGGCGCGCA,0,1882458
icdC_predicted,0.09090909090909091,10,10,GTCGCATTTACAAAGAACTC,0,1904805
icdC_predicted,0.09090909090909091,10,10,GTCCGCCTGTAACCCGCGGA,0,1894559
icdC_predicted,0.09090909090909091,10,10,GTCAGACCCGAGGTGCCACA,0,1891133
icdC_predicted,0.09090909090909091,10,10,GTCACGTCTGGTATAGTAAC,0,1902136
icdC_predicted,0.09090909090909091,10,10,GTATCCTGTGTGTCATATAA,0,1894864
icdC_predicted,0.09090909090909091,10,10,GTAGTACAGATGTCGATGTT,0,1879935
icdC_predicted,0.09090909090909091,10,10,GTAGGCCGATCTGGATAGCG,0,1896883
icdC_predicted,0.09090909090909091,10,10,GTAGACACATTTATCAGCTA,0,1904432
icdC_predicted,0.09090909090909091,10,10,GGTCGCCACCGTCTTCGGTG,0,1892475
icdC_predicted,0.09090909090909091,10,10,GGTAAAAACCTCGTGATTTG,0,1903371
icdC_predicted,0.09090909090909091,10,10,GGGATCAACCCGCCCCGAAC,0,1895523
icdC_predicted,0.09090909090909091,10,10,GGGATAGCAGCGTACGCAAC,0,1902678
icdC_predicted,0.09090909090909091,10,10,GGCCTGGCATCCACGTGTAA,0,1898415
icdC_predicted,0.09090909090909091,10,10,GGACCAGGTGATACCGGCGG,0,1878378
icdC_predicted,0.09090909090909091,10,10,GCTTGCCCGTTGCACCATTA,0,1902651
icdC_predicted,0.09090909090909091,10,10,GCTGGACGAAATCTCGGTCA,0,1892259
icdC_predicted,0.09090909090909091,10,10,GCTCGTTCGCCCTGCGCGCT,0,1889944
icdC_predicted,0.09090909090909091,10,10,GCGTGCTCAAAACATAGATC,0,1894146
icdC_predicted,0.09090909090909091,10,10,GCGTACATCCGCACCTGTAG,0,1905827
icdC_predicted,0.09090909090909091,10,10,GCGGTAGTGGCTCCTCGCCA,0,1880728
icdC_predicted,0.09090909090909091,10,10,GCGGGGGCCATCTGTGAATG,0,1880502
icdC_predicted,0.09090909090909091,10,10,GCGGCGAAACGCATGAGATA,0,1888996
icdC_predicted,0.09090909090909091,10,10,GCGAGGCCCGTGTGAGTGGA,0,1904774
icdC_predicted,0.09090909090909091,10,10,GCCTCTCAAAACCACCGATT,0,1898918
icdC_predicted,0.09090909090909091,10,10,GCCTCCTAAGTGTCAATGGA,0,1899161
icdC_predicted,0.09090909090909091,10,10,GCCGCACCTGAGAGGTATTC,0,1883360
icdC_predicted,0.09090909090909091,10,10,GCCATAGAGGAACGGATATT,0,1878064
icdC_predicted,0.09090909090909091,10,10,GCATCAACGGAGATATGTCT,0,1887076
icdC_predicted,0.09090909090909091,10,10,GCACACATTTGTGCCCGAGG,0,1883292
icdC_predicted,0.09090909090909091,10,10,GCAAGCTGGATAATGCTAGG,0,1900167
icdC_predicted,0.09090909090909091,10,10,GATTATCCTTAGATTGGAGG,0,1894609
icdC_predicted,0.09090909090909091,10,10,GATGTGAGGGTCACGAAGAG,0,1878157
icdC_predicted,0.09090909090909091,10,10,GATCCCTTGCCCAAGCAGGA,0,1896140
icdC_predicted,0.09090909090909091,10,10,GAGTGAGATCAAAGCAATTA,0,1885090
icdC_predicted,0.09090909090909091,10,10,GAGCCGTCCAGCGTTTCCCG,0,1902715
icdC_predicted,0.09090909090909091,10,10,GAGAGCAAGATAGCGCGGTG,0,1899432
icdC_predicted,0.09090909090909091,10,10,GAGAAAACCACTGGTCGGTT,0,1885336
icdC_predicted,0.09090909090909091,10,10,GACTTTCCTAGTGTACGGGG,0,1898170
icdC_predicted,0.09090909090909091,10,10,GACTCGTGACGACTACGAGA,0,1899605
icdC_predicted,0.09090909090909091,10,10,GACGGGATACGTTGACGACG,0,1890198
icdC_predicted,0.09090909090909091,10,10,GACAGTTTTACTGGGGGTAT,0,1901677
icdC_predicted,0.09090909090909091,10,10,GACACTAAGAACGAGGTGGG,0,1904469
icdC_predicted,0.09090909090909091,10,10,GAATGCCGCTGGCACATATT,0,1878666
icdC_predicted,0.09090909090909091,10,10,GAAGCTGTGCTTTCTTCCGT,0,1877931
icdC_predicted,0.09090909090909091,10,10,GAAGAAAGACCACGGCTTGC,0,1899603
icdC_predicted,0.09090909090909091,10,10,GAACGGATAATGAATATTTA,0,1883604
icdC_predicted,0.09090909090909091,10,10,CTTTGGAAGTTCCTCATACG,0,1883036
icdC_predicted,0.09090909090909091,10,10,CTTTCGGGATTTAAAATCAT,0,1902186
icdC_predicted,0.09090909090909091,10,10,CTTTCAATGCGGTTTCTGTA,0,1884766
icdC_predicted,0.09090909090909091,10,10,CTTCCACATTCCAAACGTAT,0,1894424
icdC_predicted,0.09090909090909091,10,10,CTGTTCTTCAATACTCCTGC,0,1894983
icdC_predicted,0.09090909090909091,10,10,CTGGGACAAGGTGAGGAGGT,0,1906981
icdC_predicted,0.09090909090909091,10,10,CTGCGCCGCACATAGGTGGA,0,1897873
icdC_predicted,0.09090909090909091,10,10,CTGCAAGGATATGACGATTG,0,1883570
icdC_predicted,0.09090909090909091,10,10,CTGATCTGACAAAAACGGCA,0,1889437
icdC_predicted,0.09090909090909091,10,10,CTATTTCATCGCTACGACTT,0,1909258
icdC_predicted,0.09090909090909091,10,10,CTATCACTTGCAGCACTAAA,0,1878681
icdC_predicted,0.09090909090909091,10,10,CTACGGATGGTATAAACATA,0,1881387
icdC_predicted,0.09090909090909091,10,10,CTAAGATTGTCTCACACTAG,0,1878394
icdC_predicted,0.09090909090909091,10,10,CGTTCTGGTAGCCCAACCTA,0,1884257
icdC_predicted,0.09090909090909091,10,10,CGTTATAGGGACGCGTCTGT,0,1896699
icdC_predicted,0.09090909090909091,10,10,CGTGCAGGCACGGCGCCGAA,0,1897679
icdC_predicted,0.09090909090909091,10,10,CGTCTTGCACGAGGGGCGCA,0,1904366
icdC_predicted,0.09090909090909091,10,10,CGTAATCCAAGAGGGGGCCT,0,1908031
icdC_predicted,0.09090909090909091,10,10,CGGTAGTGGGGCCTAGTTTA,0,1887844
icdC_predicted,0.09090909090909091,10,10,CGGCCGGCATTCCGCGGAAC,0,1895334
icdC_predicted,0.09090909090909091,10,10,CGGCCCTCTAGGGGGGGAAA,0,1890286
icdC_predicted,0.09090909090909091,10,10,CGGACACTATCTGAGTGACT,0,1889071
icdC_predicted,0.09090909090909091,10,10,CGGACACAATGCTGGCCGTC,0,1881371
icdC_predicted,0.09090909090909091,10,10,CGCTTGGCCAAGTAATATCT,0,1909064
icdC_predicted,0.09090909090909091,10,10,CGCTCAAGGCCTGTGCCTGA,0,1881689
icdC_predicted,0.09090909090909091,10,10,CGCGAATTGTCATTTAGCTA,0,1886461
icdC_predicted,0.09090909090909091,10,10,CGCACTGCTCGTGGCATCTA,0,1888174
icdC_predicted,0.09090909090909091,10,10,CGAATGCGCAAGACTTGATT,0,1895809
icdC_predicted,0.09090909090909091,10,10,CGAAGGCATACACCGCATTA,0,1878730
icdC_predicted,0.09090909090909091,10,10,CCTGGTCATCGCCTCCGCAC,0,1898374
icdC_predicted,0.09090909090909091,10,10,CCGTGTGTAGGGTGATATCT,0,1902109
icdC_predicted,0.09090909090909091,10,10,CCGTGCGCGAGTTTCGTTGA,0,1898505
icdC_predicted,0.09090909090909091,10,10,CCGGCGCCCGTCTGTAGGTA,0,1891508
icdC_predicted,0.09090909090909091,10,10,CCCTCCGGATTGCGGGTGCG,0,1894914
icdC_predicted,0.09090909090909091,10,10,CCCAGCCGGAGCCCGCATAA,0,1904035
icdC_predicted,0.09090909090909091,10,10,CCAGCTCCGGCTACGGTGAC,0,1902954
icdC_predicted,0.09090909090909091,10,10,CCAATTATACAGAGTCTGAA,0,1905000
icdC_predicted,0.09090909090909091,10,10,CCAACTTAAAGTCGCGTCAA,0,1909077
icdC_predicted,0.09090909090909091,10,10,CCAAAGGCTGCGTTTTTACC,0,1907761
icdC_predicted,0.09090909090909091,10,10,CATTTATTGAGTATCGTACG,0,1880682
icdC_predicted,0.09090909090909091,10,10,CATTCTACGGGAGCTACACA,0,1900407
icdC_predicted,0.09090909090909091,10,10,CATTCATTAAGTGTCATGCG,0,1893334
icdC_predicted,0.09090909090909091,10,10,CATGTGTTCAAGCCAGCACT,0,1901450
icdC_predicted,0.09090909090909091,10,10,CAGTACGTTCGAGGAACCGT,0,1884481
icdC_predicted,0.09090909090909091,10,10,CAGATCTCTATACTAATCCT,0,1900224
icdC_predicted,0.09090909090909091,10,10,CACGGTAAGTGCCGGCCCAC,0,1905040
icdC_predicted,0.09090909090909091,10,10,CACCGACGCCAAGTAATCTT,0,1897923
icdC_predicted,0.09090909090909091,10,10,CAATTTCTCACCAATGAAGT,0,1905294
icdC_predicted,0.09090909090909091,10,10,CAATGTACGGCCTTCCGGAA,0,1906547
icdC_predicted,0.09090909090909091,10,10,CAATCGTTGTCGGCGTAAGG,0,1894901
icdC_predicted,0.09090909090909091,10,10,CAAGAAAGTGTTTATCTTTT,0,1882904
icdC_predicted,0.09090909090909091,10,10,CAACACCAGTCCTTTAGGTC,0,1889957
icdC_predicted,0.09090909090909091,10,10,CAAATCTTAAATTTTCCTAA,0,1905679
icdC_predicted,0.09090909090909091,10,10,ATTCCCTGACATGCTAACAT,0,1883208
icdC_predicted,0.09090909090909091,10,10,ATTCACGGCACGGCCCAGGG,0,1889149
icdC_predicted,0.09090909090909091,10,10,ATTACCGCACTTCGACTCCA,0,1905838
icdC_predicted,0.09090909090909091,10,10,ATGTATCGCTAGTAATTAAC,0,1886673
icdC_predicted,0.09090909090909091,10,10,ATGAGGTTGTAACGTCCCAT,0,1880675
icdC_predicted,0.09090909090909091,10,10,ATCGTCCGTCAACACCCTGA,0,1883325
icdC_predicted,0.09090909090909091,10,10,ATCCCTATGTAGTGTCAAAC,0,1882898
icdC_predicted,0.09090909090909091,10,10,ATAGTAAAACGATTTTTCGT,0,1906445
icdC_predicted,0.09090909090909091,10,10,ATAGAGGGCGAGATGCTTAA,0,1896217
icdC_predicted,0.09090909090909091,10,10,ATAGAAAAGTGTCCCGCCGT,0,1884060
icdC_predicted,0.09090909090909091,10,10,ATACCGCTCACAGGACTTCG,0,1898427
icdC_predicted,0.09090909090909091,10,10,AGTGATAAGATCTGCTAGAT,0,1902523
icdC_predicted,0.09090909090909091,10,10,AGTCGGAAATTAGGCTCTTA,0,1898633
icdC_predicted,0.09090909090909091,10,10,AGTAAGTTTCCCAGCCGATA,0,1905069
icdC_predicted,0.09090909090909091,10,10,AGGTGTCGCGACCTGCTAAG,0,1878090
icdC_predicted,0.09090909090909091,10,10,AGGTACGTGCCTGTCTGTTA,0,1893349
icdC_predicted,0.09090909090909091,10,10,AGCTTGTCGCGTCCTCATGT,0,1882088
icdC_predicted,0.09090909090909091,10,10,AGCTATCTAGGGACATAACA,0,1882516
icdC_predicted,0.09090909090909091,10,10,AGATTAGACACCCCGCTCTT,0,1904026
icdC_predicted,0.09090909090909091,10,10,ACTTGTGGAGAATGATAGAA,0,1881805
icdC_predicted,0.09090909090909091,10,10,ACTTAGATTCGCATGCCGCG,0,1908765
icdC_predicted,0.09090909090909091,10,10,ACTGGTATACATAGCATGGA,0,1893405
icdC_predicted,0.09090909090909091,10,10,ACTGATCAACATCTGTGTAC,0,1892533
icdC_predicted,0.09090909090909091,10,10,ACGGTTTGGCGTAGGTATTG,0,1896659
icdC_predicted,0.09090909090909091,10,10,ACGGTGGCCTCTATATGGAG,0,1884159
icdC_predicted,0.09090909090909091,10,10,ACGGGACCTAAAGCATCTCC,0,1889886
icdC_predicted,0.09090909090909091,10,10,ACCGATGTTATACACTTATC,0,1906158
icdC_predicted,0.09090909090909091,10,10,ACCCATTGGGTCTCTCGGCA,0,1896402
icdC_predicted,0.09090909090909091,10,10,ACAGAAATGCCCTGGTGGAC,0,1886976
icdC_predicted,0.09090909090909091,10,10,ACACTGGCCGCCGGGCTTAG,0,1898245
icdC_predicted,0.09090909090909091,10,10,ACACCTTTCTACGGGAGGAT,0,1895549
icdC_predicted,0.09090909090909091,10,10,AATCCCTCTCATCGAAAAGA,0,1894915
icdC_predicted,0.09090909090909091,10,10,AATATCATTGTCCCGTCATG,0,1896580
icdC_predicted,0.09090909090909091,10,10,AATAAGTTCACCTACCCTCG,0,1878022
icdC_predicted,0.09090909090909091,10,10,AAGTCAGCACTGGCGGGCAA,0,1888748
icdC_predicted,0.09090909090909091,10,10,AACTCGGACCTTGCGTATAG,0,1878756
icdC_predicted,0.09090909090909091,10,10,AACGCGCTCGCTAAGGGGAA,0,1904403
icdC_predicted,0.09090909090909091,10,10,AACGCGCGGGTCTCATAGTG,0,1883110
icdC_predicted,0.09090909090909091,10,10,AACACACGTGGCGAGACCTC,0,1900837
icdC_predicted,0.09090909090909091,10,10,AAAGGTTTGGCTGGACGTCG,0,1894012
icdC_predicted,0.09090909090909091,10,10,AAAGGTGGTGCTGCCGGCCC,0,1882693
icdC_predicted,0.09090909090909091,10,10,AAAGATTGCGCGAGCCAATC,0,1901138
icdC_predicted,0.09090909090909091,10,10,AAAATTAGGTCCAGCAAATG,0,1884357
icdC_predicted,0.1,9,9,TTTTGTATGTGGGAATAAGA,0,1909003
icdC_predicted,0.1,9,9,TTTAGCCATCTCCGCTGCAA,0,1901461
icdC_predicted,0.1,9,9,TTGGTGTATGAACGCCAATC,0,1903562
icdC_predicted,0.1,9,9,TTGCAAGGGGGCGAACACTT,0,1887811
icdC_predicted,0.1,9,9,TTCGAGCACCGTGCGAATGT,0,1883962
icdC_predicted,0.1,9,9,TTCCTCGTTCTAAAAGGACC,0,1903296
icdC_predicted,0.1,9,9,TTCAACGCCTACTGGTTACG,0,1897464
icdC_predicted,0.1,9,9,TTATGTAAAGTATACAGGGC,0,1908470
icdC_predicted,0.1,9,9,TTATAGTAGTATGCTTTCTC,0,1902647
icdC_predicted,0.1,9,9,TTAGGGATTTACTGACGAGA,0,1884455
icdC_predicted,0.1,9,9,TTAATGTATCTGTCTTTGGT,0,1891382
icdC_predicted,0.1,9,9,TTAATCCGTTTTTAGGGACA,0,1895388
icdC_predicted,0.1,9,9,TTAAGGGGTCTCGGATTCGC,0,1903610
icdC_predicted,0.1,9,9,TGTGGACCCGTAATTGCAAA,0,1900490
icdC_predicted,0.1,9,9,TGTCCGGGCGGTATATACAG,0,1898506
icdC_predicted,0.1,9,9,TGTCCAACGGTTATGTGGCC,0,1882392
icdC_predicted,0.1,9,9,TGTAGGGGGCACCCGAGATG,0,1886541
icdC_predicted,0.1,9,9,TGGTGTCCGCCAATGCTAAA,0,1878791
icdC_predicted,0.1,9,9,TGGTGAGAGGCATCGCTAAA,0,1907759
icdC_predicted,0.1,9,9,TGGGCATTGGCCATAATCGC,0,1890896
icdC_predicted,0.1,9,9,TGGAATGGTTTGCATTACTG,0,1898229
icdC_predicted,0.1,9,9,TGCTAGGGCAGAGCACCGCA,0,1901237
icdC_predicted,0.1,9,9,TGCATGCCGTTCCAACAATC,0,1907016
icdC_predicted,0.1,9,9,TGCATCGGTCCACTCACGCG,0,1886425
icdC_predicted,0.1,9,9,TGCATCGGGGACATCATTGT,0,1908502
icdC_predicted,0.1,9,9,TGATAATAAACCGCAACGCT,0,1899684
icdC_predicted,0.1,9,9,TGAGAATGACCCCATTGATA,0,1906476
icdC_predicted,0.1,9,9,TGACGAACAGCTATGTTGCA,0,1900589
icdC_predicted,0.1,9,9,TGAATCATAACGCAGCACGA,0,1879591
icdC_predicted,0.1,9,9,TGAATATTAGACCACGAACA,0,1907302
icdC_predicted,0.1,9,9,TGAAGTACGCAACCGCGCGG,0,1904289
icdC_predicted,0.1,9,9,TGAAAACAAAATGTGGATCT,0,1883659
icdC_predicted,0.1,9,9,TCTTTTAAAGCCGGTCTTAG,0,1884051
icdC_predicted,0.1,9,9,TCTGGTTTTCACGCTCCGAT,0,1907985
icdC_predicted,0.1,9,9,TCGTTCGTAACATATGTATG,0,1903474
icdC_predicted,0.1,9,9,TCGGGTCACCAGTCTATAGG,0,1900073
icdC_predicted,0.1,9,9,TCGACGTGACGTAATATATT,0,1903470
icdC_predicted,0.1,9,9,TCCTTTTGGTCTAATGGCAG,0,1879891
icdC_predicted,0.1,9,9,TCCTTCGCGGTCTGGGATAA,0,1893729
icdC_predicted,0.1,9,9,TCCTGAGAACAATTACGGTT,0,1892215
icdC_predicted,0.1,9,9,TCCTATAAAAGTTTTCGTCG,0,1907817
icdC_predicted,0.1,9,9,TCCCGGATACTGCGGAGTCC,0,1904029
icdC_predicted,0.1,9,9,TCACCTCAAATAAGGGATAA,0,1888448
icdC_predicted,0.1,9,9,TCACCTACATCCTGAGGCAG,0,1883084
icdC_predicted,0.1,9,9,TCACCGGGTTGATGCTAGCC,0,1887364
icdC_predicted,0.1,9,9,TCACATTGCAGTGAGAGCTA,0,1887769
icdC_predicted,0.1,9,9,TCAATACGGCGCGGAAATTC,0,1878259
icdC_predicted,0.1,9,9,TATCGTGTGGGTACGGCAAC,0,1885000
icdC_predicted,0.1,9,9,TAGGTAACTATTCCCGCTCT,0,1885550
icdC_predicted,0.1,9,9,TAGGGGCTGAGCCCGTCCTA,0,1906631
icdC_predicted,0.1,9,9,TAGGCCTAATCGGTTTTAGA,0,1901457
icdC_predicted,0.1,9,9,TAGGCACAGGGTATTGTTCA,0,1892766
icdC_predicted,0.1,9,9,TAGCTAAGCAGCGCCCTTAC,0,1881682
icdC_predicted,0.1,9,9,TAGCCACACTTGGTCAAGCT,0,1884880
icdC_predicted,0.1,9,9,TAGAACGCGTGGTAGGTATG,0,1905315
icdC_predicted,0.1,9,9,TACCTTTAACGAGTCTGAAG,0,1901853
icdC_predicted,0.1,9,9,TACCAGTCGGCTTAATTTTG,0,1885229
icdC_predicted,0.1,9,9,TAATTTCCTACCAGAACTGA,0,1879711
icdC_predicted,0.1,9,9,TAATTAATCCGTTGGTCAAG,0,1888420
icdC_predicted,0.1,9,9,TAATAGATCCGATTGATCGG,0,1880763
icdC_predicted,0.1,9,9,TAAGTTGTAGAGTAAGGCTA,0,1906860
icdC_predicted,0.1,9,9,TAAATGTAAGGTTTAGCAAC,0,1897126
icdC_predicted,0.1,9,9,GTTGGGGGTCTCGAACTTTA,0,1895717
icdC_predicted,0.1,9,9,GTTGCCTCCGAGTTACAGAT,0,1904524
icdC_predicted,0.1,9,9,GTTCGTCATGCAAGGTACAT,0,1899220
icdC_predicted,0.1,9,9,GTTACTGAGGATGCTTATTG,0,1888044
icdC_predicted,0.1,9,9,GTGGGACACCGGGTTTGGGA,0,1904114
icdC_predicted,0.1,9,9,GTGCAAGAACGATACCAATT,0,1891419
icdC_predicted,0.1,9,9,GTGATATGGTGACGATAAGG,0,1895660
icdC_predicted,0.1,9,9,GTCTGATCATTCAGTTACGT,0,1889722
icdC_predicted,0.1,9,9,GTCAGGACACGCGACCATAT,0,1894432
icdC_predicted,0.1,9,9,GTATACTGGGTCCAAATGGC,0,1905160
icdC_predicted,0.1,9,9,GTAGCAATCTTGCTCATCCA,0,1884312
icdC_predicted,0.1,9,9,GTACATTTAGCCTATAACTA,0,1905343
icdC_predicted,0.1,9,9,GTAATTCTTCCACGAAAGAC,0,1878264
icdC_predicted,0.1,9,9,GTAAGTTCGATATAGGAGGT,0,1892909
icdC_predicted,0.1,9,9,GTAACCTATCGTCACAGTGG,0,1896798
icdC_predicted,0.1,9,9,GGTTGGGTTACCGGAGTCAA,0,1880348
icdC_predicted,0.1,9,9,GGTTGGGTAATATTTTTAAG,0,1890929
icdC_predicted,0.1,9,9,GGTTCTAAGCTTGGGAGGAT,0,1879434
icdC_predicted,0.1,9,9,GGTGGGTCATTAGGTCCCAT,0,1909436
icdC_predicted,0.1,9,9,GGTAGCGATTCCCGTGGCTA,0,1889793
icdC_predicted,0.1,9,9,GGTAACCCCACTTTGCTTAT,0,1883845
icdC_predicted,0.1,9,9,GGGTAGTCTACGGTCGCTCA,0,1901501
icdC_predicted,0.1,9,9,GGGGGCAGGTGCACAACGGT,0,1897812
icdC_predicted,0.1,9,9,GGGGCCAACGCGGATCTGAA,0,1893694
icdC_predicted,0.1,9,9,GGGGCACGATTTACCGAACT,0,1885719
icdC_predicted,0.1,9,9,GGGGACACAGCTGGTAACTT,0,1883835
icdC_predicted,0.1,9,9,GGGCAGTCAAACGTCCCGAT,0,1907577
icdC_predicted,0.1,9,9,GGGCACGAGTAATAAAGGGG,0,1878928
icdC_predicted,0.1,9,9,GGGAAGCGCTTAGTGGTTTG,0,1890701
icdC_predicted,0.1,9,9,GCTGTCCACAAGTTACACTC,0,1887871
icdC_predicted,0.1,9,9,GCTGAGGAGTGATTTGTGTA,0,1899389
icdC_predicted,0.1,9,9,GCTGAGGAGAACTGCTGCAT,0,1905317
icdC_predicted,0.1,9,9,GCTCAGGCCGGGCGACGCTC,0,1906239
icdC_predicted,0.1,9,9,GCTAACTTGAAGGGTTAATA,0,1901366
icdC_predicted,0.1,9,9,GCGGTTACCTCCGAGCAAAT,0,1880588
icdC_predicted,0.1,9,9,GCGCAAAATGTTCCTCTGGA,0,1908036
icdC_predicted,0.1,9,9,GCGAGGGAGAAGACTCCAGT,0,1888254
icdC_predicted,0.1,9,9,GCCGTCTATTTCTAGTTGAC,0,1892232
icdC_predicted,0.1,9,9,GCCAAGTTAACCTGGGCATG,0,1891006
icdC_predicted,0.1,9,9,GCATTGTAATGATTATTCAG,0,1883997
icdC_predicted,0.1,9,9,GCATAGTCAAACTTGGTTTA,0,1893238
icdC_predicted,0.1,9,9,GCACGCCACAGGCCAGATAC,0,1878987
icdC_predicted,0.1,9,9,GCAATCCATCTATTGGTGAC,0,1891743
icdC_predicted,0.1,9,9,GCAACACACTCCTGGTAAAC,0,1895917
icdC_predicted,0.1,9,9,GATTCATGGCGTATTGCGAA,0,1888749
icdC_predicted,0.1,9,9,GAGTTCGCTCGGCCGCAGCT,0,1887707
icdC_predicted,0.1,9,9,GAGCGTCCTTGTCACTATCA,0,1901854
icdC_predicted,0.1,9,9,GAGCGCCAGCAGTGCCTTTC,0,1885140
icdC_predicted,0.1,9,9,GAGAGACTGAGGTCACTAGT,0,1884379
icdC_predicted,0.1,9,9,GACTCTGCGTATATACAAGA,0,1903196
icdC_predicted,0.1,9,9,GACGATTTGTTTTCTACACT,0,1906785
icdC_predicted,0.1,9,9,GACCTACCGCGAAGGAACAA,0,1880529
icdC_predicted,0.1,9,9,GACCGAGTAGCGAACACGCT,0,1885758
icdC_predicted,0.1,9,9,GACATTTAAACAACGTAGTC,0,1906028
icdC_predicted,0.1,9,9,GAAGTGTGGCGCTTCAGATA,0,1896582
icdC_predicted,0.1,9,9,GAAGCTCAAACTCGGTACCC,0,1883244
icdC_predicted,0.1,9,9,GAACAGGAAGGTCTGTCAAA,0,1894964
icdC_predicted,0.1,9,9,CTTGGTGTTCTCCGTTCCGT,0,1898143
icdC_predicted,0.1,9,9,CTTCGTGGCTCATGAGAGCA,0,1901166
icdC_predicted,0.1,9,9,CTTCCCCGCTCGCGTGCAGG,0,1905398
icdC_predicted,0.1,9,9,CTTATGCTGAGCGCGGATAT,0,1886423
icdC_predicted,0.1,9,9,CTGGTCCCAGAGATTCCACT,0,1894590
icdC_predicted,0.1,9,9,CTGGGCTGCTTCACTGAATC,0,1893287
icdC_predicted,0.1,9,9,CTGGCTCTCGTGAAGGCGTG,0,1881692
icdC_predicted,0.1,9,9,CTCGCGGAAATACGTTCCTT,0,1889027
icdC_predicted,0.1,9,9,CTCAGTGTTTTATGCAACGG,0,1894966
icdC_predicted,0.1,9,9,CTCAGAGGCTTTGCATGCGC,0,1907272
icdC_predicted,0.1,9,9,CTATCCTGTAGGTAGATCTT,0,1906242
icdC_predicted,0.1,9,9,CTAGACCCTTGAGTTCAGCT,0,1893174
icdC_predicted,0.1,9,9,CTACTTAAGGTGCATTCAGA,0,1891294
icdC_predicted,0.1,9,9,CTACGTGAGGTGTCCAGCGG,0,1878319
icdC_predicted,0.1,9,9,CTACCGGTGGCAGAGGCATT,0,1882566
icdC_predicted,0.1,9,9,CGTTTTCATATTAAAATGAA,0,1897453
icdC_predicted,0.1,9,9,CGTTTCGGCCACTCGCGAGT,0,1884403
icdC_predicted,0.1,9,9,CGTTCCCACCCGTTTAATCA,0,1897835
icdC_predicted,0.1,9,9,CGTGCTCTCGTCCCAAGTAT,0,1888431
icdC_predicted,0.1,9,9,CGTATACGATTATAGACGAT,0,1899185
icdC_predicted,0.1,9,9,CGTACTGGCACCGGGAGTGC,0,1899959
icdC_predicted,0.1,9,9,CGTAATCAATTGATTCGGTC,0,1883987
icdC_predicted,0.1,9,9,CGGTATGATTCTAAATTGTG,0,1896510
icdC_predicted,0.1,9,9,CGGTAGATGTGCATGGTGAG,0,1899483
icdC_predicted,0.1,9,9,CGGGTCGGACCAGTCTCCAG,0,1891215
icdC_predicted,0.1,9,9,CGGGGTCGCGCGGGGAGTCT,0,1896164
icdC_predicted,0.1,9,9,CGGCTTCTTATGTCTTAACA,0,1906727
icdC_predicted,0.1,9,9,CGGATCGCACATAAATTCTT,0,1902639
icdC_predicted,0.1,9,9,CGCTTTCTACCGAAATGTAC,0,1885468
icdC_predicted,0.1,9,9,CGCGGCGCGTCTTCCTGTTC,0,1883189
icdC_predicted,0.1,9,9,CGCGCCGTTGCGTCACAACT,0,1885182
icdC_predicted,0.1,9,9,CGCCTAACCGACGGACAAGA,0,1878755
icdC_predicted,0.1,9,9,CGCCATGCTGAGTATGCGAA,0,1904104
icdC_predicted,0.1,9,9,CGCAAGTACGCGACGTGAGA,0,1891442
icdC_predicted,0.1,9,9,CGCAACCTGGATTCATCCTA,0,1897285
icdC_predicted,0.1,9,9,CGATGGGTACCTGGGCGTCA,0,1883461
icdC_predicted,0.1,9,9,CGATCCACCGCGTGTACGGG,0,1903912
icdC_predicted,0.1,9,9,CGAATCGGAAGGTTATCCCT,0,1888346
icdC_predicted,0.1,9,9,CCTGGCAGTATTCAGCCCGA,0,1884999
icdC_predicted,0.1,9,9,CCTGAAGCGGTACGGCTATA,0,1896935
icdC_predicted,0.1,9,9,CCTCACAACTCTAGTAAAGA,0,1908904
icdC_predicted,0.1,9,9,CCTACTGTCGAATGTTAGCC,0,1898563
icdC_predicted,0.1,9,9,CCTACGACAACAAATCGCTT,0,1906704
icdC_predicted,0.1,9,9,CCGCTGGATCGGCCAACGTG,0,1890402
icdC_predicted,0.1,9,9,CCCTTTGAGGTAGTATATCC,0,1906325
icdC_predicted,0.1,9,9,CCCGATCTTTGATCATCCCG,0,1895680
icdC_predicted,0.1,9,9,CCCATACGCGTTAGTGAAGT,0,1886108
icdC_predicted,0.1,9,9,CCATGGACCAAGTGGGTCCG,0,1886301
icdC_predicted,0.1,9,9,CCATCAGGCATTGTGGTACG,0,1895035
icdC_predicted,0.1,9,9,CCAGTGCACTGGGTGCCAGT,0,1902891
icdC_predicted,0.1,9,9,CCACTGCTTGCCGACCGATC,0,1880432
icdC_predicted,0.1,9,9,CATTTTGTCTCGATTAGGCA,0,1903213
icdC_predicted,0.1,9,9,CATTGTTATGGTGCCATGAC,0,1901895
icdC_predicted,0.1,9,9,CATTGGAGTTACACGACCAA,0,1886083
icdC_predicted,0.1,9,9,CATGTACATGAAAGTCGAAC,0,1894238
icdC_predicted,0.1,9,9,CATGGTGTCCTCCTGACCAG,0,1882527
icdC_predicted,0.1,9,9,CATCAACTGAACAGCTTGTG,0,1886679
icdC_predicted,0.1,9,9,CATACGGTTACCATCAGTGG,0,1898732
icdC_predicted,0.1,9,9,CAGTAAGTGAAAGTAGTCGC,0,1896215
icdC_predicted,0.1,9,9,CAGTAAGGCGCTTTGGAGGG,0,1900180
icdC_predicted,0.1,9,9,CAGGGGGTTTGGCGCCCTCT,0,1888986
icdC_predicted,0.1,9,9,CAGGAATTTCGGCGTGGTGA,0,1899423
icdC_predicted,0.1,9,9,CACTTGCTGCGGGTTCTCTT,0,1896612
icdC_predicted,0.1,9,9,CACTTAATTTTGAGTGATAC,0,1888445
icdC_predicted,0.1,9,9,CAATTAAAGCTTGGAATGGT,0,1904514
icdC_predicted,0.1,9,9,CAAGGGGTCTGCTAATTGAT,0,1886426
icdC_predicted,0.1,9,9,CAAGCTCGGCAGAACAAACC,0,1885203
icdC_predicted,0.1,9,9,CAAGCGTATATTACCGTGTC,0,1891347
icdC_predicted,0.1,9,9,CAACGCCAAACTAGACTCGC,0,1901996
icdC_predicted,0.1,9,9,CAAATGCCAGGTTCATTCGT,0,1892900
icdC_predicted,0.1,9,9,ATTTAAGTGGCTATTTCCCT,0,1898860
icdC_predicted,0.1,9,9,ATTCGTTCATCTACGGTGTG,0,1900910
icdC_predicted,0.1,9,9,ATTCGATACATAAGCCACCG,0,1881482
icdC_predicted,0.1,9,9,ATGTTCTGCCGTGGCCCAGC,0,1895882
icdC_predicted,0.1,9,9,ATGGTAAAGGGCAAAAGTCA,0,1894913
icdC_predicted,0.1,9,9,ATGGCCGTGGTTATCGCTCA,0,1892279
icdC_predicted,0.1,9,9,ATGCATTGAATGACCTAGCA,0,1886171
icdC_predicted,0.1,9,9,ATGCATTCGTGCCGGGTGTC,0,1894293
icdC_predicted,0.1,9,9,ATCTTTCTCGACGGGTAGCA,0,1907458
icdC_predicted,0.1,9,9,ATCTTAGGCGGCTAATTGGA,0,1906013
icdC_predicted,0.1,9,9,ATCTCCAAGTTACGTTGGAT,0,1887418
icdC_predicted,0.1,9,9,ATCCACTAACCAATATGACG,0,1885098
icdC_predicted,0.1,9,9,ATAACTTGGTTTCGCTAGTA,0,1883919
icdC_predicted,0.1,9,9,ATAAATTTATAACGCTACTC,0,1894448
icdC_predicted,0.1,9,9,AGTGAGAGGCAGGTCGGCTT,0,1904980
icdC_predicted,0.1,9,9,AGTAACTCGGCTCTCAACTC,0,1892950
icdC_predicted,0.1,9,9,AGGTCCTGTTGAGGCGCGCG,0,1900035
icdC_predicted,0.1,9,9,AGGGTAGCCGGCCAATTGTA,0,1882704
icdC_predicted,0.1,9,9,AGGGCACTCCACTCTGCCCT,0,1881834
icdC_predicted,0.1,9,9,AGGCGTGTCGATTGTGTCTC,0,1894479
icdC_predicted,0.1,9,9,AGCTATAGTGAGTAGGGGTA,0,1905518
icdC_predicted,0.1,9,9,AGCCGTTGATGATACGTACC,0,1887413
icdC_predicted,0.1,9,9,AGCCGCAGCTAAGGCATAAC,0,1903792
icdC_predicted,0.1,9,9,AGCCATTACACTCAGAGGGG,0,1904110
icdC_predicted,0.1,9,9,AGCATCTCTTTACGACTGCG,0,1892948
icdC_predicted,0.1,9,9,AGCAACGGCAGAGACTTAAG,0,1886222
icdC_predicted,0.1,9,9,AGATGATAGATAACAGTCGT,0,1906068
icdC_predicted,0.1,9,9,AGAATTTCGAGAACGCGCAT,0,1907757
icdC_predicted,0.1,9,9,AGAATTCTACAATTTGATTG,0,1905425
icdC_predicted,0.1,9,9,ACTGTTCACCCAGCCCGAAT,0,1897235
icdC_predicted,0.1,9,9,ACTGTGACTTGCATGGGCGA,0,1883705
icdC_predicted,0.1,9,9,ACTCCTGGAACGTATGCTCG,0,1880778
icdC_predicted,0.1,9,9,ACTATTGCCTCCTTCCAGTC,0,1899410
icdC_predicted,0.1,9,9,ACTACACGGCCACGAAATTG,0,1903901
icdC_predicted,0.1,9,9,ACGTTGACATGGGCCTCATA,0,1894910
icdC_predicted,0.1,9,9,ACGTGACGAATGACACGCGG,0,1897943
icdC_predicted,0.1,9,9,ACGCGGAATAGACTGTTGAG,0,1908052
icdC_predicted,0.1,9,9,ACGCCTTAAAAAGAACCAAT,0,1894217
icdC_predicted,0.1,9,9,ACGCCAACGAACTGTCGTCC,0,1894627
icdC_predicted,0.1,9,9,ACGATCTCAGGTTCAGCACT,0,1901282
icdC_predicted,0.1,9,9,ACGAGAGGGCTGGCGCTAGG,0,1888981
icdC_predicted,0.1,9,9,ACCGGTGCTTTGCGTATCTC,0,1894118
icdC_predicted,0.1,9,9,ACCCGAGATATCGAAGTACT,0,1903588
icdC_predicted,0.1,9,9,ACCCCTTGCACCTGGACCTA,0,1905314
icdC_predicted,0.1,9,9,ACATTCGTGTTCAGCTGGCA,0,1882250
icdC_predicted,0.1,9,9,ACACCTCCTGCTATCGTAGT,0,1881905
icdC_predicted,0.1,9,9,ACACCTACGGACTTGGGAAT,0,1908691
icdC_predicted,0.1,9,9,ACACCGTCCTGCTTGGGACT,0,1893251
icdC_predicted,0.1,9,9,AATTCTGGACTTAAACGAGT,0,1880945
icdC_predicted,0.1,9,9,AAGTTATCCGTGTCTCGGAC,0,1882395
icdC_predicted,0.1,9,9,AAGTGATTTTACCGCAAGTG,0,1896282
icdC_predicted,0.1,9,9,AAGGTAAGCGCCACTCGTTC,0,1907126
icdC_predicted,0.1,9,9,AAGACGGGTGCGTATCAGCA,0,1888495
icdC_predicted,0.1,9,9,AACTATAGAGGTGACTTGTT,0,1885571
icdC_predicted,0.1,9,9,AACCGAATATGGGGTCGCTG,0,1901022
icdC_predicted,0.1,9,9,AAATGGTAAGAGTTAGGCGA,0,1882832
icdC_predicted,0.1,9,9,AAAGTCTTATCTACTTCAGG,0,1882394
icdC_predicted,0.1,9,9,AAAGAGGCAGGTCGAGAAAT,0,1885781
icdC_predicted,0.1,9,9,AAAATTCCACAACACTCTAT,0,1887919
icdC_predicted,0.1,9,9,AAAAAGTGGTTCGAGCAGAC,0,1878897
icdC_predicted,0.1111111111111111,8,8,TTTGTCCTCCCGTCACCCAC,0,1908351
icdC_predicted,0.1111111111111111,8,8,TTTCGATCTGACAGCATAGT,0,1891548
icdC_predicted,0.1111111111111111,8,8,TTTCAACAATGCACAAGTGC,0,1900662
icdC_predicted,0.1111111111111111,8,8,TTTCAAAAGTCTGAATGTAT,0,1896412
icdC_predicted,0.1111111111111111,8,8,TTGTGATATTTAGGAGGGCA,0,1897163
icdC_predicted,0.1111111111111111,8,8,TTGTACGTTATTTAGTTTTA,0,1881799
icdC_predicted,0.1111111111111111,8,8,TTGGGGCGGGAGGTTGCAGG,0,1909054
icdC_predicted,0.1111111111111111,8,8,TTGGGCGCCGAAGCGAGTCA,0,1886431
icdC_predicted,0.1111111111111111,8,8,TTGCCTTAAAAACTCAACGC,0,1908134
icdC_predicted,0.1111111111111111,8,8,TTGCCTCAGCGTAGTATTTG,0,1879406
icdC_predicted,0.1111111111111111,8,8,TTGCACGCAGCCTCCATCGC,0,1900311
icdC_predicted,0.1111111111111111,8,8,TTGAGTCCCATTTGGGTTAA,0,1905105
icdC_predicted,0.1111111111111111,8,8,TTGAAGCGTATTTTGCAGTT,0,1905683
icdC_predicted,0.1111111111111111,8,8,TTCTTGTCACCTGGTGCGGC,0,1882960
icdC_predicted,0.1111111111111111,8,8,TTCTACGGAATTCGTGTTAC,0,1897891
icdC_predicted,0.1111111111111111,8,8,TTCGGTTCAGACATTGAAGT,0,1889155
icdC_predicted,0.1111111111111111,8,8,TTCGATACTTTGGTCGCAAG,0,1884418
icdC_predicted,0.1111111111111111,8,8,TTCCTGGGCGAGACCATCAG,0,1899288
icdC_predicted,0.1111111111111111,8,8,TTCCGTGCCTGCCTGGAAGC,0,1884085
icdC_predicted,0.1111111111111111,8,8,TTCATCTTGGTCCCTCGCCT,0,1877993
icdC_predicted,0.1111111111111111,8,8,TTATGTATTTTCTACGTCAA,0,1903564
icdC_predicted,0.1111111111111111,8,8,TTAGGGTACCCAATAAATGT,0,1909102
icdC_predicted,0.1111111111111111,8,8,TTAGGGGCACCATTCTAATC,0,1899892
icdC_predicted,0.1111111111111111,8,8,TTACGTTTCCTGCGCGCGGC,0,1908234
icdC_predicted,0.1111111111111111,8,8,TTACATCCTTTTCAAGGGCT,0,1889264
icdC_predicted,0.1111111111111111,8,8,TTAATTCTTTAAATCGTGCT,0,1893209
icdC_predicted,0.1111111111111111,8,8,TTAATAACTCCACGTCCCTT,0,1879443
icdC_predicted,0.1111111111111111,8,8,TGTTTTTGTTTAGGATCCAA,0,1901227
icdC_predicted,0.1111111111111111,8,8,TGTTGATATGATCGGGAAAC,0,1887235
icdC_predicted,0.1111111111111111,8,8,TGTTCTATGAAGTTGTCTCT,0,1886929
icdC_predicted,0.1111111111111111,8,8,TGTGCCAGGTGTTCAGATGT,0,1881017
icdC_predicted,0.1111111111111111,8,8,TGTCTTTCTAGAATAGTGTC,0,1886365
icdC_predicted,0.1111111111111111,8,8,TGTAGATGGTTGTCCGGTGC,0,1902013
icdC_predicted,0.1111111111111111,8,8,TGTAAGTGTTCCCGTAAAGG,0,1907574
icdC_predicted,0.1111111111111111,8,8,TGGTGGCGATAGCTTGCGAT,0,1882101
icdC_predicted,0.1111111111111111,8,8,TGCGGGGTTATCCCGCTGAC,0,1880503
icdC_predicted,0.1111111111111111,8,8,TGCCCTTTTCTGCATTCCCC,0,1887236
icdC_predicted,0.1111111111111111,8,8,TGCAGATTACTCCGTGCGAG,0,1894921
icdC_predicted,0.1111111111111111,8,8,TGCAGAGGCGATTAGGGTAG,0,1899223
icdC_predicted,0.1111111111111111,8,8,TGATCAACCGAGTCAATGAA,0,1889822
icdC_predicted,0.1111111111111111,8,8,TGACTTCTTACACCGGGTAC,0,1882028
icdC_predicted,0.1111111111111111,8,8,TGACTTAGCTGGTGGGGCAT,0,1883427
icdC_predicted,0.1111111111111111,8,8,TGAATACAGATTTATGTAGA,0,1880914
icdC_predicted,0.1111111111111111,8,8,TGAAAAAATGCTTGCAAGGG,0,1881878
icdC_predicted,0.1111111111111111,8,8,TCTTAGGACAGAAGAAAGGG,0,1889011
icdC_predicted,0.1111111111111111,8,8,TCGTTCCCGGCTGGCTTCCC,0,1899778
icdC_predicted,0.1111111111111111,8,8,TCGTCAATAATAACGGACTA,0,1891016
icdC_predicted,0.1111111111111111,8,8,TCGGCACGCTGGATATTGAC,0,1886565
icdC_predicted,0.1111111111111111,8,8,TCGCGTAAAGCCTTTCGTAC,0,1878332
icdC_predicted,0.1111111111111111,8,8,TCGCATCGGACCCCCGCTGT,0,1890076
icdC_predicted,0.1111111111111111,8,8,TCGACTCATGAATCGTACCA,0,1885263
icdC_predicted,0.1111111111111111,8,8,TCGACCGGTTTGAGCACATC,0,1878429
icdC_predicted,0.1111111111111111,8,8,TCGAAGTCCAGAGGCCGACA,0,1890901
icdC_predicted,0.1111111111111111,8,8,TCCGTGGTATTCATAGCCTC,0,1880795
icdC_predicted,0.1111111111111111,8,8,TATTGCTCGAGGCAGAGCCT,0,1887414
icdC_predicted,0.1111111111111111,8,8,TATGCCCTGCAACGAACAGC,0,1904096
icdC_predicted,0.1111111111111111,8,8,TATCTGCGCGGCCAGGCCTT,0,1900436
icdC_predicted,0.1111111111111111,8,8,TATAGGAGCTCCGCACTTCA,0,1879159
icdC_predicted,0.1111111111111111,8,8,TATAGGAAAGCGATGAGGAA,0,1896388
icdC_predicted,0.1111111111111111,8,8,TATACCTCTTGCTGTAGTAT,0,1888151
icdC_predicted,0.1111111111111111,8,8,TAGGATACCTCCTGTGTCCC,0,1889458
icdC_predicted,0.1111111111111111,8,8,TAGAGCACCGGCATTCGCGG,0,1895658
icdC_predicted,0.1111111111111111,8,8,TAGAATATGGTTTCATCTGG,0,1905963
icdC_predicted,0.1111111111111111,8,8,TACTACATCTTGTACAAACA,0,1905602
icdC_predicted,0.1111111111111111,8,8,TACCATTGCTGCGAAGGTCA,0,1888637
icdC_predicted,0.1111111111111111,8,8,TACAGTGGAACGGTCAACTT,0,1894107
icdC_predicted,0.1111111111111111,8,8,TACACATCTCCGACATCTGA,0,1895327
icdC_predicted,0.1111111111111111,8,8,TAATCCGGTGTAAACCTCTC,0,1898202
icdC_predicted,0.1111111111111111,8,8,TAATCACCTCTACTTGGAAA,0,1904779
icdC_predicted,0.1111111111111111,8,8,TAACGGTTATAAGTAAACGG,0,1897811
icdC_predicted,0.1111111111111111,8,8,TAACCAACTCGGGGGCGAAG,0,1883042
icdC_predicted,0.1111111111111111,8,8,TAAACGATCGTTGGTATGAT,0,1885668
icdC_predicted,0.1111111111111111,8,8,GTTTGTACAGCCCAGCCCCT,0,1909257
icdC_predicted,0.1111111111111111,8,8,GTTTACTTCAGAGGGCGCAG,0,1891501
icdC_predicted,0.1111111111111111,8,8,GTTGTGGATGGGCTAGGCAT,0,1904824
icdC_predicted,0.1111111111111111,8,8,GTTGTACCCAGGTACCCCAG,0,1901219
icdC_predicted,0.1111111111111111,8,8,GTGGGACCATCACACGCGTA,0,1898167
icdC_predicted,0.1111111111111111,8,8,GTGCGCCGGATAAATTATTA,0,1907201
icdC_predicted,0.1111111111111111,8,8,GTGCGACGCTCCCCCGCGAC,0,1884910
icdC_predicted,0.1111111111111111,8,8,GTCTATGTAAGCCTCCCCAC,0,1887253
icdC_predicted,0.1111111111111111,8,8,GTCCCCGTGCTCGCTGTGGT,0,1892604
icdC_predicted,0.1111111111111111,8,8,GTCCCATTGACACCCGAGGA,0,1903242
icdC_predicted,0.1111111111111111,8,8,GTCATGTTTTTTTACCCTAG,0,1904381
icdC_predicted,0.1111111111111111,8,8,GTATGGACTGTAGTTGTTCG,0,1892496
icdC_predicted,0.1111111111111111,8,8,GTACGGACAGGCATGGGCTT,0,1894459
icdC_predicted,0.1111111111111111,8,8,GTACATCGCCCATTGATCGA,0,1890813
icdC_predicted,0.1111111111111111,8,8,GTAACGCATGCGGGGCACCA,0,1900569
icdC_predicted,0.1111111111111111,8,8,GTAAAAAAACGGCTCGCCCC,0,1879442
icdC_predicted,0.1111111111111111,8,8,GGTCTATTCTCTCCGGGAGG,0,1907105
icdC_predicted,0.1111111111111111,8,8,GGTCGTCACGCGTACTCCGA,0,1885888
icdC_predicted,0.1111111111111111,8,8,GGTATATATGTGCCGAAAGA,0,1902964
icdC_predicted,0.1111111111111111,8,8,GGGCATGAGGTATTCACATA,0,1895367
icdC_predicted,0.1111111111111111,8,8,GGGATCCCCAGCGAGTTAAC,0,1878674
icdC_predicted,0.1111111111111111,8,8,GGCTTTAGTCGCGGTGTTAA,0,1905984
icdC_predicted,0.1111111111111111,8,8,GGCGTCAAATCGGACAATTT,0,1901513
icdC_predicted,0.1111111111111111,8,8,GGCGGTAGTTTTCACAGGAG,0,1898865
icdC_predicted,0.1111111111111111,8,8,GGATCAGGCATCTTATTTGC,0,1903054
icdC_predicted,0.1111111111111111,8,8,GGATATTTTCGCAATACCCG,0,1888482
icdC_predicted,0.1111111111111111,8,8,GGACGCTGTGGGGATATCAG,0,1879634
icdC_predicted,0.1111111111111111,8,8,GGAAACTCTGTGTCTTAAGT,0,1883395
icdC_predicted,0.1111111111111111,8,8,GCTTCACAAAGCGTAGGGAG,0,1896752
icdC_predicted,0.1111111111111111,8,8,GCTGGTCGCCTCTAAGGTAC,0,1901408
icdC_predicted,0.1111111111111111,8,8,GCTGGAAGGCTAACACACTG,0,1895685
icdC_predicted,0.1111111111111111,8,8,GCTGATTCCTCAGTCCAGGA,0,1902649
icdC_predicted,0.1111111111111111,8,8,GCTGACAAAAGGCGCTAGTT,0,1900766
icdC_predicted,0.1111111111111111,8,8,GCTATGGTATGCGGTTCTGC,0,1891865
icdC_predicted,0.1111111111111111,8,8,GCGTTAATGTTTCAAGGTTG,0,1899240
icdC_predicted,0.1111111111111111,8,8,GCGGTCAAATGATGGTTCAG,0,1884668
icdC_predicted,0.1111111111111111,8,8,GCGCACCATCACGGCTACAC,0,1905249
icdC_predicted,0.1111111111111111,8,8,GCGCAACAGCGGTCAGGTTA,0,1895683
icdC_predicted,0.1111111111111111,8,8,GCCTACTAGATGCATCCGTC,0,1903917
icdC_predicted,0.1111111111111111,8,8,GCCTAAGGTAGTATGGGCAG,0,1904562
icdC_predicted,0.1111111111111111,8,8,GCATCCCCCGGGGCTGCCTG,0,1885521
icdC_predicted,0.1111111111111111,8,8,GCATCACGCCTCTGGAAAGG,0,1900709
icdC_predicted,0.1111111111111111,8,8,GCATATCTAGGGTTTCTCTT,0,1896426
icdC_predicted,0.1111111111111111,8,8,GCACGAATGAATGTAGTGCG,0,1886763
icdC_predicted,0.1111111111111111,8,8,GCACAAAGGAGCGTGCGCTG,0,1902432
icdC_predicted,0.1111111111111111,8,8,GATTTATTTCTGCAGACCGT,0,1893600
icdC_predicted,0.1111111111111111,8,8,GATGGTCGAATTGCATTAGT,0,1891769
icdC_predicted,0.1111111111111111,8,8,GATGCGTACGCAGAACACAT,0,1892517
icdC_predicted,0.1111111111111111,8,8,GATGCCTTCTATCGGTTCTA,0,1898938
icdC_predicted,0.1111111111111111,8,8,GATCTTTTTCGCTTGCCTTA,0,1906679
icdC_predicted,0.1111111111111111,8,8,GATCTGGACAGCGCGCTTGT,0,1906088
icdC_predicted,0.1111111111111111,8,8,GATCAGCTCACCCGGACAAT,0,1890411
icdC_predicted,0.1111111111111111,8,8,GATATTACGGGATGATTGGC,0,1883350
icdC_predicted,0.1111111111111111,8,8,GAGCTCGGCTTCGATCTTGG,0,1907768
icdC_predicted,0.1111111111111111,8,8,GAGCACTTTATACAGGGCTC,0,1900009
icdC_predicted,0.1111111111111111,8,8,GAGATGTCGCGGGATTGTAG,0,1878736
icdC_predicted,0.1111111111111111,8,8,GACTGCAAGCATTTTTGTAT,0,1891650
icdC_predicted,0.1111111111111111,8,8,GACGGAAAGATCAAGAAACT,0,1905303
icdC_predicted,0.1111111111111111,8,8,GACCCAGTTGCCTGAGATGC,0,1891393
icdC_predicted,0.1111111111111111,8,8,GACAGTTGAGTCGGCTTTGT,0,1889610
icdC_predicted,0.1111111111111111,8,8,GACAGGTCGGAACTTTGTAA,0,1883488
icdC_predicted,0.1111111111111111,8,8,GACAGGGTGGTTGTTTGAGT,0,1890440
icdC_predicted,0.1111111111111111,8,8,GACAGAGCAGGCGCGCTGTG,0,1894150
icdC_predicted,0.1111111111111111,8,8,GAAGGTAGGCGGGGAGACCT,0,1885261
icdC_predicted,0.1111111111111111,8,8,GAACGAAACGAGCACCAGTT,0,1887160
icdC_predicted,0.1111111111111111,8,8,GAAAAGGTCTTGGTATGGGT,0,1897382
icdC_predicted,0.1111111111111111,8,8,GAAAACTTAGATCAAAGTTA,0,1901554
icdC_predicted,0.1111111111111111,8,8,CTTTGTTCGACCCTCTTGCG,0,1890804
icdC_predicted,0.1111111111111111,8,8,CTTTACATGTATCCGGATAT,0,1889993
icdC_predicted,0.1111111111111111,8,8,CTTGTACCGTACCGTTGTAG,0,1884495
icdC_predicted,0.1111111111111111,8,8,CTTGTACAAATTTCCTGTTT,0,1906951
icdC_predicted,0.1111111111111111,8,8,CTTCTTTGTAACGAATGCCT,0,1894883
icdC_predicted,0.1111111111111111,8,8,CTTCGCCGGTAATCTGCACC,0,1887399
icdC_predicted,0.1111111111111111,8,8,CTTCCTAGTCAGGCCGCTTG,0,1898691
icdC_predicted,0.1111111111111111,8,8,CTTACGCTGCGCCAACAGCG,0,1886334
icdC_predicted,0.1111111111111111,8,8,CTGGCTCAATGAATCAGTGG,0,1878223
icdC_predicted,0.1111111111111111,8,8,CTGCTTAACGCGGGGGTCAA,0,1884588
icdC_predicted,0.1111111111111111,8,8,CTGCCACATGTCGTTTCAGT,0,1881861
icdC_predicted,0.1111111111111111,8,8,CTGCAGCATAGGTCTCCCGA,0,1907637
icdC_predicted,0.1111111111111111,8,8,CTGAGGCTGACAATACTAAT,0,1899347
icdC_predicted,0.1111111111111111,8,8,CTGAGACTTGCCAGTTAAGT,0,1883892
icdC_predicted,0.1111111111111111,8,8,CTGACTTAGGTGGTAAATGG,0,1898871
icdC_predicted,0.1111111111111111,8,8,CTCTGCTTAAATAGAGTGGG,0,1900628
icdC_predicted,0.1111111111111111,8,8,CTCCTGGAAAAGGCTGTTAC,0,1906802
icdC_predicted,0.1111111111111111,8,8,CTCCGTGCCAACATCCAGAG,0,1886175
icdC_predicted,0.1111111111111111,8,8,CTCCCCTTGGGCCAATTGCC,0,1882376
icdC_predicted,0.1111111111111111,8,8,CTCCCATCTAGTCACCGATA,0,1908160
icdC_predicted,0.1111111111111111,8,8,CTATGCTGCAAGCAGCCCTT,0,1880514
icdC_predicted,0.1111111111111111,8,8,CTATAGAATTGTTCTTTTCT,0,1878058
icdC_predicted,0.1111111111111111,8,8,CTATACTAGCCTGCCCGTGG,0,1890900
icdC_predicted,0.1111111111111111,8,8,CTAGTCATGCACGCACCCCA,0,1880704
icdC_predicted,0.1111111111111111,8,8,CTAGTAGGAAAAACTTGGTC,0,1885492
icdC_predicted,0.1111111111111111,8,8,CTACTCGCGCCTAGATCTCT,0,1899213
icdC_predicted,0.1111111111111111,8,8,CTACCGCCGAACGCTAGGGT,0,1881801
icdC_predicted,0.1111111111111111,8,8,CGTCATAGGCTGCATGACGC,0,1886246
icdC_predicted,0.1111111111111111,8,8,CGTCAGCATAGCCTACTCAA,0,1889578
icdC_predicted,0.1111111111111111,8,8,CGTAATGTATTTTGAGTAAT,0,1887226
icdC_predicted,0.1111111111111111,8,8,CGGGTGCCTTAAAATCGATC,0,1897315
icdC_predicted,0.1111111111111111,8,8,CGGGGGCCAGAACCCGGTCG,0,1893343
icdC_predicted,0.1111111111111111,8,8,CGGGCTATTCGAAAGAAGTC,0,1888215
icdC_predicted,0.1111111111111111,8,8,CGGCTGGTCTGTGGTGATTG,0,1892359
icdC_predicted,0.1111111111111111,8,8,CGGCTCTGACGTACATCCAA,0,1880846
icdC_predicted,0.1111111111111111,8,8,CGCCGTGAGCGCGCTCGCGA,0,1905150
icdC_predicted,0.1111111111111111,8,8,CGCCAAGCTAGTCTTTCTAC,0,1899029
icdC_predicted,0.1111111111111111,8,8,CGCAATGTTAACGGCCTATT,0,1892853
icdC_predicted,0.1111111111111111,8,8,CGATCGGACGTGTGCCTGCC,0,1901531
icdC_predicted,0.1111111111111111,8,8,CGAGTCATGGTCACCAGCTA,0,1890808
icdC_predicted,0.1111111111111111,8,8,CGAGATTAGGTTTCCTCCGG,0,1887003
icdC_predicted,0.1111111111111111,8,8,CGAGAGTACTCTACTTCGCT,0,1899006
icdC_predicted,0.1111111111111111,8,8,CGACGCTCAGACATTTCGGT,0,1892375
icdC_predicted,0.1111111111111111,8,8,CGACCGGATCCCGACACTAC,0,1900455
icdC_predicted,0.1111111111111111,8,8,CGACATATTGCAGAACTGTC,0,1896466
icdC_predicted,0.1111111111111111,8,8,CCTTAGATAAGGACTGGGGA,0,1891137
icdC_predicted,0.1111111111111111,8,8,CCTGAGGTAAACGGGTTGGA,0,1904470
icdC_predicted,0.1111111111111111,8,8,CCTCAAGAAAGCTCGAAAGT,0,1892970
icdC_predicted,0.1111111111111111,8,8,CCTACTGGAAGACGTTTACT,0,1905382
icdC_predicted,0.1111111111111111,8,8,CCGTTCCGGTAGGATCCGTA,0,1890776
icdC_predicted,0.1111111111111111,8,8,CCGGCCACCTGGCAGGCAAT,0,1886919
icdC_predicted,0.1111111111111111,8,8,CCGGCATATTAGCTACTAAC,0,1882323
icdC_predicted,0.1111111111111111,8,8,CCGCGTTTGGTTATGCGTGG,0,1892455
icdC_predicted,0.1111111111111111,8,8,CCGCCTGTCTCGTCCAGGTA,0,1889928
icdC_predicted,0.1111111111111111,8,8,CCGCACTGGTTCATCGCTCA,0,1881784
icdC_predicted,0.1111111111111111,8,8,CCGAGATGACGAAAAGTTAT,0,1901488
icdC_predicted,0.1111111111111111,8,8,CCCGCGACGGAGCGTGTCCC,0,1901884
icdC_predicted,0.1111111111111111,8,8,CCCGCAAAGTGGGTTCCATT,0,1908828
icdC_predicted,0.1111111111111111,8,8,CCCGAAAAAATGCGATGCTA,0,1906267
icdC_predicted,0.1111111111111111,8,8,CCCAACTCATGTACATGAAA,0,1896323
icdC_predicted,0.1111111111111111,8,8,CCCAAAGACAACCTGTGATG,0,1906754
icdC_predicted,0.1111111111111111,8,8,CCAGCAACTTAGATACACCT,0,1886618
icdC_predicted,0.1111111111111111,8,8,CCACAGTAACGTTTCCTCGG,0,1907617
icdC_predicted,0.1111111111111111,8,8,CATCCGGATTGAGGGACCCG,0,1878039
icdC_predicted,0.1111111111111111,8,8,CATATCGGCAGGTTCCGGGG,0,1907322
icdC_predicted,0.1111111111111111,8,8,CATAGAGCACCCACCCGTAG,0,1906147
icdC_predicted,0.1111111111111111,8,8,CATAAGATAGATTGATTTCG,0,1880364
icdC_predicted,0.1111111111111111,8,8,CAGTGTAAGAGATGTAGGCT,0,1878119
icdC_predicted,0.1111111111111111,8,8,CAGCTGAGCGGCGCAATATG,0,1882011
icdC_predicted,0.1111111111111111,8,8,CAGAGGAACAGTATGCACGC,0,1897586
icdC_predicted,0.1111111111111111,8,8,CACTTGTGACGTCACTCGAG,0,1880314
icdC_predicted,0.1111111111111111,8,8,CACCGGTTCTTTTAGCTTTA,0,1886504
icdC_predicted,0.1111111111111111,8,8,CACATTTTGCACGTACTAGG,0,1883429
icdC_predicted,0.1111111111111111,8,8,CAATGTAATCTCGGTCGGTG,0,1906065
icdC_predicted,0.1111111111111111,8,8,CAATACGGAATGACGGTTAT,0,1883691
icdC_predicted,0.1111111111111111,8,8,CAAGTAACATGCTAGCGACC,0,1908870
icdC_predicted,0.1111111111111111,8,8,CAACGAGTAGAGAACTATCT,0,1908999
icdC_predicted,0.1111111111111111,8,8,CAACCATACTTGCTTCTTAT,0,1898459
icdC_predicted,0.1111111111111111,8,8,CAAAGGGTCGTATAAGGCCT,0,1878627
icdC_predicted,0.1111111111111111,8,8,ATTTTATGATTTTTCAATCT,0,1897972
icdC_predicted,0.1111111111111111,8,8,ATTTATGCTCTCCTCTACAA,0,1886221
icdC_predicted,0.1111111111111111,8,8,ATTGCCGCAGAATGGGTAAC,0,1884525
icdC_predicted,0.1111111111111111,8,8,ATTCCCCACACGATCGGGGT,0,1907666
icdC_predicted,0.1111111111111111,8,8,ATTCATAACCCAGGCGTATA,0,1901534
icdC_predicted,0.1111111111111111,8,8,ATTCACTGCACTGGAATTCT,0,1906936
icdC_predicted,0.1111111111111111,8,8,ATGGTTAACCGTGACCTGTT,0,1900395
icdC_predicted,0.1111111111111111,8,8,ATGGTGCCCGTCACTTCCGT,0,1907270
icdC_predicted,0.1111111111111111,8,8,ATGGCCTCCGTCTACCGTCC,0,1888991
icdC_predicted,0.1111111111111111,8,8,ATGCGTATCTCGCATTCATT,0,1901177
icdC_predicted,0.1111111111111111,8,8,ATGCCAAAGGTGCCACCGTT,0,1900608
icdC_predicted,0.1111111111111111,8,8,ATCCTACTGCTGACCCTCAG,0,1890183
icdC_predicted,0.1111111111111111,8,8,ATCCCTCTCCTGCTCAAGGG,0,1893408
icdC_predicted,0.1111111111111111,8,8,ATCCATGGCAGACGATTCCT,0,1904954
icdC_predicted,0.1111111111111111,8,8,ATCAATTATCGCAGCGGGCA,0,1903960
icdC_predicted,0.1111111111111111,8,8,ATAGTGTGCGGTTGAAGCAT,0,1892059
icdC_predicted,0.1111111111111111,8,8,ATAGTATGATCGGTAGGGCG,0,1881360
icdC_predicted,0.1111111111111111,8,8,ATACTGTACCGGCTGGCTCA,0,1908376
icdC_predicted,0.1111111111111111,8,8,ATACAGGTTCCCTTGAAAGA,0,1889802
icdC_predicted,0.1111111111111111,8,8,AGTTTAAAGTTATACCCAAT,0,1895036
icdC_predicted,0.1111111111111111,8,8,AGTTGTTCGTTACGCGCAGT,0,1909288
icdC_predicted,0.1111111111111111,8,8,AGTTGCAGCTCTCGACACAA,0,1886661
icdC_predicted,0.1111111111111111,8,8,AGTGTTCTTGTGCTACTGAA,0,1890551
icdC_predicted,0.1111111111111111,8,8,AGTGTGCGGGTGCTATGTAC,0,1880121
icdC_predicted,0.1111111111111111,8,8,AGTATTTTGGACTACGTTGT,0,1901477
icdC_predicted,0.1111111111111111,8,8,AGTATGAGTCACTGCTACGT,0,1902792
icdC_predicted,0.1111111111111111,8,8,AGTAGTGACATGCCCATCTT,0,1878577
icdC_predicted,0.1111111111111111,8,8,AGTACGTCACGGCCCGGTAG,0,1891937
icdC_predicted,0.1111111111111111,8,8,AGTAAATAACAGAAATCTCA,0,1887297
icdC_predicted,0.1111111111111111,8,8,AGGGTGTTTCGACCGGCATC,0,1898839
icdC_predicted,0.1111111111111111,8,8,AGGCCCACTTGGGTTCCTAT,0,1889747
icdC_predicted,0.1111111111111111,8,8,AGGATGGCGCTATGTAAATC,0,1885069
icdC_predicted,0.1111111111111111,8,8,AGGATAAAAAACTAACACAA,0,1890361
icdC_predicted,0.1111111111111111,8,8,AGCGAGAGAGAATCCCGCCC,0,1896960
icdC_predicted,0.1111111111111111,8,8,AGATATCTGCGGTTGTCGCG,0,1887794
icdC_predicted,0.1111111111111111,8,8,ACTTAAAGACTGATAGGTTA,0,1877902
icdC_predicted,0.1111111111111111,8,8,ACTGGTTAGCCTCCCGAAAG,0,1899912
icdC_predicted,0.1111111111111111,8,8,ACTCTCGTTACGAAGGCGAA,0,1888570
icdC_predicted,0.1111111111111111,8,8,ACGGACCGAGATCGCCGTGG,0,1884197
icdC_predicted,0.1111111111111111,8,8,ACGCGGGGGCGCCTCCATAG,0,1903919
icdC_predicted,0.1111111111111111,8,8,ACGATTCGCACTTTTTATCT,0,1899805
icdC_predicted,0.1111111111111111,8,8,ACCTGTCCGGCCGTACCATT,0,1904602
icdC_predicted,0.1111111111111111,8,8,ACCTGCATACAGATCGCAAT,0,1897022
icdC_predicted,0.1111111111111111,8,8,ACCTACAAACAGCCCTACGG,0,1888056
icdC_predicted,0.1111111111111111,8,8,ACCGGCGGGTGCCGGTTCGT,0,1894162
icdC_predicted,0.1111111111111111,8,8,ACCGAAGGCTCTTTGCCCGC,0,1885138
icdC_predicted,0.1111111111111111,8,8,ACCCCATATGTCCAACTGAC,0,1891802
icdC_predicted,0.1111111111111111,8,8,ACATGAGGTGGGTGTAGTCT,0,1886436
icdC_predicted,0.1111111111111111,8,8,ACAGAGTATAGCCTCGCCCC,0,1882466
icdC_predicted,0.1111111111111111,8,8,ACACGGGAATCAGCTCAGCT,0,1886780
icdC_predicted,0.1111111111111111,8,8,ACACCAAGGAAGTGTTAAAC,0,1900617
icdC_predicted,0.1111111111111111,8,8,ACACAAGATGAGTAACGGTC,0,1885903
icdC_predicted,0.1111111111111111,8,8,ACAACTTAGTCTTACAAGCC,0,1890506
icdC_predicted,0.1111111111111111,8,8,ACAACGCCGTTACAAGTCCC,0,1878757
icdC_predicted,0.1111111111111111,8,8,AATTTTTCAAACCGCTTAGG,0,1887046
icdC_predicted,0.1111111111111111,8,8,AATTATGGCGCTTCAGGGGA,0,1886597
icdC_predicted,0.1111111111111111,8,8,AATGGAGTTAAGGTTGCCCT,0,1897552
icdC_predicted,0.1111111111111111,8,8,AATGCATTACTAGGTCCGTG,0,1892738
icdC_predicted,0.1111111111111111,8,8,AATAAAGTTCGTGGGTGTCG,0,1890124
icdC_predicted,0.1111111111111111,8,8,AAGGTTACTATCTGAACCCG,0,1885784
icdC_predicted,0.1111111111111111,8,8,AAGGCCTGCGTCGTGGCACA,0,1892276
icdC_predicted,0.1111111111111111,8,8,AAGCGTCAATGCAGGTATGC,0,1880162
icdC_predicted,0.1111111111111111,8,8,AAGCCTGGGTTGGAGTCTAC,0,1909409
icdC_predicted,0.1111111111111111,8,8,AAGCAGACGCCGAGGGAGAG,0,1907045
icdC_predicted,0.1111111111111111,8,8,AAGATGTCGAGGTGCCCAAT,0,1897553
icdC_predicted,0.1111111111111111,8,8,AACGTGCCACGGCGGACCAA,0,1900930
icdC_predicted,0.1111111111111111,8,8,AACCGCTGCTTGACAGTTCC,0,1885035
icdC_predicted,0.1111111111111111,8,8,AACCGCCTTGCCGGCAGAAA,0,1888832
icdC_predicted,0.1111111111111111,8,8,AAAGGGGGGCAGAGGCGGCA,0,1890833
icdC_predicted,0.1111111111111111,8,8,AAACACAGTAGGCTGTCCAA,0,1908290
icdC_predicted,0.1111111111111111,8,8,AAAAGATCTATGGTACCTGT,0,1906669
icdC_predicted,0.125,7,7,TTTTATCACTGAAGCGTCGC,0,1903374
icdC_predicted,0.125,7,7,TTTGGACCAAGGATCTAGAG,0,1897283
icdC_predicted,0.125,7,7,TTTAGGAAGGCTAAGTGCAG,0,1884063
icdC_predicted,0.125,7,7,TTTACCTCGCTTCCCCGTTG,0,1906902
icdC_predicted,0.125,7,7,TTGCTATAACGAAAGTAAAG,0,1899093
icdC_predicted,0.125,7,7,TTGCCTACATGCACCGCTTT,0,1902135
icdC_predicted,0.125,7,7,TTGCACTGCAGATAAGCTCC,0,1881600
icdC_predicted,0.125,7,7,TTGATTCAGGCCGATTGTAA,0,1881593
icdC_predicted,0.125,7,7,TTGATTATGCTTCTGCATTC,0,1905727
icdC_predicted,0.125,7,7,TTCTGCAATCTGGAGTAGCA,0,1885647
icdC_predicted,0.125,7,7,TTCTGAACTTTATATGACTT,0,1889488
icdC_predicted,0.125,7,7,TTCCTTGACAGCAAATCTGT,0,1901552
icdC_predicted,0.125,7,7,TTACGACGCGAATGTAAGCT,0,1878309
icdC_predicted,0.125,7,7,TTAACAGCTGCGATTATATT,0,1891602
icdC_predicted,0.125,7,7,TGTTTTTATAGGGTTGCCGC,0,1880129
icdC_predicted,0.125,7,7,TGTTTCCACGCAGCCGCATA,0,1893938
icdC_predicted,0.125,7,7,TGTGGCCTCGGAAGGGTGTC,0,1903583
icdC_predicted,0.125,7,7,TGTGCTTCTCACGGCTCCGT,0,1882838
icdC_predicted,0.125,7,7,TGTGATGTGGAGCTCTATGA,0,1898325
icdC_predicted,0.125,7,7,TGTCCACGGAATAAGTCTAG,0,1898471
icdC_predicted,0.125,7,7,TGTAGCTGTACCTAAAGTGC,0,1885396
icdC_predicted,0.125,7,7,TGTACGCCGCGATCAGCTCT,0,1892299
icdC_predicted,0.125,7,7,TGGTTGCGCCCGAATTAATG,0,1893295
icdC_predicted,0.125,7,7,TGGTGGGAGCGTCAAGACCG,0,1908606
icdC_predicted,0.125,7,7,TGGGGCTGCCCGCGGGCAAA,0,1884340
icdC_predicted,0.125,7,7,TGGGCGCCTGAGTGCCTAAA,0,1885947
icdC_predicted,0.125,7,7,TGGCGTTTTCTGATGTGATT,0,1907827
icdC_predicted,0.125,7,7,TGGCCCGTGACTCACTGAGG,0,1883909
icdC_predicted,0.125,7,7,TGGAAAACGGGAGCGCTTCG,0,1904619
icdC_predicted,0.125,7,7,TGCGTAATGGCCTAAGATAA,0,1882085
icdC_predicted,0.125,7,7,TGCGCACCAGAAGGCGTTAT,0,1902279
icdC_predicted,0.125,7,7,TGCCGGAATCTGCTATGGTG,0,1907797
icdC_predicted,0.125,7,7,TGCCGAATGAGGCCTTCCAT,0,1901702
icdC_predicted,0.125,7,7,TGATTGACCGGACCGTCTGG,0,1908425
icdC_predicted,0.125,7,7,TGATTACTCAGTCTCGCGTT,0,1903617
icdC_predicted,0.125,7,7,TGATCATACATGATGTAGCC,0,1889527
icdC_predicted,0.125,7,7,TCTGGGACTCATGATACCCC,0,1885212
icdC_predicted,0.125,7,7,TCTCTACGCTTGCGGGTGTT,0,1893190
icdC_predicted,0.125,7,7,TCTCCCTGACCATGATTCGA,0,1891399
icdC_predicted,0.125,7,7,TCGTGCGTCAACCCTCCCAA,0,1906115
icdC_predicted,0.125,7,7,TCGTAGACTCAAGTGGGGTC,0,1902712
icdC_predicted,0.125,7,7,TCGTACTACTGTGGCGTCAC,0,1878776
icdC_predicted,0.125,7,7,TCGGGGACTCGTAGTATTGC,0,1905926
icdC_predicted,0.125,7,7,TCGGGACGTGAACTCACTAT,0,1906136
icdC_predicted,0.125,7,7,TCGGCTAATTTGGCGGTCTT,0,1888599
icdC_predicted,0.125,7,7,TCGCCCCGGACAGACGGAAT,0,1892751
icdC_predicted,0.125,7,7,TCCACATTGAAACGATCTTA,0,1883209
icdC_predicted,0.125,7,7,TCCAACACCATTAGCCAAGA,0,1893853
icdC_predicted,0.125,7,7,TCATTCCGGAGCATTTGGTG,0,1878751
icdC_predicted,0.125,7,7,TCATGTGCATGGATAAACGA,0,1882992
icdC_predicted,0.125,7,7,TCATGTATTCTATCGGCATT,0,1893719
icdC_predicted,0.125,7,7,TCACGGGGAATTACTGGACA,0,1903926
icdC_predicted,0.125,7,7,TCAATGTGTACGACATCTTC,0,1884700
icdC_predicted,0.125,7,7,TCAATGAAGAGATATGCGTT,0,1890228
icdC_predicted,0.125,7,7,TCAAGAGGGAACATGTCCAT,0,1882870
icdC_predicted,0.125,7,7,TATTCAATGATATTTGGCGA,0,1888489
icdC_predicted,0.125,7,7,TATTAAATGGACCTAGGAAC,0,1888222
icdC_predicted,0.125,7,7,TATCTGATGAGAAAATTCAG,0,1907938
icdC_predicted,0.125,7,7,TATCACAATATTGTAATGTG,0,1894057
icdC_predicted,0.125,7,7,TATATTAAGCTTACTCTGGG,0,1891191
icdC_predicted,0.125,7,7,TATATCATATCCCGTTGAGT,0,1883448
icdC_predicted,0.125,7,7,TATAGCAACCGACAGGTGTT,0,1906469
icdC_predicted,0.125,7,7,TATAGATCAGGATAACTGAC,0,1892128
icdC_predicted,0.125,7,7,TATACGGCTGGCCACTTTAG,0,1882070
icdC_predicted,0.125,7,7,TATAAACGGTCTTACGTATT,0,1906223
icdC_predicted,0.125,7,7,TACTGTCTCTCGATATTCTC,0,1894205
icdC_predicted,0.125,7,7,TACTCACCGCTATAGCCCTT,0,1892933
icdC_predicted,0.125,7,7,TACTAAGTTTTACTGTATGA,0,1896224
icdC_predicted,0.125,7,7,TACGGTTTTATAAGCAGTGG,0,1904855
icdC_predicted,0.125,7,7,TAATCTGCTCTAGTGGAAAA,0,1905954
icdC_predicted,0.125,7,7,TAAGAGCGTTGAGTCGGGCG,0,1904298
icdC_predicted,0.125,7,7,GTTGCATCTGGCTCAGTCAT,0,1907311
icdC_predicted,0.125,7,7,GTTCGGTTGGGCTCAAATTC,0,1900536
icdC_predicted,0.125,7,7,GTTCCTGCGGTGCTATTTTT,0,1900406
icdC_predicted,0.125,7,7,GTTCCACCAGATATAATTTG,0,1892042
icdC_predicted,0.125,7,7,GTTCACAAGAGGGCGTTAAG,0,1878852
icdC_predicted,0.125,7,7,GTTATTTAGCTCGGGCAGGT,0,1905830
icdC_predicted,0.125,7,7,GTGTGTCATTAGACAGATCG,0,1905560
icdC_predicted,0.125,7,7,GTGAACCTCAGAGGGGCTTT,0,1880652
icdC_predicted,0.125,7,7,GTCTTGAGGCGGCGATTAAC,0,1878913
icdC_predicted,0.125,7,7,GTCTGAGTACTCTGGATAAA,0,1889535
icdC_predicted,0.125,7,7,GTCTCTCAACAGCCCTGGCC,0,1882625
icdC_predicted,0.125,7,7,GTCGTATAACCGTATTGTTT,0,1908051
icdC_predicted,0.125,7,7,GTCGGAGTATCACAGTATAA,0,1887087
icdC_predicted,0.125,7,7,GTCCCGGGATGTACAGATAA,0,1894733
icdC_predicted,0.125,7,7,GTCAGATCTTTCGCAAGTCG,0,1881164
icdC_predicted,0.125,7,7,GTCAAACGATGCTACTTTCG,0,1880207
icdC_predicted,0.125,7,7,GTATTTAAGAACATGTCACG,0,1886468
icdC_predicted,0.125,7,7,GTATGACGCGGGTAAACATC,0,1892154
icdC_predicted,0.125,7,7,GTAGTGTATCGTTGAAACTT,0,1877886
icdC_predicted,0.125,7,7,GTAGCGAGTGATCGCAATCT,0,1902914
icdC_predicted,0.125,7,7,GGTTGCTTATTTTCTAACAC,0,1885569
icdC_predicted,0.125,7,7,GGTTGCTGTATTTCACAGGA,0,1885585
icdC_predicted,0.125,7,7,GGTTCGTCACATTATCCAGC,0,1890442
icdC_predicted,0.125,7,7,GGTTCGATCGACAAAAATTA,0,1908874
icdC_predicted,0.125,7,7,GGTTATGCACATCGTTCCAA,0,1894292
icdC_predicted,0.125,7,7,GGTGTAGCGGGGCGCCCGAA,0,1888606
icdC_predicted,0.125,7,7,GGTGCTAATAGTGCTTGGGG,0,1887972
icdC_predicted,0.125,7,7,GGTGCGGGCTCTGTGACGCA,0,1897012
icdC_predicted,0.125,7,7,GGTGCCGATCGGTAATACCC,0,1908312
icdC_predicted,0.125,7,7,GGTCCAGGGCATACCAGTAA,0,1890747
icdC_predicted,0.125,7,7,GGGTGTAAAGCCACCAATGT,0,1879881
icdC_predicted,0.125,7,7,GGGTCTTTTGCGTCTCAAAT,0,1883142
icdC_predicted,0.125,7,7,GGGTCCCATAAGGTTGCCTC,0,1896586
icdC_predicted,0.125,7,7,GGGGGTCTAGAGGCAATACC,0,1881743
icdC_predicted,0.125,7,7,GGGCTCCCGGTGAGGTCTAG,0,1885488
icdC_predicted,0.125,7,7,GGGCTAGTCTGTAAGTGGTT,0,1898364
icdC_predicted,0.125,7,7,GGGAGTACAGCAAGTTATAA,0,1907346
icdC_predicted,0.125,7,7,GGGACGGAGTTCGAGGTGGT,0,1895725
icdC_predicted,0.125,7,7,GGGACACAAGTGTGCGCCTT,0,1880744
icdC_predicted,0.125,7,7,GGCTCGGTTAGCGGTAACGG,0,1896881
icdC_predicted,0.125,7,7,GGCTCGAGTTGCGAGTACGA,0,1887164
icdC_predicted,0.125,7,7,GGCTAAAACCTGCTCAGGGA,0,1905769
icdC_predicted,0.125,7,7,GGCGAGGCGATCCACGTCAA,0,1883223
icdC_predicted,0.125,7,7,GGCAACAATGTGTTAGGGCA,0,1906890
icdC_predicted,0.125,7,7,GGATACGCCGCTTGCTTGAT,0,1884122
icdC_predicted,0.125,7,7,GGAGCTCGTCCCACAGATAA,0,1887845
icdC_predicted,0.125,7,7,GGACCGAAACTTCGGCGGGG,0,1883207
icdC_predicted,0.125,7,7,GGAACGCGTAACTCTTCGTT,0,1904291
icdC_predicted,0.125,7,7,GGAACGCGGAGATTATATAG,0,1892105
icdC_predicted,0.125,7,7,GCTGAGGCCAGGCGTATATA,0,1904463
icdC_predicted,0.125,7,7,GCTCGAACCTAGACTTGATC,0,1898057
icdC_predicted,0.125,7,7,GCTACTCTATAAGCACCGAA,0,1895507
icdC_predicted,0.125,7,7,GCGTCCGACTGTCCAAGACA,0,1880457
icdC_predicted,0.125,7,7,GCGCACCGCAGGAACCTCTA,0,1885611
icdC_predicted,0.125,7,7,GCGATTGAGCGTGGGTGTTC,0,1884249
icdC_predicted,0.125,7,7,GCCTATGTTCTGAATATTGT,0,1889684
icdC_predicted,0.125,7,7,GCCTACGCAGTTGGCCTTAT,0,1905157
icdC_predicted,0.125,7,7,GCCGTGCGTAGATATCGGAA,0,1884212
icdC_predicted,0.125,7,7,GCCGGCAGCCACTGTCGGCA,0,1889107
icdC_predicted,0.125,7,7,GCCCCTGGGTTAAGGGGCCA,0,1896536
icdC_predicted,0.125,7,7,GCCATCGCGGATAAGGACTC,0,1905047
icdC_predicted,0.125,7,7,GCCAGAAGGGGGATCTTCTT,0,1897329
icdC_predicted,0.125,7,7,GCATATACTGGGGTGAGGAT,0,1900111
icdC_predicted,0.125,7,7,GCAGTTTGGGCAGTTCTCTC,0,1890784
icdC_predicted,0.125,7,7,GCAGTTCACAGGATCTCATC,0,1881440
icdC_predicted,0.125,7,7,GCACAGTGCGAGATTGTGCC,0,1897467
icdC_predicted,0.125,7,7,GCAATGGCCTTACAAGGTGA,0,1906568
icdC_predicted,0.125,7,7,GCAATCAAAAGGTTAACGTT,0,1880985
icdC_predicted,0.125,7,7,GCAATAAGGTGAACGCTTAA,0,1883965
icdC_predicted,0.125,7,7,GATGTTAAAGTTCTCAGAGA,0,1881356
icdC_predicted,0.125,7,7,GATGAGGTGTGCGCAATCCG,0,1879638
icdC_predicted,0.125,7,7,GATCCTCGCCGTAAGTGGTA,0,1893839
icdC_predicted,0.125,7,7,GAGTTTGGGGGATCTTCATT,0,1894736
icdC_predicted,0.125,7,7,GAGTGCAGGTAATGTAACCA,0,1884835
icdC_predicted,0.125,7,7,GAGTAGATTTCGTATGGAAT,0,1884230
icdC_predicted,0.125,7,7,GAGCCGGTGATGCGTGTACA,0,1888045
icdC_predicted,0.125,7,7,GACTTACCGAGTACCTCACA,0,1907405
icdC_predicted,0.125,7,7,GACTGGAAATTGTGCGGACA,0,1884240
icdC_predicted,0.125,7,7,GACGCGCAGCTCGGCGCTCC,0,1908325
icdC_predicted,0.125,7,7,GACCTCAATTCATCTTATGA,0,1894615
icdC_predicted,0.125,7,7,GACATACTACTATATCGTGT,0,1900870
icdC_predicted,0.125,7,7,GAAGTGAGATGACAATACGT,0,1897180
icdC_predicted,0.125,7,7,GAAACTCGTTACGACAATGC,0,1895675
icdC_predicted,0.125,7,7,GAAAAAATCAATATCGCTGT,0,1899689
icdC_predicted,0.125,7,7,CTTTCTGCGGAGTGGGGGTG,0,1898589
icdC_predicted,0.125,7,7,CTTGGGGACTCAGGAACCTG,0,1880708
icdC_predicted,0.125,7,7,CTTGAAAGGCGGAATTAAGC,0,1882688
icdC_predicted,0.125,7,7,CTTCTGCCAGTCTGGTTTAG,0,1897492
icdC_predicted,0.125,7,7,CTTAACCCAAGAGCGGCTGA,0,1898666
icdC_predicted,0.125,7,7,CTGTTATGCGAGTAATATAC,0,1896117
icdC_predicted,0.125,7,7,CTGTGGTTTTGAGTTGAGAT,0,1891194
icdC_predicted,0.125,7,7,CTGGGACAGCCTTATAGGCC,0,1892018
icdC_predicted,0.125,7,7,CTGGCTGGATACTGTACGGT,0,1906120
icdC_predicted,0.125,7,7,CTGCGACTGTGGTTATTGAG,0,1883225
icdC_predicted,0.125,7,7,CTGATCATAAGTTCAGGGCT,0,1881222
icdC_predicted,0.125,7,7,CTCTGACGGGTCAGACAGCA,0,1898295
icdC_predicted,0.125,7,7,CTCTATCTCCCCTAGCTACA,0,1903040
icdC_predicted,0.125,7,7,CTCGCATGCTACGCATGCGG,0,1889262
icdC_predicted,0.125,7,7,CTCCTTTTCACTTACTTTTT,0,1902426
icdC_predicted,0.125,7,7,CTCATAGTGTATCGACTCAA,0,1892665
icdC_predicted,0.125,7,7,CTCAGACTAGCAGAAGTGTC,0,1889542
icdC_predicted,0.125,7,7,CTCAACTCAAACGCTTCACT,0,1883762
icdC_predicted,0.125,7,7,CTAGAGGACCGTTCTAGTCC,0,1893486
icdC_predicted,0.125,7,7,CTACGTTGACCGACTAAAGC,0,1881883
icdC_predicted,0.125,7,7,CTAAGACGCATCGATATTAT,0,1901676
icdC_predicted,0.125,7,7,CGTTTAAGCTTTTGATCGCG,0,1893560
icdC_predicted,0.125,7,7,CGTGTGTGTACCTCAGGATC,0,1895111
icdC_predicted,0.125,7,7,CGTGGGTTTTAGATCGTATT,0,1888253
icdC_predicted,0.125,7,7,CGTGGATAGGACTCCACCAT,0,1899705
icdC_predicted,0.125,7,7,CGTCTTCTGACAGGTAATGT,0,1884805
icdC_predicted,0.125,7,7,CGTAACGCTCTAAAACTCTG,0,1877930
icdC_predicted,0.125,7,7,CGGTGTCAGATTTTGCGCAA,0,1884232
icdC_predicted,0.125,7,7,CGGTACGACTCTCCAGATCG,0,1886514
icdC_predicted,0.125,7,7,CGGGGTCCGCCAGTACAGGC,0,1885971
icdC_predicted,0.125,7,7,CGGGGGGCGACGGCGATAGT,0,1878428
icdC_predicted,0.125,7,7,CGGCATGTGACGCTTCAGGA,0,1909345
icdC_predicted,0.125,7,7,CGGACCGCTGTTATCTTTTC,0,1907787
icdC_predicted,0.125,7,7,CGCCCACGCCTGGATACGGG,0,1884504
icdC_predicted,0.125,7,7,CGCCATCACACGTCATTTTG,0,1907487
icdC_predicted,0.125,7,7,CGCACAGGATCGATTCAGTC,0,1883632
icdC_predicted,0.125,7,7,CGATACTTAACGAGCTTTAC,0,1908883
icdC_predicted,0.125,7,7,CGATACGGCGCCGTTCCGGA,0,1885785
icdC_predicted,0.125,7,7,CGAGAATAATGCGAAGACTG,0,1895385
icdC_predicted,0.125,7,7,CGACTTAAACCAGGACAGTT,0,1890683
icdC_predicted,0.125,7,7,CGACGCTGGACTAGAATATG,0,1898689
icdC_predicted,0.125,7,7,CGACACGGGTCTAACATCAG,0,1892017
icdC_predicted,0.125,7,7,CGAAGGGCGGGCAGGATACT,0,1903305
icdC_predicted,0.125,7,7,CGAAAATACGCAGCCAAGTC,0,1895596
icdC_predicted,0.125,7,7,CCTCTCATATCAGAAAGCAT,0,1893625
icdC_predicted,0.125,7,7,CCTATGACTAAGCGCATTGC,0,1897287
icdC_predicted,0.125,7,7,CCTATGACAGGTTGGCAGTT,0,1889178
icdC_predicted,0.125,7,7,CCTAGCCACCATAAACTTCC,0,1904180
icdC_predicted,0.125,7,7,CCGGTCACCGGTGGGGATCC,0,1885599
icdC_predicted,0.125,7,7,CCGGGTCACGAAGCGCCGGG,0,1878964
icdC_predicted,0.125,7,7,CCGCGGTTAAAAATGTCTAG,0,1899862
icdC_predicted,0.125,7,7,CCGCCACCTTATTACTAACA,0,1878427
icdC_predicted,0.125,7,7,CCGAGCTCTTTGTACGGGAG,0,1888073
icdC_predicted,0.125,7,7,CCGAGCGCCCAGGAGCGGAT,0,1882949
icdC_predicted,0.125,7,7,CCCTCCCCAGCTTAAAGGAA,0,1889907
icdC_predicted,0.125,7,7,CCCGGCTGCAGTACCCTAGC,0,1908578
icdC_predicted,0.125,7,7,CCCAGTGGAATCTTCGTTAA,0,1908861
icdC_predicted,0.125,7,7,CCCAGATGTATAAAGTGTAC,0,1906080
icdC_predicted,0.125,7,7,CCATTTCGCCTGGAGTATAA,0,1905537
icdC_predicted,0.125,7,7,CCATGGTCTTCCCCTTGTGT,0,1895393
icdC_predicted,0.125,7,7,CCATCCGAACATTGCTTAAG,0,1901039
icdC_predicted,0.125,7,7,CCAGTCCACAACCGAACGCG,0,1897763
icdC_predicted,0.125,7,7,CCACTCCATTAAGTGGCAAA,0,1891200
icdC_predicted,0.125,7,7,CCACCTCGTCGAACCCCCTA,0,1905875
icdC_predicted,0.125,7,7,CCAATCGAACATACTTTACT,0,1895574
icdC_predicted,0.125,7,7,CCAAACTTCTATGGTCTTTC,0,1885290
icdC_predicted,0.125,7,7,CATGTACAACGATGGTAATA,0,1886260
icdC_predicted,0.125,7,7,CATGCCTTGGAGGACCATTG,0,1885301
icdC_predicted,0.125,7,7,CAGTTTTCCGATACCTCTTC,0,1884179
icdC_predicted,0.125,7,7,CAGGGTCCCGGTTAGAAGAC,0,1903699
icdC_predicted,0.125,7,7,CAGGACGGGACAAGCGTCAG,0,1894552
icdC_predicted,0.125,7,7,CAGGAACGCCTCTGAGTGCC,0,1880414
icdC_predicted,0.125,7,7,CAGCTTACCTGTCCCTTTGT,0,1892708
icdC_predicted,0.125,7,7,CAGCTGAAATTTGGCGGGTA,0,1904327
icdC_predicted,0.125,7,7,CACGGCAAGAGAGGGCTTGT,0,1888493
icdC_predicted,0.125,7,7,CACGCTCCCGTTTACAGGCG,0,1906986
icdC_predicted,0.125,7,7,CACGCATCTAGAGGCCTCGC,0,1905993
icdC_predicted,0.125,7,7,CACCCGACATATGGGACCCT,0,1907319
icdC_predicted,0.125,7,7,CACCACTGAAGGAGTGCTAC,0,1892962
icdC_predicted,0.125,7,7,CACATAGCACGGATGCATCA,0,1881595
icdC_predicted,0.125,7,7,CACAGAGTAAAGGTTTGATG,0,1892363
icdC_predicted,0.125,7,7,CACACTGTGAATCCGTGTGG,0,1895948
icdC_predicted,0.125,7,7,CAAGTATGCAACAGACGAGA,0,1879961
icdC_predicted,0.125,7,7,CAAGCTTTCATAACATATAG,0,1891661
icdC_predicted,0.125,7,7,CAAGACGATGGACACGTCAG,0,1898793
icdC_predicted,0.125,7,7,CAACTGCAGTCTTTACAGCT,0,1902905
icdC_predicted,0.125,7,7,ATTTGCGATTAGTTAAGCGA,0,1902754
icdC_predicted,0.125,7,7,ATTGGGACTCTCCGGATAGA,0,1905930
icdC_predicted,0.125,7,7,ATTATCCTGGTTAGTGTCTT,0,1892573
icdC_predicted,0.125,7,7,ATGTGGAGCGTCACCCGGCA,0,1905316
icdC_predicted,0.125,7,7,ATGTGCGAAACACAACACAA,0,1896731
icdC_predicted,0.125,7,7,ATGTATTCGTCACCGACATC,0,1909119
icdC_predicted,0.125,7,7,ATGATACTTGGGGGCGCGGA,0,1883694
icdC_predicted,0.125,7,7,ATGAGCCCCAACAGAAGGGT,0,1899314
icdC_predicted,0.125,7,7,ATCTGAAAATACCACTTTTG,0,1904011
icdC_predicted,0.125,7,7,ATCTAAAGTTTTAAGCGGAC,0,1880380
icdC_predicted,0.125,7,7,ATCGGAAAATGAAGGACGAT,0,1899786
icdC_predicted,0.125,7,7,ATCCATTTCCAATGCTACTG,0,1887406
icdC_predicted,0.125,7,7,ATCCAGCCGGAGAATGTAAT,0,1878991
icdC_predicted,0.125,7,7,ATCCACGATTAAGTGTCCAA,0,1893153
icdC_predicted,0.125,7,7,ATATTATATTTCCCTCCTGT,0,1885495
icdC_predicted,0.125,7,7,ATACCAGGCAATCGTCACAT,0,1894431
icdC_predicted,0.125,7,7,ATACAGGATTAAGCAGACTC,0,1881235
icdC_predicted,0.125,7,7,AGTTCCCAGCAAAGCCTGCT,0,1882368
icdC_predicted,0.125,7,7,AGTTAAGTAGGCTCGCGACA,0,1905158
icdC_predicted,0.125,7,7,AGTGTTACTTAGATCGGCTC,0,1878127
icdC_predicted,0.125,7,7,AGTCATTATCTGTCGAAGAG,0,1884088
icdC_predicted,0.125,7,7,AGTCATTAAAAGCGGACTTA,0,1896974
icdC_predicted,0.125,7,7,AGTATGCTAGAGCTAGATAA,0,1899992
icdC_predicted,0.125,7,7,AGTAGAGTAGCAGCCCACGC,0,1893621
icdC_predicted,0.125,7,7,AGGTAAAAAACATATATTCC,0,1881028
icdC_predicted,0.125,7,7,AGGCCGTGACTGGGTTCCAA,0,1890573
icdC_predicted,0.125,7,7,AGGATGAGATAATCTAAAGG,0,1896723
icdC_predicted,0.125,7,7,AGGAATCTTCGACACACTTC,0,1905901
icdC_predicted,0.125,7,7,AGGAAGTGGACCTGTCTCCC,0,1904806
icdC_predicted,0.125,7,7,AGCTTGCGACATATCTGACA,0,1900107
icdC_predicted,0.125,7,7,AGCGTTTCTTGAGCCCGGGG,0,1886585
icdC_predicted,0.125,7,7,AGCATCAGTCAAGGATTGGT,0,1899285
icdC_predicted,0.125,7,7,AGCAAATTTTTTCACCGCAA,0,1879302
icdC_predicted,0.125,7,7,AGATCAACCCACAGTCCTGT,0,1903976
icdC_predicted,0.125,7,7,AGAGCATCGTTTATAAGGTT,0,1903157
icdC_predicted,0.125,7,7,AGAGATGTCTTTGTGCAAGC,0,1885651
icdC_predicted,0.125,7,7,AGACCACGATAGGGTAGATC,0,1883352
icdC_predicted,0.125,7,7,AGACATTCCCCTAGGAGTAT,0,1888382
icdC_predicted,0.125,7,7,AGAACGCATCAGTATGTCCT,0,1878625
icdC_predicted,0.125,7,7,ACTTTTCGTAGCGGCTTCGT,0,1904846
icdC_predicted,0.125,7,7,ACTGGGCTGACCCTTCAGTG,0,1902526
icdC_predicted,0.125,7,7,ACTATTCTCTTGTGCTGTGA,0,1891842
icdC_predicted,0.125,7,7,ACTAAAGCCGCTTTACGCGT,0,1880046
icdC_predicted,0.125,7,7,ACGTGCTTGAACAGCGGCGT,0,1897594
icdC_predicted,0.125,7,7,ACGGGCCCGGTCGATCGTAC,0,1884248
icdC_predicted,0.125,7,7,ACGGCAGAACGAGGTCGGGG,0,1881773
icdC_predicted,0.125,7,7,ACCTTTTAACTCCGGGGGGT,0,1901958
icdC_predicted,0.125,7,7,ACCTTTCCGGCATAGGGACA,0,1890452
icdC_predicted,0.125,7,7,ACCCGGCCTATGAATGAGGG,0,1897486
icdC_predicted,0.125,7,7,ACCCCCCGTGTAGTTCGCCA,0,1891844
icdC_predicted,0.125,7,7,ACATACTGGCCCTAGCGAAG,0,1894256
icdC_predicted,0.125,7,7,ACAGATTATCATTACCATAT,0,1890806
icdC_predicted,0.125,7,7,ACACGGCACACGGTGATCAC,0,1883748
icdC_predicted,0.125,7,7,ACACCGTGATCGTGCCTCGC,0,1887854
icdC_predicted,0.125,7,7,AATTGTATCGTTGCTTCTTT,0,1885134
icdC_predicted,0.125,7,7,AATGCTCCCTGGTCAACATA,0,1885116
icdC_predicted,0.125,7,7,AATGCCTCACTGCTGTAAAG,0,1898743
icdC_predicted,0.125,7,7,AATGATACGGAAATGGCTAT,0,1903234
icdC_predicted,0.125,7,7,AATCGCAATCAATTACGCTA,0,1892936
icdC_predicted,0.125,7,7,AAGTTGTTGGACATACTCCT,0,1886713
icdC_predicted,0.125,7,7,AAGGGCGCGCATCGCACCTG,0,1881626
icdC_predicted,0.125,7,7,AAGCCTCTCTAGCCCTCCTT,0,1878792
icdC_predicted,0.125,7,7,AAGATACATTGGCAATGCCT,0,1897472
icdC_predicted,0.125,7,7,AACAGTAGCCCTGAGCAATC,0,1900220
icdC_predicted,0.125,7,7,AACAGCGTCCGTTGAGCAAG,0,1880482
icdC_predicted,0.125,7,7,AAATCTATCAGGGTGAAGAA,0,1898632
icdC_predicted,0.125,7,7,AAAGAGGGTCTGAAGTGGGT,0,1878498
icdC_predicted,0.125,7,7,AAACGGAATTCGTCAGCGAT,0,1899322
icdC_predicted,0.125,7,7,AAAAAGGCGTGGTGGAGACA,0,1890600
icdC_predicted,0.14285714285714285,6,6,TTTTCACAAGAGCTATGATG,0,1897746
icdC_predicted,0.14285714285714285,6,6,TTTTAGTACCCGCTGAAGGC,0,1883896
icdC_predicted,0.14285714285714285,6,6,TTTTACAGCGTTTCGGTTCT,0,1886642
icdC_predicted,0.14285714285714285,6,6,TTTGTTCGATGTGGTCCAAT,0,1900857
icdC_predicted,0.14285714285714285,6,6,TTTGTTATTCCACCTTTGCA,0,1898291
icdC_predicted,0.14285714285714285,6,6,TTTGGTATGTGTTAAGTTTC,0,1880452
icdC_predicted,0.14285714285714285,6,6,TTTAGAGGGTCGCATGTTTA,0,1878407
icdC_predicted,0.14285714285714285,6,6,TTGTACCTTAATCCCTAAAA,0,1880366
icdC_predicted,0.14285714285714285,6,6,TTGGTATGGAGTAAGCTAAG,0,1907724
icdC_predicted,0.14285714285714285,6,6,TTGAGTGTACCGCTGCATGC,0,1882933
icdC_predicted,0.14285714285714285,6,6,TTGAATTCTTGCGAGAGTAC,0,1904822
icdC_predicted,0.14285714285714285,6,6,TTCTTTAGAACGTGTATCGT,0,1902970
icdC_predicted,0.14285714285714285,6,6,TTCTTAGGATTCGGGTCTCG,0,1886462
icdC_predicted,0.14285714285714285,6,6,TTCTCCCAGCAGGCCCACCG,0,1892241
icdC_predicted,0.14285714285714285,6,6,TTCGTCCCATTCTATTCGCA,0,1902214
icdC_predicted,0.14285714285714285,6,6,TTCGCGTGCCTCCTTAGTGT,0,1892861
icdC_predicted,0.14285714285714285,6,6,TTCAATTGAGATTCGTGTTG,0,1895041
icdC_predicted,0.14285714285714285,6,6,TTCAAGACTCGGACCCTGTC,0,1886164
icdC_predicted,0.14285714285714285,6,6,TTATGTTCTACCGCCACCCC,0,1889034
icdC_predicted,0.14285714285714285,6,6,TTATCTCCCTGAGGGGTGAA,0,1878851
icdC_predicted,0.14285714285714285,6,6,TTATCGGGCCGAACGGCCAA,0,1903137
icdC_predicted,0.14285714285714285,6,6,TTACGACTGGGTAAGATGAG,0,1909153
icdC_predicted,0.14285714285714285,6,6,TTAATCGTTGCTTGACGCGG,0,1900688
icdC_predicted,0.14285714285714285,6,6,TTAACTTTCGTGCCAATGGG,0,1901184
icdC_predicted,0.14285714285714285,6,6,TGTGCATGCTACGTCCAGAC,0,1901180
icdC_predicted,0.14285714285714285,6,6,TGTGCACTTGAGATGTCTTT,0,1883660
icdC_predicted,0.14285714285714285,6,6,TGTCTGCAACAAGGTTCTTC,0,1893320
icdC_predicted,0.14285714285714285,6,6,TGTCCAGGTAAGATGGGAAT,0,1882837
icdC_predicted,0.14285714285714285,6,6,TGGGAAGGCTCAGTGAAGGC,0,1886183
icdC_predicted,0.14285714285714285,6,6,TGCCTCGAATCCATTACATT,0,1905043
icdC_predicted,0.14285714285714285,6,6,TGCCCTTGTGCAAATCGGAC,0,1893751
icdC_predicted,0.14285714285714285,6,6,TGCACTCTGTCTAGCAGGAT,0,1877972
icdC_predicted,0.14285714285714285,6,6,TGATTAGCTGGAGCGGGCAT,0,1897898
icdC_predicted,0.14285714285714285,6,6,TGACGAGTTCGTTCGCTTAC,0,1887211
icdC_predicted,0.14285714285714285,6,6,TGACAGCCCGCACTGGAGAT,0,1894007
icdC_predicted,0.14285714285714285,6,6,TGAATAGAACCGTCTACTCA,0,1891196
icdC_predicted,0.14285714285714285,6,6,TCTTTTGGATGACATCGGGG,0,1899566
icdC_predicted,0.14285714285714285,6,6,TCTGGTTTGACCTCGAATGA,0,1898508
icdC_predicted,0.14285714285714285,6,6,TCTGATTACGGGTTCGGGAC,0,1892651
icdC_predicted,0.14285714285714285,6,6,TCTCTTGCAACTGTCATCTG,0,1880532
icdC_predicted,0.14285714285714285,6,6,TCGTAATAGATTTCCGAATG,0,1890745
icdC_predicted,0.14285714285714285,6,6,TCGAATGGAGGCATTAAAGC,0,1902875
icdC_predicted,0.14285714285714285,6,6,TCCTAATAGAACTAAGGCAT,0,1899846
icdC_predicted,0.14285714285714285,6,6,TCCGACCTTGTCACAAAAAT,0,1898629
icdC_predicted,0.14285714285714285,6,6,TCCCGGTCACGCAGATCATC,0,1881204
icdC_predicted,0.14285714285714285,6,6,TCCCCGTGCCGATTCCAACT,0,1889746
icdC_predicted,0.14285714285714285,6,6,TCCCACGCAAAGGGGTACAG,0,1908675
icdC_predicted,0.14285714285714285,6,6,TCCACCATGGCGAGCATTGA,0,1908688
icdC_predicted,0.14285714285714285,6,6,TCATTCTGCAGCCCTATTAA,0,1893838
icdC_predicted,0.14285714285714285,6,6,TCATCTCTCTTACAATAAAC,0,1885842
icdC_predicted,0.14285714285714285,6,6,TCAGACGCTGAACCCAGCTT,0,1903355
icdC_predicted,0.14285714285714285,6,6,TCACAGGCACAGCGCCCGGG,0,1892598
icdC_predicted,0.14285714285714285,6,6,TATTTATATGTTACCTCACT,0,1889720
icdC_predicted,0.14285714285714285,6,6,TATTCGGACAAAGTTTGCGC,0,1881174
icdC_predicted,0.14285714285714285,6,6,TATGCGGGGAGCGCCTGTTC,0,1882358
icdC_predicted,0.14285714285714285,6,6,TATGCGATTTTGCGCAATAG,0,1901280
icdC_predicted,0.14285714285714285,6,6,TATAGTCACCCTCTCCCGGG,0,1880824
icdC_predicted,0.14285714285714285,6,6,TATAAGATGGCCCCCCAGGA,0,1900353
icdC_predicted,0.14285714285714285,6,6,TATAACCGCCTGAACTTAGG,0,1883908
icdC_predicted,0.14285714285714285,6,6,TAGGGGTTGGAACCGCGGTA,0,1899709
icdC_predicted,0.14285714285714285,6,6,TAGGCTTTTTGCTGAGGCTA,0,1901241
icdC_predicted,0.14285714285714285,6,6,TAGGAGCATGTATGTCCATC,0,1901508
icdC_predicted,0.14285714285714285,6,6,TAGCCTGCCTTAGCTCACGG,0,1888635
icdC_predicted,0.14285714285714285,6,6,TAGCAGATTATCGGCTGGCA,0,1883945
icdC_predicted,0.14285714285714285,6,6,TAGCACGGGGGCTGAAACAA,0,1896229
icdC_predicted,0.14285714285714285,6,6,TACTTGAAGAGTATTGCTGT,0,1907778
icdC_predicted,0.14285714285714285,6,6,TACTGATCGTCTGAAAATCT,0,1884001
icdC_predicted,0.14285714285714285,6,6,TACGTGGGGGCCGTACACGT,0,1893593
icdC_predicted,0.14285714285714285,6,6,TACGGGCATCAAAACGGGGG,0,1893176
icdC_predicted,0.14285714285714285,6,6,TACGGAGGTACCCATTTATA,0,1881461
icdC_predicted,0.14285714285714285,6,6,TACGACGTAAACACGGGTCG,0,1885879
icdC_predicted,0.14285714285714285,6,6,TACAGCGGATAGAGGTGCCC,0,1880335
icdC_predicted,0.14285714285714285,6,6,TACAGAGGCAACTGGTGCCA,0,1892663
icdC_predicted,0.14285714285714285,6,6,TACACGCGCATTATTAACTT,0,1901281
icdC_predicted,0.14285714285714285,6,6,TACAACAAAGACACCTATGG,0,1891657
icdC_predicted,0.14285714285714285,6,6,TAATTGGTCGGCGAATGATT,0,1881029
icdC_predicted,0.14285714285714285,6,6,TAATTGAGGAGTACAGGGCG,0,1879597
icdC_predicted,0.14285714285714285,6,6,TAATGGTATGTACTCAATCC,0,1900401
icdC_predicted,0.14285714285714285,6,6,TAAGTGTGGTAGGGCTATGT,0,1907300
icdC_predicted,0.14285714285714285,6,6,TAAGTCGGTGTGATCCATTT,0,1905362
icdC_predicted,0.14285714285714285,6,6,TAACGATAGTCATCAGGCTA,0,1880644
icdC_predicted,0.14285714285714285,6,6,TAACCTCTAGATTCTAAACA,0,1904012
icdC_predicted,0.14285714285714285,6,6,TAACACTTCAGCTTTATGCA,0,1899762
icdC_predicted,0.14285714285714285,6,6,TAAAACGGGTCTTACATTAA,0,1889879
icdC_predicted,0.14285714285714285,6,6,GTTCTTGTACAGTCAGTTAT,0,1895813
icdC_predicted,0.14285714285714285,6,6,GTTCGTCCGCCGCGTTCGTG,0,1897705
icdC_predicted,0.14285714285714285,6,6,GTTCAACTTGAATAGGACTT,0,1898554
icdC_predicted,0.14285714285714285,6,6,GTTAGTAGCATCCTACGCGA,0,1889393
icdC_predicted,0.14285714285714285,6,6,GTTAAGCCACACAGTCGTCA,0,1905968
icdC_predicted,0.14285714285714285,6,6,GTGGTTGCTGCCGGATTGAA,0,1907130
icdC_predicted,0.14285714285714285,6,6,GTGGTGACAGCTGACGTAGC,0,1885670
icdC_predicted,0.14285714285714285,6,6,GTGGGCACAGAAATGGCACT,0,1889770
icdC_predicted,0.14285714285714285,6,6,GTGGCATGTATCCAGACGAG,0,1896779
icdC_predicted,0.14285714285714285,6,6,GTGCCCTTAGAGGAGTCTAC,0,1894401
icdC_predicted,0.14285714285714285,6,6,GTGATGCTAGTAACACAAGA,0,1901139
icdC_predicted,0.14285714285714285,6,6,GTGACCATGCCGCTCGCGTA,0,1894155
icdC_predicted,0.14285714285714285,6,6,GTCTGCACAATAGCAAAAAG,0,1902500
icdC_predicted,0.14285714285714285,6,6,GTCGGCTGCTTCTGAGCCGA,0,1887553
icdC_predicted,0.14285714285714285,6,6,GTCGGCCGATTATTGCTCTC,0,1878945
icdC_predicted,0.14285714285714285,6,6,GTCGCCATGCCTCGCGGTTT,0,1905248
icdC_predicted,0.14285714285714285,6,6,GTCGATCACTGAGAGGTGGT,0,1884365
icdC_predicted,0.14285714285714285,6,6,GTCCTGAACGTAGGTAAGCG,0,1896356
icdC_predicted,0.14285714285714285,6,6,GTCCATTTGCCGGGCCGTAT,0,1884267
icdC_predicted,0.14285714285714285,6,6,GTCAGGGTTGCGCCCGGGGA,0,1881214
icdC_predicted,0.14285714285714285,6,6,GTATTGGGTTCGAGGTAGTG,0,1891409
icdC_predicted,0.14285714285714285,6,6,GTAGTGGTCCCGTAAGAGCG,0,1891637
icdC_predicted,0.14285714285714285,6,6,GTAGCGGGGTATGTGTACAC,0,1888992
icdC_predicted,0.14285714285714285,6,6,GTAGAAGTATTTGCAAAGCT,0,1881389
icdC_predicted,0.14285714285714285,6,6,GTACGGCTCCGTCGGGGTCC,0,1878023
icdC_predicted,0.14285714285714285,6,6,GTACCGGATTTGCTCCTTCG,0,1903060
icdC_predicted,0.14285714285714285,6,6,GTACAGCTAGTAGACCAGCC,0,1902347
icdC_predicted,0.14285714285714285,6,6,GTAAAGCGGTTGGGGCTGGA,0,1890588
icdC_predicted,0.14285714285714285,6,6,GGTTGCTGGGTTAAGGGAAG,0,1889206
icdC_predicted,0.14285714285714285,6,6,GGTTCGTGGTCTGCATTACG,0,1899017
icdC_predicted,0.14285714285714285,6,6,GGTGCAGGCCATCGTGCTCC,0,1900614
icdC_predicted,0.14285714285714285,6,6,GGTCGGCGTGTCGTGCACTC,0,1886427
icdC_predicted,0.14285714285714285,6,6,GGTCGATTGCCAGGATCCGG,0,1903962
icdC_predicted,0.14285714285714285,6,6,GGTCATATGTAGTCCTAAGT,0,1893277
icdC_predicted,0.14285714285714285,6,6,GGTAATATCAAAACCGGTGA,0,1878213
icdC_predicted,0.14285714285714285,6,6,GGTAACGAGAGGGTATGGAT,0,1899928
icdC_predicted,0.14285714285714285,6,6,GGGTGTGCACGGAACACTGT,0,1904995
icdC_predicted,0.14285714285714285,6,6,GGGTGATGGGTGTATGCGGA,0,1880896
icdC_predicted,0.14285714285714285,6,6,GGGGCTATGGTATCCTTGGG,0,1908216
icdC_predicted,0.14285714285714285,6,6,GGGGCCAGGGCCCTACAGTG,0,1907512
icdC_predicted,0.14285714285714285,6,6,GGGCTTTGCAATTGAGGTGT,0,1909180
icdC_predicted,0.14285714285714285,6,6,GGGCCGCGACGGCTGGTGAA,0,1887533
icdC_predicted,0.14285714285714285,6,6,GGGCACGGCATATTTTGTAG,0,1894309
icdC_predicted,0.14285714285714285,6,6,GGGAGTTTCGAGAGGGCTGC,0,1902951
icdC_predicted,0.14285714285714285,6,6,GGGACTGTGCTAAGTGTCTA,0,1904567
icdC_predicted,0.14285714285714285,6,6,GGGACGCAGTCGCCTGGTAA,0,1895156
icdC_predicted,0.14285714285714285,6,6,GGCTGTTTCGGACAATGGCA,0,1901568
icdC_predicted,0.14285714285714285,6,6,GGCTAGCTGTTATGAGAGAC,0,1901748
icdC_predicted,0.14285714285714285,6,6,GGCATGGCTCGGGTGTTCGG,0,1886581
icdC_predicted,0.14285714285714285,6,6,GGATTCTCCCAAAAGGCTAA,0,1902999
icdC_predicted,0.14285714285714285,6,6,GGATGAGGCCGCGGCGCGAA,0,1906786
icdC_predicted,0.14285714285714285,6,6,GGATAAACACTGCAGGAGCA,0,1891502
icdC_predicted,0.14285714285714285,6,6,GGAGTGTATTGGTTACCACT,0,1887162
icdC_predicted,0.14285714285714285,6,6,GGAGGTTGGATTAGCCTATT,0,1903506
icdC_predicted,0.14285714285714285,6,6,GGAGGTACCGGGGAACGGGG,0,1880600
icdC_predicted,0.14285714285714285,6,6,GCTTGCAGTGAATAGCTCCG,0,1908230
icdC_predicted,0.14285714285714285,6,6,GCTTCACGGGTTTGTGTATA,0,1890312
icdC_predicted,0.14285714285714285,6,6,GCTGTGGCTTTCACGTAGGG,0,1902517
icdC_predicted,0.14285714285714285,6,6,GCTGGACGAGGACCTCGGAG,0,1888859
icdC_predicted,0.14285714285714285,6,6,GCTGAAGACATACTAAGCCT,0,1895298
icdC_predicted,0.14285714285714285,6,6,GCTCTTGTGAGGGAATCGGC,0,1893889
icdC_predicted,0.14285714285714285,6,6,GCTCTGAAAGTATGCCCGCT,0,1908030
icdC_predicted,0.14285714285714285,6,6,GCTATCTTAGGCGAGCTCAG,0,1892897
icdC_predicted,0.14285714285714285,6,6,GCTAGGTGTCACAGGATGTA,0,1908067
icdC_predicted,0.14285714285714285,6,6,GCTACTCAGATATTCCTACA,0,1906379
icdC_predicted,0.14285714285714285,6,6,GCGTTAGTCTGTTATAGTAC,0,1878669
icdC_predicted,0.14285714285714285,6,6,GCGTGCCGTGATTGGCGCGC,0,1899465
icdC_predicted,0.14285714285714285,6,6,GCGGGGTGCATAGCTACTAT,0,1883198
icdC_predicted,0.14285714285714285,6,6,GCGGGGCGACTCCGCGAGTT,0,1882929
icdC_predicted,0.14285714285714285,6,6,GCGACTCTTACTGCTAGACA,0,1888134
icdC_predicted,0.14285714285714285,6,6,GCCTTTAGATGAGGCTAGAT,0,1906238
icdC_predicted,0.14285714285714285,6,6,GCCTTAGATACCACGCACTT,0,1895706
icdC_predicted,0.14285714285714285,6,6,GCCTGGTGTATCAATTGGAG,0,1889392
icdC_predicted,0.14285714285714285,6,6,GCCTGCTACATTCCTTCAAA,0,1878101
icdC_predicted,0.14285714285714285,6,6,GCCGGGTGTTAGCAATCGGG,0,1890856
icdC_predicted,0.14285714285714285,6,6,GCCCTTGACAGGCTCTTCGT,0,1898627
icdC_predicted,0.14285714285714285,6,6,GCCACTATATATAAGCTTCA,0,1902841
icdC_predicted,0.14285714285714285,6,6,GCATCACTATTTATGAATTG,0,1893631
icdC_predicted,0.14285714285714285,6,6,GCATAACGCAGACTTACAGT,0,1901960
icdC_predicted,0.14285714285714285,6,6,GCAGTTCGGGGGTAAGAAGA,0,1895903
icdC_predicted,0.14285714285714285,6,6,GCAGTCTCTAGTGACGTCAT,0,1898334
icdC_predicted,0.14285714285714285,6,6,GCAGATAGGTGATCACACAA,0,1886652
icdC_predicted,0.14285714285714285,6,6,GCAGACTATGACCTGTAATG,0,1896382
icdC_predicted,0.14285714285714285,6,6,GCACGGGGCCTCGTGCACCT,0,1898282
icdC_predicted,0.14285714285714285,6,6,GCACGCCAGCGACATCATGT,0,1892443
icdC_predicted,0.14285714285714285,6,6,GCAATCCGCTTGATTTCGGG,0,1890405
icdC_predicted,0.14285714285714285,6,6,GCAAGTGTAGTTGATTTCAC,0,1890627
icdC_predicted,0.14285714285714285,6,6,GCAAGGGAGCACATAAAACA,0,1890948
icdC_predicted,0.14285714285714285,6,6,GATTCCTCGCCCAGCGCCTA,0,1906061
icdC_predicted,0.14285714285714285,6,6,GATCACGTTGGTCGGCCCCA,0,1891853
icdC_predicted,0.14285714285714285,6,6,GATACCTCCCTGAGCCAGCT,0,1878477
icdC_predicted,0.14285714285714285,6,6,GATACAAAGTCCATCAAGGT,0,1879228
icdC_predicted,0.14285714285714285,6,6,GATAAATGCTTACCAGGAAC,0,1886076
icdC_predicted,0.14285714285714285,6,6,GAGTGCTGGGGGATGGGCAA,0,1886957
icdC_predicted,0.14285714285714285,6,6,GAGTCCGTTTGGTAGCGTCC,0,1893896
icdC_predicted,0.14285714285714285,6,6,GAGTAAACGGGAACTTTTAG,0,1881339
icdC_predicted,0.14285714285714285,6,6,GAGGTGTGGAATACACTACT,0,1907561
icdC_predicted,0.14285714285714285,6,6,GAGGGTGGCAAGAGAGAGGT,0,1888304
icdC_predicted,0.14285714285714285,6,6,GAGCTTTTGTTGTCTACCGT,0,1904627
icdC_predicted,0.14285714285714285,6,6,GAGCGCGGTTGCGGCTGGTG,0,1891291
icdC_predicted,0.14285714285714285,6,6,GAGAAAAATGGCTCTTTGGC,0,1884091
icdC_predicted,0.14285714285714285,6,6,GACTCTTACCCGAAACCTGC,0,1893722
icdC_predicted,0.14285714285714285,6,6,GACTCAGAGCCCCCGTCGTG,0,1890078
icdC_predicted,0.14285714285714285,6,6,GACGCCATCACCGCACGTAT,0,1888951
icdC_predicted,0.14285714285714285,6,6,GACAGCTAACGGGTTCTCCA,0,1900393
icdC_predicted,0.14285714285714285,6,6,GAATTAACCATCAATACGTT,0,1884256
icdC_predicted,0.14285714285714285,6,6,GAATGAGCGGGGCGTAGGGA,0,1880086
icdC_predicted,0.14285714285714285,6,6,GAAGGGTCTAGGGGTACAGG,0,1889712
icdC_predicted,0.14285714285714285,6,6,GAACTTTCCAAGATCTGGGA,0,1897214
icdC_predicted,0.14285714285714285,6,6,GAACTCATGAGGCGCCCGGG,0,1892199
icdC_predicted,0.14285714285714285,6,6,GAACCTGGGGAACTAGGGAT,0,1889193
icdC_predicted,0.14285714285714285,6,6,GAACACATAAAGCGTACCGA,0,1898763
icdC_predicted,0.14285714285714285,6,6,GAAACAGGGATGTTGATCCT,0,1891715
icdC_predicted,0.14285714285714285,6,6,GAAAACCGGACGTCCTTATT,0,1894882
icdC_predicted,0.14285714285714285,6,6,CTTTACGCATGAGCGATTGA,0,1903167
icdC_predicted,0.14285714285714285,6,6,CTTCAACCAAAACCTTTCTT,0,1898817
icdC_predicted,0.14285714285714285,6,6,CTTATCCGAAGTGAGCCACG,0,1901182
icdC_predicted,0.14285714285714285,6,6,CTTAGGTGTAACGTTAAATC,0,1901706
icdC_predicted,0.14285714285714285,6,6,CTTAAATCGACTAGCCGTCA,0,1886656
icdC_predicted,0.14285714285714285,6,6,CTGGCGTGCCCAGGTTATCA,0,1877978
icdC_predicted,0.14285714285714285,6,6,CTGGCATGCCCCACGCGTAA,0,1904535
icdC_predicted,0.14285714285714285,6,6,CTGCGTCAAGAACGGCTTCG,0,1885597
icdC_predicted,0.14285714285714285,6,6,CTGAGACAATCTAATGCCCA,0,1886353
icdC_predicted,0.14285714285714285,6,6,CTGACCGTCATACTATTTTA,0,1896529
icdC_predicted,0.14285714285714285,6,6,CTCTATATAGGGTGATGTTG,0,1890756
icdC_predicted,0.14285714285714285,6,6,CTCGGCCCCCCATATAGCAA,0,1896622
icdC_predicted,0.14285714285714285,6,6,CTCCCTTGGTTGGCACAGAT,0,1907996
icdC_predicted,0.14285714285714285,6,6,CTCATCTTGCGCTAGATAAG,0,1898948
icdC_predicted,0.14285714285714285,6,6,CTCAGTGGAACGACGATACA,0,1909032
icdC_predicted,0.14285714285714285,6,6,CTATTCGACACCTTTGCTTA,0,1882641
icdC_predicted,0.14285714285714285,6,6,CTATCCTCGTTCGACCCTGG,0,1898366
icdC_predicted,0.14285714285714285,6,6,CTATAAATTAGATCCCAACT,0,1906574
icdC_predicted,0.14285714285714285,6,6,CTAGCGCTGGGGGTTGGAAG,0,1905274
icdC_predicted,0.14285714285714285,6,6,CTACTTGAATCAGTTGAATG,0,1897677
icdC_predicted,0.14285714285714285,6,6,CTACGGGACCGCAGGACCTA,0,1889062
icdC_predicted,0.14285714285714285,6,6,CTACGAAGTGAGCATTCGAA,0,1885561
icdC_predicted,0.14285714285714285,6,6,CTACATCTTGCTAATGCAAA,0,1898953
icdC_predicted,0.14285714285714285,6,6,CTAATTCGAGCCTAAAACGT,0,1891360
icdC_predicted,0.14285714285714285,6,6,CTAAGCAGGTAGAGCGGATA,0,1906541
icdC_predicted,0.14285714285714285,6,6,CGTTAACCAAAGAGTAGACT,0,1879116
icdC_predicted,0.14285714285714285,6,6,CGTGGCTGACTTCGGCCCAA,0,1907511
icdC_predicted,0.14285714285714285,6,6,CGTACGCCTTGTTCGTGTGA,0,1892287
icdC_predicted,0.14285714285714285,6,6,CGGTGCCTTCCTTGGAGACA,0,1884056
icdC_predicted,0.14285714285714285,6,6,CGGGGCGAACCCATCTAGTG,0,1888461
icdC_predicted,0.14285714285714285,6,6,CGGGCAGTCCTAATTGCGCT,0,1888551
icdC_predicted,0.14285714285714285,6,6,CGGCTAGCGAACACAATACC,0,1890473
icdC_predicted,0.14285714285714285,6,6,CGGATTAGAATGGCGGTGAA,0,1905855
icdC_predicted,0.14285714285714285,6,6,CGGATACTGTGTGTGGAGGG,0,1905548
icdC_predicted,0.14285714285714285,6,6,CGGACACTGATGGTAACTGG,0,1903372
icdC_predicted,0.14285714285714285,6,6,CGGAAGTTATTGGCAGAACA,0,1905790
icdC_predicted,0.14285714285714285,6,6,CGCTTAGGTCTAGGGGAGCA,0,1900938
icdC_predicted,0.14285714285714285,6,6,CGCTCTCATTGGTTGTGAGA,0,1899094
icdC_predicted,0.14285714285714285,6,6,CGCCTTGCGCTCACCATAGC,0,1888790
icdC_predicted,0.14285714285714285,6,6,CGCCCCGCATTCGTCGATCC,0,1891841
icdC_predicted,0.14285714285714285,6,6,CGCCCACGCGGCTAACGGAT,0,1883029
icdC_predicted,0.14285714285714285,6,6,CGCCATAAAGCGAGTGGTTT,0,1908223
icdC_predicted,0.14285714285714285,6,6,CGCATAACGGGGCCGACGTG,0,1901104
icdC_predicted,0.14285714285714285,6,6,CGATGGTCACATGAATCTGG,0,1880911
icdC_predicted,0.14285714285714285,6,6,CGATAATGGTGGAAACCGGA,0,1902440
icdC_predicted,0.14285714285714285,6,6,CGAGCAAGTCTTATGGTCGG,0,1907176
icdC_predicted,0.14285714285714285,6,6,CGAAGGTGTTGGCAATGGCG,0,1898643
icdC_predicted,0.14285714285714285,6,6,CGAACCCCTCGTTTGTTTAA,0,1890216
icdC_predicted,0.14285714285714285,6,6,CCTTCCTGAAGGAAACTCGA,0,1882665
icdC_predicted,0.14285714285714285,6,6,CCTCAGGAAGGTTAATGTAA,0,1896107
icdC_predicted,0.14285714285714285,6,6,CCTCAAGCGGAGGCTCATAT,0,1890435
icdC_predicted,0.14285714285714285,6,6,CCTAGGGGTAATCCCTTGAA,0,1904647
icdC_predicted,0.14285714285714285,6,6,CCTAGGAGCACCGTGAGCCC,0,1881317
icdC_predicted,0.14285714285714285,6,6,CCGTGTTACTCGGTCCATAA,0,1905231
icdC_predicted,0.14285714285714285,6,6,CCGTGGCTCCACCCACGGTA,0,1878986
icdC_predicted,0.14285714285714285,6,6,CCGTAATCTACGTTCAACGG,0,1895673
icdC_predicted,0.14285714285714285,6,6,CCGATGGTATACAATGGTAC,0,1907779
icdC_predicted,0.14285714285714285,6,6,CCGAACTTATTTGCCGCATC,0,1897310
icdC_predicted,0.14285714285714285,6,6,CCCTTGCACATAGCCCTCTA,0,1900489
icdC_predicted,0.14285714285714285,6,6,CCCATGCTTAACGGTTCGGT,0,1878258
icdC_predicted,0.14285714285714285,6,6,CCCATCGAGAGAGTCAGCGT,0,1904732
icdC_predicted,0.14285714285714285,6,6,CCCAAACCTATATGTCCATC,0,1884990
icdC_predicted,0.14285714285714285,6,6,CCATCCCTGTGTCAAGCATG,0,1890339
icdC_predicted,0.14285714285714285,6,6,CCATCACCAGCGGACTTCTC,0,1887738
icdC_predicted,0.14285714285714285,6,6,CCACTCTTCTGTAGTTGGCA,0,1891193
icdC_predicted,0.14285714285714285,6,6,CATGCAGTTGACGCGACGAA,0,1899833
icdC_predicted,0.14285714285714285,6,6,CATGAGACGCGCCGAATGGC,0,1890864
icdC_predicted,0.14285714285714285,6,6,CATCCCTCTCAGGAACCGTT,0,1900148
icdC_predicted,0.14285714285714285,6,6,CATCCCGGACGTCCCAGTTT,0,1897302
icdC_predicted,0.14285714285714285,6,6,CATATTTCTACCATCTGGTG,0,1900956
icdC_predicted,0.14285714285714285,6,6,CAGGTTCAGGGTTTATTTGG,0,1898149
icdC_predicted,0.14285714285714285,6,6,CAGGAATCACCGCAACCGAA,0,1905428
icdC_predicted,0.14285714285714285,6,6,CACTTTGGTCTCACCGGAGC,0,1877951
icdC_predicted,0.14285714285714285,6,6,CACTGAAATTGCCTGGACCT,0,1897383
icdC_predicted,0.14285714285714285,6,6,CACATATGCAGCGTTTCTTG,0,1900454
icdC_predicted,0.14285714285714285,6,6,CACACGAAGCCTCGCTTGGT,0,1891773
icdC_predicted,0.14285714285714285,6,6,CAATTGCATTATCGCCTCGC,0,1902933
icdC_predicted,0.14285714285714285,6,6,CAAGTAGACATAAATTCTCG,0,1901298
icdC_predicted,0.14285714285714285,6,6,CAAGAATAGTACGGGCTGTT,0,1907177
icdC_predicted,0.14285714285714285,6,6,CAACGTTAGCTGCCGCTTAC,0,1895918
icdC_predicted,0.14285714285714285,6,6,CAACCTGGATATGGTACGGA,0,1907710
icdC_predicted,0.14285714285714285,6,6,CAACCATGCTGGTTACCCTT,0,1900244
icdC_predicted,0.14285714285714285,6,6,CAAACCGAGGACGATCTACG,0,1893636
icdC_predicted,0.14285714285714285,6,6,ATTTTAATAAAGTTATGCTA,0,1895914
icdC_predicted,0.14285714285714285,6,6,ATTTGCCCGGGCTCACTCGT,0,1898971
icdC_predicted,0.14285714285714285,6,6,ATTGGCCGCGCCTGTAAGCA,0,1900611
icdC_predicted,0.14285714285714285,6,6,ATTGACTTGGCCTGCAGCTC,0,1899888
icdC_predicted,0.14285714285714285,6,6,ATTCAAATCGTACCGCTGAC,0,1904767
icdC_predicted,0.14285714285714285,6,6,ATTAGTCACGCTTAGAGTCA,0,1887956
icdC_predicted,0.14285714285714285,6,6,ATTAGGGTAAGATTATAGGT,0,1894988
icdC_predicted,0.14285714285714285,6,6,ATTAAAGTACGACAACTGCA,0,1893278
icdC_predicted,0.14285714285714285,6,6,ATGTACACCCAGGAATTCTT,0,1881898
icdC_predicted,0.14285714285714285,6,6,ATGCTGGGGCGGGCCTCGAA,0,1906345
icdC_predicted,0.14285714285714285,6,6,ATGCGCTTGTCTGTTCGTGT,0,1886899
icdC_predicted,0.14285714285714285,6,6,ATGCCGAATACTCACAGCGT,0,1903587
icdC_predicted,0.14285714285714285,6,6,ATGATGATTTTGAACTGTAA,0,1904983
icdC_predicted,0.14285714285714285,6,6,ATGATACCGTTGATGGCGGT,0,1888568
icdC_predicted,0.14285714285714285,6,6,ATGACTCGATGGCTTGACTA,0,1901300
icdC_predicted,0.14285714285714285,6,6,ATCTTTTGCGCACCGATCTT,0,1893875
icdC_predicted,0.14285714285714285,6,6,ATCTTGACTTCATCTGATGA,0,1881437
icdC_predicted,0.14285714285714285,6,6,ATCTAGATTGCGTAAAGGAC,0,1892997
icdC_predicted,0.14285714285714285,6,6,ATCGTCCAAGATTGCGTTTC,0,1878197
icdC_predicted,0.14285714285714285,6,6,ATCGGGCGGCACGACGTCAC,0,1895353
icdC_predicted,0.14285714285714285,6,6,ATCCCCGGCTTCCCGTACTT,0,1881252
icdC_predicted,0.14285714285714285,6,6,ATCCAGTTTAAACGTAGTAG,0,1891214
icdC_predicted,0.14285714285714285,6,6,ATCAGTTGGGATTCTGAAAC,0,1882322
icdC_predicted,0.14285714285714285,6,6,ATCACATAGTATCTCCGTAA,0,1904013
icdC_predicted,0.14285714285714285,6,6,ATAGTGAACCTCCCAAGCAT,0,1898979
icdC_predicted,0.14285714285714285,6,6,ATAGGGGGTATTCGAATAAT,0,1903334
icdC_predicted,0.14285714285714285,6,6,ATACACGTTAGCGGCCCCCC,0,1908876
icdC_predicted,0.14285714285714285,6,6,ATAATGTGGTTCAGAGTGCG,0,1899003
icdC_predicted,0.14285714285714285,6,6,ATAAGAGATTACAGGATTAC,0,1902535
icdC_predicted,0.14285714285714285,6,6,ATAACCAGCATGGGCATTGA,0,1895834
icdC_predicted,0.14285714285714285,6,6,AGTTTGGCGTAATAAGGTTG,0,1905924
icdC_predicted,0.14285714285714285,6,6,AGTGCCCAGCGTCAGAGGGG,0,1896802
icdC_predicted,0.14285714285714285,6,6,AGTGCATCGTGAAGAGGAGG,0,1888059
icdC_predicted,0.14285714285714285,6,6,AGTCGGGTCCGTATTTCAGC,0,1902173
icdC_predicted,0.14285714285714285,6,6,AGTAATCACCGAAATATAGA,0,1909402
icdC_predicted,0.14285714285714285,6,6,AGGTTCGACTGCGAGCACCC,0,1893776
icdC_predicted,0.14285714285714285,6,6,AGGTGTACTATGTTTGTGAT,0,1894036
icdC_predicted,0.14285714285714285,6,6,AGGTGACGCCTGTACTAAGG,0,1895199
icdC_predicted,0.14285714285714285,6,6,AGGTATCGCGTTAAAGATAA,0,1885518
icdC_predicted,0.14285714285714285,6,6,AGGGTGATCCACGCTGTACC,0,1899652
icdC_predicted,0.14285714285714285,6,6,AGGGTAATTGGACCGACCCA,0,1908923
icdC_predicted,0.14285714285714285,6,6,AGGGGTAAGGTCTGAATCGT,0,1879624
icdC_predicted,0.14285714285714285,6,6,AGGGACGTCCACCGACCCAC,0,1894291
icdC_predicted,0.14285714285714285,6,6,AGGATTAATTGCGTTGCAAT,0,1881589
icdC_predicted,0.14285714285714285,6,6,AGGAACGGAGGGTTATTTGG,0,1896165
icdC_predicted,0.14285714285714285,6,6,AGCTACTATATCTCATGTAG,0,1894055
icdC_predicted,0.14285714285714285,6,6,AGCGGGATTTTGATCTATTG,0,1881310
icdC_predicted,0.14285714285714285,6,6,AGCGCATGGAGGGACTGGTT,0,1880220
icdC_predicted,0.14285714285714285,6,6,AGCCCCAGAAAGAGTATGAC,0,1905029
icdC_predicted,0.14285714285714285,6,6,AGCATCCATTCATTTGCGGA,0,1893259
icdC_predicted,0.14285714285714285,6,6,AGCAAGGATGTGCGATCTAG,0,1894362
icdC_predicted,0.14285714285714285,6,6,AGATGCAGGACATATTTAGT,0,1893935
icdC_predicted,0.14285714285714285,6,6,AGATGAAGATTGTCCTAGTG,0,1891056
icdC_predicted,0.14285714285714285,6,6,AGATAGGTACCGCTATATCG,0,1879600
icdC_predicted,0.14285714285714285,6,6,AGAGGCTCGAGCATCTGCGG,0,1898301
icdC_predicted,0.14285714285714285,6,6,AGAATCAAATGAACCTCGCC,0,1897444
icdC_predicted,0.14285714285714285,6,6,AGAACTAGGACGCTGAACAG,0,1907986
icdC_predicted,0.14285714285714285,6,6,AGAAATTGGGTCAGAGGATC,0,1900868
icdC_predicted,0.14285714285714285,6,6,ACTTGTCCGAGACCTGATGC,0,1884667
icdC_predicted,0.14285714285714285,6,6,ACTTGTATGCGTACGACTAC,0,1904269
icdC_predicted,0.14285714285714285,6,6,ACTTACTGCAAATCTACGTG,0,1907993
icdC_predicted,0.14285714285714285,6,6,ACTTAAATCGGCTCTCTCGA,0,1908495
icdC_predicted,0.14285714285714285,6,6,ACTTAAAGGATATAATTATT,0,1894982
icdC_predicted,0.14285714285714285,6,6,ACTGTCAGGCTCAATGGTAA,0,1887196
icdC_predicted,0.14285714285714285,6,6,ACTGAGTATATGTTCGGGCG,0,1890444
icdC_predicted,0.14285714285714285,6,6,ACTGAGGTTTGAGCGCGTTC,0,1901376
icdC_predicted,0.14285714285714285,6,6,ACTATTTCGTTTAAAGAATA,0,1905928
icdC_predicted,0.14285714285714285,6,6,ACTAGTGAAACCAGTGACCA,0,1893127
icdC_predicted,0.14285714285714285,6,6,ACTAGATAATCTGCTATACA,0,1898795
icdC_predicted,0.14285714285714285,6,6,ACGGCTACAGTACTGACGTT,0,1898000
icdC_predicted,0.14285714285714285,6,6,ACGGAAATCTCCGATTAGTT,0,1895306
icdC_predicted,0.14285714285714285,6,6,ACGCCTTCGAATTTTGACAT,0,1895384
icdC_predicted,0.14285714285714285,6,6,ACGCCTGATCGAAAATTAGT,0,1888162
icdC_predicted,0.14285714285714285,6,6,ACGATATTGCTCCCCGGCAG,0,1909178
icdC_predicted,0.14285714285714285,6,6,ACCTATTGCGCCTGCCGGGC,0,1888519
icdC_predicted,0.14285714285714285,6,6,ACCCAGGGTCATTACAGAAC,0,1894011
icdC_predicted,0.14285714285714285,6,6,ACCATGGCGCACCGGTATGC,0,1879814
icdC_predicted,0.14285714285714285,6,6,ACATTTTAGGGTCGCAGTGG,0,1900196
icdC_predicted,0.14285714285714285,6,6,ACAGCCGAGCACAAATGGGA,0,1887616
icdC_predicted,0.14285714285714285,6,6,ACACGTCTAGCCGATATAAT,0,1901937
icdC_predicted,0.14285714285714285,6,6,ACACGCATCAGTTTCCTATC,0,1884518
icdC_predicted,0.14285714285714285,6,6,ACACATCGGTCCCTATGCGA,0,1892767
icdC_predicted,0.14285714285714285,6,6,AATTACCGCAAGACGCTCAA,0,1907751
icdC_predicted,0.14285714285714285,6,6,AATGCGGATTCATCTCCTAG,0,1905880
icdC_predicted,0.14285714285714285,6,6,AATCGCTGAGTGAATTAGAT,0,1884578
icdC_predicted,0.14285714285714285,6,6,AATAAGGTTCAACATCTGCT,0,1907021
icdC_predicted,0.14285714285714285,6,6,AAGGTTCAACGTTATATTTC,0,1895808
icdC_predicted,0.14285714285714285,6,6,AAGGTGATTAGAAGCGAAGT,0,1897784
icdC_predicted,0.14285714285714285,6,6,AAGGAAACGATTAGAAACAG,0,1897623
icdC_predicted,0.14285714285714285,6,6,AAGAGTTTTCTACAGCTTAG,0,1886604
icdC_predicted,0.14285714285714285,6,6,AAGAGCATGGCTGGTCGTAC,0,1884601
icdC_predicted,0.14285714285714285,6,6,AAGAAGATATCTTGGCCGGG,0,1887073
icdC_predicted,0.14285714285714285,6,6,AACTATGGTATTGCACACCA,0,1890280
icdC_predicted,0.14285714285714285,6,6,AACGCTCTCAAGTTTATTCC,0,1885157
icdC_predicted,0.14285714285714285,6,6,AACCTACTGAGAGGAGCTTG,0,1893280
icdC_predicted,0.14285714285714285,6,6,AACCGCCATCTCCCCGCGCC,0,1882877
icdC_predicted,0.14285714285714285,6,6,AACCATTTGCTCAGGCTGGA,0,1908246
icdC_predicted,0.14285714285714285,6,6,AACAACTCCAGGACTTACAT,0,1887334
icdC_predicted,0.14285714285714285,6,6,AAATCCCGACAATGATGTAT,0,1883886
icdC_predicted,0.14285714285714285,6,6,AAAGTGCACAACAGGCTTAC,0,1880289
icdC_predicted,0.14285714285714285,6,6,AAAGGAGGGGCTACTATATA,0,1891561
icdC_predicted,0.14285714285714285,6,6,AAAGCTTCGACCCGTCGGTG,0,1887181
icdC_predicted,0.14285714285714285,6,6,AAAACAGGTGCTAGGCGTGT,0,1885761
icdC_predicted,0.16666666666666666,5,5,TTTGGTGCAGTACGCTACCT,0,1887744
icdC_predicted,0.16666666666666666,5,5,TTTGCTTGTTTCAAGGGACG,0,1898486
icdC_predicted,0.16666666666666666,5,5,TTTGCACGGACACCATGAAC,0,1888326
icdC_predicted,0.16666666666666666,5,5,TTTCACTATAAGTACGCGTT,0,1888405
icdC_predicted,0.16666666666666666,5,5,TTTATTGTTGGCCCGTGGTA,0,1904581
icdC_predicted,0.16666666666666666,5,5,TTTATTCTAGTACCTCCGAG,0,1903549
icdC_predicted,0.16666666666666666,5,5,TTTATCCGTTCCTCTCGTCG,0,1892649
icdC_predicted,0.16666666666666666,5,5,TTGTTACTAGGGAATCCGGA,0,1892607
icdC_predicted,0.16666666666666666,5,5,TTGGCGACGGCTCGACTGCA,0,1882287
icdC_predicted,0.16666666666666666,5,5,TTGGAGTTCGTTGTAATCTA,0,1884298
icdC_predicted,0.16666666666666666,5,5,TTGCCATCGTAATCATTTTA,0,1896528
icdC_predicted,0.16666666666666666,5,5,TTGCAGACAAGGATTAAATG,0,1895130
icdC_predicted,0.16666666666666666,5,5,TTGAGCAACCACCGTAGTGA,0,1887419
icdC_predicted,0.16666666666666666,5,5,TTGAGAATTCTCATCTCCGT,0,1883475
icdC_predicted,0.16666666666666666,5,5,TTGAGAATCTTTGATCTCCC,0,1878581
icdC_predicted,0.16666666666666666,5,5,TTCGGTAGTTCTTGCACCAG,0,1888317
icdC_predicted,0.16666666666666666,5,5,TTCGCTGTCTATGGGAACCG,0,1903548
icdC_predicted,0.16666666666666666,5,5,TTCGCGACATTGTTCGCTAT,0,1902934
icdC_predicted,0.16666666666666666,5,5,TTCGATGTGCGTACAGAGTG,0,1899696
icdC_predicted,0.16666666666666666,5,5,TTCGAAATTACACACGTGCT,0,1883312
icdC_predicted,0.16666666666666666,5,5,TTCATCAGTTGCATCCTTGG,0,1879737
icdC_predicted,0.16666666666666666,5,5,TTATCCGGTTCTGGACTGAG,0,1883228
icdC_predicted,0.16666666666666666,5,5,TTATAGTTGAAACAATATTG,0,1880084
icdC_predicted,0.16666666666666666,5,5,TTAGGCTCAAAGTGTTGGAT,0,1903989
icdC_predicted,0.16666666666666666,5,5,TTACTGAGCAACAAAGAGGT,0,1898449
icdC_predicted,0.16666666666666666,5,5,TTAAGTCGATTGTATTGATG,0,1906780
icdC_predicted,0.16666666666666666,5,5,TGTTCGTTGGGTTCGCAGTA,0,1894111
icdC_predicted,0.16666666666666666,5,5,TGTTCGCAGGTGATGTGCGC,0,1903135
icdC_predicted,0.16666666666666666,5,5,TGTGATTTGGTGGCGAGCCG,0,1884782
icdC_predicted,0.16666666666666666,5,5,TGTCGTGTTATAGTGTGCGG,0,1885308
icdC_predicted,0.16666666666666666,5,5,TGTCGTCAGGCGTATCAGGA,0,1900457
icdC_predicted,0.16666666666666666,5,5,TGTCCTCAGGCTTGAGGCGG,0,1893645
icdC_predicted,0.16666666666666666,5,5,TGTACGTATATGAGAAACTA,0,1906610
icdC_predicted,0.16666666666666666,5,5,TGTACGGTATGCGCTCCGTT,0,1901611
icdC_predicted,0.16666666666666666,5,5,TGTAAGTTAACATCGACGTT,0,1897267
icdC_predicted,0.16666666666666666,5,5,TGTAAATCAAAGTCAACAAA,0,1884876
icdC_predicted,0.16666666666666666,5,5,TGGTCCCAGCGATCTGTCGG,0,1894965
icdC_predicted,0.16666666666666666,5,5,TGGTCAGCTTAGTAGCAGAA,0,1884280
icdC_predicted,0.16666666666666666,5,5,TGGTACTTCCCATGGGCTGC,0,1885230
icdC_predicted,0.16666666666666666,5,5,TGGTACGTCCGCCTCGACTT,0,1894439
icdC_predicted,0.16666666666666666,5,5,TGGGTCATTAAACGTCGTTA,0,1906698
icdC_predicted,0.16666666666666666,5,5,TGGGTATAGCATCTCGGCAA,0,1908050
icdC_predicted,0.16666666666666666,5,5,TGGGGTCTCCCGTCCTCGTG,0,1900783
icdC_predicted,0.16666666666666666,5,5,TGGGGGCATTTTCATAGTGG,0,1898983
icdC_predicted,0.16666666666666666,5,5,TGGGGCCAGTAATAGCATTT,0,1891289
icdC_predicted,0.16666666666666666,5,5,TGGCTTGATCGCTACACAGA,0,1884624
icdC_predicted,0.16666666666666666,5,5,TGGCTCGGCGAATCAAACTG,0,1888111
icdC_predicted,0.16666666666666666,5,5,TGGCGGGCATGCTCCCGACC,0,1891799
icdC_predicted,0.16666666666666666,5,5,TGGCCCTGGGTAGCCGTCAC,0,1889228
icdC_predicted,0.16666666666666666,5,5,TGGCCCTCGGGCGCCAGTCT,0,1903239
icdC_predicted,0.16666666666666666,5,5,TGGAGGGTCGTTGTCATTTA,0,1892205
icdC_predicted,0.16666666666666666,5,5,TGCCTCCTTACGTCGCTTGA,0,1901275
icdC_predicted,0.16666666666666666,5,5,TGCCGGTATACCATAGCGAG,0,1894463
icdC_predicted,0.16666666666666666,5,5,TGATTTATGGACCTTGGGTA,0,1905214
icdC_predicted,0.16666666666666666,5,5,TGATCTCTGCCACTCTGGCT,0,1908885
icdC_predicted,0.16666666666666666,5,5,TGAGAATACAGACCATGTAA,0,1895578
icdC_predicted,0.16666666666666666,5,5,TGACTTCGCGTGCAAAAATA,0,1907760
icdC_predicted,0.16666666666666666,5,5,TGAATCCCTGCATGGATTTA,0,1883486
icdC_predicted,0.16666666666666666,5,5,TGAAGGGCGTTATTCGCGTT,0,1885412
icdC_predicted,0.16666666666666666,5,5,TGAAATTCGCTTCTGGCACC,0,1886348
icdC_predicted,0.16666666666666666,5,5,TCTTGAGGTGCTACATTGTA,0,1896279
icdC_predicted,0.16666666666666666,5,5,TCTTCTGAATAAGTGTTAAT,0,1895522
icdC_predicted,0.16666666666666666,5,5,TCTTCGGCTCAATCCGCTAT,0,1900785
icdC_predicted,0.16666666666666666,5,5,TCTTCCGTCGCTCCATCATG,0,1886650
icdC_predicted,0.16666666666666666,5,5,TCTTCCCAGGAAGCCCTTAA,0,1882137
icdC_predicted,0.16666666666666666,5,5,TCTGCGCTTTTGCGCTGACA,0,1897725
icdC_predicted,0.16666666666666666,5,5,TCTAAGTACACGCCTTTATG,0,1906865
icdC_predicted,0.16666666666666666,5,5,TCGTTCTTAAGGAGCATGAT,0,1898624
icdC_predicted,0.16666666666666666,5,5,TCGTGGGTTCCACGACCGAG,0,1909156
icdC_predicted,0.16666666666666666,5,5,TCGTATGTACAGGTATGTGT,0,1887701
icdC_predicted,0.16666666666666666,5,5,TCGTAAAAGGATAGATTGTA,0,1904515
icdC_predicted,0.16666666666666666,5,5,TCGGGGTGCCTCGCAAATGA,0,1877967
icdC_predicted,0.16666666666666666,5,5,TCGCCCTTACAGTTTAATGT,0,1897129
icdC_predicted,0.16666666666666666,5,5,TCGCCATGCCCAGCCGACTT,0,1889400
icdC_predicted,0.16666666666666666,5,5,TCGATTCGGCGCGACCTTGA,0,1888434
icdC_predicted,0.16666666666666666,5,5,TCGAGCTCTAATTACGAGAC,0,1889380
icdC_predicted,0.16666666666666666,5,5,TCGAGATTTAACGCATGCTA,0,1879740
icdC_predicted,0.16666666666666666,5,5,TCCTTATAGCCGTTTCTTTG,0,1892366
icdC_predicted,0.16666666666666666,5,5,TCCGACGTCTTGCCTCCTCA,0,1885402
icdC_predicted,0.16666666666666666,5,5,TCCCGAAACGGGTTTAACCG,0,1888724
icdC_predicted,0.16666666666666666,5,5,TCCCCTGGAACTTAAGGCCT,0,1893504
icdC_predicted,0.16666666666666666,5,5,TCCATGACGAGTTAAGGAAT,0,1878449
icdC_predicted,0.16666666666666666,5,5,TCATTACTATATAAGCACAG,0,1899878
icdC_predicted,0.16666666666666666,5,5,TCATGTGTAGTGCACCGAAT,0,1901147
icdC_predicted,0.16666666666666666,5,5,TCATGTACGCGATATATATA,0,1888307
icdC_predicted,0.16666666666666666,5,5,TCATGCCTGCAGTCTGTCGT,0,1903134
icdC_predicted,0.16666666666666666,5,5,TCACTCGCTGAACTGGGCGT,0,1908322
icdC_predicted,0.16666666666666666,5,5,TCACTATTGGCCGTCCAGGA,0,1893655
icdC_predicted,0.16666666666666666,5,5,TCAATCCCGAGCATTGTAAC,0,1890485
icdC_predicted,0.16666666666666666,5,5,TCAAAATGCCGCCCTAATGT,0,1884192
icdC_predicted,0.16666666666666666,5,5,TATTCCACTCATTTATTCAG,0,1888328
icdC_predicted,0.16666666666666666,5,5,TATTATAGAGCTATAAGCGA,0,1903750
icdC_predicted,0.16666666666666666,5,5,TATTACGCAAATAAATGCTC,0,1888369
icdC_predicted,0.16666666666666666,5,5,TATGACTCGCTCGGGAGTTC,0,1888876
icdC_predicted,0.16666666666666666,5,5,TAGGCAAATTGCATGCCCGG,0,1881189
icdC_predicted,0.16666666666666666,5,5,TAGCTCCATGGAATTTCTCG,0,1901757
icdC_predicted,0.16666666666666666,5,5,TAGCGCCGGCTCAATATTCG,0,1900850
icdC_predicted,0.16666666666666666,5,5,TACTCCCGGGGGAAACGTGC,0,1886915
icdC_predicted,0.16666666666666666,5,5,TACTAACTGGATTAAACGCA,0,1880492
icdC_predicted,0.16666666666666666,5,5,TACGGTTCGAAACCACACCT,0,1883279
icdC_predicted,0.16666666666666666,5,5,TAAGGCTAGACGGCGTTACT,0,1886737
icdC_predicted,0.16666666666666666,5,5,TAAGATGAACGCTAACTTTA,0,1889837
icdC_predicted,0.16666666666666666,5,5,TAAAGTGCTGTACCCACTAG,0,1906332
icdC_predicted,0.16666666666666666,5,5,TAAAGCTCTTGTCAAGCTCG,0,1893449
icdC_predicted,0.16666666666666666,5,5,GTTTCCACAAATGGTATTGG,0,1900217
icdC_predicted,0.16666666666666666,5,5,GTTGGGGAGAGCCGCTTTTT,0,1893876
icdC_predicted,0.16666666666666666,5,5,GTTGATTTTCATGGTCTTAA,0,1908858
icdC_predicted,0.16666666666666666,5,5,GTTGAGGTCTTTTTCACAGC,0,1895165
icdC_predicted,0.16666666666666666,5,5,GTTATGCCAAGAGTGTTATG,0,1895762
icdC_predicted,0.16666666666666666,5,5,GTTACAACGCGTCTTTCGAT,0,1894568
icdC_predicted,0.16666666666666666,5,5,GTGTTGCTTCAGTTTTTATC,0,1893753
icdC_predicted,0.16666666666666666,5,5,GTGTGGTCCAACCGGCTTTG,0,1881880
icdC_predicted,0.16666666666666666,5,5,GTGTGCTTACGCGTTTTCCA,0,1895514
icdC_predicted,0.16666666666666666,5,5,GTGTCCCCAAATGGTTTCGT,0,1889581
icdC_predicted,0.16666666666666666,5,5,GTGGTCGAACGGCGGCAAAG,0,1887780
icdC_predicted,0.16666666666666666,5,5,GTGGCCCAGCCATGCAGGAC,0,1881205
icdC_predicted,0.16666666666666666,5,5,GTGGAAGACCCAGGGCATGT,0,1879934
icdC_predicted,0.16666666666666666,5,5,GTGCAAGGGCGATGCCGACA,0,1883939
icdC_predicted,0.16666666666666666,5,5,GTGAGTGGGATTCCGGACCG,0,1890917
icdC_predicted,0.16666666666666666,5,5,GTGAAACGGCTCTATGTCCC,0,1896777
icdC_predicted,0.16666666666666666,5,5,GTCTTTACTCACGAACAAGT,0,1897284
icdC_predicted,0.16666666666666666,5,5,GTCTCAATTCACCAAGACGC,0,1885840
icdC_predicted,0.16666666666666666,5,5,GTCGTAACGTCTTTAACACA,0,1899840
icdC_predicted,0.16666666666666666,5,5,GTCGGGGGACCTTGTGTATC,0,1909091
icdC_predicted,0.16666666666666666,5,5,GTCGGAACGTAAAGCACGTT,0,1886019
icdC_predicted,0.16666666666666666,5,5,GTCCGGATAATCCTCGTCGG,0,1897576
icdC_predicted,0.16666666666666666,5,5,GTCCAGCGGCTCAATGGGGG,0,1886400
icdC_predicted,0.16666666666666666,5,5,GTCATATGGCCCGCGAGACT,0,1879217
icdC_predicted,0.16666666666666666,5,5,GTAGGTACTGGTCCCCGGCA,0,1906730
icdC_predicted,0.16666666666666666,5,5,GTAGCCCAAGCTTCAACCAT,0,1887200
icdC_predicted,0.16666666666666666,5,5,GTAGAGGCCCTCAGGGGTGT,0,1890884
icdC_predicted,0.16666666666666666,5,5,GTACCCTTTTATTTTACTTT,0,1880396
icdC_predicted,0.16666666666666666,5,5,GTACCACGCGCGCGCCACTA,0,1896010
icdC_predicted,0.16666666666666666,5,5,GTACACCCTTGGCGACAGAA,0,1902250
icdC_predicted,0.16666666666666666,5,5,GTAACCGAGCGACTGTCGAC,0,1903639
icdC_predicted,0.16666666666666666,5,5,GTAAAGGAATACGTAGTACG,0,1887284
icdC_predicted,0.16666666666666666,5,5,GGTTTTCCTGCTGCGGAGGT,0,1907580
icdC_predicted,0.16666666666666666,5,5,GGTTTGTAAGGGCGGGATAG,0,1884773
icdC_predicted,0.16666666666666666,5,5,GGTGTTGCGCCGATATGCTT,0,1908857
icdC_predicted,0.16666666666666666,5,5,GGTGTCAGACCTCACCAGAA,0,1906279
icdC_predicted,0.16666666666666666,5,5,GGTGCGTGGCAAAGGGCTTG,0,1906666
icdC_predicted,0.16666666666666666,5,5,GGTGCACTACGTGAAGTGGC,0,1886698
icdC_predicted,0.16666666666666666,5,5,GGTGCACCCAAGTCGAGAAC,0,1895795
icdC_predicted,0.16666666666666666,5,5,GGGTTTGGGAGAGCCCCAAG,0,1880299
icdC_predicted,0.16666666666666666,5,5,GGGTTGCAGACGAGGGCGCG,0,1892266
icdC_predicted,0.16666666666666666,5,5,GGGGCGCTCTGAGCGCACAG,0,1902443
icdC_predicted,0.16666666666666666,5,5,GGGGAGTGCACTGATACGTA,0,1906946
icdC_predicted,0.16666666666666666,5,5,GGGCAGTGACGAGGCATGAG,0,1891280
icdC_predicted,0.16666666666666666,5,5,GGGATAAAATACATTGGTCT,0,1894666
icdC_predicted,0.16666666666666666,5,5,GGGAGGCGGCTATCCGAGTC,0,1892647
icdC_predicted,0.16666666666666666,5,5,GGGACTTCTCGTGAGTAACA,0,1900952
icdC_predicted,0.16666666666666666,5,5,GGCTTAAGTCTTGGATGTGT,0,1890314
icdC_predicted,0.16666666666666666,5,5,GGCTCTCTGAACGCGTTACG,0,1892934
icdC_predicted,0.16666666666666666,5,5,GGCGTATCCTTGCCATCCGG,0,1881653
icdC_predicted,0.16666666666666666,5,5,GGCGGCGCGAATAAACCGGA,0,1884006
icdC_predicted,0.16666666666666666,5,5,GGCGCAAATCGCAGGGAGAC,0,1893444
icdC_predicted,0.16666666666666666,5,5,GGCCTGGTTTTTTCATCGAT,0,1905370
icdC_predicted,0.16666666666666666,5,5,GGCCTATGAGGAAGACCCCA,0,1887849
icdC_predicted,0.16666666666666666,5,5,GGCCCACCCAAGTGGGAGAG,0,1900869
icdC_predicted,0.16666666666666666,5,5,GGCATCCTCGGTGGCTTAGG,0,1904248
icdC_predicted,0.16666666666666666,5,5,GGCACTAACCTGAATTTTCT,0,1887768
icdC_predicted,0.16666666666666666,5,5,GGATGCAAGTGCGATCTGTT,0,1883377
icdC_predicted,0.16666666666666666,5,5,GGACTTCGCGTCGGGTGTCT,0,1882918
icdC_predicted,0.16666666666666666,5,5,GGACGAACCAAGGGATCTTA,0,1885841
icdC_predicted,0.16666666666666666,5,5,GGACCAGGAATGGCGACTGT,0,1891586
icdC_predicted,0.16666666666666666,5,5,GGAAAGCATAGGCCTTTTAA,0,1906033
icdC_predicted,0.16666666666666666,5,5,GCTTGGCGAGGACCATTGCC,0,1883588
icdC_predicted,0.16666666666666666,5,5,GCTTATGCTAGATGGTAGCG,0,1898232
icdC_predicted,0.16666666666666666,5,5,GCTACTGGGACTCATTGGGA,0,1899024
icdC_predicted,0.16666666666666666,5,5,GCGTTGGGAAGAGCAGAGTT,0,1895333
icdC_predicted,0.16666666666666666,5,5,GCGTTCGCTGTTCTTATCAC,0,1896053
icdC_predicted,0.16666666666666666,5,5,GCGTTCAACAACCAGATGGG,0,1878187
icdC_predicted,0.16666666666666666,5,5,GCGTGGACAAGCTTAGGGGG,0,1882845
icdC_predicted,0.16666666666666666,5,5,GCGTCCATAAGGTTGGTCAC,0,1887436
icdC_predicted,0.16666666666666666,5,5,GCGCTTGTTTTAAATTCTTG,0,1904646
icdC_predicted,0.16666666666666666,5,5,GCGACGTGCATCTATGATCG,0,1908852
icdC_predicted,0.16666666666666666,5,5,GCCGGATTGCAATCTGTGCT,0,1899504
icdC_predicted,0.16666666666666666,5,5,GCCACGGGGTGGGCCTTGTG,0,1879596
icdC_predicted,0.16666666666666666,5,5,GCCACACCTTACGGTAGCCT,0,1896461
icdC_predicted,0.16666666666666666,5,5,GCATAAGGTCAATAGAGTCA,0,1895416
icdC_predicted,0.16666666666666666,5,5,GCAGTTCCTCTCCGACCCCA,0,1900088
icdC_predicted,0.16666666666666666,5,5,GCAGGCGCACAACGATACAA,0,1903466
icdC_predicted,0.16666666666666666,5,5,GCAACGTGACCACCGCTGAC,0,1890447
icdC_predicted,0.16666666666666666,5,5,GATGTTCAATAGGCGACATG,0,1892777
icdC_predicted,0.16666666666666666,5,5,GATGATCTGGAGGTAGCCAG,0,1897854
icdC_predicted,0.16666666666666666,5,5,GATGAGCAGTTGGGAAATTG,0,1900726
icdC_predicted,0.16666666666666666,5,5,GATCTCTGCTGGCTGACGGA,0,1888484
icdC_predicted,0.16666666666666666,5,5,GATATCGGTTCGCCGAGAGG,0,1906756
icdC_predicted,0.16666666666666666,5,5,GATATCGGGATATCAACTTC,0,1899087
icdC_predicted,0.16666666666666666,5,5,GATAGGAGCCCACGGCATTA,0,1896839
icdC_predicted,0.16666666666666666,5,5,GATACTCTTACGCTAGCGTT,0,1882307
icdC_predicted,0.16666666666666666,5,5,GAGTGGTATGCACCTCGTGC,0,1891884
icdC_predicted,0.16666666666666666,5,5,GAGTCTCACAATCACATAGA,0,1893376
icdC_predicted,0.16666666666666666,5,5,GAGGGTGAGTATAGCTATGT,0,1894376
icdC_predicted,0.16666666666666666,5,5,GAGGGGGCCAGAATCTGGTT,0,1880921
icdC_predicted,0.16666666666666666,5,5,GAGGATGGGCGGTCTACTTA,0,1899493
icdC_predicted,0.16666666666666666,5,5,GAGCCTATGCAGTTTGTATG,0,1887178
icdC_predicted,0.16666666666666666,5,5,GAGAGTTTGTGAGTATCACA,0,1908231
icdC_predicted,0.16666666666666666,5,5,GACTTGAGGGCGTGTCCTAA,0,1882379
icdC_predicted,0.16666666666666666,5,5,GACTCTCCTATGAATAGAAT,0,1879438
icdC_predicted,0.16666666666666666,5,5,GACGCTTAGTGGGACTAATA,0,1905844
icdC_predicted,0.16666666666666666,5,5,GACAATTGCCAACCCCTAAC,0,1888197
icdC_predicted,0.16666666666666666,5,5,GACAAACACGGTAGGTGACG,0,1907805
icdC_predicted,0.16666666666666666,5,5,GAATGTGTGAAAATACCGTT,0,1902907
icdC_predicted,0.16666666666666666,5,5,GAATGCTCGTGATCGTCACA,0,1908626
icdC_predicted,0.16666666666666666,5,5,GAATGATTACTTGGGCGATA,0,1897995
icdC_predicted,0.16666666666666666,5,5,GAATAAGATGCGACTTCCGA,0,1889551
icdC_predicted,0.16666666666666666,5,5,GAAGCCAAGATGTTGTTGGA,0,1899824
icdC_predicted,0.16666666666666666,5,5,GAAGATAAGCCGCTGACAGA,0,1888148
icdC_predicted,0.16666666666666666,5,5,GAACGTGACCTAGCCGCCTG,0,1890695
icdC_predicted,0.16666666666666666,5,5,GAACGGAATGACGCCACGTC,0,1889430
icdC_predicted,0.16666666666666666,5,5,GAAAAGGGACGTACTCCTGC,0,1886023
icdC_predicted,0.16666666666666666,5,5,CTTTCGCGAGGCTATGAAGT,0,1890527
icdC_predicted,0.16666666666666666,5,5,CTTTCGCCGTTGGTGCCTGG,0,1893246
icdC_predicted,0.16666666666666666,5,5,CTTTATGTCACATGTGACGT,0,1887620
icdC_predicted,0.16666666666666666,5,5,CTTGTTGTAGTTCCGAACCG,0,1900069
icdC_predicted,0.16666666666666666,5,5,CTTGTTAGCAGGCTTGCCTA,0,1890557
icdC_predicted,0.16666666666666666,5,5,CTTCGCTGCGACTCTAGCGG,0,1887815
icdC_predicted,0.16666666666666666,5,5,CTTCCTGCCTACGTTGACTC,0,1906877
icdC_predicted,0.16666666666666666,5,5,CTTATTCAAGCTGTTCTGAT,0,1905436
icdC_predicted,0.16666666666666666,5,5,CTTATGCCGGGGTTGCGCAA,0,1894737
icdC_predicted,0.16666666666666666,5,5,CTTAGCTACGATCCTGCGGC,0,1894974
icdC_predicted,0.16666666666666666,5,5,CTGTGCCGGCACGGCATTTA,0,1887448
icdC_predicted,0.16666666666666666,5,5,CTGGGGTGAGGGTTTCCCCT,0,1891573
icdC_predicted,0.16666666666666666,5,5,CTGGGGCTGCGTAGGTGGTC,0,1881305
icdC_predicted,0.16666666666666666,5,5,CTGGGCCAATTGCGCTGATG,0,1890753
icdC_predicted,0.16666666666666666,5,5,CTGGGAGTGGATTGGCAGCA,0,1880310
icdC_predicted,0.16666666666666666,5,5,CTGGCTCGTCAGCAGGTAAC,0,1892735
icdC_predicted,0.16666666666666666,5,5,CTGGCCGGGCAACAGGATCT,0,1894922
icdC_predicted,0.16666666666666666,5,5,CTGATTTTCGACTCCAAGTG,0,1879713
icdC_predicted,0.16666666666666666,5,5,CTGATTTCGTCCCCGGCAGG,0,1904189
icdC_predicted,0.16666666666666666,5,5,CTGATGTTATATATCTTTAT,0,1890692
icdC_predicted,0.16666666666666666,5,5,CTGACTCGTCATTGCTCAGG,0,1908279
icdC_predicted,0.16666666666666666,5,5,CTCTTCCGGAGTGGCCACTT,0,1882858
icdC_predicted,0.16666666666666666,5,5,CTCTAATCTACACTACTTTG,0,1906140
icdC_predicted,0.16666666666666666,5,5,CTCGCGAGGCAATTTTACAC,0,1896753
icdC_predicted,0.16666666666666666,5,5,CTCGCCCGGGAATTGCGTGG,0,1878871
icdC_predicted,0.16666666666666666,5,5,CTCGAAGGGAGGGGTGTAAA,0,1889028
icdC_predicted,0.16666666666666666,5,5,CTCCTGGCATTGCATTAGCT,0,1905992
icdC_predicted,0.16666666666666666,5,5,CTCCAGGGAGGTAAATATAT,0,1895198
icdC_predicted,0.16666666666666666,5,5,CTCAGCGCTAGTGTGGCGTC,0,1898052
icdC_predicted,0.16666666666666666,5,5,CTCACATAGAGCCAGAGTTG,0,1880291
icdC_predicted,0.16666666666666666,5,5,CTATTGGGATTCGGTAGTAT,0,1880741
icdC_predicted,0.16666666666666666,5,5,CTAGCGTCGTTACACGCCTG,0,1898373
icdC_predicted,0.16666666666666666,5,5,CTACTTTTACTCCAGTTGAT,0,1879770
icdC_predicted,0.16666666666666666,5,5,CTACTAGACTAATCTATATT,0,1894255
icdC_predicted,0.16666666666666666,5,5,CTACAAGTTCGCCGTGTTCG,0,1896565
icdC_predicted,0.16666666666666666,5,5,CGTTGAAACGCTCTTTGACA,0,1886785
icdC_predicted,0.16666666666666666,5,5,CGTGGGTATGGATTTACGAC,0,1879553
icdC_predicted,0.16666666666666666,5,5,CGTGAGACTGTATCTCTAGG,0,1881694
icdC_predicted,0.16666666666666666,5,5,CGTCTGCAGTAGCGGATCGG,0,1901857
icdC_predicted,0.16666666666666666,5,5,CGTCGAGAGACCGATGTGGT,0,1909083
icdC_predicted,0.16666666666666666,5,5,CGTAGCTGCCTTCAGTTGGC,0,1898228
icdC_predicted,0.16666666666666666,5,5,CGTAATCGACTCGTAGGGGA,0,1908256
icdC_predicted,0.16666666666666666,5,5,CGGTGGACATCGTAGTCGGT,0,1890605
icdC_predicted,0.16666666666666666,5,5,CGGAATACGGCCAGAGACCA,0,1895431
icdC_predicted,0.16666666666666666,5,5,CGGAACGGATATAACTTGCT,0,1909040
icdC_predicted,0.16666666666666666,5,5,CGCTAGACTCTTCAGCTCAG,0,1893526
icdC_predicted,0.16666666666666666,5,5,CGCGGGTATCGATACTAAGA,0,1887516
icdC_predicted,0.16666666666666666,5,5,CGCGACAGAATCTGTTGCGA,0,1888923
icdC_predicted,0.16666666666666666,5,5,CGCCGTTGGTTAGCGGTGCA,0,1884233
icdC_predicted,0.16666666666666666,5,5,CGCAAGCTGCCTCCCAGGTA,0,1904361
icdC_predicted,0.16666666666666666,5,5,CGCAACTCACGGACCAGTTG,0,1884994
icdC_predicted,0.16666666666666666,5,5,CGCAAAGCAATTCAGATATA,0,1892969
icdC_predicted,0.16666666666666666,5,5,CGATCGTCGCTGGCAACAGA,0,1908254
icdC_predicted,0.16666666666666666,5,5,CGAGTGATATGTTATGCGCC,0,1896422
icdC_predicted,0.16666666666666666,5,5,CGAGGGGGTTTGTTCACAGG,0,1882632
icdC_predicted,0.16666666666666666,5,5,CGAGGATTGCCAGTCTTTCT,0,1902786
icdC_predicted,0.16666666666666666,5,5,CGACTTTATACCCGTGCTTC,0,1886287
icdC_predicted,0.16666666666666666,5,5,CGACAGTTTGAAGAAGGTAC,0,1895369
icdC_predicted,0.16666666666666666,5,5,CGAAAAGTAGGGTAGCTAGG,0,1904588
icdC_predicted,0.16666666666666666,5,5,CCTTTACGATTCGTCGATAA,0,1901912
icdC_predicted,0.16666666666666666,5,5,CCTTAGAAATACTCGACTTC,0,1903117
icdC_predicted,0.16666666666666666,5,5,CCTCTGTCAGGTATTGTGGC,0,1904054
icdC_predicted,0.16666666666666666,5,5,CCTCTACTTCCTGCAACCTC,0,1892770
icdC_predicted,0.16666666666666666,5,5,CCTCCACACGCCTAGCTATT,0,1895677
icdC_predicted,0.16666666666666666,5,5,CCTATATTTAATAACAACGT,0,1894770
icdC_predicted,0.16666666666666666,5,5,CCGTGTATCCATTTTCCTCT,0,1893023
icdC_predicted,0.16666666666666666,5,5,CCGTAAGACGCCGCCGTGGT,0,1895615
icdC_predicted,0.16666666666666666,5,5,CCGGTTACCGTTCGGGCATG,0,1894008
icdC_predicted,0.16666666666666666,5,5,CCGGCCATCATTTAGGGGAA,0,1893120
icdC_predicted,0.16666666666666666,5,5,CCGCAATGGCATGAGACATT,0,1897340
icdC_predicted,0.16666666666666666,5,5,CCGAGCCACCACTACTCTTC,0,1899125
icdC_predicted,0.16666666666666666,5,5,CCGAACGTGAAGACGAATTA,0,1878989
icdC_predicted,0.16666666666666666,5,5,CCCGTCCACTTCGTTCAGTG,0,1889885
icdC_predicted,0.16666666666666666,5,5,CCCGTAGTTGTTCCAAGCTT,0,1901116
icdC_predicted,0.16666666666666666,5,5,CCCGGCGATCACTAGCGGTG,0,1893743
icdC_predicted,0.16666666666666666,5,5,CCCCTCTACTCCGAAGTCGT,0,1889594
icdC_predicted,0.16666666666666666,5,5,CCCCTCCTCGGAATAGGGCT,0,1892044
icdC_predicted,0.16666666666666666,5,5,CCCCGGCCGGTTTGTGCATG,0,1900309
icdC_predicted,0.16666666666666666,5,5,CCATCTCGAGAATAGGTGGC,0,1887362
icdC_predicted,0.16666666666666666,5,5,CCAGCTTCCACCTTACCTAG,0,1900199
icdC_predicted,0.16666666666666666,5,5,CCAGATAGCTGGAGCCCACA,0,1892203
icdC_predicted,0.16666666666666666,5,5,CCACTTGATGTCGTCTAAAG,0,1896799
icdC_predicted,0.16666666666666666,5,5,CCACCTGTGTCAGCATAGTA,0,1883713
icdC_predicted,0.16666666666666666,5,5,CCAATCGACGCAGAGCTGCC,0,1909186
icdC_predicted,0.16666666666666666,5,5,CCAATAAATAACCTGCGCCC,0,1897217
icdC_predicted,0.16666666666666666,5,5,CCAAGCAGGGGACACCATAC,0,1884086
icdC_predicted,0.16666666666666666,5,5,CATTGTTATAGGGTCAATGA,0,1892022
icdC_predicted,0.16666666666666666,5,5,CATTGTGATGCAGGCGGACG,0,1891930
icdC_predicted,0.16666666666666666,5,5,CATTAACCATGGAGGGTTAT,0,1886286
icdC_predicted,0.16666666666666666,5,5,CATGCACTAGGGTCGTAGGT,0,1902837
icdC_predicted,0.16666666666666666,5,5,CATCTCGGATTCGTCTAGAC,0,1895341
icdC_predicted,0.16666666666666666,5,5,CATCCTTTTTGAGCTGGATA,0,1895862
icdC_predicted,0.16666666666666666,5,5,CATATATAAAGACGAGGTCG,0,1889777
icdC_predicted,0.16666666666666666,5,5,CATACGACTAGCTGTACCGG,0,1902672
icdC_predicted,0.16666666666666666,5,5,CATAACCAGAACCCTTGCGC,0,1892557
icdC_predicted,0.16666666666666666,5,5,CAGTTCAACACATCTCCTGC,0,1897966
icdC_predicted,0.16666666666666666,5,5,CAGGTGGTCATATGTTTCCA,0,1889866
icdC_predicted,0.16666666666666666,5,5,CAGCTAGTTATAACACAGGT,0,1897750
icdC_predicted,0.16666666666666666,5,5,CAGCGGACGATCTGACCATC,0,1893496
icdC_predicted,0.16666666666666666,5,5,CACTGCTATTTCCTGGGCTG,0,1908830
icdC_predicted,0.16666666666666666,5,5,CACTACAAATTAAGTATGCG,0,1896937
icdC_predicted,0.16666666666666666,5,5,CACCCGTCGCATTGGGAGCT,0,1890127
icdC_predicted,0.16666666666666666,5,5,CACCCCCGAACTAGCCGGAG,0,1906119
icdC_predicted,0.16666666666666666,5,5,CACCACAATTCCCGTACAAA,0,1907345
icdC_predicted,0.16666666666666666,5,5,CACATCCAAGCCCGGAGGGG,0,1886488
icdC_predicted,0.16666666666666666,5,5,CAATGTCCCAGGACGTTACT,0,1885148
icdC_predicted,0.16666666666666666,5,5,CAAAGTTTGGATGCGTAGGA,0,1879869
icdC_predicted,0.16666666666666666,5,5,CAAAGACTCACCAATGGTAG,0,1889586
icdC_predicted,0.16666666666666666,5,5,ATTTGTCTGGCATTCTTAAG,0,1906703
icdC_predicted,0.16666666666666666,5,5,ATTTGGACAAAGGCCCTGAA,0,1893707
icdC_predicted,0.16666666666666666,5,5,ATTTGAGCGACATGTCTCGT,0,1908007
icdC_predicted,0.16666666666666666,5,5,ATTTCTTCACCCTCTACCAA,0,1888794
icdC_predicted,0.16666666666666666,5,5,ATTTCGTGGGGTATAATAAT,0,1887839
icdC_predicted,0.16666666666666666,5,5,ATTGTAAACGTTGAGCCCCT,0,1902505
icdC_predicted,0.16666666666666666,5,5,ATTGGACGACTATCCAAGGT,0,1882050
icdC_predicted,0.16666666666666666,5,5,ATTCTAGGGTCGGGCTAGCC,0,1906933
icdC_predicted,0.16666666666666666,5,5,ATTCCGTATTTGCGCGCGCG,0,1898879
icdC_predicted,0.16666666666666666,5,5,ATTCAGCAGCGCAAGGACGT,0,1886026
icdC_predicted,0.16666666666666666,5,5,ATTCAACCCCATTTAGTTGG,0,1901047
icdC_predicted,0.16666666666666666,5,5,ATTATCGCGCTCCAGTTATA,0,1885139
icdC_predicted,0.16666666666666666,5,5,ATTAACCTGATTAACGGCAT,0,1893204
icdC_predicted,0.16666666666666666,5,5,ATGTAAACTAACTAGCAGCT,0,1878165
icdC_predicted,0.16666666666666666,5,5,ATGGAGGACCAGCCTAGCTA,0,1884065
icdC_predicted,0.16666666666666666,5,5,ATGCGTTGATGGTGTGGGGG,0,1879066
icdC_predicted,0.16666666666666666,5,5,ATGATCTAGGCCTTTTTAGT,0,1906352
icdC_predicted,0.16666666666666666,5,5,ATCTTTAGAAACTACCGGGT,0,1902249
icdC_predicted,0.16666666666666666,5,5,ATCTGTTCGGATGTCCAATA,0,1902763
icdC_predicted,0.16666666666666666,5,5,ATCGTAATATATAAAGTACA,0,1905526
icdC_predicted,0.16666666666666666,5,5,ATCCCAAAGTTCCGCAACCA,0,1899259
icdC_predicted,0.16666666666666666,5,5,ATCCAGAAGTGTAGAGGTGG,0,1890048
icdC_predicted,0.16666666666666666,5,5,ATCAAATAGTGTAAAAAGAT,0,1884859
icdC_predicted,0.16666666666666666,5,5,ATATTGCTGTCACAGATTGT,0,1885631
icdC_predicted,0.16666666666666666,5,5,ATATTCATTGTTGTCATCTC,0,1897010
icdC_predicted,0.16666666666666666,5,5,ATATGTCTAGGGCTAAAACT,0,1898376
icdC_predicted,0.16666666666666666,5,5,ATAGCGGTTTGACGCATGGT,0,1878305
icdC_predicted,0.16666666666666666,5,5,ATAGAAACGCTTATATCTAA,0,1892380
icdC_predicted,0.16666666666666666,5,5,ATACGAATTGGTAATCAGCC,0,1903436
icdC_predicted,0.16666666666666666,5,5,ATACCGGAGGATGGTCGAGT,0,1897240
icdC_predicted,0.16666666666666666,5,5,ATACATGAGTTCACCATCCA,0,1907408
icdC_predicted,0.16666666666666666,5,5,ATAATTTCTAACTTTCGGTA,0,1890423
icdC_predicted,0.16666666666666666,5,5,ATAACGCTAGCTCAGGCGGG,0,1897747
icdC_predicted,0.16666666666666666,5,5,ATAAATGATGGATGCATCCC,0,1895924
icdC_predicted,0.16666666666666666,5,5,AGTTTCCCATGGCTACGGAG,0,1906673
icdC_predicted,0.16666666666666666,5,5,AGTGTAACCCCATATGCGAG,0,1879734
icdC_predicted,0.16666666666666666,5,5,AGTATCGAATCGGAAAAGTG,0,1885337
icdC_predicted,0.16666666666666666,5,5,AGTACCGAGAGCAATCGTTC,0,1885603
icdC_predicted,0.16666666666666666,5,5,AGGTTAATATGCACACCAAG,0,1900416
icdC_predicted,0.16666666666666666,5,5,AGGTCATAAGTCGTATTGTC,0,1894489
icdC_predicted,0.16666666666666666,5,5,AGGGTGAATTGAGACAGTGA,0,1905538
icdC_predicted,0.16666666666666666,5,5,AGGGGGGTAGGGAGGCTGAC,0,1884716
icdC_predicted,0.16666666666666666,5,5,AGGGCTCATCCATAAGATTC,0,1900268
icdC_predicted,0.16666666666666666,5,5,AGGGCGCAAAAGCATCATGA,0,1885786
icdC_predicted,0.16666666666666666,5,5,AGGCGTCGCAGAATGGGATA,0,1885064
icdC_predicted,0.16666666666666666,5,5,AGGCGCTTTGGACATCCTGA,0,1894395
icdC_predicted,0.16666666666666666,5,5,AGGATAGGCCCTGTGATGTC,0,1898116
icdC_predicted,0.16666666666666666,5,5,AGCTTTGAGTTCCTTGGAGA,0,1879440
icdC_predicted,0.16666666666666666,5,5,AGCTTGTTCGCTAAATATTG,0,1886953
icdC_predicted,0.16666666666666666,5,5,AGCGCGTAACGCGTGTATGT,0,1907698
icdC_predicted,0.16666666666666666,5,5,AGCGCACATTGGTCCAAAGG,0,1881529
icdC_predicted,0.16666666666666666,5,5,AGCGATTCCCTGCACTTCCG,0,1899008
icdC_predicted,0.16666666666666666,5,5,AGCGAAGCGAAGTAGCCCAA,0,1880847
icdC_predicted,0.16666666666666666,5,5,AGCCACCATGCCACCTAGGA,0,1899708
icdC_predicted,0.16666666666666666,5,5,AGCACGCTAAGAGCAAGTCT,0,1904178
icdC_predicted,0.16666666666666666,5,5,AGCAAATTTTGCTCGAGCTT,0,1901992
icdC_predicted,0.16666666666666666,5,5,AGAGTCTTCTGTGAATTTGA,0,1888711
icdC_predicted,0.16666666666666666,5,5,AGAGCTGAGTCCCCTTTCAA,0,1889391
icdC_predicted,0.16666666666666666,5,5,AGACGTTAATACATCAACTT,0,1882470
icdC_predicted,0.16666666666666666,5,5,AGACCCTACTATGCGTACCC,0,1899919
icdC_predicted,0.16666666666666666,5,5,AGAACCGCGAGGACACAGTT,0,1892033
icdC_predicted,0.16666666666666666,5,5,ACTTTCCGGGATCACTGAAA,0,1889007
icdC_predicted,0.16666666666666666,5,5,ACTTCTCCGGAGCGAGATTC,0,1885387
icdC_predicted,0.16666666666666666,5,5,ACTTCATGTTGAATTGCTGA,0,1879575
icdC_predicted,0.16666666666666666,5,5,ACTGACTTGCGTGGTGTCCA,0,1888131
icdC_predicted,0.16666666666666666,5,5,ACTGAAACCCACTCCGCAGA,0,1900871
icdC_predicted,0.16666666666666666,5,5,ACTAGAAGTCGGCACATTTT,0,1897415
icdC_predicted,0.16666666666666666,5,5,ACTACTTTGATCCTTGCCCA,0,1905749
icdC_predicted,0.16666666666666666,5,5,ACTACTTCACCTTGGGTAGT,0,1898978
icdC_predicted,0.16666666666666666,5,5,ACGTTAAATACGTGAATGCA,0,1879152
icdC_predicted,0.16666666666666666,5,5,ACGTGCGCATACCCTCAAAT,0,1892781
icdC_predicted,0.16666666666666666,5,5,ACGTATTTTAGTGGTTACAA,0,1903578
icdC_predicted,0.16666666666666666,5,5,ACGGTGATCAGTTGGTATCG,0,1878882
icdC_predicted,0.16666666666666666,5,5,ACGGTCGCTGATGCAATGTT,0,1884752
icdC_predicted,0.16666666666666666,5,5,ACGGGTACCCGAGTTCTGCC,0,1878633
icdC_predicted,0.16666666666666666,5,5,ACGGAAAGTTGCCCTGCCAT,0,1880748
icdC_predicted,0.16666666666666666,5,5,ACGCTTAGCCGATAAGACAT,0,1899977
icdC_predicted,0.16666666666666666,5,5,ACGCTGTTGAAAGTTCAGAT,0,1893206
icdC_predicted,0.16666666666666666,5,5,ACGAGCAAAACATGAGGCGC,0,1897660
icdC_predicted,0.16666666666666666,5,5,ACGACATTAAGCGATTTCGA,0,1906404
icdC_predicted,0.16666666666666666,5,5,ACGAACGACGGCCAGACAAC,0,1886974
icdC_predicted,0.16666666666666666,5,5,ACCGTCTGTTTTTAGGGTAA,0,1888854
icdC_predicted,0.16666666666666666,5,5,ACCGACGTTCCCGCTTCCGG,0,1893446
icdC_predicted,0.16666666666666666,5,5,ACCGAAATTTACAGTTAGCT,0,1880397
icdC_predicted,0.16666666666666666,5,5,ACCCTGGCATATTCCGATGG,0,1907876
icdC_predicted,0.16666666666666666,5,5,ACCCGTGGGTCGAGTCCCAG,0,1892953
icdC_predicted,0.16666666666666666,5,5,ACCCACCTCTGGTGCCCGTT,0,1886116
icdC_predicted,0.16666666666666666,5,5,ACCATCATCTAAAGGGACCA,0,1883993
icdC_predicted,0.16666666666666666,5,5,ACATTTGAATAGAAGAGTGT,0,1907144
icdC_predicted,0.16666666666666666,5,5,ACATAGATCATGCCGCAGGT,0,1883610
icdC_predicted,0.16666666666666666,5,5,ACAGAGGTCATGGGGTGCGC,0,1894207
icdC_predicted,0.16666666666666666,5,5,ACACTGCCAAGGTATGCTCT,0,1888355
icdC_predicted,0.16666666666666666,5,5,ACACCCCTAACATATGGTGC,0,1884154
icdC_predicted,0.16666666666666666,5,5,ACACATCCCACTTAATATTC,0,1884604
icdC_predicted,0.16666666666666666,5,5,AATTTTTCTGGACCTCGTAC,0,1907253
icdC_predicted,0.16666666666666666,5,5,AATGGGTAACACCATTACCT,0,1881502
icdC_predicted,0.16666666666666666,5,5,AATGGCGGGGTACCGGTATG,0,1885901
icdC_predicted,0.16666666666666666,5,5,AATGCGATTTAGCCGCTTCA,0,1895748
icdC_predicted,0.16666666666666666,5,5,AATGATGAATTACGGCTTCG,0,1885304
icdC_predicted,0.16666666666666666,5,5,AATCGTCAAGCGTATATCGT,0,1896389
icdC_predicted,0.16666666666666666,5,5,AATCATGCGGTGCACTCATT,0,1891198
icdC_predicted,0.16666666666666666,5,5,AATCAGTCCATTCCCCGCCA,0,1901038
icdC_predicted,0.16666666666666666,5,5,AATCAACCTATGACTGCATA,0,1904388
icdC_predicted,0.16666666666666666,5,5,AAGTTCTCGAGCAGACAGCA,0,1878629
icdC_predicted,0.16666666666666666,5,5,AAGTGACTCGCTTATATCAA,0,1885367
icdC_predicted,0.16666666666666666,5,5,AAGTCCACTAAGTTGTAGGG,0,1892126
icdC_predicted,0.16666666666666666,5,5,AAGGCATCTTCTAAGGGTAC,0,1896081
icdC_predicted,0.16666666666666666,5,5,AAGACTTTCAGAAAGGCAAA,0,1901272
icdC_predicted,0.16666666666666666,5,5,AAGACGCTCGAGCGAGTTTT,0,1905394
icdC_predicted,0.16666666666666666,5,5,AACGCTCGCTTGTTCGAATG,0,1900574
icdC_predicted,0.16666666666666666,5,5,AACGACTAAGACGATCGCGA,0,1891213
icdC_predicted,0.16666666666666666,5,5,AACGAAAATCGTCCCTTAAG,0,1902974
icdC_predicted,0.16666666666666666,5,5,AACCTTTCCGTTTCTTTTTA,0,1902469
icdC_predicted,0.16666666666666666,5,5,AACCTCACCAAGCTTTACAG,0,1880917
icdC_predicted,0.16666666666666666,5,5,AACCTAGACTGGGCACCTAG,0,1904998
icdC_predicted,0.16666666666666666,5,5,AACCGAGGGAGGACCGGGAA,0,1886050
icdC_predicted,0.16666666666666666,5,5,AACCCCCGTCACAGGCGCTC,0,1879296
icdC_predicted,0.16666666666666666,5,5,AACAGTTCTAATAGCCCATC,0,1904488
icdC_predicted,0.16666666666666666,5,5,AACAGGGAAAACAGGATAGT,0,1898020
icdC_predicted,0.16666666666666666,5,5,AAAGGCGCGTTATCATGTTA,0,1900618
icdC_predicted,0.16666666666666666,5,5,AAAGGACTCACGTTCTGAGT,0,1879821
icdC_predicted,0.16666666666666666,5,5,AAAGCCGTGTTGTGCTGTTG,0,1900799
icdC_predicted,0.16666666666666666,5,5,AAAGATTGGCGGGATTCATT,0,1880060
icdC_predicted,0.16666666666666666,5,5,AAACGCGAAAATGGGGCTGC,0,1895733
icdC_predicted,0.16666666666666666,5,5,AAACGACAATTTGTTGCCCA,0,1879727
icdC_predicted,0.16666666666666666,5,5,AAACCGCCTGGTAAGTCGGA,0,1880742
icdC_predicted,0.16666666666666666,5,5,AAAATGCAGGCCTCAAGGCA,0,1886367
icdC_predicted,0.16666666666666666,5,5,AAAAGAACCTGGTAAATTAA,0,1881952
icdC_predicted,0.16666666666666666,5,5,AAAACTGGTTGAGGTTGCAA,0,1899590
icdC_predicted,0.2,4,4,TTTTTCATGGCAAGCGCGGA,0,1879601
icdC_predicted,0.2,4,4,TTTTTAGTGCCATCAATCAC,0,1882148
icdC_predicted,0.2,4,4,TTTTGGCTTCTTTGGCATAC,0,1879355
icdC_predicted,0.2,4,4,TTTTGACACGTTTGCCGTGG,0,1882260
icdC_predicted,0.2,4,4,TTTGTGATCCACTACTTTTA,0,1883227
icdC_predicted,0.2,4,4,TTTCATATCACGATCGAATG,0,1895581
icdC_predicted,0.2,4,4,TTTATCACCTAGCTTCGACT,0,1894380
icdC_predicted,0.2,4,4,TTGTTGGCATTGCGGGGGGG,0,1883675
icdC_predicted,0.2,4,4,TTGTTCGCTTATCACGAAAG,0,1883097
icdC_predicted,0.2,4,4,TTGTGAGCCACGTCCTACAA,0,1878813
icdC_predicted,0.2,4,4,TTGTCAATCTGGTTCAGACC,0,1893094
icdC_predicted,0.2,4,4,TTGTAAGCCCAAGCAGATGA,0,1906493
icdC_predicted,0.2,4,4,TTGTAAAGGGTTATTAGGGG,0,1890852
icdC_predicted,0.2,4,4,TTGGTTGAACCATTTGTTAC,0,1881901
icdC_predicted,0.2,4,4,TTGCCAGATTTACTCCTTGG,0,1887335
icdC_predicted,0.2,4,4,TTGCCAACGGAAACGCATCA,0,1902805
icdC_predicted,0.2,4,4,TTGCATAGGCAACACCCACA,0,1889972
icdC_predicted,0.2,4,4,TTGCAGAAACGACCAGGCTT,0,1904158
icdC_predicted,0.2,4,4,TTCTAGCGGGGGGTGTCCGA,0,1881965
icdC_predicted,0.2,4,4,TTCTACCAAAACAGTATATG,0,1890248
icdC_predicted,0.2,4,4,TTCTAAAGGAAAGCTGGCAA,0,1898252
icdC_predicted,0.2,4,4,TTCGTGTCCCAAAGGTAAGA,0,1908504
icdC_predicted,0.2,4,4,TTCATCCGAACCAACCATGG,0,1900722
icdC_predicted,0.2,4,4,TTCAGCGTAAGATGACAGAC,0,1894072
icdC_predicted,0.2,4,4,TTCACGACACTCTCACCAAA,0,1881490
icdC_predicted,0.2,4,4,TTCAAGGGTTAGGGTAAACA,0,1883127
icdC_predicted,0.2,4,4,TTCAACCTGTTCGTGTTCAC,0,1891346
icdC_predicted,0.2,4,4,TTCAAAGGATAACATCATAG,0,1892834
icdC_predicted,0.2,4,4,TTCAAACCCTAATCGGCGAG,0,1901304
icdC_predicted,0.2,4,4,TTATGGGGGCGTTTCCGATA,0,1904339
icdC_predicted,0.2,4,4,TTATAAGTTAAAATACATAC,0,1902727
icdC_predicted,0.2,4,4,TTAGTTTCTGGGGTGCAAGG,0,1907376
icdC_predicted,0.2,4,4,TTAGTATGCGAGCGATACCA,0,1895678
icdC_predicted,0.2,4,4,TTAGCTTATCCAGACCTATT,0,1885237
icdC_predicted,0.2,4,4,TTAGCGTAACATGCCTCTCA,0,1890860
icdC_predicted,0.2,4,4,TTACACAGTGGTCTAGCTGC,0,1902534
icdC_predicted,0.2,4,4,TTAAGCCACGGTCTAATCTA,0,1902177
icdC_predicted,0.2,4,4,TGTGGCTAAGCAAGATATTG,0,1886280
icdC_predicted,0.2,4,4,TGTATGGGTTATTGCTACCA,0,1904825
icdC_predicted,0.2,4,4,TGGTGCCAAAGGTTAGATTA,0,1880117
icdC_predicted,0.2,4,4,TGGTCTAGGTCTAGGCCTAT,0,1887055
icdC_predicted,0.2,4,4,TGGGGACCCGTGACTAATGA,0,1878766
icdC_predicted,0.2,4,4,TGGGCCAAAGATCTCCGTAT,0,1901644
icdC_predicted,0.2,4,4,TGGCTGTCGGGGTTATGACA,0,1888084
icdC_predicted,0.2,4,4,TGGCGTGCTCATTCCGAAAG,0,1885423
icdC_predicted,0.2,4,4,TGGACTGAGGACACCGTGAG,0,1890151
icdC_predicted,0.2,4,4,TGCTACGAGACTTCATGAAT,0,1908676
icdC_predicted,0.2,4,4,TGCGGGCCTACTGCAGATGT,0,1890150
icdC_predicted,0.2,4,4,TGCGAATATGTGGGCAGTCA,0,1901367
icdC_predicted,0.2,4,4,TGCCTAGTCCTAAGAGTTGT,0,1888967
icdC_predicted,0.2,4,4,TGCCGTAGTGTCATGCAGAA,0,1883630
icdC_predicted,0.2,4,4,TGCCCGGGGTGTCGCACCAA,0,1881135
icdC_predicted,0.2,4,4,TGCAGTTTGGGGACCGGACC,0,1892179
icdC_predicted,0.2,4,4,TGATCTGTCGCGCTACGGCA,0,1898512
icdC_predicted,0.2,4,4,TGATCGGGACGAACCATACA,0,1891749
icdC_predicted,0.2,4,4,TGATACACAATCTCCTTCTT,0,1904729
icdC_predicted,0.2,4,4,TGAGCTACGTCATGTATATG,0,1901236
icdC_predicted,0.2,4,4,TGACTCTAGCTTCCAAGACA,0,1881296
icdC_predicted,0.2,4,4,TGAATTAATTCTGGTCTCTT,0,1882801
icdC_predicted,0.2,4,4,TGAATGCTAGGCAACTTTAA,0,1900891
icdC_predicted,0.2,4,4,TGAACGAATTACAGGAGATT,0,1885490
icdC_predicted,0.2,4,4,TGAAAGACAGCAGGGCACTC,0,1898017
icdC_predicted,0.2,4,4,TGAAAAGGCCCGACAGAGAA,0,1886191
icdC_predicted,0.2,4,4,TCTTGTTGGCTAGTCCGATC,0,1878387
icdC_predicted,0.2,4,4,TCTTCTTGAAACTGCACCGT,0,1904655
icdC_predicted,0.2,4,4,TCTTAGTGTGTCAAGTCACT,0,1884519
icdC_predicted,0.2,4,4,TCTGTTTATACCGGAATTTA,0,1881021
icdC_predicted,0.2,4,4,TCTGTCTTGGTGCCGAGCAA,0,1908214
icdC_predicted,0.2,4,4,TCTGGTGTTCGCGAATTCAC,0,1895276
icdC_predicted,0.2,4,4,TCTGGTGAATCGCACAGTCA,0,1881098
icdC_predicted,0.2,4,4,TCTGCCAGGGATACTGTCGT,0,1889122
icdC_predicted,0.2,4,4,TCTGATCGCCTGCTCGCGCA,0,1886484
icdC_predicted,0.2,4,4,TCTGACTTCGTACTACGATC,0,1881751
icdC_predicted,0.2,4,4,TCTCCTCTATCAATCCGAGG,0,1881395
icdC_predicted,0.2,4,4,TCTCAAGCTCGTACCAATAG,0,1896169
icdC_predicted,0.2,4,4,TCTACTAGGCGAGCCCGCTG,0,1907786
icdC_predicted,0.2,4,4,TCGTCTCTAACGCTTATAGT,0,1881910
icdC_predicted,0.2,4,4,TCGTCGCCCATAGAGGCACG,0,1892896
icdC_predicted,0.2,4,4,TCGTATTTGATTGGCTCGTC,0,1899641
icdC_predicted,0.2,4,4,TCGGGCTGGTGAGACAAAGG,0,1879062
icdC_predicted,0.2,4,4,TCGCGGGTATTGAGTGTCCA,0,1883683
icdC_predicted,0.2,4,4,TCCTTGGTCAGTGACGAAGC,0,1888273
icdC_predicted,0.2,4,4,TCCTGGTGGAGTCATCACGA,0,1907181
icdC_predicted,0.2,4,4,TCCTAGTGGTTTGAAACCGG,0,1881659
icdC_predicted,0.2,4,4,TCCTAATATAGCCAGCTCCT,0,1882411
icdC_predicted,0.2,4,4,TCCGGGCGGGGGTATCATCA,0,1890115
icdC_predicted,0.2,4,4,TCCGAAGAGCCACTGCCTCT,0,1899052
icdC_predicted,0.2,4,4,TCCCCATACGAACAAGTAAA,0,1899412
icdC_predicted,0.2,4,4,TCCATGAGGTCGGCTACGAG,0,1907019
icdC_predicted,0.2,4,4,TCCAGGAAAAAAAGAATTCC,0,1886402
icdC_predicted,0.2,4,4,TCATTGGGGGTCATTTTGTA,0,1888178
icdC_predicted,0.2,4,4,TCATGAAAGGGATCTCCAAT,0,1897422
icdC_predicted,0.2,4,4,TCATATATACCGAGTATACG,0,1892304
icdC_predicted,0.2,4,4,TCAGTATTAAACCCGACAAT,0,1879736
icdC_predicted,0.2,4,4,TCAGCGAGGGGAATGATCAT,0,1897089
icdC_predicted,0.2,4,4,TCACGGACCAAACGACTTGC,0,1888683
icdC_predicted,0.2,4,4,TCACATTGCCACTACAATTA,0,1896280
icdC_predicted,0.2,4,4,TCACAGAGCAGCCGCCTCAG,0,1905656
icdC_predicted,0.2,4,4,TCAAGCTATAATTGGCTAAT,0,1898342
icdC_predicted,0.2,4,4,TATTTATTGTGTGATTATCG,0,1895100
icdC_predicted,0.2,4,4,TATTGCCACCTGTTAAGGAG,0,1895945
icdC_predicted,0.2,4,4,TATGGGCTAATTATTTCCTA,0,1892333
icdC_predicted,0.2,4,4,TATGCTGGTTGTCACCACGG,0,1892932
icdC_predicted,0.2,4,4,TATCTTTGGTAAGATCGGCA,0,1900794
icdC_predicted,0.2,4,4,TATCTGCTGGAGGCACAGCG,0,1881157
icdC_predicted,0.2,4,4,TATCGACGGGACCGGCGTTT,0,1881064
icdC_predicted,0.2,4,4,TATCAATAGAATGGGGAATA,0,1893168
icdC_predicted,0.2,4,4,TATCAAGGTGGGCTAAGCGT,0,1896835
icdC_predicted,0.2,4,4,TATAGAGATGAGCCGATTGA,0,1907078
icdC_predicted,0.2,4,4,TAGGGGGGTCAGGCGTCCCA,0,1893652
icdC_predicted,0.2,4,4,TAGCCGGCCTCCGCTTGAAG,0,1903316
icdC_predicted,0.2,4,4,TAGCCAAGCGAAAAACGAAC,0,1883703
icdC_predicted,0.2,4,4,TAGAGACGGATCGCGCGCTT,0,1878586
icdC_predicted,0.2,4,4,TACTGTTATCTCCGGGATCA,0,1884646
icdC_predicted,0.2,4,4,TACTCTGTCGCAGTGACAAC,0,1893984
icdC_predicted,0.2,4,4,TACGGCCAGTCTCCAATCGC,0,1886826
icdC_predicted,0.2,4,4,TACGCTTCATCATTCGGACG,0,1896942
icdC_predicted,0.2,4,4,TACGACAGAATGGGAACGCT,0,1882553
icdC_predicted,0.2,4,4,TACAAGGGATGTATCTTCCT,0,1891896
icdC_predicted,0.2,4,4,TAATGTGGTGATCAGGATGG,0,1900533
icdC_predicted,0.2,4,4,TAATATCTAACTCCCCTTTT,0,1892666
icdC_predicted,0.2,4,4,TAAGTGCGCGTACAGTAAAA,0,1889222
icdC_predicted,0.2,4,4,TAAGTCAGGCTTGGTAATAG,0,1890031
icdC_predicted,0.2,4,4,TAAGGTCAAAGCTGGCGCGG,0,1884771
icdC_predicted,0.2,4,4,TAAGCCTTCGAGCGACGGAA,0,1881656
icdC_predicted,0.2,4,4,TAACGCATGCGATCGCACAA,0,1900013
icdC_predicted,0.2,4,4,TAACCTGCGGCCTTCCAAAA,0,1891665
icdC_predicted,0.2,4,4,TAACACCTGGGCTACATGTA,0,1899212
icdC_predicted,0.2,4,4,TAAACTCTAGATGTCAGACA,0,1887976
icdC_predicted,0.2,4,4,TAAACAAGTACAACTCTATG,0,1905719
icdC_predicted,0.2,4,4,GTTTAGCATGCCCGGTCCTT,0,1882890
icdC_predicted,0.2,4,4,GTTGTGGACATATATAAAAT,0,1888997
icdC_predicted,0.2,4,4,GTTGGAAGAGTGGATTGTCA,0,1900377
icdC_predicted,0.2,4,4,GTTGACGTCGGTTTTCGTGG,0,1891127
icdC_predicted,0.2,4,4,GTTGACGAGCTGTACTGTCT,0,1907321
icdC_predicted,0.2,4,4,GTTCGGGGACAGCTATTAGA,0,1901230
icdC_predicted,0.2,4,4,GTTCCTTAGCTGGTTCGTAG,0,1899832
icdC_predicted,0.2,4,4,GTTCAGCAATCAACAATATT,0,1880944
icdC_predicted,0.2,4,4,GTTCACCGTCCGTATTATCT,0,1891591
icdC_predicted,0.2,4,4,GTTATCAATTAGAACTCTTC,0,1894628
icdC_predicted,0.2,4,4,GTTAACGAGTGGGGCTCCCA,0,1906872
icdC_predicted,0.2,4,4,GTGTGGTCGTGGTCTTCATC,0,1892701
icdC_predicted,0.2,4,4,GTGTAAATTAGTTACCATCC,0,1885114
icdC_predicted,0.2,4,4,GTGGCGCTTATCTGTTAATG,0,1908233
icdC_predicted,0.2,4,4,GTGGATAAGAGCATGGGAGA,0,1879924
icdC_predicted,0.2,4,4,GTGCTGTTAGATGCGGGCGT,0,1883331
icdC_predicted,0.2,4,4,GTGCTCAGCCCGCTACCGAA,0,1900830
icdC_predicted,0.2,4,4,GTGCACGAAGTGTTAGCCAA,0,1882076
icdC_predicted,0.2,4,4,GTGATGAACTTCCGGGACAT,0,1890715
icdC_predicted,0.2,4,4,GTCTCCCTCGTGTGCACGGG,0,1888911
icdC_predicted,0.2,4,4,GTCTCATAAGCTTGCATAGG,0,1902281
icdC_predicted,0.2,4,4,GTCTACAATCCTGTTGGAGT,0,1878156
icdC_predicted,0.2,4,4,GTCGTAGTATCGGGTCGTTT,0,1900260
icdC_predicted,0.2,4,4,GTCATCGTGTGTTCGCCCGT,0,1890224
icdC_predicted,0.2,4,4,GTCAGCTGACAGTGAATGTA,0,1899049
icdC_predicted,0.2,4,4,GTCACTAGGGCAATAGTTAA,0,1907860
icdC_predicted,0.2,4,4,GTCACCAGCTCTACAGTTTT,0,1893485
icdC_predicted,0.2,4,4,GTCAACCCGAAATCTGCATT,0,1879501
icdC_predicted,0.2,4,4,GTATAGTTGGCACCGGGCAA,0,1887227
icdC_predicted,0.2,4,4,GTATAGCGCGTCCGTACGTC,0,1884511
icdC_predicted,0.2,4,4,GTAGTGTCGGAAGAGCGAGT,0,1907731
icdC_predicted,0.2,4,4,GTAGTAGCTACCACGCGTGA,0,1878496
icdC_predicted,0.2,4,4,GTAGCCCCTCGCACCGTGGC,0,1890038
icdC_predicted,0.2,4,4,GTAGACACTTAAATAGTTGA,0,1891939
icdC_predicted,0.2,4,4,GTACATCGTACACAGTGTAT,0,1905895
icdC_predicted,0.2,4,4,GTAAGTCGTATTGATGTGTA,0,1897373
icdC_predicted,0.2,4,4,GTAAGGGGTCCGGACGGGTG,0,1878254
icdC_predicted,0.2,4,4,GGTTTTAACAGGTGCAGAAT,0,1904862
icdC_predicted,0.2,4,4,GGTTGCGTCGGTATGAGCAT,0,1884818
icdC_predicted,0.2,4,4,GGTTGATTTCGTAAGATATT,0,1895617
icdC_predicted,0.2,4,4,GGTGCTCTGGATGGGTCAGT,0,1894490
icdC_predicted,0.2,4,4,GGTCGAGCGTTTAACCCACA,0,1902817
icdC_predicted,0.2,4,4,GGTATGATTTTTGTTAGGTT,0,1886616
icdC_predicted,0.2,4,4,GGTAGCGGGTAGGTAAGGGG,0,1895576
icdC_predicted,0.2,4,4,GGGGGGAGGCTCTGTCAGTT,0,1883481
icdC_predicted,0.2,4,4,GGGGGCGGCCTCCGTTCTGT,0,1904019
icdC_predicted,0.2,4,4,GGGGCGACTGCCCAGTATCG,0,1895571
icdC_predicted,0.2,4,4,GGGGCGACAAGGGACCTGTT,0,1891522
icdC_predicted,0.2,4,4,GGGGATTGCCAGCTAGGGCA,0,1895280
icdC_predicted,0.2,4,4,GGGCTCACAGAACGTGTAAA,0,1896644
icdC_predicted,0.2,4,4,GGGCGGGATTTAGGGTCGCA,0,1889456
icdC_predicted,0.2,4,4,GGGCGACTCGAAGGTGTGAG,0,1879595
icdC_predicted,0.2,4,4,GGGATCCGGGAAGGAAGCAA,0,1894038
icdC_predicted,0.2,4,4,GGGAACCGAAGCAGCGGATT,0,1901736
icdC_predicted,0.2,4,4,GGCTTGAGGAAGGTTGGTGA,0,1892502
icdC_predicted,0.2,4,4,GGCGTGCTAACATGTGATTC,0,1896210
icdC_predicted,0.2,4,4,GGCCTTCGGGATCTATAGCA,0,1890346
icdC_predicted,0.2,4,4,GGCCTAGACTCAAATTAAGT,0,1896827
icdC_predicted,0.2,4,4,GGCCTAGACCTAATCCGTAT,0,1896154
icdC_predicted,0.2,4,4,GGCCCGCCCGCCCATGGAAA,0,1903211
icdC_predicted,0.2,4,4,GGCCACCATCCGACTAGGCC,0,1885240
icdC_predicted,0.2,4,4,GGCATATTGAGAAGGTCTCC,0,1881035
icdC_predicted,0.2,4,4,GGCAACCGGCACCTAGGGAT,0,1892592
icdC_predicted,0.2,4,4,GGATGTACACTTCTGCAGGT,0,1900623
icdC_predicted,0.2,4,4,GGATCTCGCAGGGCTACACA,0,1881159
icdC_predicted,0.2,4,4,GGATCCTTTGGTATAGAAAT,0,1879503
icdC_predicted,0.2,4,4,GGATAGATCGGCGGCAACTA,0,1888792
icdC_predicted,0.2,4,4,GGATAACAACGATACGACTT,0,1899081
icdC_predicted,0.2,4,4,GGAGGCGTGCTGACAATTGG,0,1892307
icdC_predicted,0.2,4,4,GGACCCGGGTATAGGCCGTA,0,1902634
icdC_predicted,0.2,4,4,GCTTGTAGCGCGGCGGTGTC,0,1879295
icdC_predicted,0.2,4,4,GCTGGTCGTTGATGCGTGTC,0,1898323
icdC_predicted,0.2,4,4,GCTCACGAATACACGATTGT,0,1882610
icdC_predicted,0.2,4,4,GCTACGAACCTTCCCCACAT,0,1884007
icdC_predicted,0.2,4,4,GCTACAGAAAACTATCTTAG,0,1888007
icdC_predicted,0.2,4,4,GCGTGTTCATCGCAACCTTG,0,1887559
icdC_predicted,0.2,4,4,GCGTGATTCAGTATGTAATT,0,1886623
icdC_predicted,0.2,4,4,GCGGTATGCACTGTAGGCGT,0,1906810
icdC_predicted,0.2,4,4,GCGGGTAGTCAACACACAAG,0,1888292
icdC_predicted,0.2,4,4,GCGGGCTAGCACGACGGATG,0,1886376
icdC_predicted,0.2,4,4,GCGCGGGGACGGGCCGGAGT,0,1906572
icdC_predicted,0.2,4,4,GCGCGATACATCTCCTGGTG,0,1897700
icdC_predicted,0.2,4,4,GCGCCGGGCGACGGATTATC,0,1879432
icdC_predicted,0.2,4,4,GCGAGCGGGATACGGGCACG,0,1897828
icdC_predicted,0.2,4,4,GCGACGGTTAACTCACCCCG,0,1900248
icdC_predicted,0.2,4,4,GCGAAGGTGCGATCCCCGTT,0,1900205
icdC_predicted,0.2,4,4,GCCTAGTCTGTGTTAAGTCA,0,1888376
icdC_predicted,0.2,4,4,GCCGTGTAGATGACGCTTCA,0,1907678
icdC_predicted,0.2,4,4,GCCGGCAGATTCCGTGTACA,0,1890459
icdC_predicted,0.2,4,4,GCCGGAACAGGGATAGCCTC,0,1889575
icdC_predicted,0.2,4,4,GCCCGCCCAAGGTTCTATAG,0,1903505
icdC_predicted,0.2,4,4,GCCCGATAGGTCGAATTTTT,0,1904282
icdC_predicted,0.2,4,4,GCCATGCATACGAGTTGTTA,0,1877970
icdC_predicted,0.2,4,4,GCCAGTGAGCCGAAGAGCTT,0,1879496
icdC_predicted,0.2,4,4,GCCAGTCTCCAATAGTGACA,0,1879314
icdC_predicted,0.2,4,4,GCATTTGGAGGGACATTTCC,0,1894891
icdC_predicted,0.2,4,4,GCATGGGTCCAGGCACATAG,0,1898695
icdC_predicted,0.2,4,4,GCATCAGTAAAGGAATCCAG,0,1896673
icdC_predicted,0.2,4,4,GCAGCGGGATGTCTCCTGGG,0,1901502
icdC_predicted,0.2,4,4,GCAGATATGGCGATATAACC,0,1892785
icdC_predicted,0.2,4,4,GCACTCGCATAATAAATGGT,0,1886466
icdC_predicted,0.2,4,4,GCAATTGTGTTAGACAAGGG,0,1885801
icdC_predicted,0.2,4,4,GATTTTCCCAAGAGCGAGAC,0,1894157
icdC_predicted,0.2,4,4,GATGCCGGACGTACAATGGC,0,1894273
icdC_predicted,0.2,4,4,GATGCACTGTGTGAGCTTCT,0,1900745
icdC_predicted,0.2,4,4,GATGAACCAAGACAGGTAGT,0,1889949
icdC_predicted,0.2,4,4,GATCGGTGATCTTTCGCCGA,0,1904133
icdC_predicted,0.2,4,4,GATAATAGGGAAGACCGCCC,0,1887540
icdC_predicted,0.2,4,4,GAGTTAGAGCAACCGAGAGA,0,1907777
icdC_predicted,0.2,4,4,GAGTCGGACTGTACAATTCT,0,1905278
icdC_predicted,0.2,4,4,GAGGTCGTATACAGATTCAA,0,1884285
icdC_predicted,0.2,4,4,GAGGAACTAGCTGTAGCGCA,0,1903116
icdC_predicted,0.2,4,4,GAGCTTTTTCCTGTGTCCTA,0,1891248
icdC_predicted,0.2,4,4,GAGAGTGTTTTTATAGGAGG,0,1893837
icdC_predicted,0.2,4,4,GAGAGGTATACACAGCCGTA,0,1896278
icdC_predicted,0.2,4,4,GAGAGCACGTTAAGTGTTGT,0,1885829
icdC_predicted,0.2,4,4,GAGAAGGGAGTCCATGTATT,0,1894709
icdC_predicted,0.2,4,4,GACTATTGTGGGACGGGCCT,0,1893466
icdC_predicted,0.2,4,4,GACGTTTAAACCCATGGAAT,0,1906285
icdC_predicted,0.2,4,4,GACGGTACCAAACTCACGAA,0,1891130
icdC_predicted,0.2,4,4,GACGCAGGATTGATCAGGAA,0,1887636
icdC_predicted,0.2,4,4,GACGAATCGGCAGAGCTGCA,0,1895590
icdC_predicted,0.2,4,4,GACCGGTCTTTGCTCCTGGT,0,1900014
icdC_predicted,0.2,4,4,GACAGGTTTCCTGGTAATCA,0,1890284
icdC_predicted,0.2,4,4,GAAGTCAGCGCTGCGACGGG,0,1888050
icdC_predicted,0.2,4,4,GAAGGTGTAAGATTCACACG,0,1885671
icdC_predicted,0.2,4,4,GAAGCAGGCCGGACCTGCAG,0,1902700
icdC_predicted,0.2,4,4,GAAGCAGAGCCATGATGGGT,0,1886298
icdC_predicted,0.2,4,4,GAAGCAAAGGAAGGTTACAA,0,1890972
icdC_predicted,0.2,4,4,GAACTTATATGAGATTATAT,0,1898398
icdC_predicted,0.2,4,4,GAACTAATAGCTAGTATCCG,0,1889466
icdC_predicted,0.2,4,4,GAACAGAACTCAACCGATAG,0,1886684
icdC_predicted,0.2,4,4,GAAAGTAGATTGTTAAATTA,0,1894021
icdC_predicted,0.2,4,4,CTTTCGTTCGTACGTATCAC,0,1903023
icdC_predicted,0.2,4,4,CTTTCGGGCTGACCTGTCAG,0,1878190
icdC_predicted,0.2,4,4,CTTTCCATTAAATGTAGTGT,0,1889648
icdC_predicted,0.2,4,4,CTTGAGACCCTGAGGGTCAT,0,1891172
icdC_predicted,0.2,4,4,CTTCTGGTATCTTGGGGTGG,0,1886489
icdC_predicted,0.2,4,4,CTTCGATCTCCGGAATGCAA,0,1886256
icdC_predicted,0.2,4,4,CTTCAGGGGCGCGGCTTTAC,0,1900168
icdC_predicted,0.2,4,4,CTTAATGGTTTCGGTCATAC,0,1896814
icdC_predicted,0.2,4,4,CTTAAGACTACCGCTACAGC,0,1900031
icdC_predicted,0.2,4,4,CTGTTTTAAATCAGCCACCT,0,1904087
icdC_predicted,0.2,4,4,CTGTACACATAAAACGGATC,0,1905876
icdC_predicted,0.2,4,4,CTGGTCATGGGCTACGACAC,0,1904687
icdC_predicted,0.2,4,4,CTGGTAGGCAAAGTTATTGC,0,1884024
icdC_predicted,0.2,4,4,CTGGCTCTCACATCTGTAGG,0,1891444
icdC_predicted,0.2,4,4,CTGGCGTTACCAGGGCTAAG,0,1888354
icdC_predicted,0.2,4,4,CTGGACGATTCGATTTGCGG,0,1887256
icdC_predicted,0.2,4,4,CTGCTTTATAAACTCACCTG,0,1880227
icdC_predicted,0.2,4,4,CTGCGGTTCCTTTGAGACCC,0,1894860
icdC_predicted,0.2,4,4,CTGCAGACTGATATCTAGTT,0,1909065
icdC_predicted,0.2,4,4,CTGATAGCTGGTTGATGATG,0,1892190
icdC_predicted,0.2,4,4,CTGAATTGAGTGGCCGCAAT,0,1881419
icdC_predicted,0.2,4,4,CTCTGTTGTAAACCCAGGGT,0,1880067
icdC_predicted,0.2,4,4,CTCGTAAGCCGACGACGGGG,0,1894852
icdC_predicted,0.2,4,4,CTCGACTGATACGGTGGTCT,0,1886765
icdC_predicted,0.2,4,4,CTCCTTCCCCGCGCTTGTTC,0,1885830
icdC_predicted,0.2,4,4,CTCCTCGATGGGCTTAGGGA,0,1894723
icdC_predicted,0.2,4,4,CTCCAGGCTTTCTTCGGTAA,0,1899238
icdC_predicted,0.2,4,4,CTCATTCAGGGGTGCGGGCT,0,1901666
icdC_predicted,0.2,4,4,CTCAGCTCGTGGGGTGGTAG,0,1907926
icdC_predicted,0.2,4,4,CTCAATCGAATTTACCCTCT,0,1897281
icdC_predicted,0.2,4,4,CTATTTATTCACAAGCAAGT,0,1905241
icdC_predicted,0.2,4,4,CTATTCCACTTTTACAGGTC,0,1906542
icdC_predicted,0.2,4,4,CTATGGTAGCATATCACATT,0,1885601
icdC_predicted,0.2,4,4,CTAGTGTCCTGTGCTTCGGA,0,1881458
icdC_predicted,0.2,4,4,CTAGGCAAGTCCAGTATACA,0,1894287
icdC_predicted,0.2,4,4,CTAGCGACACGATAGCCAGA,0,1881998
icdC_predicted,0.2,4,4,CTACTTAAGTCCCTGGGTCT,0,1892341
icdC_predicted,0.2,4,4,CTACTCTCCGACACCAATTT,0,1898773
icdC_predicted,0.2,4,4,CTACTCAGTCCTGAGGTGTT,0,1888159
icdC_predicted,0.2,4,4,CTACCGGCGGGCACTCACTC,0,1909126
icdC_predicted,0.2,4,4,CGTTTGGGATAGATTCCGTG,0,1902201
icdC_predicted,0.2,4,4,CGTTTCCTCACGTAAGTCTT,0,1893614
icdC_predicted,0.2,4,4,CGTTGTTGTAAAATACTTAT,0,1880962
icdC_predicted,0.2,4,4,CGTTATCAGCTCACGAGGCT,0,1893133
icdC_predicted,0.2,4,4,CGTGCGCCCATCGGGATGTA,0,1909468
icdC_predicted,0.2,4,4,CGTGAAGCTGGGTTGTACAA,0,1899443
icdC_predicted,0.2,4,4,CGTAGCCCGCATTGTTGCCT,0,1905833
icdC_predicted,0.2,4,4,CGTACTTCAAATAGGTGTAA,0,1908274
icdC_predicted,0.2,4,4,CGTACGTATACTGCGCCTGT,0,1886136
icdC_predicted,0.2,4,4,CGGTTTTTCCACTAACTGCT,0,1894403
icdC_predicted,0.2,4,4,CGGTGGAGCGCCTGCCGTAA,0,1880893
icdC_predicted,0.2,4,4,CGGTGCAGGGGGGGCGTCAA,0,1895022
icdC_predicted,0.2,4,4,CGGGCGTTAAAGACCGGGCA,0,1887434
icdC_predicted,0.2,4,4,CGGGATTCAGGCTATGGAGG,0,1903119
icdC_predicted,0.2,4,4,CGGCTTTGGCTTCAACCAGC,0,1879842
icdC_predicted,0.2,4,4,CGGCTCCCTACGTAATCCAT,0,1894437
icdC_predicted,0.2,4,4,CGGCCTGACTAGAGGGTCTT,0,1883267
icdC_predicted,0.2,4,4,CGGCCGTGCAAACCTTCAGT,0,1887918
icdC_predicted,0.2,4,4,CGGAGGGTTGCCAAGGGAGC,0,1909398
icdC_predicted,0.2,4,4,CGGACCAAACCCGTAGGTCC,0,1908791
icdC_predicted,0.2,4,4,CGGACATGTTGCTAGGCCGG,0,1891228
icdC_predicted,0.2,4,4,CGGAAACTAAGATAATTAAC,0,1881143
icdC_predicted,0.2,4,4,CGCTTGAGTCACTCATCCTA,0,1886895
icdC_predicted,0.2,4,4,CGCGTCACTAAGGAGGCCGC,0,1880239
icdC_predicted,0.2,4,4,CGCGCTGTGTCATGGCACTT,0,1886410
icdC_predicted,0.2,4,4,CGCCTGAGCATGAAGATGCT,0,1884879
icdC_predicted,0.2,4,4,CGCCGCCTGGGACCAGGAGG,0,1889696
icdC_predicted,0.2,4,4,CGCCATGATTGGTGCGGGAT,0,1900984
icdC_predicted,0.2,4,4,CGCATGCCTCAAGGGTGCGT,0,1896196
icdC_predicted,0.2,4,4,CGATGCCCGATACTCGGAAC,0,1907152
icdC_predicted,0.2,4,4,CGATCCGTACCGGTACCGCA,0,1883819
icdC_predicted,0.2,4,4,CGAGGTCCTTATGCGATTGG,0,1884852
icdC_predicted,0.2,4,4,CGAGGAGTTATGACTTTCGT,0,1883124
icdC_predicted,0.2,4,4,CGAGAGCTTTTTCCAAATAA,0,1896086
icdC_predicted,0.2,4,4,CGACTGGTGGCTATGGCCGT,0,1894766
icdC_predicted,0.2,4,4,CGACCACCTACAAAGGGACC,0,1888571
icdC_predicted,0.2,4,4,CGAAGTAAGTACACCACCTG,0,1909141
icdC_predicted,0.2,4,4,CGAAGCACTCGACGTCATAA,0,1888785
icdC_predicted,0.2,4,4,CCTTTGACCACTGGGGACAT,0,1899488
icdC_predicted,0.2,4,4,CCTTCTCAACGTCGAAAGGG,0,1880490
icdC_predicted,0.2,4,4,CCTGCGTTGAGCGAAGATAA,0,1891697
icdC_predicted,0.2,4,4,CCTCGCGAGCTGTTTAGGTG,0,1903095
icdC_predicted,0.2,4,4,CCTATACTTCATTTCTCAGG,0,1893997
icdC_predicted,0.2,4,4,CCTAGCAGGTTTTGTGATAA,0,1896023
icdC_predicted,0.2,4,4,CCGTGACTTTGAGGCTGATG,0,1883087
icdC_predicted,0.2,4,4,CCGGGTTTAAATCCTGGTTA,0,1885544
icdC_predicted,0.2,4,4,CCGGCTGAAGGTTCTCCTGT,0,1884633
icdC_predicted,0.2,4,4,CCGCTCCCACGAATCAACCG,0,1889530
icdC_predicted,0.2,4,4,CCGCTAGAACATTCCGCTCC,0,1880538
icdC_predicted,0.2,4,4,CCGCGCGCAACTGTCGCAAC,0,1895254
icdC_predicted,0.2,4,4,CCGCCTGATAGGGCTTGCAA,0,1885003
icdC_predicted,0.2,4,4,CCGATTTGCGAGGATAGGAC,0,1889571
icdC_predicted,0.2,4,4,CCGAAGGGATGTCTCACCTG,0,1905668
icdC_predicted,0.2,4,4,CCCTCTTTTTATCCTTCCGT,0,1881914
icdC_predicted,0.2,4,4,CCCTACGCTTTGGGGGGGGT,0,1893564
icdC_predicted,0.2,4,4,CCCGGACAAGCTCTTGGACC,0,1883568
icdC_predicted,0.2,4,4,CCCCCGAGGCAAGCTTCCAA,0,1898670
icdC_predicted,0.2,4,4,CCCAGTTAGCGAAATAGCGC,0,1886562
icdC_predicted,0.2,4,4,CCCAGATACAACGGGCTGAA,0,1903423
icdC_predicted,0.2,4,4,CCATTCGCCCCGTGGCTCAT,0,1894688
icdC_predicted,0.2,4,4,CCATGCGCGTAATTTTTTTA,0,1888314
icdC_predicted,0.2,4,4,CCATCCATGGGTCTAGTTAC,0,1892734
icdC_predicted,0.2,4,4,CCAGATGTACTGAAATACAT,0,1907820
icdC_predicted,0.2,4,4,CCAGAAGGCGTACCTCCGAC,0,1892750
icdC_predicted,0.2,4,4,CCACGTGTTTACCAGCTTCA,0,1880418
icdC_predicted,0.2,4,4,CCACGGGGACTATTAGAGTT,0,1886266
icdC_predicted,0.2,4,4,CCACGCTGCCAAGCATAGAC,0,1891319
icdC_predicted,0.2,4,4,CATTTGCTCTGTATCATCAT,0,1897773
icdC_predicted,0.2,4,4,CATTAAGAGGGCCGCCAGCT,0,1885344
icdC_predicted,0.2,4,4,CATGGTTTGCCATATACAGG,0,1894005
icdC_predicted,0.2,4,4,CATGCCAAATGACGCTGGTC,0,1887544
icdC_predicted,0.2,4,4,CATCCGGGTCAAGGGCCATT,0,1889263
icdC_predicted,0.2,4,4,CATCCATGGTCAAAAACCAT,0,1905456
icdC_predicted,0.2,4,4,CATACGGTTCTCCAGAAGAT,0,1880925
icdC_predicted,0.2,4,4,CAGTCGAAGCCATGGAAATC,0,1878442
icdC_predicted,0.2,4,4,CAGGTTTAGCTTAGGATCCA,0,1906485
icdC_predicted,0.2,4,4,CAGGTGTGATCTCATGATAA,0,1906844
icdC_predicted,0.2,4,4,CAGGTCTAGCATGTCCCCCC,0,1884967
icdC_predicted,0.2,4,4,CAGGGTGCGCTCCAGAGCCA,0,1899754
icdC_predicted,0.2,4,4,CAGGGCTTCGAGAGTCTCGC,0,1881663
icdC_predicted,0.2,4,4,CAGCGGGTGGCAGAAGCGCA,0,1886417
icdC_predicted,0.2,4,4,CAGCGGCAGAGGGACGGGGG,0,1880866
icdC_predicted,0.2,4,4,CAGCAAGGATTGTCTGGACT,0,1905686
icdC_predicted,0.2,4,4,CAGATGTCCACACACTACTC,0,1889323
icdC_predicted,0.2,4,4,CAGAAACTCCTTACAAGAGA,0,1897886
icdC_predicted,0.2,4,4,CACTCTTGGCAGCCGTCTTA,0,1879959
icdC_predicted,0.2,4,4,CACGTCCGTAAGTGGTACGT,0,1898780
icdC_predicted,0.2,4,4,CACGGATTAGCGTTAATTAA,0,1889968
icdC_predicted,0.2,4,4,CACGAAGGCGGGATATTTTT,0,1885524
icdC_predicted,0.2,4,4,CACCGTCACCGTCTAACCCT,0,1890332
icdC_predicted,0.2,4,4,CACCGGACTCCGATCAAGAC,0,1878437
icdC_predicted,0.2,4,4,CACACTGTTTAGTCACTCGA,0,1893255
icdC_predicted,0.2,4,4,CAATCACAGTGACGAGATCA,0,1886784
icdC_predicted,0.2,4,4,CAATAGAGCTGCATTATGGG,0,1894416
icdC_predicted,0.2,4,4,CAAGGCTAATTAAGTCATGG,0,1899112
icdC_predicted,0.2,4,4,CAAATGTCAATCAAGAGGCT,0,1886709
icdC_predicted,0.2,4,4,CAAATCAGATGTTCAGACTA,0,1886035
icdC_predicted,0.2,4,4,CAAAATTCCCCCTTCACTCC,0,1892732
icdC_predicted,0.2,4,4,ATTTTTAACTCAGCTGAACG,0,1899139
icdC_predicted,0.2,4,4,ATTTCCTAGCAAGTCTCAGC,0,1903485
icdC_predicted,0.2,4,4,ATTTCACGGCCGTAAACAGC,0,1898204
icdC_predicted,0.2,4,4,ATTGGGGTCCCATTTCTTCT,0,1881830
icdC_predicted,0.2,4,4,ATTGATCCCAACGTGCATTA,0,1895552
icdC_predicted,0.2,4,4,ATTGAAAGGGAGCATTAGGG,0,1890219
icdC_predicted,0.2,4,4,ATTCGTTACGGGAGTCTGCA,0,1890540
icdC_predicted,0.2,4,4,ATTCGGAGCATGAATAATTC,0,1903195
icdC_predicted,0.2,4,4,ATTCACGCGTAATATCCCGT,0,1881196
icdC_predicted,0.2,4,4,ATTCACCGTTCTGATTTTGT,0,1887400
icdC_predicted,0.2,4,4,ATTATTGAGTATCTTGCAGT,0,1878718
icdC_predicted,0.2,4,4,ATTAGTATAGTCGTTTAAAC,0,1905771
icdC_predicted,0.2,4,4,ATGGTCCAATTCTTTCAGCT,0,1901278
icdC_predicted,0.2,4,4,ATGCTAGAACGGCTCGGTGG,0,1891417
icdC_predicted,0.2,4,4,ATGATTGCATTCTGAAGTAA,0,1905272
icdC_predicted,0.2,4,4,ATGACGGTGGACTGCCTTAG,0,1892046
icdC_predicted,0.2,4,4,ATCTAGAGGGACGGATGCTT,0,1895886
icdC_predicted,0.2,4,4,ATCTACGATGTTTATAGTGT,0,1888022
icdC_predicted,0.2,4,4,ATCGTAAACGGGTGTCCGTT,0,1900705
icdC_predicted,0.2,4,4,ATCCGGTATCTGTGAAGTTC,0,1881004
icdC_predicted,0.2,4,4,ATCCCGGGTTATTCTAAGGG,0,1894597
icdC_predicted,0.2,4,4,ATCCACCCACGCGCGATTTA,0,1886443
icdC_predicted,0.2,4,4,ATCCACATGAGTGCCTAAAG,0,1893697
icdC_predicted,0.2,4,4,ATCCAAGTAAACCGAATCAT,0,1895119
icdC_predicted,0.2,4,4,ATCATGTTACGGAGCTTCAG,0,1891668
icdC_predicted,0.2,4,4,ATCAATGGTGGAGCACACCA,0,1896143
icdC_predicted,0.2,4,4,ATATTGGATATGATTTTTAT,0,1881128
icdC_predicted,0.2,4,4,ATATGGTTTATTAAAGAGGA,0,1882862
icdC_predicted,0.2,4,4,ATATGGCACGAGTCAAACAG,0,1900075
icdC_predicted,0.2,4,4,ATATGCGATAGGCGAAGCGC,0,1889505
icdC_predicted,0.2,4,4,ATAGCCACGCATTCCTGGTC,0,1883269
icdC_predicted,0.2,4,4,ATAGAAGAGTTTTAAAATTG,0,1883083
icdC_predicted,0.2,4,4,ATACGCGCTGGGATTCGCGT,0,1888597
icdC_predicted,0.2,4,4,ATAATTAGTATGGGCGTTCT,0,1896548
icdC_predicted,0.2,4,4,AGTTCTGGTGTCATTTATTA,0,1884819
icdC_predicted,0.2,4,4,AGTTCATAGTTATCTCTTAC,0,1883478
icdC_predicted,0.2,4,4,AGTGATCAGCCATAACCGTC,0,1905319
icdC_predicted,0.2,4,4,AGTACCCAATAATGTGCACG,0,1907667
icdC_predicted,0.2,4,4,AGGTGAAGTTGGCTGCATGA,0,1885532
icdC_predicted,0.2,4,4,AGGTCTAGACCAGCGCCCCC,0,1897824
icdC_predicted,0.2,4,4,AGGGGCCATTGGCTCGGAAG,0,1909507
icdC_predicted,0.2,4,4,AGGGGAGAAAGACATGTGGT,0,1897122
icdC_predicted,0.2,4,4,AGGGCGAGTACTCGGACGCA,0,1887268
icdC_predicted,0.2,4,4,AGGGAGGGCCGGTCCCACCT,0,1901016
icdC_predicted,0.2,4,4,AGGGACTCGACGGTCGCGAC,0,1908169
icdC_predicted,0.2,4,4,AGGCTTATCGAGGTTGCACC,0,1903434
icdC_predicted,0.2,4,4,AGGCTGGACTGAACCGTAGG,0,1883646
icdC_predicted,0.2,4,4,AGGCTGATCAGTAATAGATG,0,1880153
icdC_predicted,0.2,4,4,AGGCTACCGCTGTTGTCGTA,0,1898813
icdC_predicted,0.2,4,4,AGGAGTTGCACACATACTAC,0,1883760
icdC_predicted,0.2,4,4,AGGAGAATGGCCGACCAATC,0,1892603
icdC_predicted,0.2,4,4,AGGACGTGTCTTCGCGAGGG,0,1902514
icdC_predicted,0.2,4,4,AGGAACGGGCAGTCCCCCAG,0,1880548
icdC_predicted,0.2,4,4,AGCTTCCTCGAGCGAAAGTA,0,1881900
icdC_predicted,0.2,4,4,AGCGTATCGGCTATAACGTT,0,1886739
icdC_predicted,0.2,4,4,AGCGGGTTTTCAAACCTCTT,0,1903370
icdC_predicted,0.2,4,4,AGCGGCCGTTTCCTATTATG,0,1904734
icdC_predicted,0.2,4,4,AGCGCAACCCCTCTCAATCG,0,1886150
icdC_predicted,0.2,4,4,AGCCAAGTCGTGGTGTGGAA,0,1881311
icdC_predicted,0.2,4,4,AGCCAAAATGCTTTGGGTAA,0,1899961
icdC_predicted,0.2,4,4,AGCATTTAAGCGCGTACTTA,0,1883573
icdC_predicted,0.2,4,4,AGCATCAAACTTTTTGACCG,0,1878447
icdC_predicted,0.2,4,4,AGATTATACTTTGAGTTTTA,0,1895583
icdC_predicted,0.2,4,4,AGATGGGTCTATCGTTGAGT,0,1893312
icdC_predicted,0.2,4,4,AGATGGGACGACGGCTAAGA,0,1892019
icdC_predicted,0.2,4,4,AGAGTGTCTGTTAAATAGGT,0,1900336
icdC_predicted,0.2,4,4,AGAGTCGGCAGATCTAAAGC,0,1884636
icdC_predicted,0.2,4,4,AGACGAGATCTAATTGTTTT,0,1898125
icdC_predicted,0.2,4,4,AGAAACGACTTATACGGATG,0,1905349
icdC_predicted,0.2,4,4,ACTCCGGTGCGTTAGCGCAT,0,1896637
icdC_predicted,0.2,4,4,ACTACTAAAAAGACCACCTT,0,1887255
icdC_predicted,0.2,4,4,ACTAATCACTATACGACGTC,0,1909068
icdC_predicted,0.2,4,4,ACGCGGCTACTATAGGTCAA,0,1884262
icdC_predicted,0.2,4,4,ACGCGGAAACGTATCAGATC,0,1897280
icdC_predicted,0.2,4,4,ACCTGTTTTCGTGGATGTGC,0,1879949
icdC_predicted,0.2,4,4,ACCTACGGGATGCTTCTGAA,0,1903254
icdC_predicted,0.2,4,4,ACCGAATGACTCACTTAGAC,0,1896807
icdC_predicted,0.2,4,4,ACCGAAAATAGAGCCGACAC,0,1883876
icdC_predicted,0.2,4,4,ACCCTTGACCCCGGGCTCGC,0,1893426
icdC_predicted,0.2,4,4,ACCATTTGCGAGTTGCGCCT,0,1888436
icdC_predicted,0.2,4,4,ACATGACTGCATACTAATTA,0,1884062
icdC_predicted,0.2,4,4,ACATCTGCTTGGAAGCCCTA,0,1887416
icdC_predicted,0.2,4,4,ACATCTAGTTAATTCGGTGA,0,1907934
icdC_predicted,0.2,4,4,ACATCCGAGGACATATTCAA,0,1905115
icdC_predicted,0.2,4,4,ACAGTTCATCTTTATACTTC,0,1879162
icdC_predicted,0.2,4,4,ACAGTGAGTAACGGGTTACA,0,1892985
icdC_predicted,0.2,4,4,ACAGGGCTTCTGCCGCGCTC,0,1894641
icdC_predicted,0.2,4,4,ACAGGCCTTGGCCAGGCTAA,0,1903945
icdC_predicted,0.2,4,4,ACACTTCCTATTTCCTGTCT,0,1880586
icdC_predicted,0.2,4,4,ACACGGATAGGGGGGAGGGT,0,1888966
icdC_predicted,0.2,4,4,ACACCCAGAAAAACCGGTAA,0,1888095
icdC_predicted,0.2,4,4,ACACCACACAGTTGAACGTA,0,1902895
icdC_predicted,0.2,4,4,ACACACAACCACTTCAACGG,0,1900201
icdC_predicted,0.2,4,4,ACACAAGGCGCTCCGCCTTT,0,1884739
icdC_predicted,0.2,4,4,ACAACGTCCTATCTTTGGAA,0,1900491
icdC_predicted,0.2,4,4,AATTTAGGCCGTTGTAGGTC,0,1903159
icdC_predicted,0.2,4,4,AATTGAACGAAACTGGTGGG,0,1892482
icdC_predicted,0.2,4,4,AATGTGCGCCTCGCGAGAGT,0,1878875
icdC_predicted,0.2,4,4,AATGTAAGAACTTGCGGGCA,0,1889800
icdC_predicted,0.2,4,4,AATGGGGAATACCGAGTGGT,0,1905873
icdC_predicted,0.2,4,4,AATGGAGCATTTTCAAATAC,0,1892996
icdC_predicted,0.2,4,4,AATCGTAGTGGCCGTCCGAA,0,1882397
icdC_predicted,0.2,4,4,AATCATACCGAATAATGCGA,0,1892854
icdC_predicted,0.2,4,4,AATACCTGCTCTTATGAGAT,0,1903718
icdC_predicted,0.2,4,4,AAGTCTCATCTACTGGGTGC,0,1901263
icdC_predicted,0.2,4,4,AAGGTGGCGGCTGTAAAGTG,0,1880395
icdC_predicted,0.2,4,4,AAGGCGATCGTTGCTGTAAT,0,1890757
icdC_predicted,0.2,4,4,AAGGCGAATTCGCGCATCTT,0,1885904
icdC_predicted,0.2,4,4,AAGCGACTGAAAAGTTCTCT,0,1897068
icdC_predicted,0.2,4,4,AAGCCATGAAGACGCACTTT,0,1883173
icdC_predicted,0.2,4,4,AAGATTATGTCTGAGATTCC,0,1901023
icdC_predicted,0.2,4,4,AAGAAGAATAACTCTCCTCC,0,1907800
icdC_predicted,0.2,4,4,AAGAAAATTGACATGCCCGA,0,1887622
icdC_predicted,0.2,4,4,AACGTGATAAGGGCGTCTTG,0,1904478
icdC_predicted,0.2,4,4,AACGATCTTTTGTGGTACAC,0,1890197
icdC_predicted,0.2,4,4,AACGATCGGTGCTTGCGGAC,0,1896617
icdC_predicted,0.2,4,4,AACAGTAGCAGTACTCGCGT,0,1906656
icdC_predicted,0.2,4,4,AACACCGTCACTCCCAATCT,0,1899710
icdC_predicted,0.2,4,4,AAATGAGTACCAGCACCTAC,0,1887293
icdC_predicted,0.2,4,4,AAAGCGAGGCGGTCACGCGG,0,1879819
icdC_predicted,0.2,4,4,AAACCTCGGCGGGCTTAGGT,0,1899524
icdC_predicted,0.2,4,4,AAACCCGAAGTAGGCTAGGA,0,1878859
icdC_predicted,0.2,4,4,AAAACTCGTTGTATAGGTGT,0,1897717
icdC_predicted,0.2,4,4,AAAACGGCACTTGGCTCCAT,0,1893669
icdC_predicted,0.25,3,3,TTTTTCACATTGTCAGGGAT,0,1889390
icdC_predicted,0.25,3,3,TTTTTCACAACAAATGCAAA,0,1885331
icdC_predicted,0.25,3,3,TTTTTACGGATACGTCCAGT,0,1878857
icdC_predicted,0.25,3,3,TTTTTAATAGTCGTGCCAAA,0,1900276
icdC_predicted,0.25,3,3,TTTTGCTATCCCGCTGCGGC,0,1891887
icdC_predicted,0.25,3,3,TTTTCCGGTAAGTTTTCGTG,0,1891103
icdC_predicted,0.25,3,3,TTTGTACCAGGCGCTTAACT,0,1899865
icdC_predicted,0.25,3,3,TTTGGATCACCTGTATACTA,0,1895042
icdC_predicted,0.25,3,3,TTTGCAGCGGGAGTAGCAGA,0,1881884
icdC_predicted,0.25,3,3,TTTGAGGTAAGTGCATCTGG,0,1893098
icdC_predicted,0.25,3,3,TTTCAGGCGAAAAAGCTAGA,0,1894154
icdC_predicted,0.25,3,3,TTTATGTTCATGTTTGAGGA,0,1908730
icdC_predicted,0.25,3,3,TTTATAGCAGCCGGACGGTC,0,1908503
icdC_predicted,0.25,3,3,TTTAACGCCCCTGAAGTGCA,0,1896572
icdC_predicted,0.25,3,3,TTGTGATCTCAGCGAGTCAG,0,1889274
icdC_predicted,0.25,3,3,TTGTCGGGAGACAGCCTGTT,0,1903728
icdC_predicted,0.25,3,3,TTGTCCGGGGCTTTGGATCC,0,1878619
icdC_predicted,0.25,3,3,TTGGTCCGTGGGATGGATAA,0,1902664
icdC_predicted,0.25,3,3,TTGGGTGCCGAAGTTCCCGC,0,1891698
icdC_predicted,0.25,3,3,TTGGCCCAGGGCAAGGATCC,0,1907630
icdC_predicted,0.25,3,3,TTGGAACCGCTGGGCCTGTT,0,1908634
icdC_predicted,0.25,3,3,TTGCTACCAGTAGTCTCCTT,0,1878094
icdC_predicted,0.25,3,3,TTGCCCGTTTCCCCCGCGAA,0,1899439
icdC_predicted,0.25,3,3,TTGCAGCGTGACATAGGCTT,0,1893871
icdC_predicted,0.25,3,3,TTGATATAACTCAAATGTTT,0,1881816
icdC_predicted,0.25,3,3,TTGATACTACGGAAACACGT,0,1879356
icdC_predicted,0.25,3,3,TTCTTAAATGCACGCGACGA,0,1888946
icdC_predicted,0.25,3,3,TTCTACGACGGTAATTGGAA,0,1887281
icdC_predicted,0.25,3,3,TTCGTTTCCTCCAAGCCTTA,0,1879371
icdC_predicted,0.25,3,3,TTCGTGGGAGATGGCTTCAC,0,1899936
icdC_predicted,0.25,3,3,TTCGGGGGTATTGCAACGCC,0,1892986
icdC_predicted,0.25,3,3,TTCGGCAGTACTCGAGCTAA,0,1889363
icdC_predicted,0.25,3,3,TTCCTGCAATTCCTCTAGTT,0,1900876
icdC_predicted,0.25,3,3,TTCCGGACAATACTTTTAAT,0,1882993
icdC_predicted,0.25,3,3,TTCCAATGTTCGGATCAAGG,0,1896981
icdC_predicted,0.25,3,3,TTCAGGCTACTCGACGGTAT,0,1889856
icdC_predicted,0.25,3,3,TTCACGCCCACCCATCTTCA,0,1880822
icdC_predicted,0.25,3,3,TTCAATCGAACGCTCTACAT,0,1909405
icdC_predicted,0.25,3,3,TTATGGGGCAGCTTCAGCAT,0,1883733
icdC_predicted,0.25,3,3,TTAGGGGTGTCTTGTCTATA,0,1898673
icdC_predicted,0.25,3,3,TTAGGCGAAACATGCAATCC,0,1902111
icdC_predicted,0.25,3,3,TTAGCGGTGCGCCGCTAGCT,0,1880932
icdC_predicted,0.25,3,3,TTAGACGGAGCCGGTTCAGC,0,1890238
icdC_predicted,0.25,3,3,TTACCGCATAAGGGATTGAA,0,1902801
icdC_predicted,0.25,3,3,TTACACAGTAGCCTATCGAC,0,1884438
icdC_predicted,0.25,3,3,TTAACGGCCTAATCCATACG,0,1899835
icdC_predicted,0.25,3,3,TTAACAGTAGAATCGGAGCC,0,1887706
icdC_predicted,0.25,3,3,TGTTTGGGTGTAGTGTGCTC,0,1880136
icdC_predicted,0.25,3,3,TGTTTGCGGCATGTCGGCAA,0,1897353
icdC_predicted,0.25,3,3,TGTTCGCGCGAAAGGCATGC,0,1881826
icdC_predicted,0.25,3,3,TGTGGTGGTGGTCGCGGAAA,0,1879977
icdC_predicted,0.25,3,3,TGTGGTAGAATCATCACGGA,0,1904127
icdC_predicted,0.25,3,3,TGTGGGTTATCAAACGTGGT,0,1907099
icdC_predicted,0.25,3,3,TGTGGGTCCCACGCGACCAT,0,1883887
icdC_predicted,0.25,3,3,TGTGCAGTCCTCTCATCATC,0,1895708
icdC_predicted,0.25,3,3,TGTGATTAGCTAATGTATAC,0,1898259
icdC_predicted,0.25,3,3,TGTGATCCCGCGACCCAGCA,0,1896625
icdC_predicted,0.25,3,3,TGTCGTATGGGTACTCTTTT,0,1908313
icdC_predicted,0.25,3,3,TGTCCAAGTTAACACTCAAG,0,1889600
icdC_predicted,0.25,3,3,TGTACTCCACTGAACATAGT,0,1881797
icdC_predicted,0.25,3,3,TGGTGGCATTATGCCTCTCA,0,1888397
icdC_predicted,0.25,3,3,TGGTCTTTCGGGTGTACAAG,0,1908656
icdC_predicted,0.25,3,3,TGGTATGTGAAGTACGCCTT,0,1880534
icdC_predicted,0.25,3,3,TGGGTTTAAACGCTCTCTCT,0,1885012
icdC_predicted,0.25,3,3,TGGGTCACGTTCGCCAACGT,0,1886262
icdC_predicted,0.25,3,3,TGGGCGCCGTTTCTAAGTAC,0,1900064
icdC_predicted,0.25,3,3,TGGCTTTGGGAGTACATGAA,0,1906203
icdC_predicted,0.25,3,3,TGGCTATTGACTGCGGCCCT,0,1889128
icdC_predicted,0.25,3,3,TGGCGGTTAATTCTCAATTC,0,1878789
icdC_predicted,0.25,3,3,TGGCGATCAACGTACCCATT,0,1905795
icdC_predicted,0.25,3,3,TGGATTTTTCAGTTTAGCCG,0,1895010
icdC_predicted,0.25,3,3,TGGAGGTCGCGGCAACGTCC,0,1881746
icdC_predicted,0.25,3,3,TGGAGCTGTCAATCGATGGT,0,1896195
icdC_predicted,0.25,3,3,TGGACTGTCTGGTGATCCAA,0,1905135
icdC_predicted,0.25,3,3,TGGAATATATTGTTTCGTAT,0,1897321
icdC_predicted,0.25,3,3,TGCTTGCGGTCTGTATGACA,0,1905284
icdC_predicted,0.25,3,3,TGCTTCAATTCGGGACGAAA,0,1909289
icdC_predicted,0.25,3,3,TGCTGTCAATGCTTGGAATA,0,1896421
icdC_predicted,0.25,3,3,TGCTGCAGAGTTCATTTCCT,0,1894016
icdC_predicted,0.25,3,3,TGCTACCGCAACAAAGTATT,0,1908732
icdC_predicted,0.25,3,3,TGCTAACCGACGGTCCTGAC,0,1907098
icdC_predicted,0.25,3,3,TGCGGGCTAGAGCCGATCGC,0,1891005
icdC_predicted,0.25,3,3,TGCCCTGGAAGTCTGACGAT,0,1878445
icdC_predicted,0.25,3,3,TGCCCAAAGATCACCATAAC,0,1890353
icdC_predicted,0.25,3,3,TGCATAAGGGGTTCCGATCC,0,1888488
icdC_predicted,0.25,3,3,TGCAGACCTGTCTCCAGATA,0,1882265
icdC_predicted,0.25,3,3,TGCACTTATAGGCACGGCAG,0,1886766
icdC_predicted,0.25,3,3,TGCACAACAGCTTGGAATTT,0,1888266
icdC_predicted,0.25,3,3,TGCAACGCGAATCATGGTGA,0,1905582
icdC_predicted,0.25,3,3,TGCAACCGTACAGCTCGAGC,0,1885469
icdC_predicted,0.25,3,3,TGAGCGGCATGGATGATTCT,0,1899281
icdC_predicted,0.25,3,3,TGAGACCGACTGACCCGCCA,0,1889577
icdC_predicted,0.25,3,3,TGACAATGTTAGACTGCATA,0,1906913
icdC_predicted,0.25,3,3,TGAATTCCACGAAATCCCGA,0,1893144
icdC_predicted,0.25,3,3,TGAAGGGTCGTCAAACTTTT,0,1889962
icdC_predicted,0.25,3,3,TGAAAATTGCACATCTCTAT,0,1893009
icdC_predicted,0.25,3,3,TCTTCGTGGATAATCGGGTC,0,1903702
icdC_predicted,0.25,3,3,TCTTAGGGCTCCGACTTGCG,0,1884740
icdC_predicted,0.25,3,3,TCTGATGGCTTTGGCAAGCA,0,1881555
icdC_predicted,0.25,3,3,TCTCTGCAACGCTGCCAGAT,0,1900822
icdC_predicted,0.25,3,3,TCTCGTGGATTTTAAGTGGC,0,1896599
icdC_predicted,0.25,3,3,TCTCCATATTACGAGTGGCC,0,1881031
icdC_predicted,0.25,3,3,TCTATTACGCTCCGGGTAAG,0,1896957
icdC_predicted,0.25,3,3,TCTATCACATGGCTCAATTT,0,1883153
icdC_predicted,0.25,3,3,TCTATCAAACTGTGAATAGG,0,1897697
icdC_predicted,0.25,3,3,TCTAGTGTGTTATTTCGAAG,0,1885133
icdC_predicted,0.25,3,3,TCTACCCGCGAGGGCAAGAC,0,1891450
icdC_predicted,0.25,3,3,TCTAACGCAAGTTGGACAGA,0,1893122
icdC_predicted,0.25,3,3,TCGTCCCGATCGACTCTACG,0,1892436
icdC_predicted,0.25,3,3,TCGGTCTGCGGCCCGTGTAA,0,1893182
icdC_predicted,0.25,3,3,TCGGGTAGAAACCGAAACAC,0,1908795
icdC_predicted,0.25,3,3,TCGGCGAGTGTCACATGTCA,0,1902766
icdC_predicted,0.25,3,3,TCGCTTCAACGTGGTCCAAG,0,1905298
icdC_predicted,0.25,3,3,TCGCCGCATTCGGCACTTTA,0,1896641
icdC_predicted,0.25,3,3,TCGCATAGGGTCTGTAAGGG,0,1903870
icdC_predicted,0.25,3,3,TCGATATTAGGATTCGTTTC,0,1900690
icdC_predicted,0.25,3,3,TCCTGACTTACATCGTCGAT,0,1893976
icdC_predicted,0.25,3,3,TCCGGACCATAGTTCTAGCG,0,1908323
icdC_predicted,0.25,3,3,TCCCTCCTTCAACGGGGTAC,0,1899827
icdC_predicted,0.25,3,3,TCCATCTAAGGGATCCGTGC,0,1899082
icdC_predicted,0.25,3,3,TCCAGGCGCTGAGGTTTGGA,0,1885594
icdC_predicted,0.25,3,3,TCATCTGTGACGCACGGGTG,0,1886338
icdC_predicted,0.25,3,3,TCATCGGGTGGAGTGATATG,0,1879133
icdC_predicted,0.25,3,3,TCATCGGAGTAGGGATAGAG,0,1883567
icdC_predicted,0.25,3,3,TCATCCCACTCAGCCGTTCG,0,1891040
icdC_predicted,0.25,3,3,TCATCATATCCAGGGTCAGG,0,1899340
icdC_predicted,0.25,3,3,TCATAGCCTTTAGCATACGG,0,1892585
icdC_predicted,0.25,3,3,TCAATGTGAGAACCATACTG,0,1905247
icdC_predicted,0.25,3,3,TCAAAACAATATGGATCATG,0,1900387
icdC_predicted,0.25,3,3,TATTTTGGAGAGCTCCGCAC,0,1890069
icdC_predicted,0.25,3,3,TATTGTGCACCGTCGGTTAT,0,1901754
icdC_predicted,0.25,3,3,TATTAGGAACGTGATTCTGC,0,1897242
icdC_predicted,0.25,3,3,TATTAGGAACCTATCCAAGA,0,1879417
icdC_predicted,0.25,3,3,TATGGTGGCGCCATTGGAAA,0,1888815
icdC_predicted,0.25,3,3,TATGCGCGTCGAGCAAGAGT,0,1902371
icdC_predicted,0.25,3,3,TATGAGATTGTCACCATTTT,0,1879057
icdC_predicted,0.25,3,3,TATCGGCTTATTTAGATTTA,0,1901603
icdC_predicted,0.25,3,3,TATCGGATACAGCGGCCCCT,0,1878123
icdC_predicted,0.25,3,3,TATCGCCACACTGGATTAGA,0,1893199
icdC_predicted,0.25,3,3,TATCCGGCAGGCAATCATTC,0,1893673
icdC_predicted,0.25,3,3,TATAGTGACACGACCGGTAC,0,1908437
icdC_predicted,0.25,3,3,TAGGCCCCGAGACCAAAGAG,0,1907713
icdC_predicted,0.25,3,3,TAGGAATCACGAATGTATAT,0,1909260
icdC_predicted,0.25,3,3,TAGCGCTAGCTCCAGTCTCG,0,1886056
icdC_predicted,0.25,3,3,TAGCGCGGACTATATTCAAA,0,1899730
icdC_predicted,0.25,3,3,TAGACCGGGGTACGTGCTTG,0,1899635
icdC_predicted,0.25,3,3,TAGACCCTTAACAGATTGTA,0,1887699
icdC_predicted,0.25,3,3,TACTTCAAATTCGTGTTAAC,0,1880036
icdC_predicted,0.25,3,3,TACGTGGTAAGAAATCATTT,0,1882924
icdC_predicted,0.25,3,3,TACGGGAGGGCTGGTGGCTC,0,1909407
icdC_predicted,0.25,3,3,TACGCGAGTGTGCGGGTCCT,0,1881515
icdC_predicted,0.25,3,3,TACCGCATGAATTCTTTGTG,0,1899031
icdC_predicted,0.25,3,3,TACCGCAAGCAGGGTTAGAC,0,1897234
icdC_predicted,0.25,3,3,TACCGACATAACACTCTGCA,0,1886831
icdC_predicted,0.25,3,3,TACCCGCTATACCAATATCC,0,1882547
icdC_predicted,0.25,3,3,TACCACGCCCGAAGCCTGTA,0,1897440
icdC_predicted,0.25,3,3,TACAGGTCCACAGCGACCAC,0,1903236
icdC_predicted,0.25,3,3,TACAAGGGGGAGAAGAGAAG,0,1892344
icdC_predicted,0.25,3,3,TAATTTGAACTGTTTGCCCG,0,1899825
icdC_predicted,0.25,3,3,TAATTTAGGTCCTATGAGTT,0,1907166
icdC_predicted,0.25,3,3,TAATAGCCAAAGGCTCGAAA,0,1904074
icdC_predicted,0.25,3,3,TAAGTGCGGGCCAATACATC,0,1892178
icdC_predicted,0.25,3,3,TAAGTGCGCATCCTTCGGAG,0,1884316
icdC_predicted,0.25,3,3,TAAGTAGAGAAACGATACTT,0,1884966
icdC_predicted,0.25,3,3,TAAGAAGCACTCCGGGGCAT,0,1891101
icdC_predicted,0.25,3,3,TAACTTGGAAGGTTTCAATC,0,1904997
icdC_predicted,0.25,3,3,TAACCGATCCGTCTATGGGG,0,1887047
icdC_predicted,0.25,3,3,TAAAGCCGAGTATGGGATGC,0,1885638
icdC_predicted,0.25,3,3,TAAACCTCCAGCCGTAAGTC,0,1886270
icdC_predicted,0.25,3,3,GTTTTTGGACCATCGAGTTG,0,1881814
icdC_predicted,0.25,3,3,GTTTTGGACCTGACCATCCT,0,1880469
icdC_predicted,0.25,3,3,GTTTTCGTCGGGTGGGGGTG,0,1907796
icdC_predicted,0.25,3,3,GTTTCATTAAGTCACGGTTC,0,1889718
icdC_predicted,0.25,3,3,GTTTCACTGGACTAGTTGCG,0,1901302
icdC_predicted,0.25,3,3,GTTGGTCCGAAATTAACGAT,0,1896597
icdC_predicted,0.25,3,3,GTTGCCCTAAAGGGAATGAT,0,1895438
icdC_predicted,0.25,3,3,GTTGACATAAACTATACCGT,0,1885914
icdC_predicted,0.25,3,3,GTTCTCCTGGTTAGTCAACG,0,1904134
icdC_predicted,0.25,3,3,GTTCCACCTGGTGCTGCCGT,0,1886692
icdC_predicted,0.25,3,3,GTTCACAAGGTCCGCTCATA,0,1884307
icdC_predicted,0.25,3,3,GTTATTGGGGAGTGTAGATG,0,1890566
icdC_predicted,0.25,3,3,GTTATTAACTTATTACCTGC,0,1901959
icdC_predicted,0.25,3,3,GTTAGAGCGGTCAATCGTTT,0,1898662
icdC_predicted,0.25,3,3,GTTAGAGACAGGCTAAGCAA,0,1902387
icdC_predicted,0.25,3,3,GTTACCTTTAATATGGGTCG,0,1905437
icdC_predicted,0.25,3,3,GTTAATGACGGAGGCTGCCA,0,1905990
icdC_predicted,0.25,3,3,GTGTGTGCACCGCCAATCAA,0,1880498
icdC_predicted,0.25,3,3,GTGTGGGTATGGGAGCAGTC,0,1900626
icdC_predicted,0.25,3,3,GTGTATGTTACTTACTCAGC,0,1891883
icdC_predicted,0.25,3,3,GTGTAGATAGCGGTCAGTTA,0,1893038
icdC_predicted,0.25,3,3,GTGGGAAAACGGAGTTCTGC,0,1904564
icdC_predicted,0.25,3,3,GTGGCATCTGGCCTAGATCC,0,1884238
icdC_predicted,0.25,3,3,GTGCGCATTGTGTGCTGTTG,0,1891495
icdC_predicted,0.25,3,3,GTGCCATCGGGATTTAGGCA,0,1898707
icdC_predicted,0.25,3,3,GTGCCAAGAATGGCTCGAAA,0,1888130
icdC_predicted,0.25,3,3,GTGCACTTCTTTTGAACAAG,0,1905750
icdC_predicted,0.25,3,3,GTGACTGGTGTTGGTGGAGC,0,1894394
icdC_predicted,0.25,3,3,GTGAAGGATAGGATTTTTCG,0,1906619
icdC_predicted,0.25,3,3,GTCTCGCCGAGTGGACTGAA,0,1899401
icdC_predicted,0.25,3,3,GTCGGTCACAGCCTACGGTT,0,1893501
icdC_predicted,0.25,3,3,GTCGGACCTAAGACCGCTGT,0,1906739
icdC_predicted,0.25,3,3,GTCGCCTTGCCCTTCGGCGA,0,1908788
icdC_predicted,0.25,3,3,GTCATATTTCGACCTTTTCA,0,1891343
icdC_predicted,0.25,3,3,GTCAGCACCTCGCCCAGTGC,0,1896506
icdC_predicted,0.25,3,3,GTATTCGTTAGAAGTTTAAA,0,1886049
icdC_predicted,0.25,3,3,GTATCTAGGTTGCAGGCATC,0,1894435
icdC_predicted,0.25,3,3,GTATCGGTGGCTATCCGCGA,0,1902027
icdC_predicted,0.25,3,3,GTAGTATTGGTAGGTTGAAT,0,1879780
icdC_predicted,0.25,3,3,GTAGCTGTAGGGTCCCTCAC,0,1879274
icdC_predicted,0.25,3,3,GTACTTCGTGCGCATAAAGC,0,1899625
icdC_predicted,0.25,3,3,GTACCTGAGGTTCAGTCCGG,0,1899413
icdC_predicted,0.25,3,3,GTACAGCAATCCAACCCTAG,0,1879769
icdC_predicted,0.25,3,3,GTAACTTGGGGCGGTTATCA,0,1880411
icdC_predicted,0.25,3,3,GTAACGGGAGCAATGTCCGG,0,1907080
icdC_predicted,0.25,3,3,GTAAACTTGACTGGGGCCCA,0,1885596
icdC_predicted,0.25,3,3,GGTTTTTCAGGGTCGGGTGC,0,1882671
icdC_predicted,0.25,3,3,GGTTGGTGGGACCGCACGTG,0,1885698
icdC_predicted,0.25,3,3,GGTTCGGCGACAATAACACT,0,1905814
icdC_predicted,0.25,3,3,GGTTATCCACCAGCTTTAGA,0,1888643
icdC_predicted,0.25,3,3,GGTTAATGTGATCGCCTAGT,0,1885349
icdC_predicted,0.25,3,3,GGTGTACAATTGATTATCCC,0,1903077
icdC_predicted,0.25,3,3,GGTGATTATTCAAGTAGTAT,0,1902691
icdC_predicted,0.25,3,3,GGTGACTGTTGTTTTGCCAC,0,1888263
icdC_predicted,0.25,3,3,GGTATTATTCAGCCATTGAC,0,1883858
icdC_predicted,0.25,3,3,GGTAGGCTAGCTTGAGGTTC,0,1890830
icdC_predicted,0.25,3,3,GGTACCTGCCCCGCCTAATG,0,1891439
icdC_predicted,0.25,3,3,GGGTGGAACCGCCTCGAACG,0,1904863
icdC_predicted,0.25,3,3,GGGTCATGGTGGTAGTCTAA,0,1908035
icdC_predicted,0.25,3,3,GGGTACGGTCAGTGATGGCG,0,1894365
icdC_predicted,0.25,3,3,GGGGTGAGGAACGCTCCGGC,0,1891052
icdC_predicted,0.25,3,3,GGGGATTTACGTTGCAGACA,0,1897547
icdC_predicted,0.25,3,3,GGGGATGGGGGCGGAAAACT,0,1905614
icdC_predicted,0.25,3,3,GGGCATCCGCGTGAGAGGGT,0,1900283
icdC_predicted,0.25,3,3,GGCTTACTTAGGTTCGGGGA,0,1894854
icdC_predicted,0.25,3,3,GGCTTAAGAGCTGCAGCGCA,0,1902212
icdC_predicted,0.25,3,3,GGCTCCAGTTTCATTTAATG,0,1893596
icdC_predicted,0.25,3,3,GGCGGTCATAGGGCATCAAG,0,1905515
icdC_predicted,0.25,3,3,GGCGGCAGTGAGAAATGCCC,0,1886689
icdC_predicted,0.25,3,3,GGCGCTCCATGGAGCCGGAA,0,1898003
icdC_predicted,0.25,3,3,GGCCGTTGGATATATTTGCC,0,1900865
icdC_predicted,0.25,3,3,GGCATCCTTGCTGTTTTCGG,0,1900170
icdC_predicted,0.25,3,3,GGATACCTTACAGGCCCTTA,0,1901249
icdC_predicted,0.25,3,3,GGAGCGCCGACTGTTCAAAC,0,1878283
icdC_predicted,0.25,3,3,GGAGCAACCTATGTCTATCC,0,1883212
icdC_predicted,0.25,3,3,GGACTTTAAATATGTTCCAT,0,1890035
icdC_predicted,0.25,3,3,GGACGGAGGGGAGATTAATT,0,1878089
icdC_predicted,0.25,3,3,GGACGGAAAGTTTTCTTCAC,0,1900735
icdC_predicted,0.25,3,3,GGAACATGTGGGGCGTAGGT,0,1909478
icdC_predicted,0.25,3,3,GGAAAAAATGGAGGCCGGCG,0,1901995
icdC_predicted,0.25,3,3,GCTTGCATGCATAATCGCAA,0,1880489
icdC_predicted,0.25,3,3,GCTTACTGAAAGACTTTTAA,0,1879090
icdC_predicted,0.25,3,3,GCTGAAACTCGAGCGGGCAA,0,1896928
icdC_predicted,0.25,3,3,GCTATCGGCCCTCCAAAGTC,0,1886372
icdC_predicted,0.25,3,3,GCGTGTAGCCTCAGAGTGAC,0,1880302
icdC_predicted,0.25,3,3,GCGTGCTAGTTGCACTACAT,0,1883398
icdC_predicted,0.25,3,3,GCGTATGTGTATGCTCGCCC,0,1885040
icdC_predicted,0.25,3,3,GCGTAGAAGATGTTTTACCG,0,1882082
icdC_predicted,0.25,3,3,GCGGTAGGGTCACGGAACAG,0,1903488
icdC_predicted,0.25,3,3,GCGGCCTCGTGGCGGCCAAA,0,1884124
icdC_predicted,0.25,3,3,GCGGAACCGCTAGCAAGTGT,0,1894588
icdC_predicted,0.25,3,3,GCGCGTCCGGACTGTCTCAC,0,1901703
icdC_predicted,0.25,3,3,GCGAGTGGTCAGACTAGCTA,0,1905071
icdC_predicted,0.25,3,3,GCCTGGAATCAAGAGTGTGT,0,1886906
icdC_predicted,0.25,3,3,GCCTCTACGCTTGGCCCTAG,0,1883357
icdC_predicted,0.25,3,3,GCCTCGAATTCCATTTTAAA,0,1891011
icdC_predicted,0.25,3,3,GCCGCGGGACGTTTCTTATG,0,1904800
icdC_predicted,0.25,3,3,GCCCTGGAAAGCTCGTCAGG,0,1899287
icdC_predicted,0.25,3,3,GCCCTACTTTCCAGCCAGTT,0,1884681
icdC_predicted,0.25,3,3,GCCCCTTGTTTAGGCAGGCG,0,1907952
icdC_predicted,0.25,3,3,GCCCCCGAGAGACGCAGCGG,0,1895672
icdC_predicted,0.25,3,3,GCCAGGGCTTCGAGTTTCTC,0,1880242
icdC_predicted,0.25,3,3,GCATCAGTCAAGCGGACTCG,0,1889830
icdC_predicted,0.25,3,3,GCAGCGTTACGTAATTGGCA,0,1879120
icdC_predicted,0.25,3,3,GCAGCATGACCCGGTGAAGT,0,1899587
icdC_predicted,0.25,3,3,GCACAGTGTGCCCATGATTA,0,1887878
icdC_predicted,0.25,3,3,GCAAACGATGCATTGGCCAC,0,1898785
icdC_predicted,0.25,3,3,GATTGTGAAGGTTTGCATCA,0,1906152
icdC_predicted,0.25,3,3,GATTGAAGTCACGGCTACCC,0,1890902
icdC_predicted,0.25,3,3,GATTCTTTTGTCTCTTATGC,0,1903071
icdC_predicted,0.25,3,3,GATTCGCCGACCGAGAATCT,0,1884099
icdC_predicted,0.25,3,3,GATTCCAAGTGCGGTTCTTG,0,1881503
icdC_predicted,0.25,3,3,GATTAGACGTTTAACTGCTC,0,1893241
icdC_predicted,0.25,3,3,GATGCGCCTGCGTAAGTAAT,0,1899704
icdC_predicted,0.25,3,3,GATGAACAAGGCTCCAACAA,0,1891750
icdC_predicted,0.25,3,3,GATCTCAGGATAGGAATCAT,0,1879944
icdC_predicted,0.25,3,3,GATCACGTGATAGACTTCCT,0,1890190
icdC_predicted,0.25,3,3,GATATTGGTGCCTAAGAAGT,0,1893237
icdC_predicted,0.25,3,3,GATATCATGTGGGGCGCGAA,0,1884969
icdC_predicted,0.25,3,3,GATAATATTCCGAGTTAGCA,0,1888913
icdC_predicted,0.25,3,3,GATAACAGTTAGCTGGTTAG,0,1908481
icdC_predicted,0.25,3,3,GATAAATAGTGGCCTCTTAT,0,1889887
icdC_predicted,0.25,3,3,GAGTCGGGTCAGAGTCACAA,0,1899616
icdC_predicted,0.25,3,3,GAGTAGGGCTGTAGTTTTGA,0,1905113
icdC_predicted,0.25,3,3,GAGGTTAGGCACCAACTATT,0,1888058
icdC_predicted,0.25,3,3,GAGGTATATATACTAGAATC,0,1892630
icdC_predicted,0.25,3,3,GAGGGAGTAACATGGCAAGG,0,1905623
icdC_predicted,0.25,3,3,GAGGCACACCGCTTAATTTG,0,1904528
icdC_predicted,0.25,3,3,GAGCAATGCGTCGATATAGC,0,1901683
icdC_predicted,0.25,3,3,GAGATTAGAACAACATGTTA,0,1879214
icdC_predicted,0.25,3,3,GAGAGGATGTACCTTGATCC,0,1883309
icdC_predicted,0.25,3,3,GAGACTAGCTACATATTTGG,0,1880126
icdC_predicted,0.25,3,3,GACTGTCATCCACCAATTTG,0,1898992
icdC_predicted,0.25,3,3,GACTGAGCCCAGGACTAAGC,0,1908896
icdC_predicted,0.25,3,3,GACGCAGCGAGTTACAAGGG,0,1890268
icdC_predicted,0.25,3,3,GACGCACTCCATCGTAAGGA,0,1879293
icdC_predicted,0.25,3,3,GACCTTGTCACGAAAGATCA,0,1884069
icdC_predicted,0.25,3,3,GACCTTGGAATCCCGTGTAG,0,1888150
icdC_predicted,0.25,3,3,GACCCCGGTCGGCGGGGTGT,0,1886540
icdC_predicted,0.25,3,3,GACATAACTGGGAGTGATTT,0,1881253
icdC_predicted,0.25,3,3,GAATTTGTAGGAGTTAATTG,0,1907131
icdC_predicted,0.25,3,3,GAATGATTGCGTACAATACG,0,1895270
icdC_predicted,0.25,3,3,GAATCGGAGCATTACTACGT,0,1886589
icdC_predicted,0.25,3,3,GAATAGTTCATTAGCGTGTT,0,1880101
icdC_predicted,0.25,3,3,GAAGTGCAGTCGGGACCGAG,0,1881618
icdC_predicted,0.25,3,3,GAAGGTTGGCTACGATCCAT,0,1896191
icdC_predicted,0.25,3,3,GAAGGTCTCCAGCTTGAAAG,0,1898525
icdC_predicted,0.25,3,3,GAACTTACGTAAACCTAGGA,0,1907928
icdC_predicted,0.25,3,3,CTTTCGAGTGAAGCACGAGA,0,1894010
icdC_predicted,0.25,3,3,CTTGTAGCGGGTACCTACTC,0,1887258
icdC_predicted,0.25,3,3,CTTGCTTGACGCAATCAGTC,0,1884823
icdC_predicted,0.25,3,3,CTTGCTTAACCATCCACCGA,0,1902183
icdC_predicted,0.25,3,3,CTTGCGTTCGATTAAGCCAA,0,1904960
icdC_predicted,0.25,3,3,CTTGAAGTCAGAAGTTGGAC,0,1902065
icdC_predicted,0.25,3,3,CTTCCCCACAGAGCAAAAAT,0,1900150
icdC_predicted,0.25,3,3,CTTCAAAACCATCATTAGTC,0,1894467
icdC_predicted,0.25,3,3,CTTATGCCTGTATATAAGAG,0,1894400
icdC_predicted,0.25,3,3,CTTAACCCAGGGTTTCAGCT,0,1903650
icdC_predicted,0.25,3,3,CTGTTCCTGGTCACCTACGA,0,1880145
icdC_predicted,0.25,3,3,CTGGCTTGATTCATTATACA,0,1907503
icdC_predicted,0.25,3,3,CTGCGTGCGAACAGACAGCA,0,1882077
icdC_predicted,0.25,3,3,CTGCGGCCCTAGGGGCCTGA,0,1900851
icdC_predicted,0.25,3,3,CTGCCACACGTTCATGTATT,0,1894385
icdC_predicted,0.25,3,3,CTGCACTTGGAGGTACTTGT,0,1892983
icdC_predicted,0.25,3,3,CTGATTTTAAACCGCCATCT,0,1897515
icdC_predicted,0.25,3,3,CTGAATCCCCTCGGGGCCTT,0,1884057
icdC_predicted,0.25,3,3,CTCTTTGCAGCTACCCAGAC,0,1898756
icdC_predicted,0.25,3,3,CTCTTCCTTCAACAGCCCGA,0,1892243
icdC_predicted,0.25,3,3,CTCTGTGCGAGAATAAACAG,0,1885704
icdC_predicted,0.25,3,3,CTCTCTCGGTCTATGCGATC,0,1895196
icdC_predicted,0.25,3,3,CTCTCCGTCTTACCTAAATA,0,1897282
icdC_predicted,0.25,3,3,CTCTCCGTAAAGTTGGCGGT,0,1886538
icdC_predicted,0.25,3,3,CTCGTACACCAATATATCGA,0,1895595
icdC_predicted,0.25,3,3,CTCCTAAATGGAGCTCTCTG,0,1883766
icdC_predicted,0.25,3,3,CTCCGACACAGCAGACCGTT,0,1902613
icdC_predicted,0.25,3,3,CTCCCACATTACTATACGGA,0,1891610
icdC_predicted,0.25,3,3,CTCCATAGCCGAACTAGCAT,0,1905164
icdC_predicted,0.25,3,3,CTCATAATGGGTGACCACTG,0,1878062
icdC_predicted,0.25,3,3,CTCAAATTTAAGGTTAGCGA,0,1908566
icdC_predicted,0.25,3,3,CTATTACGGCTTCAGTAAAT,0,1895101
icdC_predicted,0.25,3,3,CTAGGCTCGTCTCGGATGCC,0,1878576
icdC_predicted,0.25,3,3,CTAGAGCCGATGGGTCTTAA,0,1891288
icdC_predicted,0.25,3,3,CTAAATAAAGCATCGTTCCA,0,1898826
icdC_predicted,0.25,3,3,CGTTTGATCCGTATCTCTTG,0,1907183
icdC_predicted,0.25,3,3,CGTTGAGCCCATAGTGGGAT,0,1907403
icdC_predicted,0.25,3,3,CGTGCCTTCAGGGGGAGGTA,0,1884499
icdC_predicted,0.25,3,3,CGTGCAAATCACGGAACGGA,0,1886371
icdC_predicted,0.25,3,3,CGTCTGTGGTTGCACGCGGA,0,1881651
icdC_predicted,0.25,3,3,CGTCTCCGAACGCTTCATTA,0,1892980
icdC_predicted,0.25,3,3,CGTCGGTGGAGCATGGTGCT,0,1886335
icdC_predicted,0.25,3,3,CGTCCGGAAGTGAAGATACA,0,1900057
icdC_predicted,0.25,3,3,CGTCCGACTAACTGTCATAG,0,1885590
icdC_predicted,0.25,3,3,CGTCCCGGTGCATCCGCGAT,0,1904186
icdC_predicted,0.25,3,3,CGTACGATTTCGAGGTTTCT,0,1897548
icdC_predicted,0.25,3,3,CGTACACAATGTATAGGTTA,0,1891864
icdC_predicted,0.25,3,3,CGGTGGTAGCAGTTCACTGT,0,1893415
icdC_predicted,0.25,3,3,CGGTGAGTTAAGTTATTACG,0,1880168
icdC_predicted,0.25,3,3,CGGGTGACTATATAATATAA,0,1881806
icdC_predicted,0.25,3,3,CGGGGAGTTGGCTCGACTAG,0,1890773
icdC_predicted,0.25,3,3,CGGGGAATCGTCTTGAGACT,0,1885128
icdC_predicted,0.25,3,3,CGGGCTGCTTGATGTAAAGT,0,1883277
icdC_predicted,0.25,3,3,CGGGCCTATAGCTGTACACC,0,1900944
icdC_predicted,0.25,3,3,CGGGAGATATTCTCCCCCGA,0,1888607
icdC_predicted,0.25,3,3,CGGCTAAATTAAGCGGGCAT,0,1879088
icdC_predicted,0.25,3,3,CGGAGGGGATCGCGCGATGG,0,1887454
icdC_predicted,0.25,3,3,CGGAGGGCCTGAGGCGATGT,0,1892245
icdC_predicted,0.25,3,3,CGGAGGCCCATAGGGGTTCA,0,1893684
icdC_predicted,0.25,3,3,CGGAGATGGGATCTCTCTGT,0,1900791
icdC_predicted,0.25,3,3,CGGAGAGAGACGTTATTAGG,0,1885426
icdC_predicted,0.25,3,3,CGGACACCAAAACTACGACA,0,1878015
icdC_predicted,0.25,3,3,CGCTCTGTCAGGGGCACGGA,0,1894354
icdC_predicted,0.25,3,3,CGCTCGGCGAGCCACGTTGT,0,1908694
icdC_predicted,0.25,3,3,CGCGTATTCCGTCAGTAGCG,0,1891117
icdC_predicted,0.25,3,3,CGCGCAATGGGGCAAGCAGA,0,1904748
icdC_predicted,0.25,3,3,CGCGCAAGCAGCGGAAGGCG,0,1882348
icdC_predicted,0.25,3,3,CGCCCGATTTCAGGTTCGTG,0,1880500
icdC_predicted,0.25,3,3,CGCAAATCCTCATCACCGAC,0,1896148
icdC_predicted,0.25,3,3,CGATTTAGGGGATTGTCAGC,0,1902182
icdC_predicted,0.25,3,3,CGATTGCTATGTGCCTGTTA,0,1906048
icdC_predicted,0.25,3,3,CGACTCCGAGAAACAAACAC,0,1898001
icdC_predicted,0.25,3,3,CGACTCACCGTCTTCACCGG,0,1884567
icdC_predicted,0.25,3,3,CGACGACCGCATAAGGGGTA,0,1903555
icdC_predicted,0.25,3,3,CGACCGTGTGCACTTCGGAC,0,1909461
icdC_predicted,0.25,3,3,CGAATCCTTAATGTTGCAAT,0,1905429
icdC_predicted,0.25,3,3,CGAAGCTGTGGTGTTGGAAT,0,1879205
icdC_predicted,0.25,3,3,CCTTGGCTGTGAACGGGTTA,0,1878005
icdC_predicted,0.25,3,3,CCTTGACCCAAGGTCCAGAC,0,1895061
icdC_predicted,0.25,3,3,CCTGTACTTCGCTTAGACGT,0,1880090
icdC_predicted,0.25,3,3,CCTCGTCACCGCACGGTGTT,0,1892127
icdC_predicted,0.25,3,3,CCTCGCCCGAAGTGGCAAGC,0,1901266
icdC_predicted,0.25,3,3,CCTCACGAGTGCGTAAAGTC,0,1880455
icdC_predicted,0.25,3,3,CCTATATACATAGTGCCTTC,0,1883640
icdC_predicted,0.25,3,3,CCGTCGGCCGCCCGGCTGGC,0,1884152
icdC_predicted,0.25,3,3,CCGTCGCCCGCCACAACTAT,0,1897945
icdC_predicted,0.25,3,3,CCGTACAGCAAGCTATCTTT,0,1904236
icdC_predicted,0.25,3,3,CCGGTGGTCGGCGACTGGCA,0,1884090
icdC_predicted,0.25,3,3,CCGGTATTTCCACTTCGAGA,0,1881558
icdC_predicted,0.25,3,3,CCGGGGGGCATAGCCGCCTA,0,1895859
icdC_predicted,0.25,3,3,CCGGACTCCTGAGTCTCCGA,0,1887889
icdC_predicted,0.25,3,3,CCGCTTGACGGACTCCTAGA,0,1882771
icdC_predicted,0.25,3,3,CCGCTGAGATGGCACTTTTT,0,1902305
icdC_predicted,0.25,3,3,CCGCTAAACGTATACCGGGG,0,1892640
icdC_predicted,0.25,3,3,CCGCGTACCCGGCGAGGCCA,0,1906327
icdC_predicted,0.25,3,3,CCGCCCGGGCTAGGGCACCT,0,1898542
icdC_predicted,0.25,3,3,CCGCATTATACCGTCTGACT,0,1890774
icdC_predicted,0.25,3,3,CCGACTTTGATTCAATCGTT,0,1894592
icdC_predicted,0.25,3,3,CCCTTGGCTGGACACATCAG,0,1891252
icdC_predicted,0.25,3,3,CCCTCTGGCACCGTTGACTA,0,1902849
icdC_predicted,0.25,3,3,CCCTCGAGCTATAACCGAGC,0,1898715
icdC_predicted,0.25,3,3,CCCTACCGTACTTCCTGTTC,0,1896314
icdC_predicted,0.25,3,3,CCCGGGTATTGGGGCCGAGG,0,1895098
icdC_predicted,0.25,3,3,CCCGCGTACGGGGGTTCCCT,0,1901459
icdC_predicted,0.25,3,3,CCCGAGCTGGAAGTCTATTC,0,1893552
icdC_predicted,0.25,3,3,CCCCTGTCACCTGGTTCAAC,0,1897953
icdC_predicted,0.25,3,3,CCCCCGATGACTCTTGCTTA,0,1907426
icdC_predicted,0.25,3,3,CCCCCCGAGGTACATAGATA,0,1897339
icdC_predicted,0.25,3,3,CCCCCAGTGTACAATGGGTC,0,1883509
icdC_predicted,0.25,3,3,CCCATCTATTGGCAGGCCTT,0,1884295
icdC_predicted,0.25,3,3,CCATTGCAGTGGCGGGTCAC,0,1909441
icdC_predicted,0.25,3,3,CCATGACGCAGATGCCTCTT,0,1877901
icdC_predicted,0.25,3,3,CCAGTTTAATGTGCCATACC,0,1896290
icdC_predicted,0.25,3,3,CCAGTTCGCGTTACATTGGA,0,1887524
icdC_predicted,0.25,3,3,CCAGGTTGGCCACTCACGCC,0,1883141
icdC_predicted,0.25,3,3,CCACGTATCCCGCTCCTCAG,0,1884676
icdC_predicted,0.25,3,3,CCACATAAGCGAAGATCGGA,0,1888670
icdC_predicted,0.25,3,3,CCACAGACCCCAGGGGTTTG,0,1906190
icdC_predicted,0.25,3,3,CCAATTGTGTAGTGAGGGTT,0,1894504
icdC_predicted,0.25,3,3,CCAATCATTATTGATCCGCT,0,1884693
icdC_predicted,0.25,3,3,CCAAGGTTCGATATAGATCA,0,1884997
icdC_predicted,0.25,3,3,CCAAAGTCTGTACGATTCGA,0,1895652
icdC_predicted,0.25,3,3,CATTTCTGACATGTTCAGCG,0,1888500
icdC_predicted,0.25,3,3,CATTGTTTCACTTTTACCAT,0,1894642
icdC_predicted,0.25,3,3,CATTCCACTGGATGCCGTGA,0,1883938
icdC_predicted,0.25,3,3,CATGTGTTGAGGCCCAGGCT,0,1892587
icdC_predicted,0.25,3,3,CATGGGCGATGGTGACCCAA,0,1908725
icdC_predicted,0.25,3,3,CATGGAAGATCGTGGAGTGT,0,1879149
icdC_predicted,0.25,3,3,CATCGTTTTCGCGTGGAGCT,0,1892305
icdC_predicted,0.25,3,3,CATCGGATCTTCATTAGCCA,0,1885324
icdC_predicted,0.25,3,3,CATAGTTCGTGCCTGTAACC,0,1889429
icdC_predicted,0.25,3,3,CATAGAGGCCCAATAGGCGG,0,1906421
icdC_predicted,0.25,3,3,CATACAAATTCATACAAGGC,0,1879013
icdC_predicted,0.25,3,3,CAGTGTTGGATGTTGGACCC,0,1893223
icdC_predicted,0.25,3,3,CAGTCCTGGTCCTAAATGTT,0,1887156
icdC_predicted,0.25,3,3,CAGTATAGTTAGGGCCATAT,0,1887410
icdC_predicted,0.25,3,3,CAGGTGCGTGCGGGGGATCT,0,1905699
icdC_predicted,0.25,3,3,CAGGGAGATAGCGAGGAGTG,0,1884475
icdC_predicted,0.25,3,3,CAGGCATTTCTACGTCTTTC,0,1897946
icdC_predicted,0.25,3,3,CAGGCAACCTTCGAAGCGGC,0,1902869
icdC_predicted,0.25,3,3,CAGAACACTACGGGCATCTA,0,1902339
icdC_predicted,0.25,3,3,CACGACCCAGACAGTCTCAC,0,1883524
icdC_predicted,0.25,3,3,CACCGAGCGATGGATATCAA,0,1888092
icdC_predicted,0.25,3,3,CACATTCTCGATAAACGCAA,0,1878291
icdC_predicted,0.25,3,3,CACATCCCAGGTTCTACGTA,0,1906901
icdC_predicted,0.25,3,3,CACACGGAGAGGCGTTGGTT,0,1894464
icdC_predicted,0.25,3,3,CAATAAAAGCACGACAAGAG,0,1904512
icdC_predicted,0.25,3,3,CAAGTTGTTGCTGGGCGCTA,0,1885822
icdC_predicted,0.25,3,3,CAAGGTCTCGTCGCTTTGAT,0,1898399
icdC_predicted,0.25,3,3,CAACTCCTAAGGCTCACCGT,0,1909452
icdC_predicted,0.25,3,3,CAACGTGGGCCAGAACTTGT,0,1891207
icdC_predicted,0.25,3,3,CAACCGTTGGGGAGAGGCGT,0,1887984
icdC_predicted,0.25,3,3,CAAAGTGTCTATCCTTTGCT,0,1907573
icdC_predicted,0.25,3,3,CAAAGTATAAGGGAGAGGTA,0,1905906
icdC_predicted,0.25,3,3,ATTTTTTCAGTGTATGTTTA,0,1888786
icdC_predicted,0.25,3,3,ATTGTTTCAAATGGGTCGTG,0,1898363
icdC_predicted,0.25,3,3,ATTGTGTATATACATGAAAA,0,1908831
icdC_predicted,0.25,3,3,ATTGTCTTATATCACTGCTT,0,1878210
icdC_predicted,0.25,3,3,ATTGGAAGCGGCCCCTTAGC,0,1880651
icdC_predicted,0.25,3,3,ATTGCCACAACGTGTTCTCC,0,1894980
icdC_predicted,0.25,3,3,ATTGCACTGGTGTTTTTCTG,0,1908399
icdC_predicted,0.25,3,3,ATTCGCCGAGTTAGCAGCTG,0,1878767
icdC_predicted,0.25,3,3,ATTCGCCCATGTGCTCGGGT,0,1890311
icdC_predicted,0.25,3,3,ATTCGAACCTACTGCGGAAT,0,1888974
icdC_predicted,0.25,3,3,ATTCCATTATTGTCATGAGA,0,1886027
icdC_predicted,0.25,3,3,ATTATAATAGACAACGTCAG,0,1901707
icdC_predicted,0.25,3,3,ATTACAGGCATTATCTCCGT,0,1889604
icdC_predicted,0.25,3,3,ATTAATAGCTCAACCTGTGA,0,1879351
icdC_predicted,0.25,3,3,ATGTTTTCATGCCTAGCTAC,0,1900149
icdC_predicted,0.25,3,3,ATGTGGAGTCGAAATCTGAT,0,1908103
icdC_predicted,0.25,3,3,ATGTAATGCATGACTCCCCA,0,1907237
icdC_predicted,0.25,3,3,ATGGTCCTGTGGTTTTCTAG,0,1895780
icdC_predicted,0.25,3,3,ATGGAGGCTGAGTGTTCTCT,0,1878373
icdC_predicted,0.25,3,3,ATGCCAGGCCGTACTTAGTC,0,1900390
icdC_predicted,0.25,3,3,ATGATCGGTCTTACGTTGCA,0,1885534
icdC_predicted,0.25,3,3,ATGACTTGTTGGCCACGTAT,0,1882436
icdC_predicted,0.25,3,3,ATGACTGCCCTAAAGCAAGT,0,1901938
icdC_predicted,0.25,3,3,ATGACTACAGTCGTCTAACA,0,1882304
icdC_predicted,0.25,3,3,ATGACCACCGCAGAGGGAGT,0,1880745
icdC_predicted,0.25,3,3,ATGAACGTGCATGTGCTTAT,0,1884542
icdC_predicted,0.25,3,3,ATCTTGAGACTTTACCCTAG,0,1901480
icdC_predicted,0.25,3,3,ATCTATTAATATCAATCCTT,0,1890260
icdC_predicted,0.25,3,3,ATCGGTTTTCAGTGTTTAGT,0,1880487
icdC_predicted,0.25,3,3,ATCGGGCCTGACAGTCGCGG,0,1886101
icdC_predicted,0.25,3,3,ATCGCGCGGTGCCTGTTCGT,0,1888596
icdC_predicted,0.25,3,3,ATCGATTAATATCTTCCTAA,0,1887027
icdC_predicted,0.25,3,3,ATCCTTCCACTAACCCAGGT,0,1894441
icdC_predicted,0.25,3,3,ATCCTGTTGACATATTACTC,0,1881386
icdC_predicted,0.25,3,3,ATCCGGTTCAAAGATATTAG,0,1904991
icdC_predicted,0.25,3,3,ATCCCTGGCGGGTGTCGGTT,0,1892538
icdC_predicted,0.25,3,3,ATCCCGTTATTTGCCCATGA,0,1894492
icdC_predicted,0.25,3,3,ATCAAGCACTCCTCGCCTAG,0,1878426
icdC_predicted,0.25,3,3,ATATTGATAATGCCAATATC,0,1895690
icdC_predicted,0.25,3,3,ATATTCGGGGCCGGGCGGTG,0,1891595
icdC_predicted,0.25,3,3,ATATTCCACGAAGAATTCAG,0,1901989
icdC_predicted,0.25,3,3,ATATTATCCACTGTAGGGTC,0,1880913
icdC_predicted,0.25,3,3,ATATCTGTCATAGGTTGTCG,0,1902811
icdC_predicted,0.25,3,3,ATATAAGTTACTTTCGTGGC,0,1897239
icdC_predicted,0.25,3,3,ATAGACAAGCTCATTAACGA,0,1905796
icdC_predicted,0.25,3,3,ATACTTAATTTGGTGCAGCC,0,1905802
icdC_predicted,0.25,3,3,ATACTACTACCATATGTTAA,0,1886386
icdC_predicted,0.25,3,3,ATACGAGACGCCACAGCTGC,0,1885624
icdC_predicted,0.25,3,3,ATACGACCCGGTTTAAAGGC,0,1888593
icdC_predicted,0.25,3,3,ATACCAGTCCTGATAGGCTG,0,1908079
icdC_predicted,0.25,3,3,ATAAGGCGTGGGTTGAAGCG,0,1909023
icdC_predicted,0.25,3,3,ATAAAGGGTCGATACTCAGG,0,1882525
icdC_predicted,0.25,3,3,ATAAAAAGTATTGGGTAGCG,0,1885514
icdC_predicted,0.25,3,3,ATAAAAAATGTGAGATCAGG,0,1882734
icdC_predicted,0.25,3,3,AGTTGGGTTGAAATGATCGG,0,1908665
icdC_predicted,0.25,3,3,AGTTCTTGTCGTCACTACAT,0,1906862
icdC_predicted,0.25,3,3,AGTTCGCGCACTCCAAGTAG,0,1881309
icdC_predicted,0.25,3,3,AGTGTATGCCAGAGTGTTAG,0,1894159
icdC_predicted,0.25,3,3,AGTGGGGCAAGCGTTGCGTC,0,1898356
icdC_predicted,0.25,3,3,AGTGCGATCTTCTTTAGACC,0,1894323
icdC_predicted,0.25,3,3,AGTCCTGAGGGCAAGTACCA,0,1896710
icdC_predicted,0.25,3,3,AGTCAGGCGGAACATGAGTG,0,1903152
icdC_predicted,0.25,3,3,AGTAGCGCTCAGTATCACGT,0,1900879
icdC_predicted,0.25,3,3,AGTAGAAATACCCATCGGCA,0,1906405
icdC_predicted,0.25,3,3,AGTACACCATAATGCACATA,0,1887944
icdC_predicted,0.25,3,3,AGTAAGGTGAGCTTGAACGG,0,1882926
icdC_predicted,0.25,3,3,AGGGTCAGACTTGGTACCAG,0,1892982
icdC_predicted,0.25,3,3,AGGGGCAAATGTGAGCCCGG,0,1894450
icdC_predicted,0.25,3,3,AGGGATACCAAGAGACGAAA,0,1895065
icdC_predicted,0.25,3,3,AGGGAATTCAAGTGCCCTCG,0,1885271
icdC_predicted,0.25,3,3,AGGCTGGTACGTGGTATGCT,0,1883249
icdC_predicted,0.25,3,3,AGGCTCGATGTGTGTCTTCT,0,1897186
icdC_predicted,0.25,3,3,AGGCTATTTTCGTCATTCAA,0,1901414
icdC_predicted,0.25,3,3,AGGCGGTACCACTGCATTCG,0,1892349
icdC_predicted,0.25,3,3,AGGCGGCGCACGAGTCATTG,0,1896750
icdC_predicted,0.25,3,3,AGGCCTTGGACATCGCGACC,0,1894315
icdC_predicted,0.25,3,3,AGGATGGCCCAAAAAATCCT,0,1877954
icdC_predicted,0.25,3,3,AGGACTTGGCCCTTATAGGT,0,1892957
icdC_predicted,0.25,3,3,AGGACTGCACTGAATAGAAA,0,1893578
icdC_predicted,0.25,3,3,AGCTGGCGCAACAATACTTT,0,1899218
icdC_predicted,0.25,3,3,AGCTGGCAGCCCAGGTCGGC,0,1891174
icdC_predicted,0.25,3,3,AGCTCGTGAATACTTAGGAA,0,1893225
icdC_predicted,0.25,3,3,AGCGCTGTCGGCACGCACTA,0,1891235
icdC_predicted,0.25,3,3,AGCCTGTGAGCTGCTCAATT,0,1878227
icdC_predicted,0.25,3,3,AGCCTCCGGGTCTGACAGAT,0,1895444
icdC_predicted,0.25,3,3,AGCCACAGTCCAAATTCTGT,0,1888591
icdC_predicted,0.25,3,3,AGCAAGTACCGTGACTATGT,0,1894996
icdC_predicted,0.25,3,3,AGCAAGCAACTGCGGGGGTA,0,1877950
icdC_predicted,0.25,3,3,AGATGCGAATACATTTATAA,0,1896490
icdC_predicted,0.25,3,3,AGATCAGGTTAGATATTTCG,0,1890953
icdC_predicted,0.25,3,3,AGAGTTGGAACCGCCGTCTC,0,1896392
icdC_predicted,0.25,3,3,AGAGTCGTGCGTACGTTCGA,0,1903243
icdC_predicted,0.25,3,3,AGAGCCAGCGAACCCGCACA,0,1906950
icdC_predicted,0.25,3,3,AGACCGGCTACCTGACGCAA,0,1894390
icdC_predicted,0.25,3,3,AGAATGCGCGGTACTGTGAC,0,1902054
icdC_predicted,0.25,3,3,AGAATATGAAGTATAGGCAG,0,1903894
icdC_predicted,0.25,3,3,ACTTTATACGGGAATTTTGG,0,1906083
icdC_predicted,0.25,3,3,ACTGGCTTAATAACGAGAAC,0,1891620
icdC_predicted,0.25,3,3,ACTCTTTAGTCGTGCGGCTT,0,1899348
icdC_predicted,0.25,3,3,ACTCGGAGTCTGGCGACTGA,0,1897758
icdC_predicted,0.25,3,3,ACTATAATCCGGGCGAATCC,0,1898922
icdC_predicted,0.25,3,3,ACTAACGTGTACATAAGCGA,0,1905390
icdC_predicted,0.25,3,3,ACGTAGAGCAAACTCACAGT,0,1880367
icdC_predicted,0.25,3,3,ACGGGCTGTGGCGCGCCTAG,0,1893333
icdC_predicted,0.25,3,3,ACGGGACCCTTGATGTATGG,0,1886292
icdC_predicted,0.25,3,3,ACGGACTGCTGCCTAAGATT,0,1902885
icdC_predicted,0.25,3,3,ACGGACTACCTTTTCATTGC,0,1898079
icdC_predicted,0.25,3,3,ACGCCCACCTTGCACAGATG,0,1905204
icdC_predicted,0.25,3,3,ACGCATGCTTCCAATACTAG,0,1884094
icdC_predicted,0.25,3,3,ACGATGGTACTAACCGTGAT,0,1886197
icdC_predicted,0.25,3,3,ACGACTTACCCTTACTACGA,0,1880464
icdC_predicted,0.25,3,3,ACCTTTGGCACCAGCATCAG,0,1881431
icdC_predicted,0.25,3,3,ACCTTATTCGCACCAATCTA,0,1883248
icdC_predicted,0.25,3,3,ACCTTAGAAAGAAGTACAGG,0,1882722
icdC_predicted,0.25,3,3,ACCTCCCGTTCTTTGGAGTC,0,1892211
icdC_predicted,0.25,3,3,ACCTCCCCAATCCATTTGAC,0,1906236
icdC_predicted,0.25,3,3,ACCGTCCAGACTTCGAGAAC,0,1900764
icdC_predicted,0.25,3,3,ACCGTCACCAGGAAGACAAA,0,1906386
icdC_predicted,0.25,3,3,ACCGCTCTGCGGCTGGCGCA,0,1888614
icdC_predicted,0.25,3,3,ACCGCTATCGCTGGTTGTGG,0,1895310
icdC_predicted,0.25,3,3,ACCGCGCAACGGCACCAGCT,0,1898728
icdC_predicted,0.25,3,3,ACCGCGAACAAACAGGAGGC,0,1881244
icdC_predicted,0.25,3,3,ACCCTTCTGAGGGAGTGAAC,0,1887206
icdC_predicted,0.25,3,3,ACCCCGCCATGAACCTCGTC,0,1891129
icdC_predicted,0.25,3,3,ACCCCCTGTTCACTCTATGC,0,1882928
icdC_predicted,0.25,3,3,ACCATAAGCTGGTGATCGGT,0,1896603
icdC_predicted,0.25,3,3,ACCAGCGTACTCAGATAAGG,0,1907213
icdC_predicted,0.25,3,3,ACCAGCCGGTTCGTTGGACA,0,1901948
icdC_predicted,0.25,3,3,ACCACAGCTTTCTCAGAGAT,0,1906135
icdC_predicted,0.25,3,3,ACATTTTGGGATTCAACTTT,0,1886621
icdC_predicted,0.25,3,3,ACATTCGATCAAACTGTGAA,0,1900703
icdC_predicted,0.25,3,3,ACAGGTGACTCAGCCAATAT,0,1898488
icdC_predicted,0.25,3,3,ACAGGGGTCCATGCGGCTTG,0,1880224
icdC_predicted,0.25,3,3,ACAGGGGAGGAGCAGAGCTG,0,1887387
icdC_predicted,0.25,3,3,ACAGGATAGTTGGTGAAGCT,0,1880787
icdC_predicted,0.25,3,3,ACAGCTCTTGTACTGGGTCA,0,1894033
icdC_predicted,0.25,3,3,ACAATAAGTAGCGTCAACTC,0,1903349
icdC_predicted,0.25,3,3,AATTATTATAATTGCTTTTT,0,1893137
icdC_predicted,0.25,3,3,AATTAGGTGACGGCCCAAGT,0,1904573
icdC_predicted,0.25,3,3,AATTACAAGGGTCTCTTGTC,0,1894168
icdC_predicted,0.25,3,3,AATGGTGCATGTCAGTCTAA,0,1878248
icdC_predicted,0.25,3,3,AATGAGCTACGGTAGATCAA,0,1896810
icdC_predicted,0.25,3,3,AATCTAAGAGTGCTTCTGCA,0,1882800
icdC_predicted,0.25,3,3,AATCCCTGACTTGGCTGTCT,0,1900872
icdC_predicted,0.25,3,3,AATAACGTACGGCTCTAATC,0,1894052
icdC_predicted,0.25,3,3,AAGTTCAGGTCGGGGAGGCA,0,1882100
icdC_predicted,0.25,3,3,AAGTAAGCATCCGCGTTAGT,0,1880475
icdC_predicted,0.25,3,3,AAGGGCGTGACGACTATTGA,0,1889728
icdC_predicted,0.25,3,3,AAGGCTCCAGGGAGTCTAAT,0,1879902
icdC_predicted,0.25,3,3,AAGCTCCGGGTAGATCGACA,0,1901897
icdC_predicted,0.25,3,3,AAGAGGTTGCGGTGAGATGG,0,1899946
icdC_predicted,0.25,3,3,AAGAGGGCACAACTTATTCG,0,1894884
icdC_predicted,0.25,3,3,AACTTCCACAGGTGGTCGAT,0,1903981
icdC_predicted,0.25,3,3,AACTGGGCGTGACGGTTAGT,0,1884913
icdC_predicted,0.25,3,3,AACTCAGATAGTGACCTCAT,0,1902646
icdC_predicted,0.25,3,3,AACGTGTTGCGTGTGCGCTA,0,1900310
icdC_predicted,0.25,3,3,AACGAGGACACGGTCCGTTC,0,1896624
icdC_predicted,0.25,3,3,AACCGTGTGGAAATCTACGC,0,1879347
icdC_predicted,0.25,3,3,AACCCACAGCTTTGGCAAAG,0,1887742
icdC_predicted,0.25,3,3,AACATGTTGAGTTGGGTCCA,0,1900182
icdC_predicted,0.25,3,3,AACACTATAAGGTCGCAGGC,0,1882482
icdC_predicted,0.25,3,3,AACACCTCCAGGATTTGGTG,0,1887054
icdC_predicted,0.25,3,3,AAATTTGTTTGGGAGCACTA,0,1887994
icdC_predicted,0.25,3,3,AAATTAAATTTTCTACCCCA,0,1901121
icdC_predicted,0.25,3,3,AAATCATTCATAAGGCCTCA,0,1904319
icdC_predicted,0.25,3,3,AAATCATTATAAGTGGTGAT,0,1908348
icdC_predicted,0.25,3,3,AAAGTTTCGTTGATACGTGG,0,1880646
icdC_predicted,0.25,3,3,AAAGGGTTACAGGTCGCAAT,0,1881391
icdC_predicted,0.25,3,3,AAAGCATTCTTCTCGCCGCG,0,1904795
icdC_predicted,0.25,3,3,AAAGAGTGTTTTCATAAAGC,0,1902021
icdC_predicted,0.25,3,3,AAAGAGGCTCGGAGATGCAG,0,1905516
icdC_predicted,0.25,3,3,AAAGACCCTCTATACTGTCC,0,1880161
icdC_predicted,0.25,3,3,AAAGACACAATCGAGTGTAG,0,1893357
icdC_predicted,0.25,3,3,AAACGGTTGTGCGCGTAACG,0,1900350
icdC_predicted,0.25,3,3,AAACGGTTCCGACCGATCCC,0,1878898
icdC_predicted,0.25,3,3,AAACCTTTAGGTGGTACGCG,0,1905741
icdC_predicted,0.25,3,3,AAACAAGGTCCGCCTTCCAA,0,1903220
icdC_predicted,0.25,3,3,AAAATTCAGAGTACTTAACA,0,1878622
icdC_predicted,0.25,3,3,AAAAGTTTTCATGTTCCTAC,0,1891796
icdC_predicted,0.25,3,3,AAAAGCGAGCATGGTCCAAT,0,1890957
icdC_predicted,0.25,3,3,AAAACTAGAATTCAGCATTG,0,1896684
icdC_predicted,0.3333333333333333,2,2,TTTTTGGTGTATGAGCTAGG,0,1891545
icdC_predicted,0.3333333333333333,2,2,TTTTTCTACGAGTCTGATGT,0,1892160
icdC_predicted,0.3333333333333333,2,2,TTTTTCTAATCTAAATTATA,0,1904629
icdC_predicted,0.3333333333333333,2,2,TTTTTACAGACAAGCGGAGC,0,1907932
icdC_predicted,0.3333333333333333,2,2,TTTTCCCGAATAGTCCCCAA,0,1898230
icdC_predicted,0.3333333333333333,2,2,TTTTACACTCGTCACATGGA,0,1908520
icdC_predicted,0.3333333333333333,2,2,TTTGTGAAGCCTAAGACCAG,0,1888772
icdC_predicted,0.3333333333333333,2,2,TTTGGTAGTGAAATGTGGGC,0,1889157
icdC_predicted,0.3333333333333333,2,2,TTTGCTCTCGCTTCGCTGGT,0,1907706
icdC_predicted,0.3333333333333333,2,2,TTTCCCCGCTTTGAGACCAA,0,1898552
icdC_predicted,0.3333333333333333,2,2,TTTCATTCTTCAGAGACATG,0,1900571
icdC_predicted,0.3333333333333333,2,2,TTTCAGCTACCTTTCTGCCG,0,1881034
icdC_predicted,0.3333333333333333,2,2,TTTATTGGACTGTCCCAGCC,0,1897501
icdC_predicted,0.3333333333333333,2,2,TTGGGTCGGTCATCACGTAC,0,1886294
icdC_predicted,0.3333333333333333,2,2,TTGGGCCACGCCCGGATCTG,0,1885107
icdC_predicted,0.3333333333333333,2,2,TTGCGCATACTGAGGTCTAA,0,1897319
icdC_predicted,0.3333333333333333,2,2,TTGATGCGGCTGTGCGGATA,0,1884936
icdC_predicted,0.3333333333333333,2,2,TTGACATGCCTAAGCGGTCA,0,1880865
icdC_predicted,0.3333333333333333,2,2,TTGAATTCCCCTAAGATGCC,0,1886225
icdC_predicted,0.3333333333333333,2,2,TTGAAGGCATCGTCACGGGT,0,1885718
icdC_predicted,0.3333333333333333,2,2,TTGAAGCCGTGAGCCTCGAC,0,1883566
icdC_predicted,0.3333333333333333,2,2,TTCTTTTCGTTGCTGCTATA,0,1902623
icdC_predicted,0.3333333333333333,2,2,TTCTTTTCGGGGATCGGCAA,0,1907350
icdC_predicted,0.3333333333333333,2,2,TTCTTGATTAACAAGATGTT,0,1896407
icdC_predicted,0.3333333333333333,2,2,TTCTGTCTTTTACCATCATT,0,1898944
icdC_predicted,0.3333333333333333,2,2,TTCTATATGACGACACCAGA,0,1905059
icdC_predicted,0.3333333333333333,2,2,TTCTACGCGGAGGACGACGG,0,1885215
icdC_predicted,0.3333333333333333,2,2,TTCGGACTGGAACGGAACTG,0,1878200
icdC_predicted,0.3333333333333333,2,2,TTCGCTTTCTGTGAAGAATC,0,1893352
icdC_predicted,0.3333333333333333,2,2,TTCGCGACCACGCAAAAGCA,0,1902198
icdC_predicted,0.3333333333333333,2,2,TTCGAGCCGGTTCAACGACT,0,1890255
icdC_predicted,0.3333333333333333,2,2,TTCCGCATCCGAGGATTACC,0,1879307
icdC_predicted,0.3333333333333333,2,2,TTCATGGTCGAGGCCTTGAG,0,1898774
icdC_predicted,0.3333333333333333,2,2,TTCAGAAATATACGCAGGCA,0,1892905
icdC_predicted,0.3333333333333333,2,2,TTCACAGAATGCTATTTTGA,0,1887876
icdC_predicted,0.3333333333333333,2,2,TTATTGCGGGGATCTGGATG,0,1894350
icdC_predicted,0.3333333333333333,2,2,TTATTACGAGCAGACACGAG,0,1900604
icdC_predicted,0.3333333333333333,2,2,TTATGGACGGTTATTGCAGC,0,1888968
icdC_predicted,0.3333333333333333,2,2,TTATGATAACTGACCCACGG,0,1887804
icdC_predicted,0.3333333333333333,2,2,TTATCCTTACACGTACTCGA,0,1908922
icdC_predicted,0.3333333333333333,2,2,TTAGGCTGGGTTACTCACTT,0,1882274
icdC_predicted,0.3333333333333333,2,2,TTAGCATATCAGAGAGTCCT,0,1890608
icdC_predicted,0.3333333333333333,2,2,TTAATGACGCACAGGCTAGA,0,1891891
icdC_predicted,0.3333333333333333,2,2,TTAAGTGACGAGGTATATGC,0,1879201
icdC_predicted,0.3333333333333333,2,2,TTAAGGTGCCTGAAAAGAGT,0,1890169
icdC_predicted,0.3333333333333333,2,2,TTAAGCCTCGATAAGAGGCG,0,1886772
icdC_predicted,0.3333333333333333,2,2,TTAAGATACTGAGAGATTGA,0,1880706
icdC_predicted,0.3333333333333333,2,2,TGTTTGAGGATCGTAAGAAA,0,1896513
icdC_predicted,0.3333333333333333,2,2,TGTTTCGTGTGACAATGATC,0,1891948
icdC_predicted,0.3333333333333333,2,2,TGTTGAAGACGGTACGCATG,0,1903233
icdC_predicted,0.3333333333333333,2,2,TGTTACCACGGACCGTCTAA,0,1884934
icdC_predicted,0.3333333333333333,2,2,TGTGGCAATTCGAGCGTGTC,0,1877952
icdC_predicted,0.3333333333333333,2,2,TGTGATTAGTGAATGTCGTT,0,1904312
icdC_predicted,0.3333333333333333,2,2,TGTGATCATTGGTGTCCTTC,0,1907695
icdC_predicted,0.3333333333333333,2,2,TGTCGCTGCCCCCGATGTCA,0,1888351
icdC_predicted,0.3333333333333333,2,2,TGTCCGCTGATGTACCTTTA,0,1901246
icdC_predicted,0.3333333333333333,2,2,TGTCCCTTCCGGTGACCGGA,0,1899336
icdC_predicted,0.3333333333333333,2,2,TGTATAGGGGTAGTCCATTT,0,1898368
icdC_predicted,0.3333333333333333,2,2,TGGTGCCGACCTACGCACAT,0,1892988
icdC_predicted,0.3333333333333333,2,2,TGGTGAAGTCAAGTATAGCG,0,1878063
icdC_predicted,0.3333333333333333,2,2,TGGTATAGTGTGAAGACTAT,0,1898854
icdC_predicted,0.3333333333333333,2,2,TGGGTTACCCACGAGGAGAG,0,1884306
icdC_predicted,0.3333333333333333,2,2,TGGGTAAACGGTTCGCCAAG,0,1899065
icdC_predicted,0.3333333333333333,2,2,TGGGGCGGTTGGCAAATCTG,0,1880788
icdC_predicted,0.3333333333333333,2,2,TGGGCGCCCGGTCCACGCCA,0,1898914
icdC_predicted,0.3333333333333333,2,2,TGGGACCCGGTCAAAGATCA,0,1899654
icdC_predicted,0.3333333333333333,2,2,TGGCTCACAGCCTCTCTTGC,0,1909206
icdC_predicted,0.3333333333333333,2,2,TGGCAGGGTAAGCGATTCGA,0,1888395
icdC_predicted,0.3333333333333333,2,2,TGGATGAGAAATTTTTCTAC,0,1896474
icdC_predicted,0.3333333333333333,2,2,TGGACTCTCTCTGTTGAAGC,0,1897381
icdC_predicted,0.3333333333333333,2,2,TGCTCGTCGGTCCACACTAT,0,1902989
icdC_predicted,0.3333333333333333,2,2,TGCGGTTTCGAGACTCAATC,0,1887653
icdC_predicted,0.3333333333333333,2,2,TGCGCCGTGATGACCTCCTT,0,1906114
icdC_predicted,0.3333333333333333,2,2,TGCCTGAAAATGACACGTGA,0,1901499
icdC_predicted,0.3333333333333333,2,2,TGCCCAGTATAGTCCTGGTT,0,1902583
icdC_predicted,0.3333333333333333,2,2,TGCCACCAGCACTTATAGTG,0,1880160
icdC_predicted,0.3333333333333333,2,2,TGCAGGAGGATCCGAAAGCT,0,1880868
icdC_predicted,0.3333333333333333,2,2,TGCAGGACACAGCCCGGAGC,0,1905785
icdC_predicted,0.3333333333333333,2,2,TGCAGCTGGCGTACCTTCGT,0,1896559
icdC_predicted,0.3333333333333333,2,2,TGATTAAACGCAGGTTCTGG,0,1886245
icdC_predicted,0.3333333333333333,2,2,TGATGATACCGGACATAGGT,0,1883959
icdC_predicted,0.3333333333333333,2,2,TGATCACTTTCATTGAGAAG,0,1885720
icdC_predicted,0.3333333333333333,2,2,TGATAGGGTCTTGAAGGGTT,0,1886916
icdC_predicted,0.3333333333333333,2,2,TGAGGTCTGGACTGTTTGCT,0,1883067
icdC_predicted,0.3333333333333333,2,2,TGAGAGGGGCCTCTTTGGAC,0,1879354
icdC_predicted,0.3333333333333333,2,2,TGAGAAATGCCGCGCTTACA,0,1880848
icdC_predicted,0.3333333333333333,2,2,TGACTAGCCTTCATGCAGCA,0,1891397
icdC_predicted,0.3333333333333333,2,2,TGACCGGTTCATTAAACCCA,0,1892020
icdC_predicted,0.3333333333333333,2,2,TGACCACAGAGGAGCATACC,0,1889223
icdC_predicted,0.3333333333333333,2,2,TGACAGGCAACGCAAGCTCG,0,1879824
icdC_predicted,0.3333333333333333,2,2,TGAAGATGCCGTCCTTCTTT,0,1895027
icdC_predicted,0.3333333333333333,2,2,TGAAACCGTGACTACGCTCA,0,1894305
icdC_predicted,0.3333333333333333,2,2,TCTTTCTCTGCATATTTGAT,0,1881077
icdC_predicted,0.3333333333333333,2,2,TCTTTAACACTGACGGAAAA,0,1887952
icdC_predicted,0.3333333333333333,2,2,TCTTACGCCAATGATAGCCA,0,1888419
icdC_predicted,0.3333333333333333,2,2,TCTGGTGATCCGGTTTGAGG,0,1885882
icdC_predicted,0.3333333333333333,2,2,TCTGCAAATGTCATCAGGTG,0,1890803
icdC_predicted,0.3333333333333333,2,2,TCTGAGGGTCATTGTTAAAA,0,1894927
icdC_predicted,0.3333333333333333,2,2,TCTCCGAAGTCATGGGGCCA,0,1906588
icdC_predicted,0.3333333333333333,2,2,TCTCACAAAGGATAGCCAAG,0,1908390
icdC_predicted,0.3333333333333333,2,2,TCTATATGTTCAATGTACCT,0,1899422
icdC_predicted,0.3333333333333333,2,2,TCTAGTTTGGGCACGGCTTT,0,1889238
icdC_predicted,0.3333333333333333,2,2,TCTAGGTGCCTAGTATGTGT,0,1906945
icdC_predicted,0.3333333333333333,2,2,TCGTTGTACCCCTTACCTCA,0,1905356
icdC_predicted,0.3333333333333333,2,2,TCGTGGAGGTGCTTGGTATG,0,1883770
icdC_predicted,0.3333333333333333,2,2,TCGGTTTCCTATTCGGGATT,0,1896437
icdC_predicted,0.3333333333333333,2,2,TCGGGAGCCGACCGCGCTCA,0,1909157
icdC_predicted,0.3333333333333333,2,2,TCGCCCTAAGTGGATAGCGA,0,1902707
icdC_predicted,0.3333333333333333,2,2,TCGCATTCCCGATGGTGGAC,0,1890063
icdC_predicted,0.3333333333333333,2,2,TCGCAACTTTCATTAGGATA,0,1903031
icdC_predicted,0.3333333333333333,2,2,TCGACTTAACAACTATTAAT,0,1898359
icdC_predicted,0.3333333333333333,2,2,TCGAAAGTGGCGCTTTTCTT,0,1883638
icdC_predicted,0.3333333333333333,2,2,TCCTACCCTGCCCAAGCTGA,0,1899436
icdC_predicted,0.3333333333333333,2,2,TCCGGCCCCCGGTCCACCTT,0,1900804
icdC_predicted,0.3333333333333333,2,2,TCCGACGGGAATGTCTGCCG,0,1878719
icdC_predicted,0.3333333333333333,2,2,TCCCATAATCATGGGCGCGC,0,1892227
icdC_predicted,0.3333333333333333,2,2,TCCATTTCAATGTGGAGCGT,0,1903006
icdC_predicted,0.3333333333333333,2,2,TCCATCGCCAATCGCTGAAT,0,1888409
icdC_predicted,0.3333333333333333,2,2,TCCATACGCCTATACGTATT,0,1895485
icdC_predicted,0.3333333333333333,2,2,TCCACTCCCCACGCGGATGT,0,1899881
icdC_predicted,0.3333333333333333,2,2,TCCACTCATCAAGTTCTACA,0,1900527
icdC_predicted,0.3333333333333333,2,2,TCCAAATCCATCGGATCCCA,0,1882602
icdC_predicted,0.3333333333333333,2,2,TCCAAAATCATTGTCACCCT,0,1895000
icdC_predicted,0.3333333333333333,2,2,TCATCTTTTTGAGCACCGGT,0,1889583
icdC_predicted,0.3333333333333333,2,2,TCATCCGGACTTCAGGCTTC,0,1899707
icdC_predicted,0.3333333333333333,2,2,TCATAGCGTGCCGGTTGACT,0,1879092
icdC_predicted,0.3333333333333333,2,2,TCAGTGCATGATGACGGTCG,0,1899487
icdC_predicted,0.3333333333333333,2,2,TCAGCTTCTATCATAAGTAA,0,1878941
icdC_predicted,0.3333333333333333,2,2,TCAGATAATAAGGAACAAAA,0,1894572
icdC_predicted,0.3333333333333333,2,2,TCACTTGCGTTATAGGAGTC,0,1892486
icdC_predicted,0.3333333333333333,2,2,TCACGTGCATATGCCCGCAA,0,1900873
icdC_predicted,0.3333333333333333,2,2,TCACCCGTATGAATTGTTAC,0,1886725
icdC_predicted,0.3333333333333333,2,2,TCACAACCTACACTGTGAGC,0,1904313
icdC_predicted,0.3333333333333333,2,2,TCAACTGTCCGCCGCTAAGG,0,1895734
icdC_predicted,0.3333333333333333,2,2,TCAACAGAGTCCTACTAATC,0,1897622
icdC_predicted,0.3333333333333333,2,2,TCAACAACGGAATCCGTCGC,0,1878883
icdC_predicted,0.3333333333333333,2,2,TCAAAGAGTATTCACGTAGG,0,1883091
icdC_predicted,0.3333333333333333,2,2,TCAAACCGTAGAGGGTACCT,0,1884354
icdC_predicted,0.3333333333333333,2,2,TATTGACGCTAGGAAGGCTG,0,1900699
icdC_predicted,0.3333333333333333,2,2,TATGTGTGATTCGAGACCTG,0,1899636
icdC_predicted,0.3333333333333333,2,2,TATCGTTCAAATCCTGGCGC,0,1878255
icdC_predicted,0.3333333333333333,2,2,TATCGAACCTAGTAGTTTAT,0,1893771
icdC_predicted,0.3333333333333333,2,2,TATCCGGGATATCTGTCAAG,0,1903210
icdC_predicted,0.3333333333333333,2,2,TATCCGGAGGACACGCGTGA,0,1894259
icdC_predicted,0.3333333333333333,2,2,TATAGGGTTCAAAGAATTGA,0,1892532
icdC_predicted,0.3333333333333333,2,2,TAGCGGATAGAGCACGACCC,0,1880657
icdC_predicted,0.3333333333333333,2,2,TAGCGAATATGTGTAGTCTT,0,1895942
icdC_predicted,0.3333333333333333,2,2,TAGCATGAAGGCGATCGCTA,0,1886031
icdC_predicted,0.3333333333333333,2,2,TAGCAGAGTCCAATGGCCAA,0,1893306
icdC_predicted,0.3333333333333333,2,2,TAGCAGACTAACGCACCTTA,0,1903017
icdC_predicted,0.3333333333333333,2,2,TAGCACAATTTGAGCACGAA,0,1892711
icdC_predicted,0.3333333333333333,2,2,TAGATAAAGTGGCGGCGTTC,0,1902859
icdC_predicted,0.3333333333333333,2,2,TAGACCTTCAGTTGGAATGT,0,1883205
icdC_predicted,0.3333333333333333,2,2,TAGAAGGAAAGAAGTACGCA,0,1882825
icdC_predicted,0.3333333333333333,2,2,TACTTCCGTCAATTGACCTG,0,1879433
icdC_predicted,0.3333333333333333,2,2,TACTCGCCGCTACACCAAAA,0,1878088
icdC_predicted,0.3333333333333333,2,2,TACTACCGCGTAGGCGAACT,0,1893456
icdC_predicted,0.3333333333333333,2,2,TACGGTATCCTAGGAAATGT,0,1881703
icdC_predicted,0.3333333333333333,2,2,TACGGGGGCATGCAAAGACA,0,1891786
icdC_predicted,0.3333333333333333,2,2,TACGGCTCAGCTTAACGAAT,0,1909498
icdC_predicted,0.3333333333333333,2,2,TACGCTGTATAGTATGTGTA,0,1891549
icdC_predicted,0.3333333333333333,2,2,TACGAGTCAGGTATCACCGT,0,1895928
icdC_predicted,0.3333333333333333,2,2,TACGAGGTCGCAATTAGGTT,0,1904935
icdC_predicted,0.3333333333333333,2,2,TACGACCCCCCCAAGACGTA,0,1892441
icdC_predicted,0.3333333333333333,2,2,TACCGTATATGGGCCAGCGG,0,1879126
icdC_predicted,0.3333333333333333,2,2,TACCCATGGGTCAGGAACAG,0,1881707
icdC_predicted,0.3333333333333333,2,2,TACCACGGACCAGACCGCAA,0,1909473
icdC_predicted,0.3333333333333333,2,2,TACATGTGGTGTTGGTTTGG,0,1909106
icdC_predicted,0.3333333333333333,2,2,TACAGGCTTGCCTAGCCGCC,0,1905728
icdC_predicted,0.3333333333333333,2,2,TAATTAACTGTCCGTTGCAA,0,1898262
icdC_predicted,0.3333333333333333,2,2,TAAGCGAGTTACTTCCGTGA,0,1887939
icdC_predicted,0.3333333333333333,2,2,TAACTGTGGGTACATATCGG,0,1902767
icdC_predicted,0.3333333333333333,2,2,TAACGCGAGGACAGTTGGAT,0,1884648
icdC_predicted,0.3333333333333333,2,2,TAACCGACAGTATTGTGGGC,0,1893321
icdC_predicted,0.3333333333333333,2,2,TAACATGGAGTAATTATTAA,0,1889326
icdC_predicted,0.3333333333333333,2,2,TAAATTTCCATGGACTCGTG,0,1880885
icdC_predicted,0.3333333333333333,2,2,TAAACTTGACGACCCAAGAA,0,1886513
icdC_predicted,0.3333333333333333,2,2,GTTGTCAGGGAACGTTGCCA,0,1888681
icdC_predicted,0.3333333333333333,2,2,GTTGTAATGGGTTACCTGCT,0,1890875
icdC_predicted,0.3333333333333333,2,2,GTTGAAAGCCAGTGTGTCAG,0,1878523
icdC_predicted,0.3333333333333333,2,2,GTTCATACGAACAAGCGGTA,0,1902406
icdC_predicted,0.3333333333333333,2,2,GTTCAGAGGGATGGTACGGC,0,1890810
icdC_predicted,0.3333333333333333,2,2,GTGTGATAGATCTATGATTA,0,1878335
icdC_predicted,0.3333333333333333,2,2,GTGTCTTAGCGAAGGTAGGT,0,1882961
icdC_predicted,0.3333333333333333,2,2,GTGTCAGTCCCCGTTTGGAC,0,1891307
icdC_predicted,0.3333333333333333,2,2,GTGGTTTGGTCAGTAAGACC,0,1889327
icdC_predicted,0.3333333333333333,2,2,GTGGTTCGCACCATAGTTAT,0,1881225
icdC_predicted,0.3333333333333333,2,2,GTGCTCTGGTCAAGAAGGAG,0,1900893
icdC_predicted,0.3333333333333333,2,2,GTGATAGAACGTCTGCCGAT,0,1903120
icdC_predicted,0.3333333333333333,2,2,GTGAGTGTAGGCGGAGAATT,0,1902280
icdC_predicted,0.3333333333333333,2,2,GTGAGCGGTAAACGGATGCC,0,1878128
icdC_predicted,0.3333333333333333,2,2,GTGACTCCTAACATATGATA,0,1901733
icdC_predicted,0.3333333333333333,2,2,GTCTTGTATTCGGGGTTATA,0,1885837
icdC_predicted,0.3333333333333333,2,2,GTCTACGAGAAACACTGAGC,0,1884548
icdC_predicted,0.3333333333333333,2,2,GTCGTAAAGATGCAGGCCTA,0,1884503
icdC_predicted,0.3333333333333333,2,2,GTCGCTGATCCTGACATAGA,0,1889587
icdC_predicted,0.3333333333333333,2,2,GTCGCCGGTGTTTTCAAGAG,0,1894678
icdC_predicted,0.3333333333333333,2,2,GTCGAAAATCTGGGATTCTT,0,1909458
icdC_predicted,0.3333333333333333,2,2,GTCCATATTTCATTCGTGGC,0,1897914
icdC_predicted,0.3333333333333333,2,2,GTCATTCGACGGGAGCCGTG,0,1896539
icdC_predicted,0.3333333333333333,2,2,GTCATGCGTTGCTAAAATGC,0,1888204
icdC_predicted,0.3333333333333333,2,2,GTCATATGGGAATCGAGATC,0,1900815
icdC_predicted,0.3333333333333333,2,2,GTCAGAGCACACGGGATAAA,0,1896012
icdC_predicted,0.3333333333333333,2,2,GTCACTTGGGACATATTACC,0,1897495
icdC_predicted,0.3333333333333333,2,2,GTATGACAATAAAGGACATA,0,1879215
icdC_predicted,0.3333333333333333,2,2,GTATAGTTAACCGCGTATGT,0,1904085
icdC_predicted,0.3333333333333333,2,2,GTATAGAAGGATCTGGGGGC,0,1890455
icdC_predicted,0.3333333333333333,2,2,GTATAACTTGGCCGTTCTAG,0,1901181
icdC_predicted,0.3333333333333333,2,2,GTAGGAAGTGGATAGCGTCA,0,1899755
icdC_predicted,0.3333333333333333,2,2,GTACTTTCTATGTGGTACGT,0,1879338
icdC_predicted,0.3333333333333333,2,2,GTACTATGTAAGCGCTCTCC,0,1890847
icdC_predicted,0.3333333333333333,2,2,GTACGCCGGACCCGAAGATC,0,1902318
icdC_predicted,0.3333333333333333,2,2,GTACGATGTGGTGGCAGGCA,0,1888245
icdC_predicted,0.3333333333333333,2,2,GTACCGATGAGGGATCCCAA,0,1902819
icdC_predicted,0.3333333333333333,2,2,GTAAGCTTCTGGACGCAGGT,0,1878733
icdC_predicted,0.3333333333333333,2,2,GTAAGCAGCACGCTGGCTCG,0,1898454
icdC_predicted,0.3333333333333333,2,2,GTAAGACCGTTGTGTCTCGT,0,1890825
icdC_predicted,0.3333333333333333,2,2,GTAACGAAGGTACTGTTTCT,0,1879685
icdC_predicted,0.3333333333333333,2,2,GGTTTGTCTGCCCAAGACTC,0,1899454
icdC_predicted,0.3333333333333333,2,2,GGTTGATTAGGAACAGCGCG,0,1906569
icdC_predicted,0.3333333333333333,2,2,GGTTCTTCACGGTCCGCATA,0,1883891
icdC_predicted,0.3333333333333333,2,2,GGTTCTCGCGGGAGGAAAGT,0,1898599
icdC_predicted,0.3333333333333333,2,2,GGTTCCTAACGCGCCTAGTT,0,1895575
icdC_predicted,0.3333333333333333,2,2,GGTGGATTGATGACTCCCGT,0,1900603
icdC_predicted,0.3333333333333333,2,2,GGTGCCCGGGAAGGTTAAAG,0,1896205
icdC_predicted,0.3333333333333333,2,2,GGTCTGCGGTATATTCGGAC,0,1889699
icdC_predicted,0.3333333333333333,2,2,GGTCTCTATTGGTGTTGCGC,0,1890073
icdC_predicted,0.3333333333333333,2,2,GGTCGTGGTGGGCACCCTGC,0,1880722
icdC_predicted,0.3333333333333333,2,2,GGTCCAATATACTTCGTTTG,0,1894776
icdC_predicted,0.3333333333333333,2,2,GGTCATAGATTGGGGTGCAA,0,1884235
icdC_predicted,0.3333333333333333,2,2,GGTATTGCGGGGTCCCCAAC,0,1893704
icdC_predicted,0.3333333333333333,2,2,GGTAACTTGCGGATACCATC,0,1886452
icdC_predicted,0.3333333333333333,2,2,GGGTTTTTAGGAACGGCCAG,0,1893362
icdC_predicted,0.3333333333333333,2,2,GGGTGTACGCTACAAGTTAA,0,1882492
icdC_predicted,0.3333333333333333,2,2,GGGGTTCACCCCCTTTCACA,0,1895750
icdC_predicted,0.3333333333333333,2,2,GGGGTTACTCAAGAATCCTC,0,1891132
icdC_predicted,0.3333333333333333,2,2,GGGGTCACTCAGTTAAAGCC,0,1880391
icdC_predicted,0.3333333333333333,2,2,GGGGGCTGGTTGTAAAGCTT,0,1885332
icdC_predicted,0.3333333333333333,2,2,GGGCCTGTCCAGTCAAGGAT,0,1901017
icdC_predicted,0.3333333333333333,2,2,GGGCCGAAGTGGGTACGATT,0,1901183
icdC_predicted,0.3333333333333333,2,2,GGGATGGGGGTTTATTGAAC,0,1889820
icdC_predicted,0.3333333333333333,2,2,GGGATAATACTGAATACAAA,0,1895135
icdC_predicted,0.3333333333333333,2,2,GGGAGTCATCCAGGTCCGAT,0,1886038
icdC_predicted,0.3333333333333333,2,2,GGGAGATTACCTCGTGTGCA,0,1878740
icdC_predicted,0.3333333333333333,2,2,GGGAATAGCGACCACTAATG,0,1907248
icdC_predicted,0.3333333333333333,2,2,GGCTGGGTACCGGTGGGATC,0,1906712
icdC_predicted,0.3333333333333333,2,2,GGCTACACAGACTTAACGAA,0,1894410
icdC_predicted,0.3333333333333333,2,2,GGCGACTGACTCCGCTCGAG,0,1895501
icdC_predicted,0.3333333333333333,2,2,GGCCTCGAACAGTTCTGGGA,0,1887252
icdC_predicted,0.3333333333333333,2,2,GGCCTAGAGTGACGCAGGCC,0,1880434
icdC_predicted,0.3333333333333333,2,2,GGCCCCGTAATGGCTTAGTA,0,1883353
icdC_predicted,0.3333333333333333,2,2,GGCCCACGATGACAGGTCTT,0,1880589
icdC_predicted,0.3333333333333333,2,2,GGCACGCAATGGGAATACAG,0,1879537
icdC_predicted,0.3333333333333333,2,2,GGCACATGGTAGTATGCTCT,0,1887528
icdC_predicted,0.3333333333333333,2,2,GGATTGAAGTATCTTGCACC,0,1899358
icdC_predicted,0.3333333333333333,2,2,GGATCCCAGGGACTTTAGGT,0,1904335
icdC_predicted,0.3333333333333333,2,2,GGATCCCAACGTTGGCTGTG,0,1883467
icdC_predicted,0.3333333333333333,2,2,GGAGGTCATGCTGGCCTAAA,0,1902618
icdC_predicted,0.3333333333333333,2,2,GGACTGGTTTGGTGGTTGAT,0,1899716
icdC_predicted,0.3333333333333333,2,2,GGACTACAACTTGAACTGAA,0,1907701
icdC_predicted,0.3333333333333333,2,2,GGACATTCCGGCAGGAAAGA,0,1907254
icdC_predicted,0.3333333333333333,2,2,GGACATGGCCTGCCACCCTG,0,1892372
icdC_predicted,0.3333333333333333,2,2,GGACAAGACTCCCCGCACAC,0,1895952
icdC_predicted,0.3333333333333333,2,2,GGAATGCGCCTATAGGATCG,0,1901389
icdC_predicted,0.3333333333333333,2,2,GGAATCAGTCCGTATAGTTT,0,1894043
icdC_predicted,0.3333333333333333,2,2,GGAAGGGACGCTCGCCGAGT,0,1897503
icdC_predicted,0.3333333333333333,2,2,GGAAGGCTTAGTATATCCTT,0,1886830
icdC_predicted,0.3333333333333333,2,2,GCTTGGATCCCGTGCTCCAA,0,1894262
icdC_predicted,0.3333333333333333,2,2,GCTTCTCCCCAAAAAGCTTT,0,1903057
icdC_predicted,0.3333333333333333,2,2,GCTTCATAGGGTGTTATCTT,0,1883034
icdC_predicted,0.3333333333333333,2,2,GCTTCAATCCTACAGCGTTC,0,1887605
icdC_predicted,0.3333333333333333,2,2,GCTTATAATTTATAATACGT,0,1883233
icdC_predicted,0.3333333333333333,2,2,GCTCGTCAACCAGTTCAGGA,0,1892439
icdC_predicted,0.3333333333333333,2,2,GCTACGTGTACGCGACGGGC,0,1897813
icdC_predicted,0.3333333333333333,2,2,GCTACGGAAATACTGTTTTC,0,1898071
icdC_predicted,0.3333333333333333,2,2,GCTAATTAGACGTACCATAT,0,1891110
icdC_predicted,0.3333333333333333,2,2,GCGTTTGCGTCCCATGCTAT,0,1887451
icdC_predicted,0.3333333333333333,2,2,GCGTATTGAGGTTTGGATCT,0,1890185
icdC_predicted,0.3333333333333333,2,2,GCGTATAAATGGTACCAAGA,0,1902185
icdC_predicted,0.3333333333333333,2,2,GCGGGTTACACTGAGAAGGT,0,1895527
icdC_predicted,0.3333333333333333,2,2,GCGGCTTTGAGAGCAATGAC,0,1896879
icdC_predicted,0.3333333333333333,2,2,GCGCTCCCCCAAGAGACCTA,0,1901751
icdC_predicted,0.3333333333333333,2,2,GCGCGGACATTGACTCGTCC,0,1895839
icdC_predicted,0.3333333333333333,2,2,GCGCCGTAGCCACACGGGCT,0,1890743
icdC_predicted,0.3333333333333333,2,2,GCGAGTGGGACTTGTCCACG,0,1893004
icdC_predicted,0.3333333333333333,2,2,GCGACGTTTTACACTCAAGT,0,1900084
icdC_predicted,0.3333333333333333,2,2,GCGAATCGAGCTAGTTTCTT,0,1881076
icdC_predicted,0.3333333333333333,2,2,GCCTAGAGCCTGCAGTAGTC,0,1906382
icdC_predicted,0.3333333333333333,2,2,GCCGTAGAAACCATCGATTC,0,1894928
icdC_predicted,0.3333333333333333,2,2,GCCGGGACCCAAACGGGTCG,0,1903746
icdC_predicted,0.3333333333333333,2,2,GCCGCGCCCCGGATTCTCTC,0,1897040
icdC_predicted,0.3333333333333333,2,2,GCCCTTCGGTGCACTGTGGG,0,1890365
icdC_predicted,0.3333333333333333,2,2,GCCCTTATATCAAACGTGGG,0,1901612
icdC_predicted,0.3333333333333333,2,2,GCCCTGTATCGTCTACACGC,0,1904461
icdC_predicted,0.3333333333333333,2,2,GCCCTGGGGCGTTTTTCACA,0,1892534
icdC_predicted,0.3333333333333333,2,2,GCCCGAGCAGATGTACTCAC,0,1887285
icdC_predicted,0.3333333333333333,2,2,GCCCCATAAATCAAGGCCTA,0,1906220
icdC_predicted,0.3333333333333333,2,2,GCCCCAGACCGGGAACCAGG,0,1878765
icdC_predicted,0.3333333333333333,2,2,GCCATCGCGGGCGTCCGAAA,0,1896052
icdC_predicted,0.3333333333333333,2,2,GCCACCGTTCTGGCAAACCT,0,1906145
icdC_predicted,0.3333333333333333,2,2,GCATCGGTGATAAACTATTT,0,1896318
icdC_predicted,0.3333333333333333,2,2,GCATAATAAAATTGAGTCCA,0,1896309
icdC_predicted,0.3333333333333333,2,2,GCAGTTCGAACGAGGACCAC,0,1901688
icdC_predicted,0.3333333333333333,2,2,GCAGTCCGAGAGACTTTGTT,0,1896458
icdC_predicted,0.3333333333333333,2,2,GCAGGACTCTCATATGTAAC,0,1888718
icdC_predicted,0.3333333333333333,2,2,GCAGCGAAGTGGAGGGAATC,0,1894624
icdC_predicted,0.3333333333333333,2,2,GCAGAATGGTCTCGGGCCTT,0,1903641
icdC_predicted,0.3333333333333333,2,2,GCACGACGCTTATGTCGTGA,0,1889189
icdC_predicted,0.3333333333333333,2,2,GCACCTAGAGTGACGCATCA,0,1888195
icdC_predicted,0.3333333333333333,2,2,GCACCAGATCACCGGATTTA,0,1905655
icdC_predicted,0.3333333333333333,2,2,GCACAACATGTGCTAGAAAC,0,1906317
icdC_predicted,0.3333333333333333,2,2,GCAATTGCGAGATATGGTTG,0,1898382
icdC_predicted,0.3333333333333333,2,2,GCAAGAGGTCGCCAAGCCTC,0,1899986
icdC_predicted,0.3333333333333333,2,2,GCAACGGTAAAGGTAATCGG,0,1887657
icdC_predicted,0.3333333333333333,2,2,GCAACCAATGGTCTGGCGAT,0,1878053
icdC_predicted,0.3333333333333333,2,2,GCAACATCCCACGCAGGGGG,0,1905994
icdC_predicted,0.3333333333333333,2,2,GATTTAGAGTAAAAGCATAC,0,1899626
icdC_predicted,0.3333333333333333,2,2,GATTAAGAAATTAGCGTACA,0,1898101
icdC_predicted,0.3333333333333333,2,2,GATGTTACTGCTTTCGGGTT,0,1884202
icdC_predicted,0.3333333333333333,2,2,GATGTGTGGTTGTAGTTGAC,0,1894473
icdC_predicted,0.3333333333333333,2,2,GATGGACTTGTGGTTACCTC,0,1880123
icdC_predicted,0.3333333333333333,2,2,GATGAGGTCACTACCTCAGG,0,1899621
icdC_predicted,0.3333333333333333,2,2,GATGAAGCAGACCGCCAATT,0,1894330
icdC_predicted,0.3333333333333333,2,2,GATCTAGTAAAATCGATGTC,0,1904471
icdC_predicted,0.3333333333333333,2,2,GATCGCCTCTGGGTACAACA,0,1900090
icdC_predicted,0.3333333333333333,2,2,GATCCACATGAAGGCCCACT,0,1900062
icdC_predicted,0.3333333333333333,2,2,GATAGAAATCCCGCGGCTGA,0,1905965
icdC_predicted,0.3333333333333333,2,2,GATAAAAACTAATGCGCGAC,0,1893202
icdC_predicted,0.3333333333333333,2,2,GAGTTGTTCGATCTAGGTAT,0,1906922
icdC_predicted,0.3333333333333333,2,2,GAGTATCCGACATCCTTCGA,0,1887232
icdC_predicted,0.3333333333333333,2,2,GAGTATAAAAGCCCTCATAC,0,1886340
icdC_predicted,0.3333333333333333,2,2,GAGGCGGGCGGCCGTATTTA,0,1892184
icdC_predicted,0.3333333333333333,2,2,GAGGCCAGCCTACTTGAGGA,0,1908701
icdC_predicted,0.3333333333333333,2,2,GAGCCCGTCAAGTCCCAACC,0,1883776
icdC_predicted,0.3333333333333333,2,2,GAGCACCATGCAAAAGGTCA,0,1892819
icdC_predicted,0.3333333333333333,2,2,GAGAGACCGCACGGTATTAC,0,1906134
icdC_predicted,0.3333333333333333,2,2,GAGACGGGCCCAGACCGGGA,0,1879077
icdC_predicted,0.3333333333333333,2,2,GAGACGAGCGATCAAGCAGT,0,1897832
icdC_predicted,0.3333333333333333,2,2,GAGAACGACTCTCATAGATT,0,1902784
icdC_predicted,0.3333333333333333,2,2,GACTGAAAAGTCCTTATGCA,0,1893328
icdC_predicted,0.3333333333333333,2,2,GACGTGGACCTGCGTTACAT,0,1891645
icdC_predicted,0.3333333333333333,2,2,GACGAAGGGTTATTTGTATT,0,1909179
icdC_predicted,0.3333333333333333,2,2,GACCGTAGGTGTCACCGAGC,0,1894051
icdC_predicted,0.3333333333333333,2,2,GACCGAGGCAAAGGTGCAAC,0,1908900
icdC_predicted,0.3333333333333333,2,2,GACCGAAGCAATTCCGGTGT,0,1899655
icdC_predicted,0.3333333333333333,2,2,GACAACCTGGTCCTCCTACG,0,1880937
icdC_predicted,0.3333333333333333,2,2,GAATTTACGGTTGAGGTACG,0,1907581
icdC_predicted,0.3333333333333333,2,2,GAAGGAACCTAACAACAATG,0,1884742
icdC_predicted,0.3333333333333333,2,2,GAACTGTATCGCAGAATGCC,0,1903126
icdC_predicted,0.3333333333333333,2,2,GAACTGGCGTTTCAGGTCCG,0,1908186
icdC_predicted,0.3333333333333333,2,2,GAACGGTGCGGAAGGGGTGT,0,1894669
icdC_predicted,0.3333333333333333,2,2,GAACCGGCGATCTTAGTTCT,0,1895355
icdC_predicted,0.3333333333333333,2,2,GAACCATAGCTGTAACTAAG,0,1905275
icdC_predicted,0.3333333333333333,2,2,GAACAGCCTCCCATCATGTC,0,1896934
icdC_predicted,0.3333333333333333,2,2,GAAATCTGGGTGAAGAGGGA,0,1878780
icdC_predicted,0.3333333333333333,2,2,GAAAGTCGATTGCCTTATCA,0,1888742
icdC_predicted,0.3333333333333333,2,2,GAAAGGTACCGTGTGAGCGG,0,1896011
icdC_predicted,0.3333333333333333,2,2,GAAAGGACCTGTGTTAAGTT,0,1881282
icdC_predicted,0.3333333333333333,2,2,GAAACACCCCCTTCCCTAAA,0,1879538
icdC_predicted,0.3333333333333333,2,2,GAAAAACACAGAAGTAGACA,0,1898048
icdC_predicted,0.3333333333333333,2,2,CTTTCTTTAGGTTTTATTTT,0,1906274
icdC_predicted,0.3333333333333333,2,2,CTTTCACCAGCAACGTTGCG,0,1901312
icdC_predicted,0.3333333333333333,2,2,CTTTATGTATCGAGTAATTA,0,1900389
icdC_predicted,0.3333333333333333,2,2,CTTGTACAGCTTGCGGGCTC,0,1889671
icdC_predicted,0.3333333333333333,2,2,CTTGGTTTCGCCCAGAATTT,0,1906364
icdC_predicted,0.3333333333333333,2,2,CTTGGTATGACCGTTCTCTT,0,1907102
icdC_predicted,0.3333333333333333,2,2,CTTGCGCACAGTATGTTCAA,0,1889660
icdC_predicted,0.3333333333333333,2,2,CTTGCGATTATATCTGTTCC,0,1884627
icdC_predicted,0.3333333333333333,2,2,CTTGACTGAAACCGCGAACG,0,1893746
icdC_predicted,0.3333333333333333,2,2,CTTGACTAACGTTGACCCAC,0,1895778
icdC_predicted,0.3333333333333333,2,2,CTTGAATCAATAACTTTCGG,0,1890511
icdC_predicted,0.3333333333333333,2,2,CTTCTCCGTCTATCAGAAGT,0,1901687
icdC_predicted,0.3333333333333333,2,2,CTTCGTCCACCCGTACCGTT,0,1884780
icdC_predicted,0.3333333333333333,2,2,CTTCGGCCGGTGTTCTCGGA,0,1903612
icdC_predicted,0.3333333333333333,2,2,CTTATGAACCAACGGAATCA,0,1894478
icdC_predicted,0.3333333333333333,2,2,CTTATCCGCCAATCTTCTTA,0,1908804
icdC_predicted,0.3333333333333333,2,2,CTTAGAATGTATGAGGACTA,0,1905660
icdC_predicted,0.3333333333333333,2,2,CTTACGCAAGGTATCTTAAT,0,1902794
icdC_predicted,0.3333333333333333,2,2,CTTAAGGAAGGGTGAGTCTG,0,1889282
icdC_predicted,0.3333333333333333,2,2,CTTAACTTTTGACTACAAGT,0,1907814
icdC_predicted,0.3333333333333333,2,2,CTGTGGTTAAAACAGTAATT,0,1891026
icdC_predicted,0.3333333333333333,2,2,CTGTGGATAGCGCACCGGAT,0,1883836
icdC_predicted,0.3333333333333333,2,2,CTGGTGAGATTGTAGTGGAC,0,1890636
icdC_predicted,0.3333333333333333,2,2,CTGGATACGACTGCTCATAT,0,1880215
icdC_predicted,0.3333333333333333,2,2,CTGCGGGTCTGTCGGAACCA,0,1908316
icdC_predicted,0.3333333333333333,2,2,CTGCATGAAGGCTGTACTGA,0,1889771
icdC_predicted,0.3333333333333333,2,2,CTGATATAAGCGTTTTCAGT,0,1886223
icdC_predicted,0.3333333333333333,2,2,CTGAGGAAAGGCGATATTGG,0,1908591
icdC_predicted,0.3333333333333333,2,2,CTGAGGAAACCCCGGGCAAG,0,1896907
icdC_predicted,0.3333333333333333,2,2,CTGAGATGGGGTGCCTGACC,0,1887205
icdC_predicted,0.3333333333333333,2,2,CTGAGATCCGTGCATAAGCT,0,1906652
icdC_predicted,0.3333333333333333,2,2,CTCTCCACGCGGCAATTAAG,0,1902330
icdC_predicted,0.3333333333333333,2,2,CTCTAATCAGTAGCTAACAT,0,1894208
icdC_predicted,0.3333333333333333,2,2,CTCGGGCAGAATTCGCATGC,0,1908040
icdC_predicted,0.3333333333333333,2,2,CTCGGCACCGGGGGCGCGTG,0,1882043
icdC_predicted,0.3333333333333333,2,2,CTCGCGCATAGGGGCAGTAA,0,1884679
icdC_predicted,0.3333333333333333,2,2,CTCGCCTCGGTGCTTGACTG,0,1885284
icdC_predicted,0.3333333333333333,2,2,CTCGACAGGGTCTACACAGG,0,1898263
icdC_predicted,0.3333333333333333,2,2,CTCCTTCCGTGGTTCGGAGG,0,1884244
icdC_predicted,0.3333333333333333,2,2,CTCATGTTCATGTTATGCCA,0,1896964
icdC_predicted,0.3333333333333333,2,2,CTATTTTACGTTGCGCACCA,0,1889574
icdC_predicted,0.3333333333333333,2,2,CTATTAGGGGAAAATCAAAT,0,1905545
icdC_predicted,0.3333333333333333,2,2,CTATGCGAGAGTCCCTGCGC,0,1899214
icdC_predicted,0.3333333333333333,2,2,CTATCAGAACCGTGAGCACG,0,1902113
icdC_predicted,0.3333333333333333,2,2,CTATCAATCCTCTAGAGTGC,0,1895820
icdC_predicted,0.3333333333333333,2,2,CTATACCGCACATGGACTAA,0,1901323
icdC_predicted,0.3333333333333333,2,2,CTAGGCCTGACTGTGCGCCT,0,1896821
icdC_predicted,0.3333333333333333,2,2,CTAGCATCAAAATTACAGAA,0,1892855
icdC_predicted,0.3333333333333333,2,2,CTAGCAGTTCCCGATACATG,0,1905410
icdC_predicted,0.3333333333333333,2,2,CTACTAAAAGCGAGTTTCTG,0,1902157
icdC_predicted,0.3333333333333333,2,2,CTACGCCAGTCGATCGCTGA,0,1889798
icdC_predicted,0.3333333333333333,2,2,CTACCCGCCCCGCAGGTATG,0,1887655
icdC_predicted,0.3333333333333333,2,2,CTACAAATTTCCGGTCTATC,0,1879927
icdC_predicted,0.3333333333333333,2,2,CTAATTGATTCAGGGGCCGG,0,1887290
icdC_predicted,0.3333333333333333,2,2,CTAAACGTTACATACAACCT,0,1889700
icdC_predicted,0.3333333333333333,2,2,CGTTTGAGGAACGAATCGGG,0,1881314
icdC_predicted,0.3333333333333333,2,2,CGTTCACTCTCCGCCAACTT,0,1890831
icdC_predicted,0.3333333333333333,2,2,CGTGTGAATGATTAGAGGGC,0,1902820
icdC_predicted,0.3333333333333333,2,2,CGTGTAAGGACTCGAAAAGC,0,1880460
icdC_predicted,0.3333333333333333,2,2,CGTGCTAGCGTCCGTACTAC,0,1889956
icdC_predicted,0.3333333333333333,2,2,CGTAGTAATCAATTACTGTT,0,1880980
icdC_predicted,0.3333333333333333,2,2,CGTAATGCGTATGCGGCAGG,0,1887770
icdC_predicted,0.3333333333333333,2,2,CGGTTCTAGCTACATTGTTG,0,1882611
icdC_predicted,0.3333333333333333,2,2,CGGTGTATCACTTCTCTTAT,0,1907602
icdC_predicted,0.3333333333333333,2,2,CGGTGGGTGTGATGCGAATA,0,1891858
icdC_predicted,0.3333333333333333,2,2,CGGGGATCCAAGAACGAATG,0,1896620
icdC_predicted,0.3333333333333333,2,2,CGGGCTCGTTGGTTCCGTTG,0,1879930
icdC_predicted,0.3333333333333333,2,2,CGGGATAAGCGTAATCGTAA,0,1883466
icdC_predicted,0.3333333333333333,2,2,CGGCCGAAAACTGTGTTCAC,0,1889321
icdC_predicted,0.3333333333333333,2,2,CGGCCCTATTAATCGCCTGC,0,1887626
icdC_predicted,0.3333333333333333,2,2,CGGCCACCTATACTTTTTCT,0,1908523
icdC_predicted,0.3333333333333333,2,2,CGGCAAGAGGTTATATTTCA,0,1890595
icdC_predicted,0.3333333333333333,2,2,CGGCAAAGGCCATTGACAGT,0,1878268
icdC_predicted,0.3333333333333333,2,2,CGGATCCCGTACAACTGGCA,0,1893546
icdC_predicted,0.3333333333333333,2,2,CGGAATACGGGTGTCAATAC,0,1887955
icdC_predicted,0.3333333333333333,2,2,CGGAAGATACTCATGCGCCA,0,1906059
icdC_predicted,0.3333333333333333,2,2,CGGAAACGGGGTGATGCGGT,0,1885821
icdC_predicted,0.3333333333333333,2,2,CGCGTCGTACTCGGCAAAAT,0,1907858
icdC_predicted,0.3333333333333333,2,2,CGCGTATATAGGTTAATAAC,0,1907795
icdC_predicted,0.3333333333333333,2,2,CGCGCCTTTCATTAGTATAA,0,1879298
icdC_predicted,0.3333333333333333,2,2,CGCGACGCAAGTTACTGTAT,0,1909219
icdC_predicted,0.3333333333333333,2,2,CGCCGATTATCACTTACGCT,0,1891104
icdC_predicted,0.3333333333333333,2,2,CGCCAGTTAGAATTTAATAT,0,1887642
icdC_predicted,0.3333333333333333,2,2,CGCCAGCGGGCCCGCGTCTG,0,1883186
icdC_predicted,0.3333333333333333,2,2,CGCCAATACTGAAGTTAGAC,0,1905975
icdC_predicted,0.3333333333333333,2,2,CGCAGGTCCCACTTTATAGC,0,1904959
icdC_predicted,0.3333333333333333,2,2,CGATTAAGTTCAAGTCAATG,0,1900349
icdC_predicted,0.3333333333333333,2,2,CGAGTGGCAAGACCGCACTA,0,1879475
icdC_predicted,0.3333333333333333,2,2,CGAGTAGCCTCCGCCGACAG,0,1893121
icdC_predicted,0.3333333333333333,2,2,CGAGCTTGGCCTATGGTTAT,0,1894772
icdC_predicted,0.3333333333333333,2,2,CGAGCCAGATCAGTCGCAAA,0,1893956
icdC_predicted,0.3333333333333333,2,2,CGAGCATAAAGCGCCGTTCT,0,1887652
icdC_predicted,0.3333333333333333,2,2,CGACTCCAAAGCTGTTGTGT,0,1891264
icdC_predicted,0.3333333333333333,2,2,CGACGTCATATAATTTTTTT,0,1895655
icdC_predicted,0.3333333333333333,2,2,CGACAAAGGTTCTGGGTGGA,0,1878092
icdC_predicted,0.3333333333333333,2,2,CGAAGCGACGTATAGCTCCA,0,1906246
icdC_predicted,0.3333333333333333,2,2,CGAACCGGCATTGGGAGCCT,0,1893931
icdC_predicted,0.3333333333333333,2,2,CCTTCTGTCTTCCCATTCTG,0,1881421
icdC_predicted,0.3333333333333333,2,2,CCTTCTCCGTGTTGTTGTAC,0,1898142
icdC_predicted,0.3333333333333333,2,2,CCTTCCCGTATGAGCGGTCT,0,1898973
icdC_predicted,0.3333333333333333,2,2,CCTTCACAGTAAGCCAGGCG,0,1902419
icdC_predicted,0.3333333333333333,2,2,CCTTAGGACAATGGTAGGTT,0,1886543
icdC_predicted,0.3333333333333333,2,2,CCTTAGAGAAAGTCCGGGAC,0,1904062
icdC_predicted,0.3333333333333333,2,2,CCTGGGCGTGTCCATATGGC,0,1900483
icdC_predicted,0.3333333333333333,2,2,CCTGGAGACGATCTCGTTTC,0,1893619
icdC_predicted,0.3333333333333333,2,2,CCTGAGGGAGGGGGTCCAGG,0,1897257
icdC_predicted,0.3333333333333333,2,2,CCTCTCAGCGCTCGAAGCAG,0,1882129
icdC_predicted,0.3333333333333333,2,2,CCTCGTATAATTAGTATTAT,0,1903424
icdC_predicted,0.3333333333333333,2,2,CCTCCAATATCGCAACGCAA,0,1900816
icdC_predicted,0.3333333333333333,2,2,CCTCAGACTGACCCTACGAT,0,1900106
icdC_predicted,0.3333333333333333,2,2,CCTCAAGGGGGAACTCCGGC,0,1881283
icdC_predicted,0.3333333333333333,2,2,CCTATCACGTACTTGAGACT,0,1877917
icdC_predicted,0.3333333333333333,2,2,CCTATAAAACGACGGAAATG,0,1877974
icdC_predicted,0.3333333333333333,2,2,CCTAGTCATAGGCGTTATCC,0,1884331
icdC_predicted,0.3333333333333333,2,2,CCTACAGTACGAGGAACCTG,0,1895665
icdC_predicted,0.3333333333333333,2,2,CCGTTGGCCCCCTGAACAGC,0,1891651
icdC_predicted,0.3333333333333333,2,2,CCGTAGGCGGGTGTCGGGGT,0,1886547
icdC_predicted,0.3333333333333333,2,2,CCGGTAACGCCACAGGCTCA,0,1908986
icdC_predicted,0.3333333333333333,2,2,CCGCCCGACCAGCAGCACGG,0,1892239
icdC_predicted,0.3333333333333333,2,2,CCGCCAGCTCCCGGGTCATA,0,1890065
icdC_predicted,0.3333333333333333,2,2,CCGACCCTAAGACTACACTG,0,1891463
icdC_predicted,0.3333333333333333,2,2,CCGAACGCCTGAGGAGGAGA,0,1890576
icdC_predicted,0.3333333333333333,2,2,CCCTTGGCCACCGCGAAGGC,0,1895430
icdC_predicted,0.3333333333333333,2,2,CCCTTAGAGCAGGCGATTGA,0,1907460
icdC_predicted,0.3333333333333333,2,2,CCCGTACCCCCTGACAGCCT,0,1888133
icdC_predicted,0.3333333333333333,2,2,CCCGGTAACCGGCGGCTTAT,0,1903635
icdC_predicted,0.3333333333333333,2,2,CCCGCACATGATCCAGACAT,0,1898805
icdC_predicted,0.3333333333333333,2,2,CCCCGAGTCGGATTCGCAAT,0,1882620
icdC_predicted,0.3333333333333333,2,2,CCCCGAGGGGAAGAAAGCTC,0,1900067
icdC_predicted,0.3333333333333333,2,2,CCCCAACCGAAGCAGGTTGC,0,1879377
icdC_predicted,0.3333333333333333,2,2,CCCCAAAGAGATAGAAGCCA,0,1882772
icdC_predicted,0.3333333333333333,2,2,CCCAGGAAATCTAGCTTACG,0,1879187
icdC_predicted,0.3333333333333333,2,2,CCATGAACGGGTTTCGGCAC,0,1901444
icdC_predicted,0.3333333333333333,2,2,CCATCGGCCAGAGTCTAAGT,0,1882254
icdC_predicted,0.3333333333333333,2,2,CCATATCCGGTCTAGAATCG,0,1906030
icdC_predicted,0.3333333333333333,2,2,CCAGGCTGCCATGCCGCAGT,0,1890802
icdC_predicted,0.3333333333333333,2,2,CCAGCGGTGACTCCGTACAT,0,1881100
icdC_predicted,0.3333333333333333,2,2,CCAGATGAACGGTTACCGGG,0,1897954
icdC_predicted,0.3333333333333333,2,2,CCACTTCGTGGCTGTGTCAA,0,1882872
icdC_predicted,0.3333333333333333,2,2,CCACTGCTATGATTGGTGTT,0,1890614
icdC_predicted,0.3333333333333333,2,2,CCACTATAAATCCCATAGAC,0,1880486
icdC_predicted,0.3333333333333333,2,2,CCACACCCCCTGGTCTTGTG,0,1890684
icdC_predicted,0.3333333333333333,2,2,CCACAATGGCACTGGTATCG,0,1898873
icdC_predicted,0.3333333333333333,2,2,CCACAAATTGCGTATAATTA,0,1887705
icdC_predicted,0.3333333333333333,2,2,CCAATATTCTAAGGTTTCCC,0,1905358
icdC_predicted,0.3333333333333333,2,2,CCAACCTGGGCATCCTCAGT,0,1891102
icdC_predicted,0.3333333333333333,2,2,CCAACCACTCGGGGTCGGTC,0,1897540
icdC_predicted,0.3333333333333333,2,2,CCAAACAGGCGAGCGTCATA,0,1898671
icdC_predicted,0.3333333333333333,2,2,CATTCATAATTGACACCAAT,0,1889824
icdC_predicted,0.3333333333333333,2,2,CATTAACAAATCAGAAGGAG,0,1907974
icdC_predicted,0.3333333333333333,2,2,CATGTGGCTCGTGTAACTCG,0,1903314
icdC_predicted,0.3333333333333333,2,2,CATGACGAGGTAAACGTGCA,0,1898103
icdC_predicted,0.3333333333333333,2,2,CATCTATGTTACCAGTACGT,0,1900354
icdC_predicted,0.3333333333333333,2,2,CATCGGGTTAAACTGTCATT,0,1908355
icdC_predicted,0.3333333333333333,2,2,CAGTTTACCAGATTCAATAC,0,1901605
icdC_predicted,0.3333333333333333,2,2,CAGTTATCATCGACGGGAGA,0,1887486
icdC_predicted,0.3333333333333333,2,2,CAGTACAGTCCCGAGGTCTA,0,1908407
icdC_predicted,0.3333333333333333,2,2,CAGGTTAGGACTGTTAACAC,0,1892505
icdC_predicted,0.3333333333333333,2,2,CAGGTATATGGTGTTATATC,0,1902327
icdC_predicted,0.3333333333333333,2,2,CAGGATGGACCTCTCTTCGA,0,1882738
icdC_predicted,0.3333333333333333,2,2,CAGCTGTAAGCCTGTCTCAA,0,1889481
icdC_predicted,0.3333333333333333,2,2,CAGCGCCTCAATACTATACT,0,1901250
icdC_predicted,0.3333333333333333,2,2,CAGCGCCTACGGATGTGGAG,0,1882047
icdC_predicted,0.3333333333333333,2,2,CAGCACTAACCACAATTAGA,0,1898500
icdC_predicted,0.3333333333333333,2,2,CAGAGGTAGTGAAACATGGA,0,1898189
icdC_predicted,0.3333333333333333,2,2,CAGACTACGTATGGGACATG,0,1900658
icdC_predicted,0.3333333333333333,2,2,CAGACCCATAAGGTGCATTT,0,1904056
icdC_predicted,0.3333333333333333,2,2,CAGACCAAAGAATGGCGTCC,0,1896212
icdC_predicted,0.3333333333333333,2,2,CAGAAATTCGTCCTGAGCGG,0,1907763
icdC_predicted,0.3333333333333333,2,2,CACTTCTAGCGCCGCTTAGA,0,1884971
icdC_predicted,0.3333333333333333,2,2,CACTGGCTATATCTAACGTA,0,1902428
icdC_predicted,0.3333333333333333,2,2,CACTGGAGCTGGGTTTCAGT,0,1882506
icdC_predicted,0.3333333333333333,2,2,CACTCCTCTGACGAATATAA,0,1880061
icdC_predicted,0.3333333333333333,2,2,CACTCATGAACCCGATGCTG,0,1886470
icdC_predicted,0.3333333333333333,2,2,CACTAGCCCTTTGGGCAATC,0,1905877
icdC_predicted,0.3333333333333333,2,2,CACGCTGGTGCCCCGTACGG,0,1898087
icdC_predicted,0.3333333333333333,2,2,CACCGTATAGGCGTGTTTAC,0,1902771
icdC_predicted,0.3333333333333333,2,2,CACCAGCTCAAAAACGAGAC,0,1886271
icdC_predicted,0.3333333333333333,2,2,CACCACGCCACGATTCAGCA,0,1886236
icdC_predicted,0.3333333333333333,2,2,CACAACGGCCGCTGGCACCA,0,1897753
icdC_predicted,0.3333333333333333,2,2,CACAACCCCTAAAATGTGCT,0,1901625
icdC_predicted,0.3333333333333333,2,2,CAATTACTAGATAATGCAAA,0,1890483
icdC_predicted,0.3333333333333333,2,2,CAATTAAAGGAATACCAAGG,0,1900016
icdC_predicted,0.3333333333333333,2,2,CAATGTCATCGTCAAACCAA,0,1898484
icdC_predicted,0.3333333333333333,2,2,CAATGGTCTGTTTGTGGGCG,0,1904756
icdC_predicted,0.3333333333333333,2,2,CAATGATTTCTAGTTCGGTC,0,1884411
icdC_predicted,0.3333333333333333,2,2,CAATATCAACGGATTACAAT,0,1890196
icdC_predicted,0.3333333333333333,2,2,CAAGGCTGGGGGCGGTCCGT,0,1904534
icdC_predicted,0.3333333333333333,2,2,CAAGACGGGTGTCAACCAAG,0,1883665
icdC_predicted,0.3333333333333333,2,2,CAACTCTATCAACATAATAA,0,1905893
icdC_predicted,0.3333333333333333,2,2,CAACGGGGGGCAGGCGAACT,0,1902682
icdC_predicted,0.3333333333333333,2,2,CAACGGGCCACCTCCATATT,0,1903035
icdC_predicted,0.3333333333333333,2,2,CAACGGAGCCCATTTGGTCC,0,1905423
icdC_predicted,0.3333333333333333,2,2,ATTTTTTCAAGGGGTGCGGT,0,1896939
icdC_predicted,0.3333333333333333,2,2,ATTTGTTCGGGTTTTCTCTG,0,1878480
icdC_predicted,0.3333333333333333,2,2,ATTTCATACTACAACTATGT,0,1884683
icdC_predicted,0.3333333333333333,2,2,ATTTAAGCTAAGGACAACCC,0,1900083
icdC_predicted,0.3333333333333333,2,2,ATTCGGGGTTGCGCTAGGAA,0,1902308
icdC_predicted,0.3333333333333333,2,2,ATTCGACCAAGCGGGTAACT,0,1898240
icdC_predicted,0.3333333333333333,2,2,ATTAGGTAGACATACCCATA,0,1885652
icdC_predicted,0.3333333333333333,2,2,ATTAGGATCACATTGCCCCC,0,1882717
icdC_predicted,0.3333333333333333,2,2,ATTAAGTAGTTAGGAATAGT,0,1893841
icdC_predicted,0.3333333333333333,2,2,ATGTGTTACTATGGAAAAAA,0,1904427
icdC_predicted,0.3333333333333333,2,2,ATGTATTCAAAAGTCTATCG,0,1882354
icdC_predicted,0.3333333333333333,2,2,ATGTACTAGGTATCGTTCTA,0,1904548
icdC_predicted,0.3333333333333333,2,2,ATGTACGGTAGGCCCTGCAG,0,1907867
icdC_predicted,0.3333333333333333,2,2,ATGGTCGGCACTGTATTGTC,0,1883527
icdC_predicted,0.3333333333333333,2,2,ATGGGAGCCTCCTAAGCAAG,0,1882353
icdC_predicted,0.3333333333333333,2,2,ATGGCTAAATATCAGATAAG,0,1883877
icdC_predicted,0.3333333333333333,2,2,ATGGACAGCTCAAAGCGTAC,0,1881000
icdC_predicted,0.3333333333333333,2,2,ATGCGCGATGAGTACAGCTT,0,1878042
icdC_predicted,0.3333333333333333,2,2,ATGCCGATCGCACCGGCAAC,0,1888831
icdC_predicted,0.3333333333333333,2,2,ATGCACACCCTAAGCGTTCC,0,1899178
icdC_predicted,0.3333333333333333,2,2,ATGATGTGTGGAAGTGGCGT,0,1878493
icdC_predicted,0.3333333333333333,2,2,ATGAGAGTGGTTTAAGGAGT,0,1884662
icdC_predicted,0.3333333333333333,2,2,ATGACTGCGCTGTTCTATCC,0,1879607
icdC_predicted,0.3333333333333333,2,2,ATGACGATCAGCAGTTTTTA,0,1888146
icdC_predicted,0.3333333333333333,2,2,ATGAAAGTTCCTAACGGCGT,0,1905073
icdC_predicted,0.3333333333333333,2,2,ATCTTTGACACGAATGTCTC,0,1898545
icdC_predicted,0.3333333333333333,2,2,ATCTTCGATGAGGATGACTC,0,1900848
icdC_predicted,0.3333333333333333,2,2,ATCTTCGAACCGGGTTTAGC,0,1878195
icdC_predicted,0.3333333333333333,2,2,ATCTCTCTGAGGTCATAGTC,0,1897272
icdC_predicted,0.3333333333333333,2,2,ATCTCGGGGGATGCGCATAT,0,1878562
icdC_predicted,0.3333333333333333,2,2,ATCTCACTCAGTATAGATTT,0,1904131
icdC_predicted,0.3333333333333333,2,2,ATCTCAATGTCAGTCGGACC,0,1889368
icdC_predicted,0.3333333333333333,2,2,ATCGGCCTTAAACGACGTGT,0,1886153
icdC_predicted,0.3333333333333333,2,2,ATCGGCCGACCGGGGCGCAT,0,1906117
icdC_predicted,0.3333333333333333,2,2,ATCGCAAGTGTGAAATTCCC,0,1886193
icdC_predicted,0.3333333333333333,2,2,ATCGAAGAAGGAAGGCAAGC,0,1899121
icdC_predicted,0.3333333333333333,2,2,ATCCGCAGGACAATCGTGAT,0,1881813
icdC_predicted,0.3333333333333333,2,2,ATCCCGTAATTACTTGTGGA,0,1898117
icdC_predicted,0.3333333333333333,2,2,ATCAGGGTGCCAGTCTCATG,0,1878880
icdC_predicted,0.3333333333333333,2,2,ATCACCCAACGAGCGGGCCC,0,1890106
icdC_predicted,0.3333333333333333,2,2,ATCAATCCGAGAAGTTAACA,0,1898941
icdC_predicted,0.3333333333333333,2,2,ATCAAGGACTGGGATGAACA,0,1893331
icdC_predicted,0.3333333333333333,2,2,ATCAAAGGGTGATTGAGGCC,0,1908952
icdC_predicted,0.3333333333333333,2,2,ATATCTCCCCAGATCTAAGG,0,1890904
icdC_predicted,0.3333333333333333,2,2,ATATCCGGCGTGCCTTGATT,0,1887008
icdC_predicted,0.3333333333333333,2,2,ATATCCCCCATCGGGGGAAG,0,1901317
icdC_predicted,0.3333333333333333,2,2,ATAGTCCCGGATTGGCCCAT,0,1898431
icdC_predicted,0.3333333333333333,2,2,ATAGGCGTACCTCAATATCC,0,1902158
icdC_predicted,0.3333333333333333,2,2,ATAGCTGGGTCCAGATTTTT,0,1885270
icdC_predicted,0.3333333333333333,2,2,ATAGACTGACAAATACTCGT,0,1884388
icdC_predicted,0.3333333333333333,2,2,ATACGCGAACGCGGCCGCTT,0,1879940
icdC_predicted,0.3333333333333333,2,2,ATACACCAACGTCTTACTGG,0,1884342
icdC_predicted,0.3333333333333333,2,2,ATAAGGGATGAGGACCAGCC,0,1897356
icdC_predicted,0.3333333333333333,2,2,ATAACGGCTGTAAAGGGCTA,0,1889291
icdC_predicted,0.3333333333333333,2,2,ATAAATGGGGCGCGAAAGGA,0,1902632
icdC_predicted,0.3333333333333333,2,2,AGTTTGGATAGTATCACTAA,0,1905550
icdC_predicted,0.3333333333333333,2,2,AGTTTCGTAGTCACTCACCT,0,1892225
icdC_predicted,0.3333333333333333,2,2,AGTTGGTCTAATCGTATTTA,0,1887240
icdC_predicted,0.3333333333333333,2,2,AGTTCTGCGTCAAAGTCGAG,0,1881265
icdC_predicted,0.3333333333333333,2,2,AGTTCTCGGACTTGCCGGGC,0,1878602
icdC_predicted,0.3333333333333333,2,2,AGTTCATCGCGAAAGCCCGA,0,1906448
icdC_predicted,0.3333333333333333,2,2,AGTGTGCGTCGATAGTGCTT,0,1893003
icdC_predicted,0.3333333333333333,2,2,AGTGGTTTGGCATATAGGGC,0,1897152
icdC_predicted,0.3333333333333333,2,2,AGTGGCATCCTCATGGCCGA,0,1878885
icdC_predicted,0.3333333333333333,2,2,AGTGGATCCAGCGAATCCTA,0,1880008
icdC_predicted,0.3333333333333333,2,2,AGTGCGCTATCATAGGCCCG,0,1903943
icdC_predicted,0.3333333333333333,2,2,AGTGAAACACTGGAAGTGTG,0,1891400
icdC_predicted,0.3333333333333333,2,2,AGTCTTATCACGCATGCCAT,0,1890037
icdC_predicted,0.3333333333333333,2,2,AGTCTGTGCTAGCCCGTACT,0,1883449
icdC_predicted,0.3333333333333333,2,2,AGTCCATTTAGAAGTCGTTT,0,1909356
icdC_predicted,0.3333333333333333,2,2,AGTCACCTCTCCGTCGCTCC,0,1883953
icdC_predicted,0.3333333333333333,2,2,AGTAGGAAGGGACGGGCATG,0,1893917
icdC_predicted,0.3333333333333333,2,2,AGTACCTGTATATACAGCCT,0,1881527
icdC_predicted,0.3333333333333333,2,2,AGGTTCTCTAGATTATAAGA,0,1889022
icdC_predicted,0.3333333333333333,2,2,AGGTGTTGGAAACCGTGATC,0,1881062
icdC_predicted,0.3333333333333333,2,2,AGGTCTTTAAATACGAGGTT,0,1882186
icdC_predicted,0.3333333333333333,2,2,AGGTCTAAAATTTACCTCGA,0,1898422
icdC_predicted,0.3333333333333333,2,2,AGGTCAGTGGAATAGGGTGA,0,1879425
icdC_predicted,0.3333333333333333,2,2,AGGTCAGCTCGGAATCGTTT,0,1891467
icdC_predicted,0.3333333333333333,2,2,AGGTCAAGGTTGCGGTATTA,0,1895437
icdC_predicted,0.3333333333333333,2,2,AGGGTAAGTCTACGTGACGC,0,1900294
icdC_predicted,0.3333333333333333,2,2,AGGGCTCCCAAAATGCGTGC,0,1889672
icdC_predicted,0.3333333333333333,2,2,AGGGATTGTGTTCCTCCTCG,0,1894683
icdC_predicted,0.3333333333333333,2,2,AGGGACTTATCGCGTATCGT,0,1891892
icdC_predicted,0.3333333333333333,2,2,AGGCTGTACGAGCGGGTCCG,0,1896652
icdC_predicted,0.3333333333333333,2,2,AGGCGGTGCAGCACTCTATA,0,1895358
icdC_predicted,0.3333333333333333,2,2,AGGCAAAAACAACAAAAAGT,0,1888066
icdC_predicted,0.3333333333333333,2,2,AGGATTACTCTGTATTCATC,0,1907726
icdC_predicted,0.3333333333333333,2,2,AGGACGGCTGAAGCAAACAC,0,1881394
icdC_predicted,0.3333333333333333,2,2,AGCTTGACCACGGGATTTCC,0,1895305
icdC_predicted,0.3333333333333333,2,2,AGCTGACAGTCCGGAATGGT,0,1900923
icdC_predicted,0.3333333333333333,2,2,AGCTCCAACTGGACATTTCA,0,1900128
icdC_predicted,0.3333333333333333,2,2,AGCGTATTTAGCATGGTATG,0,1894241
icdC_predicted,0.3333333333333333,2,2,AGCGTAGTTGCGGTCGTGGT,0,1880756
icdC_predicted,0.3333333333333333,2,2,AGCGGGTATAACTTTATGCC,0,1888038
icdC_predicted,0.3333333333333333,2,2,AGCCGGGATTACGACGCCTA,0,1899701
icdC_predicted,0.3333333333333333,2,2,AGCCCGGGCGAAGGAAAGAC,0,1904810
icdC_predicted,0.3333333333333333,2,2,AGCATAGGACTCTTTGTTAT,0,1885648
icdC_predicted,0.3333333333333333,2,2,AGATGTGGCTCCACAGTCGC,0,1894930
icdC_predicted,0.3333333333333333,2,2,AGATGTACATGAACTCTATG,0,1887085
icdC_predicted,0.3333333333333333,2,2,AGATGGGCTAGATCCTGCTG,0,1899703
icdC_predicted,0.3333333333333333,2,2,AGATCTTATGTAACAGAATA,0,1902956
icdC_predicted,0.3333333333333333,2,2,AGATCGAGGGCATGAAGCCA,0,1895006
icdC_predicted,0.3333333333333333,2,2,AGATCGACACGGTACTTACA,0,1884690
icdC_predicted,0.3333333333333333,2,2,AGATCCCCTGTAGCATCGCT,0,1877906
icdC_predicted,0.3333333333333333,2,2,AGATATTTACAGCTCGAATT,0,1904065
icdC_predicted,0.3333333333333333,2,2,AGATATCGAGTGTAAAAAGC,0,1902138
icdC_predicted,0.3333333333333333,2,2,AGACTGGCTAGAACATGGAG,0,1885163
icdC_predicted,0.3333333333333333,2,2,AGACGATGCCGGATTCGTAT,0,1884868
icdC_predicted,0.3333333333333333,2,2,AGACCAAAAACCGAACTCGG,0,1897323
icdC_predicted,0.3333333333333333,2,2,AGACAATGCATATCGTCAGA,0,1892213
icdC_predicted,0.3333333333333333,2,2,AGAATTCTTCAAAATTGGTG,0,1899070
icdC_predicted,0.3333333333333333,2,2,AGAATCTGCATACAATTTTT,0,1899475
icdC_predicted,0.3333333333333333,2,2,ACTTGGTGATCAATCGAAGA,0,1890292
icdC_predicted,0.3333333333333333,2,2,ACTTAAATCATTCAAAATCG,0,1896873
icdC_predicted,0.3333333333333333,2,2,ACTGTGCAGAGGCCTCTAGG,0,1902676
icdC_predicted,0.3333333333333333,2,2,ACTGCGTAAACAGGGCGTAG,0,1907977
icdC_predicted,0.3333333333333333,2,2,ACTGAATGCGCACGGGGGTC,0,1881260
icdC_predicted,0.3333333333333333,2,2,ACTGAACCCGACACGTGGCG,0,1880884
icdC_predicted,0.3333333333333333,2,2,ACTGAACCCCGGTTTATCAT,0,1898579
icdC_predicted,0.3333333333333333,2,2,ACTCTAGCATGGTATTCGAT,0,1903162
icdC_predicted,0.3333333333333333,2,2,ACTCGTCAGTGTTTTACAGC,0,1883863
icdC_predicted,0.3333333333333333,2,2,ACTCACACGGTAGCCCGTGA,0,1880654
icdC_predicted,0.3333333333333333,2,2,ACTACTGATTGAAAGAGCGA,0,1890545
icdC_predicted,0.3333333333333333,2,2,ACTACGTTGTACAGCCACTA,0,1892966
icdC_predicted,0.3333333333333333,2,2,ACGTTTTATCCTGTCCATCC,0,1884902
icdC_predicted,0.3333333333333333,2,2,ACGTTGGGCAGAGTTTCGTT,0,1898734
icdC_predicted,0.3333333333333333,2,2,ACGTTGAAGCCGTACCATGC,0,1899773
icdC_predicted,0.3333333333333333,2,2,ACGTTCACGGTTGTAACATA,0,1885885
icdC_predicted,0.3333333333333333,2,2,ACGTCGGCGGGTAAGAAGTT,0,1902938
icdC_predicted,0.3333333333333333,2,2,ACGTCGGCGGCTACAGGCCA,0,1904464
icdC_predicted,0.3333333333333333,2,2,ACGTAGTTAAGTACAGTCTA,0,1899144
icdC_predicted,0.3333333333333333,2,2,ACGGTACCGTTTTCATCTAC,0,1892522
icdC_predicted,0.3333333333333333,2,2,ACGGCGTTAACGGCCGCTGC,0,1903779
icdC_predicted,0.3333333333333333,2,2,ACGGATTGCCTAAAGTCTCA,0,1891406
icdC_predicted,0.3333333333333333,2,2,ACGCGCTGGTCATTACGAAC,0,1894254
icdC_predicted,0.3333333333333333,2,2,ACGATGCGCCGTCCCCTAGT,0,1886074
icdC_predicted,0.3333333333333333,2,2,ACGATGCACATGGGGTATTA,0,1884854
icdC_predicted,0.3333333333333333,2,2,ACGATAGGGGGTGGTCTTAT,0,1889876
icdC_predicted,0.3333333333333333,2,2,ACGAGCGGATCTGTTCTATA,0,1885239
icdC_predicted,0.3333333333333333,2,2,ACCTTCCAGCCCTGCCTCTT,0,1901837
icdC_predicted,0.3333333333333333,2,2,ACCTTACAGCATTCGTGTAT,0,1899072
icdC_predicted,0.3333333333333333,2,2,ACCTGCGCAAGGGTACGAGC,0,1895814
icdC_predicted,0.3333333333333333,2,2,ACCGTGGGCAGCACGCTAAG,0,1906241
icdC_predicted,0.3333333333333333,2,2,ACCGTACGGGGTATATGCGA,0,1893750
icdC_predicted,0.3333333333333333,2,2,ACCGGTTGAAACCAAACGTA,0,1905087
icdC_predicted,0.3333333333333333,2,2,ACCGCTTGTACGTCTAGTTC,0,1878120
icdC_predicted,0.3333333333333333,2,2,ACCGCCCTAAAGCACGCTAA,0,1889917
icdC_predicted,0.3333333333333333,2,2,ACCGAGCCGGGCAGGTCTGG,0,1906036
icdC_predicted,0.3333333333333333,2,2,ACCCCGTTCGGCGTAAGGTA,0,1909009
icdC_predicted,0.3333333333333333,2,2,ACCCCGCCACGCGTGATTCT,0,1889673
icdC_predicted,0.3333333333333333,2,2,ACCATTAAACCGGGCACGGA,0,1891313
icdC_predicted,0.3333333333333333,2,2,ACCATAATACTTGGAGCATC,0,1901291
icdC_predicted,0.3333333333333333,2,2,ACCACTCTTTGGGTCGTCTC,0,1905341
icdC_predicted,0.3333333333333333,2,2,ACATTGGACAGGTCTTCCTC,0,1902112
icdC_predicted,0.3333333333333333,2,2,ACATTCAAATCTGGCGAATG,0,1883727
icdC_predicted,0.3333333333333333,2,2,ACATCAGAGATTTTGTTAGT,0,1881508
icdC_predicted,0.3333333333333333,2,2,ACATAACTAAAGAATGTGAC,0,1904128
icdC_predicted,0.3333333333333333,2,2,ACAGGTGGTAATTGTCATGT,0,1884000
icdC_predicted,0.3333333333333333,2,2,ACAGCCGGCATAGATTGGTA,0,1891349
icdC_predicted,0.3333333333333333,2,2,ACAGCACGGTCTAGACACTC,0,1893864
icdC_predicted,0.3333333333333333,2,2,ACACGAAGATGACTTCAGGG,0,1886762
icdC_predicted,0.3333333333333333,2,2,ACACCGTCCCCTTCCCAGGG,0,1906311
icdC_predicted,0.3333333333333333,2,2,ACACACAGTAGGTGCGAGCG,0,1879860
icdC_predicted,0.3333333333333333,2,2,ACAATGCTCCCCCTTGTTGT,0,1888839
icdC_predicted,0.3333333333333333,2,2,ACAATATTCCCGAATGGTTG,0,1891872
icdC_predicted,0.3333333333333333,2,2,ACAAGTACACCCTCGCTCAG,0,1888702
icdC_predicted,0.3333333333333333,2,2,ACAAAAAACGTTCGGCGCGT,0,1879064
icdC_predicted,0.3333333333333333,2,2,AATTTTTTTATCTCGATCGG,0,1893930
icdC_predicted,0.3333333333333333,2,2,AATTGTAAACCGCCTACAGT,0,1888560
icdC_predicted,0.3333333333333333,2,2,AATTCTGATTGTTCCATTTC,0,1892206
icdC_predicted,0.3333333333333333,2,2,AATGTGTGCTTGGCACGCCT,0,1884916
icdC_predicted,0.3333333333333333,2,2,AATGGCGGCATATCCCACAG,0,1906585
icdC_predicted,0.3333333333333333,2,2,AATGCTTAAGATCAGTATAT,0,1904094
icdC_predicted,0.3333333333333333,2,2,AATCTCTAATAGGATAAAGC,0,1893910
icdC_predicted,0.3333333333333333,2,2,AATCAGGGTCGCTCCAGGTA,0,1891177
icdC_predicted,0.3333333333333333,2,2,AATATGTCCTTCGCGAGTAC,0,1895383
icdC_predicted,0.3333333333333333,2,2,AATATAAGTACCGACCAAGG,0,1907018
icdC_predicted,0.3333333333333333,2,2,AATACACCGTTAGAGCTCAC,0,1892830
icdC_predicted,0.3333333333333333,2,2,AAGGGAGCACGGGACCCGGA,0,1893717
icdC_predicted,0.3333333333333333,2,2,AAGGATACACGTGACGTTTC,0,1891295
icdC_predicted,0.3333333333333333,2,2,AAGGAGATTTGGTGTAACGC,0,1894423
icdC_predicted,0.3333333333333333,2,2,AAGCTCCCATGAACGTCGCC,0,1905132
icdC_predicted,0.3333333333333333,2,2,AAGCTAAATCAATCGGTACA,0,1882797
icdC_predicted,0.3333333333333333,2,2,AAGCGTTTGTCGCAGGAGAA,0,1882630
icdC_predicted,0.3333333333333333,2,2,AAGCGAATTTATACACTGGC,0,1906584
icdC_predicted,0.3333333333333333,2,2,AAGCCCCGACATGTCTGTTT,0,1893279
icdC_predicted,0.3333333333333333,2,2,AAGCATACGCCCTTGGGGGA,0,1906221
icdC_predicted,0.3333333333333333,2,2,AAGCAGGGGACTCCCCCTCT,0,1903494
icdC_predicted,0.3333333333333333,2,2,AACTGCGGCGTGTTACACAT,0,1899159
icdC_predicted,0.3333333333333333,2,2,AACTATGTTGGTTTGAACGA,0,1904059
icdC_predicted,0.3333333333333333,2,2,AACTAAGGCGTCCTTCCGTA,0,1890909
icdC_predicted,0.3333333333333333,2,2,AACGGCCAGGATAACGGGTA,0,1891237
icdC_predicted,0.3333333333333333,2,2,AACGCATACCTGACAGTATG,0,1885828
icdC_predicted,0.3333333333333333,2,2,AACCTAGACCCCACACGAGA,0,1898096
icdC_predicted,0.3333333333333333,2,2,AACCGGCTTACCCTGTTCCT,0,1878712
icdC_predicted,0.3333333333333333,2,2,AACCCCGCCTTTTTGAGCAG,0,1887632
icdC_predicted,0.3333333333333333,2,2,AACCAGGGAGCAGGTATATG,0,1899639
icdC_predicted,0.3333333333333333,2,2,AACATTTTGACGGAAATTGT,0,1902151
icdC_predicted,0.3333333333333333,2,2,AACATCAAATTCTTGCATAT,0,1895299
icdC_predicted,0.3333333333333333,2,2,AACACTTATACAGCGCGAAT,0,1878864
icdC_predicted,0.3333333333333333,2,2,AAATGTACAGTTTTCGACTT,0,1904317
icdC_predicted,0.3333333333333333,2,2,AAATGCTCTACATGATCTGA,0,1903073
icdC_predicted,0.3333333333333333,2,2,AAATATCTTTACCAGTAATA,0,1904294
icdC_predicted,0.3333333333333333,2,2,AAAGTTCAAGCGACGTTTCT,0,1901145
icdC_predicted,0.3333333333333333,2,2,AAAGCTCTTGCTCCGCGGGG,0,1905326
icdC_predicted,0.3333333333333333,2,2,AAAGCACACGCGGACTTAGA,0,1901569
icdC_predicted,0.3333333333333333,2,2,AAAGAAAAAAACGCCGGCCT,0,1879394
icdC_predicted,0.3333333333333333,2,2,AAACGAGCAGATACGCCGAG,0,1880216
icdC_predicted,0.3333333333333333,2,2,AAACCGGCATCACTTTTATT,0,1889395
icdC_predicted,0.3333333333333333,2,2,AAACCCACCCGAGCCCTAAA,0,1884561
icdC_predicted,0.3333333333333333,2,2,AAACAATTGAGCGTATGTTA,0,1883915
icdC_predicted,0.5,1,1,TTTTTGTTCTGTATCTTGTA,0,1909410
icdC_predicted,0.5,1,1,TTTTGAGTGCGTGTCTACGA,0,1879291
icdC_predicted,0.5,1,1,TTTTCCGTGACTCCTTCTTT,0,1908717
icdC_predicted,0.5,1,1,TTTGTTCTCAGTCGTGGGTC,0,1900228
icdC_predicted,0.5,1,1,TTTGTCGTTCCGGCTGCAGC,0,1885567
icdC_predicted,0.5,1,1,TTTGCGGCGGTCCGTCGGTC,0,1904823
icdC_predicted,0.5,1,1,TTTGACCCGTGCGCCCAATT,0,1903970
icdC_predicted,0.5,1,1,TTTCTAGGACGAATGCCACT,0,1886361
icdC_predicted,0.5,1,1,TTTCGACATGTCGTGTATAC,0,1890648
icdC_predicted,0.5,1,1,TTTCCAAACACATGGCACGA,0,1899246
icdC_predicted,0.5,1,1,TTTCAGTGGCCGTCAGGGTT,0,1898271
icdC_predicted,0.5,1,1,TTTATCAAGGCATCAGATTA,0,1886557
icdC_predicted,0.5,1,1,TTTAGCCCCCCTAGCTTACA,0,1886714
icdC_predicted,0.5,1,1,TTTACGAGATTCTGGAATTG,0,1887183
icdC_predicted,0.5,1,1,TTTAAATCTCACGTGAACCA,0,1903369
icdC_predicted,0.5,1,1,TTGTCCGGATTGGGACGAGA,0,1888435
icdC_predicted,0.5,1,1,TTGTATCGCGCATCTCCAAC,0,1879239
icdC_predicted,0.5,1,1,TTGGGGTTCCATTGCGCCGA,0,1904962
icdC_predicted,0.5,1,1,TTGGGCACGACTGCTAGTTC,0,1904620
icdC_predicted,0.5,1,1,TTGGCAGGAGACAATAGGCA,0,1898313
icdC_predicted,0.5,1,1,TTGCCCCTTGAACAATATGA,0,1877976
icdC_predicted,0.5,1,1,TTGCAAGGTCTAAGGGGGAA,0,1889909
icdC_predicted,0.5,1,1,TTGAGCACATCTCCGCCTCG,0,1898450
icdC_predicted,0.5,1,1,TTGACTTCTTCGATTCGGTG,0,1893970
icdC_predicted,0.5,1,1,TTGACAGAAAAACAAATAAC,0,1903800
icdC_predicted,0.5,1,1,TTGAATCATGGGCCATGTTA,0,1879603
icdC_predicted,0.5,1,1,TTGAAGCACGCGGGGAAGTC,0,1906724
icdC_predicted,0.5,1,1,TTGAACGATAAGACCGATCT,0,1900472
icdC_predicted,0.5,1,1,TTGAAACAACGATCTCCGAT,0,1908463
icdC_predicted,0.5,1,1,TTCTTACCACAGAGCCACGG,0,1908718
icdC_predicted,0.5,1,1,TTCTGTCGGAGCGCTTGTAG,0,1897631
icdC_predicted,0.5,1,1,TTCGTCCGGCCTCATCGGAA,0,1889116
icdC_predicted,0.5,1,1,TTCGGCGCTTATCCTGTGTG,0,1899620
icdC_predicted,0.5,1,1,TTCGGAATCAGAGGTAAATG,0,1895356
icdC_predicted,0.5,1,1,TTCGACTGTTCCCAGGCAGG,0,1901655
icdC_predicted,0.5,1,1,TTCCGGCGACAGTAAAGAAG,0,1909039
icdC_predicted,0.5,1,1,TTCCATGCGCCGTCTCCACC,0,1883782
icdC_predicted,0.5,1,1,TTCAGGATCTAACCAATCGC,0,1904501
icdC_predicted,0.5,1,1,TTCACGGCGAAGTGGCCAGC,0,1901933
icdC_predicted,0.5,1,1,TTCAACCCGTAATTTTTTAC,0,1885388
icdC_predicted,0.5,1,1,TTATTTGAAGGGTTATCGTG,0,1888933
icdC_predicted,0.5,1,1,TTATGGTGCGGCCAGTTGGG,0,1902425
icdC_predicted,0.5,1,1,TTATGCTCCGCTGTCTGTAG,0,1905235
icdC_predicted,0.5,1,1,TTATGAGATAGACAGCGGAC,0,1908022
icdC_predicted,0.5,1,1,TTAGCGGGCAGGTCCCTTTG,0,1905036
icdC_predicted,0.5,1,1,TTAGAAGTAGGGACAAAGTC,0,1896681
icdC_predicted,0.5,1,1,TTACTACGTCCCACCAACTG,0,1884919
icdC_predicted,0.5,1,1,TTAATCAGTTGACAGCTATT,0,1878684
icdC_predicted,0.5,1,1,TTAAGATACGTCTTTTTCAG,0,1898099
icdC_predicted,0.5,1,1,TTAAAGGTTGTTAATGTTAC,0,1901547
icdC_predicted,0.5,1,1,TTAAAGCCCAACACCAAAGG,0,1899963
icdC_predicted,0.5,1,1,TTAAACCTACATCCGGCAGG,0,1900413
icdC_predicted,0.5,1,1,TGTTTTGAGATTACTGCCTA,0,1908173
icdC_predicted,0.5,1,1,TGTTGACGGGTCCGATGGCG,0,1890494
icdC_predicted,0.5,1,1,TGTTCACTGTTGTCATTGTG,0,1882941
icdC_predicted,0.5,1,1,TGTTACATAACGCGGGGCCG,0,1897465
icdC_predicted,0.5,1,1,TGTTACAAAACTGCCTAAAG,0,1885703
icdC_predicted,0.5,1,1,TGTGTGGCTGCGATACTGGT,0,1896642
icdC_predicted,0.5,1,1,TGTGTACAAACTTGTGAGCC,0,1894752
icdC_predicted,0.5,1,1,TGTGGGGTTATAGAATCGGA,0,1906280
icdC_predicted,0.5,1,1,TGTGACTGCGTCCCCCTAAT,0,1894407
icdC_predicted,0.5,1,1,TGTGACAAGCGTAAAATCTC,0,1904304
icdC_predicted,0.5,1,1,TGTGAATGGGTGTAACTCAG,0,1889283
icdC_predicted,0.5,1,1,TGTCTTGCTCATTACATCCT,0,1883379
icdC_predicted,0.5,1,1,TGTCGTGCTACAGTCCGCGT,0,1906887
icdC_predicted,0.5,1,1,TGTCGATTCGCCTAACTGCT,0,1905960
icdC_predicted,0.5,1,1,TGTCCGAGCAACATCAGGCA,0,1887640
icdC_predicted,0.5,1,1,TGTCCCGGGGTCTAATACAA,0,1883123
icdC_predicted,0.5,1,1,TGTCCAATTTGACGGGCCTC,0,1902936
icdC_predicted,0.5,1,1,TGTCAGTGTATTATGGGGGT,0,1878764
icdC_predicted,0.5,1,1,TGTCAGTCCCTGTGAGTGAT,0,1906914
icdC_predicted,0.5,1,1,TGTACGTCCGGCAATACGAT,0,1884265
icdC_predicted,0.5,1,1,TGTAAAATACAAAAGTCGCT,0,1908342
icdC_predicted,0.5,1,1,TGGTTTTTTTTTGGCAGCCA,0,1885540
icdC_predicted,0.5,1,1,TGGTTTGTCAGCGAGGCACT,0,1901048
icdC_predicted,0.5,1,1,TGGTTCTCCAACGCGCAACT,0,1887390
icdC_predicted,0.5,1,1,TGGTGGTTACAGGCAGTTTT,0,1891550
icdC_predicted,0.5,1,1,TGGTCTTAGCGATTATGCGA,0,1880345
icdC_predicted,0.5,1,1,TGGTCGCGCCCCGTGACATC,0,1886096
icdC_predicted,0.5,1,1,TGGTATGAGATCCGTTAAGG,0,1898162
icdC_predicted,0.5,1,1,TGGTAGATGCGACAGTCAAC,0,1905211
icdC_predicted,0.5,1,1,TGGTACGCAACATGGGCTCG,0,1904078
icdC_predicted,0.5,1,1,TGGGGCCACATGGGACGTGT,0,1903804
icdC_predicted,0.5,1,1,TGGCGGACTACTCGTGTGTG,0,1905450
icdC_predicted,0.5,1,1,TGGCAGGCCTCACGGGACTT,0,1909104
icdC_predicted,0.5,1,1,TGGCAGAACACGCCCCAGGA,0,1886387
icdC_predicted,0.5,1,1,TGGCACAAGAGATTGGCTAT,0,1889001
icdC_predicted,0.5,1,1,TGGATCACGTCGCTCCTTTT,0,1878992
icdC_predicted,0.5,1,1,TGGATATCTCTCGGCCCCTT,0,1884938
icdC_predicted,0.5,1,1,TGGACATAGCCCTTCGAGAG,0,1901229
icdC_predicted,0.5,1,1,TGGAATTCATTAAATAGGGA,0,1903083
icdC_predicted,0.5,1,1,TGCTTTACGTGCCCACTGAT,0,1892378
icdC_predicted,0.5,1,1,TGCTGTCGCCGCACATTTTA,0,1889015
icdC_predicted,0.5,1,1,TGCTCCATTCGCTAAAGCGC,0,1886351
icdC_predicted,0.5,1,1,TGCGTTACAACACGGGACCA,0,1896405
icdC_predicted,0.5,1,1,TGCGTCGTATACTAGACCCC,0,1896927
icdC_predicted,0.5,1,1,TGCGTAGGGAAGGTTCGTAT,0,1900723
icdC_predicted,0.5,1,1,TGCGCTAGGCTAAGCGGCTG,0,1901097
icdC_predicted,0.5,1,1,TGCCGAGCCTGGGACCTCTT,0,1898882
icdC_predicted,0.5,1,1,TGCCCGCTATTCGACAGTGC,0,1878097
icdC_predicted,0.5,1,1,TGCCATCGCGTTGGCATACA,0,1890827
icdC_predicted,0.5,1,1,TGCAGAAAGCGCTTTCACGC,0,1878390
icdC_predicted,0.5,1,1,TGCACAACTTGAGCCCGTTC,0,1906170
icdC_predicted,0.5,1,1,TGCAACGAGACAACGCATAA,0,1882657
icdC_predicted,0.5,1,1,TGATGGGATTGCCAGATCCA,0,1901375
icdC_predicted,0.5,1,1,TGATAGCCCCATGGACGGCC,0,1880916
icdC_predicted,0.5,1,1,TGACGTCGCTCTTATTATGT,0,1905789
icdC_predicted,0.5,1,1,TGAAATGCTAGCGGTGTCGT,0,1902702
icdC_predicted,0.5,1,1,TGAAAATGGCCAGTGCACTC,0,1895494
icdC_predicted,0.5,1,1,TCTTTTGTGTGGCCGAAGTT,0,1879996
icdC_predicted,0.5,1,1,TCTTAGGGGCTCGCTAAGGT,0,1892061
icdC_predicted,0.5,1,1,TCTTAATCGATGGAACATAT,0,1891566
icdC_predicted,0.5,1,1,TCTGTTTCCCGTACTGTTGA,0,1904232
icdC_predicted,0.5,1,1,TCTCGATATCCCACTCCGCA,0,1878511
icdC_predicted,0.5,1,1,TCTCGAGGGCGAAGACCAGT,0,1882286
icdC_predicted,0.5,1,1,TCTAGACAAGTACGTCTTTT,0,1899491
icdC_predicted,0.5,1,1,TCTAAGAGGCTCAGTACGTT,0,1892143
icdC_predicted,0.5,1,1,TCGTTATATTTAGGGTAGAA,0,1884182
icdC_predicted,0.5,1,1,TCGTCAGCGTACACATGAAG,0,1887212
icdC_predicted,0.5,1,1,TCGGCTGGAAAGATCGGTAC,0,1903681
icdC_predicted,0.5,1,1,TCGGCCACAAGCGTTGTTAC,0,1899850
icdC_predicted,0.5,1,1,TCGGCACGGCTCCACGATAG,0,1883608
icdC_predicted,0.5,1,1,TCGGACTGTCCTTAATGGGG,0,1893473
icdC_predicted,0.5,1,1,TCGCCTCTGCAAAGGGGTAC,0,1880453
icdC_predicted,0.5,1,1,TCGATTACCTGGATATAAAG,0,1901893
icdC_predicted,0.5,1,1,TCGAGACACCACGAAGCGTT,0,1881654
icdC_predicted,0.5,1,1,TCGACTGATGAGAACGAAAA,0,1882435
icdC_predicted,0.5,1,1,TCGACCCGGTACGACTGCCA,0,1881122
icdC_predicted,0.5,1,1,TCCTCGCCGAACCAACGGAA,0,1898075
icdC_predicted,0.5,1,1,TCCTAACTTCGCTATCGGGA,0,1902714
icdC_predicted,0.5,1,1,TCCGTTGTTTAATCCTCGTA,0,1887672
icdC_predicted,0.5,1,1,TCCGTTCACGGAAAAAGCCC,0,1898753
icdC_predicted,0.5,1,1,TCCGTCTGGTAGCGCATGAT,0,1880669
icdC_predicted,0.5,1,1,TCCGTCTCAAGGATTGCAAT,0,1882991
icdC_predicted,0.5,1,1,TCCGGGGTAATCGTTGGTCA,0,1881825
icdC_predicted,0.5,1,1,TCCGATGGTCACGAGCTAAT,0,1902446
icdC_predicted,0.5,1,1,TCCGATATATCGTCACAGAA,0,1907819
icdC_predicted,0.5,1,1,TCCGAAAAACACGCGCAAGA,0,1891520
icdC_predicted,0.5,1,1,TCCCGGAGTTAAATCGTTCA,0,1894739
icdC_predicted,0.5,1,1,TCCCGCGGCCTAAATGGAGA,0,1895479
icdC_predicted,0.5,1,1,TCCCCTCGCTAAGTGGAGAG,0,1893082
icdC_predicted,0.5,1,1,TCCCATCCAGTAACACGGTA,0,1894851
icdC_predicted,0.5,1,1,TCCAACAAACCAACGGAAAT,0,1902641
icdC_predicted,0.5,1,1,TCATTGCACGTGGTTCAATC,0,1891465
icdC_predicted,0.5,1,1,TCATGGCCAATGTTAAGGGA,0,1885447
icdC_predicted,0.5,1,1,TCAGGGATATAGCATCCTTG,0,1903455
icdC_predicted,0.5,1,1,TCAGGCGTATCGCTGCTCTC,0,1900408
icdC_predicted,0.5,1,1,TCAGCGCACTAGGTTCCGGC,0,1885033
icdC_predicted,0.5,1,1,TCACGTTAAACTTGTACGCC,0,1903857
icdC_predicted,0.5,1,1,TCACGCAGTATCCCGATCGC,0,1905360
icdC_predicted,0.5,1,1,TCACCTTTATGTAATGGACG,0,1887916
icdC_predicted,0.5,1,1,TCACCGCATGTCTCTGCATA,0,1908282
icdC_predicted,0.5,1,1,TCACATTTGAAAGCATCGGC,0,1879479
icdC_predicted,0.5,1,1,TCACAGCAAGCACGAAAGGG,0,1891526
icdC_predicted,0.5,1,1,TCACACGCGGGCTCTTGGTC,0,1904032
icdC_predicted,0.5,1,1,TCAATAAACGTACCCAGTAA,0,1892188
icdC_predicted,0.5,1,1,TCAAGTCTCATTAACCCAGT,0,1884300
icdC_predicted,0.5,1,1,TCAACCATTATGCTTAACGC,0,1905215
icdC_predicted,0.5,1,1,TCAAAAAGCCCTAGCGGGAT,0,1889981
icdC_predicted,0.5,1,1,TATTCTAGCATTACACAGTC,0,1887684
icdC_predicted,0.5,1,1,TATTCGGATTGTGATTCGAC,0,1901693
icdC_predicted,0.5,1,1,TATTACCGTTCCCCGATGGG,0,1889234
icdC_predicted,0.5,1,1,TATGTACAGCCAGCTTATCT,0,1891097
icdC_predicted,0.5,1,1,TATGACGAACATCGAAGAAC,0,1885011
icdC_predicted,0.5,1,1,TATCGGATAGCTAGGGTATG,0,1882369
icdC_predicted,0.5,1,1,TATCATAAGCCATTTCCGAA,0,1908026
icdC_predicted,0.5,1,1,TATATGGTTACTCAGGGACT,0,1881817
icdC_predicted,0.5,1,1,TATATCATGTCGGCGGGGTA,0,1898902
icdC_predicted,0.5,1,1,TATAGCACGCGAACCCCTCT,0,1885024
icdC_predicted,0.5,1,1,TATAGATTCCTGAGCGTGGG,0,1894436
icdC_predicted,0.5,1,1,TATACTTCGCTGTGGCAACC,0,1901911
icdC_predicted,0.5,1,1,TATACCAGCTGTGCGTATTG,0,1895934
icdC_predicted,0.5,1,1,TAGTGGCCTGAGCCGCGCCG,0,1890412
icdC_predicted,0.5,1,1,TAGGTGTGGTATTTTTGGAA,0,1907217
icdC_predicted,0.5,1,1,TAGGCCCGCGTGTCAGCCCC,0,1882006
icdC_predicted,0.5,1,1,TAGGCAATACACCATTAGAT,0,1895063
icdC_predicted,0.5,1,1,TAGGAACTTGCAAGCTAAAT,0,1906219
icdC_predicted,0.5,1,1,TAGCGGTTGACGCCCTCCTG,0,1883671
icdC_predicted,0.5,1,1,TAGCCTTAGGCCCTTTGTGC,0,1906126
icdC_predicted,0.5,1,1,TAGCCTACCTGAACGCCCGA,0,1903426
icdC_predicted,0.5,1,1,TAGCCACCGCTATGCATCCG,0,1882068
icdC_predicted,0.5,1,1,TAGCAATCAGTGTTGAACAT,0,1878135
icdC_predicted,0.5,1,1,TAGATTTAACGTAGGTCGAT,0,1888438
icdC_predicted,0.5,1,1,TAGAGCTCATCCGTGCCCAC,0,1878785
icdC_predicted,0.5,1,1,TAGACGGGGGGGCCACGTGG,0,1882568
icdC_predicted,0.5,1,1,TAGACCGTAAGCAGCAGATG,0,1877997
icdC_predicted,0.5,1,1,TAGACCATTTAAAGAAACTC,0,1880909
icdC_predicted,0.5,1,1,TAGAAATGGAGCGTTTAAAC,0,1885870
icdC_predicted,0.5,1,1,TACTTTCAGGCACGGCAGGA,0,1897091
icdC_predicted,0.5,1,1,TACTTGGATCTTTGCGTCCT,0,1905704
icdC_predicted,0.5,1,1,TACTTAGGTTTCATAAAGGA,0,1890212
icdC_predicted,0.5,1,1,TACTCCCTCGGAAGCCAAGA,0,1887294
icdC_predicted,0.5,1,1,TACGTTGCGTCAGCGGTCTT,0,1899277
icdC_predicted,0.5,1,1,TACGGCGTTGCAAACGCGCG,0,1892448
icdC_predicted,0.5,1,1,TACGGAGAAAGGTCAGCAAC,0,1887739
icdC_predicted,0.5,1,1,TACGCCTTGGGGGTATCTCG,0,1882429
icdC_predicted,0.5,1,1,TACGATTTAGGATCGCGATA,0,1900145
icdC_predicted,0.5,1,1,TACGAAGAAGGTCAAGCCAC,0,1907783
icdC_predicted,0.5,1,1,TACCTTGGGAGTTTAATTAA,0,1882761
icdC_predicted,0.5,1,1,TACCGGCATAGTATTACAAT,0,1903691
icdC_predicted,0.5,1,1,TACCGACGGGATTGCTAGAG,0,1887180
icdC_predicted,0.5,1,1,TACCCAACCTCATGGCGATC,0,1885364
icdC_predicted,0.5,1,1,TACATCAGCGCATACTGGGT,0,1881738
icdC_predicted,0.5,1,1,TACAGCTAGACTAAGCTTGA,0,1902392
icdC_predicted,0.5,1,1,TACAGACCGTTGCATTGGTG,0,1884299
icdC_predicted,0.5,1,1,TACAGAACTAGACTTTAGTA,0,1885478
icdC_predicted,0.5,1,1,TAATTTTCTATTAGAGCATC,0,1897094
icdC_predicted,0.5,1,1,TAATTTGCTTCATGCGGAAT,0,1896854
icdC_predicted,0.5,1,1,TAATGTGCTTACAGCGGTAC,0,1892066
icdC_predicted,0.5,1,1,TAATGTCCTCAACGTATCGA,0,1886189
icdC_predicted,0.5,1,1,TAATGTACTCGCCTACAGGG,0,1883911
icdC_predicted,0.5,1,1,TAATATGTAGTAGGTAGAAA,0,1903097
icdC_predicted,0.5,1,1,TAAGTCGTTTCCAAGTCGCC,0,1892076
icdC_predicted,0.5,1,1,TAAGGTAATTACTTTCAGTA,0,1906624
icdC_predicted,0.5,1,1,TAAGGGCTTGGCTTTTTCGG,0,1887635
icdC_predicted,0.5,1,1,TAACCTCCCTCATTTACCAG,0,1900437
icdC_predicted,0.5,1,1,TAACCGTCAAAGTAATTTGT,0,1879557
icdC_predicted,0.5,1,1,TAAATTACCATGTATAGTAA,0,1888980
icdC_predicted,0.5,1,1,TAAAGTTCCCTATGACGTCG,0,1896175
icdC_predicted,0.5,1,1,TAAAGCAGCGCGAGGATAGG,0,1907951
icdC_predicted,0.5,1,1,TAAAACTCTTTGCGCTTACT,0,1896727
icdC_predicted,0.5,1,1,GTTTTGTAGGAGCAGAGAGC,0,1881818
icdC_predicted,0.5,1,1,GTTTCCTTCGGGGTTAATAC,0,1881040
icdC_predicted,0.5,1,1,GTTTATGCCTAGGGTGCAAC,0,1895324
icdC_predicted,0.5,1,1,GTTTAACGCCTTGTAGGGTA,0,1905469
icdC_predicted,0.5,1,1,GTTGGCCCCTGGGAAATCGT,0,1907897
icdC_predicted,0.5,1,1,GTTGGATAGATCAGTGGGAC,0,1878196
icdC_predicted,0.5,1,1,GTTCTGCACTGGCCGCCCAC,0,1896369
icdC_predicted,0.5,1,1,GTTCGTGGGGCGTTGGTGTA,0,1891181
icdC_predicted,0.5,1,1,GTTCGCTTCCGCGCGTATGC,0,1889888
icdC_predicted,0.5,1,1,GTTCGCGTTGTTCCTGGGCG,0,1901442
icdC_predicted,0.5,1,1,GTTCCGTTTTCAAAAATCCA,0,1906650
icdC_predicted,0.5,1,1,GTTCCGAGTTTCGGAGCGGG,0,1903186
icdC_predicted,0.5,1,1,GTTCAATTTCAGACACCCTA,0,1905291
icdC_predicted,0.5,1,1,GTTCAAGAGCTTTACGTAAC,0,1881286
icdC_predicted,0.5,1,1,GTTAGTTAGGTTTCGGGGCG,0,1886891
icdC_predicted,0.5,1,1,GTTAGAGGTTAAAAGCGAAT,0,1893248
icdC_predicted,0.5,1,1,GTTAGACAGAGTACCCTTAT,0,1885126
icdC_predicted,0.5,1,1,GTTACGATGTACACGAACAA,0,1880423
icdC_predicted,0.5,1,1,GTTAAGGGATAATGGATGAA,0,1901549
icdC_predicted,0.5,1,1,GTGTGCGCAGCCGGTACATA,0,1903460
icdC_predicted,0.5,1,1,GTGTGAGAAAGTATATAAGC,0,1903565
icdC_predicted,0.5,1,1,GTGTAAGTGCCGGTGGTGCA,0,1879203
icdC_predicted,0.5,1,1,GTGTAAGCTTTGGCGCCTCG,0,1893879
icdC_predicted,0.5,1,1,GTGGCCCTGTGCGCCTTCAA,0,1889891
icdC_predicted,0.5,1,1,GTGGAATACCATTGTACTCA,0,1887487
icdC_predicted,0.5,1,1,GTGGAAGCGTAGCTCATGCG,0,1887662
icdC_predicted,0.5,1,1,GTGGAAACAGCTTTTGGGTA,0,1900410
icdC_predicted,0.5,1,1,GTGCTTCATAAAGCACGTTT,0,1878116
icdC_predicted,0.5,1,1,GTGCTAGGTGGACTACCAAA,0,1903358
icdC_predicted,0.5,1,1,GTGCTACGATATCATCTCAC,0,1878017
icdC_predicted,0.5,1,1,GTGCGGTATAGAACATTTAC,0,1900203
icdC_predicted,0.5,1,1,GTGCGACCTGCTTTCCCGCA,0,1909494
icdC_predicted,0.5,1,1,GTGCCTACGGATCCTATTAC,0,1906235
icdC_predicted,0.5,1,1,GTGCATCTAGTCAAGTCCCC,0,1878796
icdC_predicted,0.5,1,1,GTGCAGCGATTAGATAAGCC,0,1891727
icdC_predicted,0.5,1,1,GTGCACAGTCGCGTCTGGGA,0,1900207
icdC_predicted,0.5,1,1,GTGACCAAGAGACCCCTACA,0,1889213
icdC_predicted,0.5,1,1,GTGAATACCGGGAACAGCCA,0,1885359
icdC_predicted,0.5,1,1,GTCTGGGATCGCAACAGGAA,0,1882409
icdC_predicted,0.5,1,1,GTCTGCGCAGCCTGGTAAAC,0,1888085
icdC_predicted,0.5,1,1,GTCTCTCCACTAATGTTGAA,0,1905230
icdC_predicted,0.5,1,1,GTCTATACCATACAGTCCAT,0,1908505
icdC_predicted,0.5,1,1,GTCGGGATGTCCGAGTATTT,0,1888459
icdC_predicted,0.5,1,1,GTCGGCGTGACAAAGGGTAC,0,1886356
icdC_predicted,0.5,1,1,GTCGCGTATTTTTATTCGTG,0,1904520
icdC_predicted,0.5,1,1,GTCGCCGGTTCGTTTCTCTA,0,1897736
icdC_predicted,0.5,1,1,GTCCGATCCCAGGAAGCACG,0,1905934
icdC_predicted,0.5,1,1,GTCACATGAAGTTTAGTACC,0,1895949
icdC_predicted,0.5,1,1,GTATTCCGGAATTGAGAGAG,0,1885127
icdC_predicted,0.5,1,1,GTATGCCCTTAGGCACACGG,0,1903645
icdC_predicted,0.5,1,1,GTATCGTTTGACGTCCCGGG,0,1903666
icdC_predicted,0.5,1,1,GTATATTTTATCGCCACGCT,0,1903729
icdC_predicted,0.5,1,1,GTATAGTGGTTATAGTCGGG,0,1890340
icdC_predicted,0.5,1,1,GTATACCCACTCGGGAAGCA,0,1895325
icdC_predicted,0.5,1,1,GTAGTCAACGCTTCGTTCGT,0,1884694
icdC_predicted,0.5,1,1,GTAGGATTCGGGCTCCACTC,0,1885730
icdC_predicted,0.5,1,1,GTAGCGTTTCACTGATAGCA,0,1885743
icdC_predicted,0.5,1,1,GTAGAGCTCCCTGTTCCTTC,0,1894491
icdC_predicted,0.5,1,1,GTAGACAAACCAGCTTCCCA,0,1904016
icdC_predicted,0.5,1,1,GTACGTATCAAAAAGCAGGC,0,1888057
icdC_predicted,0.5,1,1,GTACGGCGGTCCACATTTTC,0,1902465
icdC_predicted,0.5,1,1,GTACCTGCTTATTGCCTCTA,0,1908570
icdC_predicted,0.5,1,1,GTACCATAGGTGCGCCACGG,0,1885081
icdC_predicted,0.5,1,1,GTAATGAGCCACGCCAATCC,0,1901321
icdC_predicted,0.5,1,1,GTAAGAGACAAATTCATTAG,0,1889227
icdC_predicted,0.5,1,1,GGTTTCCCCTATCTCATATC,0,1900470
icdC_predicted,0.5,1,1,GGTTCGAAGATAGTACACAG,0,1903449
icdC_predicted,0.5,1,1,GGTTCGAAAATAGCGTTGTC,0,1895768
icdC_predicted,0.5,1,1,GGTTCAATGTGCGGTTAATT,0,1894874
icdC_predicted,0.5,1,1,GGTGGAGGCTTTGGTAGGAA,0,1893915
icdC_predicted,0.5,1,1,GGTGAATAAGCAACGACTCA,0,1893469
icdC_predicted,0.5,1,1,GGTGAACACGGCTGGCCCGG,0,1893573
icdC_predicted,0.5,1,1,GGTCGAATCCAAAGACCACT,0,1904287
icdC_predicted,0.5,1,1,GGTCATAGTATGTCCAAGAA,0,1909244
icdC_predicted,0.5,1,1,GGTCATAAACTAAGACCAGT,0,1891179
icdC_predicted,0.5,1,1,GGTATCCCTTGCATACCAGG,0,1909158
icdC_predicted,0.5,1,1,GGTATATGTGCGGACTTTGT,0,1887526
icdC_predicted,0.5,1,1,GGTAAGTCGTAGATAGCCTT,0,1893363
icdC_predicted,0.5,1,1,GGGTGGCTATTCGCTGTCAT,0,1885928
icdC_predicted,0.5,1,1,GGGTGCCTCGAACCACCGGG,0,1887208
icdC_predicted,0.5,1,1,GGGTGAACAGAGTAGGTCCC,0,1884380
icdC_predicted,0.5,1,1,GGGGTGCAGCGGGCGATACA,0,1886720
icdC_predicted,0.5,1,1,GGGGTCATAGCGTAGTCCGG,0,1897699
icdC_predicted,0.5,1,1,GGGGCGTTTGCGCGAGTGAC,0,1908135
icdC_predicted,0.5,1,1,GGGGAGGATCGGGCGCTCGA,0,1886451
icdC_predicted,0.5,1,1,GGGCTCTAAATGACTGACAT,0,1885677
icdC_predicted,0.5,1,1,GGGCGCCGCGAAGAGGCCCA,0,1898537
icdC_predicted,0.5,1,1,GGGCCAATTTGTGAAAAAAC,0,1896533
icdC_predicted,0.5,1,1,GGGATAGGTACAAATTTAAC,0,1882546
icdC_predicted,0.5,1,1,GGGAGTTTGACTCGTCCACT,0,1907402
icdC_predicted,0.5,1,1,GGGAGTTGATGCTTAAAGCC,0,1902091
icdC_predicted,0.5,1,1,GGGAGAGGGTGTATTTCGAG,0,1882153
icdC_predicted,0.5,1,1,GGGACCCACCACGCCATACA,0,1907165
icdC_predicted,0.5,1,1,GGCTTATGTGGTCGGATTCG,0,1890032
icdC_predicted,0.5,1,1,GGCTGGTATGATGAGACGCA,0,1887689
icdC_predicted,0.5,1,1,GGCTGGCTTACTCAGAGTGA,0,1904227
icdC_predicted,0.5,1,1,GGCGTCTTACGAAGATGGTA,0,1884797
icdC_predicted,0.5,1,1,GGCGGAACATCCTGAGGGAC,0,1891286
icdC_predicted,0.5,1,1,GGCGCTTAGCCACTCTGGTG,0,1906594
icdC_predicted,0.5,1,1,GGCGCGTGAATCGAACCCGC,0,1890244
icdC_predicted,0.5,1,1,GGCGACTCGCTATCTCGGAA,0,1896420
icdC_predicted,0.5,1,1,GGCCGTCGTCCTGAATAGCT,0,1899409
icdC_predicted,0.5,1,1,GGCATTTTAAAGTCGTTATC,0,1880025
icdC_predicted,0.5,1,1,GGCATAGTACGTTAAGCCCC,0,1896538
icdC_predicted,0.5,1,1,GGCACATACCGTCTCGTCTT,0,1894769
icdC_predicted,0.5,1,1,GGCAATCGTCGCACCCGGTG,0,1900261
icdC_predicted,0.5,1,1,GGATTTTGGTCCTCCTCCTG,0,1890403
icdC_predicted,0.5,1,1,GGATTTTGCAGTGAATGACT,0,1884647
icdC_predicted,0.5,1,1,GGATTTTAGTTCATCGGTTA,0,1909464
icdC_predicted,0.5,1,1,GGATGGGCAGGAAAGGGCCT,0,1900863
icdC_predicted,0.5,1,1,GGAGCCGATGCCCCCACCAG,0,1896301
icdC_predicted,0.5,1,1,GGACCTCAGAGCCTCAGCGT,0,1904444
icdC_predicted,0.5,1,1,GGACCAGCACAGCGTCTAAG,0,1890125
icdC_predicted,0.5,1,1,GGACCAACGTGGCTACTTTG,0,1899115
icdC_predicted,0.5,1,1,GGAATGGCTCGTCCCTTTGG,0,1893282
icdC_predicted,0.5,1,1,GGAATGCCTATTTGTTTATC,0,1882106
icdC_predicted,0.5,1,1,GGAATGATTATGTTTAGTAA,0,1893667
icdC_predicted,0.5,1,1,GGAAGTAAGACTGCACTACT,0,1889737
icdC_predicted,0.5,1,1,GGAAGACGCATTTATGTATA,0,1885291
icdC_predicted,0.5,1,1,GGAAATCTTGGGCTACGATC,0,1884502
icdC_predicted,0.5,1,1,GGAAATCGTCCAGGTCTTGG,0,1905698
icdC_predicted,0.5,1,1,GGAAACGAACGCGCGGCTTA,0,1885210
icdC_predicted,0.5,1,1,GCTTGTGTTCATACCGAGCG,0,1902356
icdC_predicted,0.5,1,1,GCTTCCGTGCACTTCTGCTC,0,1898703
icdC_predicted,0.5,1,1,GCTTCCAGGCTAAGGACCGC,0,1879465
icdC_predicted,0.5,1,1,GCTGTCAGTGGGAAAGATCA,0,1891022
icdC_predicted,0.5,1,1,GCTGTACAACGGCTCATAAT,0,1906350
icdC_predicted,0.5,1,1,GCTGCGTAGGCTTCCCGGGG,0,1901512
icdC_predicted,0.5,1,1,GCTGCGAGACGAACATTGTA,0,1906012
icdC_predicted,0.5,1,1,GCTGCACACATGAACTCCGA,0,1907683
icdC_predicted,0.5,1,1,GCTGAGATGTTTGGCTAACG,0,1898329
icdC_predicted,0.5,1,1,GCTCAGAGTCATACTGGACA,0,1890812
icdC_predicted,0.5,1,1,GCTCACTGGGGCGCCCAAGC,0,1890570
icdC_predicted,0.5,1,1,GCTAGCTACGATACCTACCT,0,1899284
icdC_predicted,0.5,1,1,GCGTTCTGAGCAAACTGATA,0,1888035
icdC_predicted,0.5,1,1,GCGTCGTTGTTTAGAATTCT,0,1889064
icdC_predicted,0.5,1,1,GCGGTTTCGGGGGAAAGGAT,0,1901256
icdC_predicted,0.5,1,1,GCGGTCTAATCGCAAATTTT,0,1886825
icdC_predicted,0.5,1,1,GCGGCAATCTATATTTCTCT,0,1907729
icdC_predicted,0.5,1,1,GCGGAACATGATCACGATAT,0,1909133
icdC_predicted,0.5,1,1,GCGCCGTTCTTTAGACCCGT,0,1881762
icdC_predicted,0.5,1,1,GCGCCCAATTCTAGCACTGC,0,1881831
icdC_predicted,0.5,1,1,GCGCATTACCGAGTGTAATG,0,1907467
icdC_predicted,0.5,1,1,GCGCATGTCAGAATGGATGG,0,1880789
icdC_predicted,0.5,1,1,GCGCACGGATAAATGCCAGT,0,1884497
icdC_predicted,0.5,1,1,GCCTGGGATCCGACTTGATA,0,1903692
icdC_predicted,0.5,1,1,GCCTCTAGCCTAGCGAAGTA,0,1899513
icdC_predicted,0.5,1,1,GCCGTTTTTTCAATCGTCTA,0,1893323
icdC_predicted,0.5,1,1,GCCGTGCTACGCGATGGTCC,0,1883806
icdC_predicted,0.5,1,1,GCCGTGCAGTCACGTACATG,0,1894610
icdC_predicted,0.5,1,1,GCCGGAGAGGCGGTGCTCGT,0,1893410
icdC_predicted,0.5,1,1,GCCGAAGACTTTTGGTAACG,0,1900191
icdC_predicted,0.5,1,1,GCCCTTACATTGCGTATCAA,0,1897064
icdC_predicted,0.5,1,1,GCCCGCATAACCGGCTATAA,0,1902736
icdC_predicted,0.5,1,1,GCCCCTCAACTTGTGGGGGG,0,1905354
icdC_predicted,0.5,1,1,GCCCAGGCCCGGTTATGACA,0,1883918
icdC_predicted,0.5,1,1,GCCATTGAGGGCTTTCGTTA,0,1905887
icdC_predicted,0.5,1,1,GCCATGCGAGAGGTATGAAG,0,1891093
icdC_predicted,0.5,1,1,GCCATCAGTCACGGCCCATT,0,1880890
icdC_predicted,0.5,1,1,GCCAGGTGCGTACCGCACCA,0,1890836
icdC_predicted,0.5,1,1,GCCAACAAATGAGACGCTTT,0,1889410
icdC_predicted,0.5,1,1,GCATTTTTCAATGCCAGTGA,0,1902900
icdC_predicted,0.5,1,1,GCATCCCTATGCTGCTCTCA,0,1896900
icdC_predicted,0.5,1,1,GCATACCACGTCAATACCGT,0,1889224
icdC_predicted,0.5,1,1,GCAGGTCTGTAGTCCAGTGC,0,1908341
icdC_predicted,0.5,1,1,GCAGGTAAGGAATGAACGTA,0,1880052
icdC_predicted,0.5,1,1,GCAGCTTTCCTTCCCTCCGG,0,1892397
icdC_predicted,0.5,1,1,GCACCTTTAGAGCGAAAGGT,0,1878402
icdC_predicted,0.5,1,1,GCACAGACGATAGTTCTCTG,0,1896384
icdC_predicted,0.5,1,1,GCAATCGTGTTGTCTGTTAT,0,1892459
icdC_predicted,0.5,1,1,GCAATCAGCGGGATGTATGA,0,1888258
icdC_predicted,0.5,1,1,GCAACGTAAGACCGTGGGGA,0,1900519
icdC_predicted,0.5,1,1,GCAAATCGGTTAAGACGGAC,0,1881030
icdC_predicted,0.5,1,1,GCAAAGCATGCATCACGCCA,0,1891734
icdC_predicted,0.5,1,1,GATTTTGGTAGTGTCGGCTG,0,1905270
icdC_predicted,0.5,1,1,GATTTTCTGACGTGCCAAGT,0,1896123
icdC_predicted,0.5,1,1,GATTTCGCAGATAAGGGCAA,0,1907454
icdC_predicted,0.5,1,1,GATTGGGGATCTTGAGCTCT,0,1883619
icdC_predicted,0.5,1,1,GATTCTGCTGTTTGTAACAT,0,1885519
icdC_predicted,0.5,1,1,GATTCAAACACCAAGAGGAC,0,1883771
icdC_predicted,0.5,1,1,GATGCACCGGTGTGCCGAAT,0,1891788
icdC_predicted,0.5,1,1,GATGACGTCATTGCCTTACT,0,1882599
icdC_predicted,0.5,1,1,GATCGGCCAAGAGGTGTTCA,0,1886821
icdC_predicted,0.5,1,1,GATCCCCTGTCGTTTTTTGA,0,1889609
icdC_predicted,0.5,1,1,GATCAGCCTAAATCTTGCGG,0,1893158
icdC_predicted,0.5,1,1,GATATGACCCCTCCAGGGCC,0,1909413
icdC_predicted,0.5,1,1,GATAGGGCGTACTTGGCCTA,0,1908798
icdC_predicted,0.5,1,1,GATAGGACCCCGGAATCGTA,0,1885022
icdC_predicted,0.5,1,1,GATAGCTTATGCCAGAGTAG,0,1880300
icdC_predicted,0.5,1,1,GATACTTGGCGGTCAGGGTG,0,1899387
icdC_predicted,0.5,1,1,GAGTGTAACATTGAGGCGCA,0,1900388
icdC_predicted,0.5,1,1,GAGTGGGTTTTACATTTTTA,0,1894989
icdC_predicted,0.5,1,1,GAGTGGGACTTAGCGTTTGG,0,1902337
icdC_predicted,0.5,1,1,GAGTCGGACAGCGCAGCTTA,0,1899556
icdC_predicted,0.5,1,1,GAGGGTTAAAACGAAGTTGG,0,1889741
icdC_predicted,0.5,1,1,GAGGGGCAAGGCTCGCTACA,0,1886330
icdC_predicted,0.5,1,1,GAGGGCTATCGGCGTCATGG,0,1895387
icdC_predicted,0.5,1,1,GAGGAAGCCTGAGGTCAGAT,0,1895989
icdC_predicted,0.5,1,1,GAGGAACAGTACACCGCCTG,0,1906531
icdC_predicted,0.5,1,1,GAGCTTGTTGCGGTCCCGGC,0,1899026
icdC_predicted,0.5,1,1,GAGCGTCGCTCGTTTCAGGA,0,1908822
icdC_predicted,0.5,1,1,GAGCGGAGACTCGATGCGGC,0,1885009
icdC_predicted,0.5,1,1,GAGCCTCGAGTTCTACTCGT,0,1889976
icdC_predicted,0.5,1,1,GAGCCTCCAAACAACTACCT,0,1909018
icdC_predicted,0.5,1,1,GAGCATATTGCCAGAACAGG,0,1891145
icdC_predicted,0.5,1,1,GAGCAGCGAAGTTTTACTTT,0,1894647
icdC_predicted,0.5,1,1,GAGATAAAATGTCACTACTC,0,1891885
icdC_predicted,0.5,1,1,GAGAGAGTAGTGGAACTTAC,0,1887791
icdC_predicted,0.5,1,1,GAGAATACCTACTATCGTGG,0,1908152
icdC_predicted,0.5,1,1,GAGAAAAAAAGTTGAATTCT,0,1901546
icdC_predicted,0.5,1,1,GACTTACGTGCGCGTCAAGA,0,1900844
icdC_predicted,0.5,1,1,GACTCCAATGAGCCGTGGTC,0,1892828
icdC_predicted,0.5,1,1,GACTCATCACGCTATGATCA,0,1894160
icdC_predicted,0.5,1,1,GACTATTCTAACAGCGGAGT,0,1897754
icdC_predicted,0.5,1,1,GACTAGAGGGCCGGAGGATC,0,1889372
icdC_predicted,0.5,1,1,GACGGATGATTCCGGAGGCC,0,1884987
icdC_predicted,0.5,1,1,GACGATTCCGACTGACAGGA,0,1909117
icdC_predicted,0.5,1,1,GACGAACTGTTTAATAGCTC,0,1903947
icdC_predicted,0.5,1,1,GACCTTACGTAGGCGTACGT,0,1878965
icdC_predicted,0.5,1,1,GACCGATGTACTGAGCCTGC,0,1883052
icdC_predicted,0.5,1,1,GACCAGTGATTTGCAATGGA,0,1900071
icdC_predicted,0.5,1,1,GACCAGGATAGGCTTTGCAG,0,1890888
icdC_predicted,0.5,1,1,GACCACCTGTACCACCCAAA,0,1887483
icdC_predicted,0.5,1,1,GACAGTCGCAAGAATCTCCG,0,1885778
icdC_predicted,0.5,1,1,GACACGGGGACTTTGTTGGG,0,1895861
icdC_predicted,0.5,1,1,GACAACGTGGAGACATATCG,0,1899757
icdC_predicted,0.5,1,1,GACAAAATACCAGCGGCGCA,0,1881007
icdC_predicted,0.5,1,1,GAATTGTGGACGGCTAGATT,0,1899890
icdC_predicted,0.5,1,1,GAATTCCGACGATAGCCTTA,0,1903188
icdC_predicted,0.5,1,1,GAATTCAGCTCCGGGCATTA,0,1885184
icdC_predicted,0.5,1,1,GAATCCTTCATTATACCGCC,0,1888993
icdC_predicted,0.5,1,1,GAAGGGGAGAAGGGGACCGG,0,1895654
icdC_predicted,0.5,1,1,GAAGAGCCCTACACACATAA,0,1890044
icdC_predicted,0.5,1,1,GAAGACCTCCTGTTTGGAAC,0,1906729
icdC_predicted,0.5,1,1,GAACGTGCCTAGTATGGTGC,0,1890079
icdC_predicted,0.5,1,1,GAACCGTCCCCGAGGAGTCC,0,1900282
icdC_predicted,0.5,1,1,GAACCCTCGGAAGGCAGCGA,0,1882847
icdC_predicted,0.5,1,1,GAACCAGGTTGATCTCCGAC,0,1907283
icdC_predicted,0.5,1,1,GAACCAATTAGAACGGGAAC,0,1908955
icdC_predicted,0.5,1,1,GAAAGCTGTCCAGACGAGGT,0,1892655
icdC_predicted,0.5,1,1,GAAACTGATTGTCGAGTGTT,0,1900102
icdC_predicted,0.5,1,1,GAAACTAACGGTCTCCGGGA,0,1904804
icdC_predicted,0.5,1,1,CTTTGGCAACTCCTACGAAA,0,1905701
icdC_predicted,0.5,1,1,CTTGTTGTAGCGTTTGCAGG,0,1896116
icdC_predicted,0.5,1,1,CTTGGCATCGGATATCAGTA,0,1904260
icdC_predicted,0.5,1,1,CTTCTTGACGAGATTTATTG,0,1890853
icdC_predicted,0.5,1,1,CTTCTGGGGCACCGATTCAA,0,1897887
icdC_predicted,0.5,1,1,CTTCTAGTACAGTGAAAGAG,0,1887685
icdC_predicted,0.5,1,1,CTTCGTTCAAGGTGTTATTA,0,1885310
icdC_predicted,0.5,1,1,CTTCGGCCCGGGCGCTCCCC,0,1896161
icdC_predicted,0.5,1,1,CTTCGCTCAACTGAGGACGA,0,1887776
icdC_predicted,0.5,1,1,CTTCATCATTTGTTGACCTA,0,1879791
icdC_predicted,0.5,1,1,CTTCACTTTATAATATCATG,0,1899187
icdC_predicted,0.5,1,1,CTTCACCTGAGTTGAGTGCA,0,1887233
icdC_predicted,0.5,1,1,CTTCAACACAACCAAACTCA,0,1884906
icdC_predicted,0.5,1,1,CTTATGGCCCCCTGTCCGAA,0,1905592
icdC_predicted,0.5,1,1,CTTACGAGGGTCTCATCCCT,0,1884796
icdC_predicted,0.5,1,1,CTTAATTCTACCGAGGGCAA,0,1899952
icdC_predicted,0.5,1,1,CTTAACTCCCTTCGCGGGCA,0,1885046
icdC_predicted,0.5,1,1,CTTAAAGGGGGCGGATGATC,0,1903025
icdC_predicted,0.5,1,1,CTGTTCAAGCTTTAGCGTCG,0,1897667
icdC_predicted,0.5,1,1,CTGGGTCCCCGTCCGGAGTC,0,1886435
icdC_predicted,0.5,1,1,CTGGCGTTATTTTTGATTTG,0,1906310
icdC_predicted,0.5,1,1,CTGGCATATAGCATACGCGG,0,1881281
icdC_predicted,0.5,1,1,CTGGATACCAACCCCTCCAT,0,1906181
icdC_predicted,0.5,1,1,CTGCGTTGGACACTCACCCC,0,1885525
icdC_predicted,0.5,1,1,CTGCGCTCCGCACTTCTTGT,0,1888161
icdC_predicted,0.5,1,1,CTGATTGCACCAGCAAGTGT,0,1906917
icdC_predicted,0.5,1,1,CTGAGGCACCTTTAAGCATA,0,1890221
icdC_predicted,0.5,1,1,CTGACTCAGCAAGTAGCACG,0,1886269
icdC_predicted,0.5,1,1,CTCTGATATGGACCATTCCC,0,1901710
icdC_predicted,0.5,1,1,CTCGTTGGCCCCAAAACCCT,0,1892616
icdC_predicted,0.5,1,1,CTCGTTCCAACAGGAAGAAG,0,1902518
icdC_predicted,0.5,1,1,CTCGGCAGCCACCAGTGGAC,0,1895915
icdC_predicted,0.5,1,1,CTCGCCGTAACCACGCTTAG,0,1881127
icdC_predicted,0.5,1,1,CTCCGTGCAAGACAGCAGGA,0,1883518
icdC_predicted,0.5,1,1,CTCCGAACCCGAGATCGAGA,0,1896045
icdC_predicted,0.5,1,1,CTCCCCGAGTTACCCACGAA,0,1887740
icdC_predicted,0.5,1,1,CTCCACGACGGCACTTTTTA,0,1890387
icdC_predicted,0.5,1,1,CTCATTGGATATGAAGAGCC,0,1881022
icdC_predicted,0.5,1,1,CTCAGGTTTTGATTACTTTG,0,1907038
icdC_predicted,0.5,1,1,CTCAGACATTATGTCATCCT,0,1902359
icdC_predicted,0.5,1,1,CTCACTTCATTCTTACAATG,0,1885302
icdC_predicted,0.5,1,1,CTATTTAGCCGTAAGTCCCA,0,1885868
icdC_predicted,0.5,1,1,CTATTGACCAAATGCGAACG,0,1891199
icdC_predicted,0.5,1,1,CTATCTTGTTATCTATTCTA,0,1896875
icdC_predicted,0.5,1,1,CTATCATGTTAAGTCTGGAT,0,1893765
icdC_predicted,0.5,1,1,CTATATTAAGGCGGAATGTT,0,1891854
icdC_predicted,0.5,1,1,CTATAGTTAGTTATTATTAC,0,1898903
icdC_predicted,0.5,1,1,CTACTCACTCGCTGAAGATC,0,1907623
icdC_predicted,0.5,1,1,CTACGCATGGGTCTACACCC,0,1886439
icdC_predicted,0.5,1,1,CTACCTCGCGAATAGGCTTT,0,1897433
icdC_predicted,0.5,1,1,CTAATAATGTATATCCCTTG,0,1896030
icdC_predicted,0.5,1,1,CTAAGTACCGTCAAACATAA,0,1907785
icdC_predicted,0.5,1,1,CTAAGGCCTACCTAGGAGTG,0,1885132
icdC_predicted,0.5,1,1,CTAAGGACTGATGGCATGTC,0,1896464
icdC_predicted,0.5,1,1,CTAACTGGTCGTTGACAAGA,0,1888998
icdC_predicted,0.5,1,1,CTAAAAAGCTGAGGGGAGCC,0,1889869
icdC_predicted,0.5,1,1,CGTGGGTGCAGATGGTTACC,0,1878040
icdC_predicted,0.5,1,1,CGTGCTGTGACGCCAAAGGG,0,1887296
icdC_predicted,0.5,1,1,CGTGAGAGCTCATCATCTCT,0,1899129
icdC_predicted,0.5,1,1,CGTCTGAATACGGCTCGGGG,0,1886601
icdC_predicted,0.5,1,1,CGTCGGGCCTGTGGTGGGAG,0,1894006
icdC_predicted,0.5,1,1,CGTCGGCGGATGGTGGCTTG,0,1892348
icdC_predicted,0.5,1,1,CGTCCGTGTCTTCAAAGTTC,0,1892414
icdC_predicted,0.5,1,1,CGTATTACGGTTTTGGAACC,0,1905688
icdC_predicted,0.5,1,1,CGTAGCTCCTAATAGCGGAG,0,1879127
icdC_predicted,0.5,1,1,CGTAGAGAGTGGTTGCGGGG,0,1878683
icdC_predicted,0.5,1,1,CGGTTCAGTAAGCAAGAAGT,0,1877975
icdC_predicted,0.5,1,1,CGGTGACTTCGGCCGCCACC,0,1887924
icdC_predicted,0.5,1,1,CGGTCTGGAGAACCGTTTAT,0,1884268
icdC_predicted,0.5,1,1,CGGTCGGCACATACTTCGTA,0,1895881
icdC_predicted,0.5,1,1,CGGTATGTGCTAATGTAACC,0,1903902
icdC_predicted,0.5,1,1,CGGTACCTACTGGATATCGA,0,1906764
icdC_predicted,0.5,1,1,CGGTAACTCGTTCGGTATGA,0,1892921
icdC_predicted,0.5,1,1,CGGTAAAGGGATGGACTTGA,0,1879547
icdC_predicted,0.5,1,1,CGGGTCATCCGGCTGGCCTG,0,1904005
icdC_predicted,0.5,1,1,CGGGGTTTATGCTTGGCTTC,0,1901834
icdC_predicted,0.5,1,1,CGGGGGGTCTCATGCGTACA,0,1901858
icdC_predicted,0.5,1,1,CGGCTCTTATGAATTTGGCC,0,1899560
icdC_predicted,0.5,1,1,CGGCTCTTAAAGTCCTAAGA,0,1901941
icdC_predicted,0.5,1,1,CGGCGCTCAAAGGAAAGTCA,0,1889646
icdC_predicted,0.5,1,1,CGGCCTCAGTTAATGAGGGA,0,1888414
icdC_predicted,0.5,1,1,CGGCATCCCAGCGAACATAC,0,1901136
icdC_predicted,0.5,1,1,CGGATGGCGGTGGGACTATC,0,1882703
icdC_predicted,0.5,1,1,CGGATGGATGTCTGCCACCC,0,1893296
icdC_predicted,0.5,1,1,CGGACTTCGCAACTCCATCC,0,1904346
icdC_predicted,0.5,1,1,CGGACGTTTGCCAGCTAACA,0,1879144
icdC_predicted,0.5,1,1,CGGACCCAATAGAAGGGATA,0,1903512
icdC_predicted,0.5,1,1,CGCTTTACGTTGAGTGCCTT,0,1898890
icdC_predicted,0.5,1,1,CGCTTGCATTGGTAGATGTT,0,1901361
icdC_predicted,0.5,1,1,CGCTGGCCGTTGCGTCACAC,0,1885694
icdC_predicted,0.5,1,1,CGCTCTGCGTGTCCGCTTCC,0,1891619
icdC_predicted,0.5,1,1,CGCGTGCGAGGCAAGGTGGT,0,1880723
icdC_predicted,0.5,1,1,CGCGTCGAGCACCCCCTAAA,0,1894326
icdC_predicted,0.5,1,1,CGCGGTAAGGTCGATAACAG,0,1889124
icdC_predicted,0.5,1,1,CGCGGCACCAAGTGCTGGCG,0,1884036
icdC_predicted,0.5,1,1,CGCGCAGCGATTAGTCTTTG,0,1880555
icdC_predicted,0.5,1,1,CGCGCAACCAAATTTTGCTC,0,1891373
icdC_predicted,0.5,1,1,CGCGATGTTGTCGCCTGCCT,0,1905588
icdC_predicted,0.5,1,1,CGCGAGTAGACACGTGCCAG,0,1886902
icdC_predicted,0.5,1,1,CGCCTTATCCAACTTTGGGT,0,1897928
icdC_predicted,0.5,1,1,CGCCAGGCGAAGCCGCACAG,0,1880022
icdC_predicted,0.5,1,1,CGCAGGGCTGGTTATACACA,0,1908926
icdC_predicted,0.5,1,1,CGCACTCGGAAGTAATCTGT,0,1889768
icdC_predicted,0.5,1,1,CGCAAATCCACAGGTAATGC,0,1892264
icdC_predicted,0.5,1,1,CGATGGCAGCACACATCCCT,0,1886272
icdC_predicted,0.5,1,1,CGAGGGTTACCCCGGCATAT,0,1891311
icdC_predicted,0.5,1,1,CGAGGCGCTTTCCTTTCATT,0,1902207
icdC_predicted,0.5,1,1,CGAGCCGGGTCCAAAAAAAT,0,1892090
icdC_predicted,0.5,1,1,CGACTTTATCATACTGGATG,0,1902429
icdC_predicted,0.5,1,1,CGACCGGTATCATTCTGTTT,0,1885528
icdC_predicted,0.5,1,1,CGACCGGTAAAGACCATTCA,0,1884777
icdC_predicted,0.5,1,1,CGACCAGGCGCCGTCCGTAC,0,1902310
icdC_predicted,0.5,1,1,CGACCAAAATCTGCACGGAA,0,1904765
icdC_predicted,0.5,1,1,CGACAGGGGTCGCGCGCTCT,0,1899678
icdC_predicted,0.5,1,1,CGACACAGAGACATAATGAG,0,1895496
icdC_predicted,0.5,1,1,CGAATCTGTATGATTGACAC,0,1899508
icdC_predicted,0.5,1,1,CGAACTAATACGATCTATTT,0,1881899
icdC_predicted,0.5,1,1,CGAACGACCACAATGCCACT,0,1899035
icdC_predicted,0.5,1,1,CCTTTTTTGTACTTGTATGT,0,1878382
icdC_predicted,0.5,1,1,CCTTCTTATGCTCAATCTTT,0,1902338
icdC_predicted,0.5,1,1,CCTTAGCCAGTCGCGAGAAG,0,1904993
icdC_predicted,0.5,1,1,CCTTAAGGAGCTTATCAGAC,0,1896425
icdC_predicted,0.5,1,1,CCTGTTTGAGGCACCTTTCT,0,1897834
icdC_predicted,0.5,1,1,CCTGTCTACTGGGTCCAAGA,0,1901151
icdC_predicted,0.5,1,1,CCTGGAGATTACTCAAGCAG,0,1886084
icdC_predicted,0.5,1,1,CCTGCTGCCAGTATGCAATG,0,1900285
icdC_predicted,0.5,1,1,CCTGCGTTGCCGGTGCAGAT,0,1903339
icdC_predicted,0.5,1,1,CCTGCATATGATTGAGTGCT,0,1888262
icdC_predicted,0.5,1,1,CCTGATTCATTTGGAAGCTC,0,1885605
icdC_predicted,0.5,1,1,CCTGAAGTAATTGAGGAGCA,0,1904592
icdC_predicted,0.5,1,1,CCTCTAGTGATTTTATTCAT,0,1907388
icdC_predicted,0.5,1,1,CCTATGCAGCCGAAGAACAA,0,1890278
icdC_predicted,0.5,1,1,CCTATCCAATACGAGGTTCT,0,1903508
icdC_predicted,0.5,1,1,CCTATCATGGGTTCCGCACA,0,1881788
icdC_predicted,0.5,1,1,CCTATATCGTGAGTTAGGTA,0,1879725
icdC_predicted,0.5,1,1,CCTACTTTGTACTCGAGGCT,0,1903670
icdC_predicted,0.5,1,1,CCTAAGCTCTAGGCCATCCA,0,1888868
icdC_predicted,0.5,1,1,CCTAACTAAACTAGGTTAAA,0,1896621
icdC_predicted,0.5,1,1,CCTAACACTTACCAATTAGT,0,1891072
icdC_predicted,0.5,1,1,CCGTGTGGGTCCTGACCCCT,0,1895344
icdC_predicted,0.5,1,1,CCGTGTAATCGGGATTTATT,0,1887797
icdC_predicted,0.5,1,1,CCGTCTCATGGCCGCTTTTC,0,1882921
icdC_predicted,0.5,1,1,CCGGTTAGCACAGGACAGAC,0,1902362
icdC_predicted,0.5,1,1,CCGGTTAAAGATCAGTCTAT,0,1906528
icdC_predicted,0.5,1,1,CCGGTGATGCTACGCCGTTC,0,1890468
icdC_predicted,0.5,1,1,CCGGGGGGATCTTGAGGTTT,0,1891931
icdC_predicted,0.5,1,1,CCGGGGCGGCGACCCAGTTT,0,1900368
icdC_predicted,0.5,1,1,CCGGGCTAGATTCCAGCAAG,0,1892774
icdC_predicted,0.5,1,1,CCGGGCTACCTCCCCGTGCA,0,1905547
icdC_predicted,0.5,1,1,CCGCTTGGTGATCTATTGTG,0,1883291
icdC_predicted,0.5,1,1,CCGCTGGTGTCCAGGGTTCA,0,1882964
icdC_predicted,0.5,1,1,CCGCTCACTGTCTTGCTTTA,0,1896897
icdC_predicted,0.5,1,1,CCGCCTACGTAACCGCACGG,0,1907151
icdC_predicted,0.5,1,1,CCGCAGAGGTGAAGGCTCAA,0,1885665
icdC_predicted,0.5,1,1,CCGAGCCGTTGGGAGTAACC,0,1885226
icdC_predicted,0.5,1,1,CCGAGCCCCCCCTATCAATA,0,1879328
icdC_predicted,0.5,1,1,CCGACGCAGTCAGCTGCTAA,0,1885410
icdC_predicted,0.5,1,1,CCCTTGGTTATTGTTGCACT,0,1901548
icdC_predicted,0.5,1,1,CCCTTCTTCTAGCGGGCGTT,0,1879184
icdC_predicted,0.5,1,1,CCCTTCTCCTTTTCGCTCAC,0,1890716
icdC_predicted,0.5,1,1,CCCTGCTAAGTGGGTCTAAA,0,1887091
icdC_predicted,0.5,1,1,CCCTCCCCACTATAGCGTGG,0,1884120
icdC_predicted,0.5,1,1,CCCGGCTCGTACAAGACTGT,0,1906347
icdC_predicted,0.5,1,1,CCCGGACGCTCATGTCGGTT,0,1895157
icdC_predicted,0.5,1,1,CCCGCGGAGTCAAACAGTTT,0,1890865
icdC_predicted,0.5,1,1,CCCGATTCTCCTCGTGATCC,0,1894404
icdC_predicted,0.5,1,1,CCCGAAGGGCGACGTGACGG,0,1909006
icdC_predicted,0.5,1,1,CCCCTACCGAAGAATTTGCG,0,1896098
icdC_predicted,0.5,1,1,CCCCGCTCCGCTGGAACAAA,0,1882765
icdC_predicted,0.5,1,1,CCCACTCATTACACCTCATG,0,1887336
icdC_predicted,0.5,1,1,CCATTCATCTCAAATGTATA,0,1895089
icdC_predicted,0.5,1,1,CCATTCAGTCTGACGCGCAA,0,1904821
icdC_predicted,0.5,1,1,CCAGGGTTTCGACATGACCT,0,1884817
icdC_predicted,0.5,1,1,CCAGGAAGCTTCGTCATGGG,0,1904167
icdC_predicted,0.5,1,1,CCAGCTGCTCCCTCAATACC,0,1909027
icdC_predicted,0.5,1,1,CCAGATTGTCGGTTTCGGGC,0,1909242
icdC_predicted,0.5,1,1,CCAGAGAGCATGAGATGAGT,0,1882256
icdC_predicted,0.5,1,1,CCAAGGTGTGATAACTCTGA,0,1881130
icdC_predicted,0.5,1,1,CCAAGGGGCCAATAATTTTT,0,1881525
icdC_predicted,0.5,1,1,CCAACTCATTAGAATTGTGT,0,1896670
icdC_predicted,0.5,1,1,CCAACTATTGTGGATTTGTC,0,1881499
icdC_predicted,0.5,1,1,CCAACGAGGATTCTGTGGGC,0,1904943
icdC_predicted,0.5,1,1,CATTTCTCAGGTAAAAGTTC,0,1882652
icdC_predicted,0.5,1,1,CATTGACAGGAGTGATCGAT,0,1896209
icdC_predicted,0.5,1,1,CATTCGTTCTTAAATTGCTG,0,1880484
icdC_predicted,0.5,1,1,CATTCAGTCTCCCCGATCGA,0,1906876
icdC_predicted,0.5,1,1,CATTAGCGCGACGGGCCTTT,0,1895398
icdC_predicted,0.5,1,1,CATTAGACAAAGACCGGTTG,0,1886254
icdC_predicted,0.5,1,1,CATGGTGGGGCAGTCTACCC,0,1903764
icdC_predicted,0.5,1,1,CATGCAACGGTTCTTTTCAT,0,1883201
icdC_predicted,0.5,1,1,CATCCCACTCAGATCCTGCA,0,1906461
icdC_predicted,0.5,1,1,CATCAGACTTATGCCTTTGA,0,1899991
icdC_predicted,0.5,1,1,CATCAACGATGGTACACTGA,0,1891622
icdC_predicted,0.5,1,1,CATATGTAAGCTAGGTCCGC,0,1904311
icdC_predicted,0.5,1,1,CATATAGCGAGCGGTGAGTG,0,1899370
icdC_predicted,0.5,1,1,CATAGTGGTGTATCGAGCTG,0,1904604
icdC_predicted,0.5,1,1,CATAGCAAGACCACCTGTAG,0,1899729
icdC_predicted,0.5,1,1,CAGTTCGATCACGAGAACGA,0,1909545
icdC_predicted,0.5,1,1,CAGTGCGATTGAGTATGAAT,0,1905393
icdC_predicted,0.5,1,1,CAGTGCCTTCAGGGGCCGGG,0,1879068
icdC_predicted,0.5,1,1,CAGTGCCCAGCGTGCGAGTA,0,1899190
icdC_predicted,0.5,1,1,CAGTGAGGCGCTGCGTAAAC,0,1896204
icdC_predicted,0.5,1,1,CAGTCTGAACGAACAATCCT,0,1902097
icdC_predicted,0.5,1,1,CAGTCAGGCAGCGGAAGTTC,0,1905271
icdC_predicted,0.5,1,1,CAGTAACTTGGAATGAAGGT,0,1884545
icdC_predicted,0.5,1,1,CAGGGTCCAGTGGAAGCGAA,0,1893032
icdC_predicted,0.5,1,1,CAGGGCCGGGCTCGCCGGCA,0,1892345
icdC_predicted,0.5,1,1,CAGGCGCTAGCTATGAGGTA,0,1898396
icdC_predicted,0.5,1,1,CAGGCACTAACCAGCGCCCT,0,1889787
icdC_predicted,0.5,1,1,CAGCTTCTAGCGGTGTAGTA,0,1904358
icdC_predicted,0.5,1,1,CAGCTGTGTCAGACGTTTTG,0,1898164
icdC_predicted,0.5,1,1,CAGCTGCTCGGATTTTACTC,0,1899896
icdC_predicted,0.5,1,1,CAGCTGAATTTCCTAGCAGC,0,1889150
icdC_predicted,0.5,1,1,CAGCTCCACTTCTTAGAATA,0,1890959
icdC_predicted,0.5,1,1,CAGCCGTAAAGCTTCTCCGA,0,1888296
icdC_predicted,0.5,1,1,CAGCCCGCCCGCAAACCTGT,0,1889756
icdC_predicted,0.5,1,1,CAGCATGTTATATTGCTAAA,0,1881434
icdC_predicted,0.5,1,1,CAGATACTGCAACAAGGTGT,0,1897950
icdC_predicted,0.5,1,1,CAGACACGATCTTATAGTCA,0,1892438
icdC_predicted,0.5,1,1,CAGAACACATGGTAGGAGCT,0,1886509
icdC_predicted,0.5,1,1,CAGAAAAGCGATACCACACA,0,1901935
icdC_predicted,0.5,1,1,CACTTGGGAGGTGGAACTAG,0,1888464
icdC_predicted,0.5,1,1,CACTTCCCCAATGTCGCAGA,0,1900240
icdC_predicted,0.5,1,1,CACTTAGGTGTTGTGTATAG,0,1896749
icdC_predicted,0.5,1,1,CACTATCATCCATTAGGGAC,0,1885228
icdC_predicted,0.5,1,1,CACGTGGTATTCCGTGCTCG,0,1896857
icdC_predicted,0.5,1,1,CACCTCCTGCACGTGTATCC,0,1906166
icdC_predicted,0.5,1,1,CACCGTGTATGACATGCGTC,0,1886931
icdC_predicted,0.5,1,1,CACCGCCTGCTCGCTAATCT,0,1890523
icdC_predicted,0.5,1,1,CACCGAAGTCAAAGAAATCG,0,1900532
icdC_predicted,0.5,1,1,CACCCGGTGCTCAACATGGA,0,1905979
icdC_predicted,0.5,1,1,CACCCGACAGGGCTTTCCTG,0,1878028
icdC_predicted,0.5,1,1,CACCAGCGCGCACCCGCAGG,0,1896782
icdC_predicted,0.5,1,1,CACCACGTCCCACTTATGTT,0,1890604
icdC_predicted,0.5,1,1,CACATATAACAATACGTACC,0,1884911
icdC_predicted,0.5,1,1,CACATAATTCAGGGTTAAGA,0,1885063
icdC_predicted,0.5,1,1,CACAGGTCGAACCGAATAAC,0,1889462
icdC_predicted,0.5,1,1,CACACGTAGGAAGCCGATGA,0,1881671
icdC_predicted,0.5,1,1,CAATTTTGCCACCGGTGTAC,0,1888503
icdC_predicted,0.5,1,1,CAATGATGGCAACTCTGTAT,0,1895502
icdC_predicted,0.5,1,1,CAATCCATGGTCACCACAGC,0,1881315
icdC_predicted,0.5,1,1,CAATAGATCACAGCAGAGTT,0,1901357
icdC_predicted,0.5,1,1,CAATAATGCACCGATCGGGC,0,1879251
icdC_predicted,0.5,1,1,CAATAACTGGCTAGGATTCT,0,1878646
icdC_predicted,0.5,1,1,CAATAACCGTACGTGGGCAA,0,1895845
icdC_predicted,0.5,1,1,CAAGTTGGACTTGAGATGCG,0,1882548
icdC_predicted,0.5,1,1,CAAGCGAGGGATTAGTAGGC,0,1909326
icdC_predicted,0.5,1,1,CAAGCATTATGGAGCCGTCT,0,1888999
icdC_predicted,0.5,1,1,CAACTGAGTCCAGCTCGCAG,0,1903893
icdC_predicted,0.5,1,1,CAACAGAGGCCTCCGTGCGA,0,1885019
icdC_predicted,0.5,1,1,CAAAGGACAGTACGTCTCTG,0,1898400
icdC_predicted,0.5,1,1,CAAACGGTGCTTATCCTGTA,0,1878423
icdC_predicted,0.5,1,1,CAAAAGCCGTGATCTTCCGA,0,1894695
icdC_predicted,0.5,1,1,ATTTTCAGTACTGTTGACAC,0,1897704
icdC_predicted,0.5,1,1,ATTTGCGAGCGTATCCGCTC,0,1883629
icdC_predicted,0.5,1,1,ATTTAAGGCCAAACTGGTCC,0,1882127
icdC_predicted,0.5,1,1,ATTTAACAGGCTCAAAAAGT,0,1894321
icdC_predicted,0.5,1,1,ATTGTACAGATCTGTATGAT,0,1878292
icdC_predicted,0.5,1,1,ATTGGACTCGGAAATGGGGG,0,1892759
icdC_predicted,0.5,1,1,ATTGCCTGCTTGTCCCGGTT,0,1894062
icdC_predicted,0.5,1,1,ATTGCCCGCCAGACCGATGG,0,1898395
icdC_predicted,0.5,1,1,ATTGACAGATACGTACCGGT,0,1896973
icdC_predicted,0.5,1,1,ATTCGGGGTAACATACTTGC,0,1899186
icdC_predicted,0.5,1,1,ATTCGGACCAGTCAGACGTG,0,1897833
icdC_predicted,0.5,1,1,ATTCGCGTTTTGGAAGATTC,0,1906845
icdC_predicted,0.5,1,1,ATTCCTAAAGTGCCAGGTAT,0,1904854
icdC_predicted,0.5,1,1,ATTCCGCCGGTCCTAGTGTG,0,1899066
icdC_predicted,0.5,1,1,ATTCAACCCATATCCCTGCT,0,1888958
icdC_predicted,0.5,1,1,ATTATCTTGCAGATAATGTT,0,1885910
icdC_predicted,0.5,1,1,ATTAGGGTTAATAACGGGGG,0,1890457
icdC_predicted,0.5,1,1,ATTACAGGGCGCAGCAGGCA,0,1905798
icdC_predicted,0.5,1,1,ATTAACTACCTGAATGTTCT,0,1902684
icdC_predicted,0.5,1,1,ATGTTTGGTACTTGTCTGCC,0,1884865
icdC_predicted,0.5,1,1,ATGTTGACCATGGTTAACAA,0,1889191
icdC_predicted,0.5,1,1,ATGTTAGAATTTCGCCGTTA,0,1905976
icdC_predicted,0.5,1,1,ATGTGGTCCAGTCATCATGA,0,1894391
icdC_predicted,0.5,1,1,ATGTGCGACGCTATAGGTGT,0,1904268
icdC_predicted,0.5,1,1,ATGGGTCTCTAGGCTTAGAT,0,1901469
icdC_predicted,0.5,1,1,ATGGCTAGTGAACGCGGTGC,0,1903080
icdC_predicted,0.5,1,1,ATGGCTAAGTTTAGCATGGA,0,1908993
icdC_predicted,0.5,1,1,ATGGCATTATGCATGCGGCA,0,1892182
icdC_predicted,0.5,1,1,ATGGAGTTTATGGCCAGGGA,0,1897968
icdC_predicted,0.5,1,1,ATGGACGCGTATATGGCAAA,0,1890963
icdC_predicted,0.5,1,1,ATGGAATTCACATCGTAATC,0,1903098
icdC_predicted,0.5,1,1,ATGGAAACGAAATACCAAAT,0,1906137
icdC_predicted,0.5,1,1,ATGCGCATGTAGGAAGCTCA,0,1904396
icdC_predicted,0.5,1,1,ATGCGACACAGTAAAAATTG,0,1902930
icdC_predicted,0.5,1,1,ATGCCATTTAGCGTGGTGAT,0,1901620
icdC_predicted,0.5,1,1,ATGATGGATCGTACATGAAC,0,1881815
icdC_predicted,0.5,1,1,ATGATGCGTATCCTCGACTA,0,1879831
icdC_predicted,0.5,1,1,ATGAGGGAGTATAGCGGGAG,0,1895857
icdC_predicted,0.5,1,1,ATGAGATGCGATGAGGTTAT,0,1899732
icdC_predicted,0.5,1,1,ATGACTATTCTACCTTCATT,0,1895424
icdC_predicted,0.5,1,1,ATCTGGGTTATAGTCATGGT,0,1878262
icdC_predicted,0.5,1,1,ATCTGACGCGCAGGCACAGT,0,1885763
icdC_predicted,0.5,1,1,ATCTAAGGGAGTTGTGACAA,0,1901226
icdC_predicted,0.5,1,1,ATCGTTCCACACGTTGCTCT,0,1885197
icdC_predicted,0.5,1,1,ATCGGGGTAGCCTCTACAGG,0,1887498
icdC_predicted,0.5,1,1,ATCGCTTCCTATACAACGAG,0,1882958
icdC_predicted,0.5,1,1,ATCGCATAGTACTGGACCAA,0,1885358
icdC_predicted,0.5,1,1,ATCCTGTCGTAACGAAATTA,0,1878486
icdC_predicted,0.5,1,1,ATCCCTGGCCAGTGGTACTT,0,1882735
icdC_predicted,0.5,1,1,ATCATGTGTAGCTCCCACCC,0,1908563
icdC_predicted,0.5,1,1,ATCATAGAGTTTCCACCAAT,0,1881734
icdC_predicted,0.5,1,1,ATCAAGCTAGGACTTGTGCT,0,1882934
icdC_predicted,0.5,1,1,ATATTTAGTTGCCTTGGATG,0,1890325
icdC_predicted,0.5,1,1,ATATTTAGCTAGACGCGTAT,0,1889884
icdC_predicted,0.5,1,1,ATATTCAAACGACCGATCGT,0,1881881
icdC_predicted,0.5,1,1,ATATGCGCCGAGGCTTCTTT,0,1886441
icdC_predicted,0.5,1,1,ATATGAGTTAAAGCAAATGT,0,1902972
icdC_predicted,0.5,1,1,ATAGCTTATGCCACCTTGCA,0,1882792
icdC_predicted,0.5,1,1,ATAGAGCAGGTGGCGATCCT,0,1896401
icdC_predicted,0.5,1,1,ATACTTAACCATTTATCGTC,0,1883106
icdC_predicted,0.5,1,1,ATACTCAGATATTTTTAGGT,0,1897826
icdC_predicted,0.5,1,1,ATACCTAGGCAATAGACGAA,0,1903473
icdC_predicted,0.5,1,1,ATAATTATATCGGGTATAGT,0,1891664
icdC_predicted,0.5,1,1,ATAAGTTAGTAGGATTTTAA,0,1882629
icdC_predicted,0.5,1,1,ATAAGTCGCTACCAGAGTGG,0,1884003
icdC_predicted,0.5,1,1,ATAAGACTTATCCCGTGCGG,0,1897543
icdC_predicted,0.5,1,1,ATAACGCGTAGGGAATGCTT,0,1903138
icdC_predicted,0.5,1,1,ATAACAAGCAATCCAACCTG,0,1908530
icdC_predicted,0.5,1,1,ATAAACGATATCTCGGTGAC,0,1898990
icdC_predicted,0.5,1,1,AGTTGTTCTAGCTAGCTGCC,0,1908070
icdC_predicted,0.5,1,1,AGTTGGCCACCGGGGGAACT,0,1892262
icdC_predicted,0.5,1,1,AGTTGGAGTCATGTATCTTC,0,1896628
icdC_predicted,0.5,1,1,AGTTCGAAGGACTATAACAC,0,1891149
icdC_predicted,0.5,1,1,AGTTAGGACCTTGCTCATGG,0,1908321
icdC_predicted,0.5,1,1,AGTGTTCATCGAGCCGTCTC,0,1888337
icdC_predicted,0.5,1,1,AGTGTGCCCACGTCTGAAGG,0,1907202
icdC_predicted,0.5,1,1,AGTGGATCCCAAGGCCATTT,0,1880190
icdC_predicted,0.5,1,1,AGTGCGAACGGCACGAGCAT,0,1901223
icdC_predicted,0.5,1,1,AGTGCAACCCTTAGGGCCGT,0,1897499
icdC_predicted,0.5,1,1,AGTCTATACTCTGTGTGCGA,0,1887415
icdC_predicted,0.5,1,1,AGTCGTCGCGTCCGGGGACC,0,1883139
icdC_predicted,0.5,1,1,AGTCCCCTTCAAGGCGGAGT,0,1908526
icdC_predicted,0.5,1,1,AGTCCATATTACTTCTGATG,0,1893948
icdC_predicted,0.5,1,1,AGTCATACGTCTCGGAAACA,0,1893219
icdC_predicted,0.5,1,1,AGTAGGATTACAGAAAGTTC,0,1896385
icdC_predicted,0.5,1,1,AGTACATGTGCACTTACGAC,0,1897304
icdC_predicted,0.5,1,1,AGGTTGTGTGCGCCGCGCAT,0,1887947
icdC_predicted,0.5,1,1,AGGTTGTAACACCCGTCCTG,0,1906892
icdC_predicted,0.5,1,1,AGGTTCAACACCGCCTTTTA,0,1906944
icdC_predicted,0.5,1,1,AGGTTATCTGGTAACGATAT,0,1878016
icdC_predicted,0.5,1,1,AGGTTATATGGGATGCTCAA,0,1880415
icdC_predicted,0.5,1,1,AGGTGCGTAAGGAACTGCTA,0,1895142
icdC_predicted,0.5,1,1,AGGTCTCCCCACGTACACGT,0,1899054
icdC_predicted,0.5,1,1,AGGGGTGTTATCGGCATTGG,0,1885838
icdC_predicted,0.5,1,1,AGGGGAGCAGAGTAAAGCAA,0,1899197
icdC_predicted,0.5,1,1,AGGGCTGATGCATCATCATC,0,1884220
icdC_predicted,0.5,1,1,AGGCTTTAGCTTGAAAGTCG,0,1890263
icdC_predicted,0.5,1,1,AGGCTAGCCGGCGTTAGAGT,0,1889070
icdC_predicted,0.5,1,1,AGGCGCGGGTCCATTTAGTC,0,1877938
icdC_predicted,0.5,1,1,AGGCGCAAGTAACCGTGTTA,0,1901988
icdC_predicted,0.5,1,1,AGGCCCTACACGTGGATGTG,0,1906836
icdC_predicted,0.5,1,1,AGGCATGCCGCGAACGCAAC,0,1881439
icdC_predicted,0.5,1,1,AGGCAACTCGCGCCCATTCC,0,1883504
icdC_predicted,0.5,1,1,AGGATGTTAGTTCGTCGCAT,0,1890271
icdC_predicted,0.5,1,1,AGGATGGGCAACCGATGGTT,0,1879233
icdC_predicted,0.5,1,1,AGGAGGTGCGCTCAAAAAAA,0,1894501
icdC_predicted,0.5,1,1,AGCTTTTGTGGTGGAGGGGA,0,1879324
icdC_predicted,0.5,1,1,AGCTTTGTCCAGCAATCGGC,0,1898290
icdC_predicted,0.5,1,1,AGCTCTGACGCCCCGGGATA,0,1902059
icdC_predicted,0.5,1,1,AGCTCCTCGCTGGGGAACCT,0,1893390
icdC_predicted,0.5,1,1,AGCTCATTAGTTTGACGTGG,0,1893932
icdC_predicted,0.5,1,1,AGCTACCTGGCGCCCGCATC,0,1900909
icdC_predicted,0.5,1,1,AGCGGGTAACGACATGTGGC,0,1886433
icdC_predicted,0.5,1,1,AGCGGGGCCAAGGGTCTGTT,0,1880933
icdC_predicted,0.5,1,1,AGCGGAATTCACACGACTCA,0,1887563
icdC_predicted,0.5,1,1,AGCGAGATTCCTCGAAATCA,0,1899299
icdC_predicted,0.5,1,1,AGCGACCACCTGCCACTCCC,0,1882267
icdC_predicted,0.5,1,1,AGCCCGATTGTTGTCATTCT,0,1901384
icdC_predicted,0.5,1,1,AGCCACAAATTATTTCTTGT,0,1901532
icdC_predicted,0.5,1,1,AGCATCTCAATACACCGTCA,0,1885231
icdC_predicted,0.5,1,1,AGCATATACGGACATGCTTC,0,1907481
icdC_predicted,0.5,1,1,AGCAGTTGTGCAGCCCACAT,0,1895083
icdC_predicted,0.5,1,1,AGATTGGGCTAATGGCATTG,0,1900806
icdC_predicted,0.5,1,1,AGATGAGGAATCACGAACTT,0,1885633
icdC_predicted,0.5,1,1,AGATCTCGGGTGTTGGTGGT,0,1884243
icdC_predicted,0.5,1,1,AGATCCGAAGTTGTTCCGTA,0,1907361
icdC_predicted,0.5,1,1,AGAGCAGTTGAAGGCTCAAA,0,1894053
icdC_predicted,0.5,1,1,AGAGCACCGTTTGAGTATAC,0,1900121
icdC_predicted,0.5,1,1,AGAGAAGGACGTATATGTAA,0,1904436
icdC_predicted,0.5,1,1,AGACAAAGTCGTATGCGTTT,0,1890718
icdC_predicted,0.5,1,1,AGAAGTCTGAGCGGCAGTTA,0,1891470
icdC_predicted,0.5,1,1,AGAACTAGGAATGCACCGGA,0,1885824
icdC_predicted,0.5,1,1,AGAAAATATGCTCTTGCAGG,0,1906821
icdC_predicted,0.5,1,1,ACTTTCCTATGAGTCCGGGT,0,1889020
icdC_predicted,0.5,1,1,ACTTTAAAGGGATATGGATT,0,1901449
icdC_predicted,0.5,1,1,ACTTGTCTTTTCGAAGGAAT,0,1892478
icdC_predicted,0.5,1,1,ACTTATCTGGCGCCAATTCA,0,1903923
icdC_predicted,0.5,1,1,ACTTAGTTGAGACCCGGGGT,0,1905234
icdC_predicted,0.5,1,1,ACTGTGTTTGACTGAAAATC,0,1885948
icdC_predicted,0.5,1,1,ACTGGCGGTCGCCACGCAGG,0,1901867
icdC_predicted,0.5,1,1,ACTGCTGTAAGTGGTTTCTT,0,1884688
icdC_predicted,0.5,1,1,ACTCATGCTTCCCAGGCGCG,0,1894508
icdC_predicted,0.5,1,1,ACTATGGACAAACTCGTGTA,0,1903237
icdC_predicted,0.5,1,1,ACTATCCCGGATGTTAAATA,0,1894716
icdC_predicted,0.5,1,1,ACTATCCAGATCGGTGTCAG,0,1907383
icdC_predicted,0.5,1,1,ACTAGCAATCTAAGGCTGAA,0,1886137
icdC_predicted,0.5,1,1,ACTACGTCCGATATAAGACA,0,1894936
icdC_predicted,0.5,1,1,ACTAATTGATCAGTACTGCT,0,1884097
icdC_predicted,0.5,1,1,ACGTTGACTGACCTTGTAGA,0,1885764
icdC_predicted,0.5,1,1,ACGTGCTCACTCACATTACC,0,1907180
icdC_predicted,0.5,1,1,ACGTGCACCGGCAAGTATGT,0,1900568
icdC_predicted,0.5,1,1,ACGTCGTAGGAGGTCCACTT,0,1882399
icdC_predicted,0.5,1,1,ACGTAGGGAATAAAGCCTTC,0,1903722
icdC_predicted,0.5,1,1,ACGGGCGGGGTTCCATCAGT,0,1908569
icdC_predicted,0.5,1,1,ACGGCCCTGCGCAAACATTG,0,1882327
icdC_predicted,0.5,1,1,ACGGATAAGGCACAGCTGAC,0,1882474
icdC_predicted,0.5,1,1,ACGGAATTAGTGTTCAAGTT,0,1893549
icdC_predicted,0.5,1,1,ACGCTGTTTGAAGAGTGCAT,0,1891004
icdC_predicted,0.5,1,1,ACGCTATCAGGGTCAAAAAC,0,1905513
icdC_predicted,0.5,1,1,ACGCGCCATCACCCACTTAT,0,1899837
icdC_predicted,0.5,1,1,ACGCCGGTGATGGTCGTACC,0,1892852
icdC_predicted,0.5,1,1,ACGATTTCTTACATCCTTAT,0,1881532
icdC_predicted,0.5,1,1,ACGATACGACTCTGTTCTCC,0,1901753
icdC_predicted,0.5,1,1,ACGAAACCGACGGCGTGAGC,0,1907310
icdC_predicted,0.5,1,1,ACCTGGCACGCACACGAAGG,0,1892086
icdC_predicted,0.5,1,1,ACCTATGGGATACCGGGGGT,0,1890237
icdC_predicted,0.5,1,1,ACCGTAACCGCCCACACAGA,0,1878139
icdC_predicted,0.5,1,1,ACCGCGGCTCTACACGGTCA,0,1893112
icdC_predicted,0.5,1,1,ACCGATACGCGTCGGGGAAT,0,1895120
icdC_predicted,0.5,1,1,ACCGAGGAGTCCTTGTTTGT,0,1909456
icdC_predicted,0.5,1,1,ACCCTCTTTCTACGCAATAC,0,1891649
icdC_predicted,0.5,1,1,ACCCTCGGCACCACACCTGT,0,1881462
icdC_predicted,0.5,1,1,ACCCGGGCGCTCCGTCAACT,0,1889123
icdC_predicted,0.5,1,1,ACCCGCGCGTGTTCTTGGTG,0,1906259
icdC_predicted,0.5,1,1,ACCCCTGTCGGTTTGCGGGT,0,1886743
icdC_predicted,0.5,1,1,ACCCCGGGAAATCATCTAGC,0,1906705
icdC_predicted,0.5,1,1,ACCATTGACTGCCATTTCAC,0,1906207
icdC_predicted,0.5,1,1,ACCAATCACTGAACCGAAAG,0,1905491
icdC_predicted,0.5,1,1,ACCAAGGCTGTCTCCGCAAG,0,1884991
icdC_predicted,0.5,1,1,ACCAAGACATGCCTAAGACA,0,1907435
icdC_predicted,0.5,1,1,ACCAAACGCTCAAACGCGGG,0,1896300
icdC_predicted,0.5,1,1,ACCAAAAATTCGGAGGACTA,0,1899192
icdC_predicted,0.5,1,1,ACATTCTCCCCTTGCGGCAC,0,1896189
icdC_predicted,0.5,1,1,ACATTAACTGGTAAAGGCAA,0,1887277
icdC_predicted,0.5,1,1,ACATCATTAATCCTATTTGC,0,1908475
icdC_predicted,0.5,1,1,ACAGTGGACTACTGCTGTTA,0,1906613
icdC_predicted,0.5,1,1,ACAGGCTTGCGTGGGAAGAT,0,1895769
icdC_predicted,0.5,1,1,ACACTCCATAATGGACCCTA,0,1902845
icdC_predicted,0.5,1,1,ACACTATGAAGACGTCAGGA,0,1906864
icdC_predicted,0.5,1,1,ACACTACGGAGGCCTTTGGT,0,1895719
icdC_predicted,0.5,1,1,ACACGTTCTCGCTGCATTGT,0,1905596
icdC_predicted,0.5,1,1,ACACGAGGGGACACAGAGGT,0,1886773
icdC_predicted,0.5,1,1,ACACAATGCAGCTCCTGTAG,0,1881129
icdC_predicted,0.5,1,1,ACAATTGAATTACTTGGCCT,0,1889784
icdC_predicted,0.5,1,1,ACAATTAACCTCTCGCATGT,0,1891524
icdC_predicted,0.5,1,1,ACAATGAGTTACAGGACTAT,0,1890539
icdC_predicted,0.5,1,1,ACAATGAAGATGCATTGATG,0,1905240
icdC_predicted,0.5,1,1,ACAAGTTTTTTAGGGCCGAT,0,1907905
icdC_predicted,0.5,1,1,ACAACAGTGGGGGTGCGTGG,0,1883327
icdC_predicted,0.5,1,1,ACAAAGACTGACCTGAGCCG,0,1897997
icdC_predicted,0.5,1,1,ACAAAAGGTAGCACAACCCT,0,1908053
icdC_predicted,0.5,1,1,AATTTGGTCTGTGCCTCTTG,0,1879304
icdC_predicted,0.5,1,1,AATTGGGGGTGTCCATCTAA,0,1898269
icdC_predicted,0.5,1,1,AATTGCGCTGGGCTTACCAT,0,1906755
icdC_predicted,0.5,1,1,AATTACTTCGTCCGCCCGTT,0,1906562
icdC_predicted,0.5,1,1,AATGTCTATAGGAACCGCAG,0,1880821
icdC_predicted,0.5,1,1,AATGGTTCTCTCATCTTTCG,0,1882854
icdC_predicted,0.5,1,1,AATGAATGTTTCGCGCGTTC,0,1903867
icdC_predicted,0.5,1,1,AATCCCGCGGACGACGGTGT,0,1879957
icdC_predicted,0.5,1,1,AATCAGCGGAAAAGCCTCTC,0,1893700
icdC_predicted,0.5,1,1,AATCACGAACCGCTTGGTGA,0,1884385
icdC_predicted,0.5,1,1,AATATTTGGCTGCTAGGACT,0,1880711
icdC_predicted,0.5,1,1,AATATCGTGGCCTTGAGGAC,0,1891131
icdC_predicted,0.5,1,1,AATAGTCGCAAACGGCGACT,0,1906842
icdC_predicted,0.5,1,1,AATAGGTATTTGATAGCGCC,0,1886955
icdC_predicted,0.5,1,1,AATACGTATTTATTAGCTTT,0,1907448
icdC_predicted,0.5,1,1,AATACCGGGTCGGCGGATAC,0,1902508
icdC_predicted,0.5,1,1,AAGTTATATATGGAAAGTTC,0,1886975
icdC_predicted,0.5,1,1,AAGTCTTCTATCCGGCTAAG,0,1906971
icdC_predicted,0.5,1,1,AAGTCTGCTCTTTCTCCCAA,0,1887359
icdC_predicted,0.5,1,1,AAGTCGATAACGCTACAACT,0,1900671
icdC_predicted,0.5,1,1,AAGTCCGTCCCCACACCGAC,0,1897892
icdC_predicted,0.5,1,1,AAGGTTACGTATACAATGGT,0,1890446
icdC_predicted,0.5,1,1,AAGGTGAGTAGCCACTCAGC,0,1904014
icdC_predicted,0.5,1,1,AAGGGGGCTGGCCGTCCTGC,0,1893453
icdC_predicted,0.5,1,1,AAGGGACCGTGCTCATATCT,0,1906363
icdC_predicted,0.5,1,1,AAGGCTTTCGGTGTTAGTCC,0,1898818
icdC_predicted,0.5,1,1,AAGGAACGTGCGGGGGTGAG,0,1896150
icdC_predicted,0.5,1,1,AAGCGGGTAGGTTCTTCGGA,0,1890131
icdC_predicted,0.5,1,1,AAGCAGCGCGAAGCCCAGTA,0,1891372
icdC_predicted,0.5,1,1,AAGCAGAAATTACCTCCGCT,0,1902002
icdC_predicted,0.5,1,1,AAGATAATCCCGAAACTCGC,0,1889398
icdC_predicted,0.5,1,1,AAGACTAGGTGTAGAAAGGA,0,1879435
icdC_predicted,0.5,1,1,AAGACCGGGTATTCAGGGTT,0,1888396
icdC_predicted,0.5,1,1,AAGAATCATAATTGTTCTAA,0,1908699
icdC_predicted,0.5,1,1,AAGAACTTTACTGTTCTAAA,0,1901303
icdC_predicted,0.5,1,1,AACTTAGCATCTGTGTGTGG,0,1894926
icdC_predicted,0.5,1,1,AACTTAACCCTCGATCGTGC,0,1878308
icdC_predicted,0.5,1,1,AACTTAACCCGTTGGACGTC,0,1884168
icdC_predicted,0.5,1,1,AACTCTAAGTTTCAAAAACA,0,1887890
icdC_predicted,0.5,1,1,AACGGGATCTACAGGTGTGT,0,1905519
icdC_predicted,0.5,1,1,AACGCATCTACTATTGATCC,0,1907137
icdC_predicted,0.5,1,1,AACGATAGCCTGAAGTATGG,0,1895570
icdC_predicted,0.5,1,1,AACCTATATCGGAAAAGGTC,0,1892391
icdC_predicted,0.5,1,1,AACCATCAAACTCTTTGTAC,0,1896977
icdC_predicted,0.5,1,1,AACCACTGGGTTAATCATTC,0,1880015
icdC_predicted,0.5,1,1,AACATATTCCACCCGAGGCT,0,1897701
icdC_predicted,0.5,1,1,AACAGTGAATGGTATCGATA,0,1881988
icdC_predicted,0.5,1,1,AACAGGCAGCCAAGTACAAA,0,1904507
icdC_predicted,0.5,1,1,AACACGTCAAAGGGACGCGC,0,1881720
icdC_predicted,0.5,1,1,AACACAGTCGATATTTTTGG,0,1899945
icdC_predicted,0.5,1,1,AAATGATAGGCGAATCGAGT,0,1904004
icdC_predicted,0.5,1,1,AAATCCCAATGCAAAGGTAG,0,1897610
icdC_predicted,0.5,1,1,AAATAGACTGCAGTCTACCC,0,1878938
icdC_predicted,0.5,1,1,AAAGTTAGATTGCTTTGGAA,0,1888699
icdC_predicted,0.5,1,1,AAAGGCCTTTTAGCACCACT,0,1906089
icdC_predicted,0.5,1,1,AAAGGATACTACTTCACCAG,0,1882196
icdC_predicted,0.5,1,1,AAAGCTAAGGGGCGGGGCCG,0,1890324
icdC_predicted,0.5,1,1,AAAGAGTAAATGGCCGCAAC,0,1891626
icdC_predicted,0.5,1,1,AAACTTTCGCTCGATATTGG,0,1887158
icdC_predicted,0.5,1,1,AAACTAACCGAAGCGTAGAG,0,1904634
icdC_predicted,0.5,1,1,AAACGGCCTTAGTCAGGACC,0,1890739
icdC_predicted,0.5,1,1,AAACAGGGGCAATCATACTG,0,1896076
icdC_predicted,0.5,1,1,AAAATATGGCACGCGGGAGA,0,1878374
icdC_predicted,0.5,1,1,AAAAGAGTATCGACCAATCG,0,1892561
icdC_predicted,0.5,1,1,AAAACGAGATTCACAGCTTA,0,1896917
icdC_predicted,0.5,1,1,AAAACCGCACGTACACTATT,0,1899780
icdC_predicted,71.0,70,0,TCCACAATCTGAGCCAGATG,70,1907162
icdC_predicted,66.0,65,0,TACAATCCCTGTCCTGCTTA,65,1891850
icdC_predicted,60.0,59,0,TCAGAGCACGCGAAATGGCT,59,1888679
icdC_predicted,60.0,59,0,AGCGTCATACTTTTGAAATA,59,1898160
icdC_predicted,57.0,56,0,GAAAGCGGTAATAATGTAAA,56,1889647
icdC_predicted,54.0,53,0,ATTTCTTGGGATGACCAGAG,53,1896230
icdC_predicted,49.0,48,0,CTCAGATCCGCACTTATCGT,48,1889703
icdC_predicted,46.0,45,0,TTAGTGCGCCGTGAGATGTA,45,1899435
icdC_predicted,45.0,44,0,TATTCAGTGCTCTTTAAGTT,44,1896245
icdC_predicted,44.0,43,0,AGTTATGCCAAGCGTCCGCT,43,1905636
icdC_predicted,42.0,41,0,CATCTCCTCATGAGGCGCTC,41,1897566
icdC_predicted,39.0,38,0,CCCTTGATAGCATAGACAAT,38,1902917
icdC_predicted,38.0,37,0,GAAGTGAATGCCGGGAACGG,37,1889106
icdC_predicted,37.0,36,0,CCATGAACTTAAAATCTAGG,36,1887120
icdC_predicted,36.0,35,0,TCTGCCGGGCATTCTTCTGA,35,1899895
icdC_predicted,35.0,34,0,TTGGAGAGGAGAAGTACTCC,34,1890240
icdC_predicted,35.0,34,0,TGACAAAGCAGCGACTCTAA,34,1892552
icdC_predicted,34.0,33,0,TCTGCAGTTTTTTAATTCAC,33,1895465
icdC_predicted,34.0,33,0,TAACAAGCTGGGTGTCAACG,33,1905414
icdC_predicted,34.0,33,0,GTTGTCCAGTGGCAAGAGAG,33,1899051
icdC_predicted,33.0,32,0,GCTGCGTCTGCCAGTGTGTC,32,1889230
icdC_predicted,33.0,32,0,GCCGCTCCTTTTCGGATTAC,32,1898765
icdC_predicted,33.0,32,0,ATGTGTATACGGAACTTGGA,32,1900314
icdC_predicted,32.0,31,0,TCCTGAACGGGTTGGCGAGA,31,1898293
icdC_predicted,30.0,29,0,GCGTCGCCGCGTAGACAATT,29,1903036
icdC_predicted,29.0,28,0,GGGGCGAAATCCAGGTAATC,28,1879145
icdC_predicted,28.0,27,0,AGGGCTGCGCGGGGGTGGAG,27,1896004
icdC_predicted,28.0,27,0,AACTGGTCAAGGCTCTGCTC,27,1899431
icdC_predicted,27.0,26,0,TCGGTTAAAACGCAAGGACT,26,1883423
icdC_predicted,27.0,26,0,GGACAGACCTTCATCTGCCG,26,1907748
icdC_predicted,27.0,26,0,AACGTAAACAACTAACTGAA,26,1881991
icdC_predicted,26.0,25,0,GTGCCGCTCTACCTGCAATT,25,1890780
icdC_predicted,26.0,25,0,CCTATTGTCGATTGTCATTG,25,1896504
icdC_predicted,25.0,24,0,TGTGGCTCCTAGTCATCAGA,24,1881992
icdC_predicted,25.0,24,0,GACAAACTTCACGGCATCGT,24,1883428
icdC_predicted,25.0,24,0,CCTAGATATACTAAATTGAT,24,1907273
icdC_predicted,25.0,24,0,CCCGTTTTTAGTATCCAGGC,24,1890154
icdC_predicted,24.0,23,0,TTCAGGGGGACGCTCGCCCC,23,1878752
icdC_predicted,24.0,23,0,TCCTTACTGGCAGATGTTTA,23,1887726
icdC_predicted,24.0,23,0,GTTCCCGTGAGTGCACAAGG,23,1886512
icdC_predicted,24.0,23,0,GTGTCAGGCCCTACCTAATT,23,1887283
icdC_predicted,24.0,23,0,GTCATTTCCGACACATATAC,23,1879319
icdC_predicted,23.0,22,0,TGCATGCACGGGGCTAACGC,22,1893464
icdC_predicted,23.0,22,0,GTAACTTCGCTTTTGCGCCC,22,1896381
icdC_predicted,23.0,22,0,CTGTCGCATCCGGTATAATT,22,1879543
icdC_predicted,23.0,22,0,AGTAAGTCTCAAAAGTTCAC,22,1883930
icdC_predicted,22.0,21,0,TTTTGAATCAAGCGACGGTA,21,1897568
icdC_predicted,22.0,21,0,TTTTAAAGTCTAAACGGGGT,21,1882309
icdC_predicted,22.0,21,0,TCGAGGAGGACTATCCGATT,21,1890437
icdC_predicted,22.0,21,0,GGACGATAGGGACGATCGCG,21,1903963
icdC_predicted,22.0,21,0,GAGCAATCTTCTGTTATGTC,21,1888851
icdC_predicted,22.0,21,0,CTTTTGATACCAATACCCTT,21,1901971
icdC_predicted,22.0,21,0,AGACAAGATCGCGATGAGGG,21,1905682
icdC_predicted,22.0,21,0,ACTCGCGCGAGTAAATTGGC,21,1888013
icdC_predicted,22.0,21,0,ACGCTTTTGAAATCAAGATC,21,1891488
icdC_predicted,21.0,20,0,TGGCACGGCGGGTGTCAGCT,20,1879520
icdC_predicted,21.0,20,0,TCGAGACAGTGCTGTGCTGT,20,1878566
icdC_predicted,21.0,20,0,GTCCTGGAGCCAAAGGTGGG,20,1898970
icdC_predicted,21.0,20,0,GGCGTCTACGGACTAGCCAA,20,1896581
icdC_predicted,21.0,20,0,GGAGAAGCTAGACCCGCGGG,20,1881124
icdC_predicted,21.0,20,0,CGCGGTGGTTTCAATCGGCA,20,1896216
icdC_predicted,21.0,20,0,CCCCTCAGCCTAGGTATCTT,20,1896258
icdC_predicted,21.0,20,0,CACGCGGCATCCAGTTAAGA,20,1901551
icdC_predicted,21.0,20,0,ACGATACGATCCGAGGTAAC,20,1897123
icdC_predicted,20.0,19,0,TTTATGAATCAGAAAGGATG,19,1894868
icdC_predicted,20.0,19,0,TTGTTTTACGGTCGATGACA,19,1897426
icdC_predicted,20.0,19,0,GTTAAAATCGTTGTTTACGA,19,1896828
icdC_predicted,20.0,19,0,ATAACAATTGGCGGACAGTG,19,1892159
icdC_predicted,20.0,19,0,ACCCGTAGGACCGTACGGTC,19,1886499
icdC_predicted,19.0,18,0,TGAAAGACGACCGATAATGA,18,1887231
icdC_predicted,19.0,18,0,TCACCCAGAGATAAGGTAAG,18,1900630
icdC_predicted,19.0,18,0,CTATGGATACGCGATGATTC,18,1883039
icdC_predicted,19.0,18,0,CCTGTTCCGATCGTCTGTGG,18,1888037
icdC_predicted,19.0,18,0,CAGAAGGAAACAGATCTTTC,18,1907613
icdC_predicted,19.0,18,0,ATAGAAGGATGCCTGCTAAA,18,1887521
icdC_predicted,19.0,18,0,AAGTCTCGGGTTATAGGAGT,18,1903697
icdC_predicted,18.0,17,0,TTGGGCGGTCTCCGTGAGAC,17,1906194
icdC_predicted,18.0,17,0,TCAGGATAATTCTTTAACGG,17,1883710
icdC_predicted,18.0,17,0,GATACCCTGTCGCGTTAGTA,17,1899278
icdC_predicted,18.0,17,0,CAGCAAGGCGGGGTAGGGAT,17,1888421
icdC_predicted,18.0,17,0,CAACATTGTTATCGAGAATG,17,1889073
icdC_predicted,18.0,17,0,AGTGAAGGGGAATAGTGAAC,17,1904200
icdC_predicted,17.0,16,0,TGGCCTGACGTTCTACTCAA,16,1908494
icdC_predicted,17.0,16,0,TGACTACCCACAAGTCAAAG,16,1898786
icdC_predicted,17.0,16,0,GTGCGGGGAAAGAATTAACT,16,1883926
icdC_predicted,17.0,16,0,GTCTGATCGCTACCTGTCCA,16,1906683
icdC_predicted,17.0,16,0,GGAACTCTGTGTAGATGGTA,16,1884849
icdC_predicted,17.0,16,0,GCCTACTACAGTAATCAACT,16,1901604
icdC_predicted,17.0,16,0,GATAGCTCGTATACTCCTAC,16,1897053
icdC_predicted,17.0,16,0,GACCAACTCCTACACGAACG,16,1891221
icdC_predicted,17.0,16,0,CTGACCTTTAATAGTGCGCC,16,1906375
icdC_predicted,17.0,16,0,CTACTAACTACCGGGAGACA,16,1877933
icdC_predicted,17.0,16,0,CGGTGCCTAATTGACCGCAT,16,1900892
icdC_predicted,17.0,16,0,CAAGAGGATTAGCAGTAGAC,16,1896172
icdC_predicted,17.0,16,0,ACCCGAGCAATGCCTCTTAG,16,1894984
icdC_predicted,17.0,16,0,AAGCTGAATCGGAATACCAC,16,1885016
icdC_predicted,17.0,16,0,AACTGCACTCTTTTCGCAAC,16,1882498
icdC_predicted,16.0,15,0,TTGAATTAACTTAACAAGAC,15,1882922
icdC_predicted,16.0,15,0,TGAAGGACTAAGACGCTGCC,15,1909033
icdC_predicted,16.0,15,0,CTCGGTAACTCGTGGGAGAC,15,1884358
icdC_predicted,15.0,14,0,CCCGTGGGGAGCGCTAACCC,14,1882443
icdC_predicted,15.0,14,0,AAGTTGTTGGAGGGGCTTAG,14,1907320
icdC_predicted,15.0,14,0,AAATCAGCTATTCAAATGCA,14,1907910
icdC_predicted,14.0,13,0,TGATCCCCGTTATGTGGATC,13,1908908
icdC_predicted,14.0,13,0,GTACGTATCGGGGACACTAC,13,1904015
icdC_predicted,14.0,13,0,GGGACTGCGACAATTGATGC,13,1881808
icdC_predicted,14.0,13,0,ATCCTGCCACAGGTGAGTAA,13,1879306
icdC_predicted,14.0,13,0,ATATCAAGGTCTATGCAAAA,13,1907784
icdC_predicted,14.0,13,0,ACGTCACAAGGGGTGCTGTT,13,1891703
icdC_predicted,14.0,13,0,AAGGAAGACATGCATTCGAC,13,1891744
icdC_predicted,13.0,12,0,TGACGTATTAGTTATGGACA,12,1900316
icdC_predicted,13.0,12,0,TCCACAGGAGTGGTTGTAGT,12,1901479
icdC_predicted,13.0,12,0,GTTTGTGTTTCGACCAGTTA,12,1884027
icdC_predicted,13.0,12,0,GGGTATGGGGGAACTGACTA,12,1905162
icdC_predicted,13.0,12,0,GGCAACCGAGGAACTTCGGC,12,1884810
icdC_predicted,13.0,12,0,GCGCTGTAAGGTTAATATGC,12,1878336
icdC_predicted,13.0,12,0,GACTACCTACCTGTCCCATC,12,1888947
icdC_predicted,13.0,12,0,CTCTCGGCGCCAGAGGCTTA,12,1892381
icdC_predicted,13.0,12,0,CGGCCCGTCAAACTTGTGTT,12,1905070
icdC_predicted,13.0,12,0,AGGTCGCCACTTCTCGGAGG,12,1901927
icdC_predicted,13.0,12,0,ACCTCTATTTTTGGGCGGTC,12,1893188
icdC_predicted,12.0,11,0,TTCTAAACCAATAATAGGAA,11,1895992
icdC_predicted,12.0,11,0,TGGCCACGAGTCCCCTATGG,11,1891659
icdC_predicted,12.0,11,0,TGCCCGGTGCGACGAGCCAA,11,1903649
icdC_predicted,12.0,11,0,TAGCTTCGGCAGGCTCTGAC,11,1894461
icdC_predicted,12.0,11,0,TACTCCAAGAAGGGTTCAAG,11,1898888
icdC_predicted,12.0,11,0,GCAGGAGAATAAGGAGATCA,11,1902445
icdC_predicted,12.0,11,0,GACACGGTAAGGGGTCCATC,11,1905556
icdC_predicted,12.0,11,0,CAAGCTTCTACGACATGGCG,11,1902620
icdC_predicted,12.0,11,0,AGCTTGCACAGGCGTAGTGA,11,1879692
icdC_predicted,11.0,10,0,TGCGCGCCAAGTACGGGGGT,10,1886998
icdC_predicted,11.0,10,0,AAATTTGTTTTTAGTTGAGG,10,1903385
icdC_predicted,10.0,9,0,TTGACATTGTCAATAACAAG,9,1885031
icdC_predicted,10.0,9,0,GAAATTAGCCCTTCAGTTAG,9,1882942
icdC_predicted,10.0,9,0,CGGATGAACGATATTCACGA,9,1904175
icdC_predicted,10.0,9,0,CCTCATAGTTCTCGGGCGAT,9,1908553
icdC_predicted,10.0,9,0,CCCCTAAAGGAAAAGAATTG,9,1886660
icdC_predicted,10.0,9,0,ATGCCATTCGATACAGAAAA,9,1893042
icdC_predicted,10.0,9,0,ATCATCCATGGCTTCTGAAG,9,1886005
icdC_predicted,10.0,9,0,AATAAGGAGTTGTCGGCATT,9,1904250
icdC_predicted,10.0,9,0,AAGTGAAAGCGCAAGGGTAC,9,1879897
icdC_predicted,9.0,8,0,TCAAGAAGGTAACCATGTTT,8,1886622
icdC_predicted,9.0,8,0,TATTACGTATGTTGCATCAA,8,1885908
icdC_predicted,9.0,8,0,GTACTACGGGGGGATTACGC,8,1889360
icdC_predicted,9.0,8,0,GACGGATTGGTACTTTCGTA,8,1906908
icdC_predicted,9.0,8,0,CGCTCATCTCACCTAGAATC,8,1884918
icdC_predicted,9.0,8,0,ATACAGGGGTGTTGGTACTT,8,1884939
icdC_predicted,9.0,8,0,AACGTTCGTCTAATATATTC,8,1891064
icdC_predicted,8.0,7,0,TCTATAAAACGCCGCCACCA,7,1885264
icdC_predicted,8.0,7,0,TACGGAATCATACCATCGTT,7,1880095
icdC_predicted,8.0,7,0,TACCCGGCTGTACCTCGTGT,7,1906708
icdC_predicted,8.0,7,0,GGTAAGTTCCTCTCCCCGGA,7,1909268
icdC_predicted,8.0,7,0,GCAGTCTAGCATAGTCCGTT,7,1909041
icdC_predicted,8.0,7,0,CTCGGTCTCAGGAATCTCTA,7,1887621
icdC_predicted,8.0,7,0,CGCGTAGCAACACTTCCACA,7,1892156
icdC_predicted,8.0,7,0,ACTGGTGACGCGCGCATTCC,7,1877894
icdC_predicted,8.0,7,0,ACAGCGGCGCGGTTAAACGC,7,1879123
icdC_predicted,8.0,7,0,AATCAGATGGACTCCGAAAG,7,1897185
icdC_predicted,7.0,6,0,TGAGAGATGAACGTTGTCTC,6,1904395
icdC_predicted,7.0,6,0,GCAGGTGTGTACAGGTTGGA,6,1895875
icdC_predicted,7.0,6,0,GAAAATCCGCCACGCTTATG,6,1903206
icdC_predicted,7.0,6,0,ACTAATGAAGAGTTGCGCGG,6,1906446
icdC_predicted,7.0,6,0,ACAGGGAGATAACCGTGCGA,6,1880014
icdC_predicted,6.0,5,0,TAATTAAAATAACTACTCTG,5,1893230
icdC_predicted,6.0,5,0,GTTAAATCCAGGGCAATCGC,5,1881380
icdC_predicted,6.0,5,0,GTGACCGTGAACACCAGTTC,5,1884795
icdC_predicted,6.0,5,0,GGCATCGTTGGTCCCATATG,5,1887543
icdC_predicted,6.0,5,0,CGCTAAAAGGCGTCGGTTTG,5,1903995
icdC_predicted,6.0,5,0,CCAAACCGAAGCCACATTGA,5,1882989
icdC_predicted,6.0,5,0,ACTTAGCGGTAACAGACTTT,5,1895900
icdC_predicted,5.0,4,0,TCAATCTCCTTGCGGTACGA,4,1888788
icdC_predicted,5.0,4,0,CGAAACCGAGTACATTGCGT,4,1908892
icdC_predicted,5.0,4,0,ATCCGTGTCTGGCCTTGTAT,4,1899884
icdC_predicted,4.0,3,0,TAGGTCCCGGGCAATCTAAT,3,1878936
icdC_predicted,4.0,3,0,GGGATCGACACACCGTGGAC,3,1899812
icdC_predicted,4.0,3,0,CCAGTCTGCATAACTTGGCT,3,1904445
icdC_predicted,4.0,3,0,CCAAGAGATCTGGTATCCTC,3,1897949
icdC_predicted,4.0,3,0,ACAGAGGCCATGGGTAGATA,3,1880642
icdC_predicted,3.0,2,0,TGTTAATGCTCACACTGTAG,2,1880369
icdC_predicted,3.0,2,0,TATTACGTGTTCATGTCATT,2,1903771
icdC_predicted,3.0,2,0,GTTGGGACCGTCCCTCCGAC,2,1905957
icdC_predicted,3.0,2,0,GTAGATTTCGTGGAGGCTAA,2,1884970
icdC_predicted,3.0,2,0,CCGTTCTACTCCACGGTTAA,2,1895005
icdC_predicted,3.0,2,0,CCCCCTTTGGGACAGTTCAT,2,1888641
icdC_predicted,3.0,2,0,CAGTTGCACATATTAGAGCG,2,1904526
icdC_predicted,2.0,1,0,TTCTTTTCTTTACGCCAACT,1,1901965
icdC_predicted,2.0,1,0,TTCCAACAGAGATCGTCGAG,1,1906142
icdC_predicted,2.0,1,0,TTACGTCTGCAGTCATCCTA,1,1883605
icdC_predicted,2.0,1,0,TCAGAAATGCTTGTTTTGGA,1,1897391
icdC_predicted,2.0,1,0,TACGCAATCGTGGCATCCCC,1,1903843
icdC_predicted,2.0,1,0,GTGCCCTGCTCCTGACTACT,1,1909220
icdC_predicted,2.0,1,0,GTATTTACCAGTGTTGGTTC,1,1888504
icdC_predicted,2.0,1,0,GTAAGAAAATTACAACTTAT,1,1892771
icdC_predicted,2.0,1,0,GGCGACTTCCCTCCCGTCAA,1,1904798
icdC_predicted,2.0,1,0,GGCCTTTACTTAAATCCGAC,1,1882009
icdC_predicted,2.0,1,0,GCTCGTTAGCGGACTTGAAC,1,1902162
icdC_predicted,2.0,1,0,GCTCCCAGATAAATCAGATC,1,1884412
icdC_predicted,2.0,1,0,GCTAAAACCACAGGCGCGGG,1,1905551
icdC_predicted,2.0,1,0,GCGTTTCGGTGCGGTTTTAA,1,1904984
icdC_predicted,2.0,1,0,GCGGCCATCAATGAAAGGAA,1,1885458
icdC_predicted,2.0,1,0,GCCAAGTCTGACTGGCACTC,1,1907092
icdC_predicted,2.0,1,0,GCAATTGCGGCAAAACCCGC,1,1881510
icdC_predicted,2.0,1,0,GATATGGTACCGCTGACCTT,1,1894861
icdC_predicted,2.0,1,0,GACCGTGTTGTCGTTCCAGA,1,1900550
icdC_predicted,2.0,1,0,CTGACACTGGGAATCTTAAT,1,1886105
icdC_predicted,2.0,1,0,CGTAAATCGTGGATAGGTTC,1,1892461
icdC_predicted,2.0,1,0,CGGTTCATTATTGGCGCGAA,1,1879032
icdC_predicted,2.0,1,0,CCTGATTTTAATCAAGGTCT,1,1887665
icdC_predicted,2.0,1,0,CCGAGGTCCAGCTAGAAGCA,1,1882485
icdC_predicted,2.0,1,0,CCCCATGTGGGGAGGGTTTC,1,1897606
icdC_predicted,2.0,1,0,CATTTAACCCACGTGCCATT,1,1891076
icdC_predicted,2.0,1,0,CATCATCATACCAGTGTTGG,1,1890651
icdC_predicted,2.0,1,0,CATCACCCCGCTTCCTCTGA,1,1878817
icdC_predicted,2.0,1,0,CATACGTTGTCAGACGATTA,1,1894520
icdC_predicted,2.0,1,0,CACCACAACTATGATCTGTG,1,1889682
icdC_predicted,2.0,1,0,ATCGGATACTTAGTGCAACT,1,1891159
icdC_predicted,2.0,1,0,AGGTCTTTATTACAGTATCC,1,1897591
icdC_predicted,2.0,1,0,AGGCAGTAAAGAGTAAGTGA,1,1886413
icdC_predicted,2.0,1,0,AGGATACTAAAATGCGAGTA,1,1894735
icdC_predicted,2.0,1,0,AGGAGATGGAGACGGTATCT,1,1886864
icdC_predicted,2.0,1,0,ACTCTTGAGTGGCCTGGATT,1,1884767
icdC_predicted,2.0,1,0,ACTATTACGTCTCTCCTAAA,1,1886630
icdC_predicted,2.0,1,0,ACCACAGAAACAGAACAATA,1,1891176
icdC_predicted,2.0,1,0,ACAACTCGCCCCAAATTCTC,1,1897511
icdC_predicted,2.0,1,0,AACTTCTGCGCCCGCTGAAT,1,1885685
