name,relative_counts,ct,ct_0,barcode,ct_1,barcode_ind
gyrAp,2.4157303370786516,302,88,CCGAGTTTGTGGCACAAGCA,214,1749131
gyrAp,1.5119047619047619,209,83,GTGTGGCACCGACCATTGAG,126,1765508
gyrAp,0.7407407407407407,139,80,CACACGTCAGTGTCACTCTA,59,1741535
gyrAp,0.5128205128205128,116,77,TGCTGCCGAAGTTCGCGTAT,39,1741819
gyrAp,0.6052631578947368,120,75,AGAGTCCGCCAAGCGTGTCA,45,1765923
gyrAp,0.32857142857142857,91,69,AACCTAGGTTTGAGGGCTCA,22,1741685
gyrAp,0.927536231884058,131,68,CCCAAGTGCTTAGGGCAAGA,63,1741579
gyrAp,0.15151515151515152,74,65,ATGAATGGTCTATCCAGTCA,9,1742888
gyrAp,0.8225806451612904,111,61,CTCTAAGCCCGTGCATCTGG,50,1758678
gyrAp,0.1724137931034483,66,57,CGCTGCCAGTAATGTTCCAC,9,1763073
gyrAp,2.789473684210526,214,56,AGAGTTCAGACACTTAGGAC,158,1767997
gyrAp,1.2,119,54,GATGTATTCTGCAATCATGT,65,1746069
gyrAp,0.6909090909090909,91,54,CAAGGGCAACCATGTGGGTC,37,1742397
gyrAp,0.9074074074074074,101,53,TTCACGCCCCCCACTAGATG,48,1749702
gyrAp,0.39215686274509803,69,50,CTGGTTCGGAAAATCGGACA,19,1764771
gyrAp,0.8823529411764706,94,50,CTGCGATGTGCGCTGGTTCT,44,1742346
gyrAp,2.0,148,49,CCGCGCATGCGGGGATTCTA,99,1758866
gyrAp,2.673469387755102,178,48,CGGTTCCGATCCAAGAACTT,130,1754651
gyrAp,2.489795918367347,169,48,ATTCATCTTTATTACCTATA,121,1747677
gyrAp,1.489795918367347,120,48,ATATATACCTAATGCTCTTT,72,1748686
gyrAp,1.4375,115,47,ATCCGATATGCATAGCGGTA,68,1747026
gyrAp,0.6170212765957447,74,46,TCCAGATATACAAATGCCGT,28,1762341
gyrAp,0.8297872340425532,84,46,GGCCTCCTTCGACATACTTA,38,1751124
gyrAp,0.3404255319148936,61,46,GGATATTACTCAAACGGCGC,15,1744233
gyrAp,1.8297872340425532,131,46,GCGCCGGGCAGAGGTGAGAC,85,1744720
gyrAp,0.46808510638297873,67,46,ACGGAGGTTCTTATAGATCA,21,1753156
gyrAp,0.7608695652173914,79,45,CTATCCCTAGCACCCCGTCA,34,1759738
gyrAp,0.043478260869565216,46,45,ACAATCTGGAGGCACATCTT,1,1742232
gyrAp,0.9777777777777777,87,44,TTTTTAATCCCTGTTATTCA,43,1743835
gyrAp,0.8222222222222222,80,44,TGCTTATTGGACTTTATGAG,36,1748560
gyrAp,1.9777777777777779,132,44,GGAGGGGATAGAATCTAGAA,88,1743788
gyrAp,0.37777777777777777,60,44,ATTCGGGCATACGCAAAGGA,16,1759781
gyrAp,0.8444444444444444,81,44,ACGTTCAACATAGGCATATA,37,1756288
gyrAp,0.045454545454545456,44,43,GGGGTAGTTCACGTGGCTGC,1,1762449
gyrAp,0.9090909090909091,82,43,CTAAGCACCTCGTTAGGGAT,39,1762930
gyrAp,0.4772727272727273,63,43,AAAGTACCACGATGAACCGA,20,1753215
gyrAp,1.372093023255814,100,42,TAATATGTCCATCTCTCCGT,58,1757343
gyrAp,0.627906976744186,68,42,GGATCACGGCTCCAATGACT,26,1746614
gyrAp,0.09302325581395349,45,42,GATGTAGGAGGTGCGGGAGT,3,1755606
gyrAp,0.9523809523809523,80,41,GCCTAGACGTTGGACATCTC,39,1748705
gyrAp,0.16666666666666666,47,41,GAACGCGCAATGAACCGCTG,6,1755455
gyrAp,0.17073170731707318,46,40,TGCTCCCCTACCGTCTCAGC,6,1757255
gyrAp,2.268292682926829,132,40,TCTAAGGTTCCGGAAAGGTC,92,1755925
gyrAp,1.6585365853658536,107,40,GTCGGGCCTCATGTGACAAC,67,1750683
gyrAp,0.45,56,39,GTCAGGAACAATTGCTGCTA,17,1743751
gyrAp,0.05,40,39,CGACTCCGCGGCTCGATCCA,1,1760715
gyrAp,11.9,514,39,ACCGTAGGGTACAATATAGA,475,1746808
gyrAp,4.153846153846154,199,38,GGTCCTCACAAATGTCAACT,161,1752308
gyrAp,0.5384615384615384,58,38,GAGGTCACGTGGTTATATTA,20,1754166
gyrAp,0.42105263157894735,52,37,CTATCCGCTAAAGAGTACCG,15,1742607
gyrAp,0.5,55,37,AATCAGTTCGTCTCAGGAGA,18,1743383
gyrAp,1.105263157894737,78,37,AAGCGCAGGGGCGGAATGAA,41,1746271
gyrAp,0.05263157894736842,38,37,AACGAAGCAGTGGTTACTTA,1,1746087
gyrAp,0.32432432432432434,47,36,TAGCGCGAGAATTTGTCAGA,11,1749356
gyrAp,1.4054054054054055,87,36,TAAGTTTTACTCCGAGGTAC,51,1745512
gyrAp,3.675675675675676,171,36,GTCGGACCCGGTATCAACTG,135,1763927
gyrAp,0.7837837837837838,64,36,CTCAACATTACTGGGAGTCG,28,1741913
gyrAp,2.2432432432432434,118,36,CCGTGTACACTTTGTGAGTT,82,1758086
gyrAp,1.3611111111111112,83,35,TCGGGAGCCACCGTTGTGAG,48,1741508
gyrAp,4.222222222222222,186,35,GCCTCCCCCGGGCGCTATAC,151,1757966
gyrAp,0.9166666666666666,67,35,GCACGTATACGACAAATGAT,32,1753113
gyrAp,0.5277777777777778,53,35,ATAACTTCCGATGATGGAAT,18,1750681
gyrAp,0.9444444444444444,68,35,AGCCTCCGCAGGTAATGAGT,33,1744071
gyrAp,0.1388888888888889,39,35,ACGCTCTAACGCAAAGGTTA,4,1745136
gyrAp,1.7714285714285714,95,34,TTGAGTGTAGTAATGGGCGT,61,1764423
gyrAp,1.3428571428571427,80,34,TGGCACCGTCTATCGTATAA,46,1750611
gyrAp,1.7428571428571429,94,34,GATATGAGTACATCAACGTG,60,1745007
gyrAp,0.8,61,34,GACTGGGCCATGAGGGCATA,27,1754996
gyrAp,0.37142857142857144,46,34,CGCGGCCAAAATGCGCCTTT,12,1748890
gyrAp,0.14285714285714285,38,34,AGAAACGAGGTACTATCTTG,4,1755527
gyrAp,0.5294117647058824,50,33,TTCGAGCTCTGAAGTTTAGG,17,1754518
gyrAp,0.8529411764705882,61,33,TTAAACCCCTTTTCAGACTT,28,1757423
gyrAp,0.8529411764705882,61,33,TCGTGCAGTGGCCTGATGCT,28,1751750
gyrAp,0.20588235294117646,39,33,GGAAGGGTGCTGTACAGGGG,6,1744916
gyrAp,0.4117647058823529,46,33,CGTGGGAGCGATATTACTAT,13,1752587
gyrAp,2.2941176470588234,110,33,CCCTATAAAAGGCAGCAAAA,77,1759046
gyrAp,0.29411764705882354,42,33,CACGATCAATAGAGTCGTAT,9,1744324
gyrAp,2.088235294117647,103,33,ATGACAATGGTTCAAACAGT,70,1741511
gyrAp,1.6764705882352942,89,33,ATATGGCCTTCCAGTTTAGA,56,1753198
gyrAp,0.17647058823529413,38,33,AGCATATGAGCGTTCAACTG,5,1741820
gyrAp,1.088235294117647,69,33,AATAACTTGGCCCCGGACAA,36,1749919
gyrAp,1.2121212121212122,71,32,TTGGTCGGCACAAGCCACCG,39,1765677
gyrAp,3.696969696969697,153,32,TGCTCGTATGCAGGATGGTT,121,1769731
gyrAp,0.30303030303030304,41,32,TCTTCACGGTTCACAGTCAG,9,1767625
gyrAp,1.0,64,32,TCTATAGACTGGCACTGCGT,32,1759244
gyrAp,1.5151515151515151,81,32,TCAACACATCAGGGCATCTT,49,1751126
gyrAp,4.090909090909091,166,32,CTGGAAACGACTACCTTACG,134,1748935
gyrAp,0.9090909090909091,61,32,CGAGCTCTGGTTCATAGGCT,29,1746528
gyrAp,0.7878787878787878,57,32,CCAGGATTTGATATTCAAGT,25,1755115
gyrAp,0.65625,51,31,TCACACATCCTGCTGTGATA,20,1741946
gyrAp,0.75,54,31,TACAACGACTGATCACATGG,23,1764551
gyrAp,1.53125,79,31,TAAAGGAGCCAGATCTTGAA,48,1744578
gyrAp,0.78125,55,31,GGATGAGTTAGCAGCGGAGG,24,1743358
gyrAp,1.625,82,31,CTCGCGCCTCGAATATATTG,51,1741626
gyrAp,0.09375,33,31,CGTTCACAACCGTTTCTGCA,2,1742106
gyrAp,0.65625,51,31,ATTGGTACCTAAAGGAATTG,20,1742636
gyrAp,0.125,34,31,ATTGAAGGTAATGGTAAAAC,3,1750495
gyrAp,0.6875,52,31,ATCCGGGACCAAATGATCAC,21,1747049
gyrAp,1.90625,91,31,AGTCTTTGCCCCCGCTTCCC,60,1752767
gyrAp,1.46875,77,31,ACTTTGCTTTTGAAGGGTTG,46,1765574
gyrAp,1.46875,77,31,ACGCCGCAGTCTATAGGTAA,46,1748552
gyrAp,0.9032258064516129,57,30,TTGTGGCGTAACACATTATC,27,1748976
gyrAp,2.4516129032258065,105,30,TGGCATACCCGGCGCGGTAA,75,1745185
gyrAp,0.5161290322580645,45,30,TCGGACTAAATGATTGTCGC,15,1743571
gyrAp,0.967741935483871,59,30,TATTTATGTGATGACGGTTG,29,1754081
gyrAp,1.032258064516129,61,30,GAATCCCTTACAGTACAAGG,31,1755529
gyrAp,0.8064516129032258,54,30,CATGGCACTATTCCTACAAT,24,1741651
gyrAp,2.5806451612903225,109,30,CATAGTCGAGGATGTACCAC,79,1752816
gyrAp,2.4838709677419355,106,30,CAAAGAGTAGGGCGAGCGCC,76,1763601
gyrAp,0.5161290322580645,45,30,ATTCGGGTGATGGTAGAGAT,15,1753833
gyrAp,0.7096774193548387,51,30,AGGCCGAAGACCCGGCGTTT,21,1746617
gyrAp,2.0,91,30,ACGTTTTGGGCGCTCGTGTT,61,1748488
gyrAp,1.3333333333333333,68,29,TTTATACGTCACAACACCTT,39,1743466
gyrAp,0.6666666666666666,48,29,TCACGCAAGACATGGTAACT,19,1752018
gyrAp,0.7666666666666667,51,29,TACCTTCGTAAAAGACTTGC,22,1744968
gyrAp,0.7,49,29,TAAGCTTCATCCGAGTAATA,20,1757414
gyrAp,0.7,49,29,GTTCTTGGACAAGTTGTAGG,20,1750290
gyrAp,0.8,52,29,GGTAAGCGTGATCCTTAGTT,23,1744783
gyrAp,2.533333333333333,104,29,GGGTTCCTCGAGGGTCCCCC,75,1743487
gyrAp,1.9,85,29,GGACCGGACTAGGGGAGAGC,56,1754716
gyrAp,0.8666666666666667,54,29,GATGACTGACGCAGCGGTGT,25,1743310
gyrAp,2.5,103,29,CGTGTATCGTCGTGATACTA,74,1753375
gyrAp,0.8,52,29,CGCTCACCAGCTCTTCGCGT,23,1768037
gyrAp,0.3,37,29,CCGGTGCCCGGACTTGGGTA,8,1754935
gyrAp,2.2,94,29,CCACTCAAGCGGATCAGCTA,65,1745642
gyrAp,0.5333333333333333,44,29,CACCAGGTGTGTAGATTCAT,15,1749627
gyrAp,1.4666666666666666,72,29,CAACGCGGTACTTGGGCTGG,43,1741673
gyrAp,0.36666666666666664,39,29,ATGGCCGACGTTCCATTGGC,10,1742851
gyrAp,1.4,70,29,ATGCTTACGGTCAGTGTTGC,41,1748161
gyrAp,0.4666666666666667,42,29,ACTATCTTACTCCGGGCGTT,13,1755888
gyrAp,0.9333333333333333,56,29,AAGGTCCCGAGTGTGAAATT,27,1751866
gyrAp,0.1,31,29,AAGGGAGCTTCATTCCGGTA,2,1746980
gyrAp,1.3793103448275863,67,28,TTCATACGAGAAAGTGCTGC,39,1751419
gyrAp,1.3103448275862069,65,28,TGTTCTTAACTACGTAAGCT,37,1756773
gyrAp,0.9655172413793104,55,28,TGTGGAACGGACACAGTCCT,27,1755162
gyrAp,1.206896551724138,62,28,TGTGCATCAACAAGGTCGCT,34,1748727
gyrAp,1.3103448275862069,65,28,TGCCCATAAATAGGCAAAGT,37,1758353
gyrAp,0.8620689655172413,52,28,TATCTGTTCGTGCAAGTAGC,24,1748127
gyrAp,1.6206896551724137,74,28,TATCAAAGTCGCATATCCGA,46,1747829
gyrAp,1.4827586206896552,70,28,GTTCCGGTAGACGCTGGGTC,42,1764587
gyrAp,1.1724137931034482,61,28,GTGTCAGGCCGTTTCGTACA,33,1745643
gyrAp,0.41379310344827586,39,28,GTACATTTTTCCCAGACTGA,11,1741891
gyrAp,0.41379310344827586,39,28,GGGGCTCGTAAAGAGACGTT,11,1749307
gyrAp,3.0,114,28,GGACTTTGGGTAGATCCTAT,86,1749601
gyrAp,1.103448275862069,59,28,GCGTCAGCAACTGTACCCGT,31,1744465
gyrAp,0.6206896551724138,45,28,GACGCTATTTTACATCGGTA,17,1765592
gyrAp,0.5862068965517241,44,28,CTATGACATATCCTTCACGT,16,1744239
gyrAp,0.6206896551724138,45,28,CGCTTGAGGGAAGAGTGGTT,17,1745701
gyrAp,1.4827586206896552,70,28,CGCTTAGATCAGGACGTGAC,42,1742977
gyrAp,0.5862068965517241,44,28,CGCTGGACGGACCGGCCATC,16,1760730
gyrAp,0.1724137931034483,32,28,CCACTGCGACTGGACGGAGT,4,1741478
gyrAp,1.3793103448275863,67,28,CAGCACACCACAATCTTACT,39,1746274
gyrAp,1.5517241379310345,72,28,ATCTGGACCTCGGAGTTGTA,44,1750474
gyrAp,0.13793103448275862,31,28,AGTTTATTAGATCCGAACGC,3,1744445
gyrAp,0.7586206896551724,49,28,ACAAACAATGTCCGTGCGGT,21,1747114
gyrAp,1.2413793103448276,63,28,AACCACCTCGATAGCAAGCG,35,1752357
gyrAp,0.6428571428571429,44,27,TTCGTCCCCCTAGAACGGAT,17,1741821
gyrAp,0.7857142857142857,48,27,TCGATCCGTTTCGGTGTCCA,21,1765843
gyrAp,3.4642857142857144,123,27,TATTGCTAGTCTAGTAAGGG,96,1741792
gyrAp,2.0714285714285716,84,27,TACTGCGCATGTGCGTGAAA,57,1770706
gyrAp,1.8214285714285714,77,27,GTTTTTCGAGAGCATCTCAA,50,1745641
gyrAp,7.535714285714286,237,27,GTTTTGCTCCAGCCGGAGGC,210,1746050
gyrAp,0.32142857142857145,35,27,GTTTCAGGGCAGGAGCTACT,8,1751054
gyrAp,0.07142857142857142,28,27,GTGGGGTGGTTGGTTTACTG,1,1748797
gyrAp,4.178571428571429,143,27,GTACGCCCCGGATAATTTGG,116,1757345
gyrAp,0.07142857142857142,28,27,GGCGCTGTCATGACCTGCGT,1,1746860
gyrAp,0.07142857142857142,28,27,GACGAATCGAGGCCTTCATG,1,1758491
gyrAp,1.6785714285714286,73,27,CTTTCTGTAATTAGCCCCCA,46,1743829
gyrAp,2.4285714285714284,94,27,CTATGGAAACAGCCAGTAGA,67,1766110
gyrAp,1.5357142857142858,69,27,CGATGTGAGGACTTCATGGT,42,1747204
gyrAp,1.9642857142857142,81,27,CCGTATGCATAGCAAAGGGC,54,1751174
gyrAp,0.07142857142857142,28,27,CCGATTACTAAAGGGAGTGT,1,1745005
gyrAp,0.21428571428571427,32,27,CATGTTTAGTTGCCGGTGGT,5,1766470
gyrAp,0.07142857142857142,28,27,ATACCTGTTCGGGGACTGTG,1,1742019
gyrAp,1.5357142857142858,69,27,AGGTTAGCAGTAACGAGCAA,42,1756581
gyrAp,0.8571428571428571,50,27,AAGTTGCACTGACCAGTCAC,23,1750442
gyrAp,1.2962962962962963,60,26,TTCCCCGGGTCGCGTTCCGG,34,1761819
gyrAp,0.5925925925925926,41,26,TTATTGGAAGGCGGGAGCAT,15,1741696
gyrAp,0.1111111111111111,28,26,TTAGCATAGAATGAGAGCGA,2,1752768
gyrAp,1.7777777777777777,73,26,TGAAGCAGCTGACGATAGGA,47,1743193
gyrAp,1.8888888888888888,76,26,TCTCCTGTCCTCCGTAATAG,50,1757475
gyrAp,0.9629629629629629,51,26,TCCGCCGCATTTAATGACAT,25,1755379
gyrAp,1.2962962962962963,60,26,TCCCTTCTCATCATCAAACA,34,1747001
gyrAp,11.962962962962964,348,26,TAATAGAACTGTTCCATGCT,322,1767961
gyrAp,0.9259259259259259,50,26,GGATACAAGCACCGTTATTA,24,1742971
gyrAp,1.0740740740740742,54,26,GCTTAAGGCTTAGGGACCAT,28,1753660
gyrAp,0.8518518518518519,48,26,GCCCCCATTCTGAGGTCGGA,22,1743780
gyrAp,1.2592592592592593,59,26,GATGTCTTAGATCAGGCCGT,33,1757223
gyrAp,3.259259259259259,113,26,GACATCTAATCTATTAACAG,87,1744506
gyrAp,3.259259259259259,113,26,CTTTTTACGATTTTGACTGT,87,1745434
gyrAp,1.4814814814814814,65,26,CTGGGCTATACTCAGGTTAT,39,1743847
gyrAp,0.07407407407407407,27,26,CTCCCCGATAAACAAGGGTG,1,1768415
gyrAp,0.9259259259259259,50,26,CCCCTCAGTCATGGAACGCG,24,1754269
gyrAp,0.7407407407407407,45,26,ATTAGTGTTCTGCAATTTTG,19,1760132
gyrAp,1.1111111111111112,55,26,ATGGTATTTGTATGGAGTCA,29,1743194
gyrAp,1.5555555555555556,67,26,AGGTCGCGTATAGTTACTCT,41,1760831
gyrAp,1.8148148148148149,74,26,AATGACCCGGGTAGTGGTTC,48,1743267
gyrAp,1.0,52,26,AAGGTGACTCTAATGAACGC,26,1755643
gyrAp,0.9259259259259259,50,26,AAGGAGGATCATCCACAGTA,24,1742727
gyrAp,1.8888888888888888,76,26,AAGCCTGATCTGCAGATGAC,50,1766839
gyrAp,0.4230769230769231,35,25,TTAACTAAGGGTCGAGCGCA,10,1758273
gyrAp,0.2692307692307692,31,25,TGGCTAAGTCAGTATCCCTA,6,1749468
gyrAp,0.46153846153846156,36,25,TCTGGTGCTAGGCCTGTGGT,11,1763404
gyrAp,0.7307692307692307,43,25,TCGCCACGCCTTGGAAGTTA,18,1746117
gyrAp,3.1923076923076925,107,25,TCAGGACGATGAGTTGGAGG,82,1759880
gyrAp,0.11538461538461539,27,25,GTATGGAAAGTTTAGGGTTG,2,1742302
gyrAp,1.1538461538461537,54,25,GGGATTCAGAAGGCTGTCGT,29,1743580
gyrAp,0.8846153846153846,47,25,GCATAGGGTGTTGATGTCAT,22,1743505
gyrAp,2.230769230769231,82,25,GATCATAGCAACTCCTGTAG,57,1749629
gyrAp,0.9615384615384616,49,25,GACTGTACTATATTGTTACA,24,1759080
gyrAp,3.923076923076923,126,25,GACTGGATAAGACCCCGTTC,101,1762499
gyrAp,0.4230769230769231,35,25,GAAGATTGATACTAGCGCGT,10,1747740
gyrAp,1.2692307692307692,57,25,CTGTTAAAAGTTAGTCTTCG,32,1759198
gyrAp,3.9615384615384617,127,25,CTAAATCAATTTACGGGCTA,102,1744458
gyrAp,1.6153846153846154,66,25,CATACTCTGAAGGATTAACT,41,1764959
gyrAp,0.6538461538461539,41,25,CAGAAACTGAACTTGCCTGA,16,1759230
gyrAp,0.19230769230769232,29,25,AGTTGCTGCATCGCGATCAT,4,1758454
gyrAp,0.15384615384615385,28,25,AGTTGCGGAGCCTCGTATGA,3,1751569
gyrAp,2.3461538461538463,85,25,AGTCCCTTACTGGATCTTAC,60,1768780
gyrAp,0.07692307692307693,26,25,ACCCAATGAAGTCCGTGGTT,1,1758559
gyrAp,0.07692307692307693,26,25,ACACGTGGGACCGTTATCAA,1,1753848
gyrAp,3.769230769230769,122,25,AAGCTACGGGGCGTCCGGGG,97,1748403
gyrAp,1.1153846153846154,53,25,AACGTGCCTATCAGGAACTA,28,1752597
gyrAp,0.6153846153846154,40,25,AAAGAGCTGTGTATCAACGC,15,1765668
gyrAp,0.56,37,24,TTGAGCATAGGCAAGTCGAT,13,1746712
gyrAp,0.08,25,24,TGAGGTTCTCATACAGCAAA,1,1752475
gyrAp,1.08,50,24,TCTTCAAGAGCGGGTACGTG,26,1741903
gyrAp,0.64,39,24,TCCGACCGCTCCCACTACAT,15,1761414
gyrAp,0.12,26,24,TAATGATGAACTGGACATAG,2,1747534
gyrAp,6.92,196,24,GTTAGTAGCTTTGCCAATAA,172,1761748
gyrAp,0.92,46,24,GTCTAGAAGTTACTTCTCGA,22,1761795
gyrAp,0.72,41,24,GTCGTAGTTCGGGTGTACGA,17,1749178
gyrAp,0.68,40,24,GGATGCATCCGGCAAAAATA,16,1753893
gyrAp,0.76,42,24,GGAACACGCAAGGTTCATCT,18,1743055
gyrAp,1.04,49,24,GCGTTTTAGGCAAATCACTG,25,1744396
gyrAp,0.56,37,24,GCGTAAAGTGCTATAGTAGG,13,1744326
gyrAp,0.08,25,24,GCGCGGAGGGACCTAATTGG,1,1765603
gyrAp,0.88,45,24,GCGAGCGGGAAGATGGGGGA,21,1752370
gyrAp,1.92,71,24,GAGCGAGTACCTAGTTTACT,47,1744195
gyrAp,0.2,28,24,GAGCAGCCAAGATAAAATGT,4,1745052
gyrAp,2.56,87,24,GAGAGCCGCAATCGTATGTT,63,1744933
gyrAp,0.52,36,24,GACTATTTTGTGTGATGGGG,12,1743245
gyrAp,0.64,39,24,GAAGTCCGCAGTGTTACCTT,15,1761953
gyrAp,0.76,42,24,CTATTCACAGTACCTCACTG,18,1755128
gyrAp,0.72,41,24,CGTTACTAGAAATTACCAAG,17,1763687
gyrAp,2.0,73,24,CCTCTCAGCCGCGAAAAACT,49,1750243
gyrAp,1.28,55,24,CCGGTCCACGGAGCAGTCGC,31,1769817
gyrAp,1.64,64,24,CCCGACTCGCTGCGTCTTGG,40,1749289
gyrAp,1.56,62,24,ATTTTGATTGGGAATGGCAA,38,1752599
gyrAp,0.52,36,24,ATAACACGCTCCCTTGGTGG,12,1748975
gyrAp,0.56,37,24,AGGGCCTTGTTTTTCCCGCC,13,1751296
gyrAp,3.28,105,24,ACGCTAGGCCCTCTGTAGCA,81,1759381
gyrAp,1.16,52,24,ACAATTGATCAGTATTCTTA,28,1766013
gyrAp,0.96,47,24,AAACCCCAGTAATGTACAAA,23,1758183
gyrAp,0.25,28,23,TTTATCACCCCGGTTTAATA,5,1748598
gyrAp,0.5416666666666666,35,23,TTCGCATGATAATGGCATGT,12,1744124
gyrAp,0.16666666666666666,26,23,TGAACTGCTTCTATGACCCG,3,1746598
gyrAp,0.75,40,23,TATGGTTTGCCCTTAACTTT,17,1768675
gyrAp,0.7916666666666666,41,23,TAACTTTTTAGAGCTGACTG,18,1755428
gyrAp,1.0416666666666667,47,23,GTTAGCTCCTCGATAAGTGT,24,1752185
gyrAp,1.0416666666666667,47,23,GGAGGTTCGACGCGACATAC,24,1751128
gyrAp,0.2916666666666667,29,23,GCTTCAACCCCACACCCTCG,6,1750845
gyrAp,3.6666666666666665,110,23,GCATCTGCGCTGCAGAATGT,87,1752595
gyrAp,0.08333333333333333,24,23,GACTTCCCGGGTTCTCTGTT,1,1763723
gyrAp,1.875,67,23,CTCGCTCGAGATCGGAACAA,44,1748073
gyrAp,0.125,25,23,CTCGAGTAAAGTCTCAAGTA,2,1746709
gyrAp,0.16666666666666666,26,23,CTCATTTGATGGCATTAGTG,3,1756028
gyrAp,1.0416666666666667,47,23,CTAGGAAGCTATCCCCCCGA,24,1742680
gyrAp,0.5833333333333334,36,23,CGTCGATTGTAAACGCACCT,13,1755619
gyrAp,0.7083333333333334,39,23,CCATCAATCGCTGCTGGTGC,16,1745485
gyrAp,0.9583333333333334,45,23,CATTGTCATCCCCAAGGACA,22,1750782
gyrAp,1.0,46,23,CACAATTACTACTGCCCCAA,23,1746882
gyrAp,0.375,31,23,ATTGCATCAATTAACTGGAA,8,1760389
gyrAp,1.625,61,23,ATGTATGGAAGCGCTACATG,38,1758598
gyrAp,0.875,43,23,ATGGGTTACTAATAGTATCT,20,1758784
gyrAp,2.125,73,23,ATCCAAGGTATGCTGCGTTT,50,1746790
gyrAp,0.5416666666666666,35,23,ATACTAAGAGATAAGGAAAT,12,1757592
gyrAp,0.25,28,23,ACGTTGGCGTATCTATCAAT,5,1753756
gyrAp,1.375,55,23,AATATCGGCACTTCTTAGCA,32,1746769
gyrAp,0.2916666666666667,29,23,AACTATTCTTGATATTGCAG,6,1747187
gyrAp,5.375,151,23,AACGAGCTCCGTTCGTCCTA,128,1754530
gyrAp,2.1739130434782608,71,22,TTCACGCGAGCCGGGCTCCT,49,1763092
gyrAp,0.08695652173913043,23,22,TGGCCAATCGGCACAGAGTA,1,1760972
gyrAp,2.260869565217391,73,22,TGCTATACGTGAGTCTTTAT,51,1752456
gyrAp,1.608695652173913,58,22,TGCGCCCTAGGGGGTTCGAT,36,1756476
gyrAp,0.2608695652173913,27,22,TGAACTTTTCATGGGAATAC,5,1764485
gyrAp,2.782608695652174,85,22,TCTTGCAGGTCGCGCGGACA,63,1744112
gyrAp,1.3478260869565217,52,22,TCGTCGGTCGCATACGATAC,30,1757622
gyrAp,0.08695652173913043,23,22,TCCAGATCGCGATAGCGGAA,1,1747770
gyrAp,0.782608695652174,39,22,TATGACTTGGGCACGTTTAG,17,1761504
gyrAp,2.3043478260869565,74,22,TAACATGCACCTAAGTAAGC,52,1747499
gyrAp,0.7391304347826086,38,22,GTTAACACTTGAATCCTCGT,16,1748652
gyrAp,0.9130434782608695,42,22,GTGGTTTGTGCCATCATCCG,20,1766326
gyrAp,1.5217391304347827,56,22,GGTATCCCGTTTTAGGTTAA,34,1749799
gyrAp,2.0434782608695654,68,22,GGGTGCATCCCTTTATGAAT,46,1768138
gyrAp,2.391304347826087,76,22,GGGCCATGTTACTAACATCT,54,1748863
gyrAp,0.9130434782608695,42,22,GCTCCTTCTAATATGGTTTC,20,1747725
gyrAp,3.0,90,22,GCGTCCCATTCAAGTCGTCA,68,1754753
gyrAp,4.434782608695652,123,22,GAAATGTTATTTCGGCTTCT,101,1743642
gyrAp,1.4782608695652173,55,22,GAAAACCCACAGATGTCTTT,33,1758520
gyrAp,0.08695652173913043,23,22,CTTGATACACTCACAGCCCT,1,1750993
gyrAp,1.7826086956521738,62,22,CTTAACTATCCCTGAGACAA,40,1750391
gyrAp,0.5217391304347826,33,22,CTGAGCCAAGGTGCCATTAA,11,1770085
gyrAp,1.608695652173913,58,22,CTCGCTAGCAAGCGAATTCT,36,1760714
gyrAp,7.6521739130434785,197,22,CTCCGGGGGTTACATACGCA,175,1760089
gyrAp,0.13043478260869565,24,22,CGTGACAGATTCGCCTGCCA,2,1753568
gyrAp,0.34782608695652173,29,22,CGGCGTCGGGGGATGGGACT,7,1761405
gyrAp,0.34782608695652173,29,22,CGATCGCAACCATTAGGAGT,7,1742966
gyrAp,0.391304347826087,30,22,CGACATTTGAATCAAGTCTG,8,1745705
gyrAp,0.08695652173913043,23,22,CAGTGCCGGAGATACTAAGT,1,1744543
gyrAp,0.4782608695652174,32,22,CAGGTCGAGTATGCGGCACA,10,1757241
gyrAp,0.6956521739130435,37,22,CAGCGCGAGGTTAAATTCTA,15,1743102
gyrAp,5.956521739130435,158,22,ATTTCCCAAAGTCACATTCT,136,1748723
gyrAp,0.30434782608695654,28,22,ATTGGGCTGCCATTCCGCAA,6,1754653
gyrAp,0.08695652173913043,23,22,AGTGGACATCGCCGAAAGGC,1,1761566
gyrAp,0.13043478260869565,24,22,AGCAACGAGTCTATACCGGG,2,1747194
gyrAp,1.3478260869565217,52,22,AGATCAGCTGTCAGGGTTAA,30,1755541
gyrAp,2.5652173913043477,80,22,AGACGTTGGGGGTCTCCAGT,58,1743958
gyrAp,1.4782608695652173,55,22,ACCCTGTCATCACGCCGCCG,33,1742452
gyrAp,1.9130434782608696,65,22,ACCCACTTTTGCAACGCAAT,43,1764004
gyrAp,0.8260869565217391,40,22,ACACGTCTGAGGTCTACGCC,18,1744514
gyrAp,1.7391304347826086,61,22,AATTCGTAAAGGTAAGACAG,39,1742524
gyrAp,0.5217391304347826,33,22,AAGCGTAACGGACGCGCGAG,11,1769693
gyrAp,0.7272727272727273,36,21,TTAAGAGACGAGCGATCACT,15,1766244
gyrAp,0.22727272727272727,25,21,TGCTAGTACGTTAGCCTGAT,4,1753283
gyrAp,4.954545454545454,129,21,TGACCCATCTTGCTACCTTT,108,1749111
gyrAp,0.7727272727272727,37,21,TCTGCCCGTCTTTTTATCTA,16,1757862
gyrAp,1.0,42,21,TCCGGTGATCATCTGTTCTT,21,1765844
gyrAp,0.13636363636363635,23,21,TATGTAACTCCGGTTATAGA,2,1747992
gyrAp,0.5,31,21,GTCCCATCAGGACACATGAT,10,1764563
gyrAp,5.590909090909091,143,21,GTATTATCCCTGAACTATTT,122,1743933
gyrAp,2.0,64,21,GTATGTCCCGAAGCAAATCT,43,1748187
gyrAp,0.9090909090909091,40,21,GTAATGTTGGCCACCGCGGC,19,1744715
gyrAp,1.5,53,21,GTAAGCTATCAGCTGTCCCG,32,1760420
gyrAp,4.636363636363637,122,21,GGCGTCCCCCCGAAGCTTTA,101,1751361
gyrAp,0.18181818181818182,24,21,GGAGTGGCACCAGGGCCTCA,3,1745775
gyrAp,0.3181818181818182,27,21,GGAGGAGCCGAAGCCAGAAG,6,1759483
gyrAp,0.5909090909090909,33,21,GCTTCGTTAACGTCGAGTCG,12,1749059
gyrAp,0.9090909090909091,40,21,GCTTAACCTAAGGCTCCACT,19,1747459
gyrAp,0.18181818181818182,24,21,GATGCGCTCTACACTTGTGC,3,1741791
gyrAp,0.2727272727272727,26,21,CTTTTGACGTCGGCGTTGGG,5,1742658
gyrAp,0.8636363636363636,39,21,CTCGTTTCTACCACTGAAGG,18,1753150
gyrAp,0.09090909090909091,22,21,CTACTAAAGTGTAAGGCAAG,1,1749764
gyrAp,1.6818181818181819,57,21,CGGTCAGACTTGGATTCTGG,36,1754890
gyrAp,0.22727272727272727,25,21,CGCACGCATTGAGGGGGCGT,4,1766638
gyrAp,1.6363636363636365,56,21,CCTGAAGGCGGTTTTCTACC,35,1744882
gyrAp,1.3181818181818181,49,21,CCGGCCATTCAACTCATTGG,28,1757453
gyrAp,3.909090909090909,106,21,CAGCTGTTGGGCGTACCAAT,85,1742258
gyrAp,0.45454545454545453,30,21,CAAAGAACTTACCAGTCGCT,9,1765589
gyrAp,6.7727272727272725,169,21,AGTGATTAGCGCCCTGGAGC,148,1747023
gyrAp,0.9090909090909091,40,21,AGGGCTGATCGCTAGTCGTG,19,1742008
gyrAp,0.9090909090909091,40,21,AGGGACATGCGAAGGCCGTC,19,1767301
gyrAp,4.2272727272727275,113,21,AGCTAGAAGTTTATAAGAAA,92,1748343
gyrAp,0.36363636363636365,28,21,AGCTAAATTCCTTCGACCCA,7,1745807
gyrAp,3.227272727272727,91,21,AGCCTATAAGGCACGCTGGG,70,1754820
gyrAp,1.6818181818181819,57,21,AGACAGACAAGGCGTCTCAT,36,1769912
gyrAp,3.090909090909091,88,21,AAGTGCCGCTTCGATGGACT,67,1753201
gyrAp,1.3181818181818181,49,21,AAGGGGACCACACAATCCTA,28,1755567
gyrAp,0.19047619047619047,23,20,TTTTTTGCGAGGCCTTAGCA,3,1768162
gyrAp,1.4761904761904763,50,20,TTAAGCCTGCGCAGGACCAT,30,1760676
gyrAp,0.09523809523809523,21,20,TGGTGGTCAGTACTGGAGAT,1,1750538
gyrAp,0.3333333333333333,26,20,TGGTGCATCACACCCCGTAT,6,1766733
gyrAp,0.09523809523809523,21,20,TGGGACATACCGCTTAACGA,1,1747321
gyrAp,0.09523809523809523,21,20,TGATGTCTTACTTTCCGCAT,1,1761911
gyrAp,0.5714285714285714,31,20,TCGGAGAGATCTGGCTTTTA,11,1742972
gyrAp,2.142857142857143,64,20,TCCTCCAATGCCCGATCCAC,44,1753488
gyrAp,1.5714285714285714,52,20,TCCGGCATCAGCCGAGCAGT,32,1753767
gyrAp,0.6666666666666666,33,20,TCCCACGTTGTAACAATTGA,13,1758130
gyrAp,1.380952380952381,48,20,GTTAGGCATGTGAGGGCACG,28,1741660
gyrAp,0.7142857142857143,34,20,GGTCACATGTCTCTGCGTTA,14,1755620
gyrAp,1.9047619047619047,59,20,GCTGGGGCCAGGTTGTGGAC,39,1742233
gyrAp,0.14285714285714285,22,20,GCCGCGTGGATTACCTCTTT,2,1770566
gyrAp,1.0,40,20,GATTCGAAGCAATCCATTCG,20,1742931
gyrAp,1.7142857142857142,55,20,GATATCCCTCTTATCATAAA,35,1750410
gyrAp,3.3333333333333335,89,20,GAAGGTAGCAGATTAAAGAA,69,1762222
gyrAp,2.6666666666666665,75,20,GAAAGCTTCGGAAGCCCCTG,55,1747445
gyrAp,0.6190476190476191,32,20,CTCCGCATTGGAACATTTAT,12,1766428
gyrAp,0.42857142857142855,28,20,CTAGCTAGATTAGGAACTAA,8,1764142
gyrAp,0.42857142857142855,28,20,CTAGAATCAGGTTATAAACA,8,1765720
gyrAp,1.1904761904761905,44,20,CGTCCGGGAGCTGTATCCAT,24,1758525
gyrAp,2.2857142857142856,67,20,CGTATACCCAAAGGACTCGA,47,1744576
gyrAp,1.619047619047619,53,20,CGGCCACGCTCGTGCACGTT,33,1747794
gyrAp,0.5238095238095238,30,20,CGCCCCGCGGCCGTGAGGGT,10,1751952
gyrAp,0.23809523809523808,24,20,CACCATCTGCTTACGGCGCG,4,1765947
gyrAp,0.5238095238095238,30,20,CAACGGGTAACCATTCGGGT,10,1747796
gyrAp,2.238095238095238,66,20,ATACCAGTTGTCTTGGAGGC,46,1762077
gyrAp,0.6190476190476191,32,20,AGACCACATAGGCCAGCATG,12,1766333
gyrAp,1.9523809523809523,60,20,AAATACCGTTGGGTACGATT,40,1748005
gyrAp,0.8571428571428571,37,20,AAACCCTAAAAGATAAGATC,17,1768377
gyrAp,1.15,41,19,TTTCCCCTAGTCTGCGTTAA,22,1741943
gyrAp,1.75,53,19,TTTCAACATTTTGGTTAGGA,34,1761061
gyrAp,0.65,31,19,TTTATGTCATTCTTCTGGAT,12,1752205
gyrAp,3.7,92,19,TTGGAATAAGCTTACGACTG,73,1741948
gyrAp,0.65,31,19,TTCCTTATTAGACGCTACGA,12,1755079
gyrAp,6.35,145,19,TTACGTGCTTAACAACCCTC,126,1769300
gyrAp,1.0,38,19,TGCTGACCCGATATAGTATT,19,1741672
gyrAp,5.6,130,19,TGAGTTGAACGACACATGAA,111,1769299
gyrAp,0.9,36,19,TCATGTTGGGGTTACTGGTT,17,1746822
gyrAp,3.2,82,19,TCAAACTTTTAAGGCGAAAT,63,1768683
gyrAp,4.6,110,19,TAGGGACCCTTATTGGACAC,91,1756417
gyrAp,0.3,24,19,TAGCTGTAGGCTGCACCATG,5,1765202
gyrAp,1.15,41,19,TACGTCGGTCAGGAATGTTA,22,1747991
gyrAp,0.8,34,19,TAAGGTACAATCGAACGCTG,15,1760618
gyrAp,0.1,20,19,GTTTGGCACCACAAGTGTAT,1,1769812
gyrAp,3.15,81,19,GTGGCAGCATGCATGGATAA,62,1758254
gyrAp,0.8,34,19,GTAAAGAATAAGCTATGCTT,15,1751516
gyrAp,0.15,21,19,GGCATCTGGCTCAGGGAGGT,2,1769500
gyrAp,0.75,33,19,GCAGTCAGCCGTACGCAGGT,14,1759993
gyrAp,0.1,20,19,GATTCGTCCATATGGTTTGA,1,1746782
gyrAp,1.6,50,19,CTTATCTCTGAGATTAACCT,31,1746555
gyrAp,2.05,59,19,CTGATCCGGCATTTCAATGT,40,1745458
gyrAp,0.1,20,19,CTAATACGAAGGGAACGGAT,1,1742994
gyrAp,2.1,60,19,CGTTTCCCTCACATTCAATA,41,1748978
gyrAp,0.3,24,19,CGTTCGACTTTTATCGGTGT,5,1766840
gyrAp,0.35,25,19,CGTCATGCTATGAAACATTC,6,1767962
gyrAp,1.35,45,19,CGGAGTTAGCTTTTACCCTA,26,1743672
gyrAp,0.7,32,19,CGCAGGCGCAGGGTGGTTAG,13,1764894
gyrAp,1.8,54,19,CGACGAGAATACACGGGGTA,35,1756385
gyrAp,0.4,26,19,CCTCGAAGTTTCGTAGTTCG,7,1762094
gyrAp,2.15,61,19,CCGCTTGCGTAACTTTGTAC,42,1766062
gyrAp,1.4,46,19,CCCGGACTTCGCGAGGCTCC,27,1767580
gyrAp,0.95,37,19,CATTCAACTTCTAAATATAT,18,1742330
gyrAp,3.65,91,19,CACCTACCATAAGGTCTTAG,72,1755364
gyrAp,1.3,44,19,ATTCCAAGATTCTTTGTCGT,25,1755337
gyrAp,0.5,28,19,ATGGGACGCTTAGGGAGGTG,9,1743765
gyrAp,0.55,29,19,ATCCCGGGCCAGAGTATTAT,10,1750095
gyrAp,3.65,91,19,ATACGCACGACAGTTCTATG,72,1741760
gyrAp,1.5,48,19,AGTATTGACCCATTTCTTTT,29,1765317
gyrAp,2.05,59,19,AGGCACTTAGGGGCGATCAT,40,1753213
gyrAp,0.75,33,19,ACGATGCAACGCTCCGTTTA,14,1762704
gyrAp,2.15,61,19,AATCGGCGCTTCAGTGAGAA,42,1743072
gyrAp,4.5,108,19,AAGACCACATTCGCCCGATA,89,1754800
gyrAp,2.3157894736842106,61,18,TTTTAAATGTTCAAATCTTA,43,1741624
gyrAp,0.10526315789473684,19,18,TTTCATACACGATCCGGATC,1,1757334
gyrAp,1.5263157894736843,46,18,TTCGGTGTCGCTCCGGAAGT,28,1752261
gyrAp,1.2105263157894737,40,18,TTCCACAGTGGTTCCTGCCC,22,1742601
gyrAp,0.9473684210526315,35,18,TGTCTAGGTTTACGTTACTT,17,1766293
gyrAp,2.210526315789474,59,18,TGGCTGAGAGGTACCCTTTG,41,1742638
gyrAp,0.7894736842105263,32,18,TGGAGGGGTAGCATTAGGTT,14,1745539
gyrAp,0.21052631578947367,21,18,TCTGGTCTAGCTAGCCGATC,3,1743171
gyrAp,1.5789473684210527,47,18,TCCGGGAGGATGTTCTAGTG,29,1744297
gyrAp,1.8421052631578947,52,18,TCATAAGCATTTTTTCCATA,34,1762418
gyrAp,2.6842105263157894,68,18,TCAGAGCTCTATAGATGTTT,50,1754520
gyrAp,4.7368421052631575,107,18,TATATTGGTCCCTCTCTAGA,89,1769237
gyrAp,0.10526315789473684,19,18,TAAGCTTGCCAGTCTCATTG,1,1757775
gyrAp,3.4210526315789473,82,18,TAACTGGCCAGGTTGTACAT,64,1748422
gyrAp,0.5789473684210527,28,18,GTTTTACGCAAGCGATCCCC,10,1758493
gyrAp,0.15789473684210525,20,18,GTTTCAATACCGTGTAAGTG,2,1746177
gyrAp,4.0,93,18,GTCTTGGGAGGACCAAACCC,75,1763629
gyrAp,2.1052631578947367,57,18,GTCTTGGATACGCCAAGAGC,39,1754302
gyrAp,1.4210526315789473,44,18,GTCTGCGTAATGCTCACTGG,26,1743735
gyrAp,0.10526315789473684,19,18,GTCCATTCCAGGATAGGTTA,1,1748998
gyrAp,0.631578947368421,29,18,GGTCCTGTGAAGACTAACGA,11,1764737
gyrAp,0.6842105263157895,30,18,GGAGTGGGTAAGGCATTAGA,12,1742398
gyrAp,1.9473684210526316,54,18,GCCTTCTGTGTCCAAGGGTC,36,1762491
gyrAp,0.47368421052631576,26,18,GCAGGTAGGGTTGAAGGAAT,8,1767632
gyrAp,1.1578947368421053,39,18,GATTGGACAGGACTATATGA,21,1758975
gyrAp,0.631578947368421,29,18,GATATGGATAGGTAAGTATA,11,1766337
gyrAp,3.3157894736842106,80,18,GACCTGTTGTTAGGCAGGTG,62,1765105
gyrAp,2.0,55,18,GACCGAGACCAGGGGGCGCT,37,1746292
gyrAp,0.3684210526315789,24,18,GAAGCCGAGGGAAACCACCG,6,1751685
gyrAp,0.3157894736842105,23,18,GAAGACCTCTAAAGAGCGAC,5,1768988
gyrAp,0.3684210526315789,24,18,CTTCACCTGGTACTTGAAAT,6,1752572
gyrAp,2.473684210526316,64,18,CTCTACCGTTTCTGTTCAGC,46,1765491
gyrAp,1.894736842105263,53,18,CTATCTCTGCACCTGTCAAT,35,1759810
gyrAp,1.368421052631579,43,18,CTAGGCAGCGGTAGCCTATC,25,1758119
gyrAp,0.5789473684210527,28,18,CGTTTCGGCTGCATTCCCGA,10,1759254
gyrAp,1.3157894736842106,42,18,CGTAACATGACTCTATTAGT,24,1747719
gyrAp,5.684210526315789,125,18,CGGCTGTATAAGCGAATCGT,107,1754352
gyrAp,2.789473684210526,70,18,CCGTAATACCAGATTAGCAG,52,1748159
gyrAp,1.1578947368421053,39,18,CATAACCCTTGAGATCCCAT,21,1745280
gyrAp,0.15789473684210525,20,18,CAAAGGGAGCTCGCAATGCG,2,1767507
gyrAp,2.4210526315789473,63,18,ATTGAACGTAACCAGTGGAA,45,1749777
gyrAp,2.8421052631578947,71,18,ATTCACGGTTCTATTCCTGG,53,1759107
gyrAp,1.263157894736842,41,18,ATGAGTCCAGCCTGCTACGT,23,1766357
gyrAp,0.7368421052631579,31,18,ATCGTGGACGCTGGCGAGGG,13,1746116
gyrAp,0.3684210526315789,24,18,ATATGGTGACACAAAAGTGT,6,1762854
gyrAp,1.7894736842105263,51,18,ATAGTCCCATTCAGAGTCCT,33,1756626
gyrAp,0.3157894736842105,23,18,AGGCCTCGGTCGGGTGATAT,5,1752864
gyrAp,1.368421052631579,43,18,AGCTGGCTAAAACTGTACTA,25,1748844
gyrAp,0.3684210526315789,24,18,AGCGACGAATCCTGCTGAGA,6,1742453
gyrAp,0.3684210526315789,24,18,AGATACAGGTCCTTCCAGCT,6,1754068
gyrAp,2.6842105263157894,68,18,AATTATCGTGCATGTAATAC,50,1766281
gyrAp,1.4210526315789473,44,18,AAGTGTTCACTTTTTCTTAT,26,1746119
gyrAp,2.3333333333333335,58,17,TTTCTTATAGGCTCGTTCAT,41,1744939
gyrAp,2.2777777777777777,57,17,TTGGACTTAAGAGTGTTCTG,40,1747798
gyrAp,0.7777777777777778,30,17,TTAGTTTAGTCTCGTTTAAC,13,1770304
gyrAp,0.5555555555555556,26,17,TTACGTGTGGCTGGCTGAGA,9,1751190
gyrAp,0.2222222222222222,20,17,TGTTCGAGGGTGACGTTTTG,3,1744492
gyrAp,3.7222222222222223,83,17,TGGGGGCCGTATTCTAAGAA,66,1751033
gyrAp,1.8888888888888888,50,17,TGGAAATATCCAACGCTTAT,33,1750448
gyrAp,0.1111111111111111,18,17,TGCGTGGTGTACTCGCAGTG,1,1743522
gyrAp,1.4444444444444444,42,17,TGACTATTGCGTGGCAACCT,25,1743337
gyrAp,1.7222222222222223,47,17,TGACAAAGTTTTGGACGTTC,30,1746554
gyrAp,5.722222222222222,119,17,TCGAAGGACTGGCAGAGTAC,102,1742819
gyrAp,0.1111111111111111,18,17,TCCCTTAATCATTGCAGACA,1,1745801
gyrAp,4.611111111111111,99,17,GTTCTTAAAATTCATTAATG,82,1770117
gyrAp,2.9444444444444446,69,17,GTCTCAATTACGGTAGCTAG,52,1763158
gyrAp,2.8333333333333335,67,17,GGGTTTGTGAGCCAGGAGCT,50,1749372
gyrAp,0.1111111111111111,18,17,GGGTCCAACTTATCTATAAG,1,1754036
gyrAp,3.2222222222222223,74,17,GGGAGACTAGCATTTAAACC,57,1766352
gyrAp,0.2222222222222222,20,17,GGGACCATTGTGGTGTGCAT,3,1743601
gyrAp,0.9444444444444444,33,17,GGCAGTCGAGAGCTCCGAAA,16,1751194
gyrAp,1.5555555555555556,44,17,GGACGTGGGGGTATGATGTA,27,1750093
gyrAp,3.0,70,17,GCTTCCTAGGGTAAGTGGGG,53,1742993
gyrAp,3.0555555555555554,71,17,GCTCGCATGTTGGAAAAAGT,54,1765533
gyrAp,2.5,61,17,GCGTGTCACGCCTATGCGCT,44,1747414
gyrAp,1.5,43,17,GCCCGACGCTCCAGAGGACT,26,1760207
gyrAp,0.2777777777777778,21,17,GCATTGTGCCACATAGAGTG,4,1743293
gyrAp,1.3333333333333333,40,17,GATCTTACTACGATGGAGGA,23,1748160
gyrAp,3.1666666666666665,73,17,GAGCGCACTCCGGGCGGAAG,56,1756005
gyrAp,1.9444444444444444,51,17,GACTTCGACTCTCACGCAGG,34,1749599
gyrAp,1.6666666666666667,46,17,CTTGGATATGCGCGTATCCA,29,1746134
gyrAp,1.3888888888888888,41,17,CTGGGTGACATAAACCGAAT,24,1750710
gyrAp,0.8333333333333334,31,17,CTGGCCCAACCTGCAACAAT,14,1748520
gyrAp,1.4444444444444444,42,17,CTGCAAGTGCCTGGGACCTC,25,1747394
gyrAp,3.0,70,17,CTATTTTGATCCGCATAATA,53,1754830
gyrAp,0.8333333333333334,31,17,CGTCAGCTGTAGACTCGCTA,14,1749793
gyrAp,3.388888888888889,77,17,CGTAACTACACGTAACGTCC,60,1746508
gyrAp,0.6111111111111112,27,17,CCTGAGTCACAATATGCCCA,10,1745347
gyrAp,0.16666666666666666,19,17,CCTCCTGTTTTGCAACTTGC,2,1766810
gyrAp,1.0555555555555556,35,17,CCAAGCGCGCCCCACATTTA,18,1766734
gyrAp,2.111111111111111,54,17,CAGGAAACTTTTGGTGCATT,37,1761562
gyrAp,3.5555555555555554,80,17,CACTTTTTCTGTTCATACGA,63,1757287
gyrAp,0.3333333333333333,22,17,CAATGCTATAGAACAGTAAC,5,1745965
gyrAp,1.7222222222222223,47,17,ATGGACGCATTCTCCTAATT,30,1746256
gyrAp,1.6666666666666667,46,17,ATGAGTATTTCATCGGCTGA,29,1763093
gyrAp,4.0,88,17,AGTGTACGGCGCAATGGGGT,71,1758360
gyrAp,1.8888888888888888,50,17,AGGTGAGGCGGGTATCTAAA,33,1752634
gyrAp,1.8888888888888888,50,17,AGCAGTTCTGACCCTCACGC,33,1750338
gyrAp,3.6666666666666665,82,17,AGCAGCCGCTGACTTTGAAC,65,1749185
gyrAp,2.611111111111111,63,17,AGATCCACTAGAGCAGGATG,46,1755145
gyrAp,2.2777777777777777,57,17,ACGCACGAGGATATCAGTCC,40,1745668
gyrAp,2.0555555555555554,53,17,ACCTACTAAGGTGTCATCAT,36,1752320
gyrAp,1.0555555555555556,35,17,ACCCGTGAAGGAGGAACCCT,18,1763761
gyrAp,0.6111111111111112,27,17,ACATGCCAACGAACAATCGT,10,1759270
gyrAp,0.1111111111111111,18,17,AATTGATTTGGCGAGCGACG,1,1757983
gyrAp,5.166666666666667,109,17,AACGGATTGGAATGATAAGT,92,1750021
gyrAp,2.823529411764706,63,16,TTTTATAGAATTCCAAGATT,47,1750716
gyrAp,1.0,32,16,TTGTGATTAGACCGTTCTAT,16,1751544
gyrAp,0.5294117647058824,24,16,TTAATCAAAGGGCCGAAATT,8,1749559
gyrAp,0.8823529411764706,30,16,TGTATTAGCACTACACCTGT,14,1749160
gyrAp,3.5294117647058822,75,16,TGGGCCGACCCGACTTGACT,59,1746062
gyrAp,2.6470588235294117,60,16,TGCTTGACTCATGACCCCCA,44,1746289
gyrAp,1.5294117647058822,41,16,TGATGAGGGTGGTTATAGAG,25,1747996
gyrAp,1.9411764705882353,48,16,TCGCATATCTCTAAGTGACA,32,1762144
gyrAp,0.6470588235294118,26,16,TCCGGCGAAAATTAAAAGGT,10,1768539
gyrAp,0.6470588235294118,26,16,TCACGACCCGGGCCGACCTC,10,1762218
gyrAp,0.47058823529411764,23,16,TAGGTGGCGAGATAAATATT,7,1767757
gyrAp,2.588235294117647,59,16,TAATCACGGGCTCTTACGAC,43,1747084
gyrAp,1.7058823529411764,44,16,GTTCTGTGAGCAAACAGGAA,28,1769143
gyrAp,1.588235294117647,42,16,GTGCGATCCGGCTTCGGTTA,26,1751066
gyrAp,0.23529411764705882,19,16,GTGAAATACAGGCGAGCCGG,3,1765101
gyrAp,0.5882352941176471,25,16,GTCTCGCCTCTTTAGCTGTG,9,1769364
gyrAp,1.4705882352941178,40,16,GGTACATGCATCTGCCGAGT,24,1753451
gyrAp,3.764705882352941,79,16,GGTACATATGTGCATTTTTA,63,1761342
gyrAp,0.7647058823529411,28,16,GCTCGCTGTTCGGTTAACTA,12,1750742
gyrAp,0.8823529411764706,30,16,GCGGTTGACGGGGCTCCAAG,14,1742891
gyrAp,2.0,49,16,GCATTAGAGACTCGATGAAT,33,1761987
gyrAp,1.1764705882352942,35,16,GCAAGCTGGACATCGTGGTA,19,1758373
gyrAp,2.235294117647059,53,16,GATTGCAATTAGCTCGCATA,37,1757957
gyrAp,0.35294117647058826,21,16,GATGCTGAGGAATTGCCAGA,5,1770490
gyrAp,1.1176470588235294,34,16,GAGTGTGCGCGACAGCTAGT,18,1762575
gyrAp,3.4705882352941178,74,16,GAATGCCTAGGAAGTGACAT,58,1766495
gyrAp,1.0588235294117647,33,16,CTTATTAACCCGGTGCTAAT,17,1750375
gyrAp,3.235294117647059,70,16,CTTAAATAGCAAAAGGGCGC,54,1766368
gyrAp,1.9411764705882353,48,16,CTGTCCTCGATTTCGGGAAA,32,1748951
gyrAp,4.176470588235294,86,16,CTGTAACAGATAGTAAGTCT,70,1752437
gyrAp,0.35294117647058826,21,16,CGTGGCTTAGTGCTATATAG,5,1743105
gyrAp,1.8823529411764706,47,16,CGTCTGGCACGTCCGACGTT,31,1743417
gyrAp,4.0588235294117645,84,16,CGCCGGACATACGCACTGAC,68,1764865
gyrAp,2.823529411764706,63,16,CCATTTTGGCGAAAAATACT,47,1763814
gyrAp,0.6470588235294118,26,16,CAACTCGCTTTCGAAGAAAA,10,1755607
gyrAp,3.176470588235294,69,16,CAAAGATATCCAGCCTCAAT,53,1763831
gyrAp,1.7647058823529411,45,16,CAAAAGAGTTTCCACCGTGA,29,1744942
gyrAp,0.5882352941176471,25,16,ATTCAATAGTGTACCATACA,9,1752735
gyrAp,0.23529411764705882,19,16,ATTAGAGCCCCTGCAATTCT,3,1743333
gyrAp,1.0,32,16,ATCTTGCCGATAAACCCCTG,16,1750267
gyrAp,5.705882352941177,112,16,AGTGGGAAGGTACTTACTAT,96,1756680
gyrAp,0.8823529411764706,30,16,AGCTTAGGCACTCTCAGCAA,14,1741992
gyrAp,2.7058823529411766,61,16,AGCGCGACATCTTTGCTGGA,45,1761441
gyrAp,0.29411764705882354,20,16,AATTCGTCTAACTAACGGGA,4,1743539
gyrAp,0.17647058823529413,18,16,AACTTACATACAAAAAAGGT,2,1760230
gyrAp,0.29411764705882354,20,16,AACTGATATTATGATAGGAA,4,1747795
gyrAp,2.764705882352941,62,16,AAAAGACAAGGGTCCTTATG,46,1742349
gyrAp,0.375,20,15,TTTGCCAGCTGCGATTCTCA,5,1750501
gyrAp,3.0,62,15,TTTCCGATTATCTCACTCTG,47,1758929
gyrAp,3.375,68,15,TTGCATTCCATCCTAAGAAG,53,1745835
gyrAp,2.4375,53,15,TTGATTGGTCAGCACCTTTC,38,1751452
gyrAp,1.5,38,15,TTCTTCCACCTCAACTCCAG,23,1754615
gyrAp,0.125,16,15,TTATCTCCGTATTGCCTAAA,1,1749064
gyrAp,0.4375,21,15,TGTTACGAGTTTTTGTGTAT,6,1755622
gyrAp,0.625,24,15,TGCTGGCTCAGGAGTGCGGC,9,1754856
gyrAp,2.625,56,15,TGACCCTGGATTCGCGACAA,41,1748012
gyrAp,1.1875,33,15,TGAAGGGATCTCGATGATTA,18,1747343
gyrAp,1.875,44,15,TGAAATGACGGCGTCATATT,29,1759481
gyrAp,1.375,36,15,TCGCTTGGTAGTACAACAGA,21,1742467
gyrAp,0.25,18,15,TCCCCTAAGGATCACCCAAT,3,1761082
gyrAp,1.4375,37,15,TCAGGATCTAATTGGTTGTT,22,1755981
gyrAp,1.75,42,15,TCACGCATTACACTGTGGCA,27,1748512
gyrAp,0.4375,21,15,TATGATGTGGAACTAGGTCC,6,1762931
gyrAp,0.9375,29,15,TAGGCAGTCACGTAAAAATG,14,1746367
gyrAp,0.1875,17,15,TACTTTTGCCATAAACTTTC,2,1754834
gyrAp,0.125,16,15,TAAGCACGGCTCCAGTAATC,1,1757601
gyrAp,0.75,26,15,GTTCCTAGGGGGTTTAAGTG,11,1764854
gyrAp,0.625,24,15,GTGAAGAAGCCGTCAAGTGG,9,1756726
gyrAp,4.3125,83,15,GTCTAACTGATCGGATGACA,68,1767658
gyrAp,1.375,36,15,GTCGGATGCCAGCCAAGGGA,21,1750094
gyrAp,1.125,32,15,GTCCGGGTAAGGCTTGGGAG,17,1743840
gyrAp,0.125,16,15,GGTGAACGAAACAGCACTGA,1,1744175
gyrAp,0.125,16,15,GGTATGGGCTCTCCCGTCTA,1,1756514
gyrAp,1.625,40,15,GGGTCTTTACACAGCGACCT,25,1746255
gyrAp,0.375,20,15,GGAGGTAAGAAGTAAATCAG,5,1754222
gyrAp,6.875,124,15,GGAGCATGAGCCTCCCATAT,109,1748381
gyrAp,0.125,16,15,GGAAAGTATGCGAGCCACAT,1,1750426
gyrAp,1.9375,45,15,GCGCCGTTCCTGGTACGAAT,30,1766601
gyrAp,2.3125,51,15,GATCCCGTGGAACTGATGGT,36,1766815
gyrAp,0.4375,21,15,GACACAAGGCTAAAGACGGC,6,1758863
gyrAp,0.6875,25,15,GAAGGATGAAACGATAGGGG,10,1750028
gyrAp,3.5,70,15,GAAATTAAGCCTTTGCGCAA,55,1744415
gyrAp,0.3125,19,15,GAAACTCGGAAATCCCACTC,4,1767774
gyrAp,0.9375,29,15,CTTGCCGTGGGACGTCCGTG,14,1755232
gyrAp,4.375,84,15,CTGATAAGAGAATGGAGCCC,69,1756214
gyrAp,0.125,16,15,CTCAGGGGGATGCTAGCAAC,1,1741438
gyrAp,0.125,16,15,CTCAAGACTACACCAGGTAG,1,1762970
gyrAp,4.6875,89,15,CTAGGTTAGCGTGAATCTCT,74,1751817
gyrAp,0.375,20,15,CGTGAATAAAGCTCAATACC,5,1744886
gyrAp,1.6875,41,15,CGGCCAGGCACAGTTCAATA,26,1754150
gyrAp,1.375,36,15,CGGCACGACATTATTACGTC,21,1752698
gyrAp,2.4375,53,15,CGCCGGACGCTACGTGTGCC,38,1764389
gyrAp,1.0,30,15,CCCGGTCCAGTTCGCAAGGA,15,1763646
gyrAp,0.4375,21,15,CATGTAGTGCGGCACGATAG,6,1769441
gyrAp,2.0625,47,15,CATGACGAGCTTGTTATCTC,32,1742153
gyrAp,4.4375,85,15,CATAAGGGGAAACGGTACCT,70,1770857
gyrAp,2.25,50,15,CAGCTCGCAGAGTAACGCAT,35,1759482
gyrAp,0.25,18,15,CACTGGCATTTTGTATCTCT,3,1742067
gyrAp,2.6875,57,15,CACGAGATCTTTCGTTTTAT,42,1744116
gyrAp,0.1875,17,15,ATGTTAGGAACTGTGGGCTC,2,1745267
gyrAp,3.625,72,15,ATGGTCAACCAGGTGTTGAG,57,1760561
gyrAp,1.1875,33,15,ATGCTGGCATGCGTGTTTCA,18,1767007
gyrAp,1.875,44,15,ATCCGGACAGGGAGGCTTTC,29,1746784
gyrAp,2.1875,49,15,ATCAGGTGGATTCACCGTGA,34,1756105
gyrAp,2.4375,53,15,ATAACCCCGGTTAATCGGGT,38,1754682
gyrAp,1.6875,41,15,AGTTTATATCAAGGTATATT,26,1754243
gyrAp,0.25,18,15,AGTGCAGGTACGAAAGTAGG,3,1753476
gyrAp,0.625,24,15,AGTGACGAGCTGAACGAGAA,9,1759769
gyrAp,1.625,40,15,AGGTGGAAAAATTTGTACTC,25,1759780
gyrAp,1.1875,33,15,AGGTGCGTCCAAGGCTTGTT,18,1750861
gyrAp,3.3125,67,15,AGGTATGGCTGGTTACGCTA,52,1750813
gyrAp,1.625,40,15,AGCTTTCTGTGGGAGTGAGA,25,1743172
gyrAp,1.125,32,15,AGCATCTCAGTAAAGCAGTA,17,1764773
gyrAp,2.75,58,15,ACTTACGGCCGCGAACAAAT,43,1770396
gyrAp,1.875,44,15,ACTGATAGGTTCTGCACCGT,29,1764892
gyrAp,2.5625,55,15,ACTGACGACGATTATTCTTA,40,1741866
gyrAp,0.875,28,15,ACGGCAAACTGAGAGGACGA,13,1741570
gyrAp,1.125,32,15,ACGCTGGCAAGTATCTGGGA,17,1756724
gyrAp,2.0,46,15,ACCCGCATAGGACGAAGTAG,31,1741440
gyrAp,4.875,92,15,ACCACCAACCGAAAATTAAC,77,1766121
gyrAp,3.4375,69,15,AATGGCGGACCGATCATCTA,54,1750147
gyrAp,2.1875,49,15,AATCGCTTACCAAAGTTGTT,34,1750033
gyrAp,4.4375,85,15,AAGTGATGCTAGCTACCGAT,70,1752371
gyrAp,0.3125,19,15,AAGGAAAAGTACGAGCACCC,4,1755625
gyrAp,1.0625,31,15,AACTCGTTGGGGTGCCCCGG,16,1763331
gyrAp,0.5,22,15,AAATATCAGGGTTTTCGACT,7,1759141
gyrAp,0.4375,21,15,AAATAGGCCAGGACAATCGC,6,1761404
gyrAp,3.933333333333333,72,14,TTTGGCGGACGCGACACCTG,58,1746637
gyrAp,0.26666666666666666,17,14,TTTGCGCCGAATGTTCGGCC,3,1745712
gyrAp,0.4666666666666667,20,14,TTGTCGATGCGGTTGCTCAC,6,1767783
gyrAp,0.2,16,14,TTGGGCTCAAAGTTAACGTT,2,1746622
gyrAp,0.13333333333333333,15,14,TTGAGGAAAGTACATCCCTG,1,1746286
gyrAp,1.2666666666666666,32,14,TTACTGTACCATTGGATCTT,18,1763623
gyrAp,1.4666666666666666,35,14,TGTCACACTCCACAGCACCT,21,1743205
gyrAp,1.1333333333333333,30,14,TGGTGCTCAATTTTGAGGAG,16,1760236
gyrAp,1.4666666666666666,35,14,TGCTGGCACGGGCACGATTG,21,1744196
gyrAp,0.5333333333333333,21,14,TCGGCTCTCTTGTATCAGGT,7,1746161
gyrAp,0.3333333333333333,18,14,TCCTGCGAGTGATTCGGAAG,4,1747435
gyrAp,0.13333333333333333,15,14,TCCCGAAGGGCTTATCGAGA,1,1749040
gyrAp,5.933333333333334,102,14,TCACCGTGACCCGTGCGCTC,88,1747535
gyrAp,1.4,34,14,TCACCGGCAAGGCGTGAAGG,20,1742702
gyrAp,2.2,46,14,TAGCCCGCAGGGCTCTAGGG,32,1763161
gyrAp,4.533333333333333,81,14,TACATGATAAGGAGTCTATA,67,1761143
gyrAp,0.2,16,14,TAATTTCTGTACAGGACTTA,2,1760333
gyrAp,0.8666666666666667,26,14,TAAGCTGGTGAAGAAATCAT,12,1742604
gyrAp,0.8,25,14,GTGTTCGTATAAACGCGTTC,11,1753548
gyrAp,0.6666666666666666,23,14,GTGTCATGGCGAGAGGCCTG,9,1741761
gyrAp,1.9333333333333333,42,14,GTATCGTTCTTAAGAGGCGT,28,1758259
gyrAp,1.5333333333333334,36,14,GTAGTGGACGTTCAATCAAA,22,1744122
gyrAp,2.6666666666666665,53,14,GTAGGGCGAGACTGCGATGT,39,1750472
gyrAp,0.13333333333333333,15,14,GTAGACCTCGAGTTGGTCTT,1,1751064
gyrAp,1.4666666666666666,35,14,GGTCTGGATATCAACCCTGC,21,1767596
gyrAp,1.3333333333333333,33,14,GGGTTTTACACTTCTACAGC,19,1757609
gyrAp,1.4,34,14,GGGAAATGCGCGGTGACTAG,20,1764388
gyrAp,2.8,55,14,GGATATGGGGAAAGCAGAGG,41,1750869
gyrAp,1.7333333333333334,39,14,GGAAATGGGCTTATGTTGCA,25,1744416
gyrAp,1.3333333333333333,33,14,GCTCTAGGCAGCGTGCACGG,19,1747050
gyrAp,5.466666666666667,95,14,GCGTCGGCTCGAAATAAACT,81,1742247
gyrAp,0.5333333333333333,21,14,GCGAAATTTCAAGCCCACCC,7,1750340
gyrAp,0.13333333333333333,15,14,GCCATGGCGGTGACTTCGAT,1,1742454
gyrAp,1.0,28,14,GCAACTACTTGCCAGTGGCA,14,1745909
gyrAp,4.0,73,14,GATTTATTAGGTAGTGGTCC,59,1766482
gyrAp,0.2,16,14,GATATTGGGGTCTTCCCCTG,2,1744003
gyrAp,2.8666666666666667,56,14,GAGCGGTCTTCGGCGACATT,42,1744697
gyrAp,0.2,16,14,GACAACCAGTCGATCTACCT,2,1754016
gyrAp,3.8666666666666667,71,14,CTTTTGTCAATTTGGGGATT,57,1754491
gyrAp,1.4,34,14,CTGGTCACAAACAAGGGAGG,20,1761963
gyrAp,0.4,19,14,CTCCGGAGGCTTATTCCTGG,5,1751063
gyrAp,3.533333333333333,66,14,CTCCAGGGAAACCCGTAAGT,52,1764588
gyrAp,0.5333333333333333,21,14,CGTATAGAATGCCATACACG,7,1745054
gyrAp,0.2,16,14,CGGGAGCACACGGAGCTCCA,2,1754997
gyrAp,0.9333333333333333,27,14,CGCTGTACATTCCCGACACT,13,1770283
gyrAp,0.6666666666666666,23,14,CGCGAGTAGCGCCCGCAGCT,9,1767690
gyrAp,3.3333333333333335,63,14,CGCAAATCAGACATCGTTCA,49,1752903
gyrAp,0.8666666666666667,26,14,CCTCCACAGGCATCAGCAGT,12,1747851
gyrAp,1.6,37,14,CCCAAGGTCCTGAGTTGTAG,23,1761374
gyrAp,2.4,49,14,CATTCGCTTAATCGAGTAAC,35,1764387
gyrAp,0.7333333333333333,24,14,CAGGAACAGTCACGCACTCA,10,1766536
gyrAp,0.6,22,14,CACATTCCGGGGGTCATAGT,8,1749729
gyrAp,1.5333333333333334,36,14,CACATAGTAAGACGGCGGTA,22,1767472
gyrAp,3.6,67,14,CACAGTCAACGTTAAGACTA,53,1750599
gyrAp,2.466666666666667,50,14,ATCGGATGGATGAGGATCGT,36,1759008
gyrAp,1.6,37,14,ATAACGTATGATCCCATCTT,23,1748147
gyrAp,0.13333333333333333,15,14,AGGACTCAGAACATAGATAT,1,1768470
gyrAp,8.466666666666667,140,14,AGGAACTCATTCCAAGTCAG,126,1745159
gyrAp,0.13333333333333333,15,14,AGAGCAAGAGCTGCAATAGC,1,1748014
gyrAp,2.466666666666667,50,14,ACTCACGCGACCTGTGGTTT,36,1764972
gyrAp,2.2,46,14,ACGTGCCGGAGCATTACTAT,32,1755644
gyrAp,4.6,82,14,ACCCTTGATTAAAGGTCCGT,68,1743922
gyrAp,0.2,16,14,ACCCGGTCCGTTCTTGGCCT,2,1754457
gyrAp,2.4,49,14,ACCCAGCATCCACATTCGGA,35,1766737
gyrAp,0.6,22,14,AATTCCCATTGGAATATTGG,8,1744695
gyrAp,0.4,19,14,AATAGTTAAAGCGGTAAATG,5,1754906
gyrAp,3.1333333333333333,60,14,AATACTTTTAAGAAGCCCAT,46,1745440
gyrAp,5.2,91,14,AAGGTTAGCGTACCACTCAT,77,1755480
gyrAp,1.2666666666666666,32,14,AAGGAGGAGTAAACTGTGGC,18,1751298
gyrAp,3.4285714285714284,60,13,TTCTTATAAGTTTATGAGGA,47,1769414
gyrAp,1.5714285714285714,34,13,TTCTGGGTCCTCAGCAAATC,21,1766100
gyrAp,0.5714285714285714,20,13,TTCTCTCGTGAACCATTCAG,7,1765695
gyrAp,1.4285714285714286,32,13,TTCGGGCAATTGCATACCGA,19,1763154
gyrAp,11.5,173,13,TTATTTCCACCGAGTAACGG,160,1750741
gyrAp,1.0,26,13,TTATGTCGTGTGCAACGTGC,13,1750221
gyrAp,2.5714285714285716,48,13,TGGTGGACACAATTTCGCGA,35,1750082
gyrAp,6.142857142857143,98,13,TGGCGGTTCGTTTATTCCAC,85,1770692
gyrAp,0.35714285714285715,17,13,TGGCACCCGGCAACCTATCT,4,1758159
gyrAp,2.642857142857143,49,13,TGCTGTAGCAGTGGCTGGCA,36,1766946
gyrAp,1.7142857142857142,36,13,TGCCGCATAACAGTGTAGTA,23,1750719
gyrAp,0.14285714285714285,14,13,TGCCATTTGCAGAGCGCTGG,1,1745868
gyrAp,8.5,131,13,TGAATAATGCCCCCAAGAAG,118,1746978
gyrAp,1.0714285714285714,27,13,TCTTTACCAGGGGGCATCGC,14,1748642
gyrAp,5.071428571428571,83,13,TCTGCTGCAGAGGGCACATT,70,1748189
gyrAp,1.9285714285714286,39,13,TCGTGCACTGAGGAGCGACC,26,1762726
gyrAp,2.5,47,13,TCCAAGTTTAGATACCGAGG,34,1758883
gyrAp,1.6428571428571428,35,13,TCATTCGCCAATTATCTTGT,22,1741564
gyrAp,0.8571428571428571,24,13,TATGACTTAAATTTAACATG,11,1747135
gyrAp,1.1428571428571428,28,13,TACTCCCCGTAAGGGTTTGA,15,1762348
gyrAp,2.142857142857143,42,13,TAACCGTTGAGCATTTGGAT,29,1742755
gyrAp,2.7857142857142856,51,13,GTTGCAGCTCTCAGTTCCTA,38,1747760
gyrAp,0.14285714285714285,14,13,GTTATTGCTATTTTGGTACA,1,1768528
gyrAp,0.5,19,13,GTGTGCAGACGGTGAGATAA,6,1741950
gyrAp,0.14285714285714285,14,13,GTCTGCATCCGTTAGAGGTA,1,1751775
gyrAp,0.14285714285714285,14,13,GTAGCTTACGCCGAATTGAC,1,1754087
gyrAp,0.21428571428571427,15,13,GTACAGGGCAGAGGGTGATA,2,1745188
gyrAp,3.357142857142857,59,13,GTAAGCATTAGTAGTGGGCA,46,1747024
gyrAp,2.857142857142857,52,13,GGTTATGACTTATCTCGTGT,39,1742108
gyrAp,0.14285714285714285,14,13,GGTCGAGTGAACAAGCGCCC,1,1741695
gyrAp,1.2142857142857142,29,13,GGTCAAACGGCGATCTAAAG,16,1752617
gyrAp,1.7142857142857142,36,13,GGGTTACTAGGGTCCCGTAC,23,1748948
gyrAp,3.2857142857142856,58,13,GGGTTAACCCGCGCCTAAAT,45,1758253
gyrAp,0.14285714285714285,14,13,GGGTAAGCCCTCCACGTAAG,1,1742432
gyrAp,0.8571428571428571,24,13,GGGGTTGGGGACAGTCGAAA,11,1769438
gyrAp,3.4285714285714284,60,13,GGGGTTAACGTAGCACGGGA,47,1753659
gyrAp,0.5,19,13,GGGGGCGCTAAAACTTCACT,6,1741759
gyrAp,1.0714285714285714,27,13,GGGACACACATCCTGCCTCA,14,1749206
gyrAp,1.1428571428571428,28,13,GGCGGATGTAAGTGCTGGAT,15,1765268
gyrAp,5.285714285714286,86,13,GGCCTAGGGTCCCCAAGTAG,73,1742179
gyrAp,3.7857142857142856,65,13,GGCCATCACACGTCGAAAAC,52,1766683
gyrAp,4.071428571428571,69,13,GGCAGATGGATGCACTTCTT,56,1768112
gyrAp,0.5,19,13,GGAGTAATCCTAGGGGTTAC,6,1742695
gyrAp,4.857142857142857,80,13,GGACATGCTCATTCATACAC,67,1757772
gyrAp,0.42857142857142855,18,13,GCTATAATCGGTGTCTAGTT,5,1742245
gyrAp,0.5714285714285714,20,13,GCGTGCCTGCCAACGCACAC,7,1755780
gyrAp,1.5714285714285714,34,13,GCCCGGGACAACTTCCGAGA,21,1751941
gyrAp,2.857142857142857,52,13,GCCAACCCTCGTATTTCTTT,39,1764417
gyrAp,3.9285714285714284,67,13,GAGCGGTATATTTTTCAAGT,54,1752012
gyrAp,0.14285714285714285,14,13,GACTTTTCAACCTTAATAGT,1,1764232
gyrAp,1.5,33,13,GACTGGTTGACGTCAGTAAT,20,1768035
gyrAp,3.2857142857142856,58,13,GACGTCGCGCCTTTTGGAGA,45,1748113
gyrAp,0.6428571428571429,21,13,GAAATCTGGCTCTAAACGCT,8,1745660
gyrAp,1.9285714285714286,39,13,CTTTCCGGGGAATCTCCAGA,26,1755257
gyrAp,1.7857142857142858,37,13,CTTCAGAGATACTGGTCGCG,24,1756903
gyrAp,1.6428571428571428,35,13,CTGTTCGGCGCGAAGGTTGT,22,1761228
gyrAp,0.42857142857142855,18,13,CTGCATGCGGATAAGGCCTG,5,1762583
gyrAp,3.642857142857143,63,13,CTCCAAGAGGAACCGCGCGG,50,1743584
gyrAp,7.357142857142857,115,13,CTCAGGGCTCGGCATGGGCA,102,1759682
gyrAp,0.14285714285714285,14,13,CTACGATGTGTTTGAAGCTC,1,1757735
gyrAp,3.9285714285714284,67,13,CGTCCAAAGTCTTAAATACC,54,1747674
gyrAp,3.857142857142857,66,13,CGTACAGATAATTGAACCGA,53,1748738
gyrAp,1.6428571428571428,35,13,CGGTGGCCGGGCTCGCGAAT,22,1755212
gyrAp,0.6428571428571429,21,13,CGGTACTCGTTGGTCAAAAT,8,1747517
gyrAp,0.14285714285714285,14,13,CGGCCGCAAAACAAGTAAAT,1,1748045
gyrAp,1.2857142857142858,30,13,CGGAACAAGTCCATCTACAT,17,1757189
gyrAp,0.21428571428571427,15,13,CGCGTACCGCTGAGACTGGA,2,1749084
gyrAp,3.357142857142857,59,13,CGCAATAGGTACCTACAACG,46,1768060
gyrAp,1.0714285714285714,27,13,CGAGAGTAGAGACATAGTTT,14,1767519
gyrAp,1.5,33,13,CCGGGAGCGGAGTGTCGTCT,20,1759466
gyrAp,0.5714285714285714,20,13,CCCGTGCCAACTCGAGCTTA,7,1749696
gyrAp,0.6428571428571429,21,13,CCACGCCATTATTCACAGGA,8,1756334
gyrAp,1.0,26,13,CATTGTGACCTTGCTTGACT,13,1765483
gyrAp,5.642857142857143,91,13,CATAAGCAGGGGTTTGGGTC,78,1763767
gyrAp,1.4285714285714286,32,13,CAGGAATTATCTGAGACAAC,19,1764282
gyrAp,0.14285714285714285,14,13,CAGACAGAAGAACGAGAATG,1,1756289
gyrAp,1.1428571428571428,28,13,CAACTAGCAAATGCCGACCC,15,1763355
gyrAp,2.0,40,13,ATTCGTCACCGGACAGGAAT,27,1762365
gyrAp,0.2857142857142857,16,13,ATGGTAGCGGGCGCCAAATG,3,1763094
gyrAp,0.5,19,13,ATCTCGGGCTTCCGCGACCT,6,1742181
gyrAp,1.9285714285714286,39,13,ATAGCGCACGGCCCACGAGA,26,1758187
gyrAp,7.857142857142857,122,13,ATAAACATATGAGAGGAGTG,109,1755757
gyrAp,2.5,47,13,AGGGTCCATGTACGTTAGGG,34,1769679
gyrAp,3.857142857142857,66,13,AGCAAGGCCCTGGAGAACTA,53,1755951
gyrAp,2.0,40,13,ACTTGGTACCCAGAACGGCT,27,1760301
gyrAp,2.5,47,13,ACGGCCAGCTGAGAACGCTC,34,1766136
gyrAp,2.857142857142857,52,13,ACCCTTTTTGGAAGTGGAAT,39,1767621
gyrAp,3.4285714285714284,60,13,ACCACGGTAAACGGACGGGA,47,1753478
gyrAp,1.0714285714285714,27,13,ACCAAATAGAACGGTCCAAG,14,1762119
gyrAp,2.5,47,13,ACATGTCCGCGTAAACGGGG,34,1751594
gyrAp,3.0,54,13,AATGCGTGTTCGTAGTGCAA,41,1750190
gyrAp,1.5,33,13,AAGATTGAGTGTTCACAGCG,20,1747252
gyrAp,1.7142857142857142,36,13,AAATGTTGCATACCTTGAAT,23,1751283
gyrAp,3.7142857142857144,64,13,AAATGATCGACCGGCCTTGG,51,1754092
gyrAp,3.1538461538461537,52,12,TTGGGTTTTTCAGGACCTCA,40,1747890
gyrAp,2.6153846153846154,45,12,TTGATGAAGCGTTCAATTAC,33,1754489
gyrAp,0.15384615384615385,13,12,TTCTGTAGCCAGCACGACTC,1,1744236
gyrAp,2.1538461538461537,39,12,TTCTCCCATCTAGTGACGGT,27,1767908
gyrAp,0.38461538461538464,16,12,TTAAAGGCATCTCAAGAATT,4,1756051
gyrAp,2.923076923076923,49,12,TGTGCGTTCGGGCACTCTTC,37,1751517
gyrAp,2.0,37,12,TGTCAGTGTGAGTTGTTCGA,25,1747176
gyrAp,0.6923076923076923,20,12,TGGACTGGAAACCCCGGAAG,8,1758006
gyrAp,1.8461538461538463,35,12,TGCGCGTATCCGGCTGTTCC,23,1756778
gyrAp,1.0769230769230769,25,12,TGAAGAGTCCGCTATAGCCT,13,1757800
gyrAp,1.1538461538461537,26,12,TGAAGACCTCAGGGACCGGT,14,1748134
gyrAp,1.0,24,12,TCTGCATGAGAACCGGTTTA,12,1757525
gyrAp,2.5384615384615383,44,12,TCTGCAGCCGTGGCCACGAT,32,1763160
gyrAp,1.3076923076923077,28,12,TCGAGGTTGCTGATTGGGCA,16,1750289
gyrAp,0.3076923076923077,15,12,TCCAATATGAATAGTCGCGC,3,1752406
gyrAp,1.7692307692307692,34,12,TCATGGTTTTTTAAAATAAA,22,1759293
gyrAp,1.2307692307692308,27,12,TATTACGCGTTGAAGGGGTA,15,1762750
gyrAp,2.8461538461538463,48,12,TATGTACGATTTTCGGGGAT,36,1745351
gyrAp,0.23076923076923078,14,12,TATGCACTGCAACCTCGGAG,2,1763298
gyrAp,3.0,50,12,TATCGAGGCATAATTTGAGG,38,1757485
gyrAp,1.9230769230769231,36,12,TATCGAATGCACACGCCTAC,24,1757918
gyrAp,0.46153846153846156,17,12,TATACTGGGGTGGTGAGGCT,5,1742663
gyrAp,1.7692307692307692,34,12,TAGAGATCCATTAAGCTATT,22,1751352
gyrAp,2.769230769230769,47,12,TAAGGGGGATACACACGAGC,35,1766644
gyrAp,1.5384615384615385,31,12,TAAAGTCGCTGTCCAGATTT,19,1767692
gyrAp,0.6153846153846154,19,12,GTTTTCTTTGAAACTCAGGG,7,1763496
gyrAp,0.23076923076923078,14,12,GTATTGTGCAGGGCTGGGTG,2,1751545
gyrAp,0.15384615384615385,13,12,GGTTTTCTGATTGAGCTTGA,1,1746174
gyrAp,1.0,24,12,GGTTGTAATTTGTGGACATT,12,1752083
gyrAp,0.15384615384615385,13,12,GGTCGCGGGTTGCCTAGATT,1,1769808
gyrAp,4.846153846153846,74,12,GGTATCTCCAGGGCGGTTCA,62,1759122
gyrAp,0.46153846153846156,17,12,GGCTGTGTAGGAGGTACAGA,5,1759839
gyrAp,3.076923076923077,51,12,GGCTATTTCATTGACAACCT,39,1751707
gyrAp,1.3846153846153846,29,12,GGCGCGTAATCCTGCCGACG,17,1743017
gyrAp,0.5384615384615384,18,12,GGCGCGCGCATTACAATTCA,6,1769847
gyrAp,5.461538461538462,82,12,GGCAAGCGGTGGACGGGAAG,70,1755114
gyrAp,1.3076923076923077,28,12,GGACGGCGTGGATCGCCTAT,16,1770880
gyrAp,2.4615384615384617,43,12,GGAATCAAAGCTGCGATCGA,31,1745278
gyrAp,2.0,37,12,GCTTAACGGAGCTTTCGGCC,25,1758836
gyrAp,5.461538461538462,82,12,GCTCTGAGGCCGGGAACGAT,70,1762914
gyrAp,1.6153846153846154,32,12,GCGCACAATCGCGCCAAGCC,20,1742868
gyrAp,1.5384615384615385,31,12,GCCTCAGCATGGGTGATCTC,19,1769463
gyrAp,8.76923076923077,125,12,GCCGAATACCTGCGGCGGAG,113,1754634
gyrAp,0.38461538461538464,16,12,GCCCTGGCCACCGTTGCATT,4,1745654
gyrAp,0.15384615384615385,13,12,GCCCAAAGCTTGGATAGAAG,1,1768929
gyrAp,0.23076923076923078,14,12,GCAACTACCCAGCTAGAGGT,2,1765672
gyrAp,0.5384615384615384,18,12,GATTGCCAATGATCAACTTA,6,1745910
gyrAp,0.3076923076923077,15,12,GAGCGCAGTCCGCATTGTAA,3,1743827
gyrAp,3.3846153846153846,55,12,GACTCTCGAGAAAGCATAAG,43,1760940
gyrAp,0.6153846153846154,19,12,CTTATTCCGAAATGACCGAT,7,1767915
gyrAp,2.3076923076923075,41,12,CTTATGCCTCACCCGAGCGA,29,1752161
gyrAp,2.5384615384615383,44,12,CTTACAACTGAGGCCGTAAT,32,1765373
gyrAp,0.38461538461538464,16,12,CTGATGTAAACGGACAAACT,4,1759522
gyrAp,0.38461538461538464,16,12,CTCTGGCGGGAAGGAAGGGT,4,1751125
gyrAp,7.153846153846154,104,12,CTCGAACTTACCCTACTTAT,92,1751740
gyrAp,1.7692307692307692,34,12,CTCCGTCGTACAGGTAGTTC,22,1743018
gyrAp,1.3076923076923077,28,12,CGTGTGCATGTCAAAGAGTT,16,1758025
gyrAp,3.6153846153846154,58,12,CGTATGCCTTCCCCAGAGAT,46,1750909
gyrAp,0.8461538461538461,22,12,CGGTAGAGTAACAATACCGA,10,1760950
gyrAp,2.230769230769231,40,12,CGCGCTGCCGGGAGATTATA,28,1756574
gyrAp,0.7692307692307693,21,12,CGATACATACAAGATAAGTA,9,1764806
gyrAp,0.15384615384615385,13,12,CGACCGCCCATTGGCTGAGG,1,1766102
gyrAp,0.6923076923076923,20,12,CGAATGCAACCAGACTGAAA,8,1768794
gyrAp,2.1538461538461537,39,12,CCTGGGTACCGCCTTAGGCG,27,1761415
gyrAp,3.5384615384615383,57,12,CCTGGGAGAAAGATTTTCTT,45,1766774
gyrAp,0.46153846153846156,17,12,CCGAAGAGGTAGCTCGTTTT,5,1753393
gyrAp,3.1538461538461537,52,12,CCCTTCGATTTACAAAATCA,40,1745116
gyrAp,1.3846153846153846,29,12,CCCTGTCCCGTTGTGTTGAG,17,1768727
gyrAp,4.076923076923077,64,12,CCCGTCCGAAACAGACCGAT,52,1743997
gyrAp,2.923076923076923,49,12,CATTATTCAGAACCTACACA,37,1747179
gyrAp,1.2307692307692308,27,12,CATCAGCGTGATTGAGTTGC,15,1756530
gyrAp,3.769230769230769,60,12,CAGGGATATTGTGTTACAAA,48,1755206
gyrAp,12.076923076923077,168,12,CACTCGGCGCAATTAGAGTT,156,1755107
gyrAp,3.769230769230769,60,12,CACGCCTCGTTATGGTACTT,48,1768287
gyrAp,3.6923076923076925,59,12,CACCACGAATACGTGTCCCT,47,1757747
gyrAp,2.3846153846153846,42,12,CAACCCATAGCTAAGAACTC,30,1755540
gyrAp,0.6923076923076923,20,12,CAAATAACACGAGTCATTTC,8,1759820
gyrAp,0.46153846153846156,17,12,ATTGGGGTCCGGTTATAAAT,5,1742107
gyrAp,1.3076923076923077,28,12,ATTATACTCTGCGCCGCGAT,16,1747654
gyrAp,2.8461538461538463,48,12,ATCGTCTCAGAATAAGATAT,36,1760760
gyrAp,1.0769230769230769,25,12,ATCATTTATATTAGTACTGA,13,1762787
gyrAp,3.1538461538461537,52,12,ATATATAGGATTACAGGGCT,40,1756515
gyrAp,1.5384615384615385,31,12,AGTGCGCTTAGTTACCCGGT,19,1742413
gyrAp,4.3076923076923075,67,12,AGGTGGGCAGTGTTTAACGT,55,1746945
gyrAp,0.6153846153846154,19,12,AGGAGCAGCCCTACTAATAA,7,1757577
gyrAp,0.46153846153846156,17,12,AGGAAATGCTTGCCCGGTTG,5,1760531
gyrAp,3.1538461538461537,52,12,AGCTTCTAAGTCGTGGATCC,40,1742022
gyrAp,0.15384615384615385,13,12,ACGGGGCCTTGTGAGGAGCA,1,1743502
gyrAp,0.6923076923076923,20,12,ACGGGCTGCGAACTTATGGA,8,1762641
gyrAp,2.076923076923077,38,12,ACGAATCTTAGTGAGATGGA,26,1744237
gyrAp,3.076923076923077,51,12,ACCTCATAAGAGAACTCCCG,39,1752079
gyrAp,0.46153846153846156,17,12,ACCATTTACAGCGAATTGAA,5,1753381
gyrAp,2.1538461538461537,39,12,ACACACATGCTATAATCAGG,27,1765030
gyrAp,1.9230769230769231,36,12,AAGGCCACGAATGACGCTCT,24,1748137
gyrAp,1.2307692307692308,27,12,AAGCCACTGTTTAAAACACT,15,1748342
gyrAp,0.7692307692307693,21,12,AACCGCGCGGTTGCTTAACA,9,1760999
gyrAp,4.0,63,12,AACCCTCACATACACCTCGT,51,1750202
gyrAp,0.15384615384615385,13,12,AACCACCAGCCAGCACTTAA,1,1770039
gyrAp,4.384615384615385,68,12,AAAGAACATATTCCCAAACC,56,1770725
gyrAp,3.6923076923076925,59,12,AAAACGGCGTGGCCCTCCGG,47,1769404
gyrAp,0.4166666666666667,15,11,TTTTGCAGTTTTTGCGACAT,4,1751633
gyrAp,2.5,40,11,TTTTCAATAATCTGTATAAT,29,1754569
gyrAp,2.0833333333333335,35,11,TTGTCAGGGATCATTAATGC,24,1767116
gyrAp,0.9166666666666666,21,11,TTGTATGTCGCCCTGATCAG,10,1770262
gyrAp,0.9166666666666666,21,11,TTGCATTCGCAAAACAAATC,10,1745365
gyrAp,2.75,43,11,TGTGATTCATCTAGATGTCC,32,1742918
gyrAp,1.5,28,11,TGGATGTTAGGTCTAACTCT,17,1760511
gyrAp,1.8333333333333333,32,11,TGCTGAATCAGGTTAACTGG,21,1746677
gyrAp,0.5,16,11,TGCGATCGTAGAAGCTCCGA,5,1754438
gyrAp,1.6666666666666667,30,11,TGCCTAACAGTACTAGCATT,19,1768636
gyrAp,2.0,34,11,TGCATTTCGTGCAAGTATCT,23,1749516
gyrAp,0.9166666666666666,21,11,TGATCGTGGACCCTGCTGCC,10,1751752
gyrAp,1.5833333333333333,29,11,TGATAGTTCTCAAGGCGGCT,18,1745343
gyrAp,2.3333333333333335,38,11,TGACTTCCCGTTGCGGCTAC,27,1752803
gyrAp,1.0,22,11,TGACGTGTACTCAACTTAGA,11,1767276
gyrAp,0.6666666666666666,18,11,TGACCACCTGAACTTAGTTC,7,1745055
gyrAp,5.416666666666667,75,11,TCTTGGACATAAATCGCTCA,64,1755774
gyrAp,0.3333333333333333,14,11,TCTGGTGCGATATAAATAGG,3,1758024
gyrAp,0.6666666666666666,18,11,TCTAGCACCATCGAAATTGC,7,1769870
gyrAp,1.3333333333333333,26,11,TCTAGAAATTGGTCGCCCAC,15,1758060
gyrAp,2.25,37,11,TCGGTGCGCCACGGCTGGCT,26,1760969
gyrAp,4.5,64,11,TCCTGCATGATAACTAAATA,53,1751632
gyrAp,4.166666666666667,60,11,TCCTAACGTTTCATCCTTAC,49,1745133
gyrAp,2.75,43,11,TCCGCAAGATCCCCGGCACA,32,1743418
gyrAp,2.4166666666666665,39,11,TCAGGGCCTTTTTGTTTTTT,28,1754640
gyrAp,5.5,76,11,TCAATTCAATTGAAATATGG,65,1757710
gyrAp,1.25,25,11,TCAATCGGCTTTGACAGATA,14,1747153
gyrAp,0.16666666666666666,12,11,TATTTCGGTGTTTCGAACTA,1,1743921
gyrAp,0.16666666666666666,12,11,TATAGATACCAGGTTAGGGG,1,1760927
gyrAp,0.8333333333333334,20,11,TAGGCATACTTTAGGCTGAT,9,1765484
gyrAp,0.5,16,11,TAGCGGACATGATGGAACGA,5,1758175
gyrAp,0.3333333333333333,14,11,TAACGCGATCTTATATAGTA,3,1741947
gyrAp,2.0833333333333335,35,11,GTTTTTGCCCGGCAACGGGG,24,1757100
gyrAp,4.333333333333333,62,11,GTTCCTCTTTGTAGATACGT,51,1758415
gyrAp,0.5833333333333334,17,11,GTGTGATGCTTTGATCGCGT,6,1755408
gyrAp,3.3333333333333335,50,11,GTGCATGTAGAAGGTAATGT,39,1746768
gyrAp,2.5,40,11,GTGCAAAAGGTGCTTCAGTT,29,1757122
gyrAp,4.333333333333333,62,11,GTGACGCCCGAGCAACGAGC,51,1754206
gyrAp,2.0833333333333335,35,11,GTCTGTTTTTTGCGTACTCC,24,1765203
gyrAp,1.9166666666666667,33,11,GTCGGTCGGTCGAGTTTTAG,22,1743914
gyrAp,4.5,64,11,GTACCTTAATTGACTTTCTA,53,1757461
gyrAp,1.0833333333333333,23,11,GTACCCCTCATGCCTTTCTT,12,1766262
gyrAp,1.0,22,11,GTAAATTGAAGAACGAGCCT,11,1749990
gyrAp,1.0,22,11,GGTGTACCACTCCTTTAAGT,11,1768007
gyrAp,4.0,58,11,GGTAGAGAAGAGAGAGGGTT,47,1759708
gyrAp,0.16666666666666666,12,11,GGGGCTTAGGACGGAGATCA,1,1748274
gyrAp,8.166666666666666,108,11,GGGAGAGTTTGCACTAAGGA,97,1761107
gyrAp,8.25,109,11,GGCTCCGCTTACCGCGTCAT,98,1767966
gyrAp,0.25,13,11,GGCGCGGACAACAGTCAAGA,2,1761829
gyrAp,2.9166666666666665,45,11,GGCGAAGGACTACGCAAGCC,34,1758160
gyrAp,1.3333333333333333,26,11,GGCCAGGTGCCTGACTGGTT,15,1747319
gyrAp,0.16666666666666666,12,11,GGAGGCAATCCCTGGAGGGA,1,1762326
gyrAp,1.5833333333333333,29,11,GCTTCAATTGGCTTCACTGA,18,1743871
gyrAp,2.25,37,11,GCCGCAAGTGAATCGTTCTC,26,1758015
gyrAp,0.16666666666666666,12,11,GAGATCGACTTCATCGCGGG,1,1752365
gyrAp,0.6666666666666666,18,11,GACTGCTGGCGCTTAGGAGG,7,1767999
gyrAp,2.8333333333333335,44,11,GAAGTATAAGGTCACTATGT,33,1748079
gyrAp,1.1666666666666667,24,11,CTTTTCTAGTCTCTTGCACG,13,1749525
gyrAp,0.3333333333333333,14,11,CTTCCCGCGCGCACATACTA,3,1762760
gyrAp,0.6666666666666666,18,11,CTGATGTGGGAACACATGAT,7,1770627
gyrAp,2.5,40,11,CTCCAGGTTTAAAAGTAGAT,29,1742156
gyrAp,2.1666666666666665,36,11,CTATGGGAAGTCATATCCGT,25,1753736
gyrAp,2.6666666666666665,42,11,CGTTAGCCAGCTGCATGCCT,31,1751323
gyrAp,0.8333333333333334,20,11,CGTGTGCAGCACAGGATAAG,9,1742046
gyrAp,4.416666666666667,63,11,CGGTGCCTTCGTTACGTCTA,52,1756352
gyrAp,0.16666666666666666,12,11,CGGGTCCTGTTGCTATTGCG,1,1758453
gyrAp,1.75,31,11,CGATTTGCAGAGGGCGGTGT,20,1747526
gyrAp,0.16666666666666666,12,11,CGAGATATAGGGTACCAAGT,1,1745982
gyrAp,2.3333333333333335,38,11,CGAAGAAGAGGGCTGTCGGA,27,1757843
gyrAp,0.9166666666666666,21,11,CGAAACAAAAGACAATCGTT,10,1745295
gyrAp,2.5833333333333335,41,11,CCGGTTGATGCTGGTGATAG,30,1767954
gyrAp,0.16666666666666666,12,11,CCCTACTTGGGAATCCTTAA,1,1745719
gyrAp,1.0833333333333333,23,11,CCCGCGCACCCGGTGTAATA,12,1756661
gyrAp,0.16666666666666666,12,11,CCCGCGATAGTCGCTAACAA,1,1755460
gyrAp,1.5833333333333333,29,11,CCATGTCACACCTCTCTGGC,18,1764089
gyrAp,2.0833333333333335,35,11,CCAGCTGGACTGGCAGGGAG,24,1761459
gyrAp,0.8333333333333334,20,11,CCAAGAAGTGTGACCAGTGC,9,1750877
gyrAp,0.5,16,11,CATCAGTTACGGCCCTTCTG,5,1755910
gyrAp,0.75,19,11,CATAATCTTGGGCTACTAAC,8,1748498
gyrAp,1.75,31,11,CAGGAGAAAAGCGCGATCAG,20,1751736
gyrAp,0.16666666666666666,12,11,CAGATCAGTTAATGTGGTAG,1,1752408
gyrAp,0.4166666666666667,15,11,CACGTGGACGACTTTACTCA,4,1759409
gyrAp,2.5,40,11,CAAGCTATCTGTGTAGTGTG,29,1766384
gyrAp,1.9166666666666667,33,11,CAAATTCCCTCCGGGCTACT,22,1751450
gyrAp,0.6666666666666666,18,11,ATTGAGCGACGCCGGCTGAG,7,1749215
gyrAp,1.6666666666666667,30,11,ATTATTGTTGCCCCGCTTTT,19,1743896
gyrAp,3.1666666666666665,48,11,ATGTTTGTTTAGCACAGTCT,37,1753363
gyrAp,1.0833333333333333,23,11,ATGGCAGAAACATCACGCCT,12,1742504
gyrAp,0.75,19,11,ATCTCTAACTCCGCGTTGGC,8,1749712
gyrAp,2.0833333333333335,35,11,ATAAATAATCCAGTTGATGT,24,1744712
gyrAp,7.333333333333333,98,11,AGTTGGTGAGGTTAACTCGA,87,1758456
gyrAp,1.0,22,11,AGTGTCATGGATCCGACCCT,11,1750393
gyrAp,2.25,37,11,AGTGGAGATAGTCCGGCATT,26,1768883
gyrAp,1.5833333333333333,29,11,AGGATATGGGCGTACACCAA,18,1745968
gyrAp,0.16666666666666666,12,11,AGCGCGATCAGGATTGAACA,1,1761117
gyrAp,4.333333333333333,62,11,AGCCTGCCGATAGGCTATAT,51,1744768
gyrAp,2.6666666666666665,42,11,AGCATATCCAAGCAAACCCT,31,1766004
gyrAp,0.5833333333333334,17,11,AGCACACAAGATGTCGGTTA,6,1759557
gyrAp,3.1666666666666665,48,11,AGACTGTAGCCTGAGACGAG,37,1742279
gyrAp,0.3333333333333333,14,11,AGACGTCTATGGCAGCCATC,3,1747030
gyrAp,0.5833333333333334,17,11,AGAATAGAGGGCGACGGGTT,6,1768171
gyrAp,0.16666666666666666,12,11,ACGGGAGACGTTACAGGTGC,1,1749641
gyrAp,4.083333333333333,59,11,ACGATTCTTTGATCACGCCA,48,1744054
gyrAp,0.5,16,11,ACCACACATGGCGTTTGGGA,5,1752486
gyrAp,0.3333333333333333,14,11,ACCAAGGGTAACAGCAGTGC,3,1752084
gyrAp,5.083333333333333,71,11,ACACATTTGCGTCACATTCC,60,1745247
gyrAp,1.1666666666666667,24,11,AAGGAGGCTTTGGTATTCGC,13,1758782
gyrAp,0.18181818181818182,11,10,TTTTCATTCCGAGTCAGACC,1,1743757
gyrAp,1.0909090909090908,21,10,TTTGTAATGGCTTGTAAACG,11,1741717
gyrAp,2.5454545454545454,37,10,TTTCGGCATGGGTGACCAGC,27,1756858
gyrAp,1.4545454545454546,25,10,TTTAATCGCGTCTATGCTGA,15,1754218
gyrAp,6.181818181818182,77,10,TTTAATCCGTTGTAAATCTA,67,1754718
gyrAp,0.18181818181818182,11,10,TTCACAAAAAAACGTACGCA,1,1750063
gyrAp,4.818181818181818,62,10,TTCAAACGGCGGTTATGGGT,52,1746770
gyrAp,1.8181818181818181,29,10,TGTGTCGTTGAAAATGGTCA,19,1754118
gyrAp,0.2727272727272727,12,10,TGTCCGCCCTAAATATACAG,2,1761860
gyrAp,1.4545454545454546,25,10,TGCTGATCAATGCCACTTGC,15,1769427
gyrAp,0.7272727272727273,17,10,TGAATTGTGGCCTAACACGA,7,1752663
gyrAp,2.6363636363636362,38,10,TCGTCGCATGCATTAGTACA,28,1766646
gyrAp,3.0,42,10,TCGGGACCTTGGACCGTGTG,32,1757140
gyrAp,0.6363636363636364,16,10,TCGCCCCGTCCCCGTATCTG,6,1752438
gyrAp,3.3636363636363638,46,10,TCCGTCATAGCACATTACGT,36,1763064
gyrAp,1.8181818181818181,29,10,TCCATAGCTTTGAGGTCGCC,19,1754760
gyrAp,2.3636363636363638,35,10,TCACTAAAGTGGGGAATTAG,25,1764986
gyrAp,0.5454545454545454,15,10,TCAAGGGCCGGTCAATACGA,5,1742441
gyrAp,8.545454545454545,103,10,TAGCCCATCTTTGATTGTCT,93,1750131
gyrAp,0.7272727272727273,17,10,TACTGTACTCCGCAGGACGG,7,1754908
gyrAp,3.5454545454545454,48,10,TACGCTTTCAGGGAAGCTGG,38,1746173
gyrAp,0.8181818181818182,18,10,TACGAGCCGAAAGGCCTGGT,8,1756662
gyrAp,2.1818181818181817,33,10,TACCCCAGCTGCCTAGCGGT,23,1746912
gyrAp,1.6363636363636365,27,10,TACCAATGTATGACGACATG,17,1765080
gyrAp,2.5454545454545454,37,10,TAATCTTATGCTATCCTTGA,27,1748724
gyrAp,2.909090909090909,41,10,TAATCGCCTGTGGATCAAGC,31,1753300
gyrAp,2.5454545454545454,37,10,TAACCCGTGCAATAATTTCA,27,1751080
gyrAp,3.727272727272727,50,10,GTTTACCTCATCTTCAGCAT,40,1742864
gyrAp,1.2727272727272727,23,10,GTTGTGCAACAGGTCGATTT,13,1744810
gyrAp,1.6363636363636365,27,10,GTTGTATAAGGTTATTGTGC,17,1752673
gyrAp,4.0,53,10,GTTAGCCGTTTCATAATATA,43,1747799
gyrAp,0.7272727272727273,17,10,GTGGGTATCGCCTTGTCGGT,7,1767029
gyrAp,2.5454545454545454,37,10,GTGCTTGTAGGGATACTCAT,27,1768556
gyrAp,0.45454545454545453,14,10,GTGAGTATTGAGTCATGGGA,4,1757069
gyrAp,1.0909090909090908,21,10,GTAGGCGTATTATAAGTGGG,11,1752504
gyrAp,0.5454545454545454,15,10,GTAACTCAAACATACCCGCT,5,1750597
gyrAp,0.6363636363636364,16,10,GGTTGGCGCCTTGCCTGAAT,6,1757894
gyrAp,0.45454545454545453,14,10,GGTTCCTGCCCTTTTACCGT,4,1742853
gyrAp,0.18181818181818182,11,10,GGTGGCCTCATTCCAAGGCG,1,1769240
gyrAp,3.5454545454545454,48,10,GGTGGATTATTGCCCGTATA,38,1743296
gyrAp,1.8181818181818181,29,10,GGGTTTCTCGCCGGGCGCCG,19,1751251
gyrAp,1.2727272727272727,23,10,GGGCTCTAGTCCCCCAAGAC,13,1767090
gyrAp,3.1818181818181817,44,10,GGGCCAGCGGGACTCGGCAG,34,1754719
gyrAp,0.45454545454545453,14,10,GGGCATTGTGGTCACAAGAC,4,1756783
gyrAp,4.2727272727272725,56,10,GGCCTTTGGTTTGAAATACA,46,1764775
gyrAp,6.181818181818182,77,10,GGCCTATTATCACAAACTTC,67,1741587
gyrAp,0.18181818181818182,11,10,GGCCGACCCGCAAGACAACT,1,1741455
gyrAp,0.8181818181818182,18,10,GGCCCCTCCAGGTTGGCTAT,8,1746090
gyrAp,0.36363636363636365,13,10,GGCAATAAAAGGGTTGCATA,3,1755664
gyrAp,0.8181818181818182,18,10,GGCAAGCCTGTCATTTGTAA,8,1754752
gyrAp,0.18181818181818182,11,10,GCTGATAGGTTGTAAGAGTA,1,1746373
gyrAp,3.909090909090909,52,10,GCTGACTGCTCCCGTCCCTA,42,1761692
gyrAp,3.0,42,10,GCGCAGTTGAGTATGCCATG,32,1743311
gyrAp,2.1818181818181817,33,10,GCGAGCTCAAGGAGAGCCCC,23,1743587
gyrAp,0.45454545454545453,14,10,GCCCACCAAGTAAGTCAGTG,4,1754629
gyrAp,1.3636363636363635,24,10,GAATCTCCAATCAACCTCTA,14,1770607
gyrAp,0.2727272727272727,12,10,GAAGGGATCCTGCCCGATTA,2,1747815
gyrAp,7.363636363636363,90,10,GAACTGAACCACGGAAGTTA,80,1762182
gyrAp,4.2727272727272725,56,10,GAACAATCACGGTATGTGTC,46,1744173
gyrAp,0.36363636363636365,13,10,CTCTAAAATTTTATGCCACG,3,1743361
gyrAp,3.8181818181818183,51,10,CTCCGGGAAAGTCTGCTGTC,41,1756830
gyrAp,1.3636363636363635,24,10,CTCAGGACCCAGGTCTTCTA,14,1745803
gyrAp,0.45454545454545453,14,10,CTCAATGCCGCTATTGGCGG,4,1760328
gyrAp,1.6363636363636365,27,10,CTATTATACAGTTCGTACCT,17,1757218
gyrAp,5.7272727272727275,72,10,CTACCGACCCGAGCGGCCCC,62,1768155
gyrAp,1.8181818181818181,29,10,CTACAGGGAGGGTTGGCACA,19,1743332
gyrAp,3.0,42,10,CGTGTACCTTGACGTGATAT,32,1756336
gyrAp,0.18181818181818182,11,10,CGTCTGCCCACGTGGTCCAG,1,1763370
gyrAp,0.7272727272727273,17,10,CGTCGGATGGTCATATTTTT,7,1744555
gyrAp,4.454545454545454,58,10,CGGTGGTAAGGGTTCGCCTC,48,1761481
gyrAp,0.6363636363636364,16,10,CGGGACGGAGTTCGAGTACG,6,1757822
gyrAp,2.272727272727273,34,10,CGGATTAACGTGGCATCTAC,24,1742276
gyrAp,2.090909090909091,32,10,CGGAGGCAAGTCCCGTGACG,22,1762676
gyrAp,0.36363636363636365,13,10,CGCTTTCTCAGTCTGTAAGG,3,1743447
gyrAp,0.36363636363636365,13,10,CGCTGTTGGCTGCAGTTACT,3,1764973
gyrAp,1.0909090909090908,21,10,CGCTGGCTTTTCCCCATCGC,11,1741806
gyrAp,2.4545454545454546,36,10,CGCTGCCGATACCAATGAGA,26,1756296
gyrAp,5.2727272727272725,67,10,CGCGTTATATCCTCATGGGG,57,1741633
gyrAp,0.6363636363636364,16,10,CGCCTAATAACCGTGCGTGT,6,1755276
gyrAp,1.0,20,10,CCTTATGTTATTTAACCCCA,10,1754034
gyrAp,0.6363636363636364,16,10,CCTAAATAAGTCGTATCGAA,6,1766717
gyrAp,2.3636363636363638,35,10,CCGTTTTCATCGGTCGGCCT,25,1769454
gyrAp,1.5454545454545454,26,10,CCGTGGGGCGAATATCAGTG,16,1756690
gyrAp,2.3636363636363638,35,10,CCCTCAATCGTGACAGTCCG,25,1744969
gyrAp,1.1818181818181819,22,10,CCATCAATTTGCAAATAATC,12,1752739
gyrAp,15.909090909090908,184,10,CCAACGCTTCACCTCACTGT,174,1769103
gyrAp,0.18181818181818182,11,10,CATTATAGAACCTTTAAAGG,1,1746915
gyrAp,3.5454545454545454,48,10,CATAGTTAATTAATGATTGG,38,1770295
gyrAp,0.5454545454545454,15,10,CAGGCAGCGACTTCCTCAAT,5,1752503
gyrAp,0.7272727272727273,17,10,CACTTCCAGAGCTCCTGTCC,7,1764186
gyrAp,0.2727272727272727,12,10,CACTCCCCCATTCTTGCCTC,2,1756618
gyrAp,0.7272727272727273,17,10,CAATTGGTATGTGGACCCAA,7,1760012
gyrAp,1.2727272727272727,23,10,CAATGAGTGTTCTAATAAAT,13,1746662
gyrAp,1.6363636363636365,27,10,CAAGACTTTGGGTCACCCAA,17,1746999
gyrAp,3.090909090909091,43,10,ATTCGTTGCTAGCTTACATG,33,1742637
gyrAp,1.0909090909090908,21,10,ATGCACGGTGACCGCTGATG,11,1759448
gyrAp,0.5454545454545454,15,10,ATCAGACCCCTGCGTTCTTT,5,1756446
gyrAp,3.0,42,10,ATCACATGCATCAAAGTGCT,32,1742772
gyrAp,0.36363636363636365,13,10,ATACGTGTGACCTCGCGTCA,3,1756004
gyrAp,0.18181818181818182,11,10,AGTTGGGCTAAACTTAGAAA,1,1748396
gyrAp,2.909090909090909,41,10,AGGTGCTCGTCTATGTCACT,31,1744509
gyrAp,0.36363636363636365,13,10,AGGGCTACGGTTAGGAGTAT,3,1753997
gyrAp,2.090909090909091,32,10,AGGGATCATTTTGGTACCGA,22,1744486
gyrAp,0.18181818181818182,11,10,AGGAATTCCGCGTTCGCTGT,1,1764120
gyrAp,1.6363636363636365,27,10,AGGAAAATCACCGGTAATGA,17,1753950
gyrAp,1.1818181818181819,22,10,AGAGCGCTTTCGCTATCCAA,12,1749909
gyrAp,1.3636363636363635,24,10,AGAGAGGATGCCTTTCGTTC,14,1765092
gyrAp,3.272727272727273,45,10,ACTGTTTGGTCGGGTGCCCA,35,1761371
gyrAp,4.636363636363637,60,10,ACTCTGTAGGGCAGGTAGCG,50,1756369
gyrAp,1.6363636363636365,27,10,ACGTATCGGGGTTCATGGCT,17,1761382
gyrAp,0.18181818181818182,11,10,ACGGTGGTATCACGGCGTCA,1,1770300
gyrAp,0.7272727272727273,17,10,ACGCCCGAATAAGTACGAGT,7,1751913
gyrAp,4.636363636363637,60,10,ACCTGGGATCTCTAAGTACT,50,1745859
gyrAp,1.6363636363636365,27,10,ACCTCGCAGAGGTGAATAAC,17,1759591
gyrAp,0.18181818181818182,11,10,ACCTAAATTCGATGCTACTT,1,1760814
gyrAp,0.9090909090909091,19,10,ACCGGCCCACTTCTAGTTGT,9,1750069
gyrAp,1.5454545454545454,26,10,ACCGACCATTGTGTCCAGGT,16,1748128
gyrAp,0.8181818181818182,18,10,ACCACGGACATGCATGGCCA,8,1744975
gyrAp,1.8181818181818181,29,10,AATTCTCCCCTTAGATGCGT,19,1753759
gyrAp,0.18181818181818182,11,10,AATGCAGCCTGGTAGTGGCG,1,1753065
gyrAp,0.2727272727272727,12,10,AATGATGATACGGTTTATTT,2,1766087
gyrAp,0.18181818181818182,11,10,AAGTTGATGAAGATGGATTG,1,1743484
gyrAp,3.5454545454545454,48,10,AAGGGGTAGTTTCAGGCTGT,38,1765605
gyrAp,3.5454545454545454,48,10,AAGGGCTTTCTAGAAGCGAT,38,1769176
gyrAp,2.6363636363636362,38,10,AAGGCGTGGGATTGGGTTAC,28,1754823
gyrAp,0.18181818181818182,11,10,AAGCGCATCAATTCGACTAC,1,1770620
gyrAp,1.3636363636363635,24,10,AAGAGCAGATTCTCCTTGCT,14,1762712
gyrAp,2.4545454545454546,36,10,AACGTGGGTGCAATTTCGTG,26,1768312
gyrAp,5.363636363636363,68,10,AACCTCGCAATGAATGAACT,58,1750714
gyrAp,3.5454545454545454,48,10,AACCGGATTGAGTCTAGGTG,38,1754854
gyrAp,3.090909090909091,43,10,AAATAGGACAGAGCGATTCT,33,1742776
gyrAp,1.1818181818181819,22,10,AAATAAAATACCTATCAAGA,12,1767074
gyrAp,3.090909090909091,43,10,AAACGAGCTGTCGGAACAGA,33,1769220
gyrAp,3.3,41,9,TTTGATTTGATCGATACGAG,32,1762973
gyrAp,1.5,23,9,TTTCGATTCATCGGGGGAGT,14,1765156
gyrAp,3.5,43,9,TTGTAGCCGGGACACCGTGA,34,1745457
gyrAp,2.2,30,9,TTGAATAAGCGAGCGCTCCC,21,1769134
gyrAp,0.4,12,9,TTCATGTGCCGTAACGTCTA,3,1762270
gyrAp,0.2,10,9,TTACCAAGAAATAAGAGCAT,1,1742303
gyrAp,1.4,22,9,TGTGTGAGCGGATCCTTATT,13,1755571
gyrAp,5.3,61,9,TGGCCCTCTTTACTTGTATT,52,1752742
gyrAp,2.7,35,9,TGATGCATGATTATCGTCCT,26,1743870
gyrAp,8.4,92,9,TCTCCGCCGTAGGTGTTGCA,83,1758542
gyrAp,1.7,25,9,TCGAGCTGCCACGAGCTACT,16,1754266
gyrAp,1.6,24,9,TCCTGACCACATCACAATGC,15,1762325
gyrAp,0.2,10,9,TCCGTAGAAAGACTGGCTGA,1,1750339
gyrAp,0.2,10,9,TCCCAAGTCGCACACAGTAA,1,1751818
gyrAp,1.6,24,9,TCCCAACAATAGGTGGGTGC,15,1758171
gyrAp,1.1,19,9,TCATCAAGTTCTATTTATAT,10,1747671
gyrAp,5.5,63,9,TCAGAACTTCGCTAGACTGA,54,1750612
gyrAp,0.6,14,9,TCAATAGGCGCCCATGGTTA,5,1759582
gyrAp,8.1,89,9,TCAACAGTACTCCCCCCAAC,80,1757187
gyrAp,0.5,13,9,TATGTTGTGTAGTGATAAGA,4,1751005
gyrAp,0.8,16,9,TATCCTCTCGCTAGAGTCCG,7,1758317
gyrAp,0.2,10,9,TAGTATCTTCAACATTAGGC,1,1746979
gyrAp,5.8,66,9,GTTGGCTTAGTCTGACTTCA,57,1748845
gyrAp,0.8,16,9,GTTCGGTTCACCATTAACGC,7,1758237
gyrAp,2.0,28,9,GTGTCTTGACACTGTTTTAT,19,1762027
gyrAp,1.7,25,9,GTCGTTTGTGAATGCGTTTA,16,1743345
gyrAp,2.1,29,9,GTCGTCGGTAAACAGGGGTG,20,1743500
gyrAp,6.8,76,9,GTCGACGGGGTCTAGGGCCA,67,1747205
gyrAp,0.7,15,9,GTCCATCGTAGGCACTCGGT,6,1754969
gyrAp,2.2,30,9,GTAATGCTTGGGACTCTGAG,21,1765640
gyrAp,2.3,31,9,GTAAGCCGTATGAGCCGTCT,22,1761743
gyrAp,3.3,41,9,GTAACCTCCGCCCAGCAAAT,32,1764478
gyrAp,0.7,15,9,GTAAAGTCTAAGAGAAATGG,6,1741921
gyrAp,2.6,34,9,GGTTCAGTAATGTATCGGTT,25,1753090
gyrAp,3.2,40,9,GGTCGGAGCGAGCTGTCAAG,31,1751221
gyrAp,1.8,26,9,GGTCACTGTAGGTAATGGGT,17,1746792
gyrAp,1.5,23,9,GGTAGGTATGGCTGCGAGGC,14,1745419
gyrAp,0.5,13,9,GGGGGTCGGTATAGCCCGCG,4,1764960
gyrAp,0.2,10,9,GGGGGCTGGAGAGGATCGGT,1,1763191
gyrAp,3.5,43,9,GGCGGTTTCGGCGTACGGTC,34,1767133
gyrAp,0.2,10,9,GGCAAATTCGGATTAGTGTA,1,1747093
gyrAp,5.0,58,9,GGACTCAGAGCCATGCATCC,49,1756683
gyrAp,2.0,28,9,GGAAGGATTGACATTCAAAT,19,1766334
gyrAp,1.8,26,9,GCTGCCTGAAAAGTTGCGTA,17,1761438
gyrAp,6.1,69,9,GCGGGCGCCCCTCAGGGTAA,60,1755962
gyrAp,0.3,11,9,GCGATTACGCAACCTCTGAT,2,1754447
gyrAp,1.1,19,9,GCGAATTAAGAAGGCTTCAC,10,1766976
gyrAp,1.9,27,9,GCCTCACAAGTTACGGGCAG,18,1743693
gyrAp,2.2,30,9,GCAGCCCTAGCCGTCGATAC,21,1761558
gyrAp,7.7,85,9,GCAACCTCGTCTGTTGCTAA,76,1742852
gyrAp,2.7,35,9,GATTTATGAAACGGGGTTGG,26,1763509
gyrAp,0.6,14,9,GATCTATCAAATTCCCATCG,5,1755270
gyrAp,0.8,16,9,GATCACGGCTCATACTAGTC,7,1749386
gyrAp,0.2,10,9,GACGTGCACATAGTACTTCG,1,1752491
gyrAp,5.3,61,9,GACAGCTCCGTTGGATGGAT,52,1763506
gyrAp,2.0,28,9,GAATCATCCACTGTTAGAAA,19,1753485
gyrAp,2.6,34,9,CTTTTTCATCCCCATGAGAA,25,1745682
gyrAp,9.6,104,9,CTTCTGAGCTCTTAACGGGG,95,1757814
gyrAp,1.9,27,9,CTGTTCAACCATGGATTTCA,18,1747909
gyrAp,0.2,10,9,CTGATAATGGACTGAACAGT,1,1767735
gyrAp,1.3,21,9,CTCCGGTCCAGGTAAGTGAT,12,1763257
gyrAp,2.5,33,9,CTCATGAGGCCTAATCGCAG,24,1744450
gyrAp,3.1,39,9,CTATTGCAACCAACGGGTTA,30,1746929
gyrAp,0.6,14,9,CTATCGTCTTGACCTAATTT,5,1770482
gyrAp,5.6,64,9,CTATACTGCCTCGTGTATAG,55,1741827
gyrAp,3.4,42,9,CTAGGTGCTCGGGCGGCAAT,33,1765124
gyrAp,1.6,24,9,CTACATATCGTAGTGGAAGG,15,1757631
gyrAp,3.1,39,9,CGTTAGGCCTTCGATGCTAA,30,1751173
gyrAp,0.9,17,9,CGTTACTAATGCCTCAGGCA,8,1758312
gyrAp,0.4,12,9,CGTGGAGACAAAGCCGGAAG,3,1761227
gyrAp,3.5,43,9,CGGTTGAAACGATCGCATTG,34,1767589
gyrAp,0.2,10,9,CGGTGACTCGAAAGCTGCGA,1,1767756
gyrAp,0.5,13,9,CGGGGCTGAAAATGGACAAA,4,1758650
gyrAp,3.7,45,9,CGGCCGATTCCTTGTGCTAG,36,1759461
gyrAp,0.4,12,9,CGCGGAAACGGCCCGAACAC,3,1762682
gyrAp,1.9,27,9,CGCCAGTGGTCATAGGACAG,18,1746633
gyrAp,1.7,25,9,CGCATTCCGCTTATGCTTAA,16,1765225
gyrAp,3.3,41,9,CGAAATCAAGACCGGGCACA,32,1752639
gyrAp,1.1,19,9,CCTGCATAGCGAGCCCTTGG,10,1749038
gyrAp,0.7,15,9,CCTCATGCCCACGCAGAGCC,6,1747231
gyrAp,0.2,10,9,CCGCGTCCGCAATCGGAGAA,1,1751258
gyrAp,3.0,38,9,CCGACGGGGTTGTTTCCAGA,29,1742666
gyrAp,0.5,13,9,CCCTGCGTCGCTTGTCGTTT,4,1766006
gyrAp,1.3,21,9,CCCGCGGTTAGTTACGCACT,12,1752675
gyrAp,4.4,52,9,CCCAAGTCACATCAACAGTA,43,1751220
gyrAp,2.5,33,9,CCAGGTGTTCCTACAGCATA,24,1748675
gyrAp,3.1,39,9,CCAACGGGCATGTGTGGTAT,30,1763255
gyrAp,1.6,24,9,CATGGCGTTTTTTGGTAATC,15,1766752
gyrAp,2.3,31,9,CATGATTTACGTTATATTAA,22,1769329
gyrAp,5.4,62,9,CATGAAAATGATCACGTCGT,53,1763353
gyrAp,1.6,24,9,CATAGATCTTTCGCAATACA,15,1747687
gyrAp,4.1,49,9,CAGCGAGGAGACAATTAGCT,40,1762920
gyrAp,0.3,11,9,CAGAGCGCATAGTTGACTTC,2,1744978
gyrAp,5.1,59,9,CACGTATGCCGCCCGATCTG,50,1756050
gyrAp,1.3,21,9,CACGGCCCCTGGCGGGACTG,12,1761440
gyrAp,7.0,78,9,CACAGGCGAGGTCTACGCGT,69,1749311
gyrAp,1.9,27,9,CAAGGGATCTAGGCTGCGCC,18,1766296
gyrAp,1.3,21,9,CAACGTTCTTTGCCCAGTAC,12,1755530
gyrAp,2.8,36,9,CAACAGCCCCGAGATGTTTT,27,1764153
gyrAp,2.2,30,9,ATTCGCGGCCAAATTTCAAG,21,1753745
gyrAp,0.3,11,9,ATGTGTGGCTAGACAGTTCC,2,1760098
gyrAp,2.1,29,9,ATGCGGTTGCGCGATGGATT,20,1760275
gyrAp,3.0,38,9,ATGCAACATCCAATTCTGGT,29,1755565
gyrAp,0.8,16,9,ATCTGCATGCGTGCGATGTG,7,1759933
gyrAp,0.2,10,9,ATCCGCTTAACGATCATGCT,1,1742761
gyrAp,1.3,21,9,ATCCGATGTGTGTCATACGA,12,1761941
gyrAp,1.0,18,9,ATCAGTGTAAGGCTACCCTA,9,1748048
gyrAp,2.3,31,9,ATATGTTGCCTCCAGTCCTC,22,1745898
gyrAp,0.6,14,9,ATAATTTGGTGAAAGAAAGG,5,1756415
gyrAp,4.7,55,9,AGTTATCCTAAAGGGTGCGT,46,1767965
gyrAp,2.6,34,9,AGTGGTCGCTTTTTATATCG,25,1756860
gyrAp,0.6,14,9,AGTACTTACGACTTGACGCT,5,1764245
gyrAp,0.9,17,9,AGGTAAGGTGTCGGATTTTG,8,1751858
gyrAp,1.9,27,9,AGGGGTCACGCCGCGAAGTC,18,1749086
gyrAp,2.7,35,9,AGGATAAGGCGTAAATCTTG,26,1751979
gyrAp,3.0,38,9,AGCCGCGGTTGAGAGAGACT,29,1748004
gyrAp,3.2,40,9,AGATTTCACGGAGTCGTACA,31,1742155
gyrAp,2.5,33,9,AGATCTAGGCAATGTTTGAC,24,1749371
gyrAp,1.3,21,9,ACTACGATCAAATCAGTGCG,12,1759303
gyrAp,20.6,214,9,ACGGACCGCCCGGGCTTGCA,205,1743514
gyrAp,2.8,36,9,ACCCGAACCAAACGGATATT,27,1742317
gyrAp,0.3,11,9,ACCAGCACGGGTGTTAAGAC,2,1760310
gyrAp,1.2,20,9,AATTGCTTTAAATGGGACAG,11,1755148
gyrAp,2.4,32,9,AATGTGGGCGTTATAGGGCA,23,1755225
gyrAp,1.6,24,9,AAGCTGGCCTGCCATACGGT,15,1748225
gyrAp,0.2,10,9,AAGCACGGCAGAGCCCACTC,1,1745407
gyrAp,0.5,13,9,AAGCACCTCTGACTTCGACT,4,1766949
gyrAp,2.9,37,9,AACTTCTCTTGCACCTGGAA,28,1757464
gyrAp,2.2,30,9,AACTGGCAAGAGCAATGTCT,21,1763726
gyrAp,1.3,21,9,AACCGTACCCTTACAGTATC,12,1760596
gyrAp,0.4,12,9,AACACGAAAACATAGGGAGA,3,1755949
gyrAp,1.1,19,9,AAAGGCCCACACTTTAAAGT,10,1748813
gyrAp,0.7,15,9,AAACTTTGGTGATCTCGAGA,6,1745296
gyrAp,0.2,10,9,AAAACCACTGTCCGAAAGAG,1,1765606
gyrAp,2.888888888888889,33,8,TTTTTTTACACTTAACCTCG,25,1753197
gyrAp,2.5555555555555554,30,8,TTTGGGCCAGGCACCGACGA,22,1746618
gyrAp,5.333333333333333,55,8,TTTGCCTCTGCTAGTTACTA,47,1762277
gyrAp,0.6666666666666666,13,8,TTGCCGTCGGGAAGTTCCAA,5,1765510
gyrAp,4.444444444444445,47,8,TTCTTTGGGGGATGTACCGA,39,1758020
gyrAp,1.4444444444444444,20,8,TTCGGGCCTCTAGGTGCTTA,12,1746783
gyrAp,1.0,16,8,TTCCATGGGGTAATATTCAC,8,1741697
gyrAp,1.4444444444444444,20,8,TTCAGTAACGATCCAGTTTT,12,1769301
gyrAp,1.2222222222222223,18,8,TTATCTGTTGGCATTTAAAC,10,1749132
gyrAp,5.888888888888889,60,8,TTAGTTCGGCTCGGTACTCT,52,1746400
gyrAp,2.5555555555555554,30,8,TTAGTTCGATCGGTAAGGGA,22,1757712
gyrAp,0.2222222222222222,9,8,TTAATCCGAAGGGCGATTCT,1,1747737
gyrAp,1.7777777777777777,23,8,TGTGCAGTTATGGGCGTATA,15,1766057
gyrAp,4.222222222222222,45,8,TGTCTAGGGATATGCCGGGA,37,1761585
gyrAp,1.6666666666666667,22,8,TGGTGCTCGAAGGCGTGTGC,14,1754119
gyrAp,0.6666666666666666,13,8,TGGGTCACGTATTGCGTGAC,5,1741693
gyrAp,1.5555555555555556,21,8,TGGCTGCTCTTTTAAGAAGG,13,1750545
gyrAp,0.2222222222222222,9,8,TGCCGCCTACTATGGGCACG,1,1759550
gyrAp,0.7777777777777778,14,8,TGCATTACTAAAAACATTCA,6,1749874
gyrAp,0.6666666666666666,13,8,TCTCCCAAGATATATGGGGG,5,1758739
gyrAp,3.7777777777777777,41,8,TCGGGTCGTCGGTCGAATGC,33,1764394
gyrAp,1.8888888888888888,24,8,TCGGCTGTAGTAGTATTGTT,16,1755909
gyrAp,3.7777777777777777,41,8,TCGACGTTAAGGCATGGCGT,33,1755272
gyrAp,4.333333333333333,46,8,TCGAATATCGGTACAGAATC,38,1748497
gyrAp,0.6666666666666666,13,8,TCCGCTCAGTTTTGACCAGG,5,1755821
gyrAp,1.1111111111111112,17,8,TCCCTGCCGTTAGGGCGGAG,9,1748494
gyrAp,2.5555555555555554,30,8,TCAACATTCACATTCCAGTC,22,1769654
gyrAp,2.4444444444444446,29,8,TATGACCATTAACCTGTGCA,21,1754417
gyrAp,0.2222222222222222,9,8,TATCATACTAAAGTAGTCCC,1,1748341
gyrAp,1.5555555555555556,21,8,TATATACACGCATACTCAAA,13,1754689
gyrAp,2.0,25,8,TAGATTATCCGGCCAGACAA,17,1742160
gyrAp,0.2222222222222222,9,8,TAGATTACTGCACCAGTGGA,1,1760062
gyrAp,0.3333333333333333,10,8,TACGGAGCTAAGAAGCAGAA,2,1755301
gyrAp,0.2222222222222222,9,8,TAATTGGATCCTAAACAGCG,1,1749816
gyrAp,3.6666666666666665,40,8,GTTTTTCAGTCTGGGTGGCG,32,1756711
gyrAp,4.888888888888889,51,8,GTTTTCCGTGATCGATTAGA,43,1750950
gyrAp,6.0,61,8,GTTTACGGGTATCCCGTGAC,53,1750645
gyrAp,13.88888888888889,132,8,GTTGCAAGCTTTTTACACGT,124,1759024
gyrAp,4.666666666666667,49,8,GTGTGACGGCGCATCAATGC,41,1766879
gyrAp,3.4444444444444446,38,8,GTGGTTTACCAAATAATCCT,30,1766899
gyrAp,2.111111111111111,26,8,GTGGCTTCAATTTAGGCGGA,18,1749632
gyrAp,1.5555555555555556,21,8,GTGATCCGAGATCCAGCGCT,13,1755976
gyrAp,2.111111111111111,26,8,GTCTGCTTGGCGTAAGGAAT,18,1742047
gyrAp,1.5555555555555556,21,8,GTCTGAACGCAGACACGACG,13,1755515
gyrAp,0.4444444444444444,11,8,GTCTATACTCTAGACGATGG,3,1760793
gyrAp,1.6666666666666667,22,8,GTCTAATGGCCGCGACGGCC,14,1747502
gyrAp,4.111111111111111,44,8,GTCGTGACGGCGGGGCTAAC,36,1768714
gyrAp,2.2222222222222223,27,8,GTCGGTCACCCAGTAATGGG,19,1743755
gyrAp,0.5555555555555556,12,8,GTCCGTTCGGTGCCTGCGCA,4,1744146
gyrAp,1.8888888888888888,24,8,GTCACACTATTGGGGTTAGA,16,1759958
gyrAp,3.3333333333333335,37,8,GTCAAGGTAGATGCAACCGT,29,1761574
gyrAp,6.222222222222222,63,8,GTAGTGTACGAGCACGGGAA,55,1767430
gyrAp,4.777777777777778,50,8,GTAATCGACGTGGGCGGAAT,42,1746125
gyrAp,3.5555555555555554,39,8,GGTCACCAAACTGGATGCCA,31,1747133
gyrAp,0.2222222222222222,9,8,GGTACCGTACGGTTCTATCG,1,1767326
gyrAp,2.4444444444444446,29,8,GGTAATTTATCACAGAGGTA,21,1744728
gyrAp,0.5555555555555556,12,8,GGGTTCTACCACGCATCCTA,4,1761354
gyrAp,0.7777777777777778,14,8,GGGGATCCGGCAGGACGCAG,6,1745047
gyrAp,0.2222222222222222,9,8,GGCCGAACTATTCCCTCACA,1,1747172
gyrAp,5.0,52,8,GGCATACTCGTGCAGGCTTA,44,1764408
gyrAp,4.0,43,8,GGCAGGTATCATTCCGGAGG,35,1755926
gyrAp,3.2222222222222223,36,8,GGCAATCGGGCTGCCGCGGT,28,1744378
gyrAp,2.2222222222222223,27,8,GGATGGAATTCCTTCTAGTT,19,1752142
gyrAp,2.7777777777777777,32,8,GGAGGAACCGAGTTTCATGT,24,1754779
gyrAp,6.333333333333333,64,8,GCTTGCGCAGTGTAACCGCT,56,1764890
gyrAp,0.5555555555555556,12,8,GCTTCCCGCTCAACTAAAAT,4,1754077
gyrAp,5.111111111111111,53,8,GCTTATCAAGGCGGCGTCCT,45,1765490
gyrAp,0.2222222222222222,9,8,GCTCGTAAATAGTCAATAGT,1,1757299
gyrAp,4.666666666666667,49,8,GCTCGACCAGTGTATGTACT,41,1747539
gyrAp,0.7777777777777778,14,8,GCTATGTCTGCGCGTGGGTT,6,1759995
gyrAp,0.7777777777777778,14,8,GCGTGATCGGTTCGAAGAGG,6,1741755
gyrAp,2.2222222222222223,27,8,GCGCGATCGCAGGGGGGTAC,19,1742662
gyrAp,1.3333333333333333,19,8,GCCGATGGTCCGGTTACGCT,11,1768993
gyrAp,6.0,61,8,GCCATAATGCATAACGTACA,53,1760387
gyrAp,4.333333333333333,46,8,GCACCGTCAACTTGCAGAGT,38,1743023
gyrAp,1.2222222222222223,18,8,GATCGCCCTAAGGCTCGAAA,10,1762002
gyrAp,0.3333333333333333,10,8,GATATCCGAATATTAACTTC,2,1741569
gyrAp,4.333333333333333,46,8,GAGGTCGGTGAGTCCCAAAG,38,1764138
gyrAp,1.5555555555555556,21,8,GAGATTGGTAGGGACTCAAG,13,1744271
gyrAp,0.7777777777777778,14,8,GACTTTACATGGAACAGTCC,6,1764059
gyrAp,1.2222222222222223,18,8,GACTTCTACATTGCGGTCGG,10,1767318
gyrAp,4.888888888888889,51,8,GACAAAGTAGGTTCGGTTAG,43,1769181
gyrAp,2.5555555555555554,30,8,GAAGGGCAATCACGGTGTTG,22,1755697
gyrAp,3.3333333333333335,37,8,GAACTCTCCTCCCGTAAATG,29,1749260
gyrAp,4.222222222222222,45,8,GAACCGCAGTGCTTAGTATT,37,1751660
gyrAp,7.0,70,8,GAAAGATGGTCAGAATACTT,62,1761265
gyrAp,3.0,34,8,CTTCAGCTAGTTGGTAGGGG,26,1743501
gyrAp,2.111111111111111,26,8,CTGTTGAAGCTCCGTTGGGA,18,1766479
gyrAp,0.2222222222222222,9,8,CTGTGCGGCTGGTACTCCGT,1,1751796
gyrAp,4.222222222222222,45,8,CTCTGCTACATACGTCCTGC,37,1750451
gyrAp,0.2222222222222222,9,8,CTCCTTACGTCTCTTAAGAA,1,1767698
gyrAp,3.4444444444444446,38,8,CTCAAGCCTTCCGTGAAACT,30,1766822
gyrAp,0.6666666666666666,13,8,CTATTTTGATTTCAGGCTCA,5,1763152
gyrAp,0.6666666666666666,13,8,CGTTACCGGTATACGTAAGA,5,1750639
gyrAp,0.6666666666666666,13,8,CGTATCTACTGCCAGACGTT,5,1759202
gyrAp,3.7777777777777777,41,8,CGGTGTTGTCGTGTAGTTTC,33,1742917
gyrAp,0.6666666666666666,13,8,CGGTGGAGCTGTGCTGACAT,5,1754568
gyrAp,0.2222222222222222,9,8,CGGGACAGTGTAAAGTACCA,1,1763386
gyrAp,0.2222222222222222,9,8,CGGCCCTGTATTCGTATGTA,1,1745100
gyrAp,5.0,52,8,CGCTTCGGCTGTGGATCTAT,44,1751044
gyrAp,2.111111111111111,26,8,CGCTCGACCGTCTTCAATAG,18,1745743
gyrAp,1.7777777777777777,23,8,CGCCGTCCTTTGTGCCCCTG,15,1757042
gyrAp,1.2222222222222223,18,8,CGCATCATGTTCAAATGACC,10,1759679
gyrAp,1.0,16,8,CGATGTGTTTGGACGTGATA,8,1754220
gyrAp,0.3333333333333333,10,8,CGATGTGCTGTTTTTATTAC,2,1769609
gyrAp,0.2222222222222222,9,8,CGATATTTATGAAGTTGAAC,1,1756914
gyrAp,1.5555555555555556,21,8,CGACTGAGTACCGTCGGAAG,13,1755146
gyrAp,1.7777777777777777,23,8,CGACGTGGGGACTGCAGTCA,15,1769436
gyrAp,0.2222222222222222,9,8,CGACGGTGAAAATCTGGAGA,1,1770132
gyrAp,3.3333333333333335,37,8,CGAATTGTATTCCGTGTGTG,29,1742216
gyrAp,5.666666666666667,58,8,CGAATCCTATGATTGTCGAA,50,1746775
gyrAp,5.666666666666667,58,8,CCTTTCATCACGATAATGCC,50,1765122
gyrAp,0.7777777777777778,14,8,CCTCACCTCTGGGAGGCGCG,6,1742277
gyrAp,3.6666666666666665,40,8,CCTACGCACTCTCGCTGACA,32,1746706
gyrAp,2.3333333333333335,28,8,CCGCGCATCAGAGACCGGTG,20,1762042
gyrAp,2.111111111111111,26,8,CCGAGTCCGGATGCAAAAGG,18,1744938
gyrAp,0.2222222222222222,9,8,CCGAGCGATCCGGGCACCCT,1,1744473
gyrAp,1.1111111111111112,17,8,CCCTCTAGTGGTTAGCCTAA,9,1755952
gyrAp,1.5555555555555556,21,8,CCCCTAACACCGGCCTACCA,13,1763259
gyrAp,1.5555555555555556,21,8,CCCCGGGCAAAGCTGGCCCA,13,1758216
gyrAp,3.111111111111111,35,8,CCCAGTCTCGTAATGACGAA,27,1750470
gyrAp,2.7777777777777777,32,8,CCCAAAGCGGCGGCTGGAAT,24,1748375
gyrAp,5.222222222222222,54,8,CATTAACCTTTCCTATTTTA,46,1766923
gyrAp,1.8888888888888888,24,8,CATCGGTGTTGGTAGCATCT,16,1751176
gyrAp,2.5555555555555554,30,8,CATCCCCACATTGCTTCGGT,22,1752800
gyrAp,0.7777777777777778,14,8,CATAGTATCGTCCGCGCTAC,6,1741572
gyrAp,0.2222222222222222,9,8,CAGTGACATAATCCGGGATT,1,1750685
gyrAp,1.7777777777777777,23,8,CAGTCTGGGGAGGTGATAGT,15,1753427
gyrAp,2.4444444444444446,29,8,CAGTCATCCCACTAGAGCGC,21,1769251
gyrAp,1.5555555555555556,21,8,CAGGGTCTATCCAATCGTGT,13,1768920
gyrAp,14.333333333333334,136,8,CACACCCGGTCAACACCAGC,128,1770375
gyrAp,1.7777777777777777,23,8,CACAAGCGGTACCATCGACA,15,1747581
gyrAp,6.333333333333333,64,8,CAAGAAAGCATGTGAGAAGA,56,1758931
gyrAp,5.666666666666667,58,8,CAACGACTCCATGGTGTAAG,50,1753877
gyrAp,0.2222222222222222,9,8,CAACAATAGCTAGGTGGCAA,1,1743033
gyrAp,1.1111111111111112,17,8,CAAAGGTGCACTCATCTCCA,9,1759823
gyrAp,0.6666666666666666,13,8,ATTTGCTTCAGTCTCAGTGA,5,1769918
gyrAp,0.5555555555555556,12,8,ATTTCGGCCCTTTAGAGTTT,4,1758699
gyrAp,3.0,34,8,ATTTAATCACCGGTGTTATC,26,1753172
gyrAp,0.5555555555555556,12,8,ATTGTCGGGGCTACGTCTAC,4,1754558
gyrAp,0.2222222222222222,9,8,ATTGGTGGACAAGAAAGATG,1,1741904
gyrAp,1.8888888888888888,24,8,ATGTACTGTATTGTTCACTG,16,1766611
gyrAp,2.5555555555555554,30,8,ATGATTGGGTCATTTATCCG,22,1761067
gyrAp,0.7777777777777778,14,8,ATGATTACACTCTCTATGTG,6,1744377
gyrAp,1.6666666666666667,22,8,ATGATCAAGGGTTCCGACCG,14,1760267
gyrAp,0.2222222222222222,9,8,ATCTGGGAGTTGCGGGTAGG,1,1766990
gyrAp,0.3333333333333333,10,8,ATCGACTATAGGATGCTTAG,2,1749342
gyrAp,2.3333333333333335,28,8,ATCCATTGCTTGTCGTATAT,20,1746032
gyrAp,0.2222222222222222,9,8,ATCACGCAGACCTTTGAATG,1,1758495
gyrAp,3.3333333333333335,37,8,ATATTGTAAAAAACCGTAGC,29,1742110
gyrAp,3.5555555555555554,39,8,ATAGGTTGGACCATTCTAAA,31,1748979
gyrAp,3.6666666666666665,40,8,ATAGCAACTAAAACCCTGGG,32,1757533
gyrAp,1.1111111111111112,17,8,ATACTTTTCCGAGGACAATC,9,1746146
gyrAp,10.333333333333334,100,8,AGTTTCTACAATCCGGGGAA,92,1753946
gyrAp,2.4444444444444446,29,8,AGTAGGGAGTTACCAATGCA,21,1753069
gyrAp,3.4444444444444446,38,8,AGGGTACATTAGTTTTTTCA,30,1769597
gyrAp,2.3333333333333335,28,8,AGGGAACGGCCCGCATTGCA,20,1763666
gyrAp,1.1111111111111112,17,8,AGGACTATATCTGGAACTTA,9,1765120
gyrAp,3.5555555555555554,39,8,AGCCGTTGTCATGCTCGTGG,31,1758857
gyrAp,1.1111111111111112,17,8,AGACGGATCCGGGTGAGCTG,9,1755912
gyrAp,1.1111111111111112,17,8,ACTTCTCCCATGTGGGAGAT,9,1746682
gyrAp,1.7777777777777777,23,8,ACTTATGCATCACGGCTGTC,15,1766629
gyrAp,0.5555555555555556,12,8,ACTATCTTGGCCCGGTTTTC,4,1747131
gyrAp,0.2222222222222222,9,8,ACCGCGCGTGCGAGTGGAGC,1,1751843
gyrAp,5.111111111111111,53,8,ACATTTAGTAGCCTAGTCTT,45,1757234
gyrAp,3.6666666666666665,40,8,ACATGCCATAACGTGCTCGT,32,1746620
gyrAp,0.8888888888888888,15,8,ACATCAGGAACCAAATTTGA,7,1743768
gyrAp,1.6666666666666667,22,8,ACACGGGAATACAAGCAGGT,14,1753285
gyrAp,0.4444444444444444,11,8,ACACATCGGAAACTCACTAC,3,1758623
gyrAp,0.5555555555555556,12,8,AATTTGATCAATAGACGGGT,4,1769333
gyrAp,2.5555555555555554,30,8,AATTATCGGAGGACTTCGGG,22,1758097
gyrAp,2.2222222222222223,27,8,AATGCTGGGTCGGATGTGCG,19,1769701
gyrAp,7.111111111111111,71,8,AATCGGGACAACAGTACCTG,63,1763470
gyrAp,0.2222222222222222,9,8,AAGCAAATCAAATGCTGATT,1,1766537
gyrAp,1.3333333333333333,19,8,AAGAAACTGTAGCCGTTAGA,11,1754536
gyrAp,1.6666666666666667,22,8,AACTACAGCTAGGCACCTGA,14,1760665
gyrAp,0.25,8,7,TTTTTATGAGACAGCTTTTT,1,1748271
gyrAp,0.375,9,7,TTTTGGCGGACGGCAGTATT,2,1750932
gyrAp,5.75,52,7,TTTTGATGATTGTCCACTTT,45,1761403
gyrAp,0.25,8,7,TTTCCTTGATTCCTCATGGG,1,1755513
gyrAp,1.0,14,7,TTGTCTCATAGCGCAGTTGG,7,1762963
gyrAp,2.5,26,7,TTGCTCCTGTTTTTGGATTG,19,1743007
gyrAp,4.5,42,7,TTCTTTTGGTTTAGGCGGCA,35,1768499
gyrAp,2.625,27,7,TTCGCACGATGAGTACTGGC,20,1749144
gyrAp,0.5,10,7,TTCGAGATACGCAAATTTTC,3,1747742
gyrAp,2.5,26,7,TTCCTACAGCTGGGAATTTA,19,1751948
gyrAp,3.875,37,7,TTCAGGAACTCTCTACTCGT,30,1749890
gyrAp,4.0,38,7,TTAAGGGTTACAGTATGTTG,31,1759103
gyrAp,1.875,21,7,TGTGGTATTAAACGGAGTGT,14,1760336
gyrAp,0.25,8,7,TGTAGACGATGCCGTTATAA,1,1747967
gyrAp,4.875,45,7,TGTACGATGATTGGCCAGCA,38,1743266
gyrAp,3.75,36,7,TGGTGCCTTCGAGCGGACGA,29,1758218
gyrAp,5.0,46,7,TGATACCCCGCTTTTCTGTG,39,1751907
gyrAp,2.125,23,7,TGACTGGAATGGGGCGGGAA,16,1756095
gyrAp,0.875,13,7,TGAATCATCACACCTCCTCT,6,1754275
gyrAp,1.875,21,7,TCTCATCTTGGAACAGAGTT,14,1750271
gyrAp,0.25,8,7,TCTAAGGGGAGCCTCGTGGT,1,1759563
gyrAp,3.0,30,7,TCGGATCATGCTAGATGGAA,23,1766548
gyrAp,3.125,31,7,TCGATTCGCAGTTGGTTGGG,24,1755005
gyrAp,5.625,51,7,TCGAGGATTCGCGGCTTCTA,44,1766582
gyrAp,1.375,17,7,TCCGTTGCCATGCTACGTTT,10,1746506
gyrAp,0.25,8,7,TCAGAAAGCGCACAGCGCCA,1,1743816
gyrAp,0.375,9,7,TCACTCGCGTGAGGATGTTT,2,1753554
gyrAp,1.875,21,7,TATGCCTGTACCCACGTATG,14,1757446
gyrAp,0.625,11,7,TACTGCCGGCCAACCGCTCT,4,1769724
gyrAp,1.0,14,7,TACTCCGACTTCACATGGGG,7,1764624
gyrAp,3.375,33,7,TACAGGACTACGCCTCATAG,26,1745383
gyrAp,1.625,19,7,TACAAGGAGAAGGCTTGTAT,12,1748953
gyrAp,3.125,31,7,TAAAGTTAAATACTACAAGA,24,1755324
gyrAp,0.75,12,7,TAAAAAGGCTCTCAGATCAA,5,1765324
gyrAp,5.0,46,7,GTTTTCAAACTCACAACGAT,39,1744101
gyrAp,2.5,26,7,GTTCTTAACACCTGAACTCA,19,1754612
gyrAp,0.875,13,7,GTTCCTATACGAGGCTATCA,6,1757975
gyrAp,2.875,29,7,GTTAGTTTCCAATCACGCGC,22,1746823
gyrAp,9.25,80,7,GTCTAGGGGAAACGTAACCT,73,1750471
gyrAp,6.125,55,7,GTCGCCCACAGTCTATTTAT,48,1761086
gyrAp,3.875,37,7,GTATGGTCGTTTCTTCATGT,30,1758979
gyrAp,0.375,9,7,GTATAAACTACGCTGTTGCA,2,1748983
gyrAp,0.25,8,7,GGTTAGAGGCTGCCTTATAT,1,1746154
gyrAp,2.75,28,7,GGTGACGTGTGCGTTCTCTC,21,1766192
gyrAp,1.375,17,7,GGTCTAATTGTCTTCTCGAA,10,1753307
gyrAp,3.5,34,7,GGGTTTTACCTGCCAATGAC,27,1761417
gyrAp,5.875,53,7,GGGCGCAAAAAGTGACGCTG,46,1751406
gyrAp,0.25,8,7,GGGAAATCAGGTGATTCAGC,1,1758068
gyrAp,1.25,16,7,GGCTTCGTTACTTACTAAAC,9,1765232
gyrAp,3.625,35,7,GGCGGCATGAAGTAGTTCAA,28,1766213
gyrAp,1.875,21,7,GGAGTGAACAGGACGTCCCT,14,1745410
gyrAp,0.875,13,7,GGACATTAACAACAACCGGT,6,1751597
gyrAp,0.75,12,7,GCTTCTGAAGGTCACCAGTT,5,1757272
gyrAp,20.25,168,7,GCTGCATGCTGTTTCGATTG,161,1748314
gyrAp,3.875,37,7,GCTGATACTACGTGCTATAT,30,1747676
gyrAp,1.25,16,7,GCTCTGAGGATTCAATTGAC,9,1747398
gyrAp,5.375,49,7,GCTCTATAGTCCACGCAAGA,42,1745363
gyrAp,6.25,56,7,GCTCGAGCTCTTATGAAAAG,49,1755865
gyrAp,3.125,31,7,GCGGGCGCCTTGGCGAGAGC,24,1769618
gyrAp,1.125,15,7,GCCAGGATTTGTTTATCTGT,8,1768036
gyrAp,4.625,43,7,GCAGGTACGGGGTGTTAAAG,36,1769449
gyrAp,4.375,41,7,GCAGCTGTTTCCGGGAGAAC,34,1749387
gyrAp,0.375,9,7,GCAGCAATTCTCCTCAGATT,2,1767496
gyrAp,1.125,15,7,GATTCCACATGACGCTGCTC,8,1762747
gyrAp,0.375,9,7,GATCTTACTAGCGGCCACCA,2,1756153
gyrAp,3.625,35,7,GAGTTGTGTCGTACGGCGGA,28,1768206
gyrAp,3.0,30,7,GAGTCGCCCGGAGGGGTTTG,23,1745966
gyrAp,0.25,8,7,GAGGGGCTTTCAGAAGTTTA,1,1765085
gyrAp,1.0,14,7,GAGCACGTCTAAAATGTCAG,7,1747623
gyrAp,1.25,16,7,GAGATCGTGTGCGCCGAGAA,9,1754082
gyrAp,1.875,21,7,GAGACCACAAGCTTAGAGCT,14,1759874
gyrAp,0.5,10,7,GACTTTGGTCGTCTATAATT,3,1757943
gyrAp,0.25,8,7,GACGCGGATCGGCTCACACC,1,1762545
gyrAp,5.875,53,7,GAAGGCCCGTACTCCGGTAG,46,1755401
gyrAp,4.375,41,7,GAACTTGAAGCCATCAACCT,34,1754492
gyrAp,2.875,29,7,CTTTGGTAGCCATTACAAAC,22,1746507
gyrAp,2.5,26,7,CTTCGGCTGAAAGGCATTCA,19,1746763
gyrAp,2.5,26,7,CTTCCGGAAACAAAGACGGA,19,1750148
gyrAp,5.25,48,7,CTTATGGCAACGACAATCGG,41,1753254
gyrAp,1.625,19,7,CTTATGCAACGGTGGGTATA,12,1754683
gyrAp,0.625,11,7,CTTAGCGTTATGTGAGCTAT,4,1741758
gyrAp,2.0,22,7,CTGTTTATGCCACTATTGCT,15,1746144
gyrAp,1.75,20,7,CTGCGTGAATCGATTTACCA,13,1748795
gyrAp,1.375,17,7,CTGAGCTACCCGCTTCAACG,10,1768733
gyrAp,3.0,30,7,CTCCCGGAACTGCTCCAACT,23,1750160
gyrAp,11.625,99,7,CTCAACGAGGTATCGAATCA,92,1741525
gyrAp,1.125,15,7,CTACCGAGTGGGTCCAATCA,8,1751412
gyrAp,1.5,18,7,CGTTGTAACGATGTCACCTC,11,1766953
gyrAp,3.125,31,7,CGTTAGTGCCAAGAGTTTCT,24,1754754
gyrAp,0.75,12,7,CGTCATGTGTTCCGGCGGGT,5,1762253
gyrAp,2.875,29,7,CGTCACAGCGCTCATACGAC,22,1750593
gyrAp,0.875,13,7,CGTCAATAAAGCGCTCTGCA,6,1757715
gyrAp,5.25,48,7,CGTACCAAGATCCGTACAAG,41,1747311
gyrAp,0.25,8,7,CGTAACGAATCTTGCCGAAT,1,1748167
gyrAp,0.875,13,7,CGGCTTATTGCTTCTGGGAG,6,1768954
gyrAp,0.375,9,7,CGGCTGCCTGGCAGCGTGGA,2,1759771
gyrAp,3.875,37,7,CGGACCTTGGACGCTGATAT,30,1760628
gyrAp,5.125,47,7,CGGAATAATCGAGGCGGGAA,40,1768842
gyrAp,3.625,35,7,CGCTTTTTGATGGACTTCTT,28,1743394
gyrAp,5.625,51,7,CGCTGGAATTTCCTTTACAG,44,1748617
gyrAp,1.75,20,7,CGCATAGTACCAGTTGATGA,13,1760462
gyrAp,4.5,42,7,CCTTACTGACGTTTCTTTTG,35,1764957
gyrAp,5.875,53,7,CCTGCTTCTCTGAAATTGAT,46,1744423
gyrAp,6.5,58,7,CCGGACTATACAATGCACGG,51,1763764
gyrAp,0.375,9,7,CCCTCCTACTTTTAAGATTT,2,1748547
gyrAp,0.375,9,7,CCCCCGCGGCGTGCTTCAAA,2,1763734
gyrAp,5.125,47,7,CCCATCGTAGACCGCACACC,40,1760926
gyrAp,4.625,43,7,CCATCACACATTTTCGACCC,36,1767701
gyrAp,5.5,50,7,CCACATACCGGGCTAGGCAT,43,1748780
gyrAp,0.875,13,7,CCACAATCATGTCAATCACT,6,1743745
gyrAp,2.5,26,7,CCAAGTTGGTGATAGTCTAC,19,1768857
gyrAp,8.875,77,7,CATTTCGGTCGATCACCCGT,70,1755984
gyrAp,6.125,55,7,CATGTCGGGGCATCATGAAA,48,1745742
gyrAp,5.75,52,7,CATCGCGCATCCCCCATACA,45,1750809
gyrAp,4.125,39,7,CATACGAGCCCCTTCCATGC,32,1750533
gyrAp,4.75,44,7,CAGGACCGCGGCGGAACCTA,37,1763062
gyrAp,3.75,36,7,CAGCGGGCTAACACAGTATA,29,1763567
gyrAp,0.625,11,7,CAGAGTATTCCCGAGGAGTA,4,1754929
gyrAp,2.25,24,7,CACTTAGTGTCGAGGTATGA,17,1751403
gyrAp,2.0,22,7,CACCTGAGAGATGTGTTTAT,15,1765944
gyrAp,17.375,145,7,CAATTCTAGCCTGTCATCAT,138,1745164
gyrAp,0.375,9,7,CAAATGATCACGTGCGAAAC,2,1751336
gyrAp,7.375,65,7,ATTTGATGTTAGATTAGTGA,58,1759146
gyrAp,5.5,50,7,ATTGGCTCAGACTTCATGTT,43,1755461
gyrAp,4.375,41,7,ATTCCGGGAACGATTCGCTT,34,1744762
gyrAp,1.5,18,7,ATGTTAAACACATTTTCTGA,11,1759599
gyrAp,1.5,18,7,ATGGGAAGTTTTTGTCTAAC,11,1745446
gyrAp,0.25,8,7,ATGGGAAGTTCGTAGATGAA,1,1763229
gyrAp,4.25,40,7,ATGGCCCCATCCTGTTCGTA,33,1758427
gyrAp,0.25,8,7,ATGCGCTGTATGGGTAAGCG,1,1741520
gyrAp,2.875,29,7,ATGACGATCGGAAAATCTAA,22,1768136
gyrAp,7.25,64,7,ATCGACCATCGGGAAAACCC,57,1767358
gyrAp,2.375,25,7,ATATGAAAGGTTGCTCTATG,18,1767721
gyrAp,0.25,8,7,ATAAACCACCACTCGCAAAG,1,1744358
gyrAp,0.875,13,7,AGTGGATTTATCGCTGTTCA,6,1749082
gyrAp,0.25,8,7,AGTATGACAGTCTTTCTGAG,1,1757672
gyrAp,1.0,14,7,AGGTCGTCGTGCCCTACGTC,7,1755173
gyrAp,2.125,23,7,AGGTCATTATTCCTGTGTAG,16,1769768
gyrAp,0.25,8,7,AGGTCACTAACGGGTGTAAT,1,1768858
gyrAp,0.625,11,7,AGGACTTACCACCTGTCTCA,4,1741630
gyrAp,1.0,14,7,AGCTGCTTAATCATCGTGGA,7,1763895
gyrAp,0.875,13,7,AGCTACTCGCTAGCAAGTAT,6,1751338
gyrAp,0.25,8,7,AGCGGAGTGCTGGCCGTTCC,1,1757420
gyrAp,5.375,49,7,AGACTCGGGTTTTGTGGAAA,42,1768947
gyrAp,2.5,26,7,ACTTTTAACTCCTCACTGTG,19,1759971
gyrAp,2.5,26,7,ACTTTATCTTTGTCTTGCGT,19,1745417
gyrAp,1.5,18,7,ACTTCGGGTGCGTCCCGGAA,11,1742781
gyrAp,5.75,52,7,ACGTTTAGCTTGGCCTCCAG,45,1752346
gyrAp,2.875,29,7,ACGTGTACCGGACAAGGAAG,22,1756646
gyrAp,7.5,66,7,ACGTGCGAGCTCATAATATT,59,1763139
gyrAp,0.625,11,7,ACGGCATAGTAACTGGTGGA,4,1748395
gyrAp,2.25,24,7,ACGCCTAGCCCAACGCTAGT,17,1761443
gyrAp,2.75,28,7,ACCTACTCCTATAGATAACG,21,1745232
gyrAp,0.25,8,7,ACCCGCACTGTGCAGGCTAC,1,1745091
gyrAp,1.75,20,7,ACCATTGTGCACTTGAACCG,13,1770675
gyrAp,3.875,37,7,ACACTGCTACGCCCGGTACA,30,1767505
gyrAp,1.625,19,7,ACACCGGCTTTTTATAGGGG,12,1765131
gyrAp,5.375,49,7,ACACAACGAGGACCATCATG,42,1765688
gyrAp,10.625,91,7,AATGGATCGGCTAAATTAGA,84,1753354
gyrAp,1.375,17,7,AATCACGGATTAGGTTCGAT,10,1762388
gyrAp,4.0,38,7,AATATCGCTGGATGACCAGG,31,1746591
gyrAp,9.5,82,7,AAGGCCGGTGACGTTATCTC,75,1743428
gyrAp,7.25,64,7,AACGGCATAACAATTAACAC,57,1750917
gyrAp,0.25,8,7,AACGAGTGATCGGCAACTGC,1,1747868
gyrAp,5.5,50,7,AACCGAGCCGAATCAAGTCT,43,1753171
gyrAp,0.875,13,7,AACAGGGCCTTCTTCAATTT,6,1761960
gyrAp,1.5,18,7,AAAGGAAGTGAATTTGCGGG,11,1750558
gyrAp,3.25,32,7,AAAATTCCCCAATCGGCATG,25,1760583
gyrAp,1.875,21,7,AAAAGTCGCGCACTTTACCT,14,1766354
gyrAp,0.8571428571428571,11,6,TTTTCATAAATTGCGGATCA,5,1770157
gyrAp,6.714285714285714,52,6,TTTGCGTCAGTGGAGGCGAG,46,1758294
gyrAp,4.857142857142857,39,6,TTTATTGGGTCAGCGAGGAC,33,1763181
gyrAp,0.42857142857142855,8,6,TTTAGCCACTCGGGTCGTCG,2,1765417
gyrAp,2.142857142857143,20,6,TTGTACGATGCATGGTTAAT,14,1747832
gyrAp,0.42857142857142855,8,6,TTCTATCGCTGTTTCTTGAT,2,1755074
gyrAp,5.857142857142857,46,6,TTCGTTCTCGATTCTTGCCG,40,1761744
gyrAp,0.42857142857142855,8,6,TTCGGCATCTCTTGATGCGG,2,1766740
gyrAp,0.8571428571428571,11,6,TTCGCACCCCTAGTGAAAGA,5,1747951
gyrAp,2.5714285714285716,23,6,TTCAGTGCTTTATCGCGTAC,17,1765008
gyrAp,0.5714285714285714,9,6,TTCAACAGAGGACAAACCCG,3,1757808
gyrAp,7.428571428571429,57,6,TTAGCTTTCCGTCGCAGTAT,51,1768281
gyrAp,11.142857142857142,83,6,TGTGGGTCCGCATTTTATTG,77,1749187
gyrAp,2.0,19,6,TGTGCCACTTGCGGCAAATT,13,1747772
gyrAp,0.42857142857142855,8,6,TGTCGCAGCGCAGTGGTGGT,2,1762820
gyrAp,0.42857142857142855,8,6,TGTATTTGAAGTTTTGCCCC,2,1742054
gyrAp,0.2857142857142857,7,6,TGGTCTTAATTGTGTTACAG,1,1746956
gyrAp,3.4285714285714284,29,6,TGGAAGGCGCAGTTCGGGAT,23,1762320
gyrAp,1.7142857142857142,17,6,TGCTGTCACGGGTACAACTT,11,1747288
gyrAp,0.2857142857142857,7,6,TGCCCTATGCCGATTGCCGG,1,1748872
gyrAp,3.857142857142857,32,6,TGCAGGGACTGCTCCTTGCT,26,1743187
gyrAp,3.857142857142857,32,6,TGCACGAAGCCCTCATTCCA,26,1744055
gyrAp,0.2857142857142857,7,6,TGACCTCCTTCAACTTGGAA,1,1768173
gyrAp,2.857142857142857,25,6,TGACATATTGGGGGTAGTCC,19,1743869
gyrAp,1.4285714285714286,15,6,TGACATATCTGGAAGACGTA,9,1762860
gyrAp,0.2857142857142857,7,6,TGAAGGGCGTGGTGGTCAAC,1,1755351
gyrAp,2.857142857142857,25,6,TCTTTGTTAGCCGAAATCAC,19,1758526
gyrAp,1.7142857142857142,17,6,TCTTAGTAACGGCGTAGGAG,11,1744414
gyrAp,13.428571428571429,99,6,TCTGGTGTCGCGAAACGTCG,93,1760846
gyrAp,3.7142857142857144,31,6,TCTGCCGTCGTATTCTCTGA,25,1766103
gyrAp,1.1428571428571428,13,6,TCTCCCCTCAAGAACTGAAC,7,1752100
gyrAp,3.142857142857143,27,6,TCGTTACAGTACCTACCCCT,21,1759774
gyrAp,11.428571428571429,85,6,TCGTCCTACAAATGCTTGTA,79,1744348
gyrAp,5.571428571428571,44,6,TCCTTGCGTTTATACGATGT,38,1746122
gyrAp,7.428571428571429,57,6,TCCCTCCATAACCGCGCGAC,51,1747127
gyrAp,3.7142857142857144,31,6,TCCAGACGGTTTAATAGTAC,25,1763672
gyrAp,3.4285714285714284,29,6,TCACATTTTTAAAGTGACAT,23,1751515
gyrAp,6.142857142857143,48,6,TCAACAGCCTCGGCTGGACA,42,1758270
gyrAp,0.2857142857142857,7,6,TATTTCTCCGTCCTAGGTTG,1,1754005
gyrAp,1.5714285714285714,16,6,TATGGAATCTCATGGCAGAG,10,1757365
gyrAp,0.5714285714285714,9,6,TATCCGTGCCCAACTATTGT,3,1753008
gyrAp,0.42857142857142855,8,6,TATCCGACTCGAACTTGGTA,2,1745173
gyrAp,4.428571428571429,36,6,TATAGGCTGTTAGCACGGTG,30,1755059
gyrAp,0.42857142857142855,8,6,TAGGCACACATATCTTGGCC,2,1753890
gyrAp,2.0,19,6,TAGAAGGAGGCAACCTCTGG,13,1758412
gyrAp,2.857142857142857,25,6,TAGAACCGGACTTTTTTCGC,19,1766174
gyrAp,3.7142857142857144,31,6,TACTGTGGCATAGCCGAGAT,25,1742313
gyrAp,0.2857142857142857,7,6,TACGGGCAACCCCATAATAC,1,1761180
gyrAp,3.2857142857142856,28,6,TACCTTCTCAACACCGCAAG,22,1757191
gyrAp,2.2857142857142856,21,6,TAATTCAGTCCGCGATTAGC,15,1760697
gyrAp,2.2857142857142856,21,6,TAACAACTTGCGGGAGATTC,15,1769809
gyrAp,2.0,19,6,GTTTCCGTGGTCAGTGTATT,13,1760193
gyrAp,6.285714285714286,49,6,GTTGTTTCATGGTTCAGCAA,43,1751951
gyrAp,1.1428571428571428,13,6,GTTCGGTGGGCGGGGCGGGT,7,1753255
gyrAp,3.142857142857143,27,6,GTTCGGACGGTCCTTTGGGC,21,1760929
gyrAp,4.0,33,6,GTTATCCGCCGTGTTTCGCC,27,1767265
gyrAp,4.428571428571429,36,6,GTTAAGTGTTAGGGCTTTAT,30,1746052
gyrAp,1.5714285714285714,16,6,GTGTTACCGGCAAAAATGTA,10,1758488
gyrAp,4.428571428571429,36,6,GTGGGAGTCCACCGATGCGT,30,1754136
gyrAp,4.142857142857143,34,6,GTGATGCACTACTAACACAT,28,1759257
gyrAp,2.7142857142857144,24,6,GTATTTCTTGTTGACCCGGA,18,1766204
gyrAp,5.0,40,6,GTATAGGGTGTTAAGCAAAT,34,1769239
gyrAp,16.428571428571427,120,6,GTACTTCCTGGCTCTGCTCC,114,1755568
gyrAp,4.142857142857143,34,6,GTACGGTAATGTCCGCATAA,28,1760085
gyrAp,5.571428571428571,44,6,GTAAGCCTGGCGGGAAACTC,38,1741773
gyrAp,2.857142857142857,25,6,GGTTGTCATCGCAGTCAGCA,19,1769111
gyrAp,1.7142857142857142,17,6,GGTTGCGTGTCTTTGCAGAC,11,1746342
gyrAp,2.2857142857142856,21,6,GGTTCAGTCCAAGCTAGGGT,15,1763334
gyrAp,0.8571428571428571,11,6,GGTGGTCCCGCCCCACCTAA,5,1751413
gyrAp,7.285714285714286,56,6,GGTCATAGATGATCCCTTCG,50,1769452
gyrAp,0.8571428571428571,11,6,GGGTAACTTCGTACATACAG,5,1765705
gyrAp,0.42857142857142855,8,6,GGGGGCCATGTATGGGTCCG,2,1758277
gyrAp,3.7142857142857144,31,6,GGGGATGGAATTCGGGGGGT,25,1763992
gyrAp,2.142857142857143,20,6,GGGCCTGGCGCGAACATAAG,14,1763893
gyrAp,3.857142857142857,32,6,GGGATGTGGGTAGTTTGGGA,26,1745517
gyrAp,5.285714285714286,42,6,GGCCGGCCGTTAGTCAGTTA,36,1743674
gyrAp,3.7142857142857144,31,6,GGAGCGAAATGGAAACTTAA,25,1768998
gyrAp,4.428571428571429,36,6,GGACTGAAGTATGCGCCGTC,30,1747132
gyrAp,2.857142857142857,25,6,GGACAACCGGTTTTTCGGCT,19,1761775
gyrAp,0.2857142857142857,7,6,GGACAACAGGCTACAGCCTC,1,1752901
gyrAp,3.5714285714285716,30,6,GGAATTTGGCGTCAGTTGCC,24,1758772
gyrAp,1.8571428571428572,18,6,GCTGTGCTATGGTGAAGTGG,12,1760626
gyrAp,4.428571428571429,36,6,GCTGGTGATAATATTCATCT,30,1753698
gyrAp,4.0,33,6,GCTCCCTTATAAGTGTTTAC,27,1747028
gyrAp,8.285714285714286,63,6,GCTACGCTCGGAAGCAGTGA,57,1767842
gyrAp,4.714285714285714,38,6,GCTAATTTAGTATTCCGGAC,32,1753724
gyrAp,0.2857142857142857,7,6,GCGGAGCGCTGGTACGAGTC,1,1756862
gyrAp,1.1428571428571428,13,6,GCGCAATATCTAGCCTTATA,7,1759613
gyrAp,0.5714285714285714,9,6,GCCTCTTGGCAGGAAACGAA,3,1765691
gyrAp,0.8571428571428571,11,6,GCCGGCCGAGAGGCTACCCC,5,1744923
gyrAp,4.714285714285714,38,6,GCCGATGTGCAAGCCCGGGA,32,1763469
gyrAp,2.2857142857142856,21,6,GCCAGAGCTGGCTGGTGGTT,15,1763563
gyrAp,4.285714285714286,35,6,GCACTGATGTGTGGCCGAAA,29,1746294
gyrAp,0.2857142857142857,7,6,GATCCCCAAATGCTTATGAC,1,1749093
gyrAp,1.2857142857142858,14,6,GAGTTGTTTAAGACTCCAGA,8,1748526
gyrAp,3.142857142857143,27,6,GAGTACCGGGAACATAAGAA,21,1763702
gyrAp,5.142857142857143,41,6,GAGGGTGCAGTCCTAGCCGA,35,1751609
gyrAp,4.714285714285714,38,6,GAGAGTGTTTATTACTGATC,32,1742401
gyrAp,1.8571428571428572,18,6,GACCGCGGCCATTAGAACAT,12,1745829
gyrAp,4.428571428571429,36,6,GACCCTCGATACACCCGGAT,30,1741550
gyrAp,1.2857142857142858,14,6,GACCCCTAGTCCGTTCTTCT,8,1752190
gyrAp,0.2857142857142857,7,6,GAATGGACCATGATCACCCC,1,1763275
gyrAp,1.0,12,6,GAATATCGACCGTGTAGCTC,6,1758999
gyrAp,6.285714285714286,49,6,GAATAACTGGATCCAACACA,43,1757826
gyrAp,5.571428571428571,44,6,GAACGGTCCGTGCGGGCCTA,38,1747531
gyrAp,4.714285714285714,38,6,GAAATTGCGTAGACGCACAT,32,1748994
gyrAp,1.7142857142857142,17,6,GAAATTAGCTCGCACCGACC,11,1747232
gyrAp,3.7142857142857144,31,6,CTTCCTCATAGCTCAATTCT,25,1756263
gyrAp,5.428571428571429,43,6,CTTATTCCGGAAAGAGAGAA,37,1743377
gyrAp,1.0,12,6,CTGTCGTACTTCGAGCCCTT,6,1755772
gyrAp,10.428571428571429,78,6,CTGGTGTAGTCTCGGGGGGA,72,1743950
gyrAp,5.428571428571429,43,6,CTCTGAGAATCCGGGCTGCA,37,1749314
gyrAp,2.142857142857143,20,6,CTCGCCTTATGATCGAGTAG,14,1752002
gyrAp,0.2857142857142857,7,6,CTATGTACCTCAGAATGGAG,1,1757893
gyrAp,0.5714285714285714,9,6,CTAGCGCTCATATGTAAGCT,3,1761141
gyrAp,1.1428571428571428,13,6,CTAAACAAGCGGTGCTCCGA,7,1770273
gyrAp,1.8571428571428572,18,6,CGTGACTCCCCGCAACTTTA,12,1768719
gyrAp,2.7142857142857144,24,6,CGTATAATTCTCTCCTGTGA,18,1752571
gyrAp,3.0,26,6,CGTAGGAGTCTGGGAGGCGA,20,1752526
gyrAp,6.285714285714286,49,6,CGGTGAAACTAGGTCGCAAT,43,1756835
gyrAp,5.714285714285714,45,6,CGGGTAGGCTCTACCCGGCA,39,1767447
gyrAp,4.285714285714286,35,6,CGGCCAAACCATGAGTCAAA,29,1760276
gyrAp,2.2857142857142856,21,6,CGGATCTCGGTTCTGAAACG,15,1762436
gyrAp,0.2857142857142857,7,6,CGCGTCTCCTCGAAGAAGAA,1,1743446
gyrAp,10.857142857142858,81,6,CGCGTCAAATATCAGACTTA,75,1746781
gyrAp,6.142857142857143,48,6,CGCGAGGTGTGGAACATAGG,42,1744357
gyrAp,3.5714285714285716,30,6,CGCAGTGTTAGAATTCCGTG,24,1759927
gyrAp,3.5714285714285716,30,6,CGCACCGGAAGTGAATCGGG,24,1763437
gyrAp,2.4285714285714284,22,6,CGAGTTAGAGATATTGCAGT,16,1748104
gyrAp,5.142857142857143,41,6,CGAGGAGGGTAGGACGCAGG,35,1769637
gyrAp,1.2857142857142858,14,6,CGACAGGTAGCTTCTGTATC,8,1744974
gyrAp,2.0,19,6,CGAATCTGGCCGAACGCTCT,13,1745389
gyrAp,1.5714285714285714,16,6,CCTGTAATCACCGAGACCCA,10,1757559
gyrAp,9.714285714285714,73,6,CCTCCATTCGTTGGTACCCC,67,1758658
gyrAp,5.0,40,6,CCGGGATTTTATCGGTGTGA,34,1747192
gyrAp,4.428571428571429,36,6,CCCGTCATGGCGCAGTATCT,30,1756815
gyrAp,2.142857142857143,20,6,CCCGCCCGTGCCGAAGTGAT,14,1755950
gyrAp,4.428571428571429,36,6,CCCATGGAAATCCCGTGGCC,30,1752140
gyrAp,0.2857142857142857,7,6,CCCACACAGCAATTGCACAC,1,1741994
gyrAp,0.2857142857142857,7,6,CCAGTAGGGGTGCTGGCAAC,1,1766124
gyrAp,5.0,40,6,CCAGGTAAATGGGTGTCCCG,34,1753302
gyrAp,4.142857142857143,34,6,CCACTGGGTGTATTACGCAG,28,1759161
gyrAp,0.5714285714285714,9,6,CCACGGCTACTCACAAGAGG,3,1760057
gyrAp,8.428571428571429,64,6,CCAATGCGAAGGTTGCGCCC,58,1754184
gyrAp,5.0,40,6,CATTCATTAGCGCGTATCGG,34,1748566
gyrAp,5.428571428571429,43,6,CATGAGCCCGGAAAGCGCTA,37,1762396
gyrAp,0.2857142857142857,7,6,CAGTACTGTGTGTTTCTTCT,1,1756019
gyrAp,1.8571428571428572,18,6,CAGGAGGTAAACCAAGATTA,12,1753337
gyrAp,3.5714285714285716,30,6,CAGCTGAACCTCTTAGTAGA,24,1755271
gyrAp,2.0,19,6,CAGCCATCTCTTATCTAGCT,13,1746476
gyrAp,2.7142857142857144,24,6,CAGAATTGGACCTCCCTAAA,18,1765358
gyrAp,4.0,33,6,CACCGGTCGAGAACCTTATC,27,1750343
gyrAp,2.2857142857142856,21,6,CAATCGTAACCCTTACTTCC,15,1770327
gyrAp,4.857142857142857,39,6,CAATAACTGTTTTCAAGTGT,33,1758886
gyrAp,2.2857142857142856,21,6,CAAGAGCACATTACGATTGA,15,1752026
gyrAp,11.285714285714286,84,6,CAACGCGCCAACCACGTGCT,78,1751285
gyrAp,1.2857142857142858,14,6,CAACATCTCAGCGTGCTTAC,8,1761408
gyrAp,2.5714285714285716,23,6,CAAACCCGCACTCTTGGGAC,17,1761474
gyrAp,3.0,26,6,ATTTGTTTTGTAAAAGCCAT,20,1765223
gyrAp,0.2857142857142857,7,6,ATTTGCAGGAGAACAAGGGA,1,1769197
gyrAp,0.2857142857142857,7,6,ATTGCTTTTGCGCTTGGATT,1,1755404
gyrAp,1.0,12,6,ATTGAACCGTGCGTGTGATT,6,1749769
gyrAp,5.714285714285714,45,6,ATGTTTCGCGTACCAGGGGT,39,1746029
gyrAp,1.8571428571428572,18,6,ATGTTAGTAGACATCGAGTC,12,1742010
gyrAp,3.5714285714285716,30,6,ATGTCGCGGGAAACATTTAT,24,1765555
gyrAp,1.8571428571428572,18,6,ATGGGATATACGAAAAATGA,12,1744043
gyrAp,0.42857142857142855,8,6,ATGCTTCTTTTCTCAGCCGC,2,1752384
gyrAp,8.714285714285714,66,6,ATCGCTTCCATATCCCGTTG,60,1759000
gyrAp,0.8571428571428571,11,6,ATCGAAGGGATTGACGATGC,5,1762827
gyrAp,2.4285714285714284,22,6,ATCCGTGCGCGAAGGCTTAT,16,1755465
gyrAp,4.428571428571429,36,6,ATCCACACGGTATATGCATC,30,1764951
gyrAp,0.2857142857142857,7,6,ATCCAAGCTAGGTGTTGAGC,1,1757813
gyrAp,1.7142857142857142,17,6,ATCAGAACGCGGACCCATGA,11,1757351
gyrAp,2.0,19,6,AGTTGTGGTAAGCTGTTGAT,13,1744885
gyrAp,0.8571428571428571,11,6,AGTTAGGATCACGACGACTT,5,1745492
gyrAp,0.2857142857142857,7,6,AGTATGGACCTTGCGCTGCT,1,1759302
gyrAp,2.4285714285714284,22,6,AGGCGAGGAAGTTAGACGCA,16,1745249
gyrAp,7.0,54,6,AGGCATCGATGAGCGCAGCT,48,1743901
gyrAp,0.5714285714285714,9,6,AGGAGGGAGCTTGCGGCTTG,3,1767784
gyrAp,5.571428571428571,44,6,AGCGCAGCGCTCATAAGCGA,38,1762989
gyrAp,6.285714285714286,49,6,AGCATATGTTAGCGGTGCCT,43,1741853
gyrAp,0.42857142857142855,8,6,ACTTTAGGACCAGGATGACT,2,1754168
gyrAp,11.714285714285714,87,6,ACTGTTTGATGCCGGTTTTT,81,1760883
gyrAp,0.7142857142857143,10,6,ACTGGAGCTTTGATGTGTGG,4,1746988
gyrAp,0.2857142857142857,7,6,ACTCACATGGCAATTTTCCC,1,1744219
gyrAp,3.5714285714285716,30,6,ACGTGAGGAGTTGCAACTCT,24,1751212
gyrAp,5.571428571428571,44,6,ACGTCTTATGTAGCACGGGA,38,1749792
gyrAp,0.5714285714285714,9,6,ACGTATAGGATTGAACTGGC,3,1758765
gyrAp,32.142857142857146,230,6,ACGGTAGGGGACCTCGCAGC,224,1766855
gyrAp,2.2857142857142856,21,6,ACGGCACTATATAAGTGATA,15,1758128
gyrAp,1.2857142857142858,14,6,ACGCATAACACAGTGACTCA,8,1749616
gyrAp,4.714285714285714,38,6,ACGCAACTTGTATGTTGGTA,32,1743873
gyrAp,1.5714285714285714,16,6,ACCGCTTCCAGCAATTCCAT,10,1761862
gyrAp,13.428571428571429,99,6,ACCGATTTCGTCCATTGTGT,93,1754476
gyrAp,1.4285714285714286,15,6,ACCGACGATGCGACGTAGTT,9,1762604
gyrAp,4.571428571428571,37,6,AATCCATGACAAAGTAGTCC,31,1756576
gyrAp,1.5714285714285714,16,6,AATAAACGTCTAGCTCTTCG,10,1744021
gyrAp,2.857142857142857,25,6,AAGGGGAAATCTTGTATTTA,19,1749560
gyrAp,6.285714285714286,49,6,AAGGCGTTCAATTCGATGAC,43,1770026
gyrAp,0.2857142857142857,7,6,AAGCCTCGGAAATTCAGGGT,1,1743673
gyrAp,3.2857142857142856,28,6,AAGAATCCACGAGACCTGCG,22,1762434
gyrAp,2.857142857142857,25,6,AACGCCTTTGACACGCTCAA,19,1762858
gyrAp,5.571428571428571,44,6,AACGAATAGGCCATGTTCGA,38,1744243
gyrAp,0.42857142857142855,8,6,AAATGGGAACGGGCCTTGGG,2,1744653
gyrAp,3.0,26,6,AAAGCACTGTTCCACTACTG,20,1765983
gyrAp,3.7142857142857144,31,6,AAACGCGGCAGCCAGGCCGC,25,1760687
gyrAp,7.0,54,6,AAACCCACAGTTGCCCGCCT,48,1754911
gyrAp,2.2857142857142856,21,6,AAACAAACAGCAACGGGAGC,15,1754652
gyrAp,0.8571428571428571,11,6,AAAAACACCAAGGGCAAATG,5,1753326
gyrAp,6.666666666666667,44,5,TTTTGAACTAACTTGAAAGG,39,1757836
gyrAp,2.6666666666666665,20,5,TTTTAATTTCCCATGACCAC,15,1759796
gyrAp,3.3333333333333335,24,5,TTTGTTCGGCTGCCCCTCTA,19,1749711
gyrAp,2.8333333333333335,21,5,TTTCTGAGGTACGGAATATC,16,1750566
gyrAp,2.6666666666666665,20,5,TTGTATAGGAAAGTCTTTGT,15,1767235
gyrAp,2.0,16,5,TTCATTTGCAGGAGAGGCGA,11,1755544
gyrAp,2.0,16,5,TTCATTGTAGCTACGCACGC,11,1751094
gyrAp,2.6666666666666665,20,5,TGTTTAGTTATTATTGCACC,15,1742073
gyrAp,4.333333333333333,30,5,TGTTGCTCGTTCGGACTGCG,25,1741580
gyrAp,0.3333333333333333,6,5,TGTGGAGTAATGATGTCACT,1,1744040
gyrAp,2.8333333333333335,21,5,TGTATGGCCACCCGAGCTAA,16,1759768
gyrAp,1.6666666666666667,14,5,TGGGTTCGCGCTTATCGTAC,9,1768659
gyrAp,4.0,28,5,TGGGGTTAAATTACCAAAAA,23,1744390
gyrAp,1.3333333333333333,12,5,TGGCGCACTCATCACTCCTT,7,1746663
gyrAp,6.166666666666667,41,5,TGGCAGACTTTGAGTCACAA,36,1754994
gyrAp,4.333333333333333,30,5,TGGATGGGAAACGTTTGGGA,25,1752033
gyrAp,3.3333333333333335,24,5,TGGAGGACCAGCCCTCTGCT,19,1752614
gyrAp,6.0,40,5,TGCACACGCAACCCTATTGC,35,1770667
gyrAp,1.6666666666666667,14,5,TGCAATATTAATAACTGGTC,9,1752961
gyrAp,6.5,43,5,TGCAAAGTCTTTGTGCGTAT,38,1754556
gyrAp,4.5,31,5,TGCAAAAAGTCCGATACAAT,26,1756333
gyrAp,1.0,10,5,TGATGCCCCTTTCTACATGT,5,1749845
gyrAp,1.0,10,5,TGACCGGCCTGTTCGATTTA,5,1761978
gyrAp,2.3333333333333335,18,5,TCTTGAGTACTCATGATGAA,13,1745350
gyrAp,0.3333333333333333,6,5,TCGTAAATCCTGTACACGGT,1,1744993
gyrAp,1.1666666666666667,11,5,TCGGGGCCTGTCCGGTACGG,6,1754413
gyrAp,2.3333333333333335,18,5,TCGCTAAGGCCATTCTACCC,13,1744155
gyrAp,3.6666666666666665,26,5,TCCTTTTTGTCTAGACGCTG,21,1748806
gyrAp,3.0,22,5,TCCTTTAATATAATGGCAGC,17,1770757
gyrAp,3.3333333333333335,24,5,TCCTTAGTCCGGTATAGTAC,19,1745700
gyrAp,3.3333333333333335,24,5,TCCGAATTGCACAACTCCCA,19,1759921
gyrAp,3.6666666666666665,26,5,TCCGAAGGTGGGTTCCTTTA,21,1744707
gyrAp,2.8333333333333335,21,5,TCCGAACATGGTGTTGGGAC,16,1754950
gyrAp,1.3333333333333333,12,5,TCCCCGGGCGGAAAGCAGAC,7,1763620
gyrAp,4.5,31,5,TCCCCAAACGTTGCCGCGCT,26,1767171
gyrAp,6.5,43,5,TCACGGCAATGCGCCAGAAG,38,1750107
gyrAp,0.5,7,5,TCAAGCTTACCCCGGGATCT,2,1765309
gyrAp,1.0,10,5,TATTGACCTCCGGATATGCT,5,1744521
gyrAp,3.3333333333333335,24,5,TATAGAAATTCTGTCCTTTA,19,1745745
gyrAp,4.166666666666667,29,5,TAGGTGACGTTTAATAGGAC,24,1757542
gyrAp,0.8333333333333334,9,5,TAGGCCGGGCTGTGGCGCCA,4,1758337
gyrAp,0.3333333333333333,6,5,TAGCTTGCAATATCTAAAGA,1,1747396
gyrAp,0.3333333333333333,6,5,TACGTGATATGGTTGCGTAC,1,1754781
gyrAp,4.666666666666667,32,5,TACCTCATGGGACCACTAAA,27,1759011
gyrAp,1.5,13,5,TACCAAGGGTTGGCTACAAG,8,1763289
gyrAp,1.3333333333333333,12,5,TAAGCCACGAACGGGGAGTT,7,1760209
gyrAp,0.3333333333333333,6,5,TAACTATCGATAGATGTTGA,1,1753407
gyrAp,5.0,34,5,TAACCCAGCTTCTGGCCGCT,29,1755058
gyrAp,3.5,25,5,TAAAAGCTTAGAAACGGTTG,20,1756828
gyrAp,14.833333333333334,93,5,GTTTTGTCACCCCGCGCATT,88,1760501
gyrAp,2.5,19,5,GTTGCTAGGCCTCTCGCATA,14,1756343
gyrAp,1.3333333333333333,12,5,GTTGCTAAATGGTGATGATG,7,1759160
gyrAp,0.3333333333333333,6,5,GTTGACCACCCTTTGTGTCT,1,1750888
gyrAp,1.8333333333333333,15,5,GTTAGAGAAGTGCTGTAGAA,10,1758392
gyrAp,5.0,34,5,GTGTTCTCTTGAGAGCAAGT,29,1756676
gyrAp,9.833333333333334,63,5,GTCTATAGAACTATGTGGGT,58,1766160
gyrAp,0.3333333333333333,6,5,GTCCGCCTTAAGACACCCGC,1,1770560
gyrAp,7.5,49,5,GTCAGCTTTAGCCATCGGCA,44,1748955
gyrAp,1.0,10,5,GTAGGTCTGTGTTATTGCGG,5,1763970
gyrAp,3.1666666666666665,23,5,GTAGCACCAAGCTGGCTCAT,18,1768033
gyrAp,3.3333333333333335,24,5,GTACTACTTGGTAATGAGCG,19,1758121
gyrAp,10.5,67,5,GTACGGCTAATACACCTATT,62,1770456
gyrAp,2.5,19,5,GGTTGGAAAACCGCACCTAT,14,1754637
gyrAp,1.3333333333333333,12,5,GGTTCGCGCTCACGTATTGG,7,1757268
gyrAp,3.3333333333333335,24,5,GGTTAGGTCGAGTTAGCCCA,19,1751008
gyrAp,7.333333333333333,48,5,GGTGTTTGTAAAACTGGGTG,43,1744723
gyrAp,0.6666666666666666,8,5,GGTCAATCCCCGCGTATACA,3,1743022
gyrAp,0.3333333333333333,6,5,GGGTTAGGCTACCGCGTAAT,1,1745349
gyrAp,0.8333333333333334,9,5,GGGGGCGAGCTACCGTGCTC,4,1756785
gyrAp,4.166666666666667,29,5,GGGAAACAACCTCCCGACCA,24,1756859
gyrAp,1.1666666666666667,11,5,GGGAAAATCGGTCTCAAGGT,6,1763706
gyrAp,4.333333333333333,30,5,GGCTCTAGCAGTTTCGATGG,25,1756094
gyrAp,0.6666666666666666,8,5,GGATTGGAATGCTAGTTATG,3,1761071
gyrAp,3.5,25,5,GGAGGGAAAGGTGCTGTAAT,20,1753057
gyrAp,4.333333333333333,30,5,GGAATCCTGGCCCCAGGAGG,25,1761425
gyrAp,0.5,7,5,GGAACCACTTCTTTGTTGGT,2,1770423
gyrAp,1.3333333333333333,12,5,GCTCTTAATTCCTCCCATGT,7,1753177
gyrAp,2.1666666666666665,17,5,GCGTTTGAGCACGGGCATTT,12,1764402
gyrAp,2.6666666666666665,20,5,GCGTTAGACGGAGTATGGCT,15,1765529
gyrAp,2.0,16,5,GCGTGTTACGCCGCGTGCAA,11,1755432
gyrAp,0.8333333333333334,9,5,GCGTGTCAAGCATCCCTAAG,4,1755749
gyrAp,1.8333333333333333,15,5,GCGGGGACTGGGCAAAAAAG,10,1769858
gyrAp,0.6666666666666666,8,5,GCGGCGATATTTGCAGGTCT,3,1770452
gyrAp,1.0,10,5,GCGATATCGAGCAGCGTGCC,5,1744508
gyrAp,0.3333333333333333,6,5,GCGAAGGTAAACAGTTGGGA,1,1757495
gyrAp,0.6666666666666666,8,5,GCACGTACGCTAAGGCGAGA,3,1750377
gyrAp,5.666666666666667,38,5,GATTTCGATTGGCGTTGATC,33,1750863
gyrAp,5.833333333333333,39,5,GATGTAAGTGCGGTCTTGCG,34,1748096
gyrAp,4.333333333333333,30,5,GATAGAACAACCGCTCTAAA,25,1744095
gyrAp,1.8333333333333333,15,5,GAGTTTGTCCCGACAGCTTA,10,1759883
gyrAp,7.166666666666667,47,5,GAGGTTGGACAATCTACCAA,42,1757399
gyrAp,3.5,25,5,GAGCTTTTTCATCGTTGTGG,20,1751529
gyrAp,12.0,76,5,GACTGCTGTCTTCCGCTTAA,71,1763763
gyrAp,10.0,64,5,GACGCGAGGGCAAGTCACAC,59,1759101
gyrAp,5.333333333333333,36,5,GAAGTCTTAATTATAGGTGC,31,1753477
gyrAp,3.5,25,5,GAAGCAAATCAAGGTCATCT,20,1755691
gyrAp,2.0,16,5,GAACGGCAGGATGTTCTGTA,11,1756197
gyrAp,1.3333333333333333,12,5,CTTTGATTCTGTGGCAGGAT,7,1749672
gyrAp,7.833333333333333,51,5,CTTTGAACGCTACTTCAGGT,46,1758892
gyrAp,5.5,37,5,CTTCTTGGGATTCTGTGTGT,32,1754673
gyrAp,6.166666666666667,41,5,CTGTTTGATGGTGCACGAGA,36,1753506
gyrAp,7.666666666666667,50,5,CTGGTTCGCTTGATACGTCG,45,1758316
gyrAp,7.5,49,5,CTCCTGGCCTGGTGTGTAAT,44,1765221
gyrAp,3.6666666666666665,26,5,CTCCGTTAGTCCGTTGCGGT,21,1762902
gyrAp,2.3333333333333335,18,5,CTCCGTAGGTTCCGAGGTTG,13,1754875
gyrAp,7.0,46,5,CTATAGGGATGTATATGCGT,41,1767769
gyrAp,4.666666666666667,32,5,CTATAGCAGCAAGTGAATGA,27,1746480
gyrAp,3.8333333333333335,27,5,CTAGGGTTAAAAATTTCTCG,22,1756414
gyrAp,1.8333333333333333,15,5,CTACGGAAAGAGAGGGAGAG,10,1744448
gyrAp,5.666666666666667,38,5,CTAAGGTCAAAATGTGCCTC,33,1766996
gyrAp,0.3333333333333333,6,5,CGGTCCTCCGCTCCGCCTGA,1,1751906
gyrAp,0.8333333333333334,9,5,CGGGCAATATACGGCTGATA,4,1743360
gyrAp,2.0,16,5,CGGCATCAGAAAACGAACGT,11,1757110
gyrAp,4.5,31,5,CGGAATTCAGTGGTGACACT,26,1767132
gyrAp,4.333333333333333,30,5,CGCTCCTACCGGCCTTCGTT,25,1753045
gyrAp,3.8333333333333335,27,5,CGCTCCACAAAACTGCCCAA,22,1768239
gyrAp,0.3333333333333333,6,5,CGCAGGGGGCATCAGTCCGC,1,1742130
gyrAp,0.3333333333333333,6,5,CGACTGTCTAGACGACGACT,1,1764990
gyrAp,3.6666666666666665,26,5,CGACGAAGATAGGGTAGTAA,21,1751926
gyrAp,4.833333333333333,33,5,CGAATCACTGCAATGAAGTG,28,1761331
gyrAp,3.8333333333333335,27,5,CGAATAGTTCATATGCGTGC,22,1743504
gyrAp,1.8333333333333333,15,5,CGAAACCATGTATGGTCCTG,10,1751577
gyrAp,4.833333333333333,33,5,CCTGGAGTCATCCTTCTTGG,28,1761195
gyrAp,2.1666666666666665,17,5,CCGTGTAGACGTGTTTGTCT,12,1753154
gyrAp,2.5,19,5,CCGAATAAAATGCGTAATTT,14,1761986
gyrAp,0.5,7,5,CCCTTGAAGCGCACTACGGA,2,1760210
gyrAp,8.0,52,5,CCCGTCAGGTCCACATTGAA,47,1759707
gyrAp,0.3333333333333333,6,5,CCCGCGGGAGCATGGCCGGC,1,1746120
gyrAp,2.0,16,5,CCATCCGGCTAAGGTTCAGA,11,1744110
gyrAp,3.3333333333333335,24,5,CCAGGTTGACACGCTTTCTA,19,1742973
gyrAp,0.8333333333333334,9,5,CCAGGTGCAAGTGATCTAAG,4,1748162
gyrAp,4.166666666666667,29,5,CATTGAGTTTGACTCCCAGA,24,1756732
gyrAp,3.8333333333333335,27,5,CATGTCTTATGTAAGCATTA,22,1759099
gyrAp,2.6666666666666665,20,5,CATGTACTCTGGGAATAACA,15,1762987
gyrAp,4.666666666666667,32,5,CATGGGAAATCCTGCCTACT,27,1758440
gyrAp,0.3333333333333333,6,5,CATCCGCAGAGCGACAGCGG,1,1749823
gyrAp,2.1666666666666665,17,5,CATATTCATAAAGTCTGTTT,12,1744619
gyrAp,0.6666666666666666,8,5,CAGTAATAATGCGGTCACGG,3,1761165
gyrAp,0.3333333333333333,6,5,CAGCTGACATTTTTCTGTGC,1,1742458
gyrAp,0.3333333333333333,6,5,CAGCGACATACGTATTAGGT,1,1766063
gyrAp,0.3333333333333333,6,5,CAGATCACTGGTTGTTGGTC,1,1769577
gyrAp,0.3333333333333333,6,5,CACCTAACACTCGATTTCCG,1,1769556
gyrAp,3.3333333333333335,24,5,CAATTTGAATTCGACAATGG,19,1764416
gyrAp,3.0,22,5,CAACGCCGCATATTCAGCTC,17,1747945
gyrAp,5.166666666666667,35,5,CAAATGATTACATTGTCTAC,30,1748651
gyrAp,0.3333333333333333,6,5,ATTTGAAGGACGTTATCAGT,1,1743887
gyrAp,10.5,67,5,ATTGGGCCAATGCGGAGGTA,62,1756269
gyrAp,2.6666666666666665,20,5,ATTGCGTATCAATGAAGGGT,15,1763944
gyrAp,1.1666666666666667,11,5,ATTCTCCTCCCTACGTGCCA,6,1767160
gyrAp,8.0,52,5,ATTCCTTGGAAGAGAAGTAC,47,1745751
gyrAp,2.6666666666666665,20,5,ATTCCCCATATCTCATATCT,15,1757548
gyrAp,19.833333333333332,123,5,ATTCACCGCAAGGACAAAGA,118,1746001
gyrAp,4.333333333333333,30,5,ATTACCGTTTACAGCCAAGC,25,1745509
gyrAp,3.8333333333333335,27,5,ATGCTTAGGGGAGGGACGCT,22,1743120
gyrAp,1.5,13,5,ATGATCATGAAATTCACTAC,8,1764168
gyrAp,0.8333333333333334,9,5,ATGACAGCTCGGAATCCAAG,4,1742305
gyrAp,8.5,55,5,ATCTGTCGCGGGGTTGTAAT,50,1747409
gyrAp,1.5,13,5,ATCTGTAGCTCGAACGTATA,8,1763744
gyrAp,7.166666666666667,47,5,ATCGTTTAAACCATTCGCTA,42,1755091
gyrAp,4.333333333333333,30,5,ATCGTAACACTACGCTTAAG,25,1754141
gyrAp,5.333333333333333,36,5,ATCATTGGCAGTAGTCCTTG,31,1746131
gyrAp,3.5,25,5,ATCACTGCCTATGGGATAGA,20,1756822
gyrAp,3.8333333333333335,27,5,ATATGCAAAAGAAGGGCCAA,22,1754151
gyrAp,4.0,28,5,ATAGCTAGGTTCAAATCGTT,23,1746825
gyrAp,0.8333333333333334,9,5,ATACCATCGAGCTTATTGAA,4,1742311
gyrAp,3.3333333333333335,24,5,AGTGTGGATAACGCTTGAGC,19,1753327
gyrAp,3.3333333333333335,24,5,AGTAAACCTGTGCTGGCCCT,19,1756062
gyrAp,0.5,7,5,AGGTCACGAGAAAAGTATCT,2,1744413
gyrAp,3.6666666666666665,26,5,AGGGCAAACAGTAGTTTCGG,21,1746595
gyrAp,4.5,31,5,AGGCGCGTGGTTCTGCACCA,26,1765687
gyrAp,0.6666666666666666,8,5,AGGCATACATGACAGGCTCA,3,1757483
gyrAp,6.833333333333333,45,5,AGGACAGTTCGGCGCCAGGC,40,1765191
gyrAp,5.833333333333333,39,5,AGCTTCTACTCTAGAGTGAT,34,1767157
gyrAp,4.0,28,5,AGCTTATCGGTGCAATTACG,23,1766897
gyrAp,0.5,7,5,AGCTCTGCGTTACATTCAAC,2,1749780
gyrAp,3.1666666666666665,23,5,AGCGAGACTACTTAGTAAAC,18,1769242
gyrAp,7.166666666666667,47,5,AGCCCACTATCCTTTATTGC,42,1767070
gyrAp,1.1666666666666667,11,5,AGCATCCGTCGGTACAGGCC,6,1753812
gyrAp,0.6666666666666666,8,5,AGCAATATGACCGACTTACA,3,1766356
gyrAp,1.3333333333333333,12,5,AGATCAAACGACGGAAGGTA,7,1750713
gyrAp,6.0,40,5,AGAGCGGTAAGATCCTGCAG,35,1746532
gyrAp,1.1666666666666667,11,5,AGACTCACTAATACGGTTTC,6,1770774
gyrAp,0.5,7,5,ACTGCTAATTATACTTGGAA,2,1770280
gyrAp,6.166666666666667,41,5,ACTCTGGTGAGAATATTGGT,36,1752237
gyrAp,5.0,34,5,ACTCTACGACGGTTGCGCCG,29,1758295
gyrAp,1.1666666666666667,11,5,ACTATTAGGAGATGACAGTT,6,1756679
gyrAp,7.666666666666667,50,5,ACTACGAGTAGCGTAATTGT,45,1756832
gyrAp,1.1666666666666667,11,5,ACGTGTCAAGTACCCACAGT,6,1769104
gyrAp,3.8333333333333335,27,5,ACGTGGCACAAGTCCGCCTC,22,1745369
gyrAp,0.3333333333333333,6,5,ACGGCTAACTTTCTGGTGAT,1,1752255
gyrAp,0.3333333333333333,6,5,ACGCATAGGGAGAAAGTAAG,1,1753288
gyrAp,1.0,10,5,ACCGTCTTCGCCTTCAACCC,5,1742382
gyrAp,8.0,52,5,ACCCGGGATGAATGCAACAG,47,1761191
gyrAp,4.666666666666667,32,5,ACCCGATTCCTTTTCAATCA,27,1770074
gyrAp,5.0,34,5,ACCAGTGAGACAATTCTGTT,29,1756380
gyrAp,4.666666666666667,32,5,ACATTGTAGTTGGTAGATGA,27,1768021
gyrAp,3.8333333333333335,27,5,ACATTCGCCTCGTATTCTTT,22,1750655
gyrAp,2.5,19,5,ACATGCCGGTCCACTAGCCC,14,1770429
gyrAp,4.0,28,5,ACATGATATGTAGCGCCTAC,23,1765032
gyrAp,1.3333333333333333,12,5,ACATAACAACCGGCACGGTT,7,1747051
gyrAp,3.1666666666666665,23,5,ACAGGATGATTAAGCGACCG,18,1763344
gyrAp,1.1666666666666667,11,5,AATGTGGCTCAATTTTTGTG,6,1757614
gyrAp,0.6666666666666666,8,5,AATGGGCCGGTTGTAGCGAC,3,1768279
gyrAp,3.1666666666666665,23,5,AATGCGTGCGGATACCGGAC,18,1742074
gyrAp,2.1666666666666665,17,5,AATGCCCCACGACAACGGCG,12,1754388
gyrAp,2.5,19,5,AATCGCACCGCGGCCCGCTT,14,1770870
gyrAp,1.3333333333333333,12,5,AAGTTCTCGTCGCAGGGGAT,7,1762081
gyrAp,4.0,28,5,AAGATCCGATAGTGCTAGCG,23,1762103
gyrAp,0.3333333333333333,6,5,AAGACGGGAAGATTAGCTCT,1,1762788
gyrAp,0.5,7,5,AACGGATGTTGGTGGTGACT,2,1747587
gyrAp,2.1666666666666665,17,5,AACGCACCCTGGGAACCCAT,12,1750163
gyrAp,3.3333333333333335,24,5,AACGATTGCAAGCTGTTTAT,19,1766291
gyrAp,4.333333333333333,30,5,AAATTGCAAGCTTCTACGAT,25,1752786
gyrAp,1.3333333333333333,12,5,AAAGTCTTTCTTACCGACCA,7,1744655
gyrAp,6.333333333333333,42,5,AAAGGACTGTTTGAGACCCC,37,1752785
gyrAp,0.3333333333333333,6,5,AAACGGCATCCGTGAATAAC,1,1751982
gyrAp,3.1666666666666665,23,5,AAAAACGTCGCGCAGCTCCC,18,1745554
gyrAp,0.4,5,4,TTTTGGTTGGATGTAAATGT,1,1748950
gyrAp,0.4,5,4,TTTTCTAGATCCTTATACAA,1,1761865
gyrAp,4.8,27,4,TTTTAGTGCCTCTTCCGTAT,23,1761916
gyrAp,2.8,17,4,TTTGTTAGGCCTCGAGAATG,13,1768395
gyrAp,2.6,16,4,TTTGTCGGAGAAGTGATAAA,12,1752490
gyrAp,1.0,8,4,TTTGTCCAAGGGCTCCACGA,4,1751052
gyrAp,1.6,11,4,TTTGCCTTGTATCTTCGCCG,7,1747690
gyrAp,5.0,28,4,TTTATTTCGACGCCACGCCA,24,1770887
gyrAp,2.8,17,4,TTTATCGGGATATCGCACGT,13,1766225
gyrAp,3.6,21,4,TTTAATGCTCTAAAATATAC,17,1768823
gyrAp,2.0,13,4,TTTAAAATGGTTCAGACGCG,9,1743422
gyrAp,1.0,8,4,TTGCATTGGACACTACACTT,4,1766351
gyrAp,14.6,76,4,TTGATAGTTAGCCAACACTC,72,1745018
gyrAp,0.6,6,4,TTCTGAGTTGAGATTTGTAA,2,1770072
gyrAp,0.8,7,4,TTCGGAGAGGGTGTTACTTA,3,1769407
gyrAp,0.4,5,4,TTCGCTGAACGAGGCCTGTG,1,1757329
gyrAp,2.8,17,4,TTCCACTCATTAACCGTAGG,13,1747045
gyrAp,3.8,22,4,TTATAGTGAAGCTGAGATTC,18,1746716
gyrAp,1.0,8,4,TGTTCCCGGGTAGCTTCATG,4,1763197
gyrAp,4.4,25,4,TGTCTAGATGGGACCACAGT,21,1767436
gyrAp,0.8,7,4,TGGTTGCAACTGGAGTCTGG,3,1744955
gyrAp,1.6,11,4,TGGTCAATTCCCGATGCCAA,7,1766969
gyrAp,0.8,7,4,TGGGTAAGGAGGGTTCCCAT,3,1759204
gyrAp,8.6,46,4,TGGCCGATCACATTTATGTG,42,1749325
gyrAp,0.4,5,4,TGGCCACTCGCCAAAAGGGT,1,1762322
gyrAp,5.0,28,4,TGCGGCCATTCTCGCACTAA,24,1754855
gyrAp,0.6,6,4,TGCCTACTTGGATAGTCAAC,2,1751942
gyrAp,1.2,9,4,TGATTGGTTTCTAGCAGGCC,5,1745214
gyrAp,4.8,27,4,TGAGGACACATCGGGCGGAT,23,1753957
gyrAp,0.4,5,4,TGAGAGCTGACAAATATAGT,1,1767535
gyrAp,0.4,5,4,TGACCCTGCCTGTCTGGAAG,1,1750693
gyrAp,0.4,5,4,TGACAGGGGGGGGGTAGGTC,1,1744569
gyrAp,0.4,5,4,TGACAGAGCCTAGGTCCGGG,1,1761630
gyrAp,16.6,86,4,TGAAGGCAAGGGTCTGGAGC,82,1762774
gyrAp,1.2,9,4,TCTTTGTGGTCGTATAACCT,5,1768763
gyrAp,7.6,41,4,TCTGAAGGTCGTTTATAGAA,37,1768497
gyrAp,4.6,26,4,TCTACTCCGATCGAAGCCTC,22,1758351
gyrAp,7.6,41,4,TCGTTTATTTAAGCCATTAT,37,1752933
gyrAp,6.4,35,4,TCGGCATCGCAGTGTGCAAT,31,1756074
gyrAp,0.4,5,4,TCGAACCAAGGTCGTCGCGC,1,1755730
gyrAp,0.4,5,4,TCGAAAACTGGCAACGACAT,1,1762146
gyrAp,0.6,6,4,TCCTCGGAAAGCTCACCTCT,2,1752298
gyrAp,4.4,25,4,TCCCGACGGCACTGCGAGAC,21,1745570
gyrAp,5.8,32,4,TCATTTCTAAAGTGACTCAG,28,1752551
gyrAp,0.6,6,4,TCAGGCCGTGGAAATTACAC,2,1749811
gyrAp,8.0,43,4,TCAGCTTACAGCACTCTTTA,39,1748584
gyrAp,2.4,15,4,TCAAGCTTTGGAAATGGCCT,11,1743101
gyrAp,2.8,17,4,TATTAGATCGCAGACGCTTA,13,1742507
gyrAp,6.2,34,4,TATTACTATCCTAAGGCACG,30,1754555
gyrAp,9.0,48,4,TATGATTATCCTTGCACGCT,44,1750682
gyrAp,3.6,21,4,TATCTTCTACCAGGTAGCGG,17,1750105
gyrAp,0.8,7,4,TAGTAAGTAACATTGTTCTT,3,1766736
gyrAp,11.4,60,4,TAGGATGTCCAAAGTCTAAG,56,1753007
gyrAp,11.8,62,4,TAGGACCGGTTGCGGAGAAT,58,1750964
gyrAp,5.8,32,4,TACTACTGGGACTCAAAATA,28,1754305
gyrAp,6.4,35,4,TAATTTGCCCCGGGGTGGGC,31,1767642
gyrAp,6.0,33,4,TAACGAGTAGTGTTATTAGA,29,1765029
gyrAp,7.6,41,4,TAAAAAGTTTTACAGGCTCT,37,1769532
gyrAp,1.6,11,4,GTTTTTCTTATCAGCCGGAC,7,1754078
gyrAp,1.8,12,4,GTTTACTCTGAACGGAAAAA,8,1750739
gyrAp,7.8,42,4,GTTGCTATGCATGCGCACGG,38,1746465
gyrAp,4.2,24,4,GTTGCCCTTTGTAGTTTTCA,20,1753951
gyrAp,2.2,14,4,GTTAGTATGTAAGCTAGGCT,10,1748516
gyrAp,15.2,79,4,GTTAAAATGTGGAGTAGCTG,75,1768967
gyrAp,2.6,16,4,GTGTTCGTGTCCGTTAATGA,12,1752900
gyrAp,2.2,14,4,GTGCAGCACAACACGGGCCA,10,1769406
gyrAp,5.8,32,4,GTGACAGGTCAACCCTGTTA,28,1743644
gyrAp,2.0,13,4,GTCTTTGTCTGTGACTCAGA,9,1762746
gyrAp,1.6,11,4,GTCTACTGGGCACTGAGGGA,7,1748149
gyrAp,7.8,42,4,GTATTTATGTATAACCGTGC,38,1758120
gyrAp,1.6,11,4,GTAGCCATTCACAAATTAGA,7,1766498
gyrAp,4.6,26,4,GTACGGCGTGTTATGTGTGG,22,1763155
gyrAp,2.0,13,4,GTAATTTGATCTTGGGTAGA,9,1752838
gyrAp,0.6,6,4,GGTTTGACCAAGTCATAATA,2,1767201
gyrAp,3.2,19,4,GGGCAGATGGCGGGACCCCC,15,1743248
gyrAp,0.4,5,4,GGGCACGAGAGGAATCCCTT,1,1745455
gyrAp,20.2,104,4,GGGCAAGTAATCCAGGACGC,100,1746871
gyrAp,5.2,29,4,GGCTCTCGTAGGTGAAGATG,25,1761260
gyrAp,0.8,7,4,GGCTCGAGAGTGCACTTCAA,3,1761498
gyrAp,0.4,5,4,GGCTCATTAAGATGTCTATA,1,1754332
gyrAp,0.4,5,4,GGCTAGGCCGATTATCGTCT,1,1764199
gyrAp,2.0,13,4,GGCATGCAAGTCGTAGGGCG,9,1750613
gyrAp,7.8,42,4,GGCAGATTAATAGTATTCTT,38,1749680
gyrAp,6.0,33,4,GGACAATACCGTGTTGTTTG,29,1745666
gyrAp,4.8,27,4,GGAACTGAGAGATTCCGCAG,23,1770003
gyrAp,0.4,5,4,GGAAAGGTTTTCAATCTGCG,1,1748949
gyrAp,7.8,42,4,GGAAACCCCATATGGTCCTA,38,1757560
gyrAp,1.4,10,4,GCTGGGTTGCCAGAATTATT,6,1764141
gyrAp,5.0,28,4,GCGGATAGTAGTGGTAGTCA,24,1747289
gyrAp,5.4,30,4,GCGCCTCCTAACAGTTCCCT,26,1751369
gyrAp,5.6,31,4,GCGCAGTAACTGTCGTCACG,27,1742162
gyrAp,5.0,28,4,GCGATTAATCAGGCACGTAA,24,1759767
gyrAp,0.4,5,4,GCGATAGCCAGGGGATCAAT,1,1759687
gyrAp,3.4,20,4,GCGAAACTCAACGTCCGCGC,16,1751171
gyrAp,0.4,5,4,GCGAAAACTTTACGTTCCCG,1,1760516
gyrAp,5.2,29,4,GCCATGAATGCAAGTGATGA,25,1756073
gyrAp,3.4,20,4,GCATCAAATAGGCGTAGGTA,16,1747290
gyrAp,2.0,13,4,GCAGGGAGGCCCAGCGGTGA,9,1757449
gyrAp,5.2,29,4,GCACGAAACCAGCACACATG,25,1756287
gyrAp,5.4,30,4,GCACACCGGCAAATTGTGCT,26,1760997
gyrAp,1.4,10,4,GCAAGTCACTGGGCATGGCC,6,1764693
gyrAp,24.4,125,4,GCAAGAACGTTGCCCTTCCT,121,1761258
gyrAp,2.0,13,4,GATTCCGTACATTAATCGGA,9,1749359
gyrAp,6.8,37,4,GATCGGTAAATATTCATTGC,33,1753509
gyrAp,2.6,16,4,GATAATCGGTATCTCCGCAA,12,1760099
gyrAp,3.8,22,4,GAGTTCGTAGTCTGCGGAAC,18,1748289
gyrAp,6.4,35,4,GAGGTGAACATCTCGTCCTA,31,1746369
gyrAp,6.0,33,4,GAGGAGAACGTCTCTCGCAT,29,1753347
gyrAp,3.0,18,4,GAGATACATTGAGCTCCCGA,14,1749926
gyrAp,0.6,6,4,GACTCTAGCGGTATCAAACA,2,1745740
gyrAp,6.8,37,4,GACGCATCTGTGTGAGAATT,33,1767186
gyrAp,4.2,24,4,GACCGGCCGCATAGGAGTTG,20,1747455
gyrAp,6.8,37,4,GACCCTACGTCTGAAACAGG,33,1767723
gyrAp,9.6,51,4,GACAAATTGGTGTTCGCAGC,47,1743364
gyrAp,0.4,5,4,GAAGTCAATGGTGTGTCTGC,1,1749763
gyrAp,0.4,5,4,GAACTATGCTTCCCGGTCAC,1,1744644
gyrAp,0.6,6,4,GAAAAGGAGGGGTAAATGTC,2,1741681
gyrAp,6.8,37,4,CTTTTCTCTGACTTAAGATT,33,1742983
gyrAp,1.8,12,4,CTTTTCAGATTAATTCGCCC,8,1741582
gyrAp,2.6,16,4,CTTTCGTATTGGAGCCGGGG,12,1742517
gyrAp,1.0,8,4,CTTCGTGCGGCCACGGATAT,4,1755316
gyrAp,4.2,24,4,CTGTGCACTAGCCAATTCAA,20,1762492
gyrAp,1.8,12,4,CTGTATTGTCATTGAAATAA,8,1760247
gyrAp,4.6,26,4,CTGCTGGTGTCGGTGGGAAC,22,1756575
gyrAp,0.4,5,4,CTGCCGGAGATCAATCAGGG,1,1747092
gyrAp,10.8,57,4,CTGCACTCCGAAGGATATGG,53,1765994
gyrAp,1.6,11,4,CTGATGATCGGACAACAGGA,7,1762293
gyrAp,3.2,19,4,CTCGAAGACCTAAGCACGTG,15,1770635
gyrAp,9.6,51,4,CTCCTCTGAATCGTCTTGAA,47,1767772
gyrAp,8.6,46,4,CTCACGAGTAGGAGCAGATA,42,1750930
gyrAp,0.4,5,4,CTAATCCGGAATGCCAGAGC,1,1764514
gyrAp,3.0,18,4,CGTTCCATACACATCCTCCA,14,1756866
gyrAp,5.2,29,4,CGTGTCTATTCATAAACAAT,25,1764058
gyrAp,0.4,5,4,CGTCTACTTCTGACAAGTAC,1,1745971
gyrAp,2.0,13,4,CGGTTCGTGGCACCTGGAAA,9,1741524
gyrAp,3.0,18,4,CGGTGTCTGGTTCTTAGGGT,14,1768158
gyrAp,1.2,9,4,CGGTCCGAGTAATTATAGCG,5,1758156
gyrAp,7.6,41,4,CGGGGAACGAGTGAACTGAA,37,1756857
gyrAp,5.8,32,4,CGCGTTGCGTGTTTAGATGC,28,1760789
gyrAp,1.4,10,4,CGCGGCAGACCCAATTACGT,6,1754240
gyrAp,6.0,33,4,CGCGAAGGGTTATAGTGTGT,29,1752229
gyrAp,7.4,40,4,CGCCGACGGGTGGATCCAAT,36,1761052
gyrAp,0.4,5,4,CGCATTTGCTATGGGGTACA,1,1759462
gyrAp,3.8,22,4,CGCACACTGACTCCTTAGCC,18,1766191
gyrAp,11.4,60,4,CGATTGACCATCTCGCTGGA,56,1748756
gyrAp,6.0,33,4,CGATCGATCACCAGTGGGCA,29,1750580
gyrAp,5.8,32,4,CGATATCGTTGGTGTTTTGG,28,1761014
gyrAp,6.6,36,4,CGAGGGGGGTTCTGTACAAT,32,1749590
gyrAp,2.0,13,4,CGACTGTGATCACAGGGGTG,9,1758286
gyrAp,1.4,10,4,CGACTGCACCCCGGCATACT,6,1768012
gyrAp,0.6,6,4,CCTTGCCAGGGTCACCTTTT,2,1753217
gyrAp,0.4,5,4,CCTCCTGTGGGTGTGAAGTG,1,1748570
gyrAp,4.0,23,4,CCTATATACCGTGGCTGCAA,19,1756042
gyrAp,4.8,27,4,CCTAAACCTGGTTTGACGGC,23,1770179
gyrAp,2.4,15,4,CCGATATATCCCACATAATT,11,1762029
gyrAp,0.4,5,4,CCCGGTTGAGAATGTCGCGT,1,1762584
gyrAp,6.2,34,4,CCCCGCTTTGCTTTGAGGTA,30,1750475
gyrAp,0.4,5,4,CCAGTCGTCTAGTATGATCT,1,1763580
gyrAp,3.8,22,4,CCAGGCATATCTGGTCACGA,18,1747280
gyrAp,3.2,19,4,CCAGCGTAGATCGCGGCCGT,15,1755773
gyrAp,2.6,16,4,CATGTAGAAAGCCTCTAGAG,12,1760116
gyrAp,8.4,45,4,CATCCGCGCCAGACCATCAG,41,1764609
gyrAp,19.6,101,4,CAGTGACAGTGTTGCCATAG,97,1758161
gyrAp,4.2,24,4,CAGGACAAAAGCAATTTCTG,20,1754306
gyrAp,3.2,19,4,CAGATATAAACGTCCCACCT,15,1758457
gyrAp,1.8,12,4,CACTCGTCTCCCTAGGCACA,8,1761207
gyrAp,4.6,26,4,CACCCCGCAAACAGACGACT,22,1765377
gyrAp,0.4,5,4,CACCCATGGACTCGTTCGTG,1,1765459
gyrAp,4.6,26,4,CACATTGAGCTACCAGTGAA,22,1768198
gyrAp,0.4,5,4,CACACGAGTGGCTTATTCCA,1,1755260
gyrAp,0.6,6,4,CACAACGTTATCGATGGACT,2,1762857
gyrAp,5.0,28,4,CAATGTGTTCACTGGGGCGG,24,1744238
gyrAp,0.4,5,4,CAATGCACAGTGCAGCGACC,1,1765531
gyrAp,1.6,11,4,CAAGAGAGTCCACAGCACCT,7,1758549
gyrAp,0.4,5,4,CAACTCCGCTTGGATTTCGG,1,1769011
gyrAp,6.4,35,4,CAAACACATGGATTCGATGC,31,1749652
gyrAp,2.4,15,4,ATTGTACATCATGTCCCGTG,11,1741652
gyrAp,9.4,50,4,ATTGCAGCGCGCTGGGGACT,46,1765550
gyrAp,1.2,9,4,ATTCTCACATAATCTTCTCA,5,1750833
gyrAp,13.0,68,4,ATTCACTCTCGTGCTATTCT,64,1767173
gyrAp,6.0,33,4,ATGCCTTCGCAGTCCCTCAC,29,1748198
gyrAp,3.0,18,4,ATGATGGCCTTACTATATGG,14,1750632
gyrAp,2.0,13,4,ATCGTTTACGAACGGACACT,9,1752524
gyrAp,3.6,21,4,ATCGGGTACCTGGGGCTCCA,17,1743427
gyrAp,0.4,5,4,ATCATACGAATCCCGGTAGC,1,1754244
gyrAp,2.4,15,4,ATATTTGCCGGTTAACGACG,11,1760037
gyrAp,1.2,9,4,ATATAAGTGGGAGGACTTTA,5,1748561
gyrAp,0.4,5,4,ATAGACGCGCGACTCTGTCT,1,1758501
gyrAp,6.6,36,4,ATAACTTCGCCAAGAGCTCA,32,1769916
gyrAp,1.0,8,4,AGTGCTTATGATTAGGTTGA,4,1753199
gyrAp,0.4,5,4,AGTCAATCCCGGTACTGGAC,1,1741724
gyrAp,0.8,7,4,AGTATGCAATCCCGCATTGT,3,1768466
gyrAp,1.6,11,4,AGGGCGGGCTTGTGTAATTC,7,1763735
gyrAp,6.0,33,4,AGGGCAGTGTGACCGATTGT,29,1756479
gyrAp,11.6,61,4,AGGGATCGAAAGGCCTAGCC,57,1767844
gyrAp,6.4,35,4,AGGCTGAATTTTGTTTGGAT,31,1762346
gyrAp,4.4,25,4,AGGCGGCCATTGTCGTCCTA,21,1747081
gyrAp,0.4,5,4,AGGCGCATGGGGGTTAGACT,1,1762771
gyrAp,3.4,20,4,AGGCGAAGCGGTTGCACTTC,16,1764190
gyrAp,3.0,18,4,AGGCATGCGCAGTAGGAATG,14,1749701
gyrAp,5.4,30,4,AGCTATAACGGCATCAGATT,26,1750941
gyrAp,4.8,27,4,AGCGTGGGACCACAGCGTAT,23,1763828
gyrAp,9.4,50,4,AGCGAACTCAGACGCATCCT,46,1770225
gyrAp,4.6,26,4,AGATGCCGTCGTAATCAAAA,22,1761312
gyrAp,0.6,6,4,AGATCGGAGATATCCTCTTC,2,1754142
gyrAp,0.4,5,4,ACTTCGTCTTATTTTGGCGA,1,1749205
gyrAp,1.8,12,4,ACTTACACTTGGCTCGTGCG,8,1745546
gyrAp,2.2,14,4,ACTCAGTTTACATTACCAGA,10,1747828
gyrAp,4.2,24,4,ACTAGAACCCTGAGCGAGGT,20,1757700
gyrAp,4.8,27,4,ACGGTGTTAAGACACACAAC,23,1746683
gyrAp,6.6,36,4,ACGAGAGCAGTCCGTCAGGC,32,1765962
gyrAp,1.0,8,4,ACCATGGGTTGAGGTGGGTT,4,1768406
gyrAp,4.4,25,4,ACAGGATTGGTCCATGATGA,21,1759308
gyrAp,3.6,21,4,ACACGAAGACAATTGGGCGT,17,1760357
gyrAp,0.4,5,4,ACAAAGGCCACTTAGTGAAC,1,1759224
gyrAp,1.0,8,4,AATTTTATGACGGGTCAACC,4,1762095
gyrAp,2.6,16,4,AATTACTCAGTAACCCTGGG,12,1765942
gyrAp,2.8,17,4,AATGTCGTATATCGTCCATG,13,1741484
gyrAp,1.0,8,4,AATGCAATCTTCGGGACTCA,4,1742729
gyrAp,6.8,37,4,AAGTGTTATCTTATGTTTAT,33,1759110
gyrAp,5.2,29,4,AAGGCTCTCCCAAGTGTCCC,25,1763321
gyrAp,2.8,17,4,AAGGATGATGGCGTTACTTC,13,1751599
gyrAp,4.0,23,4,AAGCTTTTCCCAATTCGTGG,19,1750481
gyrAp,1.8,12,4,AACCTACTTTCAACTCATGT,8,1761520
gyrAp,7.25,31,3,TTTTCCCGGCATAAGCAGTG,28,1757610
gyrAp,0.5,4,3,TTTGACTTGCATGACAAGCC,1,1760243
gyrAp,12.75,53,3,TTTCTCGTAAGACTGTATCT,50,1751622
gyrAp,0.5,4,3,TTGTGTTTCCGTTAAACCCA,1,1741766
gyrAp,0.5,4,3,TTGGCATGCACAAACTTCCT,1,1743936
gyrAp,4.25,19,3,TTGAAATTGACGAGCTAGCT,16,1745105
gyrAp,4.75,21,3,TTCTTGAGTCGGGGCAATAC,18,1744704
gyrAp,4.5,20,3,TTCTTAAAGCTTCCTAATTC,17,1767072
gyrAp,1.75,9,3,TTCGGTGGCGCTGGCTTGTA,6,1769335
gyrAp,10.25,43,3,TTCAAGCGGTAAGAACCTTT,40,1748543
gyrAp,2.75,13,3,TTATCTAACATTTGAAGAAA,10,1765087
gyrAp,1.5,8,3,TTAGTCATTATGTCTGCCTC,5,1748545
gyrAp,4.25,19,3,TTACTGATGCTACGTAGGAT,16,1749180
gyrAp,2.5,12,3,TTACATGCGTTATTAGCAAG,9,1759644
gyrAp,8.75,37,3,TTACACCGTCTTGATAGGTA,34,1753355
gyrAp,0.75,5,3,TTACAAGCATTTGCAATGGG,2,1766321
gyrAp,6.0,26,3,TGTTCCTGGGCGAGCCTCCG,23,1744913
gyrAp,8.25,35,3,TGTTAAGCAATTCGTATCGG,32,1768496
gyrAp,6.0,26,3,TGTGGCAATAAAGTGAGGGG,23,1741456
gyrAp,11.75,49,3,TGTCCTCTAGCAAAGTTCTC,46,1751798
gyrAp,0.5,4,3,TGTCCAAATTCAGACCTGCA,1,1759521
gyrAp,0.5,4,3,TGGGGTGACTGTCCGTCAGG,1,1760163
gyrAp,0.75,5,3,TGCTGCTCGGAATACGACAT,2,1756426
gyrAp,2.0,10,3,TGCGCGGGTGGATCGAAACT,7,1743289
gyrAp,6.5,28,3,TGCCTTAGGGGTGTTGATCG,25,1755784
gyrAp,10.75,45,3,TCTGCGACGGGGCTCACTAC,42,1758263
gyrAp,1.5,8,3,TCGGTAATTATGCCATGTTT,5,1758173
gyrAp,1.25,7,3,TCCAGCCTGTTTCTTTTATA,4,1768751
gyrAp,2.75,13,3,TCATTGGTCAGAAACTGTCT,10,1752106
gyrAp,8.25,35,3,TCACTAGATCAGTTTTTGCA,32,1746419
gyrAp,6.75,29,3,TCACCCATAGCCTACCAAGA,26,1754279
gyrAp,3.75,17,3,TCAAGACTGGATCCTCCTAC,14,1744701
gyrAp,5.0,22,3,TCAAACGGTCCCACTAAAAT,19,1748053
gyrAp,0.5,4,3,TATTCACGGAGGCCTCCCCA,1,1763388
gyrAp,15.5,64,3,TATTATCGCATTTGGCTGAT,61,1756660
gyrAp,8.75,37,3,TATGAGTACGTGCGTGCTAT,34,1764201
gyrAp,1.5,8,3,TATAACGGCAAGACCCAGGT,5,1766800
gyrAp,26.25,107,3,TAGGGCGGCCCCGTCACTGC,104,1755053
gyrAp,1.25,7,3,TAGGCCGCTGAACGGTACAT,4,1770454
gyrAp,7.75,33,3,TAGCAGCTTGTACAGAGAAG,30,1765624
gyrAp,3.75,17,3,TACAGTATTCCGCGACTTAA,14,1742348
gyrAp,3.75,17,3,TAAACACCCTGCAGCTGTTC,14,1745927
gyrAp,3.25,15,3,GTTTCATAGAAACCACTGTA,12,1760844
gyrAp,4.0,18,3,GTTGTATGAAGCGCCATCCA,15,1758654
gyrAp,1.0,6,3,GTTGCCATCGTTGATCCTCA,3,1768213
gyrAp,2.25,11,3,GTTGAACGGCCTGGCCTGGG,8,1762678
gyrAp,3.25,15,3,GTTATAACGGTAGCCTGGGG,12,1757771
gyrAp,7.25,31,3,GTGTGGGCCGAAGCCCGTCA,28,1755302
gyrAp,3.5,16,3,GTGTCGCGCTCACCTTTTAA,13,1757478
gyrAp,5.75,25,3,GTGTCAGGGATTTCTTCCAC,22,1744463
gyrAp,7.75,33,3,GTGGCCACACTCTTTAGTTC,30,1749140
gyrAp,8.75,37,3,GTGAACGGGATCCGGGCCAC,34,1764373
gyrAp,10.25,43,3,GTCTCGTATCGGTAACATTG,40,1742280
gyrAp,8.0,34,3,GTCTCCAATTGGATGGCAGT,31,1764279
gyrAp,2.75,13,3,GTCTAAAGCAACGCGAGAGT,10,1762349
gyrAp,1.0,6,3,GTATCCCAAGGTAATCGTAT,3,1758154
gyrAp,2.5,12,3,GTATATTTATTCGGTAATTT,9,1753480
gyrAp,2.0,10,3,GGTTTGGATGCGTTGCCTAA,7,1753088
gyrAp,0.75,5,3,GGTTTAGGCCGTGCGTACAT,2,1751878
gyrAp,7.5,32,3,GGTGCTGTTTCCGGTAACCT,29,1760517
gyrAp,3.0,14,3,GGTGCTCCGGTTAGTGAGCC,11,1759487
gyrAp,0.75,5,3,GGGTGCATGTAGTACGGTAA,2,1759970
gyrAp,1.75,9,3,GGGGGGACCTTCACTATACG,6,1766355
gyrAp,12.25,51,3,GGGCCATTTACCGTACATTA,48,1763478
gyrAp,7.5,32,3,GGGCAATGTATATTAGTTGA,29,1746516
gyrAp,0.75,5,3,GGGACCGAAGTCGCCGTTTT,2,1745224
gyrAp,3.25,15,3,GGGACAATATGAGTATATCG,12,1752724
gyrAp,0.5,4,3,GGCTTGTAAGAGCAAGAGGC,1,1767200
gyrAp,0.5,4,3,GGCTTGAGCAATGGGCAACG,1,1748980
gyrAp,4.5,20,3,GGCGCGTACCTTAATGCTCC,17,1747003
gyrAp,4.5,20,3,GGCCTTAAGGATGAAGCCTT,17,1753216
gyrAp,9.25,39,3,GGCCGCACAGGGTGAATGGT,36,1770340
gyrAp,10.25,43,3,GGCATATCAATATAACCATG,40,1754272
gyrAp,0.75,5,3,GGATCCACCAGCTGCGACCA,2,1748171
gyrAp,1.5,8,3,GCTTTTAGCCGGTTAATAAA,5,1748774
gyrAp,0.5,4,3,GCGGTTTTCTGCACGGCTTT,1,1741982
gyrAp,1.5,8,3,GCGGCGTCGCTGGACTCGCT,5,1756975
gyrAp,1.25,7,3,GCCTGGAAAATAGTTAATAG,4,1752042
gyrAp,1.25,7,3,GCCCGAATGATGATAGGACC,4,1744111
gyrAp,12.75,53,3,GCCCCGGCGCAAGCGAGTGG,50,1768025
gyrAp,7.5,32,3,GCCACGTTTTATGTCGGATA,29,1753068
gyrAp,5.0,22,3,GCAAGGGGGAAGGAATACAT,19,1770621
gyrAp,0.5,4,3,GCAACACATCAGACTATTGG,1,1760254
gyrAp,8.75,37,3,GATTTCATGTGCCGGGCATC,34,1761483
gyrAp,6.5,28,3,GATGGTACATCGTGAGTCAT,25,1755481
gyrAp,8.75,37,3,GATATTCGATGCAGCCACCC,34,1748913
gyrAp,3.75,17,3,GATATACGCGGGCCGTCTGA,14,1769018
gyrAp,4.0,18,3,GATAGGTAGACAGGTCTTGG,15,1742775
gyrAp,0.75,5,3,GAGTAAATCTATATACTCCC,2,1754248
gyrAp,4.5,20,3,GAGGGTCCTACCCTTCATTA,17,1764882
gyrAp,0.75,5,3,GAGGCAAGGAATGTTGAGCT,2,1756375
gyrAp,9.5,40,3,GAGCGAGATTGATGTTGTCA,37,1744275
gyrAp,7.75,33,3,GAGCATTCGGTGTTCAAAAA,30,1769920
gyrAp,7.0,30,3,GAGCATGTAAGTAGGTTGTG,27,1765103
gyrAp,5.0,22,3,GACTAGCGGTCCTTGTGTCC,19,1759055
gyrAp,5.75,25,3,GACCTCGTGCCCGCCGACTG,22,1754145
gyrAp,3.75,17,3,GACCGTAGGCGGAAGATCGT,14,1763818
gyrAp,3.25,15,3,GACCCCTACAACTTTGACGC,12,1754483
gyrAp,7.75,33,3,GACCACACTAGGGAGTTTGA,30,1761445
gyrAp,0.5,4,3,GAAGCGTTGGTTTGAAATTC,1,1759484
gyrAp,5.0,22,3,CTTTTAGAATTCGAATGCGA,19,1768258
gyrAp,6.0,26,3,CTTCTCTACTAGGGTCCCTA,23,1749343
gyrAp,2.25,11,3,CTTATCGATAAACTCTCTAG,8,1748906
gyrAp,7.5,32,3,CTGTTGGTCGAGCCCATGCA,29,1745607
gyrAp,5.25,23,3,CTGGTGCTCCGGTTTCGGAG,20,1764992
gyrAp,16.0,66,3,CTGGCTCTTGGTCAGGGATA,63,1752700
gyrAp,2.5,12,3,CTGCTGTGACATTTGCGGAC,9,1760866
gyrAp,4.5,20,3,CTGCTATCCGGAACCACACA,17,1747296
gyrAp,1.75,9,3,CTGATACCCGGAATTAAACG,6,1747171
gyrAp,1.75,9,3,CTCCGTACAGCAGCTCGGAA,6,1755284
gyrAp,2.5,12,3,CTCCCGGACACGACTTCAAG,9,1762337
gyrAp,1.25,7,3,CTCCACTGATTAGGCGCCTG,4,1742892
gyrAp,7.5,32,3,CTCACCTCACCAAGCTACCC,29,1763695
gyrAp,3.75,17,3,CTAGACGTAGTCTGATGGAA,14,1753798
gyrAp,10.0,42,3,CTAATTGTACGAAGCGAAAA,39,1768560
gyrAp,14.25,59,3,CTAATACTAACGTGCATATA,56,1751963
gyrAp,5.25,23,3,CGTGACTGGCATCGCACAGG,20,1752605
gyrAp,7.25,31,3,CGTCGATAATTATGACTCCT,28,1753093
gyrAp,3.5,16,3,CGGGATTTCAATTTTAATCA,13,1745603
gyrAp,7.25,31,3,CGGCAGCAGCCTGCACCTGC,28,1761462
gyrAp,10.75,45,3,CGGATGTTATAACACGTGTT,42,1764341
gyrAp,7.0,30,3,CGCTGTGAGAACCGGCCACT,27,1768666
gyrAp,2.0,10,3,CGCGTTGGCGAACCGTCTCG,7,1746479
gyrAp,4.5,20,3,CGATCAGGGTTGACAGCGTA,17,1761409
gyrAp,0.5,4,3,CGAATCTCAAAGTCATTCGA,1,1751006
gyrAp,1.0,6,3,CCTTGCCTGGAGGTAACGGC,3,1751458
gyrAp,0.5,4,3,CCTTCCCCCCGCGTCCATAG,1,1754270
gyrAp,4.0,18,3,CCTTACGCATATGAAGGGCA,15,1754686
gyrAp,4.25,19,3,CCTTACACCCCGAACGTCAC,16,1769800
gyrAp,1.0,6,3,CCTCTTGGTGAGCCATCTGC,3,1766610
gyrAp,10.5,44,3,CCGGTGTCGGAGGCCTGGCA,41,1758900
gyrAp,1.75,9,3,CCGGTGCTTTGCAACATAAC,6,1765633
gyrAp,7.5,32,3,CCGGGGCTTACCGACTTCTG,29,1761257
gyrAp,6.0,26,3,CCGGGGAAGCCCCAGGCAAA,23,1754051
gyrAp,1.25,7,3,CCGAATGTCAATTGCTGACG,4,1757188
gyrAp,1.0,6,3,CCCGGTTACATCCGCACTGA,3,1765581
gyrAp,2.75,13,3,CCCGGTCCTGGGGCTATTCA,10,1756226
gyrAp,7.5,32,3,CCCCTATATCTCCGATTGCT,29,1750254
gyrAp,6.0,26,3,CCATTCGCAGACTCAAGATC,23,1742675
gyrAp,4.25,19,3,CCACGGTGATATCAGGGAAA,16,1751270
gyrAp,1.0,6,3,CCAATGAGCGACACCAGGTA,3,1769196
gyrAp,7.5,32,3,CCAATATCGGGCGCGAGGAG,29,1743572
gyrAp,1.0,6,3,CATCTTAAGTATCCAGGCAT,3,1765412
gyrAp,1.25,7,3,CATCGCAGGAACAGATCCAC,4,1761623
gyrAp,2.25,11,3,CATCGATGGAATAGGGAGGG,8,1764119
gyrAp,1.0,6,3,CATCAAGACGCGAACCTCTG,3,1748939
gyrAp,7.5,32,3,CAGGTCCCGATAGTCACGTA,29,1769297
gyrAp,3.75,17,3,CAGCGCTAACACGATACAAT,14,1759737
gyrAp,11.0,46,3,CAGCATTAGAGTATGCATAC,43,1765117
gyrAp,5.5,24,3,CACTTGCAGAATGGTCTTAC,21,1747673
gyrAp,1.75,9,3,CACCGGACCCGTCTTTGACA,6,1768734
gyrAp,1.0,6,3,CACATGTATCTATGTCTTTT,3,1748542
gyrAp,1.0,6,3,CAATTTGGTGGTATCTGGAC,3,1765222
gyrAp,10.75,45,3,CAATAGCCGACCCCTTCCTG,42,1758117
gyrAp,4.5,20,3,CAAGGCGCGTTGCTGCCAAT,17,1760560
gyrAp,3.0,14,3,CAACAGAGGCAGTTGTCCGG,11,1743039
gyrAp,4.25,19,3,CAAATATGTTCGTTTCGGTT,16,1750754
gyrAp,4.0,18,3,ATTTCCCAGTGATCTAACGT,15,1768180
gyrAp,3.0,14,3,ATTGTAATGGATCTCAACTC,11,1762450
gyrAp,1.75,9,3,ATTCTGTGAACCCCACTAGA,6,1742075
gyrAp,2.75,13,3,ATTCTCGGTATAAGTGTAAA,10,1743940
gyrAp,0.5,4,3,ATTCGGATATTATACGTAAG,1,1741680
gyrAp,6.25,27,3,ATTCACCTTGGAGAATAGCG,24,1763164
gyrAp,0.75,5,3,ATTAGCGCACCCGCATCCCC,2,1762227
gyrAp,14.5,60,3,ATGTTACTACCTCGGAGCAG,57,1756882
gyrAp,1.25,7,3,ATGTCTGTTTGTGTCATTGT,4,1762898
gyrAp,1.0,6,3,ATGGTGTATCCTATCTATAT,3,1749852
gyrAp,8.25,35,3,ATGCCTTTTTAGTGGATAAA,32,1750744
gyrAp,10.75,45,3,ATGCATGGGACGACTCCTGC,42,1752678
gyrAp,3.0,14,3,ATGACATTGAAATTACTCAA,11,1746445
gyrAp,1.25,7,3,ATCGTCGTCGGCAGCATGTT,4,1770526
gyrAp,3.5,16,3,ATCGCCTCTGGGTTCGACAA,13,1753755
gyrAp,5.25,23,3,ATCCTCTTAAATGTTCTGGT,20,1746789
gyrAp,0.5,4,3,ATCATAAATCACGAATATCG,1,1763667
gyrAp,1.75,9,3,ATCAGGATACGACGGATCTC,6,1750441
gyrAp,2.75,13,3,ATAGCTGCAGAAGCCAGCAA,10,1769092
gyrAp,7.0,30,3,ATACAACAGGCGTCCTAGGC,27,1749846
gyrAp,0.75,5,3,AGTTCGTGCCCTTGGTCTGC,2,1763313
gyrAp,6.25,27,3,AGTTCCTCTGGTTGGGAATT,24,1750643
gyrAp,3.75,17,3,AGTGCTCTAATGGGGTCCCA,14,1770693
gyrAp,6.25,27,3,AGTCTCAAGAAATCGGGTAA,24,1763413
gyrAp,1.75,9,3,AGTCGCCATGGCTGCATTAC,6,1760277
gyrAp,5.25,23,3,AGGGGTTCAGGACATCAGAT,20,1765104
gyrAp,1.75,9,3,AGCGTATGCTAATACGTGGT,6,1743272
gyrAp,2.75,13,3,AGCCCTGACGACCTCGAAGG,10,1762203
gyrAp,1.5,8,3,AGATCTCAAAGAAATTTACG,5,1748270
gyrAp,4.25,19,3,AGAAACTTAAAATTGAAGGC,16,1767251
gyrAp,0.75,5,3,ACTCGTGTCCACCAATATTG,2,1765175
gyrAp,4.0,18,3,ACTATTTGGCCTGTTCGAGT,15,1768856
gyrAp,0.5,4,3,ACTAGGACAGGCCACACGAA,1,1753961
gyrAp,0.75,5,3,ACGTTCGCTAGCATTGCTAA,2,1762533
gyrAp,0.75,5,3,ACGTTACTGAACGCCTACAG,2,1749303
gyrAp,0.75,5,3,ACGGCTAAAGTCCCACTAAC,2,1753832
gyrAp,0.5,4,3,ACGCCGGATGGTCTCCGGAA,1,1743937
gyrAp,0.5,4,3,ACCTCGTGCGATTATGTGCT,1,1747982
gyrAp,0.5,4,3,ACCGTAGTCCTGGCGGATGT,1,1766700
gyrAp,0.5,4,3,ACCATAATGATATCTCACGC,1,1769534
gyrAp,4.0,18,3,ACATTTTAGGGCTCCCCAAG,15,1743767
gyrAp,14.75,61,3,ACATTTAAAACGTTATGATC,58,1759709
gyrAp,0.5,4,3,ACATCTCTACTTAATTAACT,1,1760102
gyrAp,14.5,60,3,ACATCCCATCGTATGAACTT,57,1769177
gyrAp,0.5,4,3,ACAGTATGGAAAACCCACGG,1,1748195
gyrAp,1.75,9,3,ACAGGCTCTGCAAAATGAGT,6,1748778
gyrAp,1.0,6,3,ACAGCTACCCACTCGTAACT,3,1760908
gyrAp,0.5,4,3,ACAGACGCGGCGGCGTCGGC,1,1760836
gyrAp,13.0,54,3,ACACGCGATACAACGGTTCT,51,1769459
gyrAp,5.25,23,3,ACACAGGGTGCCGGCTGCCA,20,1769256
gyrAp,2.25,11,3,AATTTCAGGTATCCTATAAG,8,1766025
gyrAp,6.5,28,3,AATTGTAAGTCCATGTTGGT,25,1749348
gyrAp,2.25,11,3,AATTATCCCGTCTTTTCTCA,8,1746981
gyrAp,0.5,4,3,AATGAGTTTTGTTGCGATCG,1,1742753
gyrAp,1.25,7,3,AAGTGTACCGGGGAGAGGTA,4,1767879
gyrAp,1.75,9,3,AAGCCATCTATCGTCCAAAG,6,1749250
gyrAp,3.0,14,3,AAGAAGGGTGCCCCATATCC,11,1763162
gyrAp,0.5,4,3,AACTTTCTTGTCTGACTTTT,1,1747235
gyrAp,3.75,17,3,AACTAAAGGAACTAGTTAAT,14,1757413
gyrAp,17.0,70,3,AACCGCCCCAAGTCTCTCGT,67,1743790
gyrAp,2.75,13,3,AAATCGCATCATAATGGCTC,10,1753038
gyrAp,0.5,4,3,AAAGGATAGGGTAGATCTAA,1,1748190
gyrAp,6.5,28,3,AAACGCTTGGAGACCATCCG,25,1768076
gyrAp,0.6666666666666666,3,2,TTTCAACCGGCCGTCGGGAA,1,1767052
gyrAp,0.6666666666666666,3,2,TTTACGGCTAGCCCCTATGA,1,1754436
gyrAp,3.6666666666666665,12,2,TTGTCAGTAACCTCTTAGAT,10,1765153
gyrAp,4.0,13,2,TTGGGGCCTGCCATCCAAAA,11,1766873
gyrAp,6.0,19,2,TTGGCAGGAGCTAATAATGC,17,1756591
gyrAp,3.6666666666666665,12,2,TTGCCTCGGGGCCATCGAGT,10,1761179
gyrAp,0.6666666666666666,3,2,TTCTGTAATGTCAGAACCTC,1,1764917
gyrAp,8.666666666666666,27,2,TTCTCCTCCTTCGGGGCAGA,25,1750695
gyrAp,17.666666666666668,54,2,TTCGCAAGGTAAGCCACCGA,52,1759837
gyrAp,1.6666666666666667,6,2,TTCATTAATCAAGGCGCTGC,4,1746884
gyrAp,2.6666666666666665,9,2,TTACTTGGGATCATAGACGG,7,1747965
gyrAp,3.3333333333333335,11,2,TTACCGAGGTATGAGACCTC,9,1742498
gyrAp,2.6666666666666665,9,2,TTACATGATTCGTCAAAGTT,7,1770141
gyrAp,10.0,31,2,TGTTCCTGAATCACACCTAT,29,1755014
gyrAp,1.0,4,2,TGGGGGCGTGTGCGAAATCT,2,1748311
gyrAp,8.333333333333334,26,2,TGGGCCATCTTGGAACCCAG,24,1765097
gyrAp,8.333333333333334,26,2,TGGGCCAAGTGCCTGAATAC,24,1756412
gyrAp,5.666666666666667,18,2,TGGGACCCTGCCTTAATGGA,16,1749293
gyrAp,1.0,4,2,TGCTGGTCTTGGGGACGCAT,2,1759938
gyrAp,3.0,10,2,TGCAGGGTAGCTTTTAGACA,8,1755135
gyrAp,11.0,34,2,TGATTCACGCAGTTTCGTTG,32,1762079
gyrAp,1.0,4,2,TGATCCTCGCGGGACGTCTA,2,1760330
gyrAp,11.666666666666666,36,2,TCTTCTCGTTTAAGCACCCT,34,1748794
gyrAp,11.333333333333334,35,2,TCTGAACGCTGGATGAATCA,33,1746562
gyrAp,14.0,43,2,TCGCAGACACGGGCAGCAAG,41,1750169
gyrAp,3.0,10,2,TCGATCATTGCAGCACTGTC,8,1764867
gyrAp,11.666666666666666,36,2,TCGAGCGTCTTGCGATGTGC,34,1763319
gyrAp,8.666666666666666,27,2,TCCGTCGTCACAACTCCGGG,25,1750522
gyrAp,3.0,10,2,TCCGAAAGCAGCCATTTCCT,8,1757487
gyrAp,2.6666666666666665,9,2,TCCATGAAGAACAAAGGATA,7,1763703
gyrAp,5.333333333333333,17,2,TCCAGTGCATCCACCCAAGA,15,1752729
gyrAp,0.6666666666666666,3,2,TCCACTGAGATCGAAGTCAG,1,1766027
gyrAp,9.0,28,2,TCACCTTCTATGGGAGACCT,26,1764127
gyrAp,2.0,7,2,TATTGATAACTCGTATACAC,5,1753602
gyrAp,5.333333333333333,17,2,TATTAATCAGAGAAGGGCCG,15,1768404
gyrAp,0.6666666666666666,3,2,TATGTTCGATTCCCCCACAC,1,1764349
gyrAp,1.3333333333333333,5,2,TATGTATGAGTCCTGAGCGT,3,1753397
gyrAp,1.3333333333333333,5,2,TATGATGAACACACGGACGT,3,1758897
gyrAp,8.666666666666666,27,2,TATAATAGCGTGTATATGAC,25,1747498
gyrAp,1.0,4,2,TAGCCCCATGCTTTCGTTCC,2,1744589
gyrAp,43.333333333333336,131,2,TAGAGGTGTTCGTATCAATA,129,1743924
gyrAp,10.333333333333334,32,2,TAGAAGGTAAAGCGGTCGAG,30,1757045
gyrAp,7.666666666666667,24,2,TACTTCGACATACCTTGCGT,22,1742711
gyrAp,20.333333333333332,62,2,GTTGTGGACTTTGCTGTGTG,60,1757384
gyrAp,12.666666666666666,39,2,GTTGTAAAATTGGCGATTGC,37,1764327
gyrAp,10.0,31,2,GTTCTTGCGGGCTCCCCCTA,29,1755112
gyrAp,2.0,7,2,GTTCTGTAAACGGGCTACCT,5,1757358
gyrAp,4.0,13,2,GTTAGTAAGGTTTTCTATGC,11,1769849
gyrAp,17.0,52,2,GTTACCTGTATATTGGACAG,50,1758767
gyrAp,1.6666666666666667,6,2,GTGGCACTTTTCTTACGAAC,4,1763565
gyrAp,1.0,4,2,GTGACGGTCTACGACGATGC,2,1756978
gyrAp,1.0,4,2,GTCCCCTTAAACGGGGCCAC,2,1755388
gyrAp,1.6666666666666667,6,2,GTAGCGACAGACCGCGTACC,4,1741461
gyrAp,3.6666666666666665,12,2,GGTTACTCGCGGAGTTACTT,10,1749526
gyrAp,4.666666666666667,15,2,GGTGTCCCCCAAACCATCAA,13,1762472
gyrAp,13.666666666666666,42,2,GGTGATTGGTTTGTTTATCC,40,1753005
gyrAp,4.666666666666667,15,2,GGTCTAAAACAATTGTTCGC,13,1745854
gyrAp,12.0,37,2,GGTCGCACCGAGTGTTAAAG,35,1746183
gyrAp,4.333333333333333,14,2,GGGTATAGAGGGCTAATCGT,12,1762086
gyrAp,1.3333333333333333,5,2,GGGGTTGGGTAAATGGAACT,3,1744222
gyrAp,6.666666666666667,21,2,GGGGTTAGACCGTTTGAAAT,19,1770167
gyrAp,2.3333333333333335,8,2,GGGGTGTAACAAGAATAATT,6,1759945
gyrAp,3.0,10,2,GGGGACAAAGTGCTGCTTCG,8,1760231
gyrAp,12.666666666666666,39,2,GGGACTACGGCGCGCGTCTC,37,1746776
gyrAp,11.666666666666666,36,2,GGCTTTGTAAGTGTTGTCCT,34,1754527
gyrAp,7.333333333333333,23,2,GGCTCAGGCTAGAGGAGATA,21,1766801
gyrAp,0.6666666666666666,3,2,GGCTAAGTGTTTTACATACC,1,1756731
gyrAp,9.333333333333334,29,2,GGCGCACAACGCCTACCGGG,27,1760121
gyrAp,4.666666666666667,15,2,GGAGCGTCCACTCACTTTGG,13,1768061
gyrAp,1.0,4,2,GGAGCCTTAGGATTGGCTGG,2,1759642
gyrAp,2.6666666666666665,9,2,GGACCGTACGCCGATCCGGG,7,1742294
gyrAp,4.0,13,2,GGAATAGATCGCATTCTTTA,11,1748148
gyrAp,4.666666666666667,15,2,GCTCGTGAAGTTCACAATTG,13,1759247
gyrAp,9.333333333333334,29,2,GCTCAGTGTAGTGTTGGCTC,27,1744038
gyrAp,9.333333333333334,29,2,GCGTACGTTAAGCCGGACGA,27,1760838
gyrAp,1.3333333333333333,5,2,GCGGTCCTAGGCGTCCATCT,3,1742331
gyrAp,3.6666666666666665,12,2,GCGGTCAGGTCCACAGGCGC,10,1743127
gyrAp,2.6666666666666665,9,2,GCGCCGCCTATTCCGGCACA,7,1749274
gyrAp,2.0,7,2,GCCGTCTCGATTGCACCCAG,5,1767558
gyrAp,2.6666666666666665,9,2,GCCGAATTTTTAGAGAATGT,7,1770788
gyrAp,1.6666666666666667,6,2,GCCCCGACCAGCTGATAAGC,4,1746868
gyrAp,2.3333333333333335,8,2,GCCAAGTGTAGCCCTCCAGT,6,1754424
gyrAp,8.333333333333334,26,2,GCAGTCTGGCCGATGTGTTA,24,1752625
gyrAp,15.333333333333334,47,2,GCAGCTTGGGCACGTCAAAG,45,1759045
gyrAp,0.6666666666666666,3,2,GATTTTGTATGCGAATCCCT,1,1757043
gyrAp,6.333333333333333,20,2,GATTGACCGTCTGTTGGGAA,18,1745443
gyrAp,1.3333333333333333,5,2,GATCCGGGCGAATGAGCAAC,3,1743376
gyrAp,7.333333333333333,23,2,GAGTAAATTCCTCTTAATTG,21,1756291
gyrAp,2.0,7,2,GAGGCTTATAACCCTAAAGT,5,1752918
gyrAp,12.333333333333334,38,2,GACGCGCCTTATCACTACTT,36,1766632
gyrAp,0.6666666666666666,3,2,GACAAAATGCTGTTAATTTA,1,1766292
gyrAp,1.3333333333333333,5,2,GACAAAAGCGATCTGCGACA,3,1757239
gyrAp,23.333333333333332,71,2,GAATTCCATCGTGTATCGCA,69,1759525
gyrAp,1.0,4,2,GAAGGCCAAACTGAATTTTG,2,1742943
gyrAp,19.666666666666668,60,2,GAAAAGGTGGCTCGAAAAGA,58,1746578
gyrAp,1.0,4,2,GAAAACTACCATGCCCTCCG,2,1751831
gyrAp,9.0,28,2,CTTTGTCGGGACCGTTACAC,26,1749512
gyrAp,3.0,10,2,CTTGGTGATGACTTACCCAG,8,1763188
gyrAp,1.6666666666666667,6,2,CTTCGGCGCGTCGTCTGTAT,4,1758595
gyrAp,11.666666666666666,36,2,CTTAGACTACAGCAATTATT,34,1747608
gyrAp,4.333333333333333,14,2,CTGTGGGATCTAAGCAAAGC,12,1749403
gyrAp,4.666666666666667,15,2,CTGTATTACCAGTATTATGA,13,1759981
gyrAp,13.666666666666666,42,2,CTGATTATTTATCCATGGGT,40,1752341
gyrAp,2.3333333333333335,8,2,CTGATTATGGAGGGCTTGAA,6,1760437
gyrAp,4.333333333333333,14,2,CTCCGTCAAGTCACGTATTA,12,1757256
gyrAp,1.0,4,2,CTCCGAAGGTGTGAAGTGTC,2,1768887
gyrAp,3.3333333333333335,11,2,CTCACCCATTATAACCCTTT,9,1765630
gyrAp,2.6666666666666665,9,2,CTACTTGCACAGGAGACAGA,7,1741744
gyrAp,2.6666666666666665,9,2,CTAAGTAATAATATCTGCGC,7,1754271
gyrAp,2.3333333333333335,8,2,CGTTTACACCCGGAGTTAAG,6,1753555
gyrAp,1.6666666666666667,6,2,CGTGTCCCGATGAAACAATA,4,1742026
gyrAp,1.6666666666666667,6,2,CGTGCCGCGGTGGGTATGTC,4,1744007
gyrAp,2.0,7,2,CGTACCGGCGCCGGTCACGA,5,1748814
gyrAp,0.6666666666666666,3,2,CGTAATGAGAGGTTCTGATG,1,1761285
gyrAp,2.3333333333333335,8,2,CGGGTGTGTCATAGCTATCT,6,1750949
gyrAp,1.0,4,2,CGGCGGCCTGAATCCAAATC,2,1744381
gyrAp,2.3333333333333335,8,2,CGGATCGGCCGTTTGCGACT,6,1747016
gyrAp,8.333333333333334,26,2,CGGACAAGGCGGTAACCCTA,24,1761800
gyrAp,12.333333333333334,38,2,CGCGGCAATGAAATCCATGT,36,1752681
gyrAp,3.0,10,2,CGCGCCGGGCGGCCGGCAAA,8,1755663
gyrAp,0.6666666666666666,3,2,CGATACCCTGTGACCTAAGA,1,1756118
gyrAp,7.666666666666667,24,2,CGAGCGTTTGCGGTAATTTA,22,1744328
gyrAp,12.333333333333334,38,2,CGACCAACCCGCTGGGGGCA,36,1747216
gyrAp,1.0,4,2,CGACACCAAAGGCTGTCCAC,2,1747696
gyrAp,5.333333333333333,17,2,CCTGCTGCTTGAACTCTGGA,15,1761140
gyrAp,1.0,4,2,CCGGCATGTATACTCTTCCT,2,1742435
gyrAp,2.0,7,2,CCGAACGGGTCTATTTCATG,5,1768433
gyrAp,1.6666666666666667,6,2,CCCTATGTGAACAGTACCAG,4,1758691
gyrAp,3.0,10,2,CCCCCTTTACGGAACACACT,8,1746242
gyrAp,1.3333333333333333,5,2,CCAGACCCTTGAAGCAACGT,3,1741448
gyrAp,1.0,4,2,CCAATTTACATGATAGTTCC,2,1743575
gyrAp,12.0,37,2,CCAAACACGTAGTTCCTCGG,35,1761563
gyrAp,0.6666666666666666,3,2,CATTTTACGGTGTAACCGGG,1,1744304
gyrAp,2.3333333333333335,8,2,CATTGAGACGTGGTGTCCAC,6,1763826
gyrAp,6.0,19,2,CATTAGTCTTGTTCCAATAA,17,1764891
gyrAp,0.6666666666666666,3,2,CATTAGGATATGCCGTCCGG,1,1763329
gyrAp,1.6666666666666667,6,2,CAGTTTGAGATTTCGAAGCA,4,1747240
gyrAp,3.0,10,2,CAGTGCTTGTGAACGGGTCT,8,1759391
gyrAp,6.666666666666667,21,2,CAGGCCGGCGTTAATGGTAT,19,1770855
gyrAp,10.333333333333334,32,2,CAGAATCGATCCTCACGTTT,30,1750914
gyrAp,0.6666666666666666,3,2,CACTTGCCGTTGTTATGTCC,1,1770557
gyrAp,1.0,4,2,CACGTATCTGGATTAGTATG,2,1760033
gyrAp,1.6666666666666667,6,2,CACACTTTATTAATACCTAT,4,1750641
gyrAp,1.6666666666666667,6,2,CAATTGGATATCTACGGGGG,4,1753956
gyrAp,0.6666666666666666,3,2,ATTTTGTGATCGGCCACCTT,1,1754079
gyrAp,13.666666666666666,42,2,ATTTCGAAAAACCGTGGGCA,40,1752535
gyrAp,0.6666666666666666,3,2,ATTTCCACACGTTATGTTGA,1,1748580
gyrAp,6.666666666666667,21,2,ATTCTCCCTGCGGCTTCTCA,19,1744636
gyrAp,0.6666666666666666,3,2,ATTCGATTAAAAATTCTAGT,1,1742926
gyrAp,0.6666666666666666,3,2,ATGTCCAATAGATCTGTAGC,1,1742503
gyrAp,2.3333333333333335,8,2,ATGGTGAGTATTCCAGACGT,6,1760491
gyrAp,8.666666666666666,27,2,ATGGCTCCTCTATCATAGGT,25,1763301
gyrAp,4.0,13,2,ATGACAGGTGTGGTACATTG,11,1752502
gyrAp,8.333333333333334,26,2,ATCTGGCGCCAGGGGTTAAT,24,1763827
gyrAp,4.666666666666667,15,2,ATATCCATTTTGAAACTTAT,13,1764197
gyrAp,4.666666666666667,15,2,ATAGTTACATATGGTGTAGA,13,1764958
gyrAp,1.3333333333333333,5,2,ATAGTGTGAGCATATAGTGT,3,1756071
gyrAp,20.333333333333332,62,2,ATAGTGGCTGCTTATGTTCA,60,1766234
gyrAp,6.333333333333333,20,2,ATACGAACGTCAAGGCCGTC,18,1751317
gyrAp,4.0,13,2,AGTTCATGGTTTGGGCACCT,11,1758379
gyrAp,3.6666666666666665,12,2,AGTGCCAGTGGCGGGCATGA,10,1751625
gyrAp,3.6666666666666665,12,2,AGTGATGCCGGGCAGCCAGG,10,1762184
gyrAp,0.6666666666666666,3,2,AGTGATACAGCTAGAAAGGT,1,1758961
gyrAp,1.3333333333333333,5,2,AGGGAAGGCCGGCTTGGCCA,3,1758652
gyrAp,6.666666666666667,21,2,AGGACTGGGCGTCACACCCC,19,1768621
gyrAp,1.6666666666666667,6,2,AGCTGGAACAACCCAGGGAT,4,1765810
gyrAp,14.666666666666666,45,2,AGCTCGTTTAGTATACGCTG,43,1745610
gyrAp,7.333333333333333,23,2,AGCCAGGAAGGCCATTCTGT,21,1754326
gyrAp,15.0,46,2,AGATCCTAACGTAACGGGTC,44,1754733
gyrAp,8.666666666666666,27,2,AGAGGGCTCGCGTTCGGAAG,25,1770364
gyrAp,1.3333333333333333,5,2,ACTCGTCTTGGTGGCCAAAT,3,1753017
gyrAp,15.333333333333334,47,2,ACTCAGTATAACCTTCAAGA,45,1769517
gyrAp,13.666666666666666,42,2,ACTAAGCACTGGACCGGCAA,40,1749109
gyrAp,7.0,22,2,ACGGAGTAATCGGATATTGA,20,1770609
gyrAp,4.0,13,2,ACGCACTTTGCATCCATGAT,11,1759200
gyrAp,0.6666666666666666,3,2,ACCTGATAGAAATATCGGTA,1,1744530
gyrAp,6.333333333333333,20,2,ACCGGCTACCCAGAAAGTGA,18,1747395
gyrAp,15.666666666666666,48,2,ACCGCCGTCAATGACCCGAG,46,1768157
gyrAp,11.666666666666666,36,2,ACCATACATCCGCTGTAGCA,34,1758963
gyrAp,7.333333333333333,23,2,ACATAACTGTAACTACGCAT,21,1766382
gyrAp,1.0,4,2,ACACTGGAATCATGCGTTAC,2,1757488
gyrAp,0.6666666666666666,3,2,AATTTCCCCCTACATAGTCA,1,1757637
gyrAp,11.666666666666666,36,2,AATTCCAAGACTTTTCGGGT,34,1748952
gyrAp,6.333333333333333,20,2,AATTATCAGCCTACCAAAGC,18,1751294
gyrAp,13.333333333333334,41,2,AATCGAGTCAACTTATAACT,39,1768812
gyrAp,11.666666666666666,36,2,AAGTGGACTATCGACCATTT,34,1765541
gyrAp,2.0,7,2,AAGCCTTTGACTTATTTCTG,5,1758706
gyrAp,0.6666666666666666,3,2,AACGTTACAATTTAAGTTCC,1,1769373
gyrAp,8.0,25,2,AACGCTCCAAGTCTATTGTT,23,1769412
gyrAp,8.666666666666666,27,2,AACGCGACTGGCCACTCACT,25,1760495
gyrAp,7.333333333333333,23,2,AACCGGCGCATTCCATCTCC,21,1743563
gyrAp,1.6666666666666667,6,2,AAACTCATCGATTTTGTATC,4,1758888
gyrAp,1.0,4,2,AAAATCCGACGACACTGCAT,2,1765788
gyrAp,1.0,4,2,AAAATATCTCACTCGCGCAG,2,1767967
gyrAp,19.5,39,1,TTTTGACAGACTTAGGATCA,38,1762290
gyrAp,1.0,2,1,TTTCTGTTTACGTACTGTTT,1,1768907
gyrAp,11.5,23,1,TTTCTCAAATACGGTACTAA,22,1765863
gyrAp,3.5,7,1,TTTAAACTGTATGAATTAGA,6,1751628
gyrAp,3.5,7,1,TTGGGTCGGCGCCATCCAGA,6,1767629
gyrAp,8.5,17,1,TTCTATTAGAATTCAACGTG,16,1766492
gyrAp,8.0,16,1,TGTTGGGGAACCAAGAATGC,15,1745441
gyrAp,1.5,3,1,TGTTACTTTGACCTATACCA,2,1760568
gyrAp,8.0,16,1,TGTGTGACCACCCCACGTGC,15,1755054
gyrAp,6.5,13,1,TGTGCGGCGCCCAATGCGAT,12,1746619
gyrAp,8.0,16,1,TGTCGCCCGTCACAAAAATT,15,1751534
gyrAp,12.5,25,1,TGGTCAGTATCGCGTTTGCC,24,1752235
gyrAp,2.0,4,1,TGGGACTGGCCTTACTATAG,3,1748513
gyrAp,9.0,18,1,TGGCCGTGTCAAAGTAGTAC,17,1743235
gyrAp,14.5,29,1,TGGAAAAACGGTGACTCATT,28,1756738
gyrAp,8.5,17,1,TGCGTTCAACTATTAAGCAT,16,1759430
gyrAp,2.0,4,1,TGCGTAGCTACTGCTCATGA,3,1741942
gyrAp,2.0,4,1,TGATATGCACAAGCGTAGGA,3,1764930
gyrAp,11.0,22,1,TGAGACCTCAGAGGCATCCA,21,1768668
gyrAp,9.5,19,1,TGAAGGAGCCGTCATCAAAT,18,1767917
gyrAp,13.5,27,1,TCTGTTGTAACTGCGTCACC,26,1763770
gyrAp,13.5,27,1,TCTGTCTAAGCGGGTGAGGA,26,1750910
gyrAp,3.5,7,1,TCTGCGCGTATGCAAGCCGA,6,1747689
gyrAp,10.0,20,1,TCTCAGGGATCGCTGGGGAA,19,1755669
gyrAp,7.0,14,1,TCTCACAACGCTCCAGGCTG,13,1752652
gyrAp,16.0,32,1,TCGTTTGAACAGTTCAACCC,31,1745937
gyrAp,26.5,53,1,TCGTCTTCAACACACCCACC,52,1756508
gyrAp,2.0,4,1,TCCGTGTAGTTACGTGGTCA,3,1743198
gyrAp,18.5,37,1,TCCGCTCCTCTGATATAATA,36,1769395
gyrAp,1.0,2,1,TCCATGTTAAATAGATTACT,1,1762333
gyrAp,10.5,21,1,TCCAGTGGATGGTAGGTAGA,20,1760572
gyrAp,3.0,6,1,TCCAGACCTCGGCACTCACA,5,1754308
gyrAp,2.0,4,1,TCAGCAAGGTCCCTTGACGG,3,1752569
gyrAp,11.5,23,1,TCAATCCGAAAATAGAGAAA,22,1758715
gyrAp,9.5,19,1,TCAAAGGTATGCTTATTCCG,18,1744058
gyrAp,11.5,23,1,TATTGTCCGTTTAAGCAGCT,22,1756973
gyrAp,2.0,4,1,TATTGGCTATCCTGTCGCCT,3,1752459
gyrAp,6.0,12,1,TATTGCGGAGGATTCAGCGA,11,1752407
gyrAp,11.5,23,1,TATATGGCCGAGACACCCCG,22,1763847
gyrAp,18.5,37,1,TAGACCGGCTAGAAATAGGA,36,1769538
gyrAp,1.0,2,1,TACTATACTTGGTTAGGGTT,1,1759347
gyrAp,7.0,14,1,TACGCTATATTTACGATCAG,13,1762186
gyrAp,2.0,4,1,TACGAGCCGAAGATAGCTTT,3,1759618
gyrAp,4.5,9,1,TACCTACAAATACCCCCGTT,8,1770096
gyrAp,1.0,2,1,TAATCTTTTCGAGAAATGTG,1,1746418
gyrAp,14.5,29,1,TAAGCATGGCTGGACGTTTG,28,1763993
gyrAp,8.0,16,1,TAACTCGTGGGGGGGAGTAA,15,1768877
gyrAp,12.5,25,1,TAACGCGTAGTCTAACTACG,24,1755528
gyrAp,16.5,33,1,TAAATGCCAGTCATAATTTC,32,1748529
gyrAp,12.0,24,1,GTGTCCAGGCCAGAGGCCTA,23,1743701
gyrAp,13.0,26,1,GTGGGTACCGTAGCGCACAG,25,1750460
gyrAp,6.5,13,1,GTGCCATTCCGTGGGTGGAC,12,1756839
gyrAp,16.0,32,1,GTGACATCATATTTGCGGAA,31,1752455
gyrAp,6.5,13,1,GTCGCCGCCGGCATAAGCGG,12,1756258
gyrAp,2.0,4,1,GTCGAACAAGAAGGTTATGC,3,1762660
gyrAp,5.0,10,1,GTCCGGTGCAAGTTGGCCGA,9,1750109
gyrAp,1.0,2,1,GTCCGATCAATCGAGGGTAC,1,1759403
gyrAp,2.0,4,1,GTCAGGAGGAATATTGTCTA,3,1754635
gyrAp,9.5,19,1,GTCACTGAGCGTGCAGATTT,18,1745450
gyrAp,4.5,9,1,GGTTTGCTTTTCAGCCCGTC,8,1761634
gyrAp,13.5,27,1,GGTTGTCGGGGGTTATCCGG,26,1753410
gyrAp,11.0,22,1,GGTTAGCGAGGTTTTTTCGG,21,1766866
gyrAp,3.0,6,1,GGTGTCTACACGCCTGTTTC,5,1745777
gyrAp,13.0,26,1,GGGGAAGCGACTGAGGGCTA,25,1769591
gyrAp,12.5,25,1,GGCTATTGGCAGCCGTTACT,24,1749519
gyrAp,1.0,2,1,GGATGATCAGCAGTCGGGGT,1,1755508
gyrAp,9.0,18,1,GGAGAGCAAGAGCTTGTTAC,17,1744176
gyrAp,7.0,14,1,GGAAGGGCATATTTCGTCGC,13,1769501
gyrAp,2.0,4,1,GCTGCGTGTTTAGTCCGGGT,3,1769543
gyrAp,16.5,33,1,GCTCTCTCGAGTGGGAGCCA,32,1769942
gyrAp,15.5,31,1,GCTATCAGACAAGTTTGCTC,30,1763347
gyrAp,16.0,32,1,GCGGCTTGAAGATCGGGATA,31,1742901
gyrAp,2.5,5,1,GCGCATACTTTTGCGTTCAT,4,1756954
gyrAp,2.5,5,1,GCCTTTGCTCACGCCGGCCA,4,1767244
gyrAp,2.5,5,1,GCAGAGGGGGGCACTTCTGA,4,1766134
gyrAp,7.5,15,1,GCACCGATGGTATTAAGCGG,14,1758293
gyrAp,12.5,25,1,GCAAGCTTCGCCACAGCACT,24,1751297
gyrAp,1.0,2,1,GATGATGGGGGTCCAGGAAC,1,1748594
gyrAp,15.5,31,1,GAGTGGCAACTATACATAGT,30,1761387
gyrAp,38.5,77,1,GAGGCCACCCAAGCAGACAA,76,1745715
gyrAp,3.5,7,1,GAGGACGCATTGACACAGAC,6,1770781
gyrAp,4.0,8,1,GAGCTGTTAAACGTATCAGC,7,1761651
gyrAp,13.5,27,1,GAGCAGTGATTACGAGTAGA,26,1752781
gyrAp,16.5,33,1,GAGCAATTACCAAACGGGAG,32,1745387
gyrAp,2.0,4,1,GAGACTTATCATGGGCCTAC,3,1770222
gyrAp,4.5,9,1,GACGGTTGCCCTGAGCGAGG,8,1765043
gyrAp,2.5,5,1,GACAGTTTTTGTGATGGTAA,4,1769437
gyrAp,11.5,23,1,GACACATGATTATTTGCAAT,22,1770361
gyrAp,3.0,6,1,GAACACTACCATTCATAGCT,5,1746291
gyrAp,6.0,12,1,CTTTTTGGAAGTTGCCGCTA,11,1751641
gyrAp,3.0,6,1,CTTTTAGATCCAGGCATATA,5,1770926
gyrAp,14.5,29,1,CTTTGGAGCGGCACACCTTC,28,1750640
gyrAp,12.5,25,1,CTTGTCTCTAATGGCTCGTT,24,1763626
gyrAp,21.0,42,1,CTTGTAGTATACACTTCCTT,41,1761458
gyrAp,23.0,46,1,CTTAATTCGGTTATACGTAC,45,1748329
gyrAp,1.0,2,1,CTGTGCTGGGCCTTTCTTGA,1,1742438
gyrAp,3.0,6,1,CTGCTTCATGGGGTGTAGCT,5,1761997
gyrAp,3.5,7,1,CTGATACATTGTACCAGGAG,6,1754627
gyrAp,33.0,66,1,CTGAAAGGCAGGTATGCCAC,65,1756512
gyrAp,15.0,30,1,CTCTAGGATCCAGTGAGCGA,29,1762859
gyrAp,13.0,26,1,CTCCGTCTCCTCGTTGAGCA,25,1753232
gyrAp,13.0,26,1,CTCCGCTCTGAATCTACAAT,25,1749393
gyrAp,12.5,25,1,CTCCCATCGGGCTTCTTACA,24,1748470
gyrAp,8.0,16,1,CTCATCTTGAACGTTGTAGC,15,1750592
gyrAp,4.0,8,1,CTCACACGTGAATGTGGTAG,7,1752276
gyrAp,13.5,27,1,CTATGACGTTTACGTTAACT,26,1762395
gyrAp,1.0,2,1,CTATAGCTAGCTGCTTCAGG,1,1741625
gyrAp,9.0,18,1,CTATAAACCTAATGCCGACG,17,1755892
gyrAp,7.5,15,1,CTAAGAGTAACACGCTTAAG,14,1749814
gyrAp,3.0,6,1,CGTTAGGTTACGTCCGGGGT,5,1759922
gyrAp,12.5,25,1,CGTGGCGCTAGTTCGAACAT,24,1744462
gyrAp,3.0,6,1,CGTCCTCGAAGCCATATCGC,5,1767266
gyrAp,3.5,7,1,CGGGGCGCCGGCCATACACA,6,1761809
gyrAp,15.0,30,1,CGGGATCCATGGTTGGTATT,29,1759783
gyrAp,3.0,6,1,CGCTTTCTAATTTTAGACGT,5,1765578
gyrAp,2.5,5,1,CGCGTGATCGACAGATTAAA,4,1767073
gyrAp,1.0,2,1,CGATGAGTTGTAACCTTAGC,1,1760368
gyrAp,15.5,31,1,CGATACCCGTTGCGCTGGCT,30,1742109
gyrAp,12.0,24,1,CCTTGCCTACTTCGGTGGAT,23,1764648
gyrAp,13.0,26,1,CCTTCCGAGGCCAACGGACA,25,1768949
gyrAp,1.5,3,1,CCTTACTACACGCTGTCTTA,2,1770561
gyrAp,9.0,18,1,CCTATGCTACAAATCCATTT,17,1745171
gyrAp,7.5,15,1,CCTATCCCAGAATGTAGGCG,14,1749660
gyrAp,60.0,120,1,CCGCCGGGTAACCGCCAGTA,119,1753948
gyrAp,6.0,12,1,CCCGGTGGCATCCTCTATTT,11,1770394
gyrAp,2.0,4,1,CCCGGCTTTATCCTCCATGT,3,1749298
gyrAp,41.0,82,1,CCCATAGAAATACCTGACCC,81,1751256
gyrAp,7.5,15,1,CCAGATGCAAGCTCCCTGGT,14,1747703
gyrAp,9.5,19,1,CCACACGGTAAGACAGTGTA,18,1755485
gyrAp,1.5,3,1,CCAATGGCCCAGGTGCGTGA,2,1747621
gyrAp,3.0,6,1,CATTTTAAGCTGGAGCTTCG,5,1743155
gyrAp,20.0,40,1,CATTTCGATCGGGTTTAATA,39,1768892
gyrAp,13.0,26,1,CATCCCTCAAGTTGGCCCGA,25,1743533
gyrAp,30.0,60,1,CATATCTCAGGGCCATGTAG,59,1743754
gyrAp,25.5,51,1,CAGATGAAAAGCTACTATTA,50,1760533
gyrAp,11.5,23,1,CAGAGTAGGTGACGGCAATA,22,1747214
gyrAp,18.0,36,1,CACTGTTATACCTAGTCCCG,35,1765068
gyrAp,3.0,6,1,CACATAGCCTCATATCTGCT,5,1758859
gyrAp,19.0,38,1,CACAGGATTAGCGAACGATT,37,1742757
gyrAp,10.0,20,1,CACACGCGAAAGTCTTTCGT,19,1764635
gyrAp,37.0,74,1,CAATATAGCCAATCGGATGG,73,1766998
gyrAp,19.0,38,1,CAAGAGACGAATTTGTTCAC,37,1770799
gyrAp,8.0,16,1,CAACCGTGGCGTAATTGGTA,15,1758615
gyrAp,1.5,3,1,CAAATTCATCCCAACCACGT,2,1755438
gyrAp,18.5,37,1,CAAATAATATACATGACTGC,36,1767985
gyrAp,10.0,20,1,CAAAAGAACGAGCATGTTAT,19,1754025
gyrAp,6.5,13,1,ATTTTACGGCACACTATTAT,12,1761324
gyrAp,14.0,28,1,ATTTAGGATATGGAACCTAG,27,1758700
gyrAp,6.5,13,1,ATTCCTCCACTTCAATGTCT,12,1767738
gyrAp,3.5,7,1,ATTCCCGACGCGCATAAGTG,6,1768631
gyrAp,1.0,2,1,ATGCTCCAGTTATGTCCACC,1,1769816
gyrAp,2.0,4,1,ATGCGAAACCAGCGGGTGCA,3,1768018
gyrAp,18.0,36,1,ATGCAAGCATTCGATTTTGG,35,1751836
gyrAp,1.5,3,1,ATCCGCCAAACCGAAGCATA,2,1770530
gyrAp,4.0,8,1,ATACGATATTACTACGCGTC,7,1753777
gyrAp,21.5,43,1,AGTTCTGACGGGAACGCCTT,42,1746017
gyrAp,15.0,30,1,AGTGTTACCGACAAACTGCT,29,1745049
gyrAp,2.5,5,1,AGTGCTCGCGCATCTTTATG,4,1744307
gyrAp,13.0,26,1,AGTCATACTGTATGATCGGT,25,1762330
gyrAp,1.0,2,1,AGTACTCCGCAACGAGTAGG,1,1752919
gyrAp,8.0,16,1,AGGTAGGTACGCCTGGACTC,15,1756863
gyrAp,2.5,5,1,AGGGTATAGCGTTTGAAGTT,4,1755731
gyrAp,1.0,2,1,AGGGCAACCAGTAGTTTCGG,1,1746613
gyrAp,12.5,25,1,AGCGCACAGTGATATGATTT,24,1750299
gyrAp,11.0,22,1,AGCACGATTATTTCCGCAGG,21,1767493
gyrAp,3.5,7,1,AGCAAACTTGTAGAGAGGCC,6,1741756
gyrAp,3.0,6,1,AGAGTGGCGCGTCGTTATAC,5,1742353
gyrAp,1.0,2,1,AGAGACATCGGTCCCAATTC,1,1749186
gyrAp,1.5,3,1,AGACGCTAAAGGATTGAACC,2,1744402
gyrAp,2.5,5,1,AGACCGCAGAACCCGTTTCG,4,1759744
gyrAp,15.5,31,1,AGAAGGTGAAAAAATTTTTG,30,1768520
gyrAp,7.0,14,1,ACTTAGACCCGGTTTGGGGG,13,1748041
gyrAp,22.5,45,1,ACTCGAAGCAATAGAAACCT,44,1767729
gyrAp,5.0,10,1,ACGTTAAACGGGACTCATAC,9,1758618
gyrAp,9.0,18,1,ACGTGGCCTGTACTGCAGTC,17,1761298
gyrAp,25.5,51,1,ACGTGCCACGATCAACGACC,50,1746779
gyrAp,3.5,7,1,ACGGATTAGCTGGGGTCACT,6,1749698
gyrAp,1.5,3,1,ACGCCCCGTGCGCGGCCTGA,2,1743764
gyrAp,1.5,3,1,ACGCCCCCCCTAGGTACGTT,2,1760955
gyrAp,6.0,12,1,ACCTGGCCATGCGCCTAGCG,11,1750129
gyrAp,6.0,12,1,ACCAATTCCAATTAGTAGCG,11,1766138
gyrAp,32.5,65,1,ACAGTGACATTCAGGCACGA,64,1745125
gyrAp,16.0,32,1,ACAGCTTGCCTCGCGCACGA,31,1765051
gyrAp,5.5,11,1,ACACGGGTGGATGGGGCGAT,10,1763231
gyrAp,8.5,17,1,ACAATAAGGTTTGCTATCTA,16,1761693
gyrAp,1.0,2,1,AATTGAGTCCGGAACGGGGG,1,1758029
gyrAp,21.0,42,1,AATTCGTCGCCACAGGTATC,41,1744362
gyrAp,1.0,2,1,AATAACGCGCATTTAAGCCC,1,1749165
gyrAp,1.0,2,1,AAGTTAAGACGCATAAATGC,1,1751684
gyrAp,6.0,12,1,AAGGCAGGAACACCTATTGA,11,1767491
gyrAp,1.5,3,1,AAGCGCAGAACGATAATATA,2,1756573
gyrAp,16.0,32,1,AAGACTACAGGCTGAGGATC,31,1750638
gyrAp,15.5,31,1,AACTACTTAATCTAGTTCAG,30,1759412
gyrAp,3.0,6,1,AACGTCCCCCGCTCATTAGC,5,1742952
gyrAp,7.5,15,1,AACACACCGAAAGCGTATCT,14,1750967
gyrAp,1.0,2,1,AAATTAAGGCTCACGCGCGG,1,1758620
gyrAp,1.5,3,1,AAATATATCAGGTTCATGAA,2,1770309
gyrAp,4.0,8,1,AAAGGAACTAATTGATGCAA,7,1741586
gyrAp,25.5,51,1,AAAAGGTATTATTGTTTTTG,50,1752890
gyrAp,8.5,17,1,AAAAGACTGAGTTCTTCACT,16,1766856
gyrAp,0.017857142857142856,55,55,TACTCGAGAGTGACCACCCT,0,1742798
gyrAp,0.022222222222222223,44,44,GAAGGCGCTCCCTGTGACGT,0,1742974
gyrAp,0.022222222222222223,44,44,CACAAGAGCGAAGCCCCACC,0,1742826
gyrAp,0.023255813953488372,42,42,AGACAAAACTCGTCAGTCAC,0,1743702
gyrAp,0.023809523809523808,41,41,ACTCGCTAGAGCGAGTGCTG,0,1743959
gyrAp,0.02631578947368421,37,37,GTCTGGTTTTGCGTCAAGTA,0,1758470
gyrAp,0.02631578947368421,37,37,AATTCTGTCATACAAGGCGG,0,1741794
gyrAp,0.02631578947368421,37,37,AACTGGTCGTGATATGACAG,0,1764685
gyrAp,0.02631578947368421,37,37,AACCGGCTCATGCGCTTCTG,0,1759199
gyrAp,0.02702702702702703,36,36,CCCGTAGAGGGTGAGAGCCA,0,1757141
gyrAp,0.029411764705882353,33,33,ACAATATAAGGGGCCTGACC,0,1752949
gyrAp,0.030303030303030304,32,32,GCGACAGGGCGCTGGACTAA,0,1766210
gyrAp,0.030303030303030304,32,32,AGATGATCGACGTCATCTGC,0,1749752
gyrAp,0.03125,31,31,ACAGCCAGCCCATGGATCTA,0,1746147
gyrAp,0.03225806451612903,30,30,TTCAAACAGTAGTTGCACTG,0,1746170
gyrAp,0.03225806451612903,30,30,TAGATTACCTTTAAGACTAA,0,1758624
gyrAp,0.03333333333333333,29,29,CGCTACGACAGAGGTCGGTG,0,1745268
gyrAp,0.03333333333333333,29,29,AACCAGTCACTGCATATGTA,0,1764391
gyrAp,0.034482758620689655,28,28,CTAATATTGCAAGATGGTAG,0,1742347
gyrAp,0.034482758620689655,28,28,CCCGGTAGACAAATGTTGTA,0,1747352
gyrAp,0.034482758620689655,28,28,CATTTTCGGTTGAATGGTTG,0,1757190
gyrAp,0.03571428571428571,27,27,TTACGAAACGGCTGGGCTCT,0,1761083
gyrAp,0.03571428571428571,27,27,GTTATCGGACATGGAATCTG,0,1743899
gyrAp,0.03571428571428571,27,27,GGTACGTAAGGGACCATGGA,0,1768483
gyrAp,0.037037037037037035,26,26,CGTCATCTTGCGGGACCAGC,0,1743593
gyrAp,0.037037037037037035,26,26,CAATCAGGTCAAATTGCTTT,0,1763581
gyrAp,0.037037037037037035,26,26,ACAGACCTTCCAATAGTTAG,0,1744020
gyrAp,0.037037037037037035,26,26,AACGCTTAACGCGTTAATCG,0,1741754
gyrAp,0.038461538461538464,25,25,TCATTAATGTTGCCCTACGT,0,1761690
gyrAp,0.038461538461538464,25,25,TATGCAGGACTTGTTCGGAC,0,1758372
gyrAp,0.038461538461538464,25,25,GATATGGTTTCCGACTGTTT,0,1746998
gyrAp,0.038461538461538464,25,25,CCGCACCTAACCAATGTTCA,0,1749628
gyrAp,0.038461538461538464,25,25,AATTCGAGTGTCCCTAATAG,0,1743497
gyrAp,0.04,24,24,TCCCGATTCATCCGCCTTGC,0,1762947
gyrAp,0.04,24,24,GAATTGCTAGGTTAAGGTGT,0,1742962
gyrAp,0.04,24,24,ATCTGGGTCAGACTGGTAAG,0,1766507
gyrAp,0.04,24,24,ACCGCTCAGTTAAGTTAAAT,0,1742345
gyrAp,0.04,24,24,ACCCGGTGCGCTTATAAGAC,0,1746094
gyrAp,0.04,24,24,AAGCAGACGGCTCCACGAAG,0,1760698
gyrAp,0.041666666666666664,23,23,GTCAGCAACAGGGGAACAAA,0,1754015
gyrAp,0.041666666666666664,23,23,GGGCTGAATGCAAGTCCGAA,0,1744921
gyrAp,0.041666666666666664,23,23,GCTTGAGATTGATGGTTGTC,0,1748456
gyrAp,0.041666666666666664,23,23,GCGCTGGTCAGGATGTACGG,0,1745465
gyrAp,0.041666666666666664,23,23,CTGGTACATGACAAACACTC,0,1755286
gyrAp,0.041666666666666664,23,23,ATGGCCCAGCGAACAAGCCA,0,1764195
gyrAp,0.043478260869565216,22,22,GCGGGAGATATTTCACGAAC,0,1751123
gyrAp,0.043478260869565216,22,22,CCACATGCGACGGTCGCATG,0,1763856
gyrAp,0.043478260869565216,22,22,CATGTCGAAACAGATAATAC,0,1746026
gyrAp,0.043478260869565216,22,22,CAGAAAATGTCAGGTAGTAA,0,1753282
gyrAp,0.043478260869565216,22,22,AGAAAGGGTACTGCCAGTCT,0,1762959
gyrAp,0.043478260869565216,22,22,ACAAGTCCCTTCTGACCATA,0,1741810
gyrAp,0.045454545454545456,21,21,TTCTGGCATATAACAGATGG,0,1743144
gyrAp,0.045454545454545456,21,21,TTAAGACGGATCTGCGATCA,0,1746948
gyrAp,0.045454545454545456,21,21,TGGCGCATACGTGTATCTCG,0,1762957
gyrAp,0.045454545454545456,21,21,TGAAGTTTCTCCCATTAGTG,0,1769678
gyrAp,0.045454545454545456,21,21,TAGCATAAGCTTCTTTTCGT,0,1758596
gyrAp,0.045454545454545456,21,21,GTTCATTGATTGGTTGTCAT,0,1745325
gyrAp,0.045454545454545456,21,21,GTGTGTCGATTCACGAGGCA,0,1749404
gyrAp,0.045454545454545456,21,21,GACGATGGAATGGATCGGAT,0,1748232
gyrAp,0.045454545454545456,21,21,CCTGTAACGCCAGGAGGTTG,0,1747515
gyrAp,0.045454545454545456,21,21,CCATGTCTCCCTAGACTCTT,0,1756006
gyrAp,0.045454545454545456,21,21,CCAAGGCCTACGAGATGTCC,0,1746585
gyrAp,0.045454545454545456,21,21,CAATACGCCTTCAATTCAAT,0,1745886
gyrAp,0.045454545454545456,21,21,CAAGATTAGCCGCCATATCT,0,1754084
gyrAp,0.045454545454545456,21,21,ATGGGAACGATCTTGTTGTG,0,1759025
gyrAp,0.045454545454545456,21,21,AGAGATAATTGATTCCACTC,0,1746969
gyrAp,0.045454545454545456,21,21,ACTTCTAGTTTTCCCTTGGT,0,1759292
gyrAp,0.045454545454545456,21,21,ACTGTTATGCCGGCTCTCCA,0,1748583
gyrAp,0.045454545454545456,21,21,ACTCTACGACAATTATGCCT,0,1744446
gyrAp,0.045454545454545456,21,21,ACCCGTCACCGACATAAGCA,0,1762579
gyrAp,0.045454545454545456,21,21,ACAGGTGTGGATTGTAGTGT,0,1754611
gyrAp,0.047619047619047616,20,20,TGCCGTTTTCAAGGTATAGT,0,1761876
gyrAp,0.047619047619047616,20,20,TCTTTCGCAGCATGAATGCA,0,1746222
gyrAp,0.047619047619047616,20,20,TCATTCGCGTCCTAGAAACG,0,1750723
gyrAp,0.047619047619047616,20,20,TATAATCCGAATGTAAACAC,0,1745454
gyrAp,0.047619047619047616,20,20,TAATATATCGCCATGTAGGG,0,1745051
gyrAp,0.047619047619047616,20,20,GTGACAGTTCCAACAATAGA,0,1749615
gyrAp,0.047619047619047616,20,20,GGTCAGAAAGGACAGCTATC,0,1752268
gyrAp,0.047619047619047616,20,20,GGGCAGGGTTCCTCTGATCA,0,1745184
gyrAp,0.047619047619047616,20,20,GCAGGTGAAGGGGGCGACTG,0,1765785
gyrAp,0.047619047619047616,20,20,GAGCGTGGATTACGCACCGG,0,1760299
gyrAp,0.047619047619047616,20,20,GAAATTGGTCGTCGGACCTT,0,1761499
gyrAp,0.047619047619047616,20,20,CGAAGAGACGCGGGACAAGT,0,1755884
gyrAp,0.047619047619047616,20,20,CCGTACACGTGCGTACTCCA,0,1748074
gyrAp,0.047619047619047616,20,20,CACTCCTAAAGAGCGGCTTG,0,1752041
gyrAp,0.047619047619047616,20,20,ATGGGCTATAAACAGCTCCT,0,1767984
gyrAp,0.047619047619047616,20,20,AGGTGCCTTACGGTACCGTG,0,1769799
gyrAp,0.047619047619047616,20,20,ACGCCACCGCGCGTCGCGCG,0,1752066
gyrAp,0.047619047619047616,20,20,AATTTTAGATAGCCTCGCGT,0,1744751
gyrAp,0.047619047619047616,20,20,AAACCCCCGGAGAGATATGC,0,1754853
gyrAp,0.05,19,19,TGGGTCTCCCTGAGCGGCTC,0,1756445
gyrAp,0.05,19,19,TGATGGGTCGAGGCGGACCC,0,1758283
gyrAp,0.05,19,19,TCTCCAGTACGTACGAACGA,0,1753932
gyrAp,0.05,19,19,TCGTAATACGCATGCTTTGT,0,1742799
gyrAp,0.05,19,19,TCGGGAGATAGTGATAGGAA,0,1753205
gyrAp,0.05,19,19,TACGATGCCACGTACAATGT,0,1741566
gyrAp,0.05,19,19,GTTGGTTCTATTACAGACCT,0,1752552
gyrAp,0.05,19,19,GGGAGCTCTACAATACTACT,0,1742122
gyrAp,0.05,19,19,GATAGCGGCAGCGACTCGTT,0,1750110
gyrAp,0.05,19,19,CGGCGTGGGTCTTCGATACT,0,1744866
gyrAp,0.05,19,19,CAGATCCGCACCTATACTAC,0,1742100
gyrAp,0.05,19,19,CAACTCTAGGTGGAGGCTGA,0,1759047
gyrAp,0.05,19,19,CAACCCCGTTCACTTGTCGT,0,1755750
gyrAp,0.05,19,19,ATGGGTATACCCCTGGGCGT,0,1762447
gyrAp,0.05,19,19,ATGCAAGGTGTAGATCCGCC,0,1763696
gyrAp,0.05,19,19,ATCGGTAATCGGTGCTAGTT,0,1750940
gyrAp,0.05,19,19,ATAGAATTTTGGCGCAAGAC,0,1766731
gyrAp,0.05,19,19,ATACGGGTGGTGGTACAGCT,0,1760657
gyrAp,0.05,19,19,AGGCCCTCGTAATGGCTGTA,0,1751178
gyrAp,0.05,19,19,AGATTAACCCTGACGCGGAA,0,1760211
gyrAp,0.05,19,19,AGAACCGCTAAGCAATTGAT,0,1767288
gyrAp,0.05,19,19,ACGGAGTAGAGTCCTATTCG,0,1767892
gyrAp,0.05,19,19,AAAATCATGTTGGAGATTAA,0,1753284
gyrAp,0.05263157894736842,18,18,TTTTTCGAAGGACCTGTGCT,0,1753988
gyrAp,0.05263157894736842,18,18,TTAACGCGGAGGACATCCAA,0,1742605
gyrAp,0.05263157894736842,18,18,TGGCCCCCGGCGTAGCACAC,0,1749681
gyrAp,0.05263157894736842,18,18,GTAGGCATCCCGTTTGGAAT,0,1759612
gyrAp,0.05263157894736842,18,18,GGTTTACAATTACTGTCTGT,0,1745050
gyrAp,0.05263157894736842,18,18,GCTGGGAGTCTCGCCGCGAA,0,1750197
gyrAp,0.05263157894736842,18,18,GCCGCTCTTCAATAAACCAG,0,1757305
gyrAp,0.05263157894736842,18,18,CTTCTACGGTTTCGGTGTGA,0,1744540
gyrAp,0.05263157894736842,18,18,CGCCCGTACAATCAGCTCAA,0,1745360
gyrAp,0.05263157894736842,18,18,CATATCGCGTCACACGCTAG,0,1759858
gyrAp,0.05263157894736842,18,18,CAGGAATGTGTACGAGATGG,0,1759912
gyrAp,0.05263157894736842,18,18,CAAGGGCCGTCTGTTTTAAT,0,1742154
gyrAp,0.05263157894736842,18,18,ATTCTTGCTGCGAAACCTCA,0,1749164
gyrAp,0.05263157894736842,18,18,ATGGCCACTTTTGGATTAGG,0,1765776
gyrAp,0.05263157894736842,18,18,ATAACAAACCACGAGCCGCC,0,1758489
gyrAp,0.05263157894736842,18,18,AGAATCGTTCCACGATGTAT,0,1768053
gyrAp,0.05263157894736842,18,18,ACATCCTTGACCTTTCGCCA,0,1767097
gyrAp,0.05263157894736842,18,18,AAGTCCTAAAACTCCGCCAC,0,1764055
gyrAp,0.05555555555555555,17,17,TTATACCTGTTGCCAAGGAC,0,1757911
gyrAp,0.05555555555555555,17,17,TGGCTTCGAACAACGCTCGG,0,1757948
gyrAp,0.05555555555555555,17,17,TGAGTAATGTCCTCGCGTAA,0,1748262
gyrAp,0.05555555555555555,17,17,TCGCAGCGACGACCAAGCAG,0,1747338
gyrAp,0.05555555555555555,17,17,TAGAAGTTCCAGTGTCTCGC,0,1769882
gyrAp,0.05555555555555555,17,17,GTCCATCTTAGTCTGAGCGA,0,1747091
gyrAp,0.05555555555555555,17,17,GTCAGCGATACTCCCCCGAC,0,1749753
gyrAp,0.05555555555555555,17,17,GTAAGTGAGCTGTATGTTAA,0,1761098
gyrAp,0.05555555555555555,17,17,GGTTATACACGGGGGGGGTG,0,1754595
gyrAp,0.05555555555555555,17,17,GCTTATACCGTAGGCCGGAT,0,1743024
gyrAp,0.05555555555555555,17,17,GCGTACAAGGTAGCTTTCTC,0,1770011
gyrAp,0.05555555555555555,17,17,GCCATAAGTTCTGCCAAACT,0,1768178
gyrAp,0.05555555555555555,17,17,GATCGCTCGCGTGAAGAGTC,0,1764920
gyrAp,0.05555555555555555,17,17,GACTTTTTCAGTCGCCCCAA,0,1747193
gyrAp,0.05555555555555555,17,17,GACTACGTTGCCAGGTTACA,0,1744216
gyrAp,0.05555555555555555,17,17,CCGCAACACGGTCACCAACT,0,1746869
gyrAp,0.05555555555555555,17,17,CATGTCACATCGGAGATCCG,0,1746680
gyrAp,0.05555555555555555,17,17,CAGTTACAATTAATCACCTC,0,1747805
gyrAp,0.05555555555555555,17,17,ATCAATAGGGCTCCTCCTCG,0,1753176
gyrAp,0.05555555555555555,17,17,AAAGAGGGGCGGGGCCACGA,0,1741496
gyrAp,0.058823529411764705,16,16,TTGTATGGGAGTGTAAACAA,0,1763854
gyrAp,0.058823529411764705,16,16,TTCGAGTATGCAGATACAAT,0,1764552
gyrAp,0.058823529411764705,16,16,TGACTAACAGATGGATCGGT,0,1764994
gyrAp,0.058823529411764705,16,16,TCTCAGCTACACAAGAAAAA,0,1767693
gyrAp,0.058823529411764705,16,16,TCGTTCTTAGTATGTGCTAA,0,1741993
gyrAp,0.058823529411764705,16,16,TATCCTATGGACCCGTAAGA,0,1750765
gyrAp,0.058823529411764705,16,16,TATACAGCACAGCAGAAAGC,0,1755737
gyrAp,0.058823529411764705,16,16,GTTCTATTGCAGCGTCAAAT,0,1757372
gyrAp,0.058823529411764705,16,16,GTTAACACGCACTTTAGTTG,0,1756003
gyrAp,0.058823529411764705,16,16,GGTCCCACGCGGAGAATTAA,0,1752488
gyrAp,0.058823529411764705,16,16,GGTATACATGCCCATTGCTT,0,1767417
gyrAp,0.058823529411764705,16,16,GGATGCTGCATGTCTGATAC,0,1764826
gyrAp,0.058823529411764705,16,16,GCTTTAGTTAGGACGGAAAA,0,1755650
gyrAp,0.058823529411764705,16,16,GCTGTAACCCGTACTCGAAA,0,1756198
gyrAp,0.058823529411764705,16,16,GCCTGAGTCACGCTAACGGC,0,1749692
gyrAp,0.058823529411764705,16,16,GCAACTTTGCCTCGGGAATC,0,1770142
gyrAp,0.058823529411764705,16,16,GATTGCGACTACAGGAATCA,0,1756002
gyrAp,0.058823529411764705,16,16,GAGGTCTCCGCAGAAAGGCT,0,1747554
gyrAp,0.058823529411764705,16,16,GAACGCGAGGACTGATTTTA,0,1744577
gyrAp,0.058823529411764705,16,16,CTTGGAGTTCAGGAGGCACG,0,1758811
gyrAp,0.058823529411764705,16,16,CTGGATCAGACAGGTTGGGG,0,1755630
gyrAp,0.058823529411764705,16,16,CGCGTCGTGCACTAATCATT,0,1753600
gyrAp,0.058823529411764705,16,16,CCAGCTATTGAGTCTAGGAA,0,1744909
gyrAp,0.058823529411764705,16,16,CATCTTCGCGCGGGGGAAAT,0,1757915
gyrAp,0.058823529411764705,16,16,CATCCGCGGTAAGACTTGCT,0,1756650
gyrAp,0.058823529411764705,16,16,CACCATTCCGTAATGTCAGC,0,1745006
gyrAp,0.058823529411764705,16,16,CAAATCTGGAGTATCGTCAA,0,1763330
gyrAp,0.058823529411764705,16,16,ATTCACGGACCCATGTTTAA,0,1742183
gyrAp,0.058823529411764705,16,16,ATCTTTAGAGCTAAGCCGTC,0,1745783
gyrAp,0.058823529411764705,16,16,AGTGTTAGTATTTCAACGTA,0,1743054
gyrAp,0.058823529411764705,16,16,AGGGTCTCTGCCGAAAGCAA,0,1745891
gyrAp,0.058823529411764705,16,16,AGGCTGCCTATGAATGCTAC,0,1768625
gyrAp,0.058823529411764705,16,16,AGCTGTGGTGCGCGTATGCC,0,1767687
gyrAp,0.058823529411764705,16,16,ACGGATCTCAACGTTTTTGA,0,1741490
gyrAp,0.058823529411764705,16,16,ACCACTGGACCACACGCGAG,0,1748657
gyrAp,0.058823529411764705,16,16,AAGATACGCGTTTAAGCAGT,0,1745307
gyrAp,0.058823529411764705,16,16,AAAGGGAAGTCATTACCCGC,0,1745661
gyrAp,0.0625,15,15,TTGTTTCCGCAGGGATTCGG,0,1769277
gyrAp,0.0625,15,15,TTCCTGAGCTATTCCATATC,0,1759186
gyrAp,0.0625,15,15,TTCCGTACCCGGAGGACTCA,0,1746331
gyrAp,0.0625,15,15,TGGCTAATATATCAAGGTTT,0,1752959
gyrAp,0.0625,15,15,TCCTGACAGAATGGCACACA,0,1759980
gyrAp,0.0625,15,15,TCCCGATATATGTTTTGGAT,0,1756636
gyrAp,0.0625,15,15,TCACGAACTATTGGGTGGCT,0,1742862
gyrAp,0.0625,15,15,TAGCCTAACACTGGTCTCGC,0,1743334
gyrAp,0.0625,15,15,TAATAGGGGCCTAGACCGGT,0,1749997
gyrAp,0.0625,15,15,TAAATTTTACAAGATTTGGC,0,1770523
gyrAp,0.0625,15,15,GTTGAATATAACGAGCCACT,0,1750075
gyrAp,0.0625,15,15,GTACCGTGACAAGGCCTGTC,0,1759544
gyrAp,0.0625,15,15,GGTTAAAACTACGCCGTGGC,0,1753033
gyrAp,0.0625,15,15,GGGGCCTAAGGTAAGAAGAA,0,1758213
gyrAp,0.0625,15,15,GCCGCACTTTATTATGAGGG,0,1752726
gyrAp,0.0625,15,15,GAGCGGACAGGGCGCTTTGA,0,1746192
gyrAp,0.0625,15,15,GACATTTATCCCATTAGCCA,0,1746749
gyrAp,0.0625,15,15,GAAGTGTTTGCAGCCGGGCA,0,1759030
gyrAp,0.0625,15,15,GAACTGGTGCCGACTGGGTA,0,1757277
gyrAp,0.0625,15,15,CTGTGTCAAAAGGGAATCAA,0,1769057
gyrAp,0.0625,15,15,CTGGCACGGTTTTTGCCCAT,0,1743075
gyrAp,0.0625,15,15,CTGCCGACGTGCATTTCGCA,0,1752275
gyrAp,0.0625,15,15,CTCCTGATCGTGACGGATGT,0,1750498
gyrAp,0.0625,15,15,CTCACCAATCATGGTTGTGC,0,1766688
gyrAp,0.0625,15,15,CTATCGGCGGGCTTTAGTTT,0,1757967
gyrAp,0.0625,15,15,CGCGCAAATAGCCCTTCTGA,0,1763510
gyrAp,0.0625,15,15,CGCCCGTCCAACAGCGAGCC,0,1745156
gyrAp,0.0625,15,15,CGAGTCCAGGGCATTAAACT,0,1756082
gyrAp,0.0625,15,15,CCTATAGTATATACATCTGG,0,1768753
gyrAp,0.0625,15,15,CCGATGCGACAGTCGTGCGA,0,1762576
gyrAp,0.0625,15,15,CCAGGGGGACTGGATAAACT,0,1743663
gyrAp,0.0625,15,15,CAAGAGCTTTCACGAAATTG,0,1749218
gyrAp,0.0625,15,15,CAACCAAGCACTTGCTGTTG,0,1760903
gyrAp,0.0625,15,15,ATTATACTCGTTCTTAAAGA,0,1746983
gyrAp,0.0625,15,15,ATGTACATGGTCACCAGGTG,0,1746272
gyrAp,0.0625,15,15,ATAGGAGCTAAATCTTACAT,0,1745032
gyrAp,0.0625,15,15,AGTAATCTAATCAAATCTTC,0,1746632
gyrAp,0.0625,15,15,AGACGGTTGGAAACCCGGAC,0,1742679
gyrAp,0.0625,15,15,ACTCACTAGCCTTACGTCTG,0,1746913
gyrAp,0.0625,15,15,ACTAACAAGGCGATAGAGGG,0,1750762
gyrAp,0.0625,15,15,AATTCACGAGGGGATGGACA,0,1752711
gyrAp,0.0625,15,15,AATAGACGACGTTCGTAAAG,0,1764405
gyrAp,0.0625,15,15,AAGGAAATCAAGATTTGAAT,0,1747813
gyrAp,0.06666666666666667,14,14,TTTTCACTATGTAAGAGCAT,0,1747079
gyrAp,0.06666666666666667,14,14,TTTAGTGAGAAGGTTGATTG,0,1751546
gyrAp,0.06666666666666667,14,14,TTGGACTCTGAGGACGAACA,0,1764275
gyrAp,0.06666666666666667,14,14,TTGAAGGCTCGAACGCTGAC,0,1768843
gyrAp,0.06666666666666667,14,14,TTCCATCGTAGACCGGCGCA,0,1745985
gyrAp,0.06666666666666667,14,14,TGTGCCATCGTACGTAATGT,0,1757752
gyrAp,0.06666666666666667,14,14,TGTGACATATATGCATGGAA,0,1766242
gyrAp,0.06666666666666667,14,14,TGGTTCCCAATTTTTGAGGA,0,1769354
gyrAp,0.06666666666666667,14,14,TCTGGTACTGGATCGGGGCG,0,1766920
gyrAp,0.06666666666666667,14,14,TCACTGTAAAGGTGCGCGAA,0,1750933
gyrAp,0.06666666666666667,14,14,GTTAACAGATGCGTTAACAA,0,1752071
gyrAp,0.06666666666666667,14,14,GTGGTTATGTTGGCATATTC,0,1745327
gyrAp,0.06666666666666667,14,14,GTCAACCTTATGACCTCACG,0,1752980
gyrAp,0.06666666666666667,14,14,GGGGGTCGGAAACACAAAGG,0,1743386
gyrAp,0.06666666666666667,14,14,GGCTAGCGAATTAGCACGAC,0,1770798
gyrAp,0.06666666666666667,14,14,GGCCGTCTGGTTGACGAAAG,0,1747966
gyrAp,0.06666666666666667,14,14,GGAGTGGAATTTAGCAACTC,0,1745651
gyrAp,0.06666666666666667,14,14,GGAGCGAGTGGATTCTCCTA,0,1757646
gyrAp,0.06666666666666667,14,14,GCGTATTAGGCTTATAGTCT,0,1742923
gyrAp,0.06666666666666667,14,14,GCATTTACGAGGTGTCTAAT,0,1757816
gyrAp,0.06666666666666667,14,14,GCAGCTCGTAGGGGTCAGAC,0,1768154
gyrAp,0.06666666666666667,14,14,GAGTATTAGAGACGGGCCAC,0,1751491
gyrAp,0.06666666666666667,14,14,GACTTTCTCGGTTTGTGTGC,0,1748891
gyrAp,0.06666666666666667,14,14,CTGCCGTGTCCCCATGCGAC,0,1747253
gyrAp,0.06666666666666667,14,14,CGTAGCAATATATTTTGAAA,0,1744752
gyrAp,0.06666666666666667,14,14,CGGCATCTCCAGGTGTTATT,0,1748215
gyrAp,0.06666666666666667,14,14,CGGAAGCCTGGCCTTAGAGG,0,1751205
gyrAp,0.06666666666666667,14,14,CCGCTGACAGCTAAAAAAAA,0,1750961
gyrAp,0.06666666666666667,14,14,CCCGGGTCGTGCTAACTTCA,0,1747025
gyrAp,0.06666666666666667,14,14,CCAGCTGAGCACATCACTTA,0,1751556
gyrAp,0.06666666666666667,14,14,CATGAAAGGGTAGTACCAGT,0,1757377
gyrAp,0.06666666666666667,14,14,CATAGTCCGCACCGGGGGCA,0,1759187
gyrAp,0.06666666666666667,14,14,CACGGCTTGGACCGGCAAGA,0,1745741
gyrAp,0.06666666666666667,14,14,CAAGTTAGGCACGTATGCTG,0,1763794
gyrAp,0.06666666666666667,14,14,ATTGAATTTTCTCGTCGAAG,0,1765386
gyrAp,0.06666666666666667,14,14,AGTGAGTAGGCGTCAGCGAT,0,1764683
gyrAp,0.06666666666666667,14,14,AGTCCGGCGTCGATGTCACC,0,1748138
gyrAp,0.06666666666666667,14,14,AGGCGGGGGAAAGGACCAAC,0,1758417
gyrAp,0.06666666666666667,14,14,AGCCCGTTGACTTTATATGC,0,1762627
gyrAp,0.06666666666666667,14,14,ACGTTTAATGTTCAGCCCGC,0,1755163
gyrAp,0.06666666666666667,14,14,ACCTCGTCGTCAGTCTTATT,0,1755701
gyrAp,0.06666666666666667,14,14,ACCCCGCGTTATTGAGTGGC,0,1762040
gyrAp,0.06666666666666667,14,14,ACATAGTGATATCACTGCAT,0,1759542
gyrAp,0.06666666666666667,14,14,ACAGATAACCAGAAAGGGTC,0,1741778
gyrAp,0.06666666666666667,14,14,AATGGCTGTATTAAATGTGC,0,1750401
gyrAp,0.06666666666666667,14,14,AAGTCATGTGGGTGGCTCTG,0,1742780
gyrAp,0.06666666666666667,14,14,AAGGTGTGAGCGACATACGT,0,1744608
gyrAp,0.06666666666666667,14,14,AACTTCAGGCAGTTCATCGT,0,1768216
gyrAp,0.06666666666666667,14,14,AACCGACGGTGGGAATGATG,0,1752721
gyrAp,0.06666666666666667,14,14,AAATGCCGATCCGTGGATAT,0,1764479
gyrAp,0.07142857142857142,13,13,TTATGGACGGATGGAGGTCA,0,1756884
gyrAp,0.07142857142857142,13,13,TGGGCTGCGAATAGAGCACG,0,1760833
gyrAp,0.07142857142857142,13,13,TGAGGGCCTTTCCATCGAGG,0,1757644
gyrAp,0.07142857142857142,13,13,TGAGCAAGGGAGCGGTTCGA,0,1761479
gyrAp,0.07142857142857142,13,13,TCTCTCCCTGGAATTTCTTA,0,1757041
gyrAp,0.07142857142857142,13,13,TCGTGAAGGCTAGGCTTGGC,0,1760048
gyrAp,0.07142857142857142,13,13,TCAAAGCACAATTTCTTCGA,0,1764741
gyrAp,0.07142857142857142,13,13,TAGCCGACGTCAGGGGCGCA,0,1761703
gyrAp,0.07142857142857142,13,13,TACGGCGGCGTTTTTGAAGC,0,1741492
gyrAp,0.07142857142857142,13,13,TACCGCGTATCCGTTGACGA,0,1750413
gyrAp,0.07142857142857142,13,13,TAATCTGCGTTCAAGTATGC,0,1746349
gyrAp,0.07142857142857142,13,13,TAACCGTGGTACTGTAAAGT,0,1745408
gyrAp,0.07142857142857142,13,13,GTGGCACGGGTGTCCAAAAC,0,1746477
gyrAp,0.07142857142857142,13,13,GTCTCGTGTTAAGCCGGTAC,0,1742676
gyrAp,0.07142857142857142,13,13,GTAGCTCTTAATTGACGGGA,0,1764116
gyrAp,0.07142857142857142,13,13,GGTACCCTCGTGGGTTTATT,0,1743294
gyrAp,0.07142857142857142,13,13,GGGGTTTAACGAAGGTATAA,0,1745634
gyrAp,0.07142857142857142,13,13,GGGGTCAGCTAGGCATGCGT,0,1764522
gyrAp,0.07142857142857142,13,13,GGATGATAGGGCAAGCAATA,0,1754859
gyrAp,0.07142857142857142,13,13,GGATAACATTTCTGTCGGTC,0,1742569
gyrAp,0.07142857142857142,13,13,GGACCCAGACTCCCACGATG,0,1758196
gyrAp,0.07142857142857142,13,13,GCCCCCTGAATAAGGCACAT,0,1744213
gyrAp,0.07142857142857142,13,13,GCAACCTAGTAGTTCGAGTT,0,1742043
gyrAp,0.07142857142857142,13,13,GATGGCTGTGGAAATCCAAG,0,1752055
gyrAp,0.07142857142857142,13,13,CTGGGAGCCCTCTTTGATAG,0,1754860
gyrAp,0.07142857142857142,13,13,CTACGCGCCTATGTACAAAG,0,1748904
gyrAp,0.07142857142857142,13,13,CGTGTGGAGAATGTGAATGC,0,1755889
gyrAp,0.07142857142857142,13,13,CGTGTCATTGCGTGCTGGCC,0,1769416
gyrAp,0.07142857142857142,13,13,CGCCTCCCAACCTGAGTATG,0,1758416
gyrAp,0.07142857142857142,13,13,CCTATAAAGTAAGTGTCCAC,0,1742137
gyrAp,0.07142857142857142,13,13,CCGCGGTTGAGCCAAATGTA,0,1754390
gyrAp,0.07142857142857142,13,13,CCCCCGGCTGAGGTACTGTC,0,1741799
gyrAp,0.07142857142857142,13,13,CCATATGGCCTGTACGCTGG,0,1746011
gyrAp,0.07142857142857142,13,13,CATACGAACGCATAGGGGTC,0,1750839
gyrAp,0.07142857142857142,13,13,CAGTTGCTCAACGCGTATGG,0,1743004
gyrAp,0.07142857142857142,13,13,CAGGGTCCTAGGTCTCAACT,0,1743498
gyrAp,0.07142857142857142,13,13,CAGAACCCGGGCCACGGTTA,0,1751920
gyrAp,0.07142857142857142,13,13,ATTTTGGTGGTTTTCAGCCT,0,1742967
gyrAp,0.07142857142857142,13,13,ATGTTTCGCGTTCGGGGAGC,0,1742505
gyrAp,0.07142857142857142,13,13,ATGTTTCACACTCTATTGGT,0,1747814
gyrAp,0.07142857142857142,13,13,ATCCGGACTCGAAGGGCGAG,0,1754040
gyrAp,0.07142857142857142,13,13,ATCCACCTAATCAAGGCAAG,0,1744883
gyrAp,0.07142857142857142,13,13,ATCAATGACAGTGAAGCATA,0,1769320
gyrAp,0.07142857142857142,13,13,ATATGCGATCACCCGTGCCA,0,1761919
gyrAp,0.07142857142857142,13,13,ATAGGCCCGTATAATTAGCT,0,1767278
gyrAp,0.07142857142857142,13,13,AGTGGGTGCCGGTAAGCGGG,0,1761163
gyrAp,0.07142857142857142,13,13,AGTCCTCAGGTCCTAACGTG,0,1761017
gyrAp,0.07142857142857142,13,13,AGGCTTGACTCCCGTGCGGG,0,1758786
gyrAp,0.07142857142857142,13,13,AGCGTGTCGTTCCTATAATA,0,1767053
gyrAp,0.07142857142857142,13,13,ACTCCATTGCTTCTTGTCTC,0,1753333
gyrAp,0.07142857142857142,13,13,ACAACCGCAGAGATGCTGAA,0,1765158
gyrAp,0.07142857142857142,13,13,AATAAGGTTGCACCGGTCAT,0,1747785
gyrAp,0.07142857142857142,13,13,AAGTTTGTGGACATGCGGCA,0,1766995
gyrAp,0.07142857142857142,13,13,AAGCGTAATACACTTTGTCT,0,1753682
gyrAp,0.07142857142857142,13,13,AAGAGGTAAGCGCATGAGTC,0,1769861
gyrAp,0.07142857142857142,13,13,AACGTAGGCAAGGGAAGGGT,0,1749389
gyrAp,0.07142857142857142,13,13,AAATGCGAGGCCACTGGCTG,0,1758031
gyrAp,0.07142857142857142,13,13,AAACATTGGGTTGCCAGTAC,0,1761688
gyrAp,0.07142857142857142,13,13,AAAATTGCATCTGTCCCACT,0,1763727
gyrAp,0.07692307692307693,12,12,TTTTGGAATTGTTCAAGTGA,0,1765534
gyrAp,0.07692307692307693,12,12,TTTGTGAGATCGATAAACAG,0,1757012
gyrAp,0.07692307692307693,12,12,TTTGGACGAAAGCATACGAA,0,1764590
gyrAp,0.07692307692307693,12,12,TTTCGACTAGCAGATAAGAA,0,1765654
gyrAp,0.07692307692307693,12,12,TTGTACGCGGCCTTGACCCG,0,1747191
gyrAp,0.07692307692307693,12,12,TTGGGGCAGGGGGGCGCAAA,0,1760218
gyrAp,0.07692307692307693,12,12,TTGCTTGTGGCGACCGGCAG,0,1760151
gyrAp,0.07692307692307693,12,12,TTCTGATGTGACTTCCGACA,0,1741655
gyrAp,0.07692307692307693,12,12,TTATGGCTGGACATGCGAAA,0,1743532
gyrAp,0.07692307692307693,12,12,TGTAGTCCGGAAGCGTATGG,0,1747503
gyrAp,0.07692307692307693,12,12,TGTAGTCCAAGCCGGAAGAC,0,1760932
gyrAp,0.07692307692307693,12,12,TGGTTAGTTGATGGGCGCGG,0,1757416
gyrAp,0.07692307692307693,12,12,TGGCCCATTAAGCTAGTTCC,0,1767946
gyrAp,0.07692307692307693,12,12,TGAGAGGAACAGAATAAGTA,0,1757046
gyrAp,0.07692307692307693,12,12,TGACTCACGGATAATAACTT,0,1759014
gyrAp,0.07692307692307693,12,12,TCTGGGTTCACTTAAGAGCT,0,1754699
gyrAp,0.07692307692307693,12,12,TCGTAATTAAGGTATAATCG,0,1755191
gyrAp,0.07692307692307693,12,12,TCGCCCCCCCGTTTCATAAC,0,1742942
gyrAp,0.07692307692307693,12,12,TCCTCCCGCGCCTCCACAAT,0,1757071
gyrAp,0.07692307692307693,12,12,TCCAAGAGGGGCACGTCAAC,0,1768379
gyrAp,0.07692307692307693,12,12,TATTTAAAAGGGTTATGAGA,0,1763564
gyrAp,0.07692307692307693,12,12,TATTGCCCTGCTGCGTAAAT,0,1762331
gyrAp,0.07692307692307693,12,12,TAGCGCCTTTGTCCGCAGGG,0,1762713
gyrAp,0.07692307692307693,12,12,TACCTTATGGTAGGTCACGG,0,1749910
gyrAp,0.07692307692307693,12,12,TAACAATTAACTACGCAAAG,0,1744398
gyrAp,0.07692307692307693,12,12,TAAAAATGGGGGGCTGTTGG,0,1763582
gyrAp,0.07692307692307693,12,12,GTCGAACGGCTTTCTTTTAG,0,1767764
gyrAp,0.07692307692307693,12,12,GTAGGCGCGAAACATCATGC,0,1758490
gyrAp,0.07692307692307693,12,12,GTACTCCGTTAGGTGACAAA,0,1752086
gyrAp,0.07692307692307693,12,12,GGTTGTCCGACCTACCAGGC,0,1754268
gyrAp,0.07692307692307693,12,12,GGGTGTAAGGCGAAGCGATG,0,1748709
gyrAp,0.07692307692307693,12,12,GGGCCATGGCGTCGCACCTA,0,1757059
gyrAp,0.07692307692307693,12,12,GGCAAACATAATCCCATTTC,0,1749120
gyrAp,0.07692307692307693,12,12,GCTCACACTTGCAACGCTGT,0,1753134
gyrAp,0.07692307692307693,12,12,GCGTCGAGGCAGTCTCTTCT,0,1765069
gyrAp,0.07692307692307693,12,12,GCCCCTCTCGCTCCGATTCT,0,1744876
gyrAp,0.07692307692307693,12,12,GCACGACAATGGGTCAGGTA,0,1754207
gyrAp,0.07692307692307693,12,12,GATCTGATCGTACACCGCAA,0,1744808
gyrAp,0.07692307692307693,12,12,GATATACCTCGGTGATGCTA,0,1764306
gyrAp,0.07692307692307693,12,12,GAGAGATTTGTGATAGACAC,0,1743030
gyrAp,0.07692307692307693,12,12,GAAGGACGTTATAGGGGAAC,0,1764466
gyrAp,0.07692307692307693,12,12,GAAACGGTGTGTCACCACGG,0,1760335
gyrAp,0.07692307692307693,12,12,CTGGTTGAGAAAGTCCTGGT,0,1745038
gyrAp,0.07692307692307693,12,12,CTGGGCAAGCAGAGGTCCGT,0,1742526
gyrAp,0.07692307692307693,12,12,CTGCACATGGGGGGACGCTT,0,1764126
gyrAp,0.07692307692307693,12,12,CTATTCCGGAATGGGCCTCC,0,1753147
gyrAp,0.07692307692307693,12,12,CTAGATTCGGTTTGCGGGGG,0,1764779
gyrAp,0.07692307692307693,12,12,CGGCCTTTCAGTCGCGCGAT,0,1750376
gyrAp,0.07692307692307693,12,12,CGGAGGAGATTCCCCCCTGC,0,1766510
gyrAp,0.07692307692307693,12,12,CGCTGTTTTCTTAACAAACG,0,1753663
gyrAp,0.07692307692307693,12,12,CGCATGGAGGGGGACCAATA,0,1747774
gyrAp,0.07692307692307693,12,12,CGAGCACATTTTGTGCGGAC,0,1766812
gyrAp,0.07692307692307693,12,12,CCTCGCTCGTTCTATCTCCG,0,1767360
gyrAp,0.07692307692307693,12,12,CCCGCGCGTGAGGGCATGGA,0,1759322
gyrAp,0.07692307692307693,12,12,CCATCGTTCACGATAATCGG,0,1749169
gyrAp,0.07692307692307693,12,12,CATTGTGACAGAGGGACTAT,0,1749710
gyrAp,0.07692307692307693,12,12,CATTATCAGCTGCAGGATCG,0,1752977
gyrAp,0.07692307692307693,12,12,CATTACTTGCATCACATAAA,0,1757632
gyrAp,0.07692307692307693,12,12,CATGGTTCCATGGGCCTCTA,0,1763825
gyrAp,0.07692307692307693,12,12,CACGAGTACGCCGTGGCACA,0,1749221
gyrAp,0.07692307692307693,12,12,ATTCTTTGAGCATATGAATT,0,1746874
gyrAp,0.07692307692307693,12,12,ATGTGTACCGTTTTGATCTA,0,1742158
gyrAp,0.07692307692307693,12,12,ATCCGAAGTCCGTTGGGTTT,0,1754442
gyrAp,0.07692307692307693,12,12,AGTAGTCGAAGGGTTAGGCG,0,1744144
gyrAp,0.07692307692307693,12,12,AGGTCACCGCCAGCTGGATT,0,1769093
gyrAp,0.07692307692307693,12,12,AGGCGAGAGACCACATCGAG,0,1746143
gyrAp,0.07692307692307693,12,12,AGCCCTCCGTCGGATCCTGA,0,1749091
gyrAp,0.07692307692307693,12,12,AGAATAAAATAAATATTTTC,0,1746914
gyrAp,0.07692307692307693,12,12,ACGACTTAGATTTTCATAGT,0,1768663
gyrAp,0.07692307692307693,12,12,AAGTGGGATGGTGACCTCAA,0,1769983
gyrAp,0.07692307692307693,12,12,AAGGCATGTACGTCGATTAG,0,1751954
gyrAp,0.07692307692307693,12,12,AACTGCATCCCGCGGGGATT,0,1757360
gyrAp,0.07692307692307693,12,12,AACGAAAAGAGCGGGGATTA,0,1767165
gyrAp,0.08333333333333333,11,11,TTTTGTTCTCTCTGTAGTCC,0,1767559
gyrAp,0.08333333333333333,11,11,TTTGGAGCCCACCACCTGGT,0,1749754
gyrAp,0.08333333333333333,11,11,TTGGTGTACAATAGCACTTA,0,1765385
gyrAp,0.08333333333333333,11,11,TTGCTTTCGCTTGTGAGGCG,0,1746711
gyrAp,0.08333333333333333,11,11,TTCGTGTAGAAGCAGCGCGC,0,1754728
gyrAp,0.08333333333333333,11,11,TTCGTCGTTTTATGAAGCAT,0,1753178
gyrAp,0.08333333333333333,11,11,TTCAAACCCAGGTGGTCGAT,0,1754470
gyrAp,0.08333333333333333,11,11,TTACTCGGGTAGGACGACAT,0,1757650
gyrAp,0.08333333333333333,11,11,TTACGTAAGCGATGTTGTCA,0,1764043
gyrAp,0.08333333333333333,11,11,TTACATCGCGGCTCTTAAGG,0,1755224
gyrAp,0.08333333333333333,11,11,TGTCGCATCATTTCCGGCAG,0,1763832
gyrAp,0.08333333333333333,11,11,TGGGCGCGGAAATAGCACAT,0,1766065
gyrAp,0.08333333333333333,11,11,TGGCTGGCCAGATTCCAATG,0,1748679
gyrAp,0.08333333333333333,11,11,TGGCAGCACAGGACTCTTGC,0,1755645
gyrAp,0.08333333333333333,11,11,TGGAGTTGGGGGGTATTAGC,0,1751644
gyrAp,0.08333333333333333,11,11,TGCTAGGGGACTCCCATCAG,0,1746002
gyrAp,0.08333333333333333,11,11,TGCGTAACACCCTAGATGAT,0,1745664
gyrAp,0.08333333333333333,11,11,TGCGCTTCATGAAGATACGC,0,1761796
gyrAp,0.08333333333333333,11,11,TGACAGGGGGGGGGGTAGGT,0,1744556
gyrAp,0.08333333333333333,11,11,TCTTTGGTAGGATACAACCT,0,1765779
gyrAp,0.08333333333333333,11,11,TCTTAGCACCCTCAGTCGGT,0,1750076
gyrAp,0.08333333333333333,11,11,TCTCTTGGCCCACGTTTGGA,0,1759280
gyrAp,0.08333333333333333,11,11,TCGCTTGGACTACAATTGTA,0,1742660
gyrAp,0.08333333333333333,11,11,TCGCTCAGATTTTGCCAGCC,0,1746287
gyrAp,0.08333333333333333,11,11,TCGCGTAGCCTTGAGGATCC,0,1751973
gyrAp,0.08333333333333333,11,11,TCCTGTGGACGACTGGGCAT,0,1758451
gyrAp,0.08333333333333333,11,11,TCCGCAGTTTACTCCGCTAT,0,1765669
gyrAp,0.08333333333333333,11,11,TCACCCAGTGAACAGGTTCC,0,1759899
gyrAp,0.08333333333333333,11,11,TATACGGTTCGCCGAAGCAA,0,1752022
gyrAp,0.08333333333333333,11,11,TATAAGAGCGCGGACCGTCC,0,1745855
gyrAp,0.08333333333333333,11,11,TAGGATTCTGGCATTGAGCC,0,1750684
gyrAp,0.08333333333333333,11,11,TACGTAACTTCAGCAGTTAG,0,1753683
gyrAp,0.08333333333333333,11,11,TACAGCAGGTGCGGACCTGG,0,1756760
gyrAp,0.08333333333333333,11,11,TAACCAAGAACGCTTTCAGA,0,1745101
gyrAp,0.08333333333333333,11,11,GTTTACACCGAAAAGTCGAG,0,1769980
gyrAp,0.08333333333333333,11,11,GTTATATTCCATGCCCGGCA,0,1746446
gyrAp,0.08333333333333333,11,11,GTGACCTCTGGTATAAAACA,0,1753073
gyrAp,0.08333333333333333,11,11,GTGAATGAAGTGTTAGTGCT,0,1746615
gyrAp,0.08333333333333333,11,11,GTCGGAGGTAGTTCGGGCTA,0,1743450
gyrAp,0.08333333333333333,11,11,GTAGAGCTACGGTCCGCTAC,0,1743549
gyrAp,0.08333333333333333,11,11,GGTGAGACTAGACGTCGATC,0,1751396
gyrAp,0.08333333333333333,11,11,GGTCGTTCCCGTAGTGCAAG,0,1758716
gyrAp,0.08333333333333333,11,11,GGGAACGAGTAGGTTCTATA,0,1768567
gyrAp,0.08333333333333333,11,11,GGCCAGAATACGTCAGGGTG,0,1756160
gyrAp,0.08333333333333333,11,11,GGATCCCCTTCAAGTCGGCT,0,1748997
gyrAp,0.08333333333333333,11,11,GGAGTTTGCGACCGGCGGTG,0,1746492
gyrAp,0.08333333333333333,11,11,GGAAGTGGTGCAGCTCAATA,0,1754526
gyrAp,0.08333333333333333,11,11,GCTTTTATGCGAAGTGCGGC,0,1753892
gyrAp,0.08333333333333333,11,11,GCTGTAAAGTGATGTAACGA,0,1754941
gyrAp,0.08333333333333333,11,11,GCTCCAAAATGTACTAAGGC,0,1770267
gyrAp,0.08333333333333333,11,11,GCGTCCATCAGCTGGAGGAT,0,1746014
gyrAp,0.08333333333333333,11,11,GCGACCGAGCGGGTTAACCA,0,1768749
gyrAp,0.08333333333333333,11,11,GCATGCGTCAGGATCACATA,0,1762825
gyrAp,0.08333333333333333,11,11,GCATACTCGGGTGCACGTGA,0,1768583
gyrAp,0.08333333333333333,11,11,GATCGTTAGTATTCCGTGCG,0,1753042
gyrAp,0.08333333333333333,11,11,GATCATGAGGTACTGAATAC,0,1751236
gyrAp,0.08333333333333333,11,11,GATCATATTAGTACCGGAAT,0,1748673
gyrAp,0.08333333333333333,11,11,GATACCTCGACGCCTTGCCC,0,1758225
gyrAp,0.08333333333333333,11,11,GAGCATTGAACTGGCGCACG,0,1754340
gyrAp,0.08333333333333333,11,11,GACTAGACTGGTGTCTAGCA,0,1753676
gyrAp,0.08333333333333333,11,11,GACGAACCGATATTTGCCTA,0,1752596
gyrAp,0.08333333333333333,11,11,CTTGTCTCCGGAGGGGAGTT,0,1753092
gyrAp,0.08333333333333333,11,11,CTGTGATAACGTTCTTGAAT,0,1751127
gyrAp,0.08333333333333333,11,11,CTGGCTCAATCATACGTAGC,0,1760181
gyrAp,0.08333333333333333,11,11,CTCGCGGAGGCCTGTAACCG,0,1765690
gyrAp,0.08333333333333333,11,11,CGTGTCACCCAGGCGTTTCA,0,1756215
gyrAp,0.08333333333333333,11,11,CGTGGAAACCTTCTTACCTC,0,1762394
gyrAp,0.08333333333333333,11,11,CGGCGCTCGGGGACCGGGCG,0,1755517
gyrAp,0.08333333333333333,11,11,CGGAACGTAGCACTTTAAAA,0,1762242
gyrAp,0.08333333333333333,11,11,CGGAAAAATGATGCCTTCCT,0,1748082
gyrAp,0.08333333333333333,11,11,CGCTTAGGACACCAACGTTG,0,1742854
gyrAp,0.08333333333333333,11,11,CGAGTTCCATGTCCGACAAG,0,1747425
gyrAp,0.08333333333333333,11,11,CGAGGGCTTAGGTAACATAT,0,1757419
gyrAp,0.08333333333333333,11,11,CGAGCTACTACGTTAGAAAG,0,1763649
gyrAp,0.08333333333333333,11,11,CCTATACGAGTGTAGGCAGT,0,1746325
gyrAp,0.08333333333333333,11,11,CCGTTTTCGATCTCCCGTCG,0,1744789
gyrAp,0.08333333333333333,11,11,CCGTGGTCTGCGCGTATGAT,0,1754325
gyrAp,0.08333333333333333,11,11,CCGGCCAAGCGTTAGAAACA,0,1759059
gyrAp,0.08333333333333333,11,11,CCATCGGGGTCTTACGGGAA,0,1750718
gyrAp,0.08333333333333333,11,11,CATTCAGTCCGGCCACGTCA,0,1747342
gyrAp,0.08333333333333333,11,11,CAGTAGCGCAAAGAAGGGAC,0,1756494
gyrAp,0.08333333333333333,11,11,CAGGTTTATAACGCAGAGGC,0,1765219
gyrAp,0.08333333333333333,11,11,CACAAGCCCCATTCCCTATA,0,1750848
gyrAp,0.08333333333333333,11,11,CAAGTCTTTCTGGCACGGAT,0,1748925
gyrAp,0.08333333333333333,11,11,ATTTCGGCGTCGCCTATCAA,0,1762054
gyrAp,0.08333333333333333,11,11,ATTCGAACCGGACCCTAAAC,0,1749751
gyrAp,0.08333333333333333,11,11,ATGAGTGCGTGGCGGAGCTA,0,1762127
gyrAp,0.08333333333333333,11,11,ATATGTCGATTGAAAGCTTA,0,1746942
gyrAp,0.08333333333333333,11,11,ATACCCACCAGACGCTTACT,0,1746387
gyrAp,0.08333333333333333,11,11,AGTTTGGGGTATATTTGGAT,0,1758475
gyrAp,0.08333333333333333,11,11,AGTTTAGCTGCGTATCGTCT,0,1745115
gyrAp,0.08333333333333333,11,11,AGTGAGAATTTGGCGGCTCC,0,1753599
gyrAp,0.08333333333333333,11,11,AGTCACCTGTTAGCCACGTT,0,1745718
gyrAp,0.08333333333333333,11,11,AGCCTTGGCGCCCGGACTGA,0,1765784
gyrAp,0.08333333333333333,11,11,ACGTTTAAGCGACAACAATG,0,1745723
gyrAp,0.08333333333333333,11,11,ACGTCGTGCAAGGTAATATG,0,1743247
gyrAp,0.08333333333333333,11,11,ACGGCTCCCCTGAGAATGAA,0,1759053
gyrAp,0.08333333333333333,11,11,ACGGATTTCAGAACCTTCTC,0,1749267
gyrAp,0.08333333333333333,11,11,ACGCCTGTTTCGAGCAGTCA,0,1746939
gyrAp,0.08333333333333333,11,11,ACGCAGTCGCATTTTGACTA,0,1744785
gyrAp,0.08333333333333333,11,11,ACAGAGGCCTTGCTATGTTA,0,1745279
gyrAp,0.08333333333333333,11,11,ACACTACGTTAGACTACGAA,0,1744976
gyrAp,0.08333333333333333,11,11,ACACGGAGCGCTATACCTGG,0,1746951
gyrAp,0.08333333333333333,11,11,ACAATCTCGACACGTCAAGG,0,1757722
gyrAp,0.08333333333333333,11,11,AATGGGGGGCCGTTCATAGC,0,1742786
gyrAp,0.08333333333333333,11,11,AAGTGGCATTAGGTTATTTT,0,1763698
gyrAp,0.09090909090909091,10,10,TTCGGGAACCGATAAGCACA,0,1742186
gyrAp,0.09090909090909091,10,10,TTATTTACAACGCGAAGGAT,0,1749864
gyrAp,0.09090909090909091,10,10,TTACTTTAGTTACGTCGCTA,0,1751914
gyrAp,0.09090909090909091,10,10,TTACTTCTGGTCGTTACATG,0,1749078
gyrAp,0.09090909090909091,10,10,TGTTTTTGGACAGAATCTAA,0,1770075
gyrAp,0.09090909090909091,10,10,TGTTCTGGCGGTACCCAGCA,0,1744557
gyrAp,0.09090909090909091,10,10,TGTCTCTATGACTCTTACAA,0,1748511
gyrAp,0.09090909090909091,10,10,TGTCGGGCCAATCAACCCGA,0,1754303
gyrAp,0.09090909090909091,10,10,TGGTGATCCGCATTCATTAT,0,1759385
gyrAp,0.09090909090909091,10,10,TGACTTGCCTAGAGTCAGGA,0,1754316
gyrAp,0.09090909090909091,10,10,TGACAGCATGGTCGTCTAAG,0,1770194
gyrAp,0.09090909090909091,10,10,TGAATAGCGGAGTTCGAGTT,0,1742566
gyrAp,0.09090909090909091,10,10,TCGGCAGACGCATATATGTT,0,1758030
gyrAp,0.09090909090909091,10,10,TCGCTGCAGCACTCTTCAAG,0,1751478
gyrAp,0.09090909090909091,10,10,TCGATAATTGTGGATCCGCT,0,1760996
gyrAp,0.09090909090909091,10,10,TCAAGGTGAGTTGTAAAGCA,0,1762968
gyrAp,0.09090909090909091,10,10,TCAAAGGATTTTTAACGGGT,0,1749182
gyrAp,0.09090909090909091,10,10,TATCTCACTCAGCTCCGCTC,0,1748263
gyrAp,0.09090909090909091,10,10,TACGGAACTAGCAACTCTGG,0,1742969
gyrAp,0.09090909090909091,10,10,TACCATGGACTGGCCGGTCT,0,1754189
gyrAp,0.09090909090909091,10,10,TAAGTACGGTCAGGAAGAGT,0,1746252
gyrAp,0.09090909090909091,10,10,TAAAGACTTGGTGGCAACCA,0,1749079
gyrAp,0.09090909090909091,10,10,GTGGTTGTCCGGCCCGATTA,0,1748463
gyrAp,0.09090909090909091,10,10,GTGCAAGTCGAGTAGTATGC,0,1752045
gyrAp,0.09090909090909091,10,10,GTGAGTGCTACATAGCAAGG,0,1762202
gyrAp,0.09090909090909091,10,10,GTCTCGTCGATCTTTATGAC,0,1753479
gyrAp,0.09090909090909091,10,10,GTCGTAATGACAACTACTAG,0,1747428
gyrAp,0.09090909090909091,10,10,GTCCAAATTACTTGCGGGCT,0,1746626
gyrAp,0.09090909090909091,10,10,GTCAGAACCGTTCCGGCAGT,0,1751797
gyrAp,0.09090909090909091,10,10,GTAGACGACGCCAGACCCGC,0,1751428
gyrAp,0.09090909090909091,10,10,GTAACCCTGCAGACCATAGA,0,1765893
gyrAp,0.09090909090909091,10,10,GGTTCGTCATTGCGGGGGTG,0,1753279
gyrAp,0.09090909090909091,10,10,GGGCCCTATGCGCACGATCG,0,1743130
gyrAp,0.09090909090909091,10,10,GGCTCTTACAAGAGGCCTAC,0,1750887
gyrAp,0.09090909090909091,10,10,GGCATTCGAGATCCGAGATT,0,1743085
gyrAp,0.09090909090909091,10,10,GGCATCACGTTTGGGCTCCC,0,1746345
gyrAp,0.09090909090909091,10,10,GGCAATGCATGTGTCTAGAG,0,1764053
gyrAp,0.09090909090909091,10,10,GGATGGTGCTTGTTAGTCTA,0,1742872
gyrAp,0.09090909090909091,10,10,GGATGAGCAGTATTGCCTTT,0,1753859
gyrAp,0.09090909090909091,10,10,GGACGACGTATCCCACTCGA,0,1768830
gyrAp,0.09090909090909091,10,10,GGACATAGACGCAAAGGGCT,0,1748905
gyrAp,0.09090909090909091,10,10,GCGCGTAGGTTGAGTTATGA,0,1757139
gyrAp,0.09090909090909091,10,10,GCGATTGTACCTTGATGGGC,0,1750763
gyrAp,0.09090909090909091,10,10,GCCCTGGTTCATCGATCATC,0,1752151
gyrAp,0.09090909090909091,10,10,GACTTGGACGTGCAACATTC,0,1747963
gyrAp,0.09090909090909091,10,10,GACGAAACCACCAGCTAGGG,0,1755445
gyrAp,0.09090909090909091,10,10,GAATTTTCCGTCCCTGAGGT,0,1759556
gyrAp,0.09090909090909091,10,10,GAAACCGGTAGAAAGGACTG,0,1755490
gyrAp,0.09090909090909091,10,10,CTTTCCAAGCAGACGACCGG,0,1747056
gyrAp,0.09090909090909091,10,10,CTGTAGAAACCGCCCAAATA,0,1743499
gyrAp,0.09090909090909091,10,10,CTGCAAAGTCTCGGTCTTTG,0,1754188
gyrAp,0.09090909090909091,10,10,CTGATGCGTACCCCGTAGGA,0,1763400
gyrAp,0.09090909090909091,10,10,CTAGCTCACATTTCTCGATC,0,1742392
gyrAp,0.09090909090909091,10,10,CTAGACAGAATGCACATGGG,0,1755979
gyrAp,0.09090909090909091,10,10,CTAAAGCTGCCTCTATAGAT,0,1756988
gyrAp,0.09090909090909091,10,10,CGTTGGCTTGACCAGGTCAC,0,1744676
gyrAp,0.09090909090909091,10,10,CGTACCATAATGGGAGCATC,0,1761319
gyrAp,0.09090909090909091,10,10,CGGACATTTCCTGGTAGTTG,0,1754038
gyrAp,0.09090909090909091,10,10,CGCTCGTAGACGAGTGGAGG,0,1750664
gyrAp,0.09090909090909091,10,10,CGCCTCCAGGAAGTGGGTCG,0,1743211
gyrAp,0.09090909090909091,10,10,CGATTTAGTCTCACCCAAGT,0,1745826
gyrAp,0.09090909090909091,10,10,CGAGCGCGCATGTTTATTCC,0,1760602
gyrAp,0.09090909090909091,10,10,CCTTTACGCTGCACGGGTAC,0,1752410
gyrAp,0.09090909090909091,10,10,CCTCGGTGATTCTACGACAA,0,1754852
gyrAp,0.09090909090909091,10,10,CCGACAACAACTTGGTCAAT,0,1756715
gyrAp,0.09090909090909091,10,10,CCCCCTCAATTGCTGAATCT,0,1755491
gyrAp,0.09090909090909091,10,10,CCAGGTATGGTGCAGACTTT,0,1747590
gyrAp,0.09090909090909091,10,10,CATAGATTTTTGGACTCTGC,0,1758573
gyrAp,0.09090909090909091,10,10,CAGGCCAAAAGCCTATCGAC,0,1758763
gyrAp,0.09090909090909091,10,10,CAGAGGACTTTAGCGGCCTT,0,1762269
gyrAp,0.09090909090909091,10,10,CACGTACCGACCAAACCTTA,0,1754076
gyrAp,0.09090909090909091,10,10,CACACGCTGACGCTTCCCAT,0,1767102
gyrAp,0.09090909090909091,10,10,ATTTGTGAATTCGAATAGGT,0,1764390
gyrAp,0.09090909090909091,10,10,ATTGTGGCGGCCACGCACAA,0,1752815
gyrAp,0.09090909090909091,10,10,ATGTAGCTGGTCCAAACCCT,0,1757373
gyrAp,0.09090909090909091,10,10,ATGGAACCAACGGGGGCAAA,0,1758397
gyrAp,0.09090909090909091,10,10,ATGCGGGACGGCGGACAGGA,0,1767162
gyrAp,0.09090909090909091,10,10,ATGATGTTCACGCGTGGTCC,0,1762329
gyrAp,0.09090909090909091,10,10,ATGACTCGCATACTCATGAT,0,1759320
gyrAp,0.09090909090909091,10,10,ATCTGGGCATGGAGGAGATG,0,1750829
gyrAp,0.09090909090909091,10,10,ATCTCATCATATAGGGACGT,0,1747797
gyrAp,0.09090909090909091,10,10,ATCACGGTTGCGGAATACCC,0,1757937
gyrAp,0.09090909090909091,10,10,ATATAATACCTGAGCATAGG,0,1747840
gyrAp,0.09090909090909091,10,10,ATAAACGGTTTTCGAACAAC,0,1765323
gyrAp,0.09090909090909091,10,10,AGTCAGGGGCCGTAACCTTC,0,1763945
gyrAp,0.09090909090909091,10,10,AGTACATGAGATATTGAAGC,0,1746027
gyrAp,0.09090909090909091,10,10,AGGGGGCTAGTGGTAGAAAA,0,1768969
gyrAp,0.09090909090909091,10,10,AGCGGCGAGTGTTCCTTCGC,0,1759961
gyrAp,0.09090909090909091,10,10,AGCATCGTCCTGTCTCGCGT,0,1758757
gyrAp,0.09090909090909091,10,10,AGAACTGGGTCTTACGGTCC,0,1766061
gyrAp,0.09090909090909091,10,10,ACTGAAGGTTGCACTAACTG,0,1768872
gyrAp,0.09090909090909091,10,10,ACTCGTCCAAGTCAGTAGGA,0,1754715
gyrAp,0.09090909090909091,10,10,ACGGTAGACGATCGATATAC,0,1753573
gyrAp,0.09090909090909091,10,10,ACGGACGAAGCTGGGGCGCC,0,1755144
gyrAp,0.09090909090909091,10,10,ACGCGACACCGCACGTGTCT,0,1765552
gyrAp,0.09090909090909091,10,10,ACCATTAGAACGAGTTCAAA,0,1741694
gyrAp,0.09090909090909091,10,10,ACATAAAGATGGTGGCCAAT,0,1752863
gyrAp,0.09090909090909091,10,10,ACACACGTAGCCGTAGTTGT,0,1758091
gyrAp,0.09090909090909091,10,10,AAGCCCTCGATTCGAGTCCT,0,1741984
gyrAp,0.09090909090909091,10,10,AAACATAATGCTGTTATACA,0,1765575
gyrAp,0.09090909090909091,10,10,AAAATTTTGCTACAGTGACA,0,1745556
gyrAp,0.09090909090909091,10,10,AAAATCGAGACAGGGCGTCC,0,1745756
gyrAp,0.1,9,9,TTTTCTAAGCGTCACCGTGC,0,1743791
gyrAp,0.1,9,9,TTTTAGTTTGCCGGATGTCC,0,1747331
gyrAp,0.1,9,9,TTGTTACGTCTCTTTCTGGA,0,1747138
gyrAp,0.1,9,9,TTGCCCCCAATGTAAAAGCT,0,1763387
gyrAp,0.1,9,9,TTCTGATCTTGAAGAATCGG,0,1749063
gyrAp,0.1,9,9,TTCGTCCCGTACGGGCAGGA,0,1742500
gyrAp,0.1,9,9,TTCCGAAGATGAACTTCACG,0,1747314
gyrAp,0.1,9,9,TTATATCAGGGGCCCAGTCT,0,1743053
gyrAp,0.1,9,9,TGTTTCCCGTCTGACGGTCT,0,1747981
gyrAp,0.1,9,9,TGTGGTCGGGTTGCATGTCA,0,1741772
gyrAp,0.1,9,9,TGTCGGAAGGCTTCAGAGGC,0,1742273
gyrAp,0.1,9,9,TGTCATCCTTTAATTTTGAC,0,1744606
gyrAp,0.1,9,9,TGGCTAATCTGCGCGATGTA,0,1742525
gyrAp,0.1,9,9,TGCTATAGGATCTACTAGGC,0,1770570
gyrAp,0.1,9,9,TGCCGTCGTGTGATTAGAGC,0,1770005
gyrAp,0.1,9,9,TGATCCACTGGAGATACGTA,0,1768645
gyrAp,0.1,9,9,TGAATTCCATTGGGGCCTCT,0,1768146
gyrAp,0.1,9,9,TCTAAAGGGGTAGCTCTCCT,0,1744940
gyrAp,0.1,9,9,TCGATACGCGTGGATTTCCC,0,1744149
gyrAp,0.1,9,9,TCGACGGGGAGCAATTAGAG,0,1768944
gyrAp,0.1,9,9,TCGAATTCCGACCCGTAAAC,0,1746484
gyrAp,0.1,9,9,TCAGGGCCAAACTACAGGAT,0,1764132
gyrAp,0.1,9,9,TATTGTCGGGCGGTGCACAT,0,1745519
gyrAp,0.1,9,9,TATTGCAACCTTTGACTGTG,0,1769985
gyrAp,0.1,9,9,TATGAATACATCGACGGTAT,0,1748083
gyrAp,0.1,9,9,TATCGCAAGTTGTTGGGTAT,0,1759495
gyrAp,0.1,9,9,TAGCAACAAAGCGCGATACG,0,1750575
gyrAp,0.1,9,9,TAGATGGTCGTAAAGAGGGA,0,1745730
gyrAp,0.1,9,9,TACTTTGAACTCTGGCTCTA,0,1754578
gyrAp,0.1,9,9,TACGGTGCAAGTGTGCTTCC,0,1742895
gyrAp,0.1,9,9,TAATAGGATGAATCAACGAC,0,1770508
gyrAp,0.1,9,9,TAAATATCGCGAGTTGCCGA,0,1766984
gyrAp,0.1,9,9,GTTGTTTGACGGTGGATAAA,0,1754525
gyrAp,0.1,9,9,GTTGCGCCGGGGTATTAAGT,0,1761123
gyrAp,0.1,9,9,GTTAAGCGGCCGCCACTTAA,0,1748907
gyrAp,0.1,9,9,GTGCCTTCACCAAGTGACAC,0,1766082
gyrAp,0.1,9,9,GTCTTGATCTCTTCTAGCCA,0,1752885
gyrAp,0.1,9,9,GTCGGCATTTGCTGAAATCA,0,1747099
gyrAp,0.1,9,9,GTCAGGAGGCTGGGAATAGG,0,1749323
gyrAp,0.1,9,9,GTATGTATCTAGCTCACCTG,0,1755646
gyrAp,0.1,9,9,GTAGGCACCATGCGACTACT,0,1756377
gyrAp,0.1,9,9,GTACTAAGCGAGTGAGACAT,0,1744507
gyrAp,0.1,9,9,GTAATATGACCTGGCAACGT,0,1765004
gyrAp,0.1,9,9,GTAACGTTCCGGAATAGTGA,0,1759498
gyrAp,0.1,9,9,GGTTTGCGGACAATACCGGT,0,1748728
gyrAp,0.1,9,9,GGTTCTGGAGATGAATCCCT,0,1770198
gyrAp,0.1,9,9,GGTAATTCCATTATCGGCTC,0,1754734
gyrAp,0.1,9,9,GGTAAGAACCGACACGAGTT,0,1760094
gyrAp,0.1,9,9,GGGTATGAGACAGGACAGTT,0,1744835
gyrAp,0.1,9,9,GGGGTCCCAGGTCGTTGAAG,0,1757929
gyrAp,0.1,9,9,GGCTAAATAAGGCTTCGAGC,0,1753970
gyrAp,0.1,9,9,GGCGCGACCATACAGGGGTT,0,1743734
gyrAp,0.1,9,9,GGAGTAACTGGGCCTGGGAT,0,1747999
gyrAp,0.1,9,9,GCTTAACGCCCATCCTCGCC,0,1766478
gyrAp,0.1,9,9,GCGCAGTAGGCCAGGACATA,0,1767573
gyrAp,0.1,9,9,GCCTGGCTGATCGCGTTTCG,0,1758761
gyrAp,0.1,9,9,GCCTCCCCCAATTTGGGATC,0,1754472
gyrAp,0.1,9,9,GCATAAACCATGAACAGAAC,0,1742243
gyrAp,0.1,9,9,GCAGTAATTGGTTCACTTAT,0,1751213
gyrAp,0.1,9,9,GCACCAGAGTCCCCCGAGCC,0,1763517
gyrAp,0.1,9,9,GATTTTCCCTTGATTCCACA,0,1767713
gyrAp,0.1,9,9,GATTGGTTACAATTCGGGCA,0,1750200
gyrAp,0.1,9,9,GATGCGACACAGGACCTGAG,0,1763332
gyrAp,0.1,9,9,GAGACTCTCACCGCCCGCGC,0,1765837
gyrAp,0.1,9,9,GACCAGAGGATGTGGCAGCT,0,1769469
gyrAp,0.1,9,9,GACAGGATCCACCTAAGCAT,0,1752657
gyrAp,0.1,9,9,GAAGTTACTTGGTTCTACGG,0,1769133
gyrAp,0.1,9,9,CTTGATTAAGACCGGCACTT,0,1759335
gyrAp,0.1,9,9,CTTACTGTGCTCGGCATCGA,0,1760742
gyrAp,0.1,9,9,CTGATCTAACAGGCCGCGAT,0,1745112
gyrAp,0.1,9,9,CTCCGTCCTAGGACGGTGGG,0,1756974
gyrAp,0.1,9,9,CTCCGGCCGTTGCGTACAGG,0,1743306
gyrAp,0.1,9,9,CTAGGGTATCCCATTGTGAG,0,1747726
gyrAp,0.1,9,9,CTAAGATGAAGAGGTTGCGG,0,1745461
gyrAp,0.1,9,9,CGTGAGGAAGCCAGGACGAC,0,1748577
gyrAp,0.1,9,9,CGCCACGATTGAGTCTTCTC,0,1742806
gyrAp,0.1,9,9,CGCACAATCTATTCTAATGG,0,1750255
gyrAp,0.1,9,9,CGACACGGATTTTGATTTAT,0,1745227
gyrAp,0.1,9,9,CCTTCAAATGGAACGGGCGA,0,1754613
gyrAp,0.1,9,9,CCTAAATTTCCGCCTCGGAT,0,1745017
gyrAp,0.1,9,9,CCGGTGCGCCTACTGTGACT,0,1746434
gyrAp,0.1,9,9,CCGCGGTTAGTGCCATATGT,0,1764480
gyrAp,0.1,9,9,CCCTCGCCCGGTACATCATG,0,1752138
gyrAp,0.1,9,9,CCCCATACGGATGGCTGAAA,0,1765807
gyrAp,0.1,9,9,CATTCGTCTAGCGCGTTAAT,0,1768376
gyrAp,0.1,9,9,CATGCGAGGCAGAAGCGTTT,0,1751706
gyrAp,0.1,9,9,CATCAGGAGTGGGGTCTTTA,0,1770559
gyrAp,0.1,9,9,CAGTTGACAGGATTCCGGTT,0,1750204
gyrAp,0.1,9,9,CAGGGGGCCGTTGTTGTATG,0,1752414
gyrAp,0.1,9,9,CAGATAATTAACTCTACACT,0,1747593
gyrAp,0.1,9,9,CACGGAATCAACGCCTGAAC,0,1753152
gyrAp,0.1,9,9,CACCCCCTCATTGCCAATCC,0,1747532
gyrAp,0.1,9,9,CAATATCGGAACCGATCTTG,0,1749161
gyrAp,0.1,9,9,CAACGGGACGAACGGATTTG,0,1757985
gyrAp,0.1,9,9,CAACCGAGGAATGTGTAGAT,0,1743251
gyrAp,0.1,9,9,ATTTAGGCGCCGCGCCGGTA,0,1760822
gyrAp,0.1,9,9,ATGTGTCAGGGCTCGTTACA,0,1744702
gyrAp,0.1,9,9,ATGAGGTCCGTAACAAGGTT,0,1759001
gyrAp,0.1,9,9,ATCTATTCGTGTGGGATACG,0,1757679
gyrAp,0.1,9,9,ATATGGACGGTGGGATTTTT,0,1759760
gyrAp,0.1,9,9,ATATCATGGGTACTCGACCT,0,1758062
gyrAp,0.1,9,9,ATATAGTAGTCAATGTCGGA,0,1748115
gyrAp,0.1,9,9,ATAATACCTGTAGCATTCTT,0,1746580
gyrAp,0.1,9,9,ATAAAAGCGAATTAGGCCAG,0,1762466
gyrAp,0.1,9,9,AGTGCTTCCCAAGCGGGGAC,0,1755178
gyrAp,0.1,9,9,AGTGCATTTCCCTGCATGCA,0,1751857
gyrAp,0.1,9,9,AGTGCACGCAAACCCACCCA,0,1747315
gyrAp,0.1,9,9,AGTCGAGACATGTTATCCCC,0,1755732
gyrAp,0.1,9,9,AGTCCCCCTTTCCGGAATAT,0,1748357
gyrAp,0.1,9,9,AGGTTTCTAGATAGCCGGGG,0,1753725
gyrAp,0.1,9,9,AGGTGTGCTATCTATGTACA,0,1768696
gyrAp,0.1,9,9,AGGTGAGCCCGCAATGTGAC,0,1770768
gyrAp,0.1,9,9,AGGGAAAGTGGAGAACAGTT,0,1748992
gyrAp,0.1,9,9,AGGCGACTCATGGGGCCAGT,0,1742308
gyrAp,0.1,9,9,AGGCACACTCAGTTACCTGT,0,1743989
gyrAp,0.1,9,9,AGGATACTTCCCCTGCCCTG,0,1744643
gyrAp,0.1,9,9,AGGAGTCGAGGTTCATAACC,0,1770234
gyrAp,0.1,9,9,AGGAGGCTATACATGATGCT,0,1759227
gyrAp,0.1,9,9,AGGAATCTAACGAATTATAG,0,1765052
gyrAp,0.1,9,9,AGGAAGCCAATGAATGGGCA,0,1765047
gyrAp,0.1,9,9,AGCTACCGGGAGACACAACT,0,1763877
gyrAp,0.1,9,9,AGCGGGAGACTGTACACATG,0,1744005
gyrAp,0.1,9,9,AGCGCTAAGCAGGTCGAAAA,0,1751623
gyrAp,0.1,9,9,AGCCAATAACCGGAAATTTG,0,1750421
gyrAp,0.1,9,9,AGATATAAGACTTGCGTTAA,0,1746772
gyrAp,0.1,9,9,AGATACCCACGCAATTGCTG,0,1741709
gyrAp,0.1,9,9,AGACGTGCGCAGCCTTCGGC,0,1749977
gyrAp,0.1,9,9,ACTTCTTCAGAGGCAACGTT,0,1742510
gyrAp,0.1,9,9,ACGGTCAGGTCATAGGCTCT,0,1765475
gyrAp,0.1,9,9,ACCGCACCCTCATGTGGGAA,0,1744551
gyrAp,0.1,9,9,ACATAGCGTGGATTGAGTAG,0,1748995
gyrAp,0.1,9,9,ACAGCCGGGCCGGGTAGTTT,0,1765229
gyrAp,0.1,9,9,ACAAATGAATATCTATCCTA,0,1752101
gyrAp,0.1,9,9,AATGTAGGATATTGTTATTG,0,1756424
gyrAp,0.1,9,9,AAGTCCCGTGTAGTTCTGGA,0,1754960
gyrAp,0.1,9,9,AAGCTTATTTCTGGTGCCCT,0,1763886
gyrAp,0.1,9,9,AAGCGGCGGCGTTTCTGTCG,0,1753785
gyrAp,0.1,9,9,AAGCAAAACAGTGGCCCTAT,0,1749920
gyrAp,0.1,9,9,AAGATACCATTTGTCGCCAT,0,1758708
gyrAp,0.1,9,9,AACACAGACTGAAGCGGTTA,0,1769048
gyrAp,0.1,9,9,AAATCAGAATTAAATCCATG,0,1768080
gyrAp,0.1,9,9,AAAGTCACGCAAGTGAACCA,0,1744817
gyrAp,0.1111111111111111,8,8,TTTATGCAAGGAAGATATCT,0,1742206
gyrAp,0.1111111111111111,8,8,TTTAGTAGCCAATTCACAAA,0,1759870
gyrAp,0.1111111111111111,8,8,TTTACACGGAGCATCCAACC,0,1747949
gyrAp,0.1111111111111111,8,8,TTGGCGTCCGGACTCTTGGC,0,1770505
gyrAp,0.1111111111111111,8,8,TTGGATTATTTCAGTAACTG,0,1769052
gyrAp,0.1111111111111111,8,8,TTGGAACCTACTCGAAAATA,0,1748216
gyrAp,0.1111111111111111,8,8,TTGAGCGTTCCCGCTAATCC,0,1743367
gyrAp,0.1111111111111111,8,8,TTGAGAATTAGACCGTGCAG,0,1748006
gyrAp,0.1111111111111111,8,8,TTCTAGCATACAGCAAGTAT,0,1755647
gyrAp,0.1111111111111111,8,8,TTCCGCGTGGGTCAACTTTC,0,1767470
gyrAp,0.1111111111111111,8,8,TTCAGAAAAGCTAAGAGTGC,0,1751820
gyrAp,0.1111111111111111,8,8,TTAGATAGTTACGGGGGAAG,0,1766877
gyrAp,0.1111111111111111,8,8,TGTTTGACGCGGCCTATGCG,0,1756582
gyrAp,0.1111111111111111,8,8,TGTTGCCTGCGGGTAGAACG,0,1745849
gyrAp,0.1111111111111111,8,8,TGTTCGTTTTGTAAAATGGA,0,1758576
gyrAp,0.1111111111111111,8,8,TGTGTGGCGTTTAATTGGCA,0,1743061
gyrAp,0.1111111111111111,8,8,TGGGGACTCATTTATGTGAA,0,1743704
gyrAp,0.1111111111111111,8,8,TGGGAACATTCCTACTGGGT,0,1760298
gyrAp,0.1111111111111111,8,8,TGGCTTCGGTACGCGTTATG,0,1753641
gyrAp,0.1111111111111111,8,8,TGGATCGCAGTAGACAGGGT,0,1767032
gyrAp,0.1111111111111111,8,8,TGGAGCTAGGGGGTTCGTCT,0,1754916
gyrAp,0.1111111111111111,8,8,TGCTTGTGGTATTACTGAAC,0,1743025
gyrAp,0.1111111111111111,8,8,TGCTAGAGGTAGCCATACGT,0,1757951
gyrAp,0.1111111111111111,8,8,TGCGGCTCCACCGGAGTTTA,0,1756909
gyrAp,0.1111111111111111,8,8,TGCCGGCGAGCATCCCTCAA,0,1752232
gyrAp,0.1111111111111111,8,8,TGCCGAGGTGAAGCGGATGT,0,1749732
gyrAp,0.1111111111111111,8,8,TGCCAATGCGAGATGAAGGG,0,1765986
gyrAp,0.1111111111111111,8,8,TGCAACGCCTAAGTAATTTG,0,1752000
gyrAp,0.1111111111111111,8,8,TGACCGCTTCGAGAACGTGC,0,1770145
gyrAp,0.1111111111111111,8,8,TGACATTCATAGACTTTAGA,0,1754039
gyrAp,0.1111111111111111,8,8,TCGCCCCGAGATGGCCAATG,0,1753525
gyrAp,0.1111111111111111,8,8,TCGAGCTTCATATCGATGAC,0,1766967
gyrAp,0.1111111111111111,8,8,TCCGGAATCCAGACAAGAAA,0,1747174
gyrAp,0.1111111111111111,8,8,TCATTTTTTGTCCTGCTACC,0,1753889
gyrAp,0.1111111111111111,8,8,TCACTCACGTATGGTCTCGC,0,1751453
gyrAp,0.1111111111111111,8,8,TCACCGGGTCGAGTGAGACA,0,1759705
gyrAp,0.1111111111111111,8,8,TCAACTCTCACGCTATCGAA,0,1749889
gyrAp,0.1111111111111111,8,8,TATTAGAACACAATTCAATC,0,1761109
gyrAp,0.1111111111111111,8,8,TATACCCGAGACGCAACTCC,0,1741443
gyrAp,0.1111111111111111,8,8,TAGGACGGTTATACTGGAAA,0,1751432
gyrAp,0.1111111111111111,8,8,TACCGGAAGCGTCTGTGTCT,0,1763240
gyrAp,0.1111111111111111,8,8,TACAGGACCGGCGAGCCCAA,0,1743182
gyrAp,0.1111111111111111,8,8,TAAGTAGTAATGTATGAATG,0,1764246
gyrAp,0.1111111111111111,8,8,TAACTCTTTTGGAACGTTAA,0,1767588
gyrAp,0.1111111111111111,8,8,GTGCCGCACATAGACACGGG,0,1755387
gyrAp,0.1111111111111111,8,8,GTGCCCCAGAAGTGACCATC,0,1759338
gyrAp,0.1111111111111111,8,8,GTGAGTCTTATAGGTATGTA,0,1762052
gyrAp,0.1111111111111111,8,8,GTCAGCCGGCAGTACTGCTA,0,1765754
gyrAp,0.1111111111111111,8,8,GTCAAGGACATGGGCTGGTG,0,1760971
gyrAp,0.1111111111111111,8,8,GTAATGGGCATGCTTACGAA,0,1755703
gyrAp,0.1111111111111111,8,8,GTAAGCAAGGGTAGCCTATA,0,1767134
gyrAp,0.1111111111111111,8,8,GGTGCATTGACTCGGTGCAG,0,1763600
gyrAp,0.1111111111111111,8,8,GGTCGCTGTTAGACACCTGC,0,1744621
gyrAp,0.1111111111111111,8,8,GGTCCGTCAGGGGGACAGGA,0,1751000
gyrAp,0.1111111111111111,8,8,GGTCAGGCGACTTGAATTGT,0,1768558
gyrAp,0.1111111111111111,8,8,GGTCAGACACGCATTTTTAT,0,1756096
gyrAp,0.1111111111111111,8,8,GGTACCGTCCATAAGTTATT,0,1745030
gyrAp,0.1111111111111111,8,8,GGGGGGGAGCCGGTCTTCTT,0,1743792
gyrAp,0.1111111111111111,8,8,GGGGGCTATGACTCCCTACT,0,1760737
gyrAp,0.1111111111111111,8,8,GGGGCCTGCACTCCTTTCGT,0,1748363
gyrAp,0.1111111111111111,8,8,GGGCTGGAGTGGGAATAACA,0,1758473
gyrAp,0.1111111111111111,8,8,GGCTTAGCGGGGCTTTTCCG,0,1742133
gyrAp,0.1111111111111111,8,8,GGCTACCTGTACCACATGGA,0,1765245
gyrAp,0.1111111111111111,8,8,GGCCGCAACCCCACGTGATA,0,1767574
gyrAp,0.1111111111111111,8,8,GGCCCGTCCGGATGTGTAGC,0,1755077
gyrAp,0.1111111111111111,8,8,GGCAAATTCAATTCGGTGAA,0,1754801
gyrAp,0.1111111111111111,8,8,GGATCTAGAGGGACCCTCTT,0,1753569
gyrAp,0.1111111111111111,8,8,GGATATTTAAACCGTGGCTG,0,1752791
gyrAp,0.1111111111111111,8,8,GGATATCTCGTCCGAGCAGC,0,1759720
gyrAp,0.1111111111111111,8,8,GGAGTACGAGTTCCTGTACT,0,1745346
gyrAp,0.1111111111111111,8,8,GGACGCCCCAGGTGGATGAC,0,1745071
gyrAp,0.1111111111111111,8,8,GGACAGTTTCTGCCCTATTT,0,1759436
gyrAp,0.1111111111111111,8,8,GGAAAGGGGGACGGGTCAGT,0,1768576
gyrAp,0.1111111111111111,8,8,GCTTTTGCTAGCTCCGGCCT,0,1745890
gyrAp,0.1111111111111111,8,8,GCTTTACCCCGAGCCGCCTA,0,1764639
gyrAp,0.1111111111111111,8,8,GCTGCGGGAGTTGTTGCCAT,0,1753616
gyrAp,0.1111111111111111,8,8,GCTATTACTGATCGCTTATG,0,1744588
gyrAp,0.1111111111111111,8,8,GCTACTAACTTACTATTGTG,0,1761561
gyrAp,0.1111111111111111,8,8,GCGCCGAGCGGGCCTCTGAC,0,1745542
gyrAp,0.1111111111111111,8,8,GCGCATTAAGCGTCACAGTC,0,1749514
gyrAp,0.1111111111111111,8,8,GCCCAAACACGGAGTATCGA,0,1752648
gyrAp,0.1111111111111111,8,8,GCATAGCTACGCCGTCCGGC,0,1756929
gyrAp,0.1111111111111111,8,8,GCAGGTCGTGTTTGTAGTCA,0,1752962
gyrAp,0.1111111111111111,8,8,GCAATTCCATAACGTCCTGC,0,1752932
gyrAp,0.1111111111111111,8,8,GCAACATCTGGGGTTGGGCT,0,1757297
gyrAp,0.1111111111111111,8,8,GATGACTGCGGGCATGACTA,0,1766050
gyrAp,0.1111111111111111,8,8,GATCAGCACGGTCCTAAATG,0,1742384
gyrAp,0.1111111111111111,8,8,GATCAAAGAGTTATGTAGAG,0,1766462
gyrAp,0.1111111111111111,8,8,GATAGGTGCTCAATTGAAGT,0,1748451
gyrAp,0.1111111111111111,8,8,GATAATTTTGCAATGGTGAC,0,1764728
gyrAp,0.1111111111111111,8,8,GAGTGTTACAGAGGTTGGGC,0,1759546
gyrAp,0.1111111111111111,8,8,GAGTGATATGCAGAGTATTT,0,1756172
gyrAp,0.1111111111111111,8,8,GAGCGTATGGGTTAATAAGG,0,1741686
gyrAp,0.1111111111111111,8,8,GACTTCCCGGACGCGACCAT,0,1741801
gyrAp,0.1111111111111111,8,8,GACTGCTCCACCAAGCACTT,0,1769106
gyrAp,0.1111111111111111,8,8,GACGTAATTAATAGGATAAG,0,1747944
gyrAp,0.1111111111111111,8,8,GAATGAGTCTTGATAGAGGC,0,1761215
gyrAp,0.1111111111111111,8,8,GAAGGCCCGGCGGGGATGTC,0,1762368
gyrAp,0.1111111111111111,8,8,GAACTCTGTGCTTGGTATCT,0,1767949
gyrAp,0.1111111111111111,8,8,GAACGTGAGCCCCTCGTAGC,0,1763397
gyrAp,0.1111111111111111,8,8,CTTTATATATCGTCAAACTC,0,1754552
gyrAp,0.1111111111111111,8,8,CTGCTCTGCCGGATCCGTTA,0,1755229
gyrAp,0.1111111111111111,8,8,CTGCCACGGCTCCGATATGT,0,1762778
gyrAp,0.1111111111111111,8,8,CTGCCAATGGGTTTGGATTT,0,1760659
gyrAp,0.1111111111111111,8,8,CTGAGCTACAGTTCTTAGGT,0,1751434
gyrAp,0.1111111111111111,8,8,CTCGTAATTGGGGAAACCTG,0,1742813
gyrAp,0.1111111111111111,8,8,CTCCAACATCGTATTTGGAT,0,1748589
gyrAp,0.1111111111111111,8,8,CTCAGGGAAGAGTATCGAAA,0,1751327
gyrAp,0.1111111111111111,8,8,CTATGGCCACAGACCCCCGA,0,1757289
gyrAp,0.1111111111111111,8,8,CTATCGGTATGAGTTTTTCA,0,1766422
gyrAp,0.1111111111111111,8,8,CTAAATGTTGCATGATCTGG,0,1758341
gyrAp,0.1111111111111111,8,8,CGTTGCCTGGCTATACGCAT,0,1747722
gyrAp,0.1111111111111111,8,8,CGTGCCTGACTCGGTCCCAG,0,1757491
gyrAp,0.1111111111111111,8,8,CGTCCGGCTCCTACAGCCAC,0,1751010
gyrAp,0.1111111111111111,8,8,CGTATTCGGTATGTTTAAGT,0,1754219
gyrAp,0.1111111111111111,8,8,CGTACAGAGATTCCGTTTTA,0,1758088
gyrAp,0.1111111111111111,8,8,CGGTTCGCAGGATTCGCTTA,0,1762601
gyrAp,0.1111111111111111,8,8,CGGGCAATTGCGAGATGGGG,0,1757378
gyrAp,0.1111111111111111,8,8,CGGCTAGTGTTGCGTATAAG,0,1749039
gyrAp,0.1111111111111111,8,8,CGGAGATGTAGGATCGGGCA,0,1754981
gyrAp,0.1111111111111111,8,8,CGCGTGCGCTTGTGTGGTTG,0,1770634
gyrAp,0.1111111111111111,8,8,CGCCTGATAGAGTGGACACC,0,1748865
gyrAp,0.1111111111111111,8,8,CGCACGTCGAATTTGCTGTA,0,1759676
gyrAp,0.1111111111111111,8,8,CGATTCATGCGTTCCCCCAA,0,1765860
gyrAp,0.1111111111111111,8,8,CGATTAGTATGAGTTCAACG,0,1756904
gyrAp,0.1111111111111111,8,8,CGACAACGCTTGTTGACCAG,0,1758987
gyrAp,0.1111111111111111,8,8,CGAAGCCGGCCCCAGAAGTG,0,1750939
gyrAp,0.1111111111111111,8,8,CGAAAACAAGTGGACGGAAC,0,1758402
gyrAp,0.1111111111111111,8,8,CCTTAAACCGGCAAGGAGGA,0,1764397
gyrAp,0.1111111111111111,8,8,CCTGTCCGGGCGTGCGGCTC,0,1754523
gyrAp,0.1111111111111111,8,8,CCTGGGTGGCTGAGAGAAAC,0,1763972
gyrAp,0.1111111111111111,8,8,CCTCCAAAACATCTGTACCA,0,1748633
gyrAp,0.1111111111111111,8,8,CCGCCTAAAAAACTTCAGAA,0,1744756
gyrAp,0.1111111111111111,8,8,CCGAATGAAGTATCACGTAT,0,1755247
gyrAp,0.1111111111111111,8,8,CCCTTATTCTATCTAGCGGC,0,1762220
gyrAp,0.1111111111111111,8,8,CCCCGCCCGAAAATTCCGCT,0,1748961
gyrAp,0.1111111111111111,8,8,CCATAACTACTAACGCTAGC,0,1746329
gyrAp,0.1111111111111111,8,8,CCAGACTCGTAAGGTCAACT,0,1753200
gyrAp,0.1111111111111111,8,8,CATTGGCGAGGAATCGCGGT,0,1743607
gyrAp,0.1111111111111111,8,8,CATGGTCAGGATGTTTAATA,0,1755467
gyrAp,0.1111111111111111,8,8,CATATACGCATCCTACGATC,0,1755916
gyrAp,0.1111111111111111,8,8,CATATACCCCAGGGGTTCTG,0,1746833
gyrAp,0.1111111111111111,8,8,CATAATAAGCACCGGCGATC,0,1770126
gyrAp,0.1111111111111111,8,8,CAGTTTAGGTGAACTATGTG,0,1764156
gyrAp,0.1111111111111111,8,8,CAGTGGGTAAGGACCGGCTC,0,1760013
gyrAp,0.1111111111111111,8,8,CAGATCTAGTATAGCGTTCT,0,1744308
gyrAp,0.1111111111111111,8,8,CACTGCGGACCCCGTGTAGT,0,1766227
gyrAp,0.1111111111111111,8,8,CACGTTGCGTGGTTTCCGTA,0,1748197
gyrAp,0.1111111111111111,8,8,CACCGATAAGACAAAGGGAG,0,1742000
gyrAp,0.1111111111111111,8,8,CACATGATGAATCCGGGGCA,0,1751751
gyrAp,0.1111111111111111,8,8,CACATCTAATTGTACTCATA,0,1742234
gyrAp,0.1111111111111111,8,8,CAAGGAAAACCAAAGGTTTC,0,1769793
gyrAp,0.1111111111111111,8,8,CAACAAAACCCGTCCAGCCA,0,1753701
gyrAp,0.1111111111111111,8,8,ATTTCATACAATGCATTTTT,0,1760869
gyrAp,0.1111111111111111,8,8,ATTGGAACCCGGGCCTGCAG,0,1752861
gyrAp,0.1111111111111111,8,8,ATGTGCGTCAATGCTGGCTA,0,1757615
gyrAp,0.1111111111111111,8,8,ATGTAGTTGCTACACCCGAC,0,1758805
gyrAp,0.1111111111111111,8,8,ATGGTAAGCCAGTCATTTAA,0,1754422
gyrAp,0.1111111111111111,8,8,ATGGATTTTCGAAAGGTGGA,0,1766991
gyrAp,0.1111111111111111,8,8,ATGCTTGCACGGGACCATAG,0,1764843
gyrAp,0.1111111111111111,8,8,ATGCATTTACTATCACCAAT,0,1743662
gyrAp,0.1111111111111111,8,8,ATGAGCTCGCGTCATACATC,0,1742643
gyrAp,0.1111111111111111,8,8,ATCTTGTTAAGAAAGGCCGT,0,1749316
gyrAp,0.1111111111111111,8,8,ATCTTAGAGGGCGTGATCGC,0,1768322
gyrAp,0.1111111111111111,8,8,ATCTGATTATGGAACGATAG,0,1761301
gyrAp,0.1111111111111111,8,8,ATCGTTCGAGTAAATCTTGT,0,1769115
gyrAp,0.1111111111111111,8,8,ATCGTTATACTGGCTCGTAC,0,1759460
gyrAp,0.1111111111111111,8,8,ATCCGCTCCGTATCTCAGAA,0,1744755
gyrAp,0.1111111111111111,8,8,ATATTTTAGGCCCAGGGAAC,0,1744118
gyrAp,0.1111111111111111,8,8,ATAGTTCGGCACTTTGAGCG,0,1758568
gyrAp,0.1111111111111111,8,8,ATAGTCGGGATATGAAAAGA,0,1752818
gyrAp,0.1111111111111111,8,8,ATAGCAAGAGGGACAGACCT,0,1744194
gyrAp,0.1111111111111111,8,8,ATACATCTTCACGATAGGTT,0,1761904
gyrAp,0.1111111111111111,8,8,AGTTAATTTCGTTCTCCCAT,0,1765719
gyrAp,0.1111111111111111,8,8,AGTGTGTGCCCATTGGAAAA,0,1766947
gyrAp,0.1111111111111111,8,8,AGTGTCACCCCGCATCGAGG,0,1766971
gyrAp,0.1111111111111111,8,8,AGTGGCTGCTTGAGTCCTGT,0,1763407
gyrAp,0.1111111111111111,8,8,AGTGCGGTTGCCAGTATCGT,0,1759704
gyrAp,0.1111111111111111,8,8,AGTCGTCTCCTAAGACAGAG,0,1751325
gyrAp,0.1111111111111111,8,8,AGTAATGTATGCGGTATCAT,0,1747681
gyrAp,0.1111111111111111,8,8,AGGTTGTCGAGTACTGCGAG,0,1767553
gyrAp,0.1111111111111111,8,8,AGGTGACCTTACGTTACCTC,0,1752269
gyrAp,0.1111111111111111,8,8,AGGGCTGGCAATCGCCTCGA,0,1760884
gyrAp,0.1111111111111111,8,8,AGGCGAATGTTCAACATCTG,0,1760843
gyrAp,0.1111111111111111,8,8,AGGCCTATAAAGTTTAGTTG,0,1750364
gyrAp,0.1111111111111111,8,8,AGATCTCGACTAAAGGCCCG,0,1750025
gyrAp,0.1111111111111111,8,8,AGAGTATGGTTTGAGTCCCA,0,1749731
gyrAp,0.1111111111111111,8,8,AGACACTATCGCGGCGTCCA,0,1749668
gyrAp,0.1111111111111111,8,8,AGAACCTATTGTGCGGTAAG,0,1756749
gyrAp,0.1111111111111111,8,8,AGAAACGATCAAGAATTTGG,0,1768432
gyrAp,0.1111111111111111,8,8,ACGGGGTACGGTAACATCCA,0,1755076
gyrAp,0.1111111111111111,8,8,ACCTTAGTAGACTTTAGTGC,0,1766319
gyrAp,0.1111111111111111,8,8,ACCTCATTGATTAGATGGTC,0,1765816
gyrAp,0.1111111111111111,8,8,ACCGGACGTAGCTGCGCCGA,0,1751204
gyrAp,0.1111111111111111,8,8,ACATTGAAAGATTAGCAAAC,0,1757070
gyrAp,0.1111111111111111,8,8,ACACGTGGATATGCCTGCTC,0,1757273
gyrAp,0.1111111111111111,8,8,ACAAGGTCGGCGTTTCAACG,0,1765438
gyrAp,0.1111111111111111,8,8,ACAAAATAGGTAACGCGCAT,0,1764803
gyrAp,0.1111111111111111,8,8,AATGAGGCAGTATAGTCACA,0,1765123
gyrAp,0.1111111111111111,8,8,AATATGCTCGTTAGGAATAT,0,1743302
gyrAp,0.1111111111111111,8,8,AAGTAAGTGCTGCCGCCACT,0,1755313
gyrAp,0.1111111111111111,8,8,AAGGCGTTCTGATATAACAT,0,1748866
gyrAp,0.1111111111111111,8,8,AAGCCCGAGAGACAAATAGC,0,1748653
gyrAp,0.1111111111111111,8,8,AAATGGAATCGGGCAATTGT,0,1759272
gyrAp,0.1111111111111111,8,8,AAATAGAGTACGGAAAGGAG,0,1757008
gyrAp,0.1111111111111111,8,8,AAAGACGTTTACTCACTAAT,0,1767356
gyrAp,0.1111111111111111,8,8,AAAAGTGACGAAAGTCGTAG,0,1742292
gyrAp,0.125,7,7,TTTGTTCGTCGGTACGATTG,0,1766972
gyrAp,0.125,7,7,TTTGGAGAAGCGGTCGGGAC,0,1756185
gyrAp,0.125,7,7,TTGTGTCTACTCAGCTGGGA,0,1745873
gyrAp,0.125,7,7,TTGTCCGGACTCTATCAGAT,0,1766408
gyrAp,0.125,7,7,TTGATCCTGAAGGGAGCTGG,0,1746861
gyrAp,0.125,7,7,TTCTTTAAATACAACTGCCA,0,1764824
gyrAp,0.125,7,7,TTCGGAGGACGACTTAAGAT,0,1756402
gyrAp,0.125,7,7,TTCCAGAGGAGTCTGGTACT,0,1767931
gyrAp,0.125,7,7,TTCAAGGGCGTAAATATTCA,0,1750494
gyrAp,0.125,7,7,TTATGGGCATTGTATGATAG,0,1766081
gyrAp,0.125,7,7,TTAGTCATGTCTCTGGCTGT,0,1756595
gyrAp,0.125,7,7,TTAGACTATTTATCGTAAGA,0,1748896
gyrAp,0.125,7,7,TTAGAATTCTATTCGCACCG,0,1747877
gyrAp,0.125,7,7,TGTTATGCCATAACCAGTTT,0,1755213
gyrAp,0.125,7,7,TGTTAACCAGGCCCTCATCA,0,1753454
gyrAp,0.125,7,7,TGTGCGAAATACGTTTCACA,0,1753495
gyrAp,0.125,7,7,TGGTTACAAGGGGATCGATG,0,1757717
gyrAp,0.125,7,7,TGGTCTTACCGTAAAGTTTT,0,1762935
gyrAp,0.125,7,7,TGGCAGGTTCGGTAGGGAGG,0,1755883
gyrAp,0.125,7,7,TGGATAGCCTCAATTTAACT,0,1755929
gyrAp,0.125,7,7,TGGACGTAGGGATATCGAGG,0,1750245
gyrAp,0.125,7,7,TGCTGAGTTAGCGACGACAT,0,1760933
gyrAp,0.125,7,7,TGCATTTCGCCTTCGCAAGG,0,1761094
gyrAp,0.125,7,7,TGCACCGCACAGGTCCCGCT,0,1751093
gyrAp,0.125,7,7,TGCAATTTGTAGGGTCTAAA,0,1762468
gyrAp,0.125,7,7,TGAAACACGGCGCGGCCATT,0,1762415
gyrAp,0.125,7,7,TCTTGGCTCACGGTGCTCGA,0,1759991
gyrAp,0.125,7,7,TCTGTACTAGGATCTCTCTA,0,1755090
gyrAp,0.125,7,7,TCTGAAACGGCTCCCGGGCA,0,1764694
gyrAp,0.125,7,7,TCGTGCCCGCCTAGACTTCT,0,1751219
gyrAp,0.125,7,7,TCGGCTTGTCGAGAGTTCAG,0,1752706
gyrAp,0.125,7,7,TCGGACTAACCGGCATTGTG,0,1743295
gyrAp,0.125,7,7,TCGATGCTTCGGAATACAAA,0,1770427
gyrAp,0.125,7,7,TCGAAAGCCAGTTTACGCTA,0,1743369
gyrAp,0.125,7,7,TCCGTTGTAAAGAACGTGAC,0,1754755
gyrAp,0.125,7,7,TCCCGAGGACAGAGGCCAAA,0,1750420
gyrAp,0.125,7,7,TCCCACTATCTGAGTGGGCA,0,1757253
gyrAp,0.125,7,7,TCCAGGTTAGGGGCCTCAGC,0,1747566
gyrAp,0.125,7,7,TCATGCAGCATGCCAGCCCC,0,1763833
gyrAp,0.125,7,7,TCAGATTAGTTTAGAGGTAG,0,1758409
gyrAp,0.125,7,7,TCAGAGTTTCGCTACGCGCT,0,1746564
gyrAp,0.125,7,7,TCACATGAAAAATAAGGTAG,0,1742520
gyrAp,0.125,7,7,TATTGAGCGTAAAGGACTAG,0,1745889
gyrAp,0.125,7,7,TATCTGCCGATGGACGTTTT,0,1759271
gyrAp,0.125,7,7,TATCATCAGTGTATTATCTT,0,1760588
gyrAp,0.125,7,7,TATAAGCCGGAATCCTGGAT,0,1759136
gyrAp,0.125,7,7,TAGGGCCAAAGTCCCACATC,0,1750828
gyrAp,0.125,7,7,TAGGGAGGCAAAGGGTCATT,0,1743927
gyrAp,0.125,7,7,TAGGACGGTCTGACTTCTAC,0,1767498
gyrAp,0.125,7,7,TAGGAACCGTCGGTCGCCAC,0,1769677
gyrAp,0.125,7,7,TAGCTTAATAACTATGCTTT,0,1754727
gyrAp,0.125,7,7,TAGCGCCTCAGGCGATTTGG,0,1752191
gyrAp,0.125,7,7,TACTTGGATCTGGAGATCTT,0,1749981
gyrAp,0.125,7,7,TACCAACGGCTAAGGCTGTA,0,1764291
gyrAp,0.125,7,7,TACACTAGCTTTGCAGCGAG,0,1760487
gyrAp,0.125,7,7,TAATGGGAGCAGAGCATTAT,0,1753258
gyrAp,0.125,7,7,TAATCAAGGGAGACACCCTC,0,1753802
gyrAp,0.125,7,7,GTTTTCATTGGCGTACCCAG,0,1764005
gyrAp,0.125,7,7,GTTGTGTAAGGGTCTTTTGA,0,1747919
gyrAp,0.125,7,7,GTTGTCTACGGCTGTATCGG,0,1750246
gyrAp,0.125,7,7,GTTGGGTGGTACTAGCTTGG,0,1751375
gyrAp,0.125,7,7,GTTCCTAGACCGTGACAGTT,0,1757085
gyrAp,0.125,7,7,GTTACGGACCTTAGGATTCA,0,1752328
gyrAp,0.125,7,7,GTGTGCCCAAGATTAGCTCT,0,1750811
gyrAp,0.125,7,7,GTGACGAACCGGACGTTTTC,0,1745233
gyrAp,0.125,7,7,GTCTCGCGCGATGGGATTGA,0,1754726
gyrAp,0.125,7,7,GTCGAGAGCCATATGCATTG,0,1767094
gyrAp,0.125,7,7,GTCCGTCCAGGAGAAACAGC,0,1757530
gyrAp,0.125,7,7,GTCATAACGCGTAAGTTGGA,0,1750298
gyrAp,0.125,7,7,GTCACGGGATTTTCGGGGAA,0,1762796
gyrAp,0.125,7,7,GTCAACTTGGCACTAACTCA,0,1756887
gyrAp,0.125,7,7,GTATTGGGTTCCTAAAGATT,0,1744418
gyrAp,0.125,7,7,GTATTCACTACAGCAGAATC,0,1761858
gyrAp,0.125,7,7,GTATGCTAACTTCCTCTGGC,0,1746509
gyrAp,0.125,7,7,GTAGGAGCCGATCCGAGACC,0,1745226
gyrAp,0.125,7,7,GTAGCTTTAGGCGCCTCCCG,0,1770529
gyrAp,0.125,7,7,GTACAAGTGTACCAGGCAAA,0,1755273
gyrAp,0.125,7,7,GGTTGTTCGACACGACAGAA,0,1758504
gyrAp,0.125,7,7,GGTTGATAGTTCAAGGTGCA,0,1765224
gyrAp,0.125,7,7,GGTGGACATGCAAGACTGCA,0,1759740
gyrAp,0.125,7,7,GGTGAGTTTTATGGTGGCAG,0,1755227
gyrAp,0.125,7,7,GGTCAAGCGCTTCTGCAAAT,0,1758720
gyrAp,0.125,7,7,GGTAGACTCCCACCGTTGGG,0,1756413
gyrAp,0.125,7,7,GGTACCAATTCTTGAACGAT,0,1749544
gyrAp,0.125,7,7,GGTACACCGACTTTATATCG,0,1746124
gyrAp,0.125,7,7,GGGTGGACATGCTCTTAAGC,0,1744246
gyrAp,0.125,7,7,GGGTGCATGCCGTTATGGTA,0,1763859
gyrAp,0.125,7,7,GGGTAGCTGGACATCATATT,0,1744294
gyrAp,0.125,7,7,GGGTACAAGGGCGGAGGTTT,0,1756368
gyrAp,0.125,7,7,GGGCTTCTGCACGGGCTGGT,0,1743259
gyrAp,0.125,7,7,GGGCGCTAGCAGACATAGGT,0,1762986
gyrAp,0.125,7,7,GGGACAGCAGTTGTCTTTTT,0,1744742
gyrAp,0.125,7,7,GGCGCAAGATGGAGTGAGTG,0,1746063
gyrAp,0.125,7,7,GGCGAATGACACGAACCGCG,0,1757606
gyrAp,0.125,7,7,GGATTTGAATTATGGGGTGT,0,1768578
gyrAp,0.125,7,7,GGATTATAGCTGGTTTCCTC,0,1744936
gyrAp,0.125,7,7,GGAGGGTATCCGCAGGTGTA,0,1745303
gyrAp,0.125,7,7,GCTCATCTGTACATCTCTTA,0,1759492
gyrAp,0.125,7,7,GCTAGTAGAGACGGTCCCAT,0,1770489
gyrAp,0.125,7,7,GCTAGACGTATAAGCGCGGT,0,1761310
gyrAp,0.125,7,7,GCGTTTTCAAGTTACAGTTT,0,1753601
gyrAp,0.125,7,7,GCGTGGGAGCCCTCCAGCAA,0,1753398
gyrAp,0.125,7,7,GCGGACACGGCGCCTGGCAT,0,1759824
gyrAp,0.125,7,7,GCCTGTGTCGATCTCCGAGG,0,1759710
gyrAp,0.125,7,7,GCCCCAGGCAACCAGGAAGG,0,1745331
gyrAp,0.125,7,7,GCATTCAAGAGTAAGGCCTA,0,1747994
gyrAp,0.125,7,7,GCAGGGTTGTATCTAGACTG,0,1756540
gyrAp,0.125,7,7,GCACGTATTGTGGTCTTGGA,0,1761307
gyrAp,0.125,7,7,GCAAGTCGATTTGACCGAGT,0,1761349
gyrAp,0.125,7,7,GCAAGCCCTGCAAACGATCC,0,1747771
gyrAp,0.125,7,7,GCAACGGTCGTTTTTTCGTT,0,1752912
gyrAp,0.125,7,7,GCAAATTCAGCTGAGCTAGG,0,1767353
gyrAp,0.125,7,7,GATGGGGATCGTATTAGAAC,0,1765340
gyrAp,0.125,7,7,GATATCGGCCCCGATTCCCA,0,1761696
gyrAp,0.125,7,7,GATAACCGCATGAGTGCGTA,0,1743559
gyrAp,0.125,7,7,GAGTCTCTGAAGATGGGACG,0,1751136
gyrAp,0.125,7,7,GAGCGACTGGGCTTTTATAT,0,1754341
gyrAp,0.125,7,7,GACGCAATCCGGATCATCCG,0,1755692
gyrAp,0.125,7,7,GAATCAGCCGACCTTTGGGA,0,1760556
gyrAp,0.125,7,7,GAAGTGGCAAGTCGCGCGGT,0,1766929
gyrAp,0.125,7,7,CTTTGCAATAATTTATTGTT,0,1743021
gyrAp,0.125,7,7,CTTTGAACGGCCACGTAATA,0,1745522
gyrAp,0.125,7,7,CTGTTCGGTGCCTGGCTAGT,0,1744273
gyrAp,0.125,7,7,CTGTGCGCGACAGCGTGTGT,0,1761025
gyrAp,0.125,7,7,CTGTCCACTAAACACTGTAA,0,1763373
gyrAp,0.125,7,7,CTGGTTCCAGGCGTCTTACA,0,1747141
gyrAp,0.125,7,7,CTGGGACCCCAGATCCAACT,0,1753999
gyrAp,0.125,7,7,CTGGCCCAAGGAGGTTGAGT,0,1768130
gyrAp,0.125,7,7,CTGGATAAATGTGTGGGGTT,0,1767187
gyrAp,0.125,7,7,CTGCATAGGGTGGTATGTTC,0,1746714
gyrAp,0.125,7,7,CTCTAGCCACACCCGTCTCC,0,1751388
gyrAp,0.125,7,7,CTCGTTCGGCCACGTAATTA,0,1753286
gyrAp,0.125,7,7,CTCGGCAGAGAGATCCGCCT,0,1749866
gyrAp,0.125,7,7,CTCAGGATGAGGCACCTTTT,0,1750089
gyrAp,0.125,7,7,CTCACTCCAAAATCAGCGAG,0,1768917
gyrAp,0.125,7,7,CGTTCCGCTTTTAATCGTAG,0,1756774
gyrAp,0.125,7,7,CGTTAATCCCGCGGTAACAC,0,1751701
gyrAp,0.125,7,7,CGTGGCGGGCGTGTGTTACT,0,1761152
gyrAp,0.125,7,7,CGTCGGGATCACCTCAAGCA,0,1744950
gyrAp,0.125,7,7,CGTCGCTCTGGGTACGGGAT,0,1761541
gyrAp,0.125,7,7,CGTCCTGAAATGTCTCTACA,0,1762489
gyrAp,0.125,7,7,CGTATTCATTGGAGACATAA,0,1762438
gyrAp,0.125,7,7,CGTATAATGATAAGTAATGC,0,1746968
gyrAp,0.125,7,7,CGTACGTCATCGCCAATTCA,0,1764517
gyrAp,0.125,7,7,CGTAACCCAATAGCTGTTAC,0,1754446
gyrAp,0.125,7,7,CGGTAACGTGGACAGACGTT,0,1765933
gyrAp,0.125,7,7,CGGGGTGCCTAAACCGATGA,0,1761996
gyrAp,0.125,7,7,CGGGGAAGTTATAACAAACC,0,1743763
gyrAp,0.125,7,7,CGGCTGCCTAAGCGGACACA,0,1752378
gyrAp,0.125,7,7,CGGCCCAGTTAATGGATGCA,0,1766803
gyrAp,0.125,7,7,CGGAAAATTTTTCTTGCTTT,0,1746406
gyrAp,0.125,7,7,CGCTACTATATCCCCGGGGT,0,1760088
gyrAp,0.125,7,7,CGCGGTAGCCGTTGCGTGAG,0,1745287
gyrAp,0.125,7,7,CGCGGCACATACGGCTTTTT,0,1754739
gyrAp,0.125,7,7,CGCCATCATCGGCTCTACGA,0,1767060
gyrAp,0.125,7,7,CGCCACTTCCCTTCTTATAC,0,1768097
gyrAp,0.125,7,7,CGCAGACGGCCCCCCGTAGG,0,1756320
gyrAp,0.125,7,7,CGCACTGATCTACGCGCATC,0,1758636
gyrAp,0.125,7,7,CGCAAGCGACAGGTCGGTAA,0,1745545
gyrAp,0.125,7,7,CGAGTGCAGCAAGTTCGTGC,0,1747031
gyrAp,0.125,7,7,CGAGCAGACGGCGCGTTTGG,0,1743863
gyrAp,0.125,7,7,CGAAGTGGTTCGTATGGTCG,0,1753604
gyrAp,0.125,7,7,CCTGAACCCAGTGACCGCTC,0,1751893
gyrAp,0.125,7,7,CCTCGCTATCCTGATCCTTT,0,1743496
gyrAp,0.125,7,7,CCTAGTCTAAGGAGCGTAAG,0,1770115
gyrAp,0.125,7,7,CCTACAGTCGAGTCAGAACT,0,1765867
gyrAp,0.125,7,7,CCGGTCTTCAATTATTCATG,0,1753203
gyrAp,0.125,7,7,CCGGTATGCACCGTGACTTC,0,1752525
gyrAp,0.125,7,7,CCGGGGTAAGAACAGGATGG,0,1741634
gyrAp,0.125,7,7,CCGCTATGATCTCGAGTTGG,0,1768388
gyrAp,0.125,7,7,CCGCGCGGTGGGTTATTAGA,0,1748468
gyrAp,0.125,7,7,CCGATTCTTTGGGAGCAGGA,0,1770612
gyrAp,0.125,7,7,CCGACGTCCGGCCACGCATA,0,1743963
gyrAp,0.125,7,7,CCCGCTGTCCGGTGATCTTA,0,1763075
gyrAp,0.125,7,7,CCATCAGTGAAAAGAGCTCC,0,1765922
gyrAp,0.125,7,7,CCAAGACCCGTCATAAGCAT,0,1765400
gyrAp,0.125,7,7,CATTTTGGAGTCGGCCTTCA,0,1768758
gyrAp,0.125,7,7,CATTAGATTGCAGCGTTGTA,0,1756347
gyrAp,0.125,7,7,CATCCTGTTCGACGGATGAG,0,1756840
gyrAp,0.125,7,7,CATATTCTAAATAAGCGTTC,0,1743897
gyrAp,0.125,7,7,CATATGTCGGCAAAAACGGT,0,1770071
gyrAp,0.125,7,7,CAGTCCGTCGTACTCACCCG,0,1751869
gyrAp,0.125,7,7,CAGGGAACACCTTCAACACA,0,1761497
gyrAp,0.125,7,7,CAGGACTGGCTTTGGATCGT,0,1757981
gyrAp,0.125,7,7,CAGAGGGGCATATTTGTACA,0,1768987
gyrAp,0.125,7,7,CAGAAGGCTTTTGCAACTCA,0,1764932
gyrAp,0.125,7,7,CACTCCCGTAGTGCCTAGTT,0,1766530
gyrAp,0.125,7,7,CACCTGAGCAGCGCCCATCT,0,1764672
gyrAp,0.125,7,7,CACCGACCCGGAAAACCGTA,0,1762715
gyrAp,0.125,7,7,CACAACCTGAAAAGATTAGG,0,1757265
gyrAp,0.125,7,7,CAAGACAAGGGGGACGCTCA,0,1753638
gyrAp,0.125,7,7,CAACCCGCGAGCACCGGGCA,0,1747367
gyrAp,0.125,7,7,CAAAGACCCGATTGAGATGT,0,1758567
gyrAp,0.125,7,7,CAAACGTAACTGAGGGAGAC,0,1744809
gyrAp,0.125,7,7,ATTGCGGCCGTAAGGAGGTT,0,1767215
gyrAp,0.125,7,7,ATTGAGTCGTTGTGTCTGGA,0,1746224
gyrAp,0.125,7,7,ATGTCTGTGTGTGCCCTCCC,0,1746225
gyrAp,0.125,7,7,ATGTCATTGTGAGACGGACT,0,1748612
gyrAp,0.125,7,7,ATCCTTAATGTGGCAAAATT,0,1763423
gyrAp,0.125,7,7,ATCCTCTAGCGAACGGTGGC,0,1745515
gyrAp,0.125,7,7,ATCATGGCTCAATGGATCTT,0,1754528
gyrAp,0.125,7,7,ATCAGTCAGTGCCAAACCAA,0,1755733
gyrAp,0.125,7,7,ATCAATATTAGTGGTGTTGG,0,1762335
gyrAp,0.125,7,7,ATATGGCCAAATGTGGGTCC,0,1750141
gyrAp,0.125,7,7,ATAGTCATACTTACATAGAC,0,1766263
gyrAp,0.125,7,7,ATACGTTGTCGGTGAGGCCA,0,1763798
gyrAp,0.125,7,7,AGTTGGACCATGGAGTCCAT,0,1741936
gyrAp,0.125,7,7,AGTGAAGTCTGATACACACC,0,1752322
gyrAp,0.125,7,7,AGTCTCATTCTGTCCAGGGA,0,1755366
gyrAp,0.125,7,7,AGTCATTCCCACCGATGATA,0,1753094
gyrAp,0.125,7,7,AGTCAAGTACAAGAACCCAG,0,1768623
gyrAp,0.125,7,7,AGTAGGCCGAATAAGCGATC,0,1766312
gyrAp,0.125,7,7,AGTAGAGTTTTTCCTTTTCC,0,1750728
gyrAp,0.125,7,7,AGTAACGGGTACCCCACTAT,0,1756681
gyrAp,0.125,7,7,AGGTCGGATTACCCGCGAGC,0,1752915
gyrAp,0.125,7,7,AGGTACAGGCTCAGAGGGTT,0,1759787
gyrAp,0.125,7,7,AGGGGCCAGGGTGGTATATG,0,1750691
gyrAp,0.125,7,7,AGGGATTTTTGAAGAAATGT,0,1743019
gyrAp,0.125,7,7,AGGGACCTTGGGGAGGGATA,0,1760140
gyrAp,0.125,7,7,AGAGTGGACACCAGTACCCC,0,1748596
gyrAp,0.125,7,7,AGACCGCCCTCTTGCGACAG,0,1742616
gyrAp,0.125,7,7,AGACCAGTTGTTTGATCTCA,0,1747743
gyrAp,0.125,7,7,AGACACCTTGTACCTCATTT,0,1760835
gyrAp,0.125,7,7,AGAAGGCGCCTCCGGAATAT,0,1759926
gyrAp,0.125,7,7,AGAACGAGAAAGCTGTTGAT,0,1749443
gyrAp,0.125,7,7,ACTTATTTGTTGACGGTATA,0,1755319
gyrAp,0.125,7,7,ACTCTGTCAAGGGCGGTCGC,0,1753735
gyrAp,0.125,7,7,ACGTTGCTATTTTACAGCAG,0,1748672
gyrAp,0.125,7,7,ACGGTAAATCTGTTTGCAGG,0,1754000
gyrAp,0.125,7,7,ACGGAGGAAGCCGATTCGCT,0,1752362
gyrAp,0.125,7,7,ACGAATTCAGATGAAACTTC,0,1756885
gyrAp,0.125,7,7,ACCTTGCTCGGTCGGACTGT,0,1756656
gyrAp,0.125,7,7,ACCGTCAAAATGTAAGCGCT,0,1757364
gyrAp,0.125,7,7,ACCCTGTAAAGGCCAAACTG,0,1760758
gyrAp,0.125,7,7,ACCCCTTTCTATACTGCACC,0,1744937
gyrAp,0.125,7,7,ACCAACAATTAACGGGTTGA,0,1767867
gyrAp,0.125,7,7,ACATCATTGCGATTGCAGTC,0,1763603
gyrAp,0.125,7,7,ACAGTAAGTTTACTAGGTCG,0,1741665
gyrAp,0.125,7,7,ACACCCTACATAATGTTTCT,0,1746034
gyrAp,0.125,7,7,ACAATGTACGTGGCCACACT,0,1752271
gyrAp,0.125,7,7,ACAAATTCTTAGCCGTTGAC,0,1745866
gyrAp,0.125,7,7,AATTTGAGCATAAAGTAAAA,0,1752270
gyrAp,0.125,7,7,AATTGGAAAAGGGATCCTAA,0,1766387
gyrAp,0.125,7,7,AATCTCGGTTTCAAATCCGT,0,1755341
gyrAp,0.125,7,7,AATCATATTTACGGTCAGTA,0,1745489
gyrAp,0.125,7,7,AATCACGATTGTCTGAGACA,0,1763000
gyrAp,0.125,7,7,AATACAGCCTTCGTCCAGAA,0,1742021
gyrAp,0.125,7,7,AAGTTCAATCCCGGTGGTAG,0,1766323
gyrAp,0.125,7,7,AAGCTAACAGTAACGCGATC,0,1755499
gyrAp,0.125,7,7,AAGCAAGGGGGGGGGGGACG,0,1750203
gyrAp,0.125,7,7,AAGATTCTCATATCTACGTA,0,1742502
gyrAp,0.125,7,7,AAGAGTCGTGGTCGGCAGCG,0,1761461
gyrAp,0.125,7,7,AACGGCTTGCTCATCCGTCT,0,1761389
gyrAp,0.125,7,7,AACATGATATTAGTAATGAC,0,1751696
gyrAp,0.125,7,7,AAAGTATGTACTCATGCTTC,0,1761460
gyrAp,0.125,7,7,AAAGTAAAGGCGCTTGTTTG,0,1754330
gyrAp,0.125,7,7,AAAGGTAACACGACAGGTAT,0,1743317
gyrAp,0.125,7,7,AAAGCACGGGTTGCAAGCCG,0,1758101
gyrAp,0.125,7,7,AAACTGATGATCGTCGAAGT,0,1744994
gyrAp,0.125,7,7,AAAAGTATTGGTTAATGTCA,0,1764534
gyrAp,0.125,7,7,AAAAGGCCAAATAATTTTAA,0,1747305
gyrAp,0.14285714285714285,6,6,TTTGTACCTCTACGCGAGGT,0,1744244
gyrAp,0.14285714285714285,6,6,TTTAGACCGCACACTTATAG,0,1746558
gyrAp,0.14285714285714285,6,6,TTGTGGGCTCGAGCAGATTA,0,1770881
gyrAp,0.14285714285714285,6,6,TTGTCACCCTATTACAAGGA,0,1754439
gyrAp,0.14285714285714285,6,6,TTGGGACACAGCAGCCACTA,0,1765012
gyrAp,0.14285714285714285,6,6,TTGGACTCCAATAGCAGAGA,0,1757945
gyrAp,0.14285714285714285,6,6,TTGGAACTTTGCGAGAGTGA,0,1752495
gyrAp,0.14285714285714285,6,6,TTGCAACACGGCGCGTAACC,0,1754835
gyrAp,0.14285714285714285,6,6,TTGATCTCTTACGGTGTTGC,0,1745972
gyrAp,0.14285714285714285,6,6,TTGAGGGTTGCTAAATCGCG,0,1749467
gyrAp,0.14285714285714285,6,6,TTGACTAGGCTTGAACAGTG,0,1761116
gyrAp,0.14285714285714285,6,6,TTCTTAAGTCATATGTCGCA,0,1747540
gyrAp,0.14285714285714285,6,6,TTCTGGGATCCTCTTCCTTG,0,1769775
gyrAp,0.14285714285714285,6,6,TTCAATTATATCAGCTCGGA,0,1762312
gyrAp,0.14285714285714285,6,6,TTATCATGTCGGTATGTGGA,0,1741467
gyrAp,0.14285714285714285,6,6,TTAGCTCTGCTGCAACATCA,0,1767017
gyrAp,0.14285714285714285,6,6,TTAGACCGTAAAGTACTCTA,0,1750815
gyrAp,0.14285714285714285,6,6,TTAGAATATAATTTGAACTT,0,1762727
gyrAp,0.14285714285714285,6,6,TTACTTAAATGGTTCCCGAG,0,1743720
gyrAp,0.14285714285714285,6,6,TTACGCTCAATACGGTGCGT,0,1749440
gyrAp,0.14285714285714285,6,6,TTACGAGGATAGTCAAGTTA,0,1745984
gyrAp,0.14285714285714285,6,6,TTACCATTAGGTCAGCAGAT,0,1757193
gyrAp,0.14285714285714285,6,6,TGTTACGGCAGTCCAGACAG,0,1748465
gyrAp,0.14285714285714285,6,6,TGTGAGTTATTTCTTATCCA,0,1757885
gyrAp,0.14285714285714285,6,6,TGGTCGTGCTTAGAGAGGAA,0,1748358
gyrAp,0.14285714285714285,6,6,TGGGTCCCGTACGTCGTTCT,0,1748085
gyrAp,0.14285714285714285,6,6,TGGCATGGGAAAAGGAGGAC,0,1762207
gyrAp,0.14285714285714285,6,6,TGGAGGTTATAAGCGTAGCG,0,1744510
gyrAp,0.14285714285714285,6,6,TGCTTATGTTTGTTTTGCGG,0,1743793
gyrAp,0.14285714285714285,6,6,TGCGTAAAGTAATGTTCGTA,0,1764772
gyrAp,0.14285714285714285,6,6,TGCGCTTGGTAGGAACACTA,0,1763688
gyrAp,0.14285714285714285,6,6,TGCAACCTGTACCGGTCCAC,0,1745488
gyrAp,0.14285714285714285,6,6,TGCAAAGGCATTTGGACGGA,0,1767198
gyrAp,0.14285714285714285,6,6,TGATCAGTATGAGGTCCCGA,0,1770201
gyrAp,0.14285714285714285,6,6,TGATAGTTGTTCAAAAAAGG,0,1748369
gyrAp,0.14285714285714285,6,6,TGAGGACAGGACACAAGACT,0,1757773
gyrAp,0.14285714285714285,6,6,TGACATTGTATAATAAGCAA,0,1750767
gyrAp,0.14285714285714285,6,6,TGAATTAGTAGCATAAAATA,0,1745667
gyrAp,0.14285714285714285,6,6,TGAATCTATGTTGCGGGGTG,0,1760816
gyrAp,0.14285714285714285,6,6,TCTCGGGAAGACCGAACTGT,0,1758258
gyrAp,0.14285714285714285,6,6,TCTCGGATTTGGCTGTTCGG,0,1751513
gyrAp,0.14285714285714285,6,6,TCTCCAGCAGTGCCGCGGTT,0,1751832
gyrAp,0.14285714285714285,6,6,TCTCAAAGTCGCCAAAAGCA,0,1760049
gyrAp,0.14285714285714285,6,6,TCGTAACTCCATGGGTTTAC,0,1770042
gyrAp,0.14285714285714285,6,6,TCGGGTGTGAAGAGGGCGCT,0,1742351
gyrAp,0.14285714285714285,6,6,TCGCGAACACAACCCCGACC,0,1748664
gyrAp,0.14285714285714285,6,6,TCGCATTCTTACGGAACTGT,0,1749960
gyrAp,0.14285714285714285,6,6,TCGCACCCGTCAGACGCCCT,0,1753597
gyrAp,0.14285714285714285,6,6,TCGACGGGATGGAATTTGGA,0,1761797
gyrAp,0.14285714285714285,6,6,TCCGGTTGTAATACCGTCAT,0,1766860
gyrAp,0.14285714285714285,6,6,TCCCGATTCACTTGCTAAGA,0,1762133
gyrAp,0.14285714285714285,6,6,TCCAGAGCTTCCTACAATAT,0,1745368
gyrAp,0.14285714285714285,6,6,TCCACCTTTTCCAAGTGGAG,0,1752211
gyrAp,0.14285714285714285,6,6,TCAGGCCTGTGTCCAGGTAA,0,1755196
gyrAp,0.14285714285714285,6,6,TCACGGCAAAAGGGCTGTAC,0,1743736
gyrAp,0.14285714285714285,6,6,TCAAGTAAGGTTCCACCGCT,0,1748590
gyrAp,0.14285714285714285,6,6,TCAAATGGAATGGCCACGTT,0,1758291
gyrAp,0.14285714285714285,6,6,TCAAAGCAATAATCTAACTA,0,1751762
gyrAp,0.14285714285714285,6,6,TCAAAAGTAACCGTTGTTCA,0,1766735
gyrAp,0.14285714285714285,6,6,TCAAAAAGACCCCAGGCCGG,0,1745298
gyrAp,0.14285714285714285,6,6,TATGGTAGCGTTGAAGTAAA,0,1748637
gyrAp,0.14285714285714285,6,6,TATAAATCTAAATGTGTTCG,0,1770766
gyrAp,0.14285714285714285,6,6,TAGGCAGCCGAGACAAAGTC,0,1753688
gyrAp,0.14285714285714285,6,6,TAGCGTGCTTCGAAACGGCT,0,1750499
gyrAp,0.14285714285714285,6,6,TAGCCAATGAAAGCGGGTGT,0,1750199
gyrAp,0.14285714285714285,6,6,TAGCATCCGGGTCCTTAGGT,0,1751071
gyrAp,0.14285714285714285,6,6,TAGATGTGCGATCGACGTGG,0,1743964
gyrAp,0.14285714285714285,6,6,TACGCGCAATGGCAAAGGTG,0,1755094
gyrAp,0.14285714285714285,6,6,TACCTTGGCCACGTTTTGTG,0,1764792
gyrAp,0.14285714285714285,6,6,TACCTAATTTAACCTGCGTA,0,1765511
gyrAp,0.14285714285714285,6,6,TACATCTTCCTAGCCACAAG,0,1744242
gyrAp,0.14285714285714285,6,6,TACAGATGTATCCTGTGCGA,0,1762414
gyrAp,0.14285714285714285,6,6,TAAGATCTTGCGATGGTCTT,0,1762089
gyrAp,0.14285714285714285,6,6,TAAGAGGACCCGGGAGTGCA,0,1755616
gyrAp,0.14285714285714285,6,6,TAACGTATGGGTACACGTGT,0,1754449
gyrAp,0.14285714285714285,6,6,TAACGCCTGAAGATTGACGA,0,1754241
gyrAp,0.14285714285714285,6,6,TAAATCCCGTCTACTATGCA,0,1743280
gyrAp,0.14285714285714285,6,6,TAAATAATTGGTAAAGTAAA,0,1750184
gyrAp,0.14285714285714285,6,6,TAAACGGGTCAATCTCTTAA,0,1768638
gyrAp,0.14285714285714285,6,6,GTTGGCTTACGGGTTCTTTC,0,1756439
gyrAp,0.14285714285714285,6,6,GTTCTGCACGTGAGACCGCG,0,1756739
gyrAp,0.14285714285714285,6,6,GTTCTCGGCTACTGCTAATT,0,1748638
gyrAp,0.14285714285714285,6,6,GTTATATGCCACGGCCACGT,0,1759034
gyrAp,0.14285714285714285,6,6,GTTACTCCCACCCCGGAAGT,0,1767521
gyrAp,0.14285714285714285,6,6,GTGTTTCTACGTATAATGGG,0,1761351
gyrAp,0.14285714285714285,6,6,GTGGAGTATCCTGGATTTGT,0,1769806
gyrAp,0.14285714285714285,6,6,GTCGAACAATCTCCGCCCTT,0,1755473
gyrAp,0.14285714285714285,6,6,GTCACACACCGCTTGGGCCT,0,1761015
gyrAp,0.14285714285714285,6,6,GTCAAGTTACGTGTTGGGAA,0,1756447
gyrAp,0.14285714285714285,6,6,GTAGGATCTGCAACTCCGCA,0,1749737
gyrAp,0.14285714285714285,6,6,GTAGATGTTCCGAGCTGGTA,0,1755656
gyrAp,0.14285714285714285,6,6,GTAGAATGCTTGACCAAAGG,0,1744539
gyrAp,0.14285714285714285,6,6,GTAAGGACTCAGGACTTGCT,0,1744669
gyrAp,0.14285714285714285,6,6,GTAAGCTAATGCCCCGGTAT,0,1769028
gyrAp,0.14285714285714285,6,6,GTAACTCCTAAGATACGCGT,0,1762185
gyrAp,0.14285714285714285,6,6,GGTTTATTTTATCTGCCTAC,0,1748111
gyrAp,0.14285714285714285,6,6,GGTTGAAACGTTCATGATCA,0,1767111
gyrAp,0.14285714285714285,6,6,GGTTCACCGTCTGAGACTAA,0,1759571
gyrAp,0.14285714285714285,6,6,GGTTAGAGAGTACGTCGCCA,0,1763692
gyrAp,0.14285714285714285,6,6,GGTTACGGCAGGACCGTCGT,0,1751781
gyrAp,0.14285714285714285,6,6,GGTAATTGAGAATGTCTCAG,0,1749614
gyrAp,0.14285714285714285,6,6,GGGGTTGTAAGCCATCTTCC,0,1756963
gyrAp,0.14285714285714285,6,6,GGGGGTACTTGCGCTGGGAG,0,1762160
gyrAp,0.14285714285714285,6,6,GGGGCTTTTGCACAGTTGCG,0,1765622
gyrAp,0.14285714285714285,6,6,GGGGCTTACACCTGACAGGA,0,1752247
gyrAp,0.14285714285714285,6,6,GGGAGACAGAGAGGCATATC,0,1742995
gyrAp,0.14285714285714285,6,6,GGCTAGACTATCGCGAGTAC,0,1751182
gyrAp,0.14285714285714285,6,6,GGCAACTGAGGGACTGGTGG,0,1760364
gyrAp,0.14285714285714285,6,6,GGATTGGAAAACTTAGGTTT,0,1755726
gyrAp,0.14285714285714285,6,6,GGATGTCCCCGCGAGAACTT,0,1747571
gyrAp,0.14285714285714285,6,6,GGATGGCCCAGCTGTGAGCA,0,1749819
gyrAp,0.14285714285714285,6,6,GGATGAAGTGAGCACCGTTT,0,1744212
gyrAp,0.14285714285714285,6,6,GGATAGTCCCCCAGCGCAAG,0,1751474
gyrAp,0.14285714285714285,6,6,GGAGCCTAAGGCCCATATTT,0,1753799
gyrAp,0.14285714285714285,6,6,GCTGCTGCGGCTGATCATCG,0,1760131
gyrAp,0.14285714285714285,6,6,GCTCACCTTCTAGGGCTTAG,0,1743246
gyrAp,0.14285714285714285,6,6,GCTACTGGTACTCTAAGGTC,0,1742512
gyrAp,0.14285714285714285,6,6,GCCGCGGGGCTTTAATTCTG,0,1751956
gyrAp,0.14285714285714285,6,6,GCCACAAGCGTACGTCGGAC,0,1762634
gyrAp,0.14285714285714285,6,6,GCATTAGGTATATCTACAAT,0,1769064
gyrAp,0.14285714285714285,6,6,GCATTACCCCGAAAACATGG,0,1746404
gyrAp,0.14285714285714285,6,6,GCATGCCCGAGAATAATCGT,0,1746985
gyrAp,0.14285714285714285,6,6,GCAGGGATCCTCTCAATCAC,0,1749149
gyrAp,0.14285714285714285,6,6,GATTGAAACATTATTCAAGT,0,1766254
gyrAp,0.14285714285714285,6,6,GATGTCCCATGGTTATGGTA,0,1742290
gyrAp,0.14285714285714285,6,6,GATGGGGGATTGCCCGAAGT,0,1758506
gyrAp,0.14285714285714285,6,6,GATCGTTCTGGGGGCGATGC,0,1744513
gyrAp,0.14285714285714285,6,6,GATCGCAGGGCTTTTCGGTA,0,1757891
gyrAp,0.14285714285714285,6,6,GATATTCGACTGGACCTCGT,0,1743775
gyrAp,0.14285714285714285,6,6,GAGTCCACCATAACGTGTCC,0,1743828
gyrAp,0.14285714285714285,6,6,GAGCTGTTGCTCGCGTATTC,0,1744363
gyrAp,0.14285714285714285,6,6,GAGCACCCGTCGCTGGGATG,0,1757605
gyrAp,0.14285714285714285,6,6,GACTACCCTCTAACGAGCGA,0,1748406
gyrAp,0.14285714285714285,6,6,GACAATAGATAAACCTGCGG,0,1748748
gyrAp,0.14285714285714285,6,6,GAAGGGATATTTCTTAATGT,0,1768153
gyrAp,0.14285714285714285,6,6,GAAGCCCTAAGTGTCCCGTT,0,1761422
gyrAp,0.14285714285714285,6,6,GAAGAAGAGGCGATTTGCCC,0,1763532
gyrAp,0.14285714285714285,6,6,GAAATGCTTATTCGTGACGT,0,1769558
gyrAp,0.14285714285714285,6,6,GAAAGTCGCGGTCCCGACTC,0,1756304
gyrAp,0.14285714285714285,6,6,CTTTTGGTGTTGACTTCTGG,0,1741515
gyrAp,0.14285714285714285,6,6,CTTTCATACGATCGAGCAAA,0,1749344
gyrAp,0.14285714285714285,6,6,CTTGGCATGAAGTACAGATC,0,1744754
gyrAp,0.14285714285714285,6,6,CTTCTGTTGTCTTAGGTTTA,0,1741980
gyrAp,0.14285714285714285,6,6,CTTCTGCGTGTAGAACGGGT,0,1747297
gyrAp,0.14285714285714285,6,6,CTTCGTAAGTTCATGAATCA,0,1744061
gyrAp,0.14285714285714285,6,6,CTTCCGGGGATGATGATGGG,0,1755536
gyrAp,0.14285714285714285,6,6,CTGTCTACCGGAGATACAGT,0,1742728
gyrAp,0.14285714285714285,6,6,CTGGTTTGCCGGAATCTGGT,0,1749241
gyrAp,0.14285714285714285,6,6,CTGGTTAGAAAGTTCTTTAT,0,1761687
gyrAp,0.14285714285714285,6,6,CTGGTAACTGATTGGAAGCA,0,1750409
gyrAp,0.14285714285714285,6,6,CTGACTGACGCGGACTGCTG,0,1751268
gyrAp,0.14285714285714285,6,6,CTGAAAAGGGAGAAAAGCTA,0,1744706
gyrAp,0.14285714285714285,6,6,CTCGCTCCCCGTTAGCCCTT,0,1766481
gyrAp,0.14285714285714285,6,6,CTCGCCGTACGACACTCCTC,0,1749671
gyrAp,0.14285714285714285,6,6,CTATTCCCTACAGTTTCGAA,0,1746616
gyrAp,0.14285714285714285,6,6,CTATGTGCAAAATCTGGTAC,0,1765919
gyrAp,0.14285714285714285,6,6,CTAGTCGGTGATAGCGGACT,0,1762509
gyrAp,0.14285714285714285,6,6,CTAGAATGAGGCAGTCACAA,0,1742672
gyrAp,0.14285714285714285,6,6,CTACTTTCTTCTGGCCACAC,0,1750440
gyrAp,0.14285714285714285,6,6,CTACTAATAGTCAACTTTAA,0,1767810
gyrAp,0.14285714285714285,6,6,CTACGTGGGTGAATTTGGTT,0,1746601
gyrAp,0.14285714285714285,6,6,CTACGGCGAAGCGGAACTTG,0,1760040
gyrAp,0.14285714285714285,6,6,CTACGAATCGCCACTCCGCT,0,1759040
gyrAp,0.14285714285714285,6,6,CGTTTACAGCAATCCTGCAG,0,1769418
gyrAp,0.14285714285714285,6,6,CGTTCTACTGCACTGTCGCG,0,1745070
gyrAp,0.14285714285714285,6,6,CGTTATGTGAACAACCATGA,0,1748267
gyrAp,0.14285714285714285,6,6,CGTAGGGCCTACAATGACGA,0,1752090
gyrAp,0.14285714285714285,6,6,CGGTTTCTTGCGGGCGCGAA,0,1744796
gyrAp,0.14285714285714285,6,6,CGGCCACACAGGGCGACCTT,0,1766190
gyrAp,0.14285714285714285,6,6,CGGCAGTCCCTCATGTGGGC,0,1754968
gyrAp,0.14285714285714285,6,6,CGGCAACATCTTAGACATAT,0,1767057
gyrAp,0.14285714285714285,6,6,CGGAGCGATGTGGACAATCC,0,1762371
gyrAp,0.14285714285714285,6,6,CGGAATAGCACGCCGCGATT,0,1769470
gyrAp,0.14285714285714285,6,6,CGCTTGGTTCGTCACCCGCG,0,1765898
gyrAp,0.14285714285714285,6,6,CGCTGGAGGGACGAGTATCG,0,1764227
gyrAp,0.14285714285714285,6,6,CGCTCGAGTGCGTAGAGTCA,0,1760405
gyrAp,0.14285714285714285,6,6,CGCCATGAGTGGATGGTGCC,0,1741885
gyrAp,0.14285714285714285,6,6,CGACCCTTAGATGCGAAATA,0,1755349
gyrAp,0.14285714285714285,6,6,CGAAGTACGAGTCATGGCGG,0,1746668
gyrAp,0.14285714285714285,6,6,CGAAGCATAAGCTATACGGC,0,1759798
gyrAp,0.14285714285714285,6,6,CCTTGCAGATCTTCTGTGTT,0,1756158
gyrAp,0.14285714285714285,6,6,CCTGCGTTTATTTGCCGATG,0,1746410
gyrAp,0.14285714285714285,6,6,CCTCCGGCCTGAGTACGAGC,0,1746004
gyrAp,0.14285714285714285,6,6,CCGTTTCTTTCGGGGCGAGA,0,1744262
gyrAp,0.14285714285714285,6,6,CCGGTGACGCCTTCCGTCTA,0,1747855
gyrAp,0.14285714285714285,6,6,CCGCGTCGGCCTGTACTCAT,0,1761262
gyrAp,0.14285714285714285,6,6,CCCTAGCATGGGACCGTCCA,0,1746055
gyrAp,0.14285714285714285,6,6,CCCGCTTTTAGGTGCTGGGG,0,1752469
gyrAp,0.14285714285714285,6,6,CCCCCGAGGTAGCGCTGGTA,0,1753690
gyrAp,0.14285714285714285,6,6,CCCAATTCATAGCCTCTAGC,0,1760423
gyrAp,0.14285714285714285,6,6,CCCAATGGAATGAGGGTCGC,0,1755325
gyrAp,0.14285714285714285,6,6,CCCAAGTGGATAGCGTGGCG,0,1749245
gyrAp,0.14285714285714285,6,6,CCAGGTGTACACAACTGCAT,0,1750457
gyrAp,0.14285714285714285,6,6,CCACTCAGAGGATACAGCGG,0,1762032
gyrAp,0.14285714285714285,6,6,CCACATACGACTATTACGAA,0,1752534
gyrAp,0.14285714285714285,6,6,CCAACACACCGGTAGTTATG,0,1755823
gyrAp,0.14285714285714285,6,6,CATTTGCGATCTATACTTGC,0,1766022
gyrAp,0.14285714285714285,6,6,CATTTGCCGGAGTACATGGG,0,1741969
gyrAp,0.14285714285714285,6,6,CATTGCCGTAATGTGGGTGG,0,1753808
gyrAp,0.14285714285714285,6,6,CATTACCGTTCTAACCCTTA,0,1764208
gyrAp,0.14285714285714285,6,6,CATGGTGTGCACGTTATAGC,0,1743081
gyrAp,0.14285714285714285,6,6,CATGGTGGCTGACCGGTCCC,0,1759469
gyrAp,0.14285714285714285,6,6,CATGGCGGGCGTCTCCCATT,0,1746186
gyrAp,0.14285714285714285,6,6,CATCATCATCGGCATTTGAC,0,1748151
gyrAp,0.14285714285714285,6,6,CATCAGGGGACGGCGGATCA,0,1767609
gyrAp,0.14285714285714285,6,6,CATAGTTTTTTAGGGGCGCG,0,1764020
gyrAp,0.14285714285714285,6,6,CAGTTTGGGGGATAGCGACG,0,1748299
gyrAp,0.14285714285714285,6,6,CAGTAGGGTGCGACATCATG,0,1769612
gyrAp,0.14285714285714285,6,6,CAGTAAGGGGGTATGGAAGC,0,1760155
gyrAp,0.14285714285714285,6,6,CAGGTGTCTAGCTTAGATAG,0,1751129
gyrAp,0.14285714285714285,6,6,CAGGGTGGTAAGATAAGTAG,0,1745014
gyrAp,0.14285714285714285,6,6,CAGCGTGTCCCGCTATGTGC,0,1765984
gyrAp,0.14285714285714285,6,6,CAGAGAGTAGGAATGAGGTT,0,1741939
gyrAp,0.14285714285714285,6,6,CACTGGGACCATGATCGGGT,0,1748911
gyrAp,0.14285714285714285,6,6,CAATCACCTATTGCAGACGG,0,1753668
gyrAp,0.14285714285714285,6,6,CAAGTTCATACGATTAATCC,0,1745806
gyrAp,0.14285714285714285,6,6,CAACACGGTTAATAACTACC,0,1754372
gyrAp,0.14285714285714285,6,6,CAACACGGTCTTGATAATGC,0,1759054
gyrAp,0.14285714285714285,6,6,ATTTTTCGTATATGCACCAA,0,1757716
gyrAp,0.14285714285714285,6,6,ATTTCGTACGGTCTCGGCAA,0,1742265
gyrAp,0.14285714285714285,6,6,ATTGTACTCAGTTGCCAGTG,0,1760721
gyrAp,0.14285714285714285,6,6,ATTGGTGTAGACCTTTAAGA,0,1767042
gyrAp,0.14285714285714285,6,6,ATTCCGCAAGATCTACCCGA,0,1742921
gyrAp,0.14285714285714285,6,6,ATTCATGCACTCCGTGAGAG,0,1763030
gyrAp,0.14285714285714285,6,6,ATTCACACTGGCCTTGGAAA,0,1767851
gyrAp,0.14285714285714285,6,6,ATTATATTGTGGGGTAGATT,0,1749026
gyrAp,0.14285714285714285,6,6,ATTAGGCGTGCGGATACCCA,0,1762530
gyrAp,0.14285714285714285,6,6,ATTAGAGAGGGCGACATGGT,0,1754498
gyrAp,0.14285714285714285,6,6,ATGTTCTACCATTAGTGGCG,0,1745453
gyrAp,0.14285714285714285,6,6,ATGTCCGTTAGACGCACCTA,0,1759048
gyrAp,0.14285714285714285,6,6,ATGGACGGATCAGACGGTCT,0,1743872
gyrAp,0.14285714285714285,6,6,ATGCGGTATGACACGAAGGG,0,1741706
gyrAp,0.14285714285714285,6,6,ATGCCTCGCTGGCTTTGATA,0,1750130
gyrAp,0.14285714285714285,6,6,ATGCCGTCGTAAGTTTTAAC,0,1748491
gyrAp,0.14285714285714285,6,6,ATCGATCAAAAAATCACCTA,0,1755532
gyrAp,0.14285714285714285,6,6,ATCCGGAGGTCATGGCACCC,0,1748747
gyrAp,0.14285714285714285,6,6,ATATATCTAGGAAAACGCGC,0,1767055
gyrAp,0.14285714285714285,6,6,ATAGCACTTTGCCTCTCAAT,0,1754100
gyrAp,0.14285714285714285,6,6,ATACTACGACGTGCGAGGCA,0,1745404
gyrAp,0.14285714285714285,6,6,ATACCGAAGGTTGCAGCGAC,0,1753519
gyrAp,0.14285714285714285,6,6,ATAAGCGGTTCAAGCTCAGA,0,1753966
gyrAp,0.14285714285714285,6,6,AGTTCAGTCGGGGTAAATGG,0,1748830
gyrAp,0.14285714285714285,6,6,AGTTATCCGCTGAAAGCACA,0,1744256
gyrAp,0.14285714285714285,6,6,AGTCTGCTCGAACGGAGGAT,0,1751917
gyrAp,0.14285714285714285,6,6,AGTCTAGGAGTATCAAGCGT,0,1747669
gyrAp,0.14285714285714285,6,6,AGTCGCAGCAAAGACTGTTG,0,1766261
gyrAp,0.14285714285714285,6,6,AGTAGCAAAGACGGTCGGCG,0,1746888
gyrAp,0.14285714285714285,6,6,AGGTTTACATCGAGCTGTAA,0,1753978
gyrAp,0.14285714285714285,6,6,AGGTTAATCAGGTGATGTGA,0,1767227
gyrAp,0.14285714285714285,6,6,AGGTAAGCATTACATGAGAC,0,1766881
gyrAp,0.14285714285714285,6,6,AGGGTTGTCCATACTTTCAC,0,1754914
gyrAp,0.14285714285714285,6,6,AGGGTCCTAGCGGCCTGCTC,0,1754093
gyrAp,0.14285714285714285,6,6,AGGGGACCCAAATCTAGCAT,0,1754257
gyrAp,0.14285714285714285,6,6,AGGGCCGTAATCTAACTAGG,0,1757541
gyrAp,0.14285714285714285,6,6,AGGGCAGAATCGTCCGTACA,0,1741797
gyrAp,0.14285714285714285,6,6,AGCTGCCCCGGCTACAGTCC,0,1767465
gyrAp,0.14285714285714285,6,6,AGCTCCTTAGTTTCGCTTCT,0,1743058
gyrAp,0.14285714285714285,6,6,AGCTCAACATCCTGTTCAGT,0,1761590
gyrAp,0.14285714285714285,6,6,AGCTACGGCATCTTACCGTC,0,1758058
gyrAp,0.14285714285714285,6,6,AGCGGTTTACGGAAGCAACA,0,1751635
gyrAp,0.14285714285714285,6,6,AGCGAGGCATCAACAACTCA,0,1754918
gyrAp,0.14285714285714285,6,6,AGCCAGACTGTCTGGCGCTT,0,1751069
gyrAp,0.14285714285714285,6,6,AGCCACGATGTAGAAGCGGT,0,1759245
gyrAp,0.14285714285714285,6,6,AGATTCAAAGAAGTACCGGT,0,1747837
gyrAp,0.14285714285714285,6,6,AGATGTGGCATTGGTTCTAG,0,1755149
gyrAp,0.14285714285714285,6,6,AGATAATCTTTAAGAGCGAC,0,1759288
gyrAp,0.14285714285714285,6,6,AGAGCCAAACACCGCGATGG,0,1762590
gyrAp,0.14285714285714285,6,6,ACTTCAAGTGTCCATCGTAA,0,1752568
gyrAp,0.14285714285714285,6,6,ACTCTCACCTCACTGGTATT,0,1751999
gyrAp,0.14285714285714285,6,6,ACTCAGGAAATGCGTCTCGT,0,1743925
gyrAp,0.14285714285714285,6,6,ACTAAATGTTGCCACAATTT,0,1741876
gyrAp,0.14285714285714285,6,6,ACGTGCGCCGAGACTCAGGT,0,1742981
gyrAp,0.14285714285714285,6,6,ACGTCAACGTATCCAATGGG,0,1754334
gyrAp,0.14285714285714285,6,6,ACGGGTTGAGCCACAGATCG,0,1753551
gyrAp,0.14285714285714285,6,6,ACGACAAGTAATTTAGATTT,0,1748864
gyrAp,0.14285714285714285,6,6,ACCTAACTGTTCGGTCATGT,0,1762435
gyrAp,0.14285714285714285,6,6,ACCGGTAGTGCTCCGATACT,0,1762469
gyrAp,0.14285714285714285,6,6,ACCGCAGCATTTGGGGTTAG,0,1757671
gyrAp,0.14285714285714285,6,6,ACCCTAAGCTCGCTTTTGAG,0,1753954
gyrAp,0.14285714285714285,6,6,ACCATCGAGCTTGCCCCGTA,0,1756196
gyrAp,0.14285714285714285,6,6,ACCAAAGGAGCGACTGTGAA,0,1767226
gyrAp,0.14285714285714285,6,6,ACATCTGACAGGATGGGATA,0,1764056
gyrAp,0.14285714285714285,6,6,ACATAGATTGGACCGAAACT,0,1753149
gyrAp,0.14285714285714285,6,6,ACACTGCGCGTCCAGGGCCT,0,1753429
gyrAp,0.14285714285714285,6,6,ACAAGGACCTGGAGCATCTG,0,1765987
gyrAp,0.14285714285714285,6,6,AATTGTAAGTCGCTTTCTAA,0,1756468
gyrAp,0.14285714285714285,6,6,AATTCGGGATGTGCACATTG,0,1760421
gyrAp,0.14285714285714285,6,6,AATGGTGGGTAGAATTACAA,0,1756056
gyrAp,0.14285714285714285,6,6,AATGAATGTTATAGTAACGA,0,1759526
gyrAp,0.14285714285714285,6,6,AATCTAGGGCGGTTAAGTTG,0,1769107
gyrAp,0.14285714285714285,6,6,AATATGCTGCGAATGTCCAT,0,1761119
gyrAp,0.14285714285714285,6,6,AATAGGTACCATGTTCAGTG,0,1744026
gyrAp,0.14285714285714285,6,6,AATAGGGTACGACCCGTATT,0,1752023
gyrAp,0.14285714285714285,6,6,AATAAACACAAGAGCACACA,0,1763808
gyrAp,0.14285714285714285,6,6,AAGTTCCGCATGGAAAAGAT,0,1769345
gyrAp,0.14285714285714285,6,6,AAGTGGGTATCATGGTAAGA,0,1769228
gyrAp,0.14285714285714285,6,6,AAGTATAATGGGTGTAATAA,0,1742896
gyrAp,0.14285714285714285,6,6,AAGGGTCCATCTCGACTCGT,0,1757017
gyrAp,0.14285714285714285,6,6,AAGGGTATCCGTATCGTTCC,0,1762254
gyrAp,0.14285714285714285,6,6,AAGGGCACTGGTGAGGTTGA,0,1751277
gyrAp,0.14285714285714285,6,6,AAGAGATCCCAGACCAACGG,0,1766255
gyrAp,0.14285714285714285,6,6,AAGAACACGTCGGAGATACA,0,1763185
gyrAp,0.14285714285714285,6,6,AACCGGAATATATTCAGACA,0,1765946
gyrAp,0.14285714285714285,6,6,AACATCTTCCTTTAACATGG,0,1745814
gyrAp,0.14285714285714285,6,6,AAATCATAAGTCATAATTCT,0,1769138
gyrAp,0.14285714285714285,6,6,AAAGGCAGGTGTTGGCAGCG,0,1744174
gyrAp,0.14285714285714285,6,6,AAAGGAAACCCGTTACGCGG,0,1760180
gyrAp,0.14285714285714285,6,6,AAACTCCCTGCGGGCTGGCG,0,1768220
gyrAp,0.14285714285714285,6,6,AAACGTCCCAGATCAGTTGG,0,1747562
gyrAp,0.16666666666666666,5,5,TTTGCGCCCCACGGGTCGTT,0,1746438
gyrAp,0.16666666666666666,5,5,TTTCTGCAGCGGGACCTGTG,0,1743297
gyrAp,0.16666666666666666,5,5,TTTCCAGAGAAGGTGATTTT,0,1754557
gyrAp,0.16666666666666666,5,5,TTTATTCGTTTAAGGTTTAG,0,1742127
gyrAp,0.16666666666666666,5,5,TTTATCACATTATATTAGTT,0,1745946
gyrAp,0.16666666666666666,5,5,TTGTTTACCCCGCTACCAAT,0,1757713
gyrAp,0.16666666666666666,5,5,TTGTTATCAGAGGGGAAAGG,0,1745888
gyrAp,0.16666666666666666,5,5,TTGTCTGTCCGTTCGATACT,0,1750660
gyrAp,0.16666666666666666,5,5,TTGTAGCCATGTTCGTAAAT,0,1743655
gyrAp,0.16666666666666666,5,5,TTGTACATTATGCTGACCGT,0,1757777
gyrAp,0.16666666666666666,5,5,TTGGCTGCGAGAGTTCTCAC,0,1756513
gyrAp,0.16666666666666666,5,5,TTGCCAGAAGCGCGTACAAT,0,1768570
gyrAp,0.16666666666666666,5,5,TTGATTTTCAAGAGTGTGCT,0,1742352
gyrAp,0.16666666666666666,5,5,TTGAAGCTTTTGTCTTCCTT,0,1769514
gyrAp,0.16666666666666666,5,5,TTCTTATCGTCTATCCGATG,0,1763947
gyrAp,0.16666666666666666,5,5,TTCGTAGACCTCCATACGGG,0,1767657
gyrAp,0.16666666666666666,5,5,TTCCATAATCCAGCGTGACG,0,1768260
gyrAp,0.16666666666666666,5,5,TTCCACCGGGGACGTGGACA,0,1751959
gyrAp,0.16666666666666666,5,5,TTCATGACCTAATTCTTGCT,0,1769491
gyrAp,0.16666666666666666,5,5,TTCAACACAATAGCAAGCGA,0,1745187
gyrAp,0.16666666666666666,5,5,TTAGTTTTGCTCGTCCAGGG,0,1764565
gyrAp,0.16666666666666666,5,5,TTACCTCTAATTCCGTCGGA,0,1744496
gyrAp,0.16666666666666666,5,5,TTACCCCCCGGGCACATATA,0,1764651
gyrAp,0.16666666666666666,5,5,TTAAACCCTTTGAAGAAACC,0,1747615
gyrAp,0.16666666666666666,5,5,TGTTTAAAGGGTCAGGGTAA,0,1746918
gyrAp,0.16666666666666666,5,5,TGTTCGAAGCTGCACATTCT,0,1764681
gyrAp,0.16666666666666666,5,5,TGTGTGTATTACACGGAAAC,0,1753586
gyrAp,0.16666666666666666,5,5,TGTGGCCTAGGAATTGTGCT,0,1769073
gyrAp,0.16666666666666666,5,5,TGTCTGCGCATAACGCGTCC,0,1747207
gyrAp,0.16666666666666666,5,5,TGTCTCATTACGGACACCCG,0,1758118
gyrAp,0.16666666666666666,5,5,TGGGCTTCCGTTAGGACATT,0,1752420
gyrAp,0.16666666666666666,5,5,TGGCCACCGTGCATAGGTCG,0,1741510
gyrAp,0.16666666666666666,5,5,TGGCAACGCCAGCAGTGTTT,0,1744708
gyrAp,0.16666666666666666,5,5,TGGAGAGCCTAAAGCTTTTT,0,1760136
gyrAp,0.16666666666666666,5,5,TGGACCATGTCATATCCGAG,0,1755348
gyrAp,0.16666666666666666,5,5,TGCGTTCCCAGCTTGCGTTT,0,1744634
gyrAp,0.16666666666666666,5,5,TGCGTCCTTACAAGACCGTC,0,1745421
gyrAp,0.16666666666666666,5,5,TGCCATCTGTGAGAATTCAT,0,1752778
gyrAp,0.16666666666666666,5,5,TGCATATGTTCGGTCTACGT,0,1765615
gyrAp,0.16666666666666666,5,5,TGCAGCTGGCCACGAAGTCT,0,1759304
gyrAp,0.16666666666666666,5,5,TGCACACAGGTTACGGCGAG,0,1762399
gyrAp,0.16666666666666666,5,5,TGACTCAAACCTGTGGTAGA,0,1753835
gyrAp,0.16666666666666666,5,5,TGACATGCTGTGGGTAGTCT,0,1755131
gyrAp,0.16666666666666666,5,5,TCTTTGAAGTAGTCAGCTAG,0,1741517
gyrAp,0.16666666666666666,5,5,TCTTACGATTGGGCGGGCTA,0,1767920
gyrAp,0.16666666666666666,5,5,TCTTAAGGATCTCACTAGGA,0,1744535
gyrAp,0.16666666666666666,5,5,TCTGTGGCTCAATTTAATGT,0,1757477
gyrAp,0.16666666666666666,5,5,TCTCGTAGTATGGGCTAGGC,0,1756745
gyrAp,0.16666666666666666,5,5,TCGTTACGCTCCAGCCGAGG,0,1762294
gyrAp,0.16666666666666666,5,5,TCGTCGAACGATTTTTGTGG,0,1747393
gyrAp,0.16666666666666666,5,5,TCGGGCGGTTGCACGGGCGT,0,1765313
gyrAp,0.16666666666666666,5,5,TCGGGAGCGTTACAACATCT,0,1770334
gyrAp,0.16666666666666666,5,5,TCGGCCCAGACCGCTTGCGT,0,1756177
gyrAp,0.16666666666666666,5,5,TCGCCAAATTTGTTAAACTC,0,1749843
gyrAp,0.16666666666666666,5,5,TCGCACACATATGAGAGTTA,0,1762097
gyrAp,0.16666666666666666,5,5,TCGAGTAGGTCGAGTCTATA,0,1764070
gyrAp,0.16666666666666666,5,5,TCGAGGAAAGCGAAGACATT,0,1751872
gyrAp,0.16666666666666666,5,5,TCCTACGAGGGACAAGATCA,0,1761334
gyrAp,0.16666666666666666,5,5,TCCCCTCGATCCACTTACCG,0,1758007
gyrAp,0.16666666666666666,5,5,TCCCCGATATTGGCTCGGCT,0,1749121
gyrAp,0.16666666666666666,5,5,TCCATGGCTTGTTTGTTTCA,0,1755862
gyrAp,0.16666666666666666,5,5,TCAGAGGTTTACTCCCCGTA,0,1741996
gyrAp,0.16666666666666666,5,5,TCAGACAACTATATCCCGCA,0,1756230
gyrAp,0.16666666666666666,5,5,TCAGAAACTAGCGGCAAGTT,0,1757014
gyrAp,0.16666666666666666,5,5,TATTCTGGGATTCGTAAGCT,0,1754619
gyrAp,0.16666666666666666,5,5,TATTATTCCACAACGTTTGG,0,1742307
gyrAp,0.16666666666666666,5,5,TATGCCTTAGAATAAATAGT,0,1767058
gyrAp,0.16666666666666666,5,5,TATCGTCCGAGGACGTAGGG,0,1745392
gyrAp,0.16666666666666666,5,5,TATCGAGTACGTTTACTCGG,0,1746092
gyrAp,0.16666666666666666,5,5,TATACAATTCACTAGACCGT,0,1760740
gyrAp,0.16666666666666666,5,5,TAGGGCAGATTTAGGTACAA,0,1758345
gyrAp,0.16666666666666666,5,5,TAGGCACGTGTGAAAACTAA,0,1765311
gyrAp,0.16666666666666666,5,5,TAGGAAATGACCTGCGGTAC,0,1753108
gyrAp,0.16666666666666666,5,5,TAGCTCCCGGCCGCGGCGCA,0,1760525
gyrAp,0.16666666666666666,5,5,TAGCCTCGAAGGGGGTCTTT,0,1750912
gyrAp,0.16666666666666666,5,5,TAGCAGATAACAAGTCCTGT,0,1761340
gyrAp,0.16666666666666666,5,5,TAGACCCATAGTTTTGCCCA,0,1743554
gyrAp,0.16666666666666666,5,5,TAGACACTAGCAGCGACTGT,0,1753662
gyrAp,0.16666666666666666,5,5,TAGAAAGAGGTTGATACAGC,0,1744786
gyrAp,0.16666666666666666,5,5,TACCCGTGTGTCAGACTTCA,0,1756593
gyrAp,0.16666666666666666,5,5,TACCCGTAAGCGTGGCGTAA,0,1764647
gyrAp,0.16666666666666666,5,5,TAAGCAGTCCGCCAAATGCG,0,1765001
gyrAp,0.16666666666666666,5,5,TAACGCCCCGGGTTTACACA,0,1762273
gyrAp,0.16666666666666666,5,5,TAACCCTGGCATCTACTCCT,0,1746478
gyrAp,0.16666666666666666,5,5,TAACACGTCACGTGGGGCTT,0,1749654
gyrAp,0.16666666666666666,5,5,TAAACGTGTAGATACCGCAG,0,1741445
gyrAp,0.16666666666666666,5,5,TAAAAAAAAAAAAGTCGTCA,0,1764901
gyrAp,0.16666666666666666,5,5,GTTTCGCTCTGAGCCATGCT,0,1756644
gyrAp,0.16666666666666666,5,5,GTTATTCAAAAACTTCTCAT,0,1765839
gyrAp,0.16666666666666666,5,5,GTTATATCTGCCCAAGTTAT,0,1754566
gyrAp,0.16666666666666666,5,5,GTTAGGGGCTAATATCCAAT,0,1755456
gyrAp,0.16666666666666666,5,5,GTTAATTGTATTCCAATGTG,0,1761909
gyrAp,0.16666666666666666,5,5,GTGTTCTCACACTATCCAGC,0,1762511
gyrAp,0.16666666666666666,5,5,GTGGGGTCTAGAACCGGACT,0,1754622
gyrAp,0.16666666666666666,5,5,GTGCCATCGTTAAATTGGAG,0,1753524
gyrAp,0.16666666666666666,5,5,GTGCATGTTTCATCCGTTAA,0,1742603
gyrAp,0.16666666666666666,5,5,GTGATATCACGTTCGCCAGG,0,1758978
gyrAp,0.16666666666666666,5,5,GTGACTGGACGAGATTTGCG,0,1768096
gyrAp,0.16666666666666666,5,5,GTGAAGTATTTCTCACCCTT,0,1752197
gyrAp,0.16666666666666666,5,5,GTGAACCGCTGGGAGACGCT,0,1764207
gyrAp,0.16666666666666666,5,5,GTGAACAATGAATCGCGAAT,0,1760406
gyrAp,0.16666666666666666,5,5,GTGAAAAAATGTGAGGATAG,0,1745406
gyrAp,0.16666666666666666,5,5,GTCTCGGGGGGTTTGGTGCA,0,1769928
gyrAp,0.16666666666666666,5,5,GTCTCCTTGCTCGCTTACAA,0,1751590
gyrAp,0.16666666666666666,5,5,GTCGTGCCATTCTGTCTAAG,0,1763439
gyrAp,0.16666666666666666,5,5,GTCAGTCCGGCAGGGTAACA,0,1754412
gyrAp,0.16666666666666666,5,5,GTCAGAAACAGCCTGTTGCC,0,1743550
gyrAp,0.16666666666666666,5,5,GTCACTCATAGAACTGTGAG,0,1748166
gyrAp,0.16666666666666666,5,5,GTACACGAGTAGATTTCCAA,0,1754453
gyrAp,0.16666666666666666,5,5,GGTTTACTTCATTCTTCAAG,0,1764281
gyrAp,0.16666666666666666,5,5,GGTTCCTGTATCATTAACTG,0,1759109
gyrAp,0.16666666666666666,5,5,GGTGTAATTTTCGAGCAGAG,0,1762741
gyrAp,0.16666666666666666,5,5,GGTGAGTCTTCCCGCAACCC,0,1760995
gyrAp,0.16666666666666666,5,5,GGTCTCCGCAGGGACTCGTG,0,1744685
gyrAp,0.16666666666666666,5,5,GGTAGTCGGCTAATGCGACC,0,1769246
gyrAp,0.16666666666666666,5,5,GGTAATTCGTTATCTACAGT,0,1750971
gyrAp,0.16666666666666666,5,5,GGGTTGGGTTATATCCGCAG,0,1747234
gyrAp,0.16666666666666666,5,5,GGGTTCGAGCATGGGAGTAT,0,1744047
gyrAp,0.16666666666666666,5,5,GGGTCCCTTAAATCCGGGTT,0,1754857
gyrAp,0.16666666666666666,5,5,GGGTCCATTTCTCACCGTAG,0,1766458
gyrAp,0.16666666666666666,5,5,GGGGTAGGTGATTGCCCAAG,0,1769161
gyrAp,0.16666666666666666,5,5,GGGGTAGAGTATCACAATCC,0,1743864
gyrAp,0.16666666666666666,5,5,GGGGTAAGTTGCTCTGGCTT,0,1754018
gyrAp,0.16666666666666666,5,5,GGGGGGTGAATGCCTTGAGG,0,1754003
gyrAp,0.16666666666666666,5,5,GGGCACTACCTGAATTTTTC,0,1757582
gyrAp,0.16666666666666666,5,5,GGGAGTGATCGATGCGTTTT,0,1755776
gyrAp,0.16666666666666666,5,5,GGGAGGATACCCTTCGGTCG,0,1745028
gyrAp,0.16666666666666666,5,5,GGGACTATAATATGGCCACG,0,1743998
gyrAp,0.16666666666666666,5,5,GGGAATGCTTGCGCCACATA,0,1753737
gyrAp,0.16666666666666666,5,5,GGCTGGTTATTTACCTGTTC,0,1769033
gyrAp,0.16666666666666666,5,5,GGCTGGCTAGAGAATTCTCA,0,1761451
gyrAp,0.16666666666666666,5,5,GGCGGTGGGTTACTATAGAA,0,1756703
gyrAp,0.16666666666666666,5,5,GGCGGTGCAGGTGAAAAGCC,0,1751575
gyrAp,0.16666666666666666,5,5,GGCGCTCAACAGATAGCGAA,0,1746352
gyrAp,0.16666666666666666,5,5,GGCGAGGTTAGAATAGGGGT,0,1761170
gyrAp,0.16666666666666666,5,5,GGCCGTAGTCACGTAGTGAC,0,1750176
gyrAp,0.16666666666666666,5,5,GGATGTTATGCGTGGCATCG,0,1768038
gyrAp,0.16666666666666666,5,5,GGACTAGGCCACAGGAGTGG,0,1754310
gyrAp,0.16666666666666666,5,5,GGACCTTCGAAGACCCTAAA,0,1744018
gyrAp,0.16666666666666666,5,5,GCTTATGCCGTGAACCCTGT,0,1746295
gyrAp,0.16666666666666666,5,5,GCTTAGCGAGTCTTCAGATT,0,1745647
gyrAp,0.16666666666666666,5,5,GCTGTATGTCCGCTCACCGG,0,1759013
gyrAp,0.16666666666666666,5,5,GCTGCGGGTACCGTCAAACA,0,1748688
gyrAp,0.16666666666666666,5,5,GCTGACGTAGCGACACATAT,0,1758318
gyrAp,0.16666666666666666,5,5,GCGGTAAAGATAGGATGGAA,0,1751488
gyrAp,0.16666666666666666,5,5,GCGGGAAGCCGGTATATCGA,0,1744272
gyrAp,0.16666666666666666,5,5,GCGGCAGCCTGGCATGAGTG,0,1763697
gyrAp,0.16666666666666666,5,5,GCGCTATGGTGATTCCTTGA,0,1763791
gyrAp,0.16666666666666666,5,5,GCGCGATAGGCAATCATCAG,0,1749912
gyrAp,0.16666666666666666,5,5,GCGACCCATGCTTTAAAAGT,0,1749472
gyrAp,0.16666666666666666,5,5,GCGAACGTGGCCTGCTTATG,0,1762749
gyrAp,0.16666666666666666,5,5,GCCTTCCATCAAGTCTCAAG,0,1743343
gyrAp,0.16666666666666666,5,5,GCCTTAAAGCTGAGCCCCGT,0,1755448
gyrAp,0.16666666666666666,5,5,GCCTCACGGGCGCATGATAT,0,1752465
gyrAp,0.16666666666666666,5,5,GCCATTTCCGGCGAACCAAT,0,1761367
gyrAp,0.16666666666666666,5,5,GCCACGCGGGAAAGGCGATT,0,1746425
gyrAp,0.16666666666666666,5,5,GCATGTGGGACCTTAGTCAC,0,1766630
gyrAp,0.16666666666666666,5,5,GCAGGATTCTTGGATTACCG,0,1756611
gyrAp,0.16666666666666666,5,5,GCAGATAACGTCACGGTTAC,0,1750484
gyrAp,0.16666666666666666,5,5,GCACGTTTAACGATTGGCTC,0,1760716
gyrAp,0.16666666666666666,5,5,GCACGGTTAACACGAGTTAA,0,1759321
gyrAp,0.16666666666666666,5,5,GCAACCGGATCCTATTCAGA,0,1758166
gyrAp,0.16666666666666666,5,5,GCAAAGGCCCTCTGAGAGAT,0,1769974
gyrAp,0.16666666666666666,5,5,GCAAACCAGATCAACTGCGC,0,1764755
gyrAp,0.16666666666666666,5,5,GATTAAGGACAGCCGAAGTT,0,1767197
gyrAp,0.16666666666666666,5,5,GATAACCGACTGGCACCCAC,0,1749578
gyrAp,0.16666666666666666,5,5,GAGTCGAGTTTGGATGACGC,0,1748770
gyrAp,0.16666666666666666,5,5,GAGGGTAGTTCTGCAGCGTC,0,1762803
gyrAp,0.16666666666666666,5,5,GAGGCCAATCGACCAAAGAA,0,1760141
gyrAp,0.16666666666666666,5,5,GAGCCGGTATGATACGGGTC,0,1765790
gyrAp,0.16666666666666666,5,5,GAGCACTCCGATAATTGGCT,0,1761287
gyrAp,0.16666666666666666,5,5,GAGAGATCACTCTACGGTGG,0,1749126
gyrAp,0.16666666666666666,5,5,GAGAAGAAAAGTGTTCCGTT,0,1760750
gyrAp,0.16666666666666666,5,5,GAGAACCTCTCCAAGAGAAG,0,1745391
gyrAp,0.16666666666666666,5,5,GACTGGTCCCCAGCACCGTT,0,1762056
gyrAp,0.16666666666666666,5,5,GACGTGGGTTTAAGAGCGGG,0,1743978
gyrAp,0.16666666666666666,5,5,GACGTACTGCCCCACGCACG,0,1762527
gyrAp,0.16666666666666666,5,5,GACGGCCGACTTTACACTAT,0,1743700
gyrAp,0.16666666666666666,5,5,GACCGCACTTTGTGTCAAAA,0,1749569
gyrAp,0.16666666666666666,5,5,GAATTCCACTTAGCCCGAGT,0,1747006
gyrAp,0.16666666666666666,5,5,GAATGTGCATTAGTCTGTGG,0,1769703
gyrAp,0.16666666666666666,5,5,GAAGGATGCTGTTACTTTGT,0,1762777
gyrAp,0.16666666666666666,5,5,GAACTGGATTACGTGATCCA,0,1755990
gyrAp,0.16666666666666666,5,5,GAACAGCTTGTACGGAGTTA,0,1748493
gyrAp,0.16666666666666666,5,5,GAACACGGTCGCCCGAATCC,0,1744215
gyrAp,0.16666666666666666,5,5,GAAACTGACATGCACATTAA,0,1765467
gyrAp,0.16666666666666666,5,5,GAAAATCGTTGCTGGATTCA,0,1755399
gyrAp,0.16666666666666666,5,5,GAAAATAGCACGCGTCTCCA,0,1767115
gyrAp,0.16666666666666666,5,5,CTTTTAAAAGATCAGTCGAG,0,1762832
gyrAp,0.16666666666666666,5,5,CTTTGGAAGGGTACGACTAT,0,1759603
gyrAp,0.16666666666666666,5,5,CTTTATAAAATGGCTAATCC,0,1746751
gyrAp,0.16666666666666666,5,5,CTTTACTTATGTGCGCTCGA,0,1761835
gyrAp,0.16666666666666666,5,5,CTTGTCATTAGTTGACCCAC,0,1753618
gyrAp,0.16666666666666666,5,5,CTTGCGGGGGCTATGCAGAT,0,1762589
gyrAp,0.16666666666666666,5,5,CTGTTAGTAACCTTTCACAC,0,1751494
gyrAp,0.16666666666666666,5,5,CTGTTAAAACGCCTGCAAGC,0,1743599
gyrAp,0.16666666666666666,5,5,CTGGTTATCATATGTACCGT,0,1762748
gyrAp,0.16666666666666666,5,5,CTGGTCCCGCAGTAGGCCCG,0,1768248
gyrAp,0.16666666666666666,5,5,CTGCCATTAACTTTTTAATT,0,1762448
gyrAp,0.16666666666666666,5,5,CTGATTACACCGAGTGTCAC,0,1757811
gyrAp,0.16666666666666666,5,5,CTCTGTGTTTCAACTCATTC,0,1760616
gyrAp,0.16666666666666666,5,5,CTCTGGCAACGCGACTATCG,0,1765516
gyrAp,0.16666666666666666,5,5,CTCTAAGGTACGGAAAGTTT,0,1751365
gyrAp,0.16666666666666666,5,5,CTCGCGGGGGTTCCCCGGGG,0,1742044
gyrAp,0.16666666666666666,5,5,CTCGCACGCGACCGTGACCA,0,1747320
gyrAp,0.16666666666666666,5,5,CTCGAGCTTTGGTTGACGCG,0,1768382
gyrAp,0.16666666666666666,5,5,CTCCTTAATGGAAGGCCCCC,0,1762510
gyrAp,0.16666666666666666,5,5,CTCACGTCATTATTGTTGGA,0,1745329
gyrAp,0.16666666666666666,5,5,CTAGTCTGTCGGGTACCACA,0,1749518
gyrAp,0.16666666666666666,5,5,CTAGTACATATAGGAATCGT,0,1752303
gyrAp,0.16666666666666666,5,5,CTACTGCGCTTACAGATAGG,0,1748707
gyrAp,0.16666666666666666,5,5,CTACTGCATGGATCGTATTC,0,1749336
gyrAp,0.16666666666666666,5,5,CTACTCGATCAAATGAAGTT,0,1748755
gyrAp,0.16666666666666666,5,5,CGTTATAATAACTAGCTTGA,0,1742020
gyrAp,0.16666666666666666,5,5,CGTTAGTAACACCAGGAGTA,0,1750132
gyrAp,0.16666666666666666,5,5,CGTGGCCAGCATATCTTCCC,0,1749428
gyrAp,0.16666666666666666,5,5,CGTACAAGTAGTACGTGCCC,0,1767405
gyrAp,0.16666666666666666,5,5,CGGGACGAGGATCAATTGTG,0,1767963
gyrAp,0.16666666666666666,5,5,CGGCTTCTTGATGGATTGAG,0,1752443
gyrAp,0.16666666666666666,5,5,CGGCTGCTATCCGCTACTGC,0,1760065
gyrAp,0.16666666666666666,5,5,CGGCCCCGGACCAGTAACGT,0,1765211
gyrAp,0.16666666666666666,5,5,CGGCCATCTAGCATCATTGC,0,1765168
gyrAp,0.16666666666666666,5,5,CGGATCCACTAACCGGCGTC,0,1751137
gyrAp,0.16666666666666666,5,5,CGGAACCGGGGCAACTCTTG,0,1743717
gyrAp,0.16666666666666666,5,5,CGGAACAAAAGAAATTTAAG,0,1769426
gyrAp,0.16666666666666666,5,5,CGCTCCTGGACGGTAACCGT,0,1757895
gyrAp,0.16666666666666666,5,5,CGCGCGCTTACTGCTCATTT,0,1745765
gyrAp,0.16666666666666666,5,5,CGCGCGATAAAATCGAGCAG,0,1758163
gyrAp,0.16666666666666666,5,5,CGCGCCTGGCTACGTATCAA,0,1766043
gyrAp,0.16666666666666666,5,5,CGCGAGATCGCCAGTCAGGC,0,1744812
gyrAp,0.16666666666666666,5,5,CGCGAACAAGGACGAGATTA,0,1752966
gyrAp,0.16666666666666666,5,5,CGCGAAAGTTGATACGCGAA,0,1770426
gyrAp,0.16666666666666666,5,5,CGCCGATGCCCGGTCCGCAA,0,1766120
gyrAp,0.16666666666666666,5,5,CGCAGCTGTTGTCGTCCTCA,0,1752567
gyrAp,0.16666666666666666,5,5,CGCAAGGGATACGGCCAAGC,0,1741915
gyrAp,0.16666666666666666,5,5,CGATTTCCACCCCGAGACGT,0,1766344
gyrAp,0.16666666666666666,5,5,CGAGTTAGTCCCCGCAGCGT,0,1748345
gyrAp,0.16666666666666666,5,5,CGAGGCGCGAATGATATAGT,0,1741800
gyrAp,0.16666666666666666,5,5,CGAGCCAGGGAGAGCAGCTC,0,1751456
gyrAp,0.16666666666666666,5,5,CCTTCCGTACTCAGACATAC,0,1764303
gyrAp,0.16666666666666666,5,5,CCTGGTGAGGATGATCGAAA,0,1756964
gyrAp,0.16666666666666666,5,5,CCTGCGAAGGCACGGGCTCT,0,1767335
gyrAp,0.16666666666666666,5,5,CCTGCATCCATCGCCTCCAG,0,1754837
gyrAp,0.16666666666666666,5,5,CCTGACAATGTAGTCAACTA,0,1758741
gyrAp,0.16666666666666666,5,5,CCTATGAAGCTCTTGATCTG,0,1752439
gyrAp,0.16666666666666666,5,5,CCTAGTAACAAGTTAACACA,0,1762708
gyrAp,0.16666666666666666,5,5,CCGTGCTCTTCGTCACGATG,0,1746044
gyrAp,0.16666666666666666,5,5,CCGTATCCTCGTAGTCATAC,0,1756055
gyrAp,0.16666666666666666,5,5,CCGGTGTATGAGACGGTTAG,0,1756684
gyrAp,0.16666666666666666,5,5,CCGGCTGCACCCCGGCAGGC,0,1762805
gyrAp,0.16666666666666666,5,5,CCGCGCTGCCGCTACAGTTA,0,1756577
gyrAp,0.16666666666666666,5,5,CCGCAGTCTGGGGGGGTGCA,0,1760362
gyrAp,0.16666666666666666,5,5,CCCTCTTCAGCCCACTTCAT,0,1751871
gyrAp,0.16666666666666666,5,5,CCCGTGGAACGCAGCGACCA,0,1748370
gyrAp,0.16666666666666666,5,5,CCCCGACGCCCATATCCCGA,0,1752930
gyrAp,0.16666666666666666,5,5,CCCCACTAGCCGCTAACCAA,0,1747875
gyrAp,0.16666666666666666,5,5,CCCATGGGCAATTAACTGCC,0,1750928
gyrAp,0.16666666666666666,5,5,CCCAGGGGTGTGAGAGAATC,0,1760046
gyrAp,0.16666666666666666,5,5,CCCAATAAGAGATCGTCGAT,0,1762742
gyrAp,0.16666666666666666,5,5,CCATCACAATGCTATCGCTG,0,1764816
gyrAp,0.16666666666666666,5,5,CCAGGGGACCAGAATGGACC,0,1761078
gyrAp,0.16666666666666666,5,5,CCACACGGTTGCTTCATAAG,0,1754335
gyrAp,0.16666666666666666,5,5,CCAAGTTTGATACTACTGGA,0,1743716
gyrAp,0.16666666666666666,5,5,CCAACGAGTATGTGGCCTAT,0,1765050
gyrAp,0.16666666666666666,5,5,CCAACATCAGAATTTTGGTT,0,1742976
gyrAp,0.16666666666666666,5,5,CATGGGCATTGGGAACGAAG,0,1743988
gyrAp,0.16666666666666666,5,5,CATGCGACGCGAGACCATGT,0,1766181
gyrAp,0.16666666666666666,5,5,CATGACCTACCGTATGTTTC,0,1753315
gyrAp,0.16666666666666666,5,5,CATCTGCGGCTCAGCTTTCC,0,1762162
gyrAp,0.16666666666666666,5,5,CATCGCGTCGTTCGCACGGC,0,1757520
gyrAp,0.16666666666666666,5,5,CATACTAAGCAACCATGTTG,0,1742782
gyrAp,0.16666666666666666,5,5,CATACATCCAGATCGAGGAA,0,1754386
gyrAp,0.16666666666666666,5,5,CAGTAAAAATGGATGGAATT,0,1746638
gyrAp,0.16666666666666666,5,5,CAGGGTGCCTGAGAGCAAGG,0,1743819
gyrAp,0.16666666666666666,5,5,CAGGCATCAACCATCAGTGG,0,1761754
gyrAp,0.16666666666666666,5,5,CAGCTCCTGAAACAACATGT,0,1766562
gyrAp,0.16666666666666666,5,5,CAGCGCAGGCACAGTTATCT,0,1767697
gyrAp,0.16666666666666666,5,5,CAGCCCGTGGCAAGCAGGTG,0,1770243
gyrAp,0.16666666666666666,5,5,CACGCATTCGATAACCCAGA,0,1769355
gyrAp,0.16666666666666666,5,5,CACCTCTATCAACCGAGGTT,0,1760759
gyrAp,0.16666666666666666,5,5,CACCGTTGCTGGGATGATTG,0,1756261
gyrAp,0.16666666666666666,5,5,CACCGGAACTACGGAGGCTT,0,1752360
gyrAp,0.16666666666666666,5,5,CACCCCTGTGTCCGGTGACG,0,1767953
gyrAp,0.16666666666666666,5,5,CACCCCTCACAAGAGACGAT,0,1767330
gyrAp,0.16666666666666666,5,5,CACACTTTGGAAGAGCGAGG,0,1759188
gyrAp,0.16666666666666666,5,5,CACAACTATCCTCGTTATTG,0,1753344
gyrAp,0.16666666666666666,5,5,CAATTTTGGAATTCAACGTC,0,1750368
gyrAp,0.16666666666666666,5,5,CAATTCGCTGTCGTCTCAGG,0,1741893
gyrAp,0.16666666666666666,5,5,CAAGCCGAGCTGCCCGATAC,0,1759278
gyrAp,0.16666666666666666,5,5,CAAGACCGGGACGTAGGTGA,0,1742785
gyrAp,0.16666666666666666,5,5,CAACTTCACAATGCCGGTGG,0,1750437
gyrAp,0.16666666666666666,5,5,CAACACATGTAGAGTGCTCT,0,1746003
gyrAp,0.16666666666666666,5,5,CAAATCCAGGCACTACCCGG,0,1766302
gyrAp,0.16666666666666666,5,5,CAAATACCGGTTCGCGCCCC,0,1768100
gyrAp,0.16666666666666666,5,5,ATTGAGATAGACGGGTTCGC,0,1757149
gyrAp,0.16666666666666666,5,5,ATTCAGCTCGCTGTGCGTGC,0,1756386
gyrAp,0.16666666666666666,5,5,ATTAAGTGGTGCTATAAGCC,0,1748095
gyrAp,0.16666666666666666,5,5,ATGGGACATACAACGTAAAG,0,1763140
gyrAp,0.16666666666666666,5,5,ATGGCAATGTCGTTATCAGA,0,1766938
gyrAp,0.16666666666666666,5,5,ATGGAAACAGTTATCTGTCT,0,1755897
gyrAp,0.16666666666666666,5,5,ATGAGATCAATACGCGATCT,0,1763724
gyrAp,0.16666666666666666,5,5,ATCTGGGGTATTCTGCAGAT,0,1744039
gyrAp,0.16666666666666666,5,5,ATCTGAGATTTACGCGCGCT,0,1741457
gyrAp,0.16666666666666666,5,5,ATCTAATTTGCTGTGAGTTC,0,1759406
gyrAp,0.16666666666666666,5,5,ATCGTTTGTTAGAACTCAGG,0,1742237
gyrAp,0.16666666666666666,5,5,ATCCTCGTTTATTGTCTCGT,0,1750416
gyrAp,0.16666666666666666,5,5,ATCCAACGGAGAATGAAGAA,0,1769536
gyrAp,0.16666666666666666,5,5,ATCAACAAAACGGTCACCTC,0,1757984
gyrAp,0.16666666666666666,5,5,ATATGGAATATCGAGGATTT,0,1752178
gyrAp,0.16666666666666666,5,5,ATATCGGACCTTCTCACGGT,0,1766232
gyrAp,0.16666666666666666,5,5,ATAGCACAGAGTTTGATGTT,0,1763783
gyrAp,0.16666666666666666,5,5,ATACCCAGCGTAGGTCGCGT,0,1752043
gyrAp,0.16666666666666666,5,5,ATACATAGCGTGTGCGCCAC,0,1755303
gyrAp,0.16666666666666666,5,5,ATAAGCTGGCGGCGGGTTCG,0,1751904
gyrAp,0.16666666666666666,5,5,AGTCTGCAAGACTGCTTCAA,0,1767475
gyrAp,0.16666666666666666,5,5,AGTCCATGCAACGAATTATA,0,1759601
gyrAp,0.16666666666666666,5,5,AGGTGTATGCGAGCCGACAC,0,1749842
gyrAp,0.16666666666666666,5,5,AGGTGGTAGGCACGAAATAC,0,1745662
gyrAp,0.16666666666666666,5,5,AGGTGAGTACTCTCCTTGGT,0,1746251
gyrAp,0.16666666666666666,5,5,AGGTATTAGTGCAACATCTT,0,1769738
gyrAp,0.16666666666666666,5,5,AGGGTCATTTTGTGAGGGTG,0,1744223
gyrAp,0.16666666666666666,5,5,AGGGCATTTCGCCTATGGAA,0,1742928
gyrAp,0.16666666666666666,5,5,AGGGCAGTTGGTGTCAGAAC,0,1749951
gyrAp,0.16666666666666666,5,5,AGGGATCAAGCCACGGAACC,0,1755665
gyrAp,0.16666666666666666,5,5,AGGCTCTGGGTTATTTCGTG,0,1755104
gyrAp,0.16666666666666666,5,5,AGGCATCATCGGGCCACGAG,0,1762413
gyrAp,0.16666666666666666,5,5,AGGAGGTTGCAACCCGTGAT,0,1770737
gyrAp,0.16666666666666666,5,5,AGGACTCTACGAAGGGCTGC,0,1769038
gyrAp,0.16666666666666666,5,5,AGCCCTTTAGCTGTTGACCC,0,1764817
gyrAp,0.16666666666666666,5,5,AGCCCGCAAGCGCCTGGTAG,0,1745085
gyrAp,0.16666666666666666,5,5,AGCAGCAACCAGCTCTTTAC,0,1758335
gyrAp,0.16666666666666666,5,5,AGCACCATTTAGAGCTATTT,0,1747108
gyrAp,0.16666666666666666,5,5,AGATTAGCAAGGGTCTCATT,0,1764738
gyrAp,0.16666666666666666,5,5,AGATCCGGATACAAACCATA,0,1763264
gyrAp,0.16666666666666666,5,5,AGAGTTTTAAAGTCATCACT,0,1743362
gyrAp,0.16666666666666666,5,5,AGAGGAGGCTTTGGGACATA,0,1744987
gyrAp,0.16666666666666666,5,5,AGAGCGCGGGCTTTACGTTA,0,1758687
gyrAp,0.16666666666666666,5,5,AGACATTATTGAGTAATTTT,0,1763120
gyrAp,0.16666666666666666,5,5,ACTTGTTAGGCAAGTATATC,0,1755208
gyrAp,0.16666666666666666,5,5,ACTTGCGTCTTTAAGCCGAT,0,1766178
gyrAp,0.16666666666666666,5,5,ACTCGGGATCAATGCCAGAG,0,1768265
gyrAp,0.16666666666666666,5,5,ACGTTCACGTCGGAATCACT,0,1760812
gyrAp,0.16666666666666666,5,5,ACGTCTATTCCTTTCATACT,0,1770464
gyrAp,0.16666666666666666,5,5,ACGTCATAAAAATGTGTTGA,0,1769249
gyrAp,0.16666666666666666,5,5,ACGGTTCAACGGGCTTAACA,0,1746118
gyrAp,0.16666666666666666,5,5,ACGGTAAGACAGGTGTATAC,0,1764298
gyrAp,0.16666666666666666,5,5,ACGGGGGCCACTCATATACG,0,1751955
gyrAp,0.16666666666666666,5,5,ACGGCGGTTGAATTCCTGCT,0,1770504
gyrAp,0.16666666666666666,5,5,ACGCTCAAAGTGTTAACATG,0,1764333
gyrAp,0.16666666666666666,5,5,ACGCTACTTTATTCAACGCT,0,1754153
gyrAp,0.16666666666666666,5,5,ACGCATCGGATCAACGTTGT,0,1746887
gyrAp,0.16666666666666666,5,5,ACGAGTATGTGCTCGTAGAA,0,1754006
gyrAp,0.16666666666666666,5,5,ACGACGTCCTTGGTGAGGAG,0,1766118
gyrAp,0.16666666666666666,5,5,ACGACGACAGTGGCGGGTTG,0,1744397
gyrAp,0.16666666666666666,5,5,ACCTTTTAAACCGGCAATAT,0,1752422
gyrAp,0.16666666666666666,5,5,ACCGTTCTCCTAGAACGTTA,0,1761586
gyrAp,0.16666666666666666,5,5,ACCGTTATTCGTGACAGCGG,0,1765777
gyrAp,0.16666666666666666,5,5,ACCAGGCCAAAGGTACAGTC,0,1755314
gyrAp,0.16666666666666666,5,5,ACCACTTGGAATGGTTATGT,0,1754450
gyrAp,0.16666666666666666,5,5,ACATCAGTATAGGTAGGAGG,0,1746826
gyrAp,0.16666666666666666,5,5,ACAGTTCTCACCTGTGGATT,0,1763924
gyrAp,0.16666666666666666,5,5,ACAGCGTTGATAAGGCACTC,0,1741978
gyrAp,0.16666666666666666,5,5,ACACTACGACCCTTGAAACA,0,1757376
gyrAp,0.16666666666666666,5,5,ACAACGTACATCATCAACAA,0,1745260
gyrAp,0.16666666666666666,5,5,ACAAATTACTCAAGGCGATT,0,1747046
gyrAp,0.16666666666666666,5,5,ACAAAAGGTGAGGTAACTTT,0,1749568
gyrAp,0.16666666666666666,5,5,AATTGTAGCGTACCATTCTA,0,1762776
gyrAp,0.16666666666666666,5,5,AATGTGGGTGATACATTAAG,0,1766892
gyrAp,0.16666666666666666,5,5,AATACCGTCCGAACTCCCAC,0,1761104
gyrAp,0.16666666666666666,5,5,AATAAAAGGGAACCGGGTAT,0,1749136
gyrAp,0.16666666666666666,5,5,AAGTTTATTCCTTCTCGGCG,0,1761303
gyrAp,0.16666666666666666,5,5,AAGCGGGAAGAACGGCATAT,0,1751172
gyrAp,0.16666666666666666,5,5,AAGCGCCACTTTAACGAAAT,0,1759441
gyrAp,0.16666666666666666,5,5,AAGCCGTATGGGGTGTCGTA,0,1743746
gyrAp,0.16666666666666666,5,5,AAGCCAGTTTGGCTAGGAAA,0,1750078
gyrAp,0.16666666666666666,5,5,AAGCACATTCTAAAGGTGAT,0,1756451
gyrAp,0.16666666666666666,5,5,AAGATTTCATTGGGTCTCAG,0,1756698
gyrAp,0.16666666666666666,5,5,AAGATTAAATGCTGGTCACT,0,1765707
gyrAp,0.16666666666666666,5,5,AAGAATTTCCAACTATGGCT,0,1743402
gyrAp,0.16666666666666666,5,5,AACCAGCGCTCAAACGGTGA,0,1755713
gyrAp,0.16666666666666666,5,5,AAATCCTTAAATATTGTAGG,0,1745800
gyrAp,0.16666666666666666,5,5,AAAGCCATGGCGTCGCCCGA,0,1747448
gyrAp,0.16666666666666666,5,5,AAACTTCCGACGTACTGACT,0,1767830
gyrAp,0.2,4,4,TTTTTTTTGTTGCTTATAAT,0,1751273
gyrAp,0.2,4,4,TTTTGGACTAAGACACGAAA,0,1749893
gyrAp,0.2,4,4,TTTTACGCCCCATTGTACAA,0,1763077
gyrAp,0.2,4,4,TTTGATGAAGACGGGGGTCG,0,1759643
gyrAp,0.2,4,4,TTTCTCATAGTCTCTCAGGT,0,1763269
gyrAp,0.2,4,4,TTTCGTAGCCTCAGGTGTAA,0,1767421
gyrAp,0.2,4,4,TTTCATACATCTCCCCAGAG,0,1748130
gyrAp,0.2,4,4,TTTCAATATGGAACCCCTCC,0,1757304
gyrAp,0.2,4,4,TTTAGCGTGGAACGTTTAGT,0,1743867
gyrAp,0.2,4,4,TTGTCCTGGGAACACGTACT,0,1750842
gyrAp,0.2,4,4,TTGGTTTCGCGACGAGGGTT,0,1753566
gyrAp,0.2,4,4,TTGGTTCTCAGGATCAAGTT,0,1758281
gyrAp,0.2,4,4,TTGGGGCCGTAAAATCTCCA,0,1746581
gyrAp,0.2,4,4,TTGGGAATACACGTGTCAGA,0,1766958
gyrAp,0.2,4,4,TTGGCTGGAACAAAGGGTGT,0,1757645
gyrAp,0.2,4,4,TTGAGTTCCTCGTCCTTGTC,0,1741970
gyrAp,0.2,4,4,TTGAGGGACTTGGAGTTAGT,0,1770419
gyrAp,0.2,4,4,TTGAGAGAGGGACGTGCAGC,0,1769619
gyrAp,0.2,4,4,TTCGTTCTGCCGGCGACTTT,0,1756441
gyrAp,0.2,4,4,TTCGGAAGCGTCCCGACTCA,0,1766201
gyrAp,0.2,4,4,TTCCGAACTTGTTCTGCAAG,0,1758566
gyrAp,0.2,4,4,TTCCCTTCCTGTAATGCCAT,0,1749052
gyrAp,0.2,4,4,TTCCAGGTGAAGTCTGCACC,0,1757788
gyrAp,0.2,4,4,TTCATTTGGTAGCAATCCTA,0,1758903
gyrAp,0.2,4,4,TTCATGACAAGGACCACCGT,0,1758256
gyrAp,0.2,4,4,TTCATCGTTATCTTCCTTGT,0,1770229
gyrAp,0.2,4,4,TTAGTGGTCAAACCCATTAA,0,1753503
gyrAp,0.2,4,4,TTAGGCTACCATCGCAGCAA,0,1766973
gyrAp,0.2,4,4,TTAGCAGGTCATATTGCAGT,0,1770154
gyrAp,0.2,4,4,TTAGACGCTTTAGCGAAGGT,0,1752397
gyrAp,0.2,4,4,TTAGAAATGCTTTTCGCCTA,0,1757834
gyrAp,0.2,4,4,TTACAGGCGCCTGAATAGTA,0,1760047
gyrAp,0.2,4,4,TTAATTTTTTCGGAGGCTCC,0,1760538
gyrAp,0.2,4,4,TGTTTGCGTTTAAGGCCTCA,0,1769337
gyrAp,0.2,4,4,TGTTTGCAATATCGAATGCC,0,1747891
gyrAp,0.2,4,4,TGTTCTGTGAAAGGTATTAA,0,1763025
gyrAp,0.2,4,4,TGTGGTTTTCGATAGGCAGC,0,1761620
gyrAp,0.2,4,4,TGTCGCCCGGTCACGAGCGC,0,1754125
gyrAp,0.2,4,4,TGTATGGTGCCCCGGGACTT,0,1762255
gyrAp,0.2,4,4,TGTAGGAGCTTATGATTATA,0,1746748
gyrAp,0.2,4,4,TGGGTCTTAATCCATATGGA,0,1756010
gyrAp,0.2,4,4,TGGGTAGCGTCGGTGTTCTT,0,1751723
gyrAp,0.2,4,4,TGGCCGACGGAAATCGGCCC,0,1746321
gyrAp,0.2,4,4,TGGACTTCAAGCCCGTCTTA,0,1756850
gyrAp,0.2,4,4,TGGAAGTTCGAAGTATGCAA,0,1756400
gyrAp,0.2,4,4,TGCTGTAGACATCGTACGCA,0,1742499
gyrAp,0.2,4,4,TGCTAGTGATCAAGCCAGTG,0,1763796
gyrAp,0.2,4,4,TGCGTGCGAATCTGGGCACT,0,1743341
gyrAp,0.2,4,4,TGCGCTACTGTGGCCATGTA,0,1747304
gyrAp,0.2,4,4,TGCCGGAGAGGTCGTTTTAT,0,1756560
gyrAp,0.2,4,4,TGCCCAACATACCCGAGTGC,0,1765485
gyrAp,0.2,4,4,TGCCATCGTGGTCTAGCGGG,0,1746368
gyrAp,0.2,4,4,TGCAGCTGTTCCTCACGACT,0,1748909
gyrAp,0.2,4,4,TGATGTAACACGTGGTCTTA,0,1747573
gyrAp,0.2,4,4,TGATATGACATTAGACTCCA,0,1767755
gyrAp,0.2,4,4,TGAGGTAAATCACCGTGGTC,0,1752442
gyrAp,0.2,4,4,TGAGAGGGAGGGGAATATTT,0,1768017
gyrAp,0.2,4,4,TGACTTGACCGGTGTTAATC,0,1766066
gyrAp,0.2,4,4,TGACGTTGGGAAACCGGTTC,0,1746606
gyrAp,0.2,4,4,TGAACGACCGTGGTCCAAAA,0,1768592
gyrAp,0.2,4,4,TCTTTTCGATGGAGCTCATG,0,1764765
gyrAp,0.2,4,4,TCTTGTCTTGGAGGGGCCGT,0,1755722
gyrAp,0.2,4,4,TCTCTATTTAGAAAGAACCA,0,1748603
gyrAp,0.2,4,4,TCTCCGGTATGTTTCTCTCA,0,1761350
gyrAp,0.2,4,4,TCTAGCTGGATACGGATCTA,0,1767283
gyrAp,0.2,4,4,TCGTCAATGAGTCCGTATTT,0,1753335
gyrAp,0.2,4,4,TCGGTTAAACGCGATTAAAG,0,1758523
gyrAp,0.2,4,4,TCGGGAAAAAAGGCATCCCC,0,1743696
gyrAp,0.2,4,4,TCGGACCCTATAGGCGCCGA,0,1767051
gyrAp,0.2,4,4,TCGCTCAACCATGGCTTGAG,0,1766512
gyrAp,0.2,4,4,TCGATATGGGTCTCAGTCTG,0,1749911
gyrAp,0.2,4,4,TCGAAGCGCATGGCATTGGA,0,1756009
gyrAp,0.2,4,4,TCCTTGACTGCGAACCAGGA,0,1751867
gyrAp,0.2,4,4,TCCTCCCACTGGTCTATTCC,0,1753160
gyrAp,0.2,4,4,TCCTCATCACCGGGGTTCAT,0,1766205
gyrAp,0.2,4,4,TCCGGTCCGCGAAAAAAAGT,0,1742621
gyrAp,0.2,4,4,TCCGCTAGTAACGAGGTCCC,0,1761085
gyrAp,0.2,4,4,TCCCGACAGACGGCTAGTTT,0,1764469
gyrAp,0.2,4,4,TCCAGCGTGAATATAAGAAT,0,1761931
gyrAp,0.2,4,4,TCCACCCAGTCAGAATCACA,0,1752623
gyrAp,0.2,4,4,TCATCGTGCTATACCAGTTG,0,1754129
gyrAp,0.2,4,4,TCAGTTCAGGTCGCGGGCGT,0,1762471
gyrAp,0.2,4,4,TCACAGAAAGAAAACGTCAC,0,1769369
gyrAp,0.2,4,4,TATGTCAAATTTAATGGTGA,0,1742978
gyrAp,0.2,4,4,TATGTACTCACATCCCTGGA,0,1755334
gyrAp,0.2,4,4,TATGGGATGAAGGCGCGCAT,0,1759493
gyrAp,0.2,4,4,TATGATGCACCAAGTTTAAC,0,1752917
gyrAp,0.2,4,4,TATGACACGGTCACTGCTCA,0,1743384
gyrAp,0.2,4,4,TATCTTGGAGCAGGGTTCAT,0,1742802
gyrAp,0.2,4,4,TATCAAGGGAACGGATACGT,0,1768527
gyrAp,0.2,4,4,TATAAGTTCTCAGTAAAGCA,0,1757105
gyrAp,0.2,4,4,TAGGTTTATCTTAAGAGATG,0,1756179
gyrAp,0.2,4,4,TAGGGCTCATTCACTACGAC,0,1747753
gyrAp,0.2,4,4,TAGCGCGGCTTTACGGGATA,0,1748754
gyrAp,0.2,4,4,TACTCCAAGGCTCTAGAAAC,0,1766965
gyrAp,0.2,4,4,TACTAGAATTGCCAGGGGTG,0,1769901
gyrAp,0.2,4,4,TACTACGATGGCCGCACCAT,0,1750414
gyrAp,0.2,4,4,TACGTACCACGGAATAGCCA,0,1766093
gyrAp,0.2,4,4,TACGGGGCAATCCGGGTAAA,0,1754468
gyrAp,0.2,4,4,TACGAAACCCTATAGGTGAA,0,1764961
gyrAp,0.2,4,4,TACCTTTTATTCGGATGCAG,0,1762026
gyrAp,0.2,4,4,TACCCCCACTTGGCCCGCTT,0,1748912
gyrAp,0.2,4,4,TACCATCTGGCGAGCGCCTT,0,1744957
gyrAp,0.2,4,4,TACCAAGCGTGTTTCGCCTC,0,1752998
gyrAp,0.2,4,4,TACATGTAACCATAGCGTTG,0,1751272
gyrAp,0.2,4,4,TACAAAACGGAACGTTTATG,0,1769732
gyrAp,0.2,4,4,TAATTTTGGCTGACGCGGGG,0,1747833
gyrAp,0.2,4,4,TAAGTACGTTGTGGTATTTG,0,1765272
gyrAp,0.2,4,4,TAAGTAATAAGTGGTCTCGT,0,1745300
gyrAp,0.2,4,4,TAAACGCGGGGAGGCATCTT,0,1767432
gyrAp,0.2,4,4,GTTTTCCTAAGGCGAAGAGT,0,1746399
gyrAp,0.2,4,4,GTTGGCTGCACAAAGCTAGG,0,1750990
gyrAp,0.2,4,4,GTTCGTGAATCGATTCTGTG,0,1747218
gyrAp,0.2,4,4,GTTCAAGTGACTCCGAGGGA,0,1757129
gyrAp,0.2,4,4,GTTACCCACCCTAGCACCAT,0,1767147
gyrAp,0.2,4,4,GTGTGCACATTGGTTTCTAC,0,1743060
gyrAp,0.2,4,4,GTGTCGTGACGGGTCAACAG,0,1750237
gyrAp,0.2,4,4,GTGTCGGGCTAAGCTCGTCT,0,1751305
gyrAp,0.2,4,4,GTGTAGATCTCCGCCGGAGT,0,1758465
gyrAp,0.2,4,4,GTGTACCGCAGGGAAAACGT,0,1763382
gyrAp,0.2,4,4,GTGGTTTTCTTATGTGTCGT,0,1754033
gyrAp,0.2,4,4,GTGGGGGATGCCGTCAGCAG,0,1746866
gyrAp,0.2,4,4,GTGGGGCCATTAGAGTCGCA,0,1746811
gyrAp,0.2,4,4,GTGCTGCTTGGAGGGTATTC,0,1751180
gyrAp,0.2,4,4,GTGCGACTACCTCGCGATAC,0,1753861
gyrAp,0.2,4,4,GTGCACAGTCAGTCTGCTCA,0,1756691
gyrAp,0.2,4,4,GTCTTAATATCTTTTGGGTT,0,1750996
gyrAp,0.2,4,4,GTCTCTGTCACAGGCGTGCC,0,1756930
gyrAp,0.2,4,4,GTCTATATAATCTAGCGGTG,0,1760589
gyrAp,0.2,4,4,GTCTAGGAAGATTTTGGTAC,0,1750994
gyrAp,0.2,4,4,GTCTAAAGTTTGTTGTATGC,0,1749865
gyrAp,0.2,4,4,GTCGGTAGGGCGGAGAAAAG,0,1768013
gyrAp,0.2,4,4,GTCCGGTGATGTGGCGTGTT,0,1762483
gyrAp,0.2,4,4,GTCCGCTTGCGTTTAACGAT,0,1742471
gyrAp,0.2,4,4,GTCCACGCACTGTGTAGTAT,0,1759869
gyrAp,0.2,4,4,GTCAGCAACAATTGTGCAGG,0,1751692
gyrAp,0.2,4,4,GTCAGAAGTGAGGACAACAA,0,1766497
gyrAp,0.2,4,4,GTCAACTCGCCCACTGTACC,0,1757335
gyrAp,0.2,4,4,GTATTGGCTAATTCGCTTTT,0,1745988
gyrAp,0.2,4,4,GTATTCGGCGTCATCCCGGT,0,1770863
gyrAp,0.2,4,4,GTAGATCTTATTCACGGTGC,0,1753906
gyrAp,0.2,4,4,GTACCAAAATTCCCGCGTGT,0,1745175
gyrAp,0.2,4,4,GTAACGCTTCCTGGCGCAAT,0,1769334
gyrAp,0.2,4,4,GGTTTTGGGCTAGGCACGAA,0,1769109
gyrAp,0.2,4,4,GGTTCTACATGCCAAACGCT,0,1743994
gyrAp,0.2,4,4,GGTGGTGTCTCGCCGATAGC,0,1760086
gyrAp,0.2,4,4,GGTGACTGATTTACAGTGGT,0,1754406
gyrAp,0.2,4,4,GGTCTCTGCTTCAGACCGAG,0,1746323
gyrAp,0.2,4,4,GGTCCTGCGGCGAGTACAGA,0,1763953
gyrAp,0.2,4,4,GGTAGCGAGCAGCTGTTGGT,0,1753245
gyrAp,0.2,4,4,GGTAGATATCAAATTAGGCG,0,1749950
gyrAp,0.2,4,4,GGGTCTATCAGCCCTACCTA,0,1745996
gyrAp,0.2,4,4,GGGGTCGCCGTTCCCGATTC,0,1764575
gyrAp,0.2,4,4,GGGGTCGATCCATCGTTTCA,0,1766527
gyrAp,0.2,4,4,GGGGTCCATAGCGTAGATTA,0,1768513
gyrAp,0.2,4,4,GGGGGGACACCCGAGCCTCA,0,1753214
gyrAp,0.2,4,4,GGGGGATTCATTATCTGGAT,0,1742783
gyrAp,0.2,4,4,GGGCTGGTCATGTTAGTCCT,0,1751642
gyrAp,0.2,4,4,GGGCAAAATTCATACAGCGC,0,1748235
gyrAp,0.2,4,4,GGGAGGGTCCACGTCGCTTT,0,1749380
gyrAp,0.2,4,4,GGCTGTTGAGAGCCTCTGAT,0,1749848
gyrAp,0.2,4,4,GGCTACTGTCGCGGAGGCCT,0,1766064
gyrAp,0.2,4,4,GGCGGTTCGGGCACTTCAGC,0,1745846
gyrAp,0.2,4,4,GGCGAATCTCAGGGTCCTGT,0,1767006
gyrAp,0.2,4,4,GGCCCCTCAGAGCAGTGGTC,0,1756256
gyrAp,0.2,4,4,GGCCATATGAGTATGCAGAT,0,1743301
gyrAp,0.2,4,4,GGCAGCTCCTTTTTCACTAG,0,1745869
gyrAp,0.2,4,4,GGCACAGAAGGACATTGGGC,0,1768103
gyrAp,0.2,4,4,GGATTAGACTCAGGTGATTT,0,1763091
gyrAp,0.2,4,4,GGATCTTGTGTATATGCCAA,0,1749562
gyrAp,0.2,4,4,GGATCCGGCCATCGAGCCTA,0,1761936
gyrAp,0.2,4,4,GGAGTCTGTCCGGACTATGG,0,1769250
gyrAp,0.2,4,4,GGAGGTTTGGCGGAACGTCG,0,1750057
gyrAp,0.2,4,4,GGAGCGTCGCTCGATGCGGG,0,1743898
gyrAp,0.2,4,4,GGACGGTCTTAGGTAAGAGC,0,1756220
gyrAp,0.2,4,4,GGACCTTAGAAGCTAACCAA,0,1756689
gyrAp,0.2,4,4,GGACCATAAGTAATCTGTTT,0,1758597
gyrAp,0.2,4,4,GGAATTACCGTGGTGAAACG,0,1765320
gyrAp,0.2,4,4,GGAAACGTTGTACCGCTAGC,0,1744093
gyrAp,0.2,4,4,GGAAAACTCGATACATGCCA,0,1743837
gyrAp,0.2,4,4,GCTGGAACAGTCTATTGACA,0,1767934
gyrAp,0.2,4,4,GCTGACCCGGGTAGTGCCGC,0,1748615
gyrAp,0.2,4,4,GCTCTGGTTGGTAGATCGTA,0,1756534
gyrAp,0.2,4,4,GCTCGCTACATGAACATCTG,0,1759739
gyrAp,0.2,4,4,GCTACCCATTCCACCTTCGT,0,1753430
gyrAp,0.2,4,4,GCGTTTCCCCTGCGGCCAAG,0,1748908
gyrAp,0.2,4,4,GCGTTAATGGATATTACACC,0,1759339
gyrAp,0.2,4,4,GCGTCTCGGCCGGGACGGAC,0,1767350
gyrAp,0.2,4,4,GCGGCGACTTGGGAGCTCAC,0,1760255
gyrAp,0.2,4,4,GCGCGTGGTGATCGTACCGA,0,1763996
gyrAp,0.2,4,4,GCGATTCACTGCTGCAGAAA,0,1766403
gyrAp,0.2,4,4,GCGACGTAAGAGGAAGAGTT,0,1753671
gyrAp,0.2,4,4,GCCTGTCCGTTCTTCGCCCC,0,1755933
gyrAp,0.2,4,4,GCCTCTCCGAAATTGAGCTT,0,1751777
gyrAp,0.2,4,4,GCCTCGCGGCAGCGTTACTA,0,1746388
gyrAp,0.2,4,4,GCCTCGCGACGTCAGGCATT,0,1751821
gyrAp,0.2,4,4,GCCGCATCCCTATTTGACCA,0,1742086
gyrAp,0.2,4,4,GCCGAGGGTTTTCAAGGAAG,0,1770442
gyrAp,0.2,4,4,GCCCCGACATGCAATCCGAC,0,1766341
gyrAp,0.2,4,4,GCCCCACGCCGTTCGGTAAA,0,1754567
gyrAp,0.2,4,4,GCATTTGTATCGGACTCGTT,0,1743468
gyrAp,0.2,4,4,GCATGTGCGGGATGACGTAA,0,1747892
gyrAp,0.2,4,4,GCAGTATTGTACTGCGCGCG,0,1751012
gyrAp,0.2,4,4,GCAGCTTCCGCGGGGGCGTG,0,1746395
gyrAp,0.2,4,4,GCAAAAGTGTAACGAAGGCA,0,1760471
gyrAp,0.2,4,4,GATTCTGCAGCATTATGTCC,0,1744325
gyrAp,0.2,4,4,GATTCCTGTGCGATATGTAC,0,1751897
gyrAp,0.2,4,4,GATTACCGTAGATGAACAGT,0,1760229
gyrAp,0.2,4,4,GATGTTAGTCTCCGGGATAG,0,1767683
gyrAp,0.2,4,4,GATGTGATTTTCAACTGAAC,0,1746966
gyrAp,0.2,4,4,GATGTCTAAACTTGGGCGTC,0,1744721
gyrAp,0.2,4,4,GATGCCAAGCTTCTGACCAT,0,1766175
gyrAp,0.2,4,4,GATGCAAGCTAATCCGGCGT,0,1768075
gyrAp,0.2,4,4,GATCACCACTACGGAGGTTT,0,1757128
gyrAp,0.2,4,4,GATATTGCTCGTTATACCTT,0,1751550
gyrAp,0.2,4,4,GATACCCATCTGCTAAGTTC,0,1767471
gyrAp,0.2,4,4,GAGTTATGCTCCTTTTGACG,0,1770035
gyrAp,0.2,4,4,GAGGGAAACATATAACGCTT,0,1768014
gyrAp,0.2,4,4,GAGGCTGCGCAACCACGTTA,0,1744722
gyrAp,0.2,4,4,GAGGATGGTCGCAATGACAT,0,1754821
gyrAp,0.2,4,4,GAGGAATGTAGAACTTTAGA,0,1752570
gyrAp,0.2,4,4,GAGCTAATCCTTGGGCGCAA,0,1745904
gyrAp,0.2,4,4,GAGCGCGGGTAAAAATGAGG,0,1759241
gyrAp,0.2,4,4,GAGCGAGCTGACTAACATGG,0,1754249
gyrAp,0.2,4,4,GAGCCTGTTGAGTTAAGCTC,0,1766069
gyrAp,0.2,4,4,GAGACTAAAAATAAGAGATG,0,1750942
gyrAp,0.2,4,4,GAGAATGTAGAGAAATAAAC,0,1767556
gyrAp,0.2,4,4,GACTGGCTAGATTCCTACGG,0,1756384
gyrAp,0.2,4,4,GACTCTTAGACCTATCGAAA,0,1748223
gyrAp,0.2,4,4,GACGTGGCCCGGTTGCGAAG,0,1764465
gyrAp,0.2,4,4,GACCTGTGCTGCGCCCCGGC,0,1755078
gyrAp,0.2,4,4,GACCTGCCAGGCCGCGGGGC,0,1753321
gyrAp,0.2,4,4,GACCTCTTCATAAAAGCCTA,0,1761976
gyrAp,0.2,4,4,GACCTAGAGAGGACGACATG,0,1755822
gyrAp,0.2,4,4,GACCGGACTCTATTGAGAAG,0,1753328
gyrAp,0.2,4,4,GACCCGGGTAAGGCCTGCAG,0,1743992
gyrAp,0.2,4,4,GACCAAATACTAACCCCGAT,0,1754946
gyrAp,0.2,4,4,GACAGGACCCAGGAATGAAT,0,1749055
gyrAp,0.2,4,4,GACACGTGATCTTTAATCAG,0,1766008
gyrAp,0.2,4,4,GAATTGAGAATCGTTTAGAT,0,1752441
gyrAp,0.2,4,4,GAATGCATTGGTTCCTGGCG,0,1756761
gyrAp,0.2,4,4,GAACTAGATTAAATTTTCTC,0,1752538
gyrAp,0.2,4,4,GAACCCATTGTCGTCCGAAG,0,1765521
gyrAp,0.2,4,4,GAACATAAGTGGTTATTACC,0,1753349
gyrAp,0.2,4,4,GAAATTCTTGTAATGGCGAA,0,1743741
gyrAp,0.2,4,4,GAAAGAGATCACCAGACCTG,0,1748316
gyrAp,0.2,4,4,CTTTTTCTTCTTTTGTTTGT,0,1759876
gyrAp,0.2,4,4,CTTTCTCCGCAGATGTCGTT,0,1765238
gyrAp,0.2,4,4,CTTTATCCTTCATCTTGCGA,0,1753609
gyrAp,0.2,4,4,CTTGGTCGGCACTAGGAGAG,0,1767569
gyrAp,0.2,4,4,CTTGGAAAGCTTGAAAGCCA,0,1764329
gyrAp,0.2,4,4,CTTGACAAAGACACGCAAGG,0,1752665
gyrAp,0.2,4,4,CTTGAATCCTCATAAATAAC,0,1743862
gyrAp,0.2,4,4,CTTGAAAGTTGGACCTGTTG,0,1753727
gyrAp,0.2,4,4,CTTCTTGATCGATGTTTCCA,0,1769725
gyrAp,0.2,4,4,CTTAGTTGCCGCAAATGCGG,0,1758492
gyrAp,0.2,4,4,CTTAATCCGGCGCAAAGTGA,0,1745501
gyrAp,0.2,4,4,CTTAAAGGAAGGGTGCACAT,0,1751875
gyrAp,0.2,4,4,CTGGTCTGTATAGCACGTGA,0,1751351
gyrAp,0.2,4,4,CTGATTAACGTTTCACATTT,0,1742129
gyrAp,0.2,4,4,CTGACCCTGTGGTATCCCTA,0,1766045
gyrAp,0.2,4,4,CTGACAAATGTCTTTATTTC,0,1762582
gyrAp,0.2,4,4,CTGAACGACGTCTAGATGCC,0,1749321
gyrAp,0.2,4,4,CTGAAACAGTTGCGCAGACT,0,1749385
gyrAp,0.2,4,4,CTCTGCCTTCTGAAGACCTT,0,1750559
gyrAp,0.2,4,4,CTCTCTGGTGAGACTGCGGG,0,1757238
gyrAp,0.2,4,4,CTCTAAATCTTAGGAGGGGA,0,1761221
gyrAp,0.2,4,4,CTCGGCCTCTGATTCTGAAT,0,1762529
gyrAp,0.2,4,4,CTCGACCAACGTGGGGTCGG,0,1748136
gyrAp,0.2,4,4,CTCCTAGTCTGCGTGGATCA,0,1757324
gyrAp,0.2,4,4,CTCCGGCACAGCTCAGATCG,0,1762046
gyrAp,0.2,4,4,CTCAGGAGTTGACTATCAAA,0,1768855
gyrAp,0.2,4,4,CTATGTACAATCCAGTGCCA,0,1753933
gyrAp,0.2,4,4,CTATGGTGCTCGGAGTGGGA,0,1770428
gyrAp,0.2,4,4,CTATCTATGGGATACGTGCT,0,1746604
gyrAp,0.2,4,4,CTATAGAGGATCGTTAAGGC,0,1745102
gyrAp,0.2,4,4,CTATACCTCCACAGACCGCT,0,1767578
gyrAp,0.2,4,4,CTAGCTGTCTGAATCGGAGG,0,1753763
gyrAp,0.2,4,4,CTAGCTCAGGTGAGCGTGTA,0,1757047
gyrAp,0.2,4,4,CTAGCACTGTCCCCGATATA,0,1760956
gyrAp,0.2,4,4,CTACTCTCCTTAAGCACTTA,0,1750279
gyrAp,0.2,4,4,CTACGATTCTGTACAACTAT,0,1760404
gyrAp,0.2,4,4,CTAACTATGGGCGGAAGCAG,0,1752409
gyrAp,0.2,4,4,CTAAAAACCAATGAAAAACT,0,1750284
gyrAp,0.2,4,4,CGTTCGGCCTCGTGGACTCA,0,1742878
gyrAp,0.2,4,4,CGTTCCTGGTATATTGAGTT,0,1745255
gyrAp,0.2,4,4,CGTGCGTGTTGTGCGGTGAA,0,1762657
gyrAp,0.2,4,4,CGTGCAGAAATCGAGTGCTA,0,1743034
gyrAp,0.2,4,4,CGTGAGGGGGTTGGACTCAA,0,1754896
gyrAp,0.2,4,4,CGTCGGTGCGCTGACACATA,0,1748099
gyrAp,0.2,4,4,CGTCGCCGGTAGAATACATC,0,1753685
gyrAp,0.2,4,4,CGTACTGGTCCACTCACGCT,0,1763645
gyrAp,0.2,4,4,CGGTTCGGGCGGAGGGCTAT,0,1747778
gyrAp,0.2,4,4,CGGGTAAGCTGTCCCGAGGG,0,1745409
gyrAp,0.2,4,4,CGGCACCTTGCCTTAGACTT,0,1747613
gyrAp,0.2,4,4,CGGAGTGTAGCGAATCGCCG,0,1768054
gyrAp,0.2,4,4,CGGAGATCAGACTGGCTCTT,0,1741968
gyrAp,0.2,4,4,CGCTGTGCATAGACCTGGTG,0,1747682
gyrAp,0.2,4,4,CGCTACTCTGGCCAACCAGT,0,1770432
gyrAp,0.2,4,4,CGCGTAAGTGCTGCGGGTTC,0,1748404
gyrAp,0.2,4,4,CGCGGATCTGAGCAAAGCGC,0,1748486
gyrAp,0.2,4,4,CGCGAAGGGATGGTCAAATT,0,1765053
gyrAp,0.2,4,4,CGCCTATTAATATGCCGGGC,0,1753702
gyrAp,0.2,4,4,CGCATTTGCCGATTTAGCAT,0,1747568
gyrAp,0.2,4,4,CGCATAGCATATGGTCATCA,0,1751778
gyrAp,0.2,4,4,CGCACACGAATTATTCACAT,0,1756047
gyrAp,0.2,4,4,CGATAGGGCGGCTCCCGCCA,0,1756911
gyrAp,0.2,4,4,CGAGTTTGTGTAGGTGCCAA,0,1762467
gyrAp,0.2,4,4,CGAGTAAGAGTTGGAAGACA,0,1751275
gyrAp,0.2,4,4,CGAGGAGGCACTCAGCAACG,0,1750066
gyrAp,0.2,4,4,CGACGCGAAACTCGCCATCC,0,1752021
gyrAp,0.2,4,4,CCTTCGGCTACATCCCAAGG,0,1748077
gyrAp,0.2,4,4,CCTTAGCAGCAACTCGAACA,0,1757790
gyrAp,0.2,4,4,CCTGTGGGCGGCCTAAGAAT,0,1766107
gyrAp,0.2,4,4,CCTCCCCAAGTAGCCGCATT,0,1762091
gyrAp,0.2,4,4,CCTAGGTATGGTCGCGTCTT,0,1763995
gyrAp,0.2,4,4,CCTAAACGACAGTAGCTAAA,0,1765167
gyrAp,0.2,4,4,CCGTTATTTGTCAATGGCCT,0,1753538
gyrAp,0.2,4,4,CCGTGTGGCTTCGTAGCCTG,0,1759826
gyrAp,0.2,4,4,CCGTCTGTAACCATCTAGCA,0,1747242
gyrAp,0.2,4,4,CCGGTGTCGTTTATGGGCAT,0,1770738
gyrAp,0.2,4,4,CCGGGGTTGGCCTAAGCAAT,0,1759635
gyrAp,0.2,4,4,CCGGCCTCCGATTCAAGCCA,0,1742259
gyrAp,0.2,4,4,CCGGATAAGTAATCAGCGAA,0,1748993
gyrAp,0.2,4,4,CCGCGGGGGCTATCTGGTTG,0,1743074
gyrAp,0.2,4,4,CCGCAAACAATTCAGTCATG,0,1744205
gyrAp,0.2,4,4,CCCTCTTCGGGTGGGCGCGT,0,1759893
gyrAp,0.2,4,4,CCCTCGCAAGGATTATATGA,0,1742646
gyrAp,0.2,4,4,CCCTCAACTCGGCCGGACTA,0,1753501
gyrAp,0.2,4,4,CCCTAGTCCAAATCGGGTCA,0,1760837
gyrAp,0.2,4,4,CCCGTGTTGCAACTTAGCTG,0,1742831
gyrAp,0.2,4,4,CCCGGTTTCTTTTCTGGTGT,0,1742286
gyrAp,0.2,4,4,CCCCATAGGTCTTGTTTGCG,0,1750419
gyrAp,0.2,4,4,CCCCACGGCAGACGCGAGGG,0,1752082
gyrAp,0.2,4,4,CCCATCTCATAATTTCTGGG,0,1745913
gyrAp,0.2,4,4,CCCAGGGCGGTCCCTTATGT,0,1767211
gyrAp,0.2,4,4,CCCACCGCGCACAGACTGCC,0,1751463
gyrAp,0.2,4,4,CCCACAGGGACGATTCGTCC,0,1760717
gyrAp,0.2,4,4,CCATTTTCGGTACCTTGGCT,0,1762620
gyrAp,0.2,4,4,CCATAAGCGCGCCGTGTTGC,0,1751051
gyrAp,0.2,4,4,CCAGGTCATAAGCTGACAAT,0,1747705
gyrAp,0.2,4,4,CCAGGCGTCCAGTAGGATGG,0,1756053
gyrAp,0.2,4,4,CCAGAAATTTTGACTACTGA,0,1757757
gyrAp,0.2,4,4,CCACTCAGCAAGGGCCTTTG,0,1768280
gyrAp,0.2,4,4,CCACCGTATTTACCAGGCGA,0,1745699
gyrAp,0.2,4,4,CCACCATGTTCGATATGATG,0,1745541
gyrAp,0.2,4,4,CCAAGGCAGTGGCGAGCCCC,0,1752294
gyrAp,0.2,4,4,CATCCAGTCGAGAGCACATT,0,1763839
gyrAp,0.2,4,4,CAGTGTGAGTACAACGACTC,0,1764641
gyrAp,0.2,4,4,CAGTCCGTAGTTGTGTATGA,0,1769094
gyrAp,0.2,4,4,CAGGGGATCATACAGTCTGA,0,1748258
gyrAp,0.2,4,4,CAGGGAGAGAGGGAATTTAA,0,1764629
gyrAp,0.2,4,4,CAGCCAATTAGACTTGGACG,0,1746091
gyrAp,0.2,4,4,CACGTTCATTCGATTCTGAG,0,1769166
gyrAp,0.2,4,4,CACGCAGAAATTGCACAAGG,0,1748739
gyrAp,0.2,4,4,CACCTCCGAGTAACAGGCAG,0,1770701
gyrAp,0.2,4,4,CACCATAGCATTCGGGAGGA,0,1760701
gyrAp,0.2,4,4,CACCAATTAGAAATCGGAGG,0,1766257
gyrAp,0.2,4,4,CACACGGCGCGGCCTGAAAT,0,1750228
gyrAp,0.2,4,4,CACACACGAGGGTAGACCAA,0,1756264
gyrAp,0.2,4,4,CAAGTCCGCGCCTAGGGACG,0,1747279
gyrAp,0.2,4,4,CAAGTATTGTGCGGGTGAAC,0,1741845
gyrAp,0.2,4,4,CAAGCAAATTCACCACAAGG,0,1750055
gyrAp,0.2,4,4,CAAGAAACGAATCCACGTTA,0,1751735
gyrAp,0.2,4,4,CAACCGAACGGCTTCCGTAA,0,1768778
gyrAp,0.2,4,4,CAACATAGCAAGGTATGGCT,0,1750305
gyrAp,0.2,4,4,CAACACAGTTTTTGAGACTT,0,1754186
gyrAp,0.2,4,4,CAAATTTACCCACTAGGAGG,0,1752304
gyrAp,0.2,4,4,CAAATGAGGGCCAGATAGGA,0,1767113
gyrAp,0.2,4,4,CAAATAAGTCGTTCTGGCGG,0,1746435
gyrAp,0.2,4,4,CAAAAAATGAAGCTTCACGT,0,1768984
gyrAp,0.2,4,4,ATTGGGTGAAGGGTGGTCAC,0,1767947
gyrAp,0.2,4,4,ATTGCGTTCATAAGGGCACT,0,1752636
gyrAp,0.2,4,4,ATTGCGCCGGCGTTGCAGCG,0,1746750
gyrAp,0.2,4,4,ATTCTATGAGGTCCTAGGAA,0,1760137
gyrAp,0.2,4,4,ATTCGTGCGTTCCAGAGGTC,0,1742821
gyrAp,0.2,4,4,ATTCCACATTGATCCTAGAT,0,1762271
gyrAp,0.2,4,4,ATTAGTCATGCGCTCACATT,0,1767357
gyrAp,0.2,4,4,ATTAACTGACCATCGCGGTG,0,1747852
gyrAp,0.2,4,4,ATGGGTGAACGAGATGTATC,0,1768559
gyrAp,0.2,4,4,ATGCTAGCGTATTTCTAGCG,0,1769467
gyrAp,0.2,4,4,ATGCGCATTATCATGTCTCT,0,1768968
gyrAp,0.2,4,4,ATGCAATGAGTGTAAAGTTA,0,1757633
gyrAp,0.2,4,4,ATGATGTTGCTCCCCGCCCT,0,1744586
gyrAp,0.2,4,4,ATGATGCCGTGGGTGGTCCC,0,1760106
gyrAp,0.2,4,4,ATGAGATCTGGGACTGGTCA,0,1758524
gyrAp,0.2,4,4,ATGACTCGCAGATCCACACT,0,1761045
gyrAp,0.2,4,4,ATCTCTCTCAGCAGTGATTA,0,1760133
gyrAp,0.2,4,4,ATCGAGTCGGACACCAAAAA,0,1761887
gyrAp,0.2,4,4,ATCCTCCCTCAGGCAAGAGA,0,1757667
gyrAp,0.2,4,4,ATCCTCCCAAAGTCTTTTCA,0,1744582
gyrAp,0.2,4,4,ATCACGCCTAGCTACGAAGC,0,1759037
gyrAp,0.2,4,4,ATATTGATCATCGGGAAGTC,0,1760329
gyrAp,0.2,4,4,ATATGCTTGTCCATCGTTCC,0,1754737
gyrAp,0.2,4,4,ATATCTAAACCTCACCATAC,0,1768981
gyrAp,0.2,4,4,ATATCACAACGAGCAATTAG,0,1760484
gyrAp,0.2,4,4,ATATAGCGTTCTAATGAGAG,0,1749849
gyrAp,0.2,4,4,ATAGGGAGGTGCATAACAGG,0,1745362
gyrAp,0.2,4,4,ATACAATTATGGGCGGCACA,0,1748868
gyrAp,0.2,4,4,ATAATTGTGGCAGCCAAAGG,0,1743431
gyrAp,0.2,4,4,ATAATATCTGGTCGTCGCCG,0,1746458
gyrAp,0.2,4,4,ATAACCCCCGTTGAGTGTTC,0,1742005
gyrAp,0.2,4,4,ATAAAAATCGTTAAGACGCG,0,1752400
gyrAp,0.2,4,4,AGTTACTGTATTAGACGCTA,0,1746178
gyrAp,0.2,4,4,AGTGTTCGAGGCCACCGGCT,0,1765852
gyrAp,0.2,4,4,AGTCGAACGCTTACATTGCT,0,1768853
gyrAp,0.2,4,4,AGTCACCATCTCAAAATATA,0,1753934
gyrAp,0.2,4,4,AGTATGATCGTTCGTCATAG,0,1769615
gyrAp,0.2,4,4,AGTATGATACAGCGAGTAGG,0,1755357
gyrAp,0.2,4,4,AGTATCTGTGTCACTCGAAG,0,1761406
gyrAp,0.2,4,4,AGTAATGTGATTAACTATCT,0,1750919
gyrAp,0.2,4,4,AGGTCCTCACAAGGTATTCC,0,1749948
gyrAp,0.2,4,4,AGGTATTAGAGAACGATCTC,0,1759433
gyrAp,0.2,4,4,AGGGAACAGATAATAGTGTA,0,1759061
gyrAp,0.2,4,4,AGGCCATTGCTCATACAATG,0,1742045
gyrAp,0.2,4,4,AGGATCTAAAGGCACAGAGG,0,1749597
gyrAp,0.2,4,4,AGCTGTCTCCGTAATCCCGA,0,1750748
gyrAp,0.2,4,4,AGCTGCAACAGAATTTGCTC,0,1765448
gyrAp,0.2,4,4,AGCTCGGTATCGGAGTACGT,0,1748996
gyrAp,0.2,4,4,AGCTACAGAGTAACTTGCTT,0,1765195
gyrAp,0.2,4,4,AGCGCTAGATCATGGAGCAA,0,1760246
gyrAp,0.2,4,4,AGCGCCCAAACCAAAATTGT,0,1770160
gyrAp,0.2,4,4,AGCCCTACACGCCGATGCAA,0,1756178
gyrAp,0.2,4,4,AGCATTAAGGGAGGCCATGA,0,1748680
gyrAp,0.2,4,4,AGCACGCTCTTTAATAATCT,0,1752411
gyrAp,0.2,4,4,AGCAAAATGTATTTGAGCAA,0,1753598
gyrAp,0.2,4,4,AGATTGAGAATCGGTTTGGG,0,1760438
gyrAp,0.2,4,4,AGATGCATGCAAAGTTTCCG,0,1743813
gyrAp,0.2,4,4,AGATAGGTAAATTAACAGCA,0,1746102
gyrAp,0.2,4,4,AGATAACTACGTGTGGTCCG,0,1768568
gyrAp,0.2,4,4,AGATAAAGAAGGGGGCGCAA,0,1744179
gyrAp,0.2,4,4,AGAGGCGCTTGGGGTTGATA,0,1753076
gyrAp,0.2,4,4,AGACGATCTCGGCGTCTCGC,0,1755489
gyrAp,0.2,4,4,AGACAAAGCCATTCTAAAGG,0,1770214
gyrAp,0.2,4,4,ACTTGTTGGTATTCTTATGG,0,1741654
gyrAp,0.2,4,4,ACTTAATTCTGTTGGAAAGG,0,1745229
gyrAp,0.2,4,4,ACTGGTTCTGGCTCGTGCGC,0,1762387
gyrAp,0.2,4,4,ACTGGATCACGTTACAGCAG,0,1747418
gyrAp,0.2,4,4,ACTGATGGGCCTAGCCGAGG,0,1766270
gyrAp,0.2,4,4,ACTCATCCAAGAGATCTACT,0,1763873
gyrAp,0.2,4,4,ACGTTAGACGGGGCATAATG,0,1752058
gyrAp,0.2,4,4,ACGTCTATTCGGGTCTATGC,0,1748466
gyrAp,0.2,4,4,ACGTCAAGCCAATGTCCTCT,0,1751036
gyrAp,0.2,4,4,ACGGATATACTCAATTGAGA,0,1763452
gyrAp,0.2,4,4,ACGGAGTGCCGAAGAAAAAT,0,1763014
gyrAp,0.2,4,4,ACGGACGCCGGACCTACACC,0,1762334
gyrAp,0.2,4,4,ACGCCCGATCCAAGGGTGAA,0,1750797
gyrAp,0.2,4,4,ACGAGTGGGGTAGACACACA,0,1741906
gyrAp,0.2,4,4,ACGAAATGCCGTCCCATTAA,0,1765061
gyrAp,0.2,4,4,ACCGGCCGGAATAAGCCGCA,0,1770006
gyrAp,0.2,4,4,ACCCAAGTCCACTAAGTTAA,0,1756313
gyrAp,0.2,4,4,ACCATCGACGGGCGAAAATT,0,1757986
gyrAp,0.2,4,4,ACCAGCATCGGCACACTTAC,0,1744867
gyrAp,0.2,4,4,ACCACCAGACAATCTAAAGA,0,1762936
gyrAp,0.2,4,4,ACCACAAGGTCGGCATGACG,0,1748623
gyrAp,0.2,4,4,ACATTTCAGTGAGTGACTTA,0,1758444
gyrAp,0.2,4,4,ACATTGTTGGCGATCTCCTG,0,1750497
gyrAp,0.2,4,4,ACATGTCCAACCTTATATCT,0,1753897
gyrAp,0.2,4,4,ACATGTAGGCTGATGAAGAC,0,1756801
gyrAp,0.2,4,4,ACAGGGAAGTTCAAGCTTAA,0,1760392
gyrAp,0.2,4,4,ACAGATTATCGTTTCGTACC,0,1764146
gyrAp,0.2,4,4,ACACCACCCTTACAGACCCT,0,1744293
gyrAp,0.2,4,4,ACACACCTTCGGATATATCA,0,1751502
gyrAp,0.2,4,4,ACAATACCAGCCAACAGACT,0,1747595
gyrAp,0.2,4,4,ACAACGGCGTTAATTTCGAT,0,1745026
gyrAp,0.2,4,4,ACAACGAGGTGCCGCCCCAA,0,1751439
gyrAp,0.2,4,4,AATTAGGCAACCACGCTCTC,0,1753034
gyrAp,0.2,4,4,AATGTGGGTACCCCAATCTC,0,1762934
gyrAp,0.2,4,4,AATGTGCGAGTCATTTATAG,0,1745194
gyrAp,0.2,4,4,AATGTCATCGACACGTGCCG,0,1770823
gyrAp,0.2,4,4,AATGCCTCATGGCTTAGTCA,0,1751764
gyrAp,0.2,4,4,AATCGTTTTACACGAGAGTT,0,1757753
gyrAp,0.2,4,4,AATCGGGACGCGGAGGACGA,0,1770794
gyrAp,0.2,4,4,AATCATTAGGCGCACGCCAG,0,1766258
gyrAp,0.2,4,4,AATCATCGCTTGTTAGTTCT,0,1742126
gyrAp,0.2,4,4,AATCAAACACCGGTACACGT,0,1763107
gyrAp,0.2,4,4,AATAGTGGTACCGCATCTTG,0,1759060
gyrAp,0.2,4,4,AATAGATCCGGGCTATCCGT,0,1765336
gyrAp,0.2,4,4,AATAGAAACCGTGCTGTCCT,0,1763144
gyrAp,0.2,4,4,AATACTACATATATATGAGT,0,1762623
gyrAp,0.2,4,4,AATACCCTAAAGAGCTGCTG,0,1744004
gyrAp,0.2,4,4,AATACAACGCACCTCACTCC,0,1762703
gyrAp,0.2,4,4,AATAACACCCGAGTTTGACG,0,1745215
gyrAp,0.2,4,4,AAGTGTCACTTAGCATGTCA,0,1744497
gyrAp,0.2,4,4,AAGTGCGGAGTTGGCGGTTG,0,1765770
gyrAp,0.2,4,4,AAGTCCCGTCTGGAGCGCGT,0,1756337
gyrAp,0.2,4,4,AAGTAATGACACGGGGCTTA,0,1764740
gyrAp,0.2,4,4,AAGGGTACTACGTTCCACGT,0,1746051
gyrAp,0.2,4,4,AAGGGCTGTGCGGTAGTCCG,0,1769997
gyrAp,0.2,4,4,AAGCTGGGATCTAGTAAGAT,0,1766317
gyrAp,0.2,4,4,AAGATGAAGTAAAGAAAAAT,0,1743520
gyrAp,0.2,4,4,AAGAGCAGCAATTGGACTAT,0,1763533
gyrAp,0.2,4,4,AACTTAACAAGTGTTAGGTC,0,1746864
gyrAp,0.2,4,4,AACGGGGGCGCCGCACTGTT,0,1763297
gyrAp,0.2,4,4,AACCAGTCCACCACCGGGTG,0,1768777
gyrAp,0.2,4,4,AACCACGGAAACCGCAAAGC,0,1770732
gyrAp,0.2,4,4,AACATTGATGAATACAAATT,0,1765333
gyrAp,0.2,4,4,AACAGGTGGATGCGAAGGAT,0,1765941
gyrAp,0.2,4,4,AACAATCTATACGAGAGGCA,0,1746596
gyrAp,0.2,4,4,AACAAGCGCCCGTCCAATGT,0,1742698
gyrAp,0.2,4,4,AACAAAGAAGGTTGTAGCTG,0,1755095
gyrAp,0.2,4,4,AAATGTTCGAAAGGCAACCC,0,1741877
gyrAp,0.2,4,4,AAATGGAGGCGGTCCGCCAA,0,1749577
gyrAp,0.2,4,4,AAATAAAAATCCCGAAGGAT,0,1743752
gyrAp,0.2,4,4,AAAGATTACGATTTGGGGCA,0,1749411
gyrAp,0.2,4,4,AAACTTGCATATACCACGGA,0,1747782
gyrAp,0.2,4,4,AAACGCCACTCCGTCATCAG,0,1755403
gyrAp,0.2,4,4,AAACATGACCCCGGAGATTG,0,1755770
gyrAp,0.2,4,4,AAAATTGTCTTTAGAACCTG,0,1765804
gyrAp,0.2,4,4,AAAAGTATTAAAAGTTGGGG,0,1742756
gyrAp,0.2,4,4,AAAAGAACATTCCCGGTCTT,0,1750636
gyrAp,0.25,3,3,TTTTGTAAATTATAAAATTG,0,1742898
gyrAp,0.25,3,3,TTTTAAGCGTTACGGAGCCT,0,1764152
gyrAp,0.25,3,3,TTTGTTACATGCCGCTTCGC,0,1758723
gyrAp,0.25,3,3,TTTGCTCCCTTGTTGCAGAT,0,1753026
gyrAp,0.25,3,3,TTTGCAGAGGTGGACAGTGA,0,1760000
gyrAp,0.25,3,3,TTTGCAAGGAATCCGTAAGT,0,1770315
gyrAp,0.25,3,3,TTTCTTTCGGGCGGTAAACA,0,1751493
gyrAp,0.25,3,3,TTTCTGACAACTACACACGG,0,1756787
gyrAp,0.25,3,3,TTTCGCGGCTATCGTAAGGT,0,1748936
gyrAp,0.25,3,3,TTTCCGCTGGAACCTAAGAT,0,1767615
gyrAp,0.25,3,3,TTTCCATGTTAAATAGAAAG,0,1764446
gyrAp,0.25,3,3,TTTCCATCAGAATTTGATCG,0,1744580
gyrAp,0.25,3,3,TTTATCGTGGCGAATTGGAT,0,1743129
gyrAp,0.25,3,3,TTTAAGTTTATGACACGCTC,0,1743817
gyrAp,0.25,3,3,TTTAACCTTGAAGTTTCCAG,0,1746599
gyrAp,0.25,3,3,TTGTCCACCGCGTGCACAGG,0,1744705
gyrAp,0.25,3,3,TTGTCCAAGCCAAGCAAGGT,0,1764636
gyrAp,0.25,3,3,TTGGTCACATAGGTGGGTCT,0,1746645
gyrAp,0.25,3,3,TTGGATAAACTAACGGCTAT,0,1745330
gyrAp,0.25,3,3,TTGCTGTTGCTATGAAAAGT,0,1744753
gyrAp,0.25,3,3,TTGCGGCTTGAGACAAGCTA,0,1747094
gyrAp,0.25,3,3,TTGATTCCTTTGTTTTACTG,0,1752610
gyrAp,0.25,3,3,TTGATGCGCTACTTCGCGAG,0,1741907
gyrAp,0.25,3,3,TTGAGTTTTCGACCCAGCAT,0,1758419
gyrAp,0.25,3,3,TTGAGGCCTAGCTCGTGCTG,0,1770520
gyrAp,0.25,3,3,TTCTTCTAGGTTCTGGATTG,0,1761237
gyrAp,0.25,3,3,TTCTGGTAGGGACCTTCTGA,0,1761290
gyrAp,0.25,3,3,TTCTGCGTCACTGGATACTC,0,1763562
gyrAp,0.25,3,3,TTCTGCAGGCCGCGCGGGAG,0,1763389
gyrAp,0.25,3,3,TTCCAGGTTAGCGATGTATC,0,1744501
gyrAp,0.25,3,3,TTCAGTACCTGTCCCCATAT,0,1746540
gyrAp,0.25,3,3,TTCAGGCGACTCCGCCGGAA,0,1748523
gyrAp,0.25,3,3,TTATTCCCCTGAGACGTCAC,0,1749239
gyrAp,0.25,3,3,TTATGGGACTTGAGTGCACT,0,1754032
gyrAp,0.25,3,3,TTATGAGCAATACCCCCTGC,0,1742291
gyrAp,0.25,3,3,TTAGGATACACCCCGGAATG,0,1760342
gyrAp,0.25,3,3,TTACCGTTCTCTTCTGTCTG,0,1767982
gyrAp,0.25,3,3,TTACACTCTAACGTCCTATG,0,1766676
gyrAp,0.25,3,3,TTAATGGCACTCTGGCGGAG,0,1767936
gyrAp,0.25,3,3,TTAAGCGAGACTCGACAATT,0,1769238
gyrAp,0.25,3,3,TGTTGGGGCATTTTTAGCCC,0,1769590
gyrAp,0.25,3,3,TGTTACACGTAACGCGTTGG,0,1768374
gyrAp,0.25,3,3,TGTGTATCGCATGGCTCGGA,0,1754353
gyrAp,0.25,3,3,TGTGGCCGTCATCGGCAAAG,0,1758348
gyrAp,0.25,3,3,TGTGATCGCTAGGGTGGTGT,0,1755507
gyrAp,0.25,3,3,TGTCAGGTATGGTGTAGTAT,0,1760448
gyrAp,0.25,3,3,TGTCAAAGCGTTACCCTCAC,0,1770704
gyrAp,0.25,3,3,TGTACTGCTCGCGAGACCAT,0,1753155
gyrAp,0.25,3,3,TGTACACGGAGATCATGAGC,0,1749087
gyrAp,0.25,3,3,TGTAACCAACGACAGGTCAT,0,1753665
gyrAp,0.25,3,3,TGGTGATCCTAGGGGCTGCC,0,1760509
gyrAp,0.25,3,3,TGGTCCTCTACCGTTTCGAA,0,1757288
gyrAp,0.25,3,3,TGGAGCCATAAATGGCACTT,0,1742157
gyrAp,0.25,3,3,TGGACCGCTAGTTTACTTCG,0,1754049
gyrAp,0.25,3,3,TGGACATTGTGGAATATCTT,0,1764646
gyrAp,0.25,3,3,TGGAAACTGGTCTAGTCCTG,0,1754338
gyrAp,0.25,3,3,TGCGGGTTTAAACATTCATA,0,1767002
gyrAp,0.25,3,3,TGCAGCTCGGAAAACGTACA,0,1744329
gyrAp,0.25,3,3,TGCACGGAGGAAATCGCGCG,0,1759414
gyrAp,0.25,3,3,TGATGCAGCCAGTTGCACTC,0,1744911
gyrAp,0.25,3,3,TGATGAAAATTTGGGAATCT,0,1748640
gyrAp,0.25,3,3,TGATCGCTTGAGATATCCCA,0,1767952
gyrAp,0.25,3,3,TGACTACTGTCCCGGCAGTG,0,1746661
gyrAp,0.25,3,3,TGACCTCATAATTAAGGGGA,0,1769498
gyrAp,0.25,3,3,TGAACTGCAAGGTGTGTTGT,0,1762770
gyrAp,0.25,3,3,TGAAATGGGAACGTCACGTT,0,1753015
gyrAp,0.25,3,3,TCTTACCGGCCCATTTGGTC,0,1761024
gyrAp,0.25,3,3,TCTCAGTGAGCGTGTTAAGA,0,1753382
gyrAp,0.25,3,3,TCTATTTTAGGTGCGGCACT,0,1755108
gyrAp,0.25,3,3,TCTAGCTGTGAGTTGGTTAG,0,1758239
gyrAp,0.25,3,3,TCTAGCAACAATTACGGGTA,0,1770583
gyrAp,0.25,3,3,TCTACTTCTCTAACTCAACT,0,1748236
gyrAp,0.25,3,3,TCTAATATCACGTAGAAATA,0,1760584
gyrAp,0.25,3,3,TCGTGGGTGCGTCTGGAAAA,0,1755753
gyrAp,0.25,3,3,TCGGTATGAGTAAATTCCTA,0,1751768
gyrAp,0.25,3,3,TCGCCAACACGTAGCGGGCA,0,1764008
gyrAp,0.25,3,3,TCGCAAATACTTCTCTACGT,0,1742051
gyrAp,0.25,3,3,TCGAAGCGTAGTGAGCTGCT,0,1763840
gyrAp,0.25,3,3,TCGAACCCCGGGTTGTCCGA,0,1748910
gyrAp,0.25,3,3,TCCTGTTCTGGAATCCTCTT,0,1754585
gyrAp,0.25,3,3,TCCTGCTAAAGCTGGCACCA,0,1753291
gyrAp,0.25,3,3,TCCGATAATTAGAAGCATCA,0,1756578
gyrAp,0.25,3,3,TCCGACTTGCTGAATAAATA,0,1742545
gyrAp,0.25,3,3,TCCCCAGGTGCGTCGGGACG,0,1767793
gyrAp,0.25,3,3,TCCAGGGTTGTTGATGCATT,0,1769723
gyrAp,0.25,3,3,TCCAGGGAATGTGTCGCCTG,0,1767144
gyrAp,0.25,3,3,TCATTGGCCACGGCCCTCGT,0,1755771
gyrAp,0.25,3,3,TCATCCGACAATAACCCATA,0,1760146
gyrAp,0.25,3,3,TCACTAAGGTACCCGCTATG,0,1746556
gyrAp,0.25,3,3,TCACCGAATCTCCTGTGGGA,0,1765670
gyrAp,0.25,3,3,TCAAGTGCGGCTCGCTCGCG,0,1745228
gyrAp,0.25,3,3,TCAACGAGCAGCTCCTTTGT,0,1768191
gyrAp,0.25,3,3,TCAAACCGTGGACAGTAGTT,0,1762550
gyrAp,0.25,3,3,TATTTGTGCCAGTCTTGTTA,0,1751489
gyrAp,0.25,3,3,TATTGTGTTGGATAGCTGGG,0,1757023
gyrAp,0.25,3,3,TATTGAGGACAAGTCCTGAT,0,1755710
gyrAp,0.25,3,3,TATTCCAGATTAGACGGACG,0,1752997
gyrAp,0.25,3,3,TATGGAATGTACATACCTTA,0,1757881
gyrAp,0.25,3,3,TATCGTGCGACTCTGTTCAT,0,1745831
gyrAp,0.25,3,3,TATCCTAGGCCATATATTCG,0,1752712
gyrAp,0.25,3,3,TATAGTCTGTATTTGTCTTT,0,1749841
gyrAp,0.25,3,3,TATAGGGCTGTTCGCTCAAA,0,1748750
gyrAp,0.25,3,3,TATAGACTGAGCTCATCAGC,0,1758089
gyrAp,0.25,3,3,TATACTGAGCCAGCCTGCAA,0,1748788
gyrAp,0.25,3,3,TATAACCTCAAACAGTGGAC,0,1742436
gyrAp,0.25,3,3,TAGTGAAGCAATTACCCACC,0,1751809
gyrAp,0.25,3,3,TAGGCGACTGCAGCCTGCAG,0,1744904
gyrAp,0.25,3,3,TAGGAGTTTGTCAACGATAG,0,1762745
gyrAp,0.25,3,3,TAGCTAGGAATACTGAGCCT,0,1761572
gyrAp,0.25,3,3,TAGCGTGGAAACCAGCTTAT,0,1759232
gyrAp,0.25,3,3,TAGAATTAATCCCCTGCGTT,0,1743336
gyrAp,0.25,3,3,TAGAACGCATGACTTTTATT,0,1752349
gyrAp,0.25,3,3,TACTCTCCCCATTTCTCAGT,0,1764818
gyrAp,0.25,3,3,TACCTTGGTTTAGTGAAAAT,0,1751234
gyrAp,0.25,3,3,TACAGTCCTTTCCGGTCCGT,0,1752676
gyrAp,0.25,3,3,TACACGCTTTTTCGGGCAAA,0,1744832
gyrAp,0.25,3,3,TAATTGTGGTTGATCGATCA,0,1763586
gyrAp,0.25,3,3,TAATAGTCCCAAAAGGTGAG,0,1748098
gyrAp,0.25,3,3,TAATACGTGTGGTGTCGTTG,0,1744920
gyrAp,0.25,3,3,TAATACCGGGATGGGAGTGG,0,1752036
gyrAp,0.25,3,3,TAAGTCGGAACCGAACTGAG,0,1746541
gyrAp,0.25,3,3,TAAGCGTCCAGACAAATCCG,0,1768788
gyrAp,0.25,3,3,TAAGCGCTAATAATGCTGAC,0,1760662
gyrAp,0.25,3,3,TAACGTTAAACATACATGGC,0,1748799
gyrAp,0.25,3,3,TAACGAATTTGGGTCGAGCA,0,1746371
gyrAp,0.25,3,3,TAAACGCGGCCTACCGGTTA,0,1751924
gyrAp,0.25,3,3,TAAAATTGATATTAAGGCGT,0,1757714
gyrAp,0.25,3,3,GTTTTAACCGGAAGGTAGGC,0,1753895
gyrAp,0.25,3,3,GTTTTAAAGGTAAAGCCTTA,0,1746126
gyrAp,0.25,3,3,GTTGCTGTTGGCCGCTCCAC,0,1759967
gyrAp,0.25,3,3,GTTGAAGGAATCGGGTGGAA,0,1748579
gyrAp,0.25,3,3,GTTCTGCGTACGGCTCCACC,0,1756444
gyrAp,0.25,3,3,GTTCGGTAAACAATTCTCGC,0,1747316
gyrAp,0.25,3,3,GTTCCTTTATAGGCATTAAT,0,1742306
gyrAp,0.25,3,3,GTTCAGCCCATATCAAAAGC,0,1741867
gyrAp,0.25,3,3,GTTAAGCCTGAGGAAAGAGT,0,1745092
gyrAp,0.25,3,3,GTGGTATAGTGAATTTGTGG,0,1749961
gyrAp,0.25,3,3,GTGCTCCGCTGTTTGTCTGG,0,1758474
gyrAp,0.25,3,3,GTGCGGTCGATTGCGGCCGA,0,1741481
gyrAp,0.25,3,3,GTGCGCTTAACTGACACTAC,0,1745010
gyrAp,0.25,3,3,GTGCAGTCTATAGACTAAAT,0,1752254
gyrAp,0.25,3,3,GTGACAATATAGCGCATTGG,0,1766011
gyrAp,0.25,3,3,GTCTTCGAGACCTTTATATC,0,1763454
gyrAp,0.25,3,3,GTCTTATTGGTTCTCTAATA,0,1769117
gyrAp,0.25,3,3,GTCTACCGATCAGGTGAACG,0,1753498
gyrAp,0.25,3,3,GTCGATTGCAGGTTAGAGCC,0,1754554
gyrAp,0.25,3,3,GTCCCCCAATCCAAGCCATA,0,1745549
gyrAp,0.25,3,3,GTCCATGTGTTGATTTCAAA,0,1755383
gyrAp,0.25,3,3,GTCACTCACTCATTCTCAAT,0,1743285
gyrAp,0.25,3,3,GTATTTTTCAATCGAGGTAG,0,1762120
gyrAp,0.25,3,3,GTATTTCATCGTGCGAGACT,0,1745472
gyrAp,0.25,3,3,GTACATGTGTGTTTTCTTAC,0,1751055
gyrAp,0.25,3,3,GTACAGTAAGGCGCAACTTC,0,1749246
gyrAp,0.25,3,3,GTACAGCGTTGGTAAACTTC,0,1765702
gyrAp,0.25,3,3,GTAATTATTCACAGGTCATC,0,1767075
gyrAp,0.25,3,3,GTAAGGAATAATCGTGTTGA,0,1765859
gyrAp,0.25,3,3,GTAAATGATTATGGGGGAAA,0,1754343
gyrAp,0.25,3,3,GGTTGGGAACGCGCGGCGCC,0,1758610
gyrAp,0.25,3,3,GGTTCGATCAGCCCGTCTGG,0,1743151
gyrAp,0.25,3,3,GGTTATTAATCTACATGCAA,0,1765121
gyrAp,0.25,3,3,GGTGTCAGAAACTCCATACC,0,1757016
gyrAp,0.25,3,3,GGTGAGGTTTATGTGTGCCT,0,1746166
gyrAp,0.25,3,3,GGTCCGAAGCCTCTGCCCAC,0,1746243
gyrAp,0.25,3,3,GGTCCGAAACTAAGGTAAAT,0,1760408
gyrAp,0.25,3,3,GGTCATCTGCATTTGGCGGT,0,1749748
gyrAp,0.25,3,3,GGTCAAGGGTGAGTCGGAGG,0,1755705
gyrAp,0.25,3,3,GGTACCAGGCTGGACGTAAT,0,1755435
gyrAp,0.25,3,3,GGGTATTTTATGTCGGGGCA,0,1743233
gyrAp,0.25,3,3,GGGTATCCCTAGTTAATTAC,0,1743373
gyrAp,0.25,3,3,GGGTAGGTCTGCTGAAAGAC,0,1743908
gyrAp,0.25,3,3,GGGTAGAGATAATGAGGCAT,0,1750077
gyrAp,0.25,3,3,GGGGGTATCGAGCCTGAAGA,0,1748233
gyrAp,0.25,3,3,GGGGGCCGGTGAAGCCGGCT,0,1769642
gyrAp,0.25,3,3,GGGCTATGCGCCTGCTAATC,0,1746076
gyrAp,0.25,3,3,GGGCGTAAGGGGACTATTCG,0,1750892
gyrAp,0.25,3,3,GGGCGGTCTGGCATGCAAAT,0,1741757
gyrAp,0.25,3,3,GGGATCAGAGAGTGACTTAA,0,1756184
gyrAp,0.25,3,3,GGGAGCTCCTGTACGATAGA,0,1744145
gyrAp,0.25,3,3,GGGAGACCGCCGGCGCCGGC,0,1746919
gyrAp,0.25,3,3,GGGACATGATGGGGTCCCGA,0,1749162
gyrAp,0.25,3,3,GGCTGCACTCCGCAGGTCGA,0,1749992
gyrAp,0.25,3,3,GGCTACTAATTTTCGGGTTA,0,1747427
gyrAp,0.25,3,3,GGCTAAACGCATCCAGCTGG,0,1748449
gyrAp,0.25,3,3,GGCGTTTCCGAGGTTAGGAG,0,1757651
gyrAp,0.25,3,3,GGCGTATTCGTAATACTCGG,0,1751271
gyrAp,0.25,3,3,GGCGTAAACGGCTTCTTGGT,0,1746248
gyrAp,0.25,3,3,GGCGGCTCATGGAGAACCCG,0,1758740
gyrAp,0.25,3,3,GGCCGACACGTTCCTCGAAA,0,1745241
gyrAp,0.25,3,3,GGCAAACGGGAGTGCGTACC,0,1743448
gyrAp,0.25,3,3,GGCAAACATACCAACATGAC,0,1766101
gyrAp,0.25,3,3,GGATACAAGGCCGCCACTGC,0,1757801
gyrAp,0.25,3,3,GGATAAGGACAGTGTACCAT,0,1754443
gyrAp,0.25,3,3,GGAGGTATGGAGAGCCCTAC,0,1768188
gyrAp,0.25,3,3,GGAGGCCTATAATTTAGGCC,0,1764643
gyrAp,0.25,3,3,GGACTTGGCGTTCGGTAGTC,0,1751899
gyrAp,0.25,3,3,GGACCTCTAAGAAAAAGTAC,0,1756271
gyrAp,0.25,3,3,GGACCTAGTTGCGGGCCAGC,0,1757138
gyrAp,0.25,3,3,GGACACGCTCTCATACCGCT,0,1752577
gyrAp,0.25,3,3,GGAATGATCACACAGAAATT,0,1767277
gyrAp,0.25,3,3,GCTTTTAAGGCTCTGCTGTA,0,1765228
gyrAp,0.25,3,3,GCTTTATATGGCGCCGCGGT,0,1743131
gyrAp,0.25,3,3,GCTTGGAGGTCCAAGCCGCG,0,1750560
gyrAp,0.25,3,3,GCTTCTAACCCCTAACCTAT,0,1757148
gyrAp,0.25,3,3,GCTTCCTCGCATTACGCCAG,0,1767576
gyrAp,0.25,3,3,GCTGGGTAGCATGGTAATGA,0,1752132
gyrAp,0.25,3,3,GCTCTTCCGGGAAGAATGCG,0,1745413
gyrAp,0.25,3,3,GCTCATGGGGCGCATCTGCA,0,1766538
gyrAp,0.25,3,3,GCTACAGGTCTTGGGCTACC,0,1746911
gyrAp,0.25,3,3,GCGTCAGTTTAGTGGCACCA,0,1762376
gyrAp,0.25,3,3,GCGTAGGGGTAGTTTCAGCC,0,1752662
gyrAp,0.25,3,3,GCGTAACAACCGCGGTGAGC,0,1763624
gyrAp,0.25,3,3,GCGGAGATTTCGATAGATCG,0,1751957
gyrAp,0.25,3,3,GCGCTATATCTCAGACACCC,0,1742205
gyrAp,0.25,3,3,GCGCCCGCCATGACAGGGCT,0,1768477
gyrAp,0.25,3,3,GCGCAGAGTCAACCAAGGAT,0,1754029
gyrAp,0.25,3,3,GCGATCGACAAAGCATATAC,0,1756275
gyrAp,0.25,3,3,GCGAGAGAAACCGGAAAAAT,0,1746257
gyrAp,0.25,3,3,GCGACTTCTGTTGTACAGGT,0,1760614
gyrAp,0.25,3,3,GCGACAGTCTCCAAAAATTG,0,1747365
gyrAp,0.25,3,3,GCCTCGTTAGCTTCCCGCGA,0,1749801
gyrAp,0.25,3,3,GCCTCCTATTATGACTTATC,0,1747072
gyrAp,0.25,3,3,GCCTATGGCGATATAAGTAA,0,1742163
gyrAp,0.25,3,3,GCCGTACCAGGGAACCTGTC,0,1765283
gyrAp,0.25,3,3,GCCGTAAAGACTGGTAGCGC,0,1764699
gyrAp,0.25,3,3,GCCATGCTTAAGCCATGTGG,0,1749448
gyrAp,0.25,3,3,GCCATCGGCTTGGGGACGGT,0,1756902
gyrAp,0.25,3,3,GCCACGTAGCCGGCTGTAGT,0,1749135
gyrAp,0.25,3,3,GCCACGCAGGTGCATTGTTA,0,1746984
gyrAp,0.25,3,3,GCATGTCACGCCTGGGGGAT,0,1757418
gyrAp,0.25,3,3,GCATAATGACTACAATCCGT,0,1748117
gyrAp,0.25,3,3,GCATAAAAAGTTCTGTGATA,0,1751727
gyrAp,0.25,3,3,GCAGTAGAAGTCCTCCTTAG,0,1756383
gyrAp,0.25,3,3,GCAGCTACCATTATTAATTA,0,1744022
gyrAp,0.25,3,3,GCAGATTGGATTGCTTTTCG,0,1753959
gyrAp,0.25,3,3,GCAGATGTAATGCTCTGTAC,0,1746703
gyrAp,0.25,3,3,GCAGATATTGACGGGCTCCT,0,1754931
gyrAp,0.25,3,3,GCAGAGGCAGCATACGGTTT,0,1767488
gyrAp,0.25,3,3,GCACAAAGCCTCCTAGCGCT,0,1744102
gyrAp,0.25,3,3,GCAACTAGGACGTGTAGGCG,0,1769702
gyrAp,0.25,3,3,GCAACGGGTGGCGTCGGTAA,0,1757145
gyrAp,0.25,3,3,GATGTCGGACGTGTATTTTC,0,1769857
gyrAp,0.25,3,3,GATGTCAGGTCTCCTGGGTA,0,1761709
gyrAp,0.25,3,3,GATGTAGCCGGGCCGAAGCG,0,1746300
gyrAp,0.25,3,3,GATGCAACGCGAACGTGTGT,0,1745544
gyrAp,0.25,3,3,GATCGGCAAGCTGAAAGCTC,0,1747508
gyrAp,0.25,3,3,GATCGATGCGTGTCACCGAC,0,1754928
gyrAp,0.25,3,3,GATCCGTCGTTCCACCGCAG,0,1763974
gyrAp,0.25,3,3,GATCAATTAGCCACTACAAC,0,1763479
gyrAp,0.25,3,3,GATATACGGAAACGGAGGCT,0,1766670
gyrAp,0.25,3,3,GATACAGCCGCTACCACGGG,0,1759166
gyrAp,0.25,3,3,GATAACTACTAGTGAGCGAG,0,1755699
gyrAp,0.25,3,3,GAGGTTAGATCCTCGCTGTA,0,1752566
gyrAp,0.25,3,3,GAGGGCCTATGAGCAACTAT,0,1761245
gyrAp,0.25,3,3,GAGGCCGCGCATTAAGGGTC,0,1747373
gyrAp,0.25,3,3,GAGCTCTAGCTACATTCGTC,0,1761026
gyrAp,0.25,3,3,GAGCCTATAATATGACACCA,0,1764696
gyrAp,0.25,3,3,GAGCCGTCGTAACTCAACGT,0,1763583
gyrAp,0.25,3,3,GAGCCAGTCATGGTGTGTTT,0,1754590
gyrAp,0.25,3,3,GAGACAAAGGGACAGCTATG,0,1755174
gyrAp,0.25,3,3,GAGAACTTTTCGTTGGATGG,0,1744934
gyrAp,0.25,3,3,GAGAAACAACCCGTTCCTTC,0,1763446
gyrAp,0.25,3,3,GACTGTTTTGGGGCACTCGA,0,1747706
gyrAp,0.25,3,3,GACGGTTTAACAGGCACACT,0,1767300
gyrAp,0.25,3,3,GACGCTTCTATATCCCTGAG,0,1756075
gyrAp,0.25,3,3,GACGCTAGTTTTCGGCTATA,0,1767948
gyrAp,0.25,3,3,GACCCGAGGGCCAAATTCAA,0,1753570
gyrAp,0.25,3,3,GACCAATACCCCAACAGAGA,0,1745328
gyrAp,0.25,3,3,GACATTGACCAGCGCGTACA,0,1744234
gyrAp,0.25,3,3,GACAGCCTGTTCCGGCAGAG,0,1762755
gyrAp,0.25,3,3,GACAGCATATGTCAAGTAAC,0,1764657
gyrAp,0.25,3,3,GACAGCAACGAATCAGCTGT,0,1758241
gyrAp,0.25,3,3,GAATCGGACCCTTGGTACAA,0,1766404
gyrAp,0.25,3,3,GAATAGAAGGTCAGCAATGG,0,1764592
gyrAp,0.25,3,3,GAATAAACTAGCGTGCTTGG,0,1758346
gyrAp,0.25,3,3,GAAGCTCGTGCACACTAGCC,0,1765049
gyrAp,0.25,3,3,GAAGCGTCGAAGTCGCAGAG,0,1762062
gyrAp,0.25,3,3,GAAGAGTAGTTCGTTGGGGT,0,1752679
gyrAp,0.25,3,3,GAAGACGTTTAACAGCCTTA,0,1762328
gyrAp,0.25,3,3,GAACTCAACTTCGGACTGCG,0,1747341
gyrAp,0.25,3,3,GAACGGACATCAGCTTCAAG,0,1754881
gyrAp,0.25,3,3,GAACCGTTGCTAGGGTTATG,0,1748985
gyrAp,0.25,3,3,GAACCAGCACAGTTGCCTCA,0,1759629
gyrAp,0.25,3,3,GAACCACACCTGCGAACTCA,0,1746175
gyrAp,0.25,3,3,GAAATTACTCGACCCAGGAC,0,1750745
gyrAp,0.25,3,3,GAAAGTTCCCTGGAGTCCCT,0,1768809
gyrAp,0.25,3,3,CTTTTTCCTACTTCCGGTAC,0,1748708
gyrAp,0.25,3,3,CTTTGGATCAGTGGTTCACA,0,1770553
gyrAp,0.25,3,3,CTTTAGCACCGTGTGGACAC,0,1746820
gyrAp,0.25,3,3,CTTTAGAGAACAAAGCAATA,0,1753807
gyrAp,0.25,3,3,CTTGCTAAACTACCTAGGCT,0,1762367
gyrAp,0.25,3,3,CTTGACCAGTCATAGTCATA,0,1762118
gyrAp,0.25,3,3,CTTAGGCAGTCGAAATTCGT,0,1765277
gyrAp,0.25,3,3,CTTAGCGCGCGTTTTCCAAA,0,1768030
gyrAp,0.25,3,3,CTTAATTTTCGGCCCCACAC,0,1756104
gyrAp,0.25,3,3,CTGTTGCGGCTTTTCACGTA,0,1766657
gyrAp,0.25,3,3,CTGTTGCGCTTAATCGCTGT,0,1749625
gyrAp,0.25,3,3,CTGTGTAACCGGGGTCACAC,0,1768660
gyrAp,0.25,3,3,CTGTGAGGAACAGGCCATGC,0,1754121
gyrAp,0.25,3,3,CTGTATAAGTTCCTGGTCGG,0,1758336
gyrAp,0.25,3,3,CTGGGGACGGTCACGGAACC,0,1750927
gyrAp,0.25,3,3,CTGGGCATATGAGGACTATC,0,1758472
gyrAp,0.25,3,3,CTGGACACAACTTGCGTACC,0,1745079
gyrAp,0.25,3,3,CTGCTGCGCAACAAGGCAAC,0,1767363
gyrAp,0.25,3,3,CTGAAGGTACAGGTATAGAT,0,1770510
gyrAp,0.25,3,3,CTCTTCGTAAGGTAGGCGGC,0,1745755
gyrAp,0.25,3,3,CTCTTACGAAATATATAGGG,0,1744092
gyrAp,0.25,3,3,CTCGTTACATTATGCCGGAC,0,1749259
gyrAp,0.25,3,3,CTCGTGGCTTTCGGCCAATG,0,1752080
gyrAp,0.25,3,3,CTCGTAACCAGGCTAGGAGG,0,1746522
gyrAp,0.25,3,3,CTCGTAAACGGCAGCGCTAT,0,1754146
gyrAp,0.25,3,3,CTCCGCTTAGCATGAAATAC,0,1764171
gyrAp,0.25,3,3,CTCCAGATGCGTCACTCGAA,0,1770633
gyrAp,0.25,3,3,CTCATTCGACTTTGGTGTAA,0,1746121
gyrAp,0.25,3,3,CTCATGACTGCAGTGATTTT,0,1745673
gyrAp,0.25,3,3,CTCATAGAGCCATTCTTCTC,0,1769949
gyrAp,0.25,3,3,CTCACCCAGCTCACTCAAGT,0,1761038
gyrAp,0.25,3,3,CTATGTAAGCCGGATTCCGA,0,1748389
gyrAp,0.25,3,3,CTATAGTACGCCCACATAAA,0,1767789
gyrAp,0.25,3,3,CTAGGTTGATAGCGTCCTAA,0,1744006
gyrAp,0.25,3,3,CTAGCAGTGACTATAGTAGG,0,1750959
gyrAp,0.25,3,3,CTACGAAGGGGAGCGACGCG,0,1749446
gyrAp,0.25,3,3,CTAATGCTTTCTTAGGTAAG,0,1742256
gyrAp,0.25,3,3,CTAAGTGCGAAGTCCCGTCA,0,1751302
gyrAp,0.25,3,3,CTAAGGTTCCTGACGTTTAA,0,1750847
gyrAp,0.25,3,3,CTAAATTTGGAGATACAGGT,0,1757543
gyrAp,0.25,3,3,CGTTCTGCGATCCGTGATTT,0,1744683
gyrAp,0.25,3,3,CGTTAGATTACACCACTGGC,0,1760017
gyrAp,0.25,3,3,CGTGTACGCCTAACTTCGGT,0,1749703
gyrAp,0.25,3,3,CGTGGCTTTGGATCTCCTGT,0,1743535
gyrAp,0.25,3,3,CGTATTCGATTCAGCTTGCT,0,1756637
gyrAp,0.25,3,3,CGTAGGGTTCACCAGCTATC,0,1748876
gyrAp,0.25,3,3,CGTACTTACCATGACGGGTG,0,1770041
gyrAp,0.25,3,3,CGTAATATGGCTTACACGGG,0,1767005
gyrAp,0.25,3,3,CGGTTACAAGTTCCAGGGCG,0,1756260
gyrAp,0.25,3,3,CGGTGATGCAAGCGACGGAA,0,1766249
gyrAp,0.25,3,3,CGGTCTCGTAAGTCGGGGTA,0,1757774
gyrAp,0.25,3,3,CGGGTTTACATCGGTCAATG,0,1745998
gyrAp,0.25,3,3,CGGGGCTGAATCAACCTCGT,0,1764615
gyrAp,0.25,3,3,CGGGACAGAGGCAGCGCCAA,0,1752220
gyrAp,0.25,3,3,CGGCTGATGCCATGTTGCAG,0,1754389
gyrAp,0.25,3,3,CGGCAGGGTGTCGAAGCATT,0,1759822
gyrAp,0.25,3,3,CGGCACCAACACACGAAGAT,0,1756466
gyrAp,0.25,3,3,CGCTTTTTTCAATGCTTAAT,0,1768978
gyrAp,0.25,3,3,CGCTTTATTATATGTCCGTT,0,1746348
gyrAp,0.25,3,3,CGCGGGGACACTCGACTCAC,0,1746531
gyrAp,0.25,3,3,CGCCATTCGCCTATTATCCA,0,1742644
gyrAp,0.25,3,3,CGCCACTGCATATACAATGT,0,1745815
gyrAp,0.25,3,3,CGCATCAGATGCTGCTCAGG,0,1763538
gyrAp,0.25,3,3,CGCAGGCCCCCCGAGGTCAG,0,1766769
gyrAp,0.25,3,3,CGCAGCGCATTTAGTGGGTT,0,1742602
gyrAp,0.25,3,3,CGCAAAGTCGATCGCCCCGA,0,1753709
gyrAp,0.25,3,3,CGATTAATGTATGAGAAGAC,0,1769763
gyrAp,0.25,3,3,CGATGAATAAAATTCCGATC,0,1750300
gyrAp,0.25,3,3,CGATACTAACCTGTTAATTT,0,1744115
gyrAp,0.25,3,3,CGAGAAATTGCCTGGCGATT,0,1752364
gyrAp,0.25,3,3,CGACTCTCTGTGGCACCCAC,0,1748875
gyrAp,0.25,3,3,CGACTCACGTACCAGAGGCG,0,1745802
gyrAp,0.25,3,3,CGAATTCCGTACGGATACGA,0,1758759
gyrAp,0.25,3,3,CGAAATCGGCTAACATCGCA,0,1743990
gyrAp,0.25,3,3,CCTGTGGCCAATCGCGAACA,0,1754818
gyrAp,0.25,3,3,CCTGACAGGGTCCTACAACT,0,1756174
gyrAp,0.25,3,3,CCTCAAGAAAAAGCCCTTTC,0,1765842
gyrAp,0.25,3,3,CCTAGTTGGCATGTGAACAT,0,1744171
gyrAp,0.25,3,3,CCGTTCAGTATGCTTACACA,0,1759005
gyrAp,0.25,3,3,CCGGGGCTTCAGAGATCTCA,0,1750411
gyrAp,0.25,3,3,CCGCGATGGTGATTGTGGAA,0,1758204
gyrAp,0.25,3,3,CCGCCTGCTACCGATATCCA,0,1760964
gyrAp,0.25,3,3,CCGATGCGCGTATTATAACC,0,1763288
gyrAp,0.25,3,3,CCGAGGATCTCGCCAATAGG,0,1755447
gyrAp,0.25,3,3,CCGAAGCTTTGACTACATGT,0,1750706
gyrAp,0.25,3,3,CCCTTTGTTATGGGTTAAGA,0,1764633
gyrAp,0.25,3,3,CCCTGGGGACTCTATACGCA,0,1760794
gyrAp,0.25,3,3,CCCTGCAATGGGCTGGTCGC,0,1766298
gyrAp,0.25,3,3,CCCTCTATCGGACGGACAAC,0,1763104
gyrAp,0.25,3,3,CCCGTTGCCGCTAAAACCGT,0,1741830
gyrAp,0.25,3,3,CCCGTGATGTTCAGACGTAG,0,1746374
gyrAp,0.25,3,3,CCCGGGTTCGGTAACCTCTC,0,1747243
gyrAp,0.25,3,3,CCCGGGTCAGCTCCGTTATC,0,1760072
gyrAp,0.25,3,3,CCCGGACATGGTTTCGGTGT,0,1747000
gyrAp,0.25,3,3,CCCGCGGCTTGCTATTCGAT,0,1762049
gyrAp,0.25,3,3,CCCGCATTTCGCTTAGTGTT,0,1749034
gyrAp,0.25,3,3,CCCCGCCCTACGTCCTAGAC,0,1749374
gyrAp,0.25,3,3,CCCCCCAGTCTGAATACGTA,0,1745148
gyrAp,0.25,3,3,CCCATCAGTCGGCCTAATCG,0,1765462
gyrAp,0.25,3,3,CCCAGCACAGGCCCGGCGAG,0,1755056
gyrAp,0.25,3,3,CCCACTGTTGAGCTTGCGTG,0,1749351
gyrAp,0.25,3,3,CCATTCCTAGATAGGGACAA,0,1770465
gyrAp,0.25,3,3,CCATGTTTGGTGAACAGAAT,0,1763730
gyrAp,0.25,3,3,CCATGCTGGACGGGACTTAA,0,1753306
gyrAp,0.25,3,3,CCATCAGGGAAGGGCGGTAT,0,1752184
gyrAp,0.25,3,3,CCATAGCTACACCAGGGTAG,0,1747426
gyrAp,0.25,3,3,CCAGGATAGAGTCTGCACCG,0,1764324
gyrAp,0.25,3,3,CCAGATGGGAAGATATTGCT,0,1751826
gyrAp,0.25,3,3,CCAGAGACGCAATCCACCGT,0,1758653
gyrAp,0.25,3,3,CCACTCGTTTCGAGGCTTAG,0,1762577
gyrAp,0.25,3,3,CCACCTCGGACTTATCCTGG,0,1745611
gyrAp,0.25,3,3,CCACCAAGAAAGAATCTCTA,0,1757523
gyrAp,0.25,3,3,CCAAGACTCCTAGGGATGCG,0,1747146
gyrAp,0.25,3,3,CCAACGATAAACGTTACCTT,0,1768886
gyrAp,0.25,3,3,CCAACAAATGGAGCACCCAC,0,1757408
gyrAp,0.25,3,3,CATTTATTTTCCATTCGGGG,0,1750977
gyrAp,0.25,3,3,CATTGTACGCACCGCACGGG,0,1750027
gyrAp,0.25,3,3,CATTGATAGCTCTGTTAAAA,0,1753687
gyrAp,0.25,3,3,CATTAATAGTTGGGGGTGGA,0,1750822
gyrAp,0.25,3,3,CATTAAGAGCTGCCCATCTA,0,1767538
gyrAp,0.25,3,3,CATTAAAGTTTTGACGCAAG,0,1766038
gyrAp,0.25,3,3,CATGTCGCGTTGGTTGAAGT,0,1757982
gyrAp,0.25,3,3,CATGTACCTAGTTATGGGGG,0,1751514
gyrAp,0.25,3,3,CATGAGTGGAGTGCCCTAAC,0,1752309
gyrAp,0.25,3,3,CATCACGCACGTAAGATGAA,0,1755405
gyrAp,0.25,3,3,CATAGGTCCATCACACCGCT,0,1766509
gyrAp,0.25,3,3,CATAGCGTAAACTTAGCGAA,0,1761999
gyrAp,0.25,3,3,CATACAGGCACGTACTGCGT,0,1746326
gyrAp,0.25,3,3,CATACAGATTAACCGCCGTG,0,1766772
gyrAp,0.25,3,3,CAGTTCATAAATATATACAT,0,1746872
gyrAp,0.25,3,3,CAGTGTCTGCTGCGGTGTTT,0,1753863
gyrAp,0.25,3,3,CAGTGACTCTATCCTTAGAT,0,1748469
gyrAp,0.25,3,3,CAGTATTCAGTGTCTATTTG,0,1764300
gyrAp,0.25,3,3,CAGTAGTCCAAACTAAATAT,0,1755752
gyrAp,0.25,3,3,CAGTAGAACCAGTAAGCGGC,0,1753915
gyrAp,0.25,3,3,CAGGTAAGGTACTAGACGTG,0,1745009
gyrAp,0.25,3,3,CAGGATTCGTTTTCCGGTGA,0,1749470
gyrAp,0.25,3,3,CAGGATAGTTGGCCCTTTCT,0,1760156
gyrAp,0.25,3,3,CAGGAGAACGTTCGAATTTC,0,1743281
gyrAp,0.25,3,3,CAGCCGTGGGAAGACAAGAC,0,1763824
gyrAp,0.25,3,3,CAGACGCGACCATTAATACG,0,1746439
gyrAp,0.25,3,3,CAGAAATACCCCCTGGTCCC,0,1767098
gyrAp,0.25,3,3,CACTCGGAGTGGGTTCGTTT,0,1767282
gyrAp,0.25,3,3,CACTACTAAGGTAAGGCCAT,0,1754871
gyrAp,0.25,3,3,CACGGTTGTTGGTTCGTGTT,0,1753800
gyrAp,0.25,3,3,CACGCCAATTTAGAACTGAA,0,1756516
gyrAp,0.25,3,3,CACCGGTCTCATGACCATTG,0,1763153
gyrAp,0.25,3,3,CACCGCCGTTTAACAACACC,0,1763019
gyrAp,0.25,3,3,CACCCTGGTCATTGATTCAG,0,1753935
gyrAp,0.25,3,3,CACACAGTTGTCAGTAGTCT,0,1756109
gyrAp,0.25,3,3,CAATTGAAACTTACCGTTTC,0,1747450
gyrAp,0.25,3,3,CAATGGCGATTGAGCAGAGA,0,1749970
gyrAp,0.25,3,3,CAATCTATGTTGCGGATAAA,0,1748601
gyrAp,0.25,3,3,CAACTACTTCAGGCGGGGAT,0,1754816
gyrAp,0.25,3,3,CAACTACGTCCTGCCTCCTG,0,1756776
gyrAp,0.25,3,3,CAACGGCTAACGGGCCATTC,0,1748692
gyrAp,0.25,3,3,CAACCCCTGAAAAAGTATCC,0,1764409
gyrAp,0.25,3,3,CAACAACTCCTTCCCCATCT,0,1742919
gyrAp,0.25,3,3,CAAATAGTGATACTATTAGA,0,1753396
gyrAp,0.25,3,3,CAAAGTACCGCCCGGCCTTA,0,1768739
gyrAp,0.25,3,3,CAAAGGCTATGTCTTGGGGA,0,1767718
gyrAp,0.25,3,3,CAAACGTATGAGTATATTGA,0,1746384
gyrAp,0.25,3,3,CAAACATGTGAAGGTACTTG,0,1746582
gyrAp,0.25,3,3,CAAACAACACAGTTCGTGTT,0,1765570
gyrAp,0.25,3,3,ATTTTAAAAATTATTTAACG,0,1759703
gyrAp,0.25,3,3,ATTTCCCGAGCCCGTGTGGT,0,1746475
gyrAp,0.25,3,3,ATTTAGTGGCGGCGTCCCGA,0,1768175
gyrAp,0.25,3,3,ATTTAGACCCTACTATGAAC,0,1750539
gyrAp,0.25,3,3,ATTTACGCAAAGAACAGAGG,0,1765662
gyrAp,0.25,3,3,ATTGCTCACACTTTAGTGGC,0,1749090
gyrAp,0.25,3,3,ATTCGCTCCGGAATCTCAAC,0,1751007
gyrAp,0.25,3,3,ATTATCACCAAGTACAGAAA,0,1755305
gyrAp,0.25,3,3,ATGTTGAAGGCAATGTGTGC,0,1761088
gyrAp,0.25,3,3,ATGTGTTTACTAAAGGAAAG,0,1751668
gyrAp,0.25,3,3,ATGTGAAAACGCGGTTTCAT,0,1751011
gyrAp,0.25,3,3,ATGTCCGGGGTTGTTGGTCG,0,1750162
gyrAp,0.25,3,3,ATGGCGTATGCGGCTTAGTA,0,1755274
gyrAp,0.25,3,3,ATGGCGCGTTCCGGAGCTGT,0,1748562
gyrAp,0.25,3,3,ATGCGCATAGGCTGTGTAAA,0,1759867
gyrAp,0.25,3,3,ATGCCACCGGTCATTTTAAA,0,1754391
gyrAp,0.25,3,3,ATGCAGAGTTTAGATTGTCT,0,1745008
gyrAp,0.25,3,3,ATGACGCGGCCTTCGTTTAG,0,1754691
gyrAp,0.25,3,3,ATCTTAACGTGGGCTGATGG,0,1758285
gyrAp,0.25,3,3,ATCTGGCCTAAGATCCCGGG,0,1749914
gyrAp,0.25,3,3,ATCGGGTACTACAGCCCGGC,0,1754008
gyrAp,0.25,3,3,ATCGGCATGTTTATGGATCC,0,1746233
gyrAp,0.25,3,3,ATCCACTAAACCTCGATCGA,0,1753121
gyrAp,0.25,3,3,ATCAGCGCAGTAATTCCCTG,0,1761665
gyrAp,0.25,3,3,ATATTGATTTAGTTGTCAGG,0,1753531
gyrAp,0.25,3,3,ATATTCTTGGGCAATCCTCG,0,1753110
gyrAp,0.25,3,3,ATATGGGACTGCTTGAGGGT,0,1742514
gyrAp,0.25,3,3,ATATACCCAAGGATATTGCA,0,1756831
gyrAp,0.25,3,3,ATAGTGCGCACAACTTGAAC,0,1762166
gyrAp,0.25,3,3,ATAGGGTCCAAGCGACCATC,0,1756780
gyrAp,0.25,3,3,ATAGGAAGTCTGATCCCATC,0,1763273
gyrAp,0.25,3,3,ATAGAAAGAAAACCCGGATA,0,1765845
gyrAp,0.25,3,3,ATACGTTTGTTGCAGACAAC,0,1750268
gyrAp,0.25,3,3,ATACGAAGCAAAACCGACTC,0,1762751
gyrAp,0.25,3,3,ATACCTATCTCCCCTAAAAT,0,1746180
gyrAp,0.25,3,3,ATACAGAAAATTATTCTGCA,0,1755009
gyrAp,0.25,3,3,ATAATACAGGCCTTGACGTT,0,1756034
gyrAp,0.25,3,3,AGTTCGGCTCGGATGACTCG,0,1753189
gyrAp,0.25,3,3,AGTTCGGAGCAGAGCGCATC,0,1743339
gyrAp,0.25,3,3,AGTCGTGCTACGTTATGAAA,0,1766520
gyrAp,0.25,3,3,AGTCACCTTGCAGCGGCTCC,0,1752187
gyrAp,0.25,3,3,AGTAGGTGGAAACAGTACCA,0,1749704
gyrAp,0.25,3,3,AGTAAGGCCAATCCAAATGG,0,1744744
gyrAp,0.25,3,3,AGGTTAAGCTGCGGTTACGG,0,1748701
gyrAp,0.25,3,3,AGGTATTATTAACAGGGGTC,0,1752984
gyrAp,0.25,3,3,AGGTAGGATTTTCACAATGA,0,1747853
gyrAp,0.25,3,3,AGGGTTTAGACACCACTGAG,0,1758374
gyrAp,0.25,3,3,AGGGAGCACGTACTATTAAA,0,1750383
gyrAp,0.25,3,3,AGGCGGCTTGAGGCCGGTCG,0,1754273
gyrAp,0.25,3,3,AGGCCCCGACCCCTTAATAA,0,1753771
gyrAp,0.25,3,3,AGGCACCGCTCACTTTACCA,0,1760397
gyrAp,0.25,3,3,AGGAGGTAATCTTATATTAC,0,1751819
gyrAp,0.25,3,3,AGGACGGTTCGGCTAGCACT,0,1753310
gyrAp,0.25,3,3,AGCTGTCTCAGTCGGACTCA,0,1754213
gyrAp,0.25,3,3,AGCTGCAGCAGCTAATTATC,0,1759326
gyrAp,0.25,3,3,AGCTCTAAGGGGCCGTCCGA,0,1762126
gyrAp,0.25,3,3,AGCGATTGGTCTGTTTTAAG,0,1767100
gyrAp,0.25,3,3,AGCCGATATACTTATGAGCT,0,1769247
gyrAp,0.25,3,3,AGCAGTGTTACTGCGGGTCT,0,1742934
gyrAp,0.25,3,3,AGCAGTGACGGCGAGGGCGA,0,1752783
gyrAp,0.25,3,3,AGCACCGCCGTGGGCCTAAC,0,1747255
gyrAp,0.25,3,3,AGCAATGCACGAGGACATTC,0,1754208
gyrAp,0.25,3,3,AGCAAAAAATGCTCCATGCT,0,1742823
gyrAp,0.25,3,3,AGATTGTGCGATTCGAACAA,0,1758377
gyrAp,0.25,3,3,AGATGCGTCCTGTGTTCAAG,0,1766523
gyrAp,0.25,3,3,AGAGCCGTACGTGGGAATTT,0,1756106
gyrAp,0.25,3,3,AGAGATATGCGCGGGCTGTC,0,1749630
gyrAp,0.25,3,3,AGAGAGACCTACGTTCCGGT,0,1765650
gyrAp,0.25,3,3,AGAGACGTGGATCCCTCAGG,0,1756308
gyrAp,0.25,3,3,AGACGTACACGCATCGTATC,0,1760327
gyrAp,0.25,3,3,AGACGGACCCGCTAAGGTGG,0,1756102
gyrAp,0.25,3,3,AGAAGTCTAATACAAAAGCC,0,1751586
gyrAp,0.25,3,3,AGAAGGACATTAGTCGGGTA,0,1754315
gyrAp,0.25,3,3,AGAACATTATTCGGCTGGCG,0,1762165
gyrAp,0.25,3,3,ACTTTTCGTAAAGAATTGGC,0,1760959
gyrAp,0.25,3,3,ACTTTTCCTTCGCGCTACAG,0,1750042
gyrAp,0.25,3,3,ACTTTTATTAGGCTAACAAT,0,1768407
gyrAp,0.25,3,3,ACTTTGGTGTTGGAAGTTAT,0,1754397
gyrAp,0.25,3,3,ACTTTAACTACCCGTGTGAT,0,1769210
gyrAp,0.25,3,3,ACTTGTACAGCGTAAAGCCC,0,1747007
gyrAp,0.25,3,3,ACTTGCCTCGTCTAAGGCAG,0,1761805
gyrAp,0.25,3,3,ACTGCGATCCGAGTGAAACC,0,1754920
gyrAp,0.25,3,3,ACTCAGCATTAAACCTGCAG,0,1761177
gyrAp,0.25,3,3,ACTACCTGGACCTACGGCAT,0,1767317
gyrAp,0.25,3,3,ACTACCGACGGGTACTTTTT,0,1756741
gyrAp,0.25,3,3,ACGTCGGCTGACTGTCACGG,0,1759519
gyrAp,0.25,3,3,ACGGGGCGACCGTTTCGCGG,0,1753031
gyrAp,0.25,3,3,ACGCGAGGGTTGGCAACAGA,0,1768326
gyrAp,0.25,3,3,ACGCGAGCGGCTCTCGTTAG,0,1748478
gyrAp,0.25,3,3,ACGCCTCTTGTCTGATGTTA,0,1744135
gyrAp,0.25,3,3,ACGCAAAAGATAAGTGGGGA,0,1758785
gyrAp,0.25,3,3,ACGAGAAAATTTGATTAAAG,0,1755021
gyrAp,0.25,3,3,ACCTGCCTATCGTCCACGCC,0,1763035
gyrAp,0.25,3,3,ACCTCGAGCTCCTTGCCCTC,0,1751596
gyrAp,0.25,3,3,ACCTACGGTAGGCTGTGCGG,0,1750578
gyrAp,0.25,3,3,ACCGTGCTATCCAGTGCAGT,0,1763505
gyrAp,0.25,3,3,ACCGTCAACTGGTTCGATAG,0,1757320
gyrAp,0.25,3,3,ACCGTAGGGTGGCAGAGATT,0,1768979
gyrAp,0.25,3,3,ACCCTTGCGGTAAGCCTTTT,0,1743589
gyrAp,0.25,3,3,ACCCTTAAATCGTCGATACT,0,1749407
gyrAp,0.25,3,3,ACCCTATTTCATCTGTTAGA,0,1744659
gyrAp,0.25,3,3,ACCATCTGCCCAATGTATTG,0,1761720
gyrAp,0.25,3,3,ACCATCGGCGGCATCTATAG,0,1765698
gyrAp,0.25,3,3,ACCATATTCCAAAGCTGGAC,0,1743271
gyrAp,0.25,3,3,ACCAGGTTGTAAAGAGGGGG,0,1769292
gyrAp,0.25,3,3,ACCAGACCATGTTCCATCGG,0,1751314
gyrAp,0.25,3,3,ACATTCCCTGATCGAAGAGG,0,1751400
gyrAp,0.25,3,3,ACATCGTTTTTAGGAGGTGG,0,1747120
gyrAp,0.25,3,3,ACAGGTGCGAGCCACATATT,0,1758169
gyrAp,0.25,3,3,ACAGGGTAGCGCTTACTCGA,0,1761223
gyrAp,0.25,3,3,ACAGGGGGTTGGTTGTGAGC,0,1757612
gyrAp,0.25,3,3,ACAGCTCTGAGCCTGTTTGA,0,1746537
gyrAp,0.25,3,3,ACAGCTATCCACATAGCGGC,0,1746058
gyrAp,0.25,3,3,ACAGCGGACCCGGTCAAAGA,0,1751480
gyrAp,0.25,3,3,ACAGAGCAACCCGGTAGGGC,0,1757474
gyrAp,0.25,3,3,ACAGAAAGCTACTTGTCACG,0,1767071
gyrAp,0.25,3,3,ACACTGAGCAACGGTGGCGC,0,1758692
gyrAp,0.25,3,3,ACACGTCTTGCTCGATCACT,0,1765370
gyrAp,0.25,3,3,ACAAGATCCCGGCTTGGAAA,0,1766765
gyrAp,0.25,3,3,ACAAATGTGGGACACACGTG,0,1752436
gyrAp,0.25,3,3,ACAAAGTGTGAAATGCAAGG,0,1761485
gyrAp,0.25,3,3,ACAAAAGCAGGCGGGATTGC,0,1748726
gyrAp,0.25,3,3,AATTGGTCACCTTCGCGTAG,0,1747270
gyrAp,0.25,3,3,AATTCTGCCCGGCCTTACGG,0,1755216
gyrAp,0.25,3,3,AATTCCCGGGATTAGAAATA,0,1768608
gyrAp,0.25,3,3,AATTCAGGGTGATCTGAGTG,0,1746917
gyrAp,0.25,3,3,AATTAGAGCCACAAGGTTGA,0,1744703
gyrAp,0.25,3,3,AATGTTGTCACCGGCGTACA,0,1755238
gyrAp,0.25,3,3,AATGTGCCCTGTTGTTCGGC,0,1757659
gyrAp,0.25,3,3,AATGCCTGATAGCAACGGGG,0,1755914
gyrAp,0.25,3,3,AATCCTGATGGTCGCAATGG,0,1763028
gyrAp,0.25,3,3,AATCATCCGGTTCGACAGAG,0,1742006
gyrAp,0.25,3,3,AATCAATAATCCGTTGTTTC,0,1743335
gyrAp,0.25,3,3,AATAGGCGTATCCGCGCAAT,0,1763022
gyrAp,0.25,3,3,AATAGCCGCCGTCCGAGCGT,0,1757333
gyrAp,0.25,3,3,AAGTCAGTTATAACTGGGAT,0,1761248
gyrAp,0.25,3,3,AAGGGCATCAGAGGCATTGA,0,1763497
gyrAp,0.25,3,3,AAGGCTTATCCACCTTCGAA,0,1761175
gyrAp,0.25,3,3,AAGGCCTCGGCCGCTTTGGT,0,1746579
gyrAp,0.25,3,3,AAGATTAAGGACTTTCATTA,0,1754729
gyrAp,0.25,3,3,AAGATAAAACGAAAAGGTGT,0,1753936
gyrAp,0.25,3,3,AAGAGAGTTACGAAGTCAAT,0,1767612
gyrAp,0.25,3,3,AAGACGAGATTGAAAACCTG,0,1768446
gyrAp,0.25,3,3,AACTCCGGCGCTCGAAGGCA,0,1752452
gyrAp,0.25,3,3,AACGCACACAACGTTTAAAA,0,1766505
gyrAp,0.25,3,3,AACGAGGGAAAATTCAGTGA,0,1750772
gyrAp,0.25,3,3,AACGACATTCTAAAGGGGAT,0,1765319
gyrAp,0.25,3,3,AACATGAGCACGCCCGAGAT,0,1754979
gyrAp,0.25,3,3,AACATATCGGCCCTTCCAGA,0,1749937
gyrAp,0.25,3,3,AACATAGTACTCTCCGGTCT,0,1755190
gyrAp,0.25,3,3,AACATAAGATGGCGGTCCCC,0,1742540
gyrAp,0.25,3,3,AACAGTACACACATTTGTTG,0,1763949
gyrAp,0.25,3,3,AACAACCCACTCGATTCGGC,0,1764476
gyrAp,0.25,3,3,AAATTTCACGGTTGACCGCT,0,1753301
gyrAp,0.25,3,3,AAATGGCCTGACACTTCGCT,0,1760195
gyrAp,0.25,3,3,AAATCCTCGGAAATTGTAAA,0,1755267
gyrAp,0.25,3,3,AAATACCAGTCCTCTGTAGC,0,1761870
gyrAp,0.25,3,3,AAAGGGTGCACCGCGATTGG,0,1751657
gyrAp,0.25,3,3,AAAGCTGAGTCAATCCAATT,0,1768079
gyrAp,0.25,3,3,AAAGAGGAACTAACAAGCTG,0,1751755
gyrAp,0.25,3,3,AAAACACAGGAAGGGAACAT,0,1764704
gyrAp,0.3333333333333333,2,2,TTTTTCTCTCAGGACCATGC,0,1745852
gyrAp,0.3333333333333333,2,2,TTTTGGGCCAGCCGGACCCT,0,1762823
gyrAp,0.3333333333333333,2,2,TTTTGCCAACTCTTCAAGCA,0,1751397
gyrAp,0.3333333333333333,2,2,TTTTGCAAGCGTTCGTCGTG,0,1747380
gyrAp,0.3333333333333333,2,2,TTTTGAGTTGAAGAGACAGG,0,1750840
gyrAp,0.3333333333333333,2,2,TTTTGACCGGCCATCGCTTG,0,1753056
gyrAp,0.3333333333333333,2,2,TTTTCGCGCAAGTAGAGCCC,0,1747974
gyrAp,0.3333333333333333,2,2,TTTTCCAAACGCCGCAATTA,0,1749304
gyrAp,0.3333333333333333,2,2,TTTTAGATAGTTGTTGCTTA,0,1763234
gyrAp,0.3333333333333333,2,2,TTTTAAGAATTAATTTTTGT,0,1767364
gyrAp,0.3333333333333333,2,2,TTTGTACCTTGCAAATATAA,0,1749651
gyrAp,0.3333333333333333,2,2,TTTCCGAGTTGATGGTTGCA,0,1748831
gyrAp,0.3333333333333333,2,2,TTTAGGACGAACCTATAGGG,0,1752293
gyrAp,0.3333333333333333,2,2,TTTAGCCGAAGATGTTCGTG,0,1743967
gyrAp,0.3333333333333333,2,2,TTTACTATACGACCTTCCAC,0,1756709
gyrAp,0.3333333333333333,2,2,TTTACCCCGGCGGCTCCTCA,0,1758998
gyrAp,0.3333333333333333,2,2,TTGTTTCTTAATGCGGGCTG,0,1765894
gyrAp,0.3333333333333333,2,2,TTGTGCAGTTACTTGGGGCA,0,1767361
gyrAp,0.3333333333333333,2,2,TTGTAGCGACACCCGAGTTG,0,1760440
gyrAp,0.3333333333333333,2,2,TTGGTTCGCCGGTAGCGCGT,0,1748281
gyrAp,0.3333333333333333,2,2,TTGCTTGAGGACCAGTAGTA,0,1761962
gyrAp,0.3333333333333333,2,2,TTGCTCTAGTTGTGCCGGGT,0,1768975
gyrAp,0.3333333333333333,2,2,TTGCCTAAAGTACAGATAAC,0,1753174
gyrAp,0.3333333333333333,2,2,TTGCCAAGTGGGGACTGCGG,0,1765985
gyrAp,0.3333333333333333,2,2,TTGCATTCCTACGGCTTTTT,0,1761383
gyrAp,0.3333333333333333,2,2,TTGCAGTGCACGAGCGTTAG,0,1764698
gyrAp,0.3333333333333333,2,2,TTGAGACAAAGGGTCGAAGT,0,1759135
gyrAp,0.3333333333333333,2,2,TTGAATGGTAGGTATATCAT,0,1753739
gyrAp,0.3333333333333333,2,2,TTCTTGGGGCACATCTCTGA,0,1760334
gyrAp,0.3333333333333333,2,2,TTCTGATAAGGTGTGTTCAG,0,1769544
gyrAp,0.3333333333333333,2,2,TTCTCGGAGCTATTCGGGTT,0,1744730
gyrAp,0.3333333333333333,2,2,TTCTCGACGGTGGCACGCGC,0,1752186
gyrAp,0.3333333333333333,2,2,TTCTAAGGTATGAGAAGCTT,0,1763711
gyrAp,0.3333333333333333,2,2,TTCTAAGCATGTCTATCCGC,0,1768086
gyrAp,0.3333333333333333,2,2,TTCGGGCTACCTTATATCCC,0,1754688
gyrAp,0.3333333333333333,2,2,TTCGACCGACTACCTAGTCC,0,1761249
gyrAp,0.3333333333333333,2,2,TTCCTCAAAATCAGCGTTAA,0,1741658
gyrAp,0.3333333333333333,2,2,TTCCAGGAGATCCAATCGAA,0,1753395
gyrAp,0.3333333333333333,2,2,TTCCACGGGTCCTGTCTCGA,0,1747446
gyrAp,0.3333333333333333,2,2,TTCAGGCAGGTTCAATTAAA,0,1743108
gyrAp,0.3333333333333333,2,2,TTCACGATACACGGAGGTAC,0,1746099
gyrAp,0.3333333333333333,2,2,TTATTAAGATTATGTTACGC,0,1745199
gyrAp,0.3333333333333333,2,2,TTATGGGGCCTAAGGATTAC,0,1756425
gyrAp,0.3333333333333333,2,2,TTATGATCTAGAATGGTCAG,0,1768624
gyrAp,0.3333333333333333,2,2,TTATATTGCGGATCAGCAAA,0,1744617
gyrAp,0.3333333333333333,2,2,TTATAACCTAAAGAAACTGA,0,1750587
gyrAp,0.3333333333333333,2,2,TTAGTTAGAGTCTAGCTCGA,0,1743029
gyrAp,0.3333333333333333,2,2,TTAGTAGGTACATGCTTGTT,0,1762001
gyrAp,0.3333333333333333,2,2,TTAGGCAAATTGCGTATGCA,0,1744910
gyrAp,0.3333333333333333,2,2,TTAGACGCAGCGTTAGGGGT,0,1745827
gyrAp,0.3333333333333333,2,2,TTACGAGGCTGTGTTCTAAC,0,1752485
gyrAp,0.3333333333333333,2,2,TTACCCTCGCGGAGGGCTCA,0,1755930
gyrAp,0.3333333333333333,2,2,TTAACGCACTCCGTGTATTT,0,1749346
gyrAp,0.3333333333333333,2,2,TTAACCACAGAGGTTCGTTT,0,1754147
gyrAp,0.3333333333333333,2,2,TTAAATGGTAATATTCGAAC,0,1761452
gyrAp,0.3333333333333333,2,2,TTAAATATAGGCTACCAACC,0,1762744
gyrAp,0.3333333333333333,2,2,TGTTTCTGCTGGGTCAGTTC,0,1751433
gyrAp,0.3333333333333333,2,2,TGTTGTCCCGAATTCTAGTA,0,1748710
gyrAp,0.3333333333333333,2,2,TGTTCCGCACCGCCCAGAAA,0,1743069
gyrAp,0.3333333333333333,2,2,TGTTATCTTTCGGCTATGTG,0,1762629
gyrAp,0.3333333333333333,2,2,TGTTAGTACGACTTAACTGA,0,1742828
gyrAp,0.3333333333333333,2,2,TGTTACTTTTTCGGAGACAT,0,1756893
gyrAp,0.3333333333333333,2,2,TGTTAAGCCGACCGTAGGTT,0,1758284
gyrAp,0.3333333333333333,2,2,TGTGCTTAAGGGATTGTACA,0,1767998
gyrAp,0.3333333333333333,2,2,TGTCGTAACAGTTACTGACT,0,1750266
gyrAp,0.3333333333333333,2,2,TGTCGCATTGATGGAGGTGA,0,1746031
gyrAp,0.3333333333333333,2,2,TGTCCGAACCCGGCCAGCAA,0,1758067
gyrAp,0.3333333333333333,2,2,TGTAGTCAGTACAATGACTC,0,1761512
gyrAp,0.3333333333333333,2,2,TGGTTCTGTGAGTTTCTGAG,0,1756727
gyrAp,0.3333333333333333,2,2,TGGGGCTGATAAGGGGTATT,0,1760177
gyrAp,0.3333333333333333,2,2,TGGGGATCATATACTAACCC,0,1753394
gyrAp,0.3333333333333333,2,2,TGGGCATGCGTCGTGGGTCC,0,1760118
gyrAp,0.3333333333333333,2,2,TGGCACACGCAACGAGGCAG,0,1745778
gyrAp,0.3333333333333333,2,2,TGGAGGATCCTGTTGACTCC,0,1757421
gyrAp,0.3333333333333333,2,2,TGGAGCATTCCATATTTAGA,0,1749011
gyrAp,0.3333333333333333,2,2,TGGACCTTTTCGTCTCGAGC,0,1749564
gyrAp,0.3333333333333333,2,2,TGGACCTATAGCAACTTAGT,0,1763787
gyrAp,0.3333333333333333,2,2,TGGAACTGTTATGAAGGGAC,0,1751233
gyrAp,0.3333333333333333,2,2,TGGAACGAGGAGGTTCCCAC,0,1755609
gyrAp,0.3333333333333333,2,2,TGCTTCTTTACCACTGATTT,0,1763511
gyrAp,0.3333333333333333,2,2,TGCTCCGGATCTCCATCGAT,0,1770155
gyrAp,0.3333333333333333,2,2,TGCGGTTGGTGCTGATGGAG,0,1745352
gyrAp,0.3333333333333333,2,2,TGCGCTTCGCGTTGCAAAAA,0,1761162
gyrAp,0.3333333333333333,2,2,TGCGCATCACTTGTTAGCCT,0,1769810
gyrAp,0.3333333333333333,2,2,TGCCGAGTAAGGCAATCACG,0,1742187
gyrAp,0.3333333333333333,2,2,TGCCCAGCCACGATTTGACC,0,1760203
gyrAp,0.3333333333333333,2,2,TGCAGGGCGTTCCCTTGCCA,0,1748772
gyrAp,0.3333333333333333,2,2,TGCAGGATAGAGGGTGTAGA,0,1752306
gyrAp,0.3333333333333333,2,2,TGCAGGACGCATATGGACGC,0,1756216
gyrAp,0.3333333333333333,2,2,TGCACTTTACCGCGAACGTA,0,1749989
gyrAp,0.3333333333333333,2,2,TGAGCTTACAGTTATGACTC,0,1761372
gyrAp,0.3333333333333333,2,2,TGAGACCAGGCCTGGTGCGT,0,1745606
gyrAp,0.3333333333333333,2,2,TGACGGTATAGCGTGTGAAG,0,1756218
gyrAp,0.3333333333333333,2,2,TGACCACATTATTCCCACGA,0,1752334
gyrAp,0.3333333333333333,2,2,TGAATTACTGATGTATCTAA,0,1754596
gyrAp,0.3333333333333333,2,2,TGAAGTCATAAAAATAGGTT,0,1770346
gyrAp,0.3333333333333333,2,2,TGAAGACGTTTACTTGATAG,0,1762619
gyrAp,0.3333333333333333,2,2,TGAACTGTATGATCTCGCGG,0,1764343
gyrAp,0.3333333333333333,2,2,TCTTTGGGGAGGTTGGTTGA,0,1746974
gyrAp,0.3333333333333333,2,2,TCTGCCGACTCGAGTGTTAC,0,1745113
gyrAp,0.3333333333333333,2,2,TCTGCCAAGATCACAGCGTC,0,1763805
gyrAp,0.3333333333333333,2,2,TCTGAGCACAATAGTGATAG,0,1770502
gyrAp,0.3333333333333333,2,2,TCTCCCACCCCATAGTAAAT,0,1756341
gyrAp,0.3333333333333333,2,2,TCTCCATCATACGTGTCTTA,0,1745903
gyrAp,0.3333333333333333,2,2,TCTCATAAGTTGGCGACGTC,0,1767114
gyrAp,0.3333333333333333,2,2,TCTCACGGTAATCCGTTTTT,0,1752921
gyrAp,0.3333333333333333,2,2,TCTATCCTAAAGGTTGGAGG,0,1758760
gyrAp,0.3333333333333333,2,2,TCTAGAAGCATACCTCTAAC,0,1755431
gyrAp,0.3333333333333333,2,2,TCGTTCTTCTGAGTTCTCTC,0,1766295
gyrAp,0.3333333333333333,2,2,TCGTTAAGTAGTACGCTGTA,0,1758586
gyrAp,0.3333333333333333,2,2,TCGTGCTATGGACTAATATC,0,1754632
gyrAp,0.3333333333333333,2,2,TCGTGAAGTAAAAAACTCCT,0,1752457
gyrAp,0.3333333333333333,2,2,TCGGGTCCACTGTTATCAGC,0,1755661
gyrAp,0.3333333333333333,2,2,TCGGGTACCAAGGCATATCG,0,1767443
gyrAp,0.3333333333333333,2,2,TCGGATGGTTCGGTAATTTA,0,1752231
gyrAp,0.3333333333333333,2,2,TCGCCCTTGTGAGTATTACA,0,1752674
gyrAp,0.3333333333333333,2,2,TCGATTTCTATTTCGAAAGA,0,1755221
gyrAp,0.3333333333333333,2,2,TCGAGTGGAGGTAAGTCTAA,0,1742860
gyrAp,0.3333333333333333,2,2,TCGAGGGTTGTCTGCTGACA,0,1759027
gyrAp,0.3333333333333333,2,2,TCGAATGGGTGAAATGCTTT,0,1753175
gyrAp,0.3333333333333333,2,2,TCGAAGTATGTGTGGCACAC,0,1749489
gyrAp,0.3333333333333333,2,2,TCCTTAATTGGGTCCCCTCG,0,1744132
gyrAp,0.3333333333333333,2,2,TCCTACGCATCGCCATGTCA,0,1757902
gyrAp,0.3333333333333333,2,2,TCCGGTTTGTATCACGAGAG,0,1745897
gyrAp,0.3333333333333333,2,2,TCCGGAGGCCCCGCACATTA,0,1755406
gyrAp,0.3333333333333333,2,2,TCCGATCGTAGCGACTCTCA,0,1749327
gyrAp,0.3333333333333333,2,2,TCCGACTGTGTTGCGTTCAC,0,1763401
gyrAp,0.3333333333333333,2,2,TCCGAAAGGGTTTCCTAACA,0,1742304
gyrAp,0.3333333333333333,2,2,TCCCTTTGATCCGCGGCCAA,0,1758743
gyrAp,0.3333333333333333,2,2,TCCCGTTAGTGTCCCGCATG,0,1766525
gyrAp,0.3333333333333333,2,2,TCCCCGTAAAAGGCGGTGGA,0,1748222
gyrAp,0.3333333333333333,2,2,TCATTGGGGGAGCCCATTGT,0,1759256
gyrAp,0.3333333333333333,2,2,TCATGTGTCGCGTGGAGGTA,0,1761463
gyrAp,0.3333333333333333,2,2,TCATGAAAACGGTGGTGTAT,0,1756643
gyrAp,0.3333333333333333,2,2,TCATACATGCCGCAGTAATG,0,1747752
gyrAp,0.3333333333333333,2,2,TCAGGTGCACGGGATTCAGA,0,1748837
gyrAp,0.3333333333333333,2,2,TCAGATCAGACTCTCTAACC,0,1764159
gyrAp,0.3333333333333333,2,2,TCAGAAGAGCCAGCGATAGG,0,1769698
gyrAp,0.3333333333333333,2,2,TCACTGTTGAGCTTCAGGCA,0,1746422
gyrAp,0.3333333333333333,2,2,TCACCGGGCGTCTCTGACGT,0,1759309
gyrAp,0.3333333333333333,2,2,TCACATACCTTGGTAACACC,0,1755063
gyrAp,0.3333333333333333,2,2,TCACAATACGAACCGTAGGG,0,1748629
gyrAp,0.3333333333333333,2,2,TCACAAGCGAACCGTTGTGG,0,1769100
gyrAp,0.3333333333333333,2,2,TCAATTATCAGGCTGGACTA,0,1760332
gyrAp,0.3333333333333333,2,2,TATTCGCATATTATTGATGG,0,1765031
gyrAp,0.3333333333333333,2,2,TATGGTCTCATCGCCACGAA,0,1754451
gyrAp,0.3333333333333333,2,2,TATGATTTTCTAAGGGGTCT,0,1761877
gyrAp,0.3333333333333333,2,2,TATGATGTGCCTCTGGCAAC,0,1765500
gyrAp,0.3333333333333333,2,2,TATCGCGAAGGAGCCGCCGG,0,1754909
gyrAp,0.3333333333333333,2,2,TATCCACACCTGACGCATGC,0,1760339
gyrAp,0.3333333333333333,2,2,TATAGAGCATATTAAGGGAA,0,1750247
gyrAp,0.3333333333333333,2,2,TATACCTATAGGTCGGAAGG,0,1745423
gyrAp,0.3333333333333333,2,2,TATAACCTAAAACTCCGAAC,0,1751487
gyrAp,0.3333333333333333,2,2,TATAACAGCGAACAGGTGAC,0,1757222
gyrAp,0.3333333333333333,2,2,TAGTATCTCAACTCCTCATA,0,1745121
gyrAp,0.3333333333333333,2,2,TAGGCGCCCCTGAACGGTAC,0,1769801
gyrAp,0.3333333333333333,2,2,TAGGATTAGTGAGTTTTCTT,0,1754786
gyrAp,0.3333333333333333,2,2,TAGGAATTGCATTAACCGGA,0,1757897
gyrAp,0.3333333333333333,2,2,TAGCGGTTCCTGATTTATTC,0,1761353
gyrAp,0.3333333333333333,2,2,TACTCACGGTTTCAGATCGA,0,1749947
gyrAp,0.3333333333333333,2,2,TACTCACCACTTCTAAGGGG,0,1765954
gyrAp,0.3333333333333333,2,2,TAATTGAGGTGTTTGGTGTA,0,1753101
gyrAp,0.3333333333333333,2,2,TAAGTAAATTTAGCTGAGGT,0,1744291
gyrAp,0.3333333333333333,2,2,TAAGGTCCCGTGTCAAATGT,0,1750454
gyrAp,0.3333333333333333,2,2,TAACTACATCTCCGATACGA,0,1766948
gyrAp,0.3333333333333333,2,2,TAACGGGCTGTGTTTCTGCA,0,1766960
gyrAp,0.3333333333333333,2,2,TAAATAGACAGAGACGTACG,0,1750292
gyrAp,0.3333333333333333,2,2,TAAAGGAGAGAGGCCTGGCC,0,1741464
gyrAp,0.3333333333333333,2,2,TAAACTTATGCCGTGCCAAC,0,1758179
gyrAp,0.3333333333333333,2,2,TAAACTACGCATACTACAGC,0,1741441
gyrAp,0.3333333333333333,2,2,TAAACCGTTTGAGCCCTGCG,0,1768518
gyrAp,0.3333333333333333,2,2,GTTTTGGTATCAAGTTTGTA,0,1756219
gyrAp,0.3333333333333333,2,2,GTTTCCATGGTTTCCCCTTT,0,1770769
gyrAp,0.3333333333333333,2,2,GTTTAGTAGGATGACTCACT,0,1749395
gyrAp,0.3333333333333333,2,2,GTTGTTTTAGGCGTTTCTCT,0,1743057
gyrAp,0.3333333333333333,2,2,GTTGGTACGACTTACATGCA,0,1766600
gyrAp,0.3333333333333333,2,2,GTTGGGTTCAGTCCGTAAGT,0,1770022
gyrAp,0.3333333333333333,2,2,GTTGCCGATGTAGGACAAAT,0,1749080
gyrAp,0.3333333333333333,2,2,GTTCTAATTAGGTTGTCATA,0,1760093
gyrAp,0.3333333333333333,2,2,GTTCGCCCCCTGCCCAGCGT,0,1764023
gyrAp,0.3333333333333333,2,2,GTTCGCCACCCCCAACTGAC,0,1754584
gyrAp,0.3333333333333333,2,2,GTTCGCAAAGCACAGCGTTG,0,1769372
gyrAp,0.3333333333333333,2,2,GTTCCGCGCAGACTAAATAT,0,1746006
gyrAp,0.3333333333333333,2,2,GTTCAGACCTGCCTAGCCGA,0,1769219
gyrAp,0.3333333333333333,2,2,GTGTGTAAATCCTTAAAATA,0,1761545
gyrAp,0.3333333333333333,2,2,GTGTGGCATGGGCGGGAATC,0,1748931
gyrAp,0.3333333333333333,2,2,GTGTGACTGCTGACCGTAAT,0,1758494
gyrAp,0.3333333333333333,2,2,GTGGTCTATCGCACGCATCT,0,1769162
gyrAp,0.3333333333333333,2,2,GTGGCGAATTTCCTTAGATA,0,1743854
gyrAp,0.3333333333333333,2,2,GTGGAAGTGATGGCGAATAT,0,1765577
gyrAp,0.3333333333333333,2,2,GTGCGTCCGGTAGGAATTAA,0,1742171
gyrAp,0.3333333333333333,2,2,GTGCGCAGAGTCTGGAATCG,0,1763925
gyrAp,0.3333333333333333,2,2,GTGCCGATATAGGTCAGGTT,0,1742606
gyrAp,0.3333333333333333,2,2,GTGCACCGACAAGACTGGTG,0,1766504
gyrAp,0.3333333333333333,2,2,GTGCACACGCGTCTGCCGAG,0,1761239
gyrAp,0.3333333333333333,2,2,GTGATTTCGTATTTGCCTCT,0,1770333
gyrAp,0.3333333333333333,2,2,GTGATTCACCAACAGTATTC,0,1746941
gyrAp,0.3333333333333333,2,2,GTGATAAGCGCCGATCCCGG,0,1746320
gyrAp,0.3333333333333333,2,2,GTGACCGGATTTCACCTCTC,0,1743188
gyrAp,0.3333333333333333,2,2,GTGAATGGAATTGACCGGCA,0,1769749
gyrAp,0.3333333333333333,2,2,GTCTGTTATGATAGCTACCG,0,1748919
gyrAp,0.3333333333333333,2,2,GTCTGTGACGTATCAATCAG,0,1769989
gyrAp,0.3333333333333333,2,2,GTCTCGCTATTGGGCGTCAT,0,1765273
gyrAp,0.3333333333333333,2,2,GTCTCAGACTGTGGGTAGAT,0,1743706
gyrAp,0.3333333333333333,2,2,GTCTAGTTACTTGGGCTAGA,0,1762272
gyrAp,0.3333333333333333,2,2,GTCTAGTAGGAGATTGATCT,0,1750269
gyrAp,0.3333333333333333,2,2,GTCGTTATTCATGAGCGTGT,0,1750293
gyrAp,0.3333333333333333,2,2,GTCGGCCAAGCCGATGGGCG,0,1770027
gyrAp,0.3333333333333333,2,2,GTCACGAGCCATTCACTATG,0,1760068
gyrAp,0.3333333333333333,2,2,GTCAACATTTTTGTCACCTC,0,1750658
gyrAp,0.3333333333333333,2,2,GTCAAATTAGAGACTATCTG,0,1766023
gyrAp,0.3333333333333333,2,2,GTCAAATGCTCCTGTCAACC,0,1751263
gyrAp,0.3333333333333333,2,2,GTCAAAAATTCCCGCGTACA,0,1748294
gyrAp,0.3333333333333333,2,2,GTATGGCCGGTGAGATGTGG,0,1765506
gyrAp,0.3333333333333333,2,2,GTAGTCGGATCAGGATACTG,0,1755110
gyrAp,0.3333333333333333,2,2,GTAGGGTCCTGTGTCGGGAT,0,1743250
gyrAp,0.3333333333333333,2,2,GTAGGGACAATTAAGTATCT,0,1753009
gyrAp,0.3333333333333333,2,2,GTAGACTGCACCAAGGAAGA,0,1756511
gyrAp,0.3333333333333333,2,2,GTACTATGATGTCCCAAGAG,0,1758116
gyrAp,0.3333333333333333,2,2,GTACCGGGCAGGTCCTTTCA,0,1766340
gyrAp,0.3333333333333333,2,2,GTACCGAGAGGTCATCCAGA,0,1741736
gyrAp,0.3333333333333333,2,2,GTACAGGTGGGAATGGCGAT,0,1742522
gyrAp,0.3333333333333333,2,2,GTAATGGGCTCTTCAACACT,0,1752825
gyrAp,0.3333333333333333,2,2,GTAAGGACGGTCAGGCCCTA,0,1761631
gyrAp,0.3333333333333333,2,2,GGTTTCGTGCATCTCGCGAG,0,1753170
gyrAp,0.3333333333333333,2,2,GGTTCGTTCTCAGTTTGGCT,0,1758423
gyrAp,0.3333333333333333,2,2,GGTGTTGAAACCCCGTCCTT,0,1754502
gyrAp,0.3333333333333333,2,2,GGTGGCTGTAAGTGGTATGA,0,1759105
gyrAp,0.3333333333333333,2,2,GGTGCGGGCGCTAAGATGTA,0,1750037
gyrAp,0.3333333333333333,2,2,GGTCTCTGATAAACTGGAAG,0,1763425
gyrAp,0.3333333333333333,2,2,GGTCTCTCGTTGCAAGACTT,0,1759274
gyrAp,0.3333333333333333,2,2,GGTAATCGCCGGCAACAATA,0,1766596
gyrAp,0.3333333333333333,2,2,GGGTGGTCCATGGCGTCAGA,0,1756947
gyrAp,0.3333333333333333,2,2,GGGTCACTCCGGTCTTACCA,0,1752319
gyrAp,0.3333333333333333,2,2,GGGGTGGTATCTCAGCATAA,0,1762045
gyrAp,0.3333333333333333,2,2,GGGGTCGAGATTCATGACCG,0,1765583
gyrAp,0.3333333333333333,2,2,GGGGGTTCTTGTCGAGAGTG,0,1750098
gyrAp,0.3333333333333333,2,2,GGGGGTTAGTCGCTTTTTCG,0,1756173
gyrAp,0.3333333333333333,2,2,GGGGAGGCGTGAGAATCTAA,0,1746921
gyrAp,0.3333333333333333,2,2,GGGGACCCTGCTCTATTTGA,0,1747938
gyrAp,0.3333333333333333,2,2,GGGCGGTTCTTCCGATCGAC,0,1757074
gyrAp,0.3333333333333333,2,2,GGGCCAGTGGTCTCCGGAAC,0,1760906
gyrAp,0.3333333333333333,2,2,GGGCATCATGGGGGCTGTAC,0,1745746
gyrAp,0.3333333333333333,2,2,GGGCACGGACTCGACCTGCA,0,1746597
gyrAp,0.3333333333333333,2,2,GGGATCGTCAAATACGTCCT,0,1747860
gyrAp,0.3333333333333333,2,2,GGGATAGGCCTGAGTTGGTT,0,1755315
gyrAp,0.3333333333333333,2,2,GGGAGTTCAGGGTCCATCGA,0,1743777
gyrAp,0.3333333333333333,2,2,GGCTTATAAGTTGTCATTTT,0,1757554
gyrAp,0.3333333333333333,2,2,GGCTGCTTGCTTTCAAATGT,0,1763078
gyrAp,0.3333333333333333,2,2,GGCTGCACTTTAAATTTTCA,0,1763121
gyrAp,0.3333333333333333,2,2,GGCTCAAACCACCACGTTGA,0,1763670
gyrAp,0.3333333333333333,2,2,GGCTATTAGTTTAGTAGGGA,0,1741971
gyrAp,0.3333333333333333,2,2,GGCGTGGGGGTACCTACTGA,0,1745858
gyrAp,0.3333333333333333,2,2,GGCGGTGGATGCACCCCAGT,0,1757286
gyrAp,0.3333333333333333,2,2,GGCGGTCTAGAACCCCCACG,0,1747577
gyrAp,0.3333333333333333,2,2,GGCGCTTAGAACAGCTTGCA,0,1752063
gyrAp,0.3333333333333333,2,2,GGCGATTGCATGCATACGAA,0,1757938
gyrAp,0.3333333333333333,2,2,GGCCTGCTCCCCGACCTCTT,0,1745063
gyrAp,0.3333333333333333,2,2,GGCCTAGTTGCGCATCATGT,0,1741674
gyrAp,0.3333333333333333,2,2,GGCCGCTTGAGCCTACGACC,0,1748729
gyrAp,0.3333333333333333,2,2,GGCCGACAGCTTGGGACGCT,0,1756707
gyrAp,0.3333333333333333,2,2,GGCCCCTAGTGTAGTTCGTC,0,1761861
gyrAp,0.3333333333333333,2,2,GGCATGACGCAAATTTCGAG,0,1760845
gyrAp,0.3333333333333333,2,2,GGCAGCGAAAAGAAAAGCTC,0,1762707
gyrAp,0.3333333333333333,2,2,GGCACAACAGACGGTGTTTT,0,1757751
gyrAp,0.3333333333333333,2,2,GGCAACGCTCTGCTCGTCTA,0,1758322
gyrAp,0.3333333333333333,2,2,GGCAACAGATTTCTGGAGTG,0,1761929
gyrAp,0.3333333333333333,2,2,GGATGGAGAGAAGAAGTCCA,0,1754874
gyrAp,0.3333333333333333,2,2,GGATGACCTGCAATGACTCG,0,1764076
gyrAp,0.3333333333333333,2,2,GGATCTCTGGAAGTCCATGA,0,1760069
gyrAp,0.3333333333333333,2,2,GGAGGACAGGTGCGCCGCGC,0,1742056
gyrAp,0.3333333333333333,2,2,GGAGAGGTCTATCACCGCCT,0,1770331
gyrAp,0.3333333333333333,2,2,GGACTCTATGAGCTAGTGTT,0,1742014
gyrAp,0.3333333333333333,2,2,GGACAGAGAACTGTGATAGT,0,1770449
gyrAp,0.3333333333333333,2,2,GGAAGTGTGCAAAGTAGGAT,0,1753630
gyrAp,0.3333333333333333,2,2,GGAAACCGTTCACCGAACTC,0,1742808
gyrAp,0.3333333333333333,2,2,GGAAACACGACAGGTCACCG,0,1759577
gyrAp,0.3333333333333333,2,2,GCTTGCATCCAGTCCATGAC,0,1762621
gyrAp,0.3333333333333333,2,2,GCTTCTATATGGTTGCGCGC,0,1765387
gyrAp,0.3333333333333333,2,2,GCTTAGGGCCTGAATACTTA,0,1765936
gyrAp,0.3333333333333333,2,2,GCTGTCGGCCCCTCTCGGCG,0,1756379
gyrAp,0.3333333333333333,2,2,GCTACTTCGGTTCCTATCAT,0,1744943
gyrAp,0.3333333333333333,2,2,GCTACTGGTCTAGAATTTAC,0,1756966
gyrAp,0.3333333333333333,2,2,GCTACGAGGTTGGCCGACGA,0,1744403
gyrAp,0.3333333333333333,2,2,GCTAAATAAGATGAGCGATT,0,1742210
gyrAp,0.3333333333333333,2,2,GCGTTAGCCGGGTCTTCTGG,0,1766714
gyrAp,0.3333333333333333,2,2,GCGTCGAGGAGTGGATAGTA,0,1745293
gyrAp,0.3333333333333333,2,2,GCGTCCCGGATTGCATACAT,0,1765503
gyrAp,0.3333333333333333,2,2,GCGGGTACTGGCCATGCGCT,0,1768444
gyrAp,0.3333333333333333,2,2,GCGGGCTTGGTTCCGTGTTT,0,1750026
gyrAp,0.3333333333333333,2,2,GCGGGCGTATTCCTGTTAGG,0,1751435
gyrAp,0.3333333333333333,2,2,GCGGGCAATGACAGCTAGCG,0,1744663
gyrAp,0.3333333333333333,2,2,GCGGGATCATCTGCTTGAAT,0,1746947
gyrAp,0.3333333333333333,2,2,GCGCTCATATGTTGAAGTTC,0,1759639
gyrAp,0.3333333333333333,2,2,GCGCAGGACTGGAGTTCTGC,0,1762773
gyrAp,0.3333333333333333,2,2,GCGATACCTGTACGGTTCAC,0,1759968
gyrAp,0.3333333333333333,2,2,GCGAGATGGGCACGTAGTAC,0,1746797
gyrAp,0.3333333333333333,2,2,GCGAAAATCAGTTCTACGAA,0,1767349
gyrAp,0.3333333333333333,2,2,GCCTTTGGATCCAGGGATAC,0,1746396
gyrAp,0.3333333333333333,2,2,GCCTTCCCTTTTGTTGCGCA,0,1755211
gyrAp,0.3333333333333333,2,2,GCCTTAAGACAGATTTGGAG,0,1747578
gyrAp,0.3333333333333333,2,2,GCCTAGCGAATCCCTAGCCT,0,1770242
gyrAp,0.3333333333333333,2,2,GCCGGAAAAGAGTTACACAA,0,1753837
gyrAp,0.3333333333333333,2,2,GCCCGCCGCAAGTTAGTTTC,0,1743691
gyrAp,0.3333333333333333,2,2,GCCCACGCGAACGGAGCATA,0,1752856
gyrAp,0.3333333333333333,2,2,GCCACATACACTCGAAATGG,0,1758869
gyrAp,0.3333333333333333,2,2,GCATGGCCAGTACTTAGTCG,0,1760055
gyrAp,0.3333333333333333,2,2,GCATGCAGCATGGCATCAGT,0,1755885
gyrAp,0.3333333333333333,2,2,GCATCCCTATGCTTTATGTA,0,1747190
gyrAp,0.3333333333333333,2,2,GCATCAGCATGGTCAATACA,0,1765530
gyrAp,0.3333333333333333,2,2,GCAGTCATCTCGGGAGGCAC,0,1754618
gyrAp,0.3333333333333333,2,2,GCAGCATCCCCTCGTATACC,0,1757319
gyrAp,0.3333333333333333,2,2,GCACGGAGCATCGGCTCATT,0,1769311
gyrAp,0.3333333333333333,2,2,GCAAGGTCTCAGGCCAGCCA,0,1768541
gyrAp,0.3333333333333333,2,2,GCAAAGGCGCATGTGGGCCA,0,1765220
gyrAp,0.3333333333333333,2,2,GCAAACGATACAATCCCCAT,0,1745361
gyrAp,0.3333333333333333,2,2,GATTATTGAGTATGGAACAG,0,1766821
gyrAp,0.3333333333333333,2,2,GATGTCTAGGTGGTATTAGA,0,1756993
gyrAp,0.3333333333333333,2,2,GATGCCCAGTGTTCATGGGG,0,1743909
gyrAp,0.3333333333333333,2,2,GATCTTACCCGTAGCTGAAT,0,1753603
gyrAp,0.3333333333333333,2,2,GATCGTGTTGAGACGATATC,0,1770457
gyrAp,0.3333333333333333,2,2,GATCGGGATGTAAATTACGT,0,1756440
gyrAp,0.3333333333333333,2,2,GATAGCGATGTTCACGCAGC,0,1748934
gyrAp,0.3333333333333333,2,2,GATAGCACAGTCCTACCGGA,0,1769655
gyrAp,0.3333333333333333,2,2,GAGTCCAACCAAAAAGTTGT,0,1742661
gyrAp,0.3333333333333333,2,2,GAGGTGAGTTAAAGAGCAAT,0,1767508
gyrAp,0.3333333333333333,2,2,GAGGGACCCTTACCATGCTA,0,1760520
gyrAp,0.3333333333333333,2,2,GAGGAAGGCGTACGCAATCG,0,1747777
gyrAp,0.3333333333333333,2,2,GAGCGTGTTCGGAGTTCCGT,0,1767354
gyrAp,0.3333333333333333,2,2,GAGCCTCTATATCCAGAGCG,0,1765480
gyrAp,0.3333333333333333,2,2,GAGCCTCGGGCTATTCTAAG,0,1747412
gyrAp,0.3333333333333333,2,2,GAGCCTCATCGATTTCAAAT,0,1741896
gyrAp,0.3333333333333333,2,2,GAGATGGCGGGAACTAGAAA,0,1741662
gyrAp,0.3333333333333333,2,2,GAGATCAAAGAGCAGCTGGG,0,1768098
gyrAp,0.3333333333333333,2,2,GAGATATTTTCTCGTTGTAG,0,1745246
gyrAp,0.3333333333333333,2,2,GAGACCAACCCCTCCTTATG,0,1761138
gyrAp,0.3333333333333333,2,2,GACTTGTACGTGCTTGCTAC,0,1742632
gyrAp,0.3333333333333333,2,2,GACTGCGATGGTCCATTCGG,0,1770491
gyrAp,0.3333333333333333,2,2,GACGCTCTCATTCTAGGGTT,0,1764155
gyrAp,0.3333333333333333,2,2,GACGCATCAAGTATCAGAGA,0,1763950
gyrAp,0.3333333333333333,2,2,GACCTTATTTGGATGCATGA,0,1743592
gyrAp,0.3333333333333333,2,2,GACCTGAGGGTTATGGCGTT,0,1761333
gyrAp,0.3333333333333333,2,2,GACCCTGCGGGTAGAACGAT,0,1768056
gyrAp,0.3333333333333333,2,2,GACCACTACCAGAATTGGGC,0,1745190
gyrAp,0.3333333333333333,2,2,GACAGCCCCAGTGCCCGATA,0,1758781
gyrAp,0.3333333333333333,2,2,GACAGAAGGGGTCGTATAAT,0,1762074
gyrAp,0.3333333333333333,2,2,GAATTGTAGTACTGCTTTGA,0,1770220
gyrAp,0.3333333333333333,2,2,GAATTGCTTCAGCATCGCCG,0,1762901
gyrAp,0.3333333333333333,2,2,GAATGCGGTTCAGCCGCCCA,0,1764139
gyrAp,0.3333333333333333,2,2,GAATCTCTGCTGTGATGCGT,0,1767570
gyrAp,0.3333333333333333,2,2,GAATAGGACCAGTCTTTTAA,0,1761314
gyrAp,0.3333333333333333,2,2,GAATACCGTTCGGTCAACCA,0,1766350
gyrAp,0.3333333333333333,2,2,GAATAACTATCGGTCTTGGT,0,1761557
gyrAp,0.3333333333333333,2,2,GAAGTGAAACGCATTAACAG,0,1758426
gyrAp,0.3333333333333333,2,2,GAAGGTCACACGGGACGTCA,0,1753043
gyrAp,0.3333333333333333,2,2,GAAGGCCGCACGCTGCGAAA,0,1758564
gyrAp,0.3333333333333333,2,2,GAAGAGGCGGGCCTGAACAG,0,1743705
gyrAp,0.3333333333333333,2,2,GAACTCCGGGCTTTGAAACC,0,1755368
gyrAp,0.3333333333333333,2,2,GAACGTGCCTCATATAGTCC,0,1754591
gyrAp,0.3333333333333333,2,2,GAACGGTCCTACGTGCGGGG,0,1743486
gyrAp,0.3333333333333333,2,2,GAAATGTCGTAGTGTAGATA,0,1768222
gyrAp,0.3333333333333333,2,2,CTTTTATAGTATAGCGGCGC,0,1760142
gyrAp,0.3333333333333333,2,2,CTTTGGCCCCGCGCCCCAGG,0,1748319
gyrAp,0.3333333333333333,2,2,CTTTCTTGCACAACTTCCAC,0,1752732
gyrAp,0.3333333333333333,2,2,CTTGTTGGACTGAGCCCTTG,0,1755748
gyrAp,0.3333333333333333,2,2,CTTGTGCGAAGGCGAGTTAT,0,1743467
gyrAp,0.3333333333333333,2,2,CTTGTCTCCGCTGATTCCTA,0,1756381
gyrAp,0.3333333333333333,2,2,CTTGTCGATCGTATCCCACC,0,1749956
gyrAp,0.3333333333333333,2,2,CTTGCCACGTCAGGCCGAAA,0,1750603
gyrAp,0.3333333333333333,2,2,CTTCCGCGACCGAGCGTTGC,0,1768926
gyrAp,0.3333333333333333,2,2,CTTCCCTCGAAATAACTTAT,0,1748321
gyrAp,0.3333333333333333,2,2,CTTCAGGGGTGAGGATGCGA,0,1760813
gyrAp,0.3333333333333333,2,2,CTTAGTCGCTAAAGAACTCG,0,1770136
gyrAp,0.3333333333333333,2,2,CTTACCCCGCAGGGTCTGGA,0,1770193
gyrAp,0.3333333333333333,2,2,CTTACCATTATGTGCACCCC,0,1746565
gyrAp,0.3333333333333333,2,2,CTGTTTGTTACTTAACTTTA,0,1741824
gyrAp,0.3333333333333333,2,2,CTGTTGTGAGTCCACGCCCA,0,1763291
gyrAp,0.3333333333333333,2,2,CTGTCTTCCAATAAGACTGT,0,1768572
gyrAp,0.3333333333333333,2,2,CTGTCAAGCTAAGCCCAGGA,0,1746095
gyrAp,0.3333333333333333,2,2,CTGTACAAAAAAGATCGGCA,0,1751330
gyrAp,0.3333333333333333,2,2,CTGGGCGATCAGGGCGTCGG,0,1769174
gyrAp,0.3333333333333333,2,2,CTGGGACGCAGGCGTCATTT,0,1750868
gyrAp,0.3333333333333333,2,2,CTGGCCTATGTTTGGAGTCA,0,1756339
gyrAp,0.3333333333333333,2,2,CTGCCCCGTGGCTGGGCAAG,0,1752044
gyrAp,0.3333333333333333,2,2,CTGAGGTCTGAAGGAATCAG,0,1744971
gyrAp,0.3333333333333333,2,2,CTGAGCAGGAATGAGGAAAG,0,1758222
gyrAp,0.3333333333333333,2,2,CTGACACGACTGCGTAGAAA,0,1758342
gyrAp,0.3333333333333333,2,2,CTCGCTTTCTAATGGGGTGC,0,1756175
gyrAp,0.3333333333333333,2,2,CTCGAAGTCCGAAAGAGACG,0,1750106
gyrAp,0.3333333333333333,2,2,CTCCTTGGAAGTCTCCAGGG,0,1759074
gyrAp,0.3333333333333333,2,2,CTCCTCTAGACCGTTATTAT,0,1741823
gyrAp,0.3333333333333333,2,2,CTCCCGCCTGGTCCGAAAGC,0,1742532
gyrAp,0.3333333333333333,2,2,CTCCCCGGGTGCCGAGGGTG,0,1766650
gyrAp,0.3333333333333333,2,2,CTCCACCTATAAAATCTGCT,0,1768371
gyrAp,0.3333333333333333,2,2,CTCATACTCAGTTTGCTCAA,0,1743064
gyrAp,0.3333333333333333,2,2,CTCACTCGACATGTACCTCA,0,1750222
gyrAp,0.3333333333333333,2,2,CTCAACTGAAGCACGTGGCT,0,1762389
gyrAp,0.3333333333333333,2,2,CTATGCACGTCTAGGAAGCT,0,1760765
gyrAp,0.3333333333333333,2,2,CTATCCTGGCTGCGATCCAG,0,1742533
gyrAp,0.3333333333333333,2,2,CTAGCTATTTAGCAGGCTTT,0,1745559
gyrAp,0.3333333333333333,2,2,CTAAGCTTCCACCCGAAGAA,0,1759576
gyrAp,0.3333333333333333,2,2,CTAAGCAGTACGAACAAGAG,0,1769475
gyrAp,0.3333333333333333,2,2,CTAAAAATAGTGCGCTCGCG,0,1748081
gyrAp,0.3333333333333333,2,2,CGTTTAGCCGGGTTACGTAT,0,1741715
gyrAp,0.3333333333333333,2,2,CGTTGGCGCACCTCCCGGGA,0,1766940
gyrAp,0.3333333333333333,2,2,CGTTCCTCCGAAGGAGATTG,0,1762911
gyrAp,0.3333333333333333,2,2,CGTTACCCACCCTTAACGTC,0,1760242
gyrAp,0.3333333333333333,2,2,CGTGGTCTTGACCACTAACT,0,1757944
gyrAp,0.3333333333333333,2,2,CGTGCGATTCACAGGGCGTC,0,1768672
gyrAp,0.3333333333333333,2,2,CGTGAGGCTTTCATTTTCCT,0,1749089
gyrAp,0.3333333333333333,2,2,CGTCTAAGGACCTCTTGGAG,0,1761833
gyrAp,0.3333333333333333,2,2,CGTCATGCATGCCTGTTTGG,0,1745649
gyrAp,0.3333333333333333,2,2,CGTCACTCGAACTGAACTGC,0,1749396
gyrAp,0.3333333333333333,2,2,CGTACATCAGGAGCTCGAGG,0,1766041
gyrAp,0.3333333333333333,2,2,CGTAATAAGTCCCCCCGCCT,0,1765758
gyrAp,0.3333333333333333,2,2,CGGTTGCTTAGGGTAATTCG,0,1755690
gyrAp,0.3333333333333333,2,2,CGGTTACGGACTAGCGACAA,0,1754840
gyrAp,0.3333333333333333,2,2,CGGTCTTATCGCGTGCAGAC,0,1753240
gyrAp,0.3333333333333333,2,2,CGGTCGAGATTTAATCTGGA,0,1743588
gyrAp,0.3333333333333333,2,2,CGGTCCGGTCCCTGAGACAT,0,1753114
gyrAp,0.3333333333333333,2,2,CGGTCCGCTTAAACAGTAAG,0,1770451
gyrAp,0.3333333333333333,2,2,CGGGCCAATTCAGACCTTAG,0,1768629
gyrAp,0.3333333333333333,2,2,CGGGAGTGTTTTGTTCAATT,0,1753655
gyrAp,0.3333333333333333,2,2,CGGCTTGGGTATGAGAAATG,0,1755853
gyrAp,0.3333333333333333,2,2,CGGCTGTCTACAGGCTTCAT,0,1770744
gyrAp,0.3333333333333333,2,2,CGGCGTGCTTAACGCGGAAT,0,1745208
gyrAp,0.3333333333333333,2,2,CGGCCTCGTAGTTGTTTTTG,0,1741764
gyrAp,0.3333333333333333,2,2,CGGCCCTACAGGAGATAGGA,0,1750239
gyrAp,0.3333333333333333,2,2,CGGATAAAAAGTGAAGTCAA,0,1752751
gyrAp,0.3333333333333333,2,2,CGGAGTGTTGCTCTCGGAAT,0,1763948
gyrAp,0.3333333333333333,2,2,CGGAGCGACCGAGTGTCCCC,0,1750244
gyrAp,0.3333333333333333,2,2,CGCGTTAAGCTGGTTGGTGC,0,1753768
gyrAp,0.3333333333333333,2,2,CGCGTCAGGGCATCGCCCCT,0,1756480
gyrAp,0.3333333333333333,2,2,CGCGGAAGCGTGCTAATTTA,0,1754804
gyrAp,0.3333333333333333,2,2,CGCGCAAGCGTAATCGTATA,0,1747151
gyrAp,0.3333333333333333,2,2,CGCCGGCTGAGGAGCATTCG,0,1758932
gyrAp,0.3333333333333333,2,2,CGCCGGAACTCTTATGACAG,0,1756121
gyrAp,0.3333333333333333,2,2,CGCCCGGCATTGATCACCTT,0,1756742
gyrAp,0.3333333333333333,2,2,CGCCCACTGAGCGACTACGT,0,1747584
gyrAp,0.3333333333333333,2,2,CGCCCAAAGCGATAAGGGTG,0,1750363
gyrAp,0.3333333333333333,2,2,CGCACGTTCGCACGTCATTT,0,1744424
gyrAp,0.3333333333333333,2,2,CGATTTACCTGATAACGATG,0,1748800
gyrAp,0.3333333333333333,2,2,CGATGGAGTTGAATCTTAGA,0,1761105
gyrAp,0.3333333333333333,2,2,CGATCCAGGGATATGGCAAT,0,1757919
gyrAp,0.3333333333333333,2,2,CGATAGCTCATGAACGCGTG,0,1760212
gyrAp,0.3333333333333333,2,2,CGATACTTATTCGGCACGGG,0,1762278
gyrAp,0.3333333333333333,2,2,CGACTTATGTTCGGAATCCT,0,1742402
gyrAp,0.3333333333333333,2,2,CGACGGCCACACTTGGACTG,0,1761624
gyrAp,0.3333333333333333,2,2,CGACAGTGCCGAACGATTTA,0,1766975
gyrAp,0.3333333333333333,2,2,CGAAGTTGACACTGGCGGCG,0,1768627
gyrAp,0.3333333333333333,2,2,CGAACTAATGTTTGGTTGAT,0,1765562
gyrAp,0.3333333333333333,2,2,CGAACCTAAACGACACTGGG,0,1763436
gyrAp,0.3333333333333333,2,2,CGAACCGAGCTGAACCGATG,0,1758356
gyrAp,0.3333333333333333,2,2,CCTTTGGTGTATTTAAGGCG,0,1752166
gyrAp,0.3333333333333333,2,2,CCTTTCACTCAGGGCGATTT,0,1755243
gyrAp,0.3333333333333333,2,2,CCTTTAGCATGGTCAGAAAT,0,1744123
gyrAp,0.3333333333333333,2,2,CCTTTAAGAAGGAGCATTCA,0,1761120
gyrAp,0.3333333333333333,2,2,CCTTGGTTGGAATAGGTCAC,0,1767118
gyrAp,0.3333333333333333,2,2,CCTTCTAGGCGCCAGCACGT,0,1744206
gyrAp,0.3333333333333333,2,2,CCTTCAGTATGACATGAAAT,0,1747678
gyrAp,0.3333333333333333,2,2,CCTTAATGCTTAATGAGTCC,0,1755240
gyrAp,0.3333333333333333,2,2,CCTGGATAAGATTCACGCTG,0,1751366
gyrAp,0.3333333333333333,2,2,CCTGCTCCCGGTCTCAAAAC,0,1767199
gyrAp,0.3333333333333333,2,2,CCTGCGGGGCACGCCTAGCG,0,1767263
gyrAp,0.3333333333333333,2,2,CCTGATAAGGAGTTACTATG,0,1748636
gyrAp,0.3333333333333333,2,2,CCTCGGGGGCCACTGAAGGC,0,1768630
gyrAp,0.3333333333333333,2,2,CCTCCATAGCACGAGTCACA,0,1743324
gyrAp,0.3333333333333333,2,2,CCTACCCCCGTAAGGTCTTC,0,1761410
gyrAp,0.3333333333333333,2,2,CCGTGTGGCTGCGATATGAG,0,1759828
gyrAp,0.3333333333333333,2,2,CCGTGGTTCATAGCTGCCTT,0,1749850
gyrAp,0.3333333333333333,2,2,CCGGGGTCAATGAGACTTGC,0,1747224
gyrAp,0.3333333333333333,2,2,CCGCGAGACTACTTTACATC,0,1748807
gyrAp,0.3333333333333333,2,2,CCGATGCCAGTATCGGCCTC,0,1760982
gyrAp,0.3333333333333333,2,2,CCGAGCCACATTTAGCATAC,0,1763384
gyrAp,0.3333333333333333,2,2,CCGACTTGAACTGGAGGCTC,0,1764897
gyrAp,0.3333333333333333,2,2,CCGACGTCCGCCGTGGAATC,0,1757833
gyrAp,0.3333333333333333,2,2,CCGACGGCCTTACACAATTT,0,1748359
gyrAp,0.3333333333333333,2,2,CCCTTTCGCTAGGATTTTCC,0,1756890
gyrAp,0.3333333333333333,2,2,CCCTTTAATTTCTATACTGT,0,1742077
gyrAp,0.3333333333333333,2,2,CCCTGGCAGTGTAGTACGCT,0,1742758
gyrAp,0.3333333333333333,2,2,CCCTCATGGCAGCCAGGCAC,0,1753311
gyrAp,0.3333333333333333,2,2,CCCGTGCTAGGTTCCAGGGA,0,1755903
gyrAp,0.3333333333333333,2,2,CCCGTACTCGGAGGGCGATT,0,1767520
gyrAp,0.3333333333333333,2,2,CCCCTAAAGCGATATCCATG,0,1764524
gyrAp,0.3333333333333333,2,2,CCCCCGTGAATCATGGGTAA,0,1769760
gyrAp,0.3333333333333333,2,2,CCCCCGGCACAAACAAGCGG,0,1767418
gyrAp,0.3333333333333333,2,2,CCCCAGACAGTGCGGGAAAG,0,1765617
gyrAp,0.3333333333333333,2,2,CCCATGCGCTGACTTTCTAA,0,1765676
gyrAp,0.3333333333333333,2,2,CCCATCAACGCAAATCTCTA,0,1756879
gyrAp,0.3333333333333333,2,2,CCCACAAAGAGCTCAGTGGA,0,1755409
gyrAp,0.3333333333333333,2,2,CCCAAGCGTATGGATTACGT,0,1760338
gyrAp,0.3333333333333333,2,2,CCATTTACTGCATACTTTTA,0,1765160
gyrAp,0.3333333333333333,2,2,CCATGCAGTTACGCGGCTGT,0,1745644
gyrAp,0.3333333333333333,2,2,CCATGCACGTTGGATTCACC,0,1757252
gyrAp,0.3333333333333333,2,2,CCATCCCGCGTTTATTATAT,0,1768870
gyrAp,0.3333333333333333,2,2,CCATATATACTTTCCGTAGT,0,1767290
gyrAp,0.3333333333333333,2,2,CCAGTACATATCAGACGCGG,0,1744306
gyrAp,0.3333333333333333,2,2,CCAGGCCGGGTTCAAATTGC,0,1746151
gyrAp,0.3333333333333333,2,2,CCACGCCCTGACTCGCAAGA,0,1756669
gyrAp,0.3333333333333333,2,2,CCACAACGTGTGCTTGAGAT,0,1767886
gyrAp,0.3333333333333333,2,2,CCAATCTCACATGCACTGGT,0,1752586
gyrAp,0.3333333333333333,2,2,CCAAGTGCCACCGCGCGAGG,0,1746141
gyrAp,0.3333333333333333,2,2,CATTTGTGACACCTGAGTGT,0,1770184
gyrAp,0.3333333333333333,2,2,CATTTCAGTTTTTCCGCTAC,0,1741653
gyrAp,0.3333333333333333,2,2,CATTTAGCTGACGTACGACT,0,1744678
gyrAp,0.3333333333333333,2,2,CATTGTAGTCGTCGTTTTGT,0,1756970
gyrAp,0.3333333333333333,2,2,CATTACATGGGTACAAGGGG,0,1753860
gyrAp,0.3333333333333333,2,2,CATGGAGCTAACGCAATATC,0,1761501
gyrAp,0.3333333333333333,2,2,CATGAAGAACTAAGCATAAG,0,1747177
gyrAp,0.3333333333333333,2,2,CATCTTGTAACACAATGAAT,0,1754313
gyrAp,0.3333333333333333,2,2,CATATACACCAACTTACGCG,0,1750646
gyrAp,0.3333333333333333,2,2,CATAGCGCGGTACGTAAGCT,0,1747356
gyrAp,0.3333333333333333,2,2,CATAATGTCTAAAAAGTCCA,0,1758242
gyrAp,0.3333333333333333,2,2,CATAACGCGTCTTGACGGTG,0,1753891
gyrAp,0.3333333333333333,2,2,CAGTCAAATTTGCTATACAG,0,1751309
gyrAp,0.3333333333333333,2,2,CAGTACAAAATAAAGGAACC,0,1764626
gyrAp,0.3333333333333333,2,2,CAGGCGGTATGTTGGCGCGT,0,1748824
gyrAp,0.3333333333333333,2,2,CAGGCGCCCCCTTAATGTCT,0,1759617
gyrAp,0.3333333333333333,2,2,CAGGCATGTCATCAAGTACA,0,1755756
gyrAp,0.3333333333333333,2,2,CAGCTTTTTGCCCCGACATA,0,1750205
gyrAp,0.3333333333333333,2,2,CAGATAAGCTGCTCTACGGT,0,1746392
gyrAp,0.3333333333333333,2,2,CAGAGACTGGTGGATCAGTT,0,1756719
gyrAp,0.3333333333333333,2,2,CAGAACGACAGTTGCTACAA,0,1744734
gyrAp,0.3333333333333333,2,2,CACTTGTTCGTGACAGGACG,0,1755721
gyrAp,0.3333333333333333,2,2,CACTTAACTCAAAGCTTAAA,0,1752820
gyrAp,0.3333333333333333,2,2,CACTGGTCCGTGAGGTGTCC,0,1752073
gyrAp,0.3333333333333333,2,2,CACTCTGGGCAACCACTCAT,0,1766699
gyrAp,0.3333333333333333,2,2,CACTCCAGTCTGAGCCGAAC,0,1743020
gyrAp,0.3333333333333333,2,2,CACTACCTTTGGAGGTTCGA,0,1759882
gyrAp,0.3333333333333333,2,2,CACGTTCATGTGGTGTTTAG,0,1743523
gyrAp,0.3333333333333333,2,2,CACGTGCTGTCGAACAGCAA,0,1752419
gyrAp,0.3333333333333333,2,2,CACGCTCAGACTCTAGCACT,0,1768341
gyrAp,0.3333333333333333,2,2,CACGAGCTCTAGAGGTGAGT,0,1755423
gyrAp,0.3333333333333333,2,2,CACCAACATGCGTTTGTTAT,0,1753066
gyrAp,0.3333333333333333,2,2,CACATACAGGAGTTACCTGC,0,1752622
gyrAp,0.3333333333333333,2,2,CACAATTTCTCTAGCAGAGC,0,1751803
gyrAp,0.3333333333333333,2,2,CAATCCCTGGGTGGCAGTTA,0,1741720
gyrAp,0.3333333333333333,2,2,CAAGCTTGCTCGGGTATTCT,0,1766126
gyrAp,0.3333333333333333,2,2,CAAGCTGTGAAAAACTCGTC,0,1765359
gyrAp,0.3333333333333333,2,2,CAAGCAGCTTAGGCTACTAC,0,1752647
gyrAp,0.3333333333333333,2,2,CAAGAGATGGTAAGCCGGGA,0,1758697
gyrAp,0.3333333333333333,2,2,CAACTTACGTCTCGATAATC,0,1750127
gyrAp,0.3333333333333333,2,2,CAAATAGGTAGCAGTTGGGT,0,1749930
gyrAp,0.3333333333333333,2,2,ATTTTCTGTAACCTCATCTG,0,1759104
gyrAp,0.3333333333333333,2,2,ATTTGACGATTAACAACTTA,0,1768301
gyrAp,0.3333333333333333,2,2,ATTTCACGCATCTCGATCCC,0,1744972
gyrAp,0.3333333333333333,2,2,ATTGGCCGGTTTACGGGGGG,0,1764599
gyrAp,0.3333333333333333,2,2,ATTGCGTGATATGCGAGCGT,0,1759909
gyrAp,0.3333333333333333,2,2,ATTGCCTCTAGCGCCAGATG,0,1756837
gyrAp,0.3333333333333333,2,2,ATTGATATTGTATTCTCCTA,0,1763142
gyrAp,0.3333333333333333,2,2,ATTCCTGCAAATCAGTCACA,0,1754394
gyrAp,0.3333333333333333,2,2,ATTCAGTGAACCCCCTTTCA,0,1744025
gyrAp,0.3333333333333333,2,2,ATTAGTACCAGATTTTACCT,0,1755394
gyrAp,0.3333333333333333,2,2,ATTACCGCGCTGAAACGTGA,0,1756725
gyrAp,0.3333333333333333,2,2,ATTAAGTTGGTGTCGAGCTA,0,1768423
gyrAp,0.3333333333333333,2,2,ATTAAGATTTCGAAATTCAG,0,1755282
gyrAp,0.3333333333333333,2,2,ATTAAAGCAAACGTATCGGT,0,1748473
gyrAp,0.3333333333333333,2,2,ATGTTAGAAGAGGCTGGTCG,0,1747572
gyrAp,0.3333333333333333,2,2,ATGGCTGACCTAGCGGAGCC,0,1768394
gyrAp,0.3333333333333333,2,2,ATGCTGTCCGTTCGAGCAAG,0,1742774
gyrAp,0.3333333333333333,2,2,ATGCATCCAAGATGAGTCAG,0,1750678
gyrAp,0.3333333333333333,2,2,ATCTGTAGGAAAAACGACGT,0,1748017
gyrAp,0.3333333333333333,2,2,ATCTGGTCAATCAGAGACTT,0,1743393
gyrAp,0.3333333333333333,2,2,ATCTACGTCCAAATTAGCGG,0,1753111
gyrAp,0.3333333333333333,2,2,ATCGCTCTTTCATTAGACGC,0,1743972
gyrAp,0.3333333333333333,2,2,ATCGCGGGATTATGCTCGAT,0,1751300
gyrAp,0.3333333333333333,2,2,ATCCGGCGGAATCTTGTTTA,0,1759884
gyrAp,0.3333333333333333,2,2,ATCCCTAGACATAATTTTTT,0,1753013
gyrAp,0.3333333333333333,2,2,ATCCCCTACTTTTCTCTAGA,0,1746892
gyrAp,0.3333333333333333,2,2,ATCATCCGCCAACCTCGTGT,0,1764428
gyrAp,0.3333333333333333,2,2,ATCAGGCGTAATAGCGGTCC,0,1752909
gyrAp,0.3333333333333333,2,2,ATATTGGACTCACAGTCGAG,0,1749931
gyrAp,0.3333333333333333,2,2,ATATTAGGTGGAGTCTACAG,0,1769322
gyrAp,0.3333333333333333,2,2,ATATGGGTCTCGCGTTATTC,0,1742600
gyrAp,0.3333333333333333,2,2,ATATGCCCCGCCAGGAAGTC,0,1746530
gyrAp,0.3333333333333333,2,2,ATATCATCGTACAGTATGAA,0,1746876
gyrAp,0.3333333333333333,2,2,ATATACCCCCCGAGCATAAC,0,1762214
gyrAp,0.3333333333333333,2,2,ATACGAAGTACCCCGGACCA,0,1754732
gyrAp,0.3333333333333333,2,2,ATAATCGTCGCTGAGTCAGC,0,1758158
gyrAp,0.3333333333333333,2,2,ATAAGTCTTTAGGAGGCGAT,0,1750651
gyrAp,0.3333333333333333,2,2,ATAAGCTTACCAGCCCATTA,0,1750595
gyrAp,0.3333333333333333,2,2,AGTGTGCACATTCTTCGATT,0,1768452
gyrAp,0.3333333333333333,2,2,AGTGCACATGTGCCGGGTCT,0,1769415
gyrAp,0.3333333333333333,2,2,AGTGATTCCGGCTCTCCGTT,0,1760011
gyrAp,0.3333333333333333,2,2,AGTACAATACTTATGGGTCG,0,1742577
gyrAp,0.3333333333333333,2,2,AGTAAGAAGCAACTGCGTTT,0,1757566
gyrAp,0.3333333333333333,2,2,AGTAACTGTATATTTTGGGT,0,1746330
gyrAp,0.3333333333333333,2,2,AGGTAGGAACTCTGTATACT,0,1766673
gyrAp,0.3333333333333333,2,2,AGGGGTTCTGTTAAATTATA,0,1768910
gyrAp,0.3333333333333333,2,2,AGGGAATTACCGGGGGTTGG,0,1754276
gyrAp,0.3333333333333333,2,2,AGGGAACGAACGAGCTCACA,0,1744607
gyrAp,0.3333333333333333,2,2,AGGCTCTTACGACGATCCCG,0,1751337
gyrAp,0.3333333333333333,2,2,AGGCACATAGACGACCTTGA,0,1766718
gyrAp,0.3333333333333333,2,2,AGGAGGCTTTCACCTGCTGC,0,1760968
gyrAp,0.3333333333333333,2,2,AGGAACTAGCTGTTCCGTTG,0,1744692
gyrAp,0.3333333333333333,2,2,AGCTTCGCTAGCGTCGTTGT,0,1757581
gyrAp,0.3333333333333333,2,2,AGCTTAGGGCCAGGAGTGGG,0,1760663
gyrAp,0.3333333333333333,2,2,AGCTCACGTAAGCTGCCAGT,0,1754333
gyrAp,0.3333333333333333,2,2,AGCCTTGCTCGTCTATTGAA,0,1767603
gyrAp,0.3333333333333333,2,2,AGCCAAAGTGCGGCGGGGTC,0,1761047
gyrAp,0.3333333333333333,2,2,AGCATTCTTTCTTATCAGGA,0,1755355
gyrAp,0.3333333333333333,2,2,AGCAGGGTGTTATGCAACGC,0,1770130
gyrAp,0.3333333333333333,2,2,AGCAGACTTTCTCTCTTTTG,0,1747548
gyrAp,0.3333333333333333,2,2,AGATGGTCTCGGCTAACTTT,0,1751978
gyrAp,0.3333333333333333,2,2,AGATGCAATTTACACATGTC,0,1752094
gyrAp,0.3333333333333333,2,2,AGATGAAATAAAGCACACAC,0,1769842
gyrAp,0.3333333333333333,2,2,AGACTTTACCACCCCCCTAC,0,1764011
gyrAp,0.3333333333333333,2,2,AGACTTCACGTGCAAAAGTA,0,1769193
gyrAp,0.3333333333333333,2,2,AGACCGGTCGCAATTCGAGT,0,1742070
gyrAp,0.3333333333333333,2,2,AGACCGGCGTGAGTGGGTCT,0,1762213
gyrAp,0.3333333333333333,2,2,AGACCGAAAGTAGCAAACGG,0,1757779
gyrAp,0.3333333333333333,2,2,AGACCCCGACCAACACTTTT,0,1757852
gyrAp,0.3333333333333333,2,2,AGAATTCCGAACATGCCAGA,0,1752955
gyrAp,0.3333333333333333,2,2,AGAAGAGTTCCTCGGTTACC,0,1757375
gyrAp,0.3333333333333333,2,2,ACTTCATTGGGCCAGTATAA,0,1747292
gyrAp,0.3333333333333333,2,2,ACTTCACCGTCGCACTGGGA,0,1765250
gyrAp,0.3333333333333333,2,2,ACTTAGATCTGTCCAAGGAA,0,1747020
gyrAp,0.3333333333333333,2,2,ACTGGTGTATGCTCGCCCGT,0,1764976
gyrAp,0.3333333333333333,2,2,ACTGGCGCTTATGATCCGTC,0,1742437
gyrAp,0.3333333333333333,2,2,ACTGGCAGGGGATCAGGACG,0,1765136
gyrAp,0.3333333333333333,2,2,ACTGGAGAAAAGAATAGGCT,0,1760469
gyrAp,0.3333333333333333,2,2,ACTGCCTGTGCAATTGGTGG,0,1746350
gyrAp,0.3333333333333333,2,2,ACTCAGATCAGCTGATGGAA,0,1766756
gyrAp,0.3333333333333333,2,2,ACTCACAGACGGCGGAGAGG,0,1750418
gyrAp,0.3333333333333333,2,2,ACTACGACTCCTTGCAGCGG,0,1759589
gyrAp,0.3333333333333333,2,2,ACTAAGTCCTTTTCCAACAA,0,1762013
gyrAp,0.3333333333333333,2,2,ACGTTGATTACTAACCATAT,0,1770670
gyrAp,0.3333333333333333,2,2,ACGTTAACTGTGTTTAATTC,0,1746667
gyrAp,0.3333333333333333,2,2,ACGTGTGTATGCGGGAAGGC,0,1764977
gyrAp,0.3333333333333333,2,2,ACGTGCAGGCTAAGAATGTG,0,1765415
gyrAp,0.3333333333333333,2,2,ACGGTCTTTATGTGTACAAT,0,1748655
gyrAp,0.3333333333333333,2,2,ACGGTCTCGGAATCTGCCTG,0,1751241
gyrAp,0.3333333333333333,2,2,ACGGGTTGAGCAAGCAGTAC,0,1761802
gyrAp,0.3333333333333333,2,2,ACGGGCCGGGCGGCCTCGGT,0,1754425
gyrAp,0.3333333333333333,2,2,ACGGGAAGCGGCGTGAGTAA,0,1741762
gyrAp,0.3333333333333333,2,2,ACGGCAGCAACCGCGGCTTA,0,1757293
gyrAp,0.3333333333333333,2,2,ACGGACGGTCAAGTCGTAGT,0,1749375
gyrAp,0.3333333333333333,2,2,ACGCGCCAGACGGTCAGATG,0,1751360
gyrAp,0.3333333333333333,2,2,ACGCGATGCGGCTTATACCC,0,1753960
gyrAp,0.3333333333333333,2,2,ACGCCGCCCCAACATCGATG,0,1753809
gyrAp,0.3333333333333333,2,2,ACGATAACTAATTAGTGACA,0,1750304
gyrAp,0.3333333333333333,2,2,ACGACTGTCTTAAGTCGGAC,0,1759124
gyrAp,0.3333333333333333,2,2,ACGAACGCACGTCACATTAT,0,1755226
gyrAp,0.3333333333333333,2,2,ACCTTTTTGATAGCGTCGTT,0,1755185
gyrAp,0.3333333333333333,2,2,ACCTTGCCTAAGAGGATGAC,0,1761844
gyrAp,0.3333333333333333,2,2,ACCTACCCACAACAGTTGAG,0,1743059
gyrAp,0.3333333333333333,2,2,ACCGTCATGCGAGGAACTAT,0,1742920
gyrAp,0.3333333333333333,2,2,ACCGCTTTTTAGAACGACGC,0,1747327
gyrAp,0.3333333333333333,2,2,ACCCCGTCGCTTTGTATACA,0,1743883
gyrAp,0.3333333333333333,2,2,ACCCCAGTTAGTTCTCAGGT,0,1743401
gyrAp,0.3333333333333333,2,2,ACCAGGTTAAAATGGGTTAT,0,1753012
gyrAp,0.3333333333333333,2,2,ACCAGGGTTCGGGTTGATCT,0,1763986
gyrAp,0.3333333333333333,2,2,ACCAGAGTATATAACATGAG,0,1762548
gyrAp,0.3333333333333333,2,2,ACATTCCGTAGCCGTCTATT,0,1767494
gyrAp,0.3333333333333333,2,2,ACAGGGGCAGCGCTTAGACG,0,1745763
gyrAp,0.3333333333333333,2,2,ACAGGCAGCATAACGCAAAG,0,1764916
gyrAp,0.3333333333333333,2,2,ACAGCTTTGTGAAAAACGAA,0,1757858
gyrAp,0.3333333333333333,2,2,ACAGCGGTAAGGGGCCTGTG,0,1750717
gyrAp,0.3333333333333333,2,2,ACACTACCTCACTCCGGTCG,0,1768554
gyrAp,0.3333333333333333,2,2,ACACCATACACCGCGGTTGC,0,1760337
gyrAp,0.3333333333333333,2,2,ACAAAGAACACAGTTTTCTT,0,1760738
gyrAp,0.3333333333333333,2,2,AATTAGGAGCTCGTAACAGT,0,1753163
gyrAp,0.3333333333333333,2,2,AATGGGTCGGTCGGTCCGCG,0,1749208
gyrAp,0.3333333333333333,2,2,AATGATAAACTTCAATCTCT,0,1760354
gyrAp,0.3333333333333333,2,2,AATGAGTACTATGGCTCATC,0,1749207
gyrAp,0.3333333333333333,2,2,AATCGTCATGTGCGTCTCTA,0,1759545
gyrAp,0.3333333333333333,2,2,AATAGCGAAAATGAGCGCTA,0,1747257
gyrAp,0.3333333333333333,2,2,AAGTTACTACTTGGAAAGGC,0,1744188
gyrAp,0.3333333333333333,2,2,AAGTGCGCGATTGTACTCGA,0,1762497
gyrAp,0.3333333333333333,2,2,AAGTGCCCTTTCCTTGAATG,0,1745322
gyrAp,0.3333333333333333,2,2,AAGTCGGGGCGGGATCCTTA,0,1743156
gyrAp,0.3333333333333333,2,2,AAGTCCAGATATTCCCTGCA,0,1769021
gyrAp,0.3333333333333333,2,2,AAGGTAACCCTATTTTTTTC,0,1754122
gyrAp,0.3333333333333333,2,2,AAGGGTTGGATACACGTGGA,0,1748752
gyrAp,0.3333333333333333,2,2,AAGGGTGCCCCAATATTGAA,0,1754539
gyrAp,0.3333333333333333,2,2,AAGGGGGGCGGCAGCGTTGC,0,1768373
gyrAp,0.3333333333333333,2,2,AAGGGACCTCGCAAGCCTAG,0,1755648
gyrAp,0.3333333333333333,2,2,AAGGCACGAGTTAAACGTCG,0,1768718
gyrAp,0.3333333333333333,2,2,AAGCTGTTTACCACCACGTA,0,1765608
gyrAp,0.3333333333333333,2,2,AAGCGATTGGGTTCCCCCCC,0,1764852
gyrAp,0.3333333333333333,2,2,AAGACCGGAACGGTGTGGTT,0,1763226
gyrAp,0.3333333333333333,2,2,AACTGATTAGATAATAACCT,0,1749115
gyrAp,0.3333333333333333,2,2,AACTGAAAATCCCCACCCTC,0,1766773
gyrAp,0.3333333333333333,2,2,AACGCAGATGTTGGAACGAT,0,1741879
gyrAp,0.3333333333333333,2,2,AACCTTTATCGCGCACTGTA,0,1760873
gyrAp,0.3333333333333333,2,2,AACCTGTTTGCTAGGTTCAG,0,1749166
gyrAp,0.3333333333333333,2,2,AACCTGGGAGGTCTGAACTG,0,1763766
gyrAp,0.3333333333333333,2,2,AACATTCGAATGTCTATTCT,0,1748303
gyrAp,0.3333333333333333,2,2,AACAAAAGCATTAATCAGGT,0,1762210
gyrAp,0.3333333333333333,2,2,AAATTTAGAGCGGATGCGCT,0,1754159
gyrAp,0.3333333333333333,2,2,AAATGAGTAAGCTTGTTGCG,0,1743603
gyrAp,0.3333333333333333,2,2,AAATCGGTTTTTAAACGAAT,0,1748666
gyrAp,0.3333333333333333,2,2,AAATATGAGGTCTCATCCCA,0,1749716
gyrAp,0.3333333333333333,2,2,AAATATAGCGTATTCCAGCT,0,1747170
gyrAp,0.3333333333333333,2,2,AAAGTGATTGATTGCTGCGA,0,1747156
gyrAp,0.3333333333333333,2,2,AAAGGGACGGGCGTAAGAAG,0,1743077
gyrAp,0.3333333333333333,2,2,AAAGCTTGCCAACAATGAGT,0,1770002
gyrAp,0.3333333333333333,2,2,AAAGCGCGAGAGTGGCAAAC,0,1744813
gyrAp,0.3333333333333333,2,2,AAACAGTCACTCTTGTTAAT,0,1763536
gyrAp,0.3333333333333333,2,2,AAAAGTCCTTCCGTACCCCC,0,1744460
gyrAp,0.3333333333333333,2,2,AAAACCACGATATATTTCAC,0,1759345
gyrAp,0.5,1,1,TTTTTCGGGCTTGATGGTGG,0,1766316
gyrAp,0.5,1,1,TTTTCCGGTCGCTGTGTCTA,0,1763651
gyrAp,0.5,1,1,TTTGTCGTTCAATGCATTGT,0,1757079
gyrAp,0.5,1,1,TTTGTCCCTATTCCTAGTTG,0,1766306
gyrAp,0.5,1,1,TTTGTCCATTCCCACTGCAC,0,1747340
gyrAp,0.5,1,1,TTTGGCCGATATCGGAATAC,0,1753654
gyrAp,0.5,1,1,TTTGCCCCGGGGCAGTCCAG,0,1766902
gyrAp,0.5,1,1,TTTGATAACGATGCATCCTA,0,1766904
gyrAp,0.5,1,1,TTTGAGAGATGCCGTCTGTC,0,1762287
gyrAp,0.5,1,1,TTTGACAGCCCTTTGGTGTC,0,1770233
gyrAp,0.5,1,1,TTTGACACTTGCGTCTACCA,0,1749778
gyrAp,0.5,1,1,TTTCTTGATAGCCGCGTTAA,0,1765730
gyrAp,0.5,1,1,TTTCAGTAGGGGTCCACATG,0,1752367
gyrAp,0.5,1,1,TTTATGGGCAGTATGGCCGG,0,1742134
gyrAp,0.5,1,1,TTTAGCTCAAAATCTAACAC,0,1767979
gyrAp,0.5,1,1,TTTAGAAATGATATAATCAG,0,1752600
gyrAp,0.5,1,1,TTTACTCGCCATGCTTTCAA,0,1751717
gyrAp,0.5,1,1,TTTACCAAAATCGGTGAACA,0,1760817
gyrAp,0.5,1,1,TTTACAGCTACAAGGGCGCG,0,1760066
gyrAp,0.5,1,1,TTGTGACCGCAGGCTCCACT,0,1742855
gyrAp,0.5,1,1,TTGTCAGCTACGGGAAACTT,0,1761942
gyrAp,0.5,1,1,TTGGTTGGGGGTAAGACTGC,0,1759999
gyrAp,0.5,1,1,TTGGGTTCTCAGGTTCATTG,0,1759547
gyrAp,0.5,1,1,TTGGCTTCGGGAAACGTGAC,0,1769344
gyrAp,0.5,1,1,TTGGCAAGAAGGTATAGGAA,0,1767204
gyrAp,0.5,1,1,TTGGCAAACTGTTTTGTGAA,0,1749949
gyrAp,0.5,1,1,TTGGATCTTCTGTTTAGGAC,0,1760585
gyrAp,0.5,1,1,TTGATAGAGACTGTGATGAC,0,1764463
gyrAp,0.5,1,1,TTGAGTTATCTTAAATGCAT,0,1762107
gyrAp,0.5,1,1,TTGACTATCACCAAGGTATA,0,1752154
gyrAp,0.5,1,1,TTGACGGCGGGGTGCTGCAT,0,1752113
gyrAp,0.5,1,1,TTGAATTTCAAGAACTCTAT,0,1747747
gyrAp,0.5,1,1,TTCTTATTTTCACTGCTGCA,0,1742360
gyrAp,0.5,1,1,TTCTTACGGTCGGCAACTCA,0,1747874
gyrAp,0.5,1,1,TTCTGCCCAGCGCCTGAATT,0,1762587
gyrAp,0.5,1,1,TTCTGCATCCTATAGTCCCT,0,1753261
gyrAp,0.5,1,1,TTCTCTCTCCTTGTAAATGA,0,1742975
gyrAp,0.5,1,1,TTCGTACCATACTCATGTAG,0,1769272
gyrAp,0.5,1,1,TTCGTACACGCAACCGTGGC,0,1757815
gyrAp,0.5,1,1,TTCGGCCGAAGGCTATTTAA,0,1745834
gyrAp,0.5,1,1,TTCGCGGCTGCCGCCCGGTC,0,1752279
gyrAp,0.5,1,1,TTCCTAATTAGCCAGCCGGA,0,1744421
gyrAp,0.5,1,1,TTCCATAGAATCTAGTGTCG,0,1748519
gyrAp,0.5,1,1,TTCCAGTAGCCATACATAAA,0,1764538
gyrAp,0.5,1,1,TTCAGGGGTCTCGGGGATGT,0,1748825
gyrAp,0.5,1,1,TTCAGGGCCATGGAACAAAT,0,1766071
gyrAp,0.5,1,1,TTCACGTGGGAACTCTGTGG,0,1758829
gyrAp,0.5,1,1,TTCACCGGCAGTTAGCCTGC,0,1761139
gyrAp,0.5,1,1,TTCACCATCAGGTGGTCTCT,0,1768669
gyrAp,0.5,1,1,TTATTCCCGCAGCGACGTAA,0,1750957
gyrAp,0.5,1,1,TTATAAATCTATACTCGAGT,0,1744688
gyrAp,0.5,1,1,TTAGGGATCAGAGCTCGCCG,0,1745621
gyrAp,0.5,1,1,TTACTTTGTTGGGTTATTGT,0,1767717
gyrAp,0.5,1,1,TTACGGTTCACGGAATCAAG,0,1749987
gyrAp,0.5,1,1,TTACGGGCCGGGCAGTCACA,0,1764233
gyrAp,0.5,1,1,TTACCACTTTAATAGCGAAC,0,1769836
gyrAp,0.5,1,1,TTACAGTCTAATATTGACGG,0,1758800
gyrAp,0.5,1,1,TTAATTAACCCTGGAGGGCC,0,1761717
gyrAp,0.5,1,1,TTAAAACATCTCCCTCCGCA,0,1760135
gyrAp,0.5,1,1,TGTTTTCTCGTTTACTGATA,0,1766108
gyrAp,0.5,1,1,TGTTTGCATAAATGACCAAT,0,1757519
gyrAp,0.5,1,1,TGTTCGGACGACACGTCACC,0,1757648
gyrAp,0.5,1,1,TGTTATACATCCCTGAAGGC,0,1765247
gyrAp,0.5,1,1,TGTGTTTGAAGGTCGGAGGT,0,1743815
gyrAp,0.5,1,1,TGTGAGGAACATCAATGTTA,0,1766228
gyrAp,0.5,1,1,TGTCTTTTAGTATAGCGGTT,0,1743670
gyrAp,0.5,1,1,TGTATGAACAGAAAGTTGAC,0,1747021
gyrAp,0.5,1,1,TGTATAAGAGAGCGCGCATT,0,1749683
gyrAp,0.5,1,1,TGGTTCCGCATTTAAGTTCA,0,1752588
gyrAp,0.5,1,1,TGGTGGCAATGCGGACTGAA,0,1757158
gyrAp,0.5,1,1,TGGTCTGGCATTGCGAGCAG,0,1759387
gyrAp,0.5,1,1,TGGTCTAGGTTTCACCTATC,0,1745388
gyrAp,0.5,1,1,TGGTCCACGGCAATTGAAAT,0,1747351
gyrAp,0.5,1,1,TGGTATGGTGAATTCCCGGA,0,1751422
gyrAp,0.5,1,1,TGGTAGGAATCGAGTAAATA,0,1741700
gyrAp,0.5,1,1,TGGGTGGATTTTTATGAGCC,0,1761391
gyrAp,0.5,1,1,TGGGGTAACCGACCGTTGTG,0,1760486
gyrAp,0.5,1,1,TGGGGGCTTCCGTTTTGCGA,0,1747004
gyrAp,0.5,1,1,TGGGGCCGCTCGGCGGCTTG,0,1746586
gyrAp,0.5,1,1,TGGGGCATGCTTCGGTATGT,0,1751845
gyrAp,0.5,1,1,TGGGCTGGCCAGTTCATAAA,0,1744253
gyrAp,0.5,1,1,TGGGCGTTAAGGGCTGACGT,0,1756597
gyrAp,0.5,1,1,TGGGACTGCTTGTGTTGGTT,0,1767604
gyrAp,0.5,1,1,TGGCTGTGAATTTCCACTCC,0,1766906
gyrAp,0.5,1,1,TGGCTGCTCAGCTCGAAATC,0,1749927
gyrAp,0.5,1,1,TGGCCTCGGACGAGTCTCAC,0,1742882
gyrAp,0.5,1,1,TGGATGGCCGTCGGTATAGC,0,1769865
gyrAp,0.5,1,1,TGGACCTTGTTTAGCATCCC,0,1755542
gyrAp,0.5,1,1,TGCTTTATCCTACTCGGGGA,0,1749856
gyrAp,0.5,1,1,TGCTGTAAGTTTAGACAAGA,0,1741770
gyrAp,0.5,1,1,TGCTCTCTGTGAGTCAGCCT,0,1759580
gyrAp,0.5,1,1,TGCTACCTGACTTTTTGTGA,0,1755790
gyrAp,0.5,1,1,TGCGTATGTCTAACTAAACC,0,1762327
gyrAp,0.5,1,1,TGCGTATGCTTGTAGGTCTC,0,1758036
gyrAp,0.5,1,1,TGCGTAGGCAGAATTTTTTA,0,1757738
gyrAp,0.5,1,1,TGCGGAGACTGACGGGTATT,0,1743553
gyrAp,0.5,1,1,TGCGCGAGGAGATGGTCAGC,0,1769864
gyrAp,0.5,1,1,TGCGAGGGCACCGTGGAGAT,0,1756936
gyrAp,0.5,1,1,TGCCTTATCGTCGGCATAGG,0,1757143
gyrAp,0.5,1,1,TGCCTGTGAGACCATAGCCA,0,1745203
gyrAp,0.5,1,1,TGCCTGGATCGTGCCGCCCA,0,1748818
gyrAp,0.5,1,1,TGCCTGCCAAGTCCAAGCCC,0,1752925
gyrAp,0.5,1,1,TGCCGCCCTCCACGTAAAAA,0,1765125
gyrAp,0.5,1,1,TGCCCGAAGTCTCTGTAGAC,0,1761559
gyrAp,0.5,1,1,TGCCACTCCGAGTTAGCTAT,0,1759317
gyrAp,0.5,1,1,TGCATGAAGTGTCGGACGTG,0,1748514
gyrAp,0.5,1,1,TGATTAGATAGCGAAGCACT,0,1766459
gyrAp,0.5,1,1,TGATGGTCTGGTTCAAATAT,0,1755136
gyrAp,0.5,1,1,TGATCTTCTTATCACCCGCC,0,1743517
gyrAp,0.5,1,1,TGATAGGCTATTTACTACTG,0,1760949
gyrAp,0.5,1,1,TGAGGGCGTGAAAATGGTTG,0,1760592
gyrAp,0.5,1,1,TGAGGCTCAGTCGTTGGATG,0,1752911
gyrAp,0.5,1,1,TGAGCAGGCTCGAGGCTCCT,0,1761958
gyrAp,0.5,1,1,TGACTCGGCGCCGGTTTCGC,0,1752250
gyrAp,0.5,1,1,TGACTCCGATCTTTATCCAG,0,1768343
gyrAp,0.5,1,1,TGACGCAGCGACACAGGCTG,0,1766406
gyrAp,0.5,1,1,TGACGAAGTAGTGGAGGTTG,0,1760117
gyrAp,0.5,1,1,TGACCACCCGTTCCCGATTA,0,1765805
gyrAp,0.5,1,1,TGACATTCGGGCGCTTGACG,0,1754304
gyrAp,0.5,1,1,TGACAGCTAGCCTCTATATA,0,1755000
gyrAp,0.5,1,1,TGAATGGAAGGGCTGTACGT,0,1754795
gyrAp,0.5,1,1,TGAACGCTCCCATTTGACTT,0,1764889
gyrAp,0.5,1,1,TGAACCATGGATGGATAGAG,0,1761392
gyrAp,0.5,1,1,TGAAAGCTCTCGCTCTTTCT,0,1751184
gyrAp,0.5,1,1,TGAAACTAACGCCGGGGGAT,0,1744383
gyrAp,0.5,1,1,TCTTTGACCTTTTTAAAGTC,0,1759551
gyrAp,0.5,1,1,TCTTTCCCCTATACTGAAGT,0,1749633
gyrAp,0.5,1,1,TCTTGTGTTATTCCGCGCCG,0,1748250
gyrAp,0.5,1,1,TCTTGGCGGACCTGTGGTAT,0,1749191
gyrAp,0.5,1,1,TCTTGACATATGCCCCGCAA,0,1767257
gyrAp,0.5,1,1,TCTTAAGATCCTTCGCGGCG,0,1746756
gyrAp,0.5,1,1,TCTGTTTCGAACACACCGAT,0,1765253
gyrAp,0.5,1,1,TCTGTGCTGCGAAAATCAAG,0,1769294
gyrAp,0.5,1,1,TCTGGCGAATCCTTTTATGA,0,1757968
gyrAp,0.5,1,1,TCTGGCCATTCCTGGCGTGG,0,1765782
gyrAp,0.5,1,1,TCTGCTTGCTAGCATATCAG,0,1752081
gyrAp,0.5,1,1,TCTGAGTCGCGAGTGGCATC,0,1759057
gyrAp,0.5,1,1,TCTCTCGTCGGGACTTCCAA,0,1746561
gyrAp,0.5,1,1,TCTCGTGACTGTGAAAGTGA,0,1745076
gyrAp,0.5,1,1,TCTCGGAGGTCGGAATGGCG,0,1758891
gyrAp,0.5,1,1,TCTCGCCGGGTCTCCGTTCA,0,1746510
gyrAp,0.5,1,1,TCTAGTACATTTAGGAATAT,0,1755390
gyrAp,0.5,1,1,TCTAAGGGTGCTGTCATATG,0,1749939
gyrAp,0.5,1,1,TCTAACGCGGTAGCAGGCGG,0,1759585
gyrAp,0.5,1,1,TCGTTGTCAGGTGTACCCGT,0,1760391
gyrAp,0.5,1,1,TCGTTGCGGCGTCATCGATT,0,1753120
gyrAp,0.5,1,1,TCGTTCTCGTCTGTCATTAA,0,1757820
gyrAp,0.5,1,1,TCGTCATTGCCAGTCGGCGG,0,1756620
gyrAp,0.5,1,1,TCGTCAGAGGAGTCAGACGA,0,1766753
gyrAp,0.5,1,1,TCGTAGTCACAATATAGTGT,0,1769639
gyrAp,0.5,1,1,TCGGTTAAATCTAGACTTGG,0,1759597
gyrAp,0.5,1,1,TCGGGCAAATCACCACAGCG,0,1743249
gyrAp,0.5,1,1,TCGGCCGACAGAGTACAAGT,0,1750586
gyrAp,0.5,1,1,TCGGCAGAGCTGCAACCGTG,0,1758550
gyrAp,0.5,1,1,TCGGAAGAGGACGCAATTAT,0,1749041
gyrAp,0.5,1,1,TCGCTTACCGGGTTCAGTAA,0,1769211
gyrAp,0.5,1,1,TCGCTGGTGTTCGGCACGTT,0,1768545
gyrAp,0.5,1,1,TCGCTAGATTTCTACCGCAC,0,1742889
gyrAp,0.5,1,1,TCGCGTGGGGGTATGGCCCC,0,1746184
gyrAp,0.5,1,1,TCGCGATGATCTGCATATAG,0,1763292
gyrAp,0.5,1,1,TCGCCAGAGGAACAGCCAAG,0,1768604
gyrAp,0.5,1,1,TCGCAGTCAACGAGTCTGCT,0,1755764
gyrAp,0.5,1,1,TCGATTCGGAGCCTACTCGT,0,1753667
gyrAp,0.5,1,1,TCGAGCGGGTGCCCGCTGAC,0,1748544
gyrAp,0.5,1,1,TCGAGCCGGCTAGAACTATC,0,1755708
gyrAp,0.5,1,1,TCCTGTACGTATGTTCTTCG,0,1741539
gyrAp,0.5,1,1,TCCTGATCACTTTGACCTGG,0,1756898
gyrAp,0.5,1,1,TCCGTCAGGCAAGTCCTGAT,0,1770108
gyrAp,0.5,1,1,TCCGGCTAACTTTCCGGTGC,0,1764167
gyrAp,0.5,1,1,TCCGGAGCCGGGTAAAGAGA,0,1743063
gyrAp,0.5,1,1,TCCGCTTGGAAACGCGAGGA,0,1744346
gyrAp,0.5,1,1,TCCCGATCACAGATTGAGTA,0,1768224
gyrAp,0.5,1,1,TCCATCTAAGGGGGACTTCG,0,1744474
gyrAp,0.5,1,1,TCCAGGCAGAGTTGGGCGCA,0,1761069
gyrAp,0.5,1,1,TCCACGTCAGAAGTCTGCAC,0,1763393
gyrAp,0.5,1,1,TCATTGCCCTTTTGTTATCC,0,1756651
gyrAp,0.5,1,1,TCATTAGAGGTGATCCCTAT,0,1756846
gyrAp,0.5,1,1,TCATATGTTTTCTCTATGAC,0,1749339
gyrAp,0.5,1,1,TCAGTTTGCGCTCTTCTTAG,0,1747268
gyrAp,0.5,1,1,TCAGTCCAGTTCGGTCATAA,0,1750394
gyrAp,0.5,1,1,TCAGGTTATCCAATACCTTG,0,1751537
gyrAp,0.5,1,1,TCAGATCCCACATGTATTCT,0,1756229
gyrAp,0.5,1,1,TCAGAATGTAAGACAGAGTG,0,1760555
gyrAp,0.5,1,1,TCACTTACTAGACATGCATA,0,1742736
gyrAp,0.5,1,1,TCACTACAGTGACACGGGAA,0,1748495
gyrAp,0.5,1,1,TCACCCTCATAAATACCACC,0,1755716
gyrAp,0.5,1,1,TCACAGGTCTGTCAGGGGAT,0,1762475
gyrAp,0.5,1,1,TCAAGGCACGCGGAACCTGG,0,1752866
gyrAp,0.5,1,1,TCAACCCGGTCCGATACCGA,0,1743779
gyrAp,0.5,1,1,TCAAACCATACCGTGGTCGA,0,1762355
gyrAp,0.5,1,1,TATTTTACGGGGATGAGGGG,0,1751830
gyrAp,0.5,1,1,TATTTGACAAAACAGTAGAA,0,1742710
gyrAp,0.5,1,1,TATTCCCAGGCAGATAGTTT,0,1747915
gyrAp,0.5,1,1,TATTATTCCGCCCTATTCGA,0,1743881
gyrAp,0.5,1,1,TATTATGTGGTAAGGGTTTC,0,1747804
gyrAp,0.5,1,1,TATTAGCGAACACATGCTCA,0,1758704
gyrAp,0.5,1,1,TATGGGTCTGATAAGGGTTG,0,1753979
gyrAp,0.5,1,1,TATGGGACTCTGTATTTGGT,0,1758556
gyrAp,0.5,1,1,TATGGATCAGTTTCATACGT,0,1751334
gyrAp,0.5,1,1,TATGGAACGGATGGCAGACC,0,1755317
gyrAp,0.5,1,1,TATGCTATACCAGTTAATTG,0,1761238
gyrAp,0.5,1,1,TATCTTCCTAGAGACGAAAA,0,1762102
gyrAp,0.5,1,1,TATCTGAAGTGGGGCATTCG,0,1756873
gyrAp,0.5,1,1,TATCTCGGGATGGCTTCGCT,0,1758471
gyrAp,0.5,1,1,TATCGGTATTTAGATCGGGT,0,1765930
gyrAp,0.5,1,1,TATCGCGCAGACATTCATGC,0,1769690
gyrAp,0.5,1,1,TATCCCGTCTGCTGATGCCA,0,1754176
gyrAp,0.5,1,1,TATCCAGGGTACTACAGACC,0,1760220
gyrAp,0.5,1,1,TATATCACGAGACGAAGAGA,0,1744698
gyrAp,0.5,1,1,TATAGGAGACTGATAGTCTA,0,1759866
gyrAp,0.5,1,1,TAGTCATGGGGGCAGAGTCC,0,1753378
gyrAp,0.5,1,1,TAGGGATTGACCTGAACCTA,0,1758512
gyrAp,0.5,1,1,TAGGCTCTTATATGTTTTGC,0,1756718
gyrAp,0.5,1,1,TAGCGTATACTGATCCCGCG,0,1763946
gyrAp,0.5,1,1,TAGAAAGTGATAGAGTCTTC,0,1749414
gyrAp,0.5,1,1,TACTGGCTAAGAATTGCTGC,0,1754788
gyrAp,0.5,1,1,TACTACTTCAGCTCAAGGTT,0,1765762
gyrAp,0.5,1,1,TACTACTCGTCCCACCAAAT,0,1741987
gyrAp,0.5,1,1,TACTACTAGGTTTAACCAAT,0,1744559
gyrAp,0.5,1,1,TACTACAAAGGTCTGCTTTG,0,1747299
gyrAp,0.5,1,1,TACGTAAACTAGAAAACGAA,0,1742001
gyrAp,0.5,1,1,TACGAACGTACTCGTAGCAT,0,1748957
gyrAp,0.5,1,1,TACCTGCCCATCCCGACAGT,0,1760731
gyrAp,0.5,1,1,TACCGCATTAAAAACAGAAT,0,1759527
gyrAp,0.5,1,1,TACCCAGTTAGATTCTACAA,0,1769553
gyrAp,0.5,1,1,TACCACGGTTAGATCGGGTT,0,1769480
gyrAp,0.5,1,1,TACCAAAACTACACATGTAG,0,1747632
gyrAp,0.5,1,1,TAATTGCCATCACGTCGCGC,0,1747326
gyrAp,0.5,1,1,TAATAGGTCGGAGCACAGTA,0,1757673
gyrAp,0.5,1,1,TAATAATCATCCCGGAGATC,0,1749736
gyrAp,0.5,1,1,TAAGGAGCAATTCATCTGCT,0,1757890
gyrAp,0.5,1,1,TAAGAGCCTTTAAATCCATT,0,1750159
gyrAp,0.5,1,1,TAACTCACTTCTCAGGGACG,0,1750445
gyrAp,0.5,1,1,TAACGCGGAGTCTAGGAGGG,0,1749326
gyrAp,0.5,1,1,TAACAAGGGTCCGATATGTT,0,1756829
gyrAp,0.5,1,1,TAAATGCGGCTAGGTGTTAC,0,1748080
gyrAp,0.5,1,1,TAAACCGGATAGCCACCGCA,0,1754209
gyrAp,0.5,1,1,GTTTTTCCTTCCATTAGTCT,0,1749107
gyrAp,0.5,1,1,GTTTTGCGGACGTTGCGGGT,0,1742811
gyrAp,0.5,1,1,GTTTTACATTCGCGCATGGA,0,1752363
gyrAp,0.5,1,1,GTTTGTAACGATCCAGGGCG,0,1762702
gyrAp,0.5,1,1,GTTTGCCGCCTCCCTCTCAT,0,1742386
gyrAp,0.5,1,1,GTTTATTACTGATTGCTATA,0,1742664
gyrAp,0.5,1,1,GTTTATATGCTTCGGTACAA,0,1757888
gyrAp,0.5,1,1,GTTTAACTGATCTTTCTAGC,0,1750650
gyrAp,0.5,1,1,GTTGTTTGACCTCGAAGTAA,0,1756696
gyrAp,0.5,1,1,GTTGTGCATCGATGTGGCGG,0,1757884
gyrAp,0.5,1,1,GTTGTAGAGAGGCCTCCTGG,0,1745326
gyrAp,0.5,1,1,GTTCGGGCACAGGCCTTGTT,0,1758575
gyrAp,0.5,1,1,GTTCCAATCACCAGTCTAAC,0,1764776
gyrAp,0.5,1,1,GTTCATCGAACCCATCGTAA,0,1741699
gyrAp,0.5,1,1,GTTAGGTCACTAGCCTGGAT,0,1743888
gyrAp,0.5,1,1,GTTACTTCTTTCGGCGCACA,0,1743076
gyrAp,0.5,1,1,GTTACTGCTGAGAACTTGCA,0,1766867
gyrAp,0.5,1,1,GTTACCATATCGTCGCATCA,0,1760070
gyrAp,0.5,1,1,GTTAAGATCTGTGGTATCTC,0,1761759
gyrAp,0.5,1,1,GTTAAAGGGTGCCAGTCGGT,0,1762607
gyrAp,0.5,1,1,GTGTTCCTCCGCTTAACCTA,0,1766716
gyrAp,0.5,1,1,GTGTGCGTTTTCCCTTTGTT,0,1746889
gyrAp,0.5,1,1,GTGTGCGTCATGGCTTACTG,0,1764355
gyrAp,0.5,1,1,GTGTCAGGCGAGGTTGCACC,0,1763910
gyrAp,0.5,1,1,GTGTCACGATGGTAGACCTT,0,1760696
gyrAp,0.5,1,1,GTGGTTATCGATTTTCTACT,0,1741912
gyrAp,0.5,1,1,GTGGTCCAGTGCGTTTAACC,0,1757224
gyrAp,0.5,1,1,GTGGTAGTACGCGAGAGCCC,0,1757409
gyrAp,0.5,1,1,GTGGGCGTCCCCTTCATACT,0,1743232
gyrAp,0.5,1,1,GTGGGCGACGGGATTAGCTG,0,1766977
gyrAp,0.5,1,1,GTGGCCGGTGCGATTCCACT,0,1748059
gyrAp,0.5,1,1,GTGCTGATACTGGGACAGTT,0,1746719
gyrAp,0.5,1,1,GTGCGTGTATTTCATCCCAA,0,1754255
gyrAp,0.5,1,1,GTGCGAGCGCCGTCTGCTAC,0,1758404
gyrAp,0.5,1,1,GTGCGAGATCGCGACGAATG,0,1749892
gyrAp,0.5,1,1,GTGCCCCAACTACGGGAATA,0,1767375
gyrAp,0.5,1,1,GTGCCAGACTTCTCCATTCA,0,1766751
gyrAp,0.5,1,1,GTGCATAGTGCCTATCCTAT,0,1752642
gyrAp,0.5,1,1,GTGCAGGGGTATCAACGATT,0,1752434
gyrAp,0.5,1,1,GTGCAGGACCCCCATTCAAC,0,1749363
gyrAp,0.5,1,1,GTGCAAGAGCTAACAACCCT,0,1741718
gyrAp,0.5,1,1,GTGATCTCGGACATTGGTGG,0,1745462
gyrAp,0.5,1,1,GTGATCGCATTCAGGGATCT,0,1756223
gyrAp,0.5,1,1,GTGAATAGACAGCTCTTATT,0,1751399
gyrAp,0.5,1,1,GTGAAGCCATATCGTCGTAG,0,1758192
gyrAp,0.5,1,1,GTCTGTCTACGACCATCAGC,0,1758063
gyrAp,0.5,1,1,GTCGTATCTGTGCTGATTTG,0,1751121
gyrAp,0.5,1,1,GTCGTACAGACGTCATTCAT,0,1742248
gyrAp,0.5,1,1,GTCGGCTTTCGACTCTTTAT,0,1764243
gyrAp,0.5,1,1,GTCCTTCAAGGGCTATACGC,0,1753006
gyrAp,0.5,1,1,GTCCTGGTCTCCCATACGAG,0,1765663
gyrAp,0.5,1,1,GTCCTGGCGCATAAGGTACC,0,1741914
gyrAp,0.5,1,1,GTCCGCCAGGTAGTGCTCGC,0,1743238
gyrAp,0.5,1,1,GTCCAAGTGGGACTCAGAGG,0,1743556
gyrAp,0.5,1,1,GTCATTGGATCGTGGAAACG,0,1766561
gyrAp,0.5,1,1,GTCATTAATAATAGACTGCA,0,1750577
gyrAp,0.5,1,1,GTCATGGCCTGTGCAGACGT,0,1755391
gyrAp,0.5,1,1,GTCATCGGCCAGACGGGGAA,0,1745490
gyrAp,0.5,1,1,GTCAGGTCAGCCGCATATGG,0,1764754
gyrAp,0.5,1,1,GTCACAAAAGAACCACTGTG,0,1764589
gyrAp,0.5,1,1,GTCAATCACCATAACTTCGG,0,1759226
gyrAp,0.5,1,1,GTATTCCCGCTTTAGTGGTG,0,1759507
gyrAp,0.5,1,1,GTATTAATTGTGGTTGTGAA,0,1742667
gyrAp,0.5,1,1,GTATGCGACGAGTGCAAAAT,0,1757497
gyrAp,0.5,1,1,GTAGTGTGGGGGATCGGCCC,0,1755680
gyrAp,0.5,1,1,GTAGTGGATAGAGATCAAAC,0,1752631
gyrAp,0.5,1,1,GTAGTCGAGTTCCATGCTGT,0,1754521
gyrAp,0.5,1,1,GTAGTAAATGATGCAGGTAT,0,1755695
gyrAp,0.5,1,1,GTAGCGGCGTAGGGTACGTC,0,1764553
gyrAp,0.5,1,1,GTAGCGCCTCTCGAGTGCAG,0,1750477
gyrAp,0.5,1,1,GTAGAGCATTACTGCCTAGG,0,1754418
gyrAp,0.5,1,1,GTACTGTACCTGAATCCTCA,0,1746926
gyrAp,0.5,1,1,GTACTGAGGCCTTTTAATCC,0,1770916
gyrAp,0.5,1,1,GTACTCATCCACGCCGTCGT,0,1744041
gyrAp,0.5,1,1,GTACATTCTCTTACCCGTGG,0,1770070
gyrAp,0.5,1,1,GTAATATGGGGCCACGCCAC,0,1764326
gyrAp,0.5,1,1,GTAACCCCGTAGGAGTCAGC,0,1746048
gyrAp,0.5,1,1,GTAACAAATAGGTCAGAGCT,0,1746337
gyrAp,0.5,1,1,GTAAAGCCATCGTTGCCTTT,0,1757291
gyrAp,0.5,1,1,GGTTTTTCAAGCAAGCTACT,0,1754938
gyrAp,0.5,1,1,GGTTCGGCGCAATGAGCGTT,0,1754262
gyrAp,0.5,1,1,GGTTCGACTTAAACGGAGCC,0,1757748
gyrAp,0.5,1,1,GGTTACCGATACAGCCGCTG,0,1763566
gyrAp,0.5,1,1,GGTTACACTCGCGGCAAATA,0,1768412
gyrAp,0.5,1,1,GGTGTTTACCGTCAGACGAT,0,1765310
gyrAp,0.5,1,1,GGTGTCGAAAGTTCGAGGTC,0,1750415
gyrAp,0.5,1,1,GGTGTACTATCACGAAGGAA,0,1755583
gyrAp,0.5,1,1,GGTGGTACTTGGGTCTCCTC,0,1768735
gyrAp,0.5,1,1,GGTCGAGACCCATTATCGGG,0,1759115
gyrAp,0.5,1,1,GGTACCCGGACCTCCCGTGC,0,1752037
gyrAp,0.5,1,1,GGTAAGCTGAGGCCCGCAAA,0,1755464
gyrAp,0.5,1,1,GGTAACGGCCATGAATCGAA,0,1760185
gyrAp,0.5,1,1,GGGTTAACAAGTACAACAGT,0,1766300
gyrAp,0.5,1,1,GGGTCAGCCACAACGTAGGA,0,1761992
gyrAp,0.5,1,1,GGGTAGCAGAAAAGGTTAGC,0,1758078
gyrAp,0.5,1,1,GGGTAGATGGAGGTGGTCAT,0,1742484
gyrAp,0.5,1,1,GGGTAGAGCTCCCATTTAAT,0,1767846
gyrAp,0.5,1,1,GGGTAAAGAGAGTAGCACCT,0,1752736
gyrAp,0.5,1,1,GGGGGCAACCGGTAACGCTG,0,1769887
gyrAp,0.5,1,1,GGGCGAAGATTGCTGGCCAA,0,1743650
gyrAp,0.5,1,1,GGGCCAAACGTGCGATTGTT,0,1742408
gyrAp,0.5,1,1,GGGATGTGGGCCAAGTACAA,0,1768535
gyrAp,0.5,1,1,GGGAGTGGTACCCGTAAGTA,0,1763547
gyrAp,0.5,1,1,GGGAGGTCGCTAGCGGGCAT,0,1766447
gyrAp,0.5,1,1,GGGAGCCAGCTTTATGTGGA,0,1768694
gyrAp,0.5,1,1,GGGACGGCATTGGCCGGTAG,0,1748315
gyrAp,0.5,1,1,GGGAAATGTGACGTCATCGA,0,1742235
gyrAp,0.5,1,1,GGCTTGCGCAGCACGTGGAG,0,1749417
gyrAp,0.5,1,1,GGCTGCTGTAGGCTCGCCGA,0,1754017
gyrAp,0.5,1,1,GGCTGAGGGACTTTTACTCA,0,1765240
gyrAp,0.5,1,1,GGCTATGTGCAGATCTCAGG,0,1761569
gyrAp,0.5,1,1,GGCTAAGGCTTGATGATTCT,0,1742614
gyrAp,0.5,1,1,GGCGTACGCCTGACCCACTT,0,1760674
gyrAp,0.5,1,1,GGCGCACCAGCCATCAGGTA,0,1757736
gyrAp,0.5,1,1,GGCGCACACCGTGTTCTCGA,0,1743426
gyrAp,0.5,1,1,GGCGAGCTATCAGTAAATTA,0,1742696
gyrAp,0.5,1,1,GGCCATTCGAGGTATCCGGA,0,1747662
gyrAp,0.5,1,1,GGCCATCGACCTATAAAGGA,0,1746583
gyrAp,0.5,1,1,GGCCACTGAATAGGATATTC,0,1767331
gyrAp,0.5,1,1,GGCATCTTGGTGTCCGGGGG,0,1764311
gyrAp,0.5,1,1,GGCAGAAGAAGAGATCTCCG,0,1741661
gyrAp,0.5,1,1,GGCACCGAATGGGCTGGGTG,0,1744946
gyrAp,0.5,1,1,GGCAATGGATGCCGTACTTC,0,1748677
gyrAp,0.5,1,1,GGCAACCCTGTCTCACCTGG,0,1757754
gyrAp,0.5,1,1,GGCAACCAGGGTATTTGTTC,0,1750992
gyrAp,0.5,1,1,GGCAAACGTCCGAGGAGCCA,0,1742608
gyrAp,0.5,1,1,GGATTTTGGAGTCTGTGTTG,0,1768299
gyrAp,0.5,1,1,GGATTTGGTCCGCAACAAAA,0,1757312
gyrAp,0.5,1,1,GGATTCCGAAGGTCTGAAAT,0,1764477
gyrAp,0.5,1,1,GGATGTTTAGGCGTCATCTC,0,1748241
gyrAp,0.5,1,1,GGATCTACGAGTGGAGAGCA,0,1763228
gyrAp,0.5,1,1,GGATCGTGGGTAAGCTATCA,0,1744008
gyrAp,0.5,1,1,GGATCGCGCACCATTCCCGC,0,1742705
gyrAp,0.5,1,1,GGATATTACTCAACCGGCGC,0,1744266
gyrAp,0.5,1,1,GGAGGTGAGCGAGCGACGGT,0,1743756
gyrAp,0.5,1,1,GGAGGTAAAGGTACAACCGT,0,1766766
gyrAp,0.5,1,1,GGAGGATGGTGGAGACTTCT,0,1770406
gyrAp,0.5,1,1,GGAGATTGTCATATCAGACT,0,1767682
gyrAp,0.5,1,1,GGAGATCCTCTCAGAGAATC,0,1758479
gyrAp,0.5,1,1,GGAGAGTCTTCCTATGGGTG,0,1747346
gyrAp,0.5,1,1,GGAGACCTCACCTCGAAGAG,0,1748613
gyrAp,0.5,1,1,GGACTACGTAGGGTTTCTTG,0,1766818
gyrAp,0.5,1,1,GGACGGCAGTCTCTCGTGCA,0,1749184
gyrAp,0.5,1,1,GGACCTTCTGGTGCAATCCC,0,1751824
gyrAp,0.5,1,1,GGACCGTGTTGGTTATTCCC,0,1751947
gyrAp,0.5,1,1,GGACCAGGTGCGTACTGAGT,0,1761019
gyrAp,0.5,1,1,GGACACAAACTCTGTCACGT,0,1761515
gyrAp,0.5,1,1,GGAATGGAGGTGTCTTCGTC,0,1743078
gyrAp,0.5,1,1,GGAATGACTATATTGCGGAT,0,1741583
gyrAp,0.5,1,1,GGAATAAGATTCTCATCGTT,0,1760032
gyrAp,0.5,1,1,GGAAGCAGGTACGGTGTCCT,0,1762150
gyrAp,0.5,1,1,GGAAAGGTGGAACCCCTCTT,0,1750054
gyrAp,0.5,1,1,GGAAACGGTAGTGTTACAAC,0,1766878
gyrAp,0.5,1,1,GCTTTCTTTTGGAGACGATA,0,1763068
gyrAp,0.5,1,1,GCTTTAATTCCGGGGCGCGA,0,1765431
gyrAp,0.5,1,1,GCTTGTACTTAATGTAATGG,0,1761448
gyrAp,0.5,1,1,GCTTGGTGGCCCCGCTGGGA,0,1742804
gyrAp,0.5,1,1,GCTTGATCGCCGGACCGGTG,0,1749531
gyrAp,0.5,1,1,GCTTGATAGCTTAATTCAGA,0,1765183
gyrAp,0.5,1,1,GCTGTTCCGGAGCGGGAAGA,0,1762038
gyrAp,0.5,1,1,GCTGTGACCCGGAGCCAGCC,0,1762080
gyrAp,0.5,1,1,GCTGGCAAACCGTTCTTAAG,0,1752489
gyrAp,0.5,1,1,GCTGGAGATTAAGAAGTGGA,0,1759465
gyrAp,0.5,1,1,GCTCTTGTGCTAAAGTATGG,0,1745418
gyrAp,0.5,1,1,GCTCTAAAACCTACAAGTGG,0,1762768
gyrAp,0.5,1,1,GCTCGTATTTCAAGCCGGGT,0,1756340
gyrAp,0.5,1,1,GCTCGCTTCATCGTGTCAGG,0,1770316
gyrAp,0.5,1,1,GCTCCGTGCATAGCGCTAAA,0,1768212
gyrAp,0.5,1,1,GCTACGCTTAGTGTGGGTCA,0,1746324
gyrAp,0.5,1,1,GCTACATTCAAAGGCCGAGA,0,1745856
gyrAp,0.5,1,1,GCTAACGGCAAGGAACCTGC,0,1752696
gyrAp,0.5,1,1,GCGTTTACATACGGTCATTT,0,1742488
gyrAp,0.5,1,1,GCGTTCACGCATTGGACTTA,0,1747262
gyrAp,0.5,1,1,GCGTTATTCGGACGAATAAC,0,1752744
gyrAp,0.5,1,1,GCGTGCTAAGTTAACGGCCA,0,1765155
gyrAp,0.5,1,1,GCGGTTTACGTCCTGACCTT,0,1742543
gyrAp,0.5,1,1,GCGGGGGGTGTCTGTTCCCT,0,1758843
gyrAp,0.5,1,1,GCGGGATACCAGTAACCAGC,0,1767571
gyrAp,0.5,1,1,GCGGCAGTATAGGCAATGTT,0,1770144
gyrAp,0.5,1,1,GCGGACCTAAGGGTGCGCCG,0,1750295
gyrAp,0.5,1,1,GCGCTTCCGCACCCACGGGG,0,1754163
gyrAp,0.5,1,1,GCGCGTTGTACAGGGCAATC,0,1747345
gyrAp,0.5,1,1,GCGCGTAAGTGTAGAGCTCT,0,1759973
gyrAp,0.5,1,1,GCGCGGGTCCGGAGAAACCT,0,1750345
gyrAp,0.5,1,1,GCGCCCTGGTCGCTAGCACA,0,1746920
gyrAp,0.5,1,1,GCGCAGTTAAGAACCCAGAC,0,1760260
gyrAp,0.5,1,1,GCGCACAATTAACTTAACAC,0,1765067
gyrAp,0.5,1,1,GCGAGGACTGCATTCTGAGA,0,1753689
gyrAp,0.5,1,1,GCGAAGGAGGGCGTGTCCTG,0,1763278
gyrAp,0.5,1,1,GCCTGAACGTGAAACTTCTA,0,1762124
gyrAp,0.5,1,1,GCCTCGAGTTCGGGCGCAAA,0,1749310
gyrAp,0.5,1,1,GCCTATTCTGCGTGCCCAAG,0,1760912
gyrAp,0.5,1,1,GCCTAGTAAATAGACTCATA,0,1762567
gyrAp,0.5,1,1,GCCGTCTATTATCAACCTGG,0,1752429
gyrAp,0.5,1,1,GCCGGAACTTTTCGTCCGTA,0,1756569
gyrAp,0.5,1,1,GCCGCTCAACGATCCGATGG,0,1764495
gyrAp,0.5,1,1,GCCCGGGTTCTATGCAGTAA,0,1745200
gyrAp,0.5,1,1,GCCCCGGGCGCATTAGCTGG,0,1763183
gyrAp,0.5,1,1,GCCCCGAACCAACTGAGCAC,0,1770703
gyrAp,0.5,1,1,GCCCACTTGCAGACACCATT,0,1754711
gyrAp,0.5,1,1,GCCAGCCACTCTATGTTTAA,0,1760039
gyrAp,0.5,1,1,GCCACAATGAGAGAAACTAA,0,1753853
gyrAp,0.5,1,1,GCATGACTGACCAGTTAGCA,0,1764464
gyrAp,0.5,1,1,GCATCCAAAAATCTCTTTTA,0,1766968
gyrAp,0.5,1,1,GCAGTTCTGATGGTCCTAGT,0,1759050
gyrAp,0.5,1,1,GCAGGTTAGGTCAGAGCGCC,0,1743537
gyrAp,0.5,1,1,GCAGCCTACCTCGGGGGAAA,0,1750182
gyrAp,0.5,1,1,GCAGATTGACGAAGAATCGC,0,1743710
gyrAp,0.5,1,1,GCACTAACAGCGTTGTGATC,0,1741763
gyrAp,0.5,1,1,GCACGGTTCACCTGCTGTTG,0,1760143
gyrAp,0.5,1,1,GCACGGCGTCACCACCAAGT,0,1753466
gyrAp,0.5,1,1,GCACACCCCCCACCGTAGGT,0,1749953
gyrAp,0.5,1,1,GCAATGCTTCCATGCGACTC,0,1748462
gyrAp,0.5,1,1,GCAAGTAGATGTTTACATGG,0,1750897
gyrAp,0.5,1,1,GCAAAGGCTATCGGGAGCTT,0,1765958
gyrAp,0.5,1,1,GATTTACCACGCAGCGCCCC,0,1754161
gyrAp,0.5,1,1,GATTCTGTGGGTTTTGTATA,0,1741728
gyrAp,0.5,1,1,GATTACAAGTGGACAACCAA,0,1768710
gyrAp,0.5,1,1,GATTAATAGACAATGCAATC,0,1749097
gyrAp,0.5,1,1,GATGGTACCACCCCGTATCC,0,1760115
gyrAp,0.5,1,1,GATGGGTCATGGATAGAATC,0,1756098
gyrAp,0.5,1,1,GATGCGGATTATCTCCTAAC,0,1765316
gyrAp,0.5,1,1,GATGCAAAACAAGGAGCCAA,0,1768251
gyrAp,0.5,1,1,GATGAGCTCACCTATAAACA,0,1767598
gyrAp,0.5,1,1,GATGACACGTGGTAATCGGG,0,1758773
gyrAp,0.5,1,1,GATCTTTGGAGTTGAACAGG,0,1762223
gyrAp,0.5,1,1,GATCTGAGTAACAGATTGTA,0,1741740
gyrAp,0.5,1,1,GATCTCTTCGCGCGCACAAC,0,1762929
gyrAp,0.5,1,1,GATCTAATCCTGACGACAAG,0,1748954
gyrAp,0.5,1,1,GATCCTTTAATTACAAGAAC,0,1760396
gyrAp,0.5,1,1,GATCCTAAGTAGGAATGATT,0,1763481
gyrAp,0.5,1,1,GATCAGGGCAGTAATCGGTA,0,1768118
gyrAp,0.5,1,1,GATATCATCTACATAACAGC,0,1769613
gyrAp,0.5,1,1,GATACCGGGCATTTCTAAGC,0,1759075
gyrAp,0.5,1,1,GAGTGTGTGAGGCGCAGCGA,0,1751549
gyrAp,0.5,1,1,GAGTGGCAGTTCTGCCATCT,0,1763058
gyrAp,0.5,1,1,GAGTAAAAGCAGCCGGTATC,0,1761712
gyrAp,0.5,1,1,GAGGTTACTGACTCATTAAC,0,1750116
gyrAp,0.5,1,1,GAGGTACATTAAAATTCGGA,0,1760658
gyrAp,0.5,1,1,GAGGTAACATTCTCCGAAGA,0,1758476
gyrAp,0.5,1,1,GAGGGATGGAGCTTCAACGC,0,1769402
gyrAp,0.5,1,1,GAGGAAGTCTGGGGTTCTGA,0,1762852
gyrAp,0.5,1,1,GAGGAAAGACTTGGCCTGAT,0,1755061
gyrAp,0.5,1,1,GAGCTGTTAAGCCCACCCCT,0,1751551
gyrAp,0.5,1,1,GAGCCAGATCGGGACTCCGA,0,1755533
gyrAp,0.5,1,1,GACTGCTTGTCATGCTGCTA,0,1755852
gyrAp,0.5,1,1,GACTCGGCCCTTTACGTAAG,0,1742180
gyrAp,0.5,1,1,GACTAGCATACTGACAGAAG,0,1765513
gyrAp,0.5,1,1,GACGGTTACTCCTGTACGGG,0,1742161
gyrAp,0.5,1,1,GACGCAGTTACCTTGATCCA,0,1747861
gyrAp,0.5,1,1,GACGAGCTTGCAAGTTTTGG,0,1752695
gyrAp,0.5,1,1,GACGAAACACAGTGCGCCGG,0,1768358
gyrAp,0.5,1,1,GACCTCATACAAATATGTAC,0,1759813
gyrAp,0.5,1,1,GACCTAAGTTAGCAGGTTTA,0,1753421
gyrAp,0.5,1,1,GACCGGGGTTGTCTAATATT,0,1757018
gyrAp,0.5,1,1,GACAGGCTAGCATGCCTGCG,0,1770028
gyrAp,0.5,1,1,GACAGGAGGCTTGACAGCCG,0,1748773
gyrAp,0.5,1,1,GACACGTCCTTGATAGGTAA,0,1758324
gyrAp,0.5,1,1,GACAAAAACGTACTATATGT,0,1759083
gyrAp,0.5,1,1,GAATTACTGCTTCAGTATAT,0,1745317
gyrAp,0.5,1,1,GAATGCTTGATATCTAGGCC,0,1758745
gyrAp,0.5,1,1,GAATATTGACACATCCGGGG,0,1749061
gyrAp,0.5,1,1,GAATACTGTCGGAAGCGCTT,0,1751799
gyrAp,0.5,1,1,GAAGTATCGCGGGGAAGATT,0,1749024
gyrAp,0.5,1,1,GAAGGGAGGGAACTTACGAG,0,1757517
gyrAp,0.5,1,1,GAAGCTTCTCTGCCGACATT,0,1742570
gyrAp,0.5,1,1,GAAGCGGGTGATGGGAACGT,0,1758846
gyrAp,0.5,1,1,GAAGCCGAATAAATCGGTTC,0,1764118
gyrAp,0.5,1,1,GAAGAGTATCTAAGGCGGTC,0,1757988
gyrAp,0.5,1,1,GAAGAACTTGTGCTGGACCA,0,1761659
gyrAp,0.5,1,1,GAAGAAAGGACTACGGCGCG,0,1763146
gyrAp,0.5,1,1,GAACTAGAGGATGTTTCATC,0,1766230
gyrAp,0.5,1,1,GAACCTTGAGCCCTGTAGCG,0,1750784
gyrAp,0.5,1,1,GAACCCGATGAGATATCACC,0,1743848
gyrAp,0.5,1,1,GAAAGGTAAAATGCCCTTAT,0,1764601
gyrAp,0.5,1,1,GAAAGGGTTTATACGCAGAG,0,1769332
gyrAp,0.5,1,1,GAAAAGGGCCATGTACAGTC,0,1763686
gyrAp,0.5,1,1,GAAAAGGAGACCAATAGGGC,0,1765840
gyrAp,0.5,1,1,CTTTTAAGCTGACTTCCTAA,0,1757056
gyrAp,0.5,1,1,CTTTGCGCGGTCTTCCCGTT,0,1749392
gyrAp,0.5,1,1,CTTTCATGCAGACCCGGCTG,0,1760724
gyrAp,0.5,1,1,CTTTCATCGAAAGCATAAAG,0,1744611
gyrAp,0.5,1,1,CTTTATATGATCATATGGAA,0,1767286
gyrAp,0.5,1,1,CTTGGTAACATGCGAGCCCC,0,1748504
gyrAp,0.5,1,1,CTTGGATATCACGATAATGA,0,1742250
gyrAp,0.5,1,1,CTTGCTCCCATGGTTAATTC,0,1767091
gyrAp,0.5,1,1,CTTGAGCTAGTAGACATCTC,0,1743363
gyrAp,0.5,1,1,CTTGAGATGGGGCATCTGCA,0,1750619
gyrAp,0.5,1,1,CTTCTTCTAAGAGCTACCTA,0,1746223
gyrAp,0.5,1,1,CTTCGCATAGCTCGGCATCG,0,1746548
gyrAp,0.5,1,1,CTTCATCCGCCATTTTTGCG,0,1765721
gyrAp,0.5,1,1,CTTCACGGTCATAGCCAGGG,0,1756889
gyrAp,0.5,1,1,CTTATGGGGCTTCCATGAAA,0,1745289
gyrAp,0.5,1,1,CTTAGCTCAGGGCCTTAAGT,0,1746708
gyrAp,0.5,1,1,CTTAGAGGTTTGGATCTCAT,0,1745732
gyrAp,0.5,1,1,CTTACGTTCGCGAACTTCCC,0,1761226
gyrAp,0.5,1,1,CTTACCGTTCCGGGCCGACA,0,1742539
gyrAp,0.5,1,1,CTTACCGGTAAATAACGTGG,0,1750891
gyrAp,0.5,1,1,CTTAATTCTCACAGAGCTTG,0,1746171
gyrAp,0.5,1,1,CTGTTTCGTAGAACGAACAT,0,1754759
gyrAp,0.5,1,1,CTGTGCGGGTCATACTCAGT,0,1758742
gyrAp,0.5,1,1,CTGTCACTCGAAGACGCCAT,0,1750461
gyrAp,0.5,1,1,CTGTAACAAAGGATGCGACG,0,1754337
gyrAp,0.5,1,1,CTGGTTCACGCCAAGCACTC,0,1770097
gyrAp,0.5,1,1,CTGGGCCGTGGGGGGCATTT,0,1769468
gyrAp,0.5,1,1,CTGGGAGAGGGTTGAATTGC,0,1747344
gyrAp,0.5,1,1,CTGGCCATCTTCGCCTAACC,0,1762481
gyrAp,0.5,1,1,CTGGCACTGTTGTCCAAATT,0,1748627
gyrAp,0.5,1,1,CTGGAACACGCCAGCCAATA,0,1744471
gyrAp,0.5,1,1,CTGCATTGTACCGCCATTGA,0,1750456
gyrAp,0.5,1,1,CTGCATCTCGCCGTGCCCTC,0,1768716
gyrAp,0.5,1,1,CTGCACACGGTCTGCGACGG,0,1767509
gyrAp,0.5,1,1,CTGAGCACAGGCATTTTCAT,0,1768825
gyrAp,0.5,1,1,CTGAGATAGCAAAGCGATGC,0,1752034
gyrAp,0.5,1,1,CTGAGAGGTCAGTCCTAATG,0,1757755
gyrAp,0.5,1,1,CTCTTAAACCTTTAGATCGT,0,1760767
gyrAp,0.5,1,1,CTCTCTCAGCGGTCCTAGGA,0,1745269
gyrAp,0.5,1,1,CTCTATCATAAGCCTCCTCA,0,1743269
gyrAp,0.5,1,1,CTCGTTTCGGTGTTCCTGTG,0,1745867
gyrAp,0.5,1,1,CTCGTTATGCCTGAAAGGCC,0,1755466
gyrAp,0.5,1,1,CTCGTTACGTAAGTCGCAGC,0,1743385
gyrAp,0.5,1,1,CTCGAGGTAGGGAGCAGTAC,0,1741536
gyrAp,0.5,1,1,CTCCTGAAATGAGTTAAGTA,0,1758594
gyrAp,0.5,1,1,CTCATGCTAGCGGGGCCGTC,0,1747672
gyrAp,0.5,1,1,CTCACCCCTAAACCGAAGAA,0,1766696
gyrAp,0.5,1,1,CTCAAAAACAGACCGAATTT,0,1765708
gyrAp,0.5,1,1,CTATTTATTACTCATATGTT,0,1747946
gyrAp,0.5,1,1,CTATATAGGGTATACCTGGG,0,1766080
gyrAp,0.5,1,1,CTATAGTTTCATGCTGACTG,0,1766460
gyrAp,0.5,1,1,CTATAAGCCCGGTAAGCAGT,0,1751807
gyrAp,0.5,1,1,CTAGTGCGACCTATGCCTAT,0,1745496
gyrAp,0.5,1,1,CTAGTAATAACTCGATTTTT,0,1755332
gyrAp,0.5,1,1,CTAGGCCCCCGAGTGTCGGC,0,1768137
gyrAp,0.5,1,1,CTAGGCACTATGGAGTATTG,0,1748812
gyrAp,0.5,1,1,CTAGGAGCTAGTTCTATTAA,0,1761450
gyrAp,0.5,1,1,CTACTGAGCAGAAAACCATT,0,1751776
gyrAp,0.5,1,1,CTACTAAAGCGTCTCGAATG,0,1761320
gyrAp,0.5,1,1,CTACGCCGACTCGTGTGAAA,0,1763731
gyrAp,0.5,1,1,CTACGAGACATCTCATTAGC,0,1744517
gyrAp,0.5,1,1,CTACCTCAACTGGAGGTGTC,0,1749634
gyrAp,0.5,1,1,CTACCGGCCCTAAGCAGGAA,0,1750951
gyrAp,0.5,1,1,CTAAGTTGTTGCGCTATGGC,0,1765227
gyrAp,0.5,1,1,CTAAGCAGCACCACAGAAAC,0,1764088
gyrAp,0.5,1,1,CGTTTCTACACAGGATCGAT,0,1769814
gyrAp,0.5,1,1,CGTTGAGGCAAACGCTGTTC,0,1760248
gyrAp,0.5,1,1,CGTTCTGCATGCAATCAAAG,0,1751754
gyrAp,0.5,1,1,CGTTCAAATAGGAGGAGGAA,0,1759947
gyrAp,0.5,1,1,CGTGTGAGGCCGTGTGATCC,0,1762804
gyrAp,0.5,1,1,CGTGGAAAGTAGTCTCCAGG,0,1769722
gyrAp,0.5,1,1,CGTCGGGATTTTAGTCCCTT,0,1752078
gyrAp,0.5,1,1,CGTCAGTAATCGCTGAGGAA,0,1750137
gyrAp,0.5,1,1,CGTCACTGGGCTGACTTCAA,0,1744368
gyrAp,0.5,1,1,CGTCAATGCTAGGGAGACGT,0,1767932
gyrAp,0.5,1,1,CGTATCCAAGGATACATCTA,0,1768502
gyrAp,0.5,1,1,CGGTGCTCTGGATAGGATTC,0,1769145
gyrAp,0.5,1,1,CGGTCGGTTTAGGCGACGTC,0,1770034
gyrAp,0.5,1,1,CGGTACTATGCTATATCATT,0,1769747
gyrAp,0.5,1,1,CGGGTACGTTCGTCTTAATG,0,1760910
gyrAp,0.5,1,1,CGGGGCGAAACGCTTATGAT,0,1758275
gyrAp,0.5,1,1,CGGGCCAGATGCCTTTACTA,0,1749860
gyrAp,0.5,1,1,CGGGAATTGTGCCTACGCGA,0,1748658
gyrAp,0.5,1,1,CGGGAAAAATCGAGGTGAGG,0,1763042
gyrAp,0.5,1,1,CGGCTAGCACCATCGAAGAA,0,1761110
gyrAp,0.5,1,1,CGGCGTTTCGGGATACTGTC,0,1758982
gyrAp,0.5,1,1,CGGCGTGTCGCACGGCGCTT,0,1753575
gyrAp,0.5,1,1,CGGCGGCGCGGGATAACGAA,0,1769925
gyrAp,0.5,1,1,CGGCCCAGCAGCATAGAACA,0,1767307
gyrAp,0.5,1,1,CGGCACCGACGTTGTGGCGA,0,1747421
gyrAp,0.5,1,1,CGGAGATCTCCCGGCTCATA,0,1761994
gyrAp,0.5,1,1,CGGAGAGTGAGCGGGAAGTA,0,1763069
gyrAp,0.5,1,1,CGGACTGTATGCATCGTTGT,0,1746870
gyrAp,0.5,1,1,CGGAAGTGTTTAGGTTATTG,0,1764013
gyrAp,0.5,1,1,CGGAAGTCAATGAAGGGCCA,0,1755180
gyrAp,0.5,1,1,CGGAAAGGTCGAGGTGTCCT,0,1763792
gyrAp,0.5,1,1,CGCTTTAACTGCGAGGCTCC,0,1742773
gyrAp,0.5,1,1,CGCTTGTGCAGGCTAGACCT,0,1765423
gyrAp,0.5,1,1,CGCTCGGTCCTTATAGTCAG,0,1745663
gyrAp,0.5,1,1,CGCTATTTAGTGTTAAGGTT,0,1749083
gyrAp,0.5,1,1,CGCTAGGGTCGAGCCGCTTT,0,1751967
gyrAp,0.5,1,1,CGCTACGGCTAGAAGGACGG,0,1762855
gyrAp,0.5,1,1,CGCTAACACTGTGTAGGCGA,0,1754440
gyrAp,0.5,1,1,CGCGTGAACACACCGGTTAA,0,1757072
gyrAp,0.5,1,1,CGCGTCTTACATAATGCGGA,0,1754573
gyrAp,0.5,1,1,CGCGGTTAAGCTGGAACATC,0,1769720
gyrAp,0.5,1,1,CGCGGCCTGGTACGCGCATA,0,1762532
gyrAp,0.5,1,1,CGCGCCCTGCTGACAAAGTC,0,1753182
gyrAp,0.5,1,1,CGCGAGGGAGCCGTGTGACC,0,1762743
gyrAp,0.5,1,1,CGCGAGCGATCGCCTCGAAC,0,1745166
gyrAp,0.5,1,1,CGCGAGATGTTCTGCCGTGC,0,1767081
gyrAp,0.5,1,1,CGCCTTTGGTTAGCATTAAA,0,1743796
gyrAp,0.5,1,1,CGCCTTCCAAACGTTTTACG,0,1762010
gyrAp,0.5,1,1,CGCCTGTCTAGGTCTGTTAT,0,1744772
gyrAp,0.5,1,1,CGCCCCGTTGGGACGTGTAA,0,1742682
gyrAp,0.5,1,1,CGCCAGGCAGTACACCCTAG,0,1759172
gyrAp,0.5,1,1,CGCCAGCGCTCCTCCGTTAC,0,1761944
gyrAp,0.5,1,1,CGCCAAGTGGTCGGTTAGGC,0,1766429
gyrAp,0.5,1,1,CGCATTACGCGATTGGATAA,0,1757562
gyrAp,0.5,1,1,CGCAGGGGCACAATCCACTT,0,1743357
gyrAp,0.5,1,1,CGCAGAGTCAGGGGGCAGAA,0,1766290
gyrAp,0.5,1,1,CGCACATTTCACACCCGTTC,0,1765093
gyrAp,0.5,1,1,CGCAATAATGTTTATGCATC,0,1747964
gyrAp,0.5,1,1,CGCAAACGAATACCTCACTT,0,1743622
gyrAp,0.5,1,1,CGATTAGCAACAATGGGAAG,0,1749210
gyrAp,0.5,1,1,CGATCGGTATCGTATACGAT,0,1758098
gyrAp,0.5,1,1,CGAGTCTTCGAATGGGTTAG,0,1744426
gyrAp,0.5,1,1,CGAGTAAGCTTTGCTTGTTC,0,1748157
gyrAp,0.5,1,1,CGAGGGATGTACGGCAAGAT,0,1741905
gyrAp,0.5,1,1,CGAGATAACGAGTTTCGACG,0,1763352
gyrAp,0.5,1,1,CGAGAGTATCTCACACATGG,0,1755831
gyrAp,0.5,1,1,CGAGACAAGCTTGAATGTTG,0,1756489
gyrAp,0.5,1,1,CGACATTTTACGATTTATTA,0,1763256
gyrAp,0.5,1,1,CGACAGGAGAGTGCTCAAGA,0,1747854
gyrAp,0.5,1,1,CGAAGGGATATCTAGTCCTC,0,1749565
gyrAp,0.5,1,1,CGAAGGAAAAATCATCTGCA,0,1751021
gyrAp,0.5,1,1,CGAAGCAATAGTGAGGCGAC,0,1768997
gyrAp,0.5,1,1,CGAAGACTCGCTTTCTGGAA,0,1751896
gyrAp,0.5,1,1,CGAACATAGTGGTTAGTAAC,0,1751637
gyrAp,0.5,1,1,CCTTTGGGCGATTCCATTTT,0,1769886
gyrAp,0.5,1,1,CCTTGCAGCGAGCTTGCGAC,0,1764339
gyrAp,0.5,1,1,CCTGTCGTGCCGGTCACTTC,0,1756290
gyrAp,0.5,1,1,CCTGGCTGTAGACTCCATTA,0,1759728
gyrAp,0.5,1,1,CCTGCCCACGGGGGAAGCTT,0,1753981
gyrAp,0.5,1,1,CCTCTACTATACCACGCGAA,0,1768740
gyrAp,0.5,1,1,CCTCGGCATTAGTGCGAGAT,0,1742954
gyrAp,0.5,1,1,CCTCGACGGGCTTCCGTGGT,0,1748915
gyrAp,0.5,1,1,CCTCCATCTCGGGTTCGAGG,0,1761013
gyrAp,0.5,1,1,CCTCATTTATCGACAACAAA,0,1758153
gyrAp,0.5,1,1,CCTATTATGCGCCGTGAATG,0,1769047
gyrAp,0.5,1,1,CCTATCCGACCAGGAACCAT,0,1760615
gyrAp,0.5,1,1,CCTAGGCATATGTGTACTGC,0,1765554
gyrAp,0.5,1,1,CCGTTCATTACACTTTTGGT,0,1752777
gyrAp,0.5,1,1,CCGTTAGGAGCCGGGATACC,0,1754196
gyrAp,0.5,1,1,CCGTGGACTAAGTGTTTCTT,0,1762885
gyrAp,0.5,1,1,CCGTGACCCAAACTGTTAGC,0,1755214
gyrAp,0.5,1,1,CCGTCCACTACTAGAGGCCT,0,1766131
gyrAp,0.5,1,1,CCGTAGCACTGGCCCCGTCC,0,1762245
gyrAp,0.5,1,1,CCGGGACGGTACAGTCGCAG,0,1753608
gyrAp,0.5,1,1,CCGGCTATATTGGTGTGGAT,0,1747968
gyrAp,0.5,1,1,CCGGCACAAAACCACCTGGG,0,1752632
gyrAp,0.5,1,1,CCGGATTCAGGAGAGTGCGA,0,1768010
gyrAp,0.5,1,1,CCGCCTTAGTTTCCTCCATA,0,1753931
gyrAp,0.5,1,1,CCGCCAACCAGAATCTCGTG,0,1769017
gyrAp,0.5,1,1,CCGAGTGGCTCATCCGATAG,0,1766260
gyrAp,0.5,1,1,CCGAGGGATATGACTCAATC,0,1758450
gyrAp,0.5,1,1,CCGACCCTAATGATTATGAT,0,1767745
gyrAp,0.5,1,1,CCCTTAGATTCAGTTCTAGA,0,1763194
gyrAp,0.5,1,1,CCCTGGTTGGACAAGAAGAT,0,1764974
gyrAp,0.5,1,1,CCCTCAACTGGATTTCCGGA,0,1765233
gyrAp,0.5,1,1,CCCGTGTGTTGGGGAGCGGT,0,1747563
gyrAp,0.5,1,1,CCCGTGTCAACCCTAACCGT,0,1768826
gyrAp,0.5,1,1,CCCGCGCTAAAGTCTATCAC,0,1765338
gyrAp,0.5,1,1,CCCGCCTTTACACTCGTTGA,0,1741710
gyrAp,0.5,1,1,CCCGCAGGGCGCCAAGTCCT,0,1758619
gyrAp,0.5,1,1,CCCGATGGGTTTCAAATTAC,0,1768022
gyrAp,0.5,1,1,CCCGATATATGCCCAGAATT,0,1770332
gyrAp,0.5,1,1,CCCGAGTTTATGGACGGCCT,0,1751689
gyrAp,0.5,1,1,CCCGAATCTGTCACCCCACG,0,1766784
gyrAp,0.5,1,1,CCCCTTGACTCGCACTTTTC,0,1769967
gyrAp,0.5,1,1,CCCCGAGCGCAAGAGGCTGA,0,1765875
gyrAp,0.5,1,1,CCCCCCGAATAATGGCCCTA,0,1755129
gyrAp,0.5,1,1,CCCATGTGTGTGTCGTCTGG,0,1760483
gyrAp,0.5,1,1,CCCAATCGCCCGCACTGGCG,0,1748352
gyrAp,0.5,1,1,CCATTCGCTGTACGTTAGGC,0,1751562
gyrAp,0.5,1,1,CCATGCGTATTGACCTGCAG,0,1752823
gyrAp,0.5,1,1,CCATGCGAAACGGGCTAGGT,0,1768424
gyrAp,0.5,1,1,CCATGATCCAGTTAAGTCTA,0,1770101
gyrAp,0.5,1,1,CCATGAAACAATCCGCAACC,0,1752343
gyrAp,0.5,1,1,CCATCGGTCTTACTACAATT,0,1761658
gyrAp,0.5,1,1,CCATCACATATTACCTGCAT,0,1754936
gyrAp,0.5,1,1,CCATATGTTGGGCAGAGTGT,0,1761859
gyrAp,0.5,1,1,CCATAACAAGAACTCCTAGT,0,1757344
gyrAp,0.5,1,1,CCAGTGGCCTCGGTCATCAT,0,1759832
gyrAp,0.5,1,1,CCAGGGGCGATGATTTGGCT,0,1741538
gyrAp,0.5,1,1,CCAGCGCCGCGGGGCTGCAT,0,1754533
gyrAp,0.5,1,1,CCACTTCTGTACAACGACAA,0,1748103
gyrAp,0.5,1,1,CCACCTGACGAACTGTGCCC,0,1751231
gyrAp,0.5,1,1,CCACCTACATGCACTATGTA,0,1751697
gyrAp,0.5,1,1,CCACATTTTGAGGCCGCTAA,0,1757578
gyrAp,0.5,1,1,CCACATCACCAAGTTGCAAC,0,1742535
gyrAp,0.5,1,1,CCACACTTGTCACCTTGTCT,0,1757805
gyrAp,0.5,1,1,CCACACTCAGGGTGTGACAA,0,1748464
gyrAp,0.5,1,1,CCACACGGGAAGCGGTAATT,0,1754327
gyrAp,0.5,1,1,CCAATTTAATCGCGACACCA,0,1744098
gyrAp,0.5,1,1,CCAATTCTAAACCTGACTGA,0,1759252
gyrAp,0.5,1,1,CCAATGGCGTTCCTCTCTCC,0,1757174
gyrAp,0.5,1,1,CCAATGATGGGGTCCAATTC,0,1765127
gyrAp,0.5,1,1,CCAAGGTTCTCGTCACACTA,0,1743623
gyrAp,0.5,1,1,CCAACCATGTGACGGCTTGG,0,1746953
gyrAp,0.5,1,1,CCAACATAGTAAACGGCCCA,0,1743197
gyrAp,0.5,1,1,CATTTACTCTGGGGAGATTG,0,1753415
gyrAp,0.5,1,1,CATTCTCAGATATATACTCG,0,1747947
gyrAp,0.5,1,1,CATTCCGGATCGGCCTCTTA,0,1751157
gyrAp,0.5,1,1,CATGTGTCCATCGTCGCCGA,0,1769050
gyrAp,0.5,1,1,CATGGCGTTTCTTGTACCCG,0,1742309
gyrAp,0.5,1,1,CATGGCCCCCCAGGCATGTC,0,1764191
gyrAp,0.5,1,1,CATCTATCGCGGAATATTAC,0,1752398
gyrAp,0.5,1,1,CATCGCGCCGGACGGTGTAT,0,1763465
gyrAp,0.5,1,1,CATCCTGACGTTGGTCGCGG,0,1754234
gyrAp,0.5,1,1,CATCCGTCCCACCGTTTCCA,0,1749591
gyrAp,0.5,1,1,CATCATAGTCCCCGTGGCGA,0,1751329
gyrAp,0.5,1,1,CATATTTACTGCGGCACTTT,0,1765493
gyrAp,0.5,1,1,CATATCAATAGTACGTCCGG,0,1768115
gyrAp,0.5,1,1,CATACCGCAATGCGAAACGG,0,1742970
gyrAp,0.5,1,1,CATACAACAGGCTCTTCGAA,0,1770804
gyrAp,0.5,1,1,CATAACAGTACTCTAGTATA,0,1752867
gyrAp,0.5,1,1,CATAAAAAGATTAATAGAGT,0,1756728
gyrAp,0.5,1,1,CAGTTCATCAGATCACCAGG,0,1763271
gyrAp,0.5,1,1,CAGTGGGGGGCTAATGGTTG,0,1745655
gyrAp,0.5,1,1,CAGTCACGGAGCGTTAAAAG,0,1748192
gyrAp,0.5,1,1,CAGTAATGATTCCTGCCAGC,0,1747379
gyrAp,0.5,1,1,CAGGTGAATCGCAGGTAGGG,0,1742968
gyrAp,0.5,1,1,CAGGGATATCCTTCATCCAC,0,1748678
gyrAp,0.5,1,1,CAGCTATAAGGGAGGCCTAA,0,1769222
gyrAp,0.5,1,1,CAGCACAGGGGACACTAAAG,0,1754654
gyrAp,0.5,1,1,CAGAGCACTTCTCGGGACGC,0,1762039
gyrAp,0.5,1,1,CAGACCGGTTAGCGCGTAGA,0,1765798
gyrAp,0.5,1,1,CAGAAACACACCAGGAGGAT,0,1744045
gyrAp,0.5,1,1,CACGGGATCATGTGCTCCCT,0,1766549
gyrAp,0.5,1,1,CACGGAGTTCGTGCGTGGTG,0,1757912
gyrAp,0.5,1,1,CACGCGCCATTTTGATCTCA,0,1753434
gyrAp,0.5,1,1,CACGAGAGATTGGGGTGTTA,0,1764535
gyrAp,0.5,1,1,CACCTTACTTGTTGCGGGGG,0,1753002
gyrAp,0.5,1,1,CACCTCGTCTTGTGAATCAT,0,1752272
gyrAp,0.5,1,1,CACCTACTAAGTTATGCTCG,0,1749561
gyrAp,0.5,1,1,CACCCGTGGCTGACAGGTAC,0,1749358
gyrAp,0.5,1,1,CACCCGACGTGTGTAGACTC,0,1764711
gyrAp,0.5,1,1,CACCCACAACACGTATGGAC,0,1744459
gyrAp,0.5,1,1,CACCAGCCGTTCTGAAGATC,0,1761070
gyrAp,0.5,1,1,CACCAATTAATGTGTGCGGT,0,1748141
gyrAp,0.5,1,1,CACCAAGCTCGTGTTGGCAT,0,1748394
gyrAp,0.5,1,1,CACCAACTGAAAAATATAGG,0,1752009
gyrAp,0.5,1,1,CACAGCGGGCCAGAACTTGT,0,1758085
gyrAp,0.5,1,1,CACAGATCAACGTAAAGACA,0,1747238
gyrAp,0.5,1,1,CACAGACAGTCTCGCTCGAG,0,1753004
gyrAp,0.5,1,1,CACAGAACCCACGGCCAGTA,0,1760465
gyrAp,0.5,1,1,CACAAGCAACACCTGATTTG,0,1756729
gyrAp,0.5,1,1,CAATTTATTCAATAATGCGT,0,1757088
gyrAp,0.5,1,1,CAATTGGTTCGGATGGTGAG,0,1768891
gyrAp,0.5,1,1,CAATGTTATTGAGGCGAACT,0,1768854
gyrAp,0.5,1,1,CAATGGAGGTGTTGACAGAA,0,1758319
gyrAp,0.5,1,1,CAATCGTCCGGGGGTGCCCC,0,1762761
gyrAp,0.5,1,1,CAATCGGTTCCGCAAATTTG,0,1759282
gyrAp,0.5,1,1,CAATCAGATAGTATGAATTG,0,1761830
gyrAp,0.5,1,1,CAAGTGGTGCCCTGAAGCGA,0,1750704
gyrAp,0.5,1,1,CAAGGCCCGAAGTTCGTGTT,0,1769488
gyrAp,0.5,1,1,CAAGCCAAGCAGCCTGTAGG,0,1748356
gyrAp,0.5,1,1,CAAGCACGGTCACGAACCTT,0,1764638
gyrAp,0.5,1,1,CAAGAATAAAAGGCCTTTTG,0,1741698
gyrAp,0.5,1,1,CAACTTTAATAGTGTCGTAG,0,1761186
gyrAp,0.5,1,1,CAACTTCTCTAACCGAAGAG,0,1748641
gyrAp,0.5,1,1,CAACGGATGTGACCGCAGAA,0,1761899
gyrAp,0.5,1,1,CAACGCTCTCCATTGGAATA,0,1752658
gyrAp,0.5,1,1,CAACGACTGCGACGGGCAGG,0,1745781
gyrAp,0.5,1,1,CAACCGTTTTCCGAGAGAAA,0,1751728
gyrAp,0.5,1,1,CAAATTGATGCGACCGTCCA,0,1758622
gyrAp,0.5,1,1,CAAATCGGGTCACAGCCATC,0,1757886
gyrAp,0.5,1,1,CAAATATTATGAATCGCCCA,0,1749913
gyrAp,0.5,1,1,CAAAATCAGAGGACTTGCGG,0,1766151
gyrAp,0.5,1,1,CAAAAGCACTGCGTAAAAGT,0,1746875
gyrAp,0.5,1,1,ATTTTAATAGCGGAACTGAC,0,1761281
gyrAp,0.5,1,1,ATTTGAACTTGGAGTGACGA,0,1766256
gyrAp,0.5,1,1,ATTTCATCGGTGCTCTCTAA,0,1770365
gyrAp,0.5,1,1,ATTGTCTACGCTTCGGTCTA,0,1767955
gyrAp,0.5,1,1,ATTGCGGTAGCGTTCACATT,0,1760274
gyrAp,0.5,1,1,ATTGCAACCGCGGCCAAATT,0,1767228
gyrAp,0.5,1,1,ATTGAGGCCCTCGGGTAATG,0,1760472
gyrAp,0.5,1,1,ATTCTGTCACGGAGTAAACA,0,1747516
gyrAp,0.5,1,1,ATTCTATTTTGCCACTCCAT,0,1761925
gyrAp,0.5,1,1,ATTCGTATGAACACTCACTA,0,1764250
gyrAp,0.5,1,1,ATTCCGTTTCGCACCATGAG,0,1748441
gyrAp,0.5,1,1,ATTCATCACCGTGAGGGTGT,0,1755234
gyrAp,0.5,1,1,ATTCACCAGCTGCTATGACA,0,1767506
gyrAp,0.5,1,1,ATTCAAGCGCCCAGGGGGTG,0,1751457
gyrAp,0.5,1,1,ATTCAACTCAATGGATTAGA,0,1757825
gyrAp,0.5,1,1,ATTATTCGGGGGGTCAAAAG,0,1745348
gyrAp,0.5,1,1,ATTAGGTCAGATTTTCAAAA,0,1751827
gyrAp,0.5,1,1,ATTAGGGGTCTCAACCTCCC,0,1768695
gyrAp,0.5,1,1,ATTAGCGCGCTGCGCGAAAC,0,1757657
gyrAp,0.5,1,1,ATTAGAGAATACTGTAATTG,0,1764673
gyrAp,0.5,1,1,ATTAGACCTACGACTGGGAT,0,1752769
gyrAp,0.5,1,1,ATTACGCATTGCCGAATTAC,0,1766522
gyrAp,0.5,1,1,ATTACGATCAGTCGGTTGGA,0,1764085
gyrAp,0.5,1,1,ATGTGGGGTGCGTGGGTCTT,0,1761424
gyrAp,0.5,1,1,ATGGTCGAGCTATAGAAGCT,0,1754519
gyrAp,0.5,1,1,ATGGTACAGTAGGTAGGTAA,0,1756937
gyrAp,0.5,1,1,ATGGGAAATGTTACGCATAG,0,1755887
gyrAp,0.5,1,1,ATGGCTCATACAGCTCCAGG,0,1769391
gyrAp,0.5,1,1,ATGGCTATGTGTTTCATCTG,0,1762073
gyrAp,0.5,1,1,ATGCTCCAGCGAAGTCGTCG,0,1746688
gyrAp,0.5,1,1,ATGCGCGCGGTACAGGTATC,0,1758367
gyrAp,0.5,1,1,ATGCAAAACGTTTCATTTTA,0,1766450
gyrAp,0.5,1,1,ATGAGTGTAGGCATAAGTCT,0,1745027
gyrAp,0.5,1,1,ATGAGGTCCGTCCGTAACGC,0,1758981
gyrAp,0.5,1,1,ATGAGCTGACCTAGTACGGT,0,1766214
gyrAp,0.5,1,1,ATGACTATAGCTGCTATGCA,0,1752848
gyrAp,0.5,1,1,ATGACGTCTCCCTATAGTAT,0,1758432
gyrAp,0.5,1,1,ATGACGCGTGTGTTCGTTGT,0,1765764
gyrAp,0.5,1,1,ATGACCGATGAACTTCTTCG,0,1745172
gyrAp,0.5,1,1,ATGAACGGAGAGCCAACCAG,0,1763584
gyrAp,0.5,1,1,ATCTTGTGGTCTATGCTTCA,0,1742820
gyrAp,0.5,1,1,ATCTTGAGCCCCGGAATGAT,0,1741995
gyrAp,0.5,1,1,ATCTTCAACAGAATATAGTA,0,1745543
gyrAp,0.5,1,1,ATCTGAAGAATAGGCTTGGT,0,1748586
gyrAp,0.5,1,1,ATCTCTCCGGTAAGCGACTG,0,1741732
gyrAp,0.5,1,1,ATCTCTCATATACCTGTTTC,0,1751462
gyrAp,0.5,1,1,ATCTCTCAGATTGAAAGGAT,0,1755109
gyrAp,0.5,1,1,ATCTCGGGTTTGCTACCCAA,0,1758376
gyrAp,0.5,1,1,ATCTATCTCGGAACAGTGTG,0,1761000
gyrAp,0.5,1,1,ATCGTGTGTGCCCCTCGTCT,0,1770076
gyrAp,0.5,1,1,ATCGTAGGCGAGTCATTCCA,0,1759081
gyrAp,0.5,1,1,ATCGTAAAAAAATCACTTCT,0,1744956
gyrAp,0.5,1,1,ATCGGTTAGATAGCGATAGC,0,1742287
gyrAp,0.5,1,1,ATCGACCGCATAAAAATCGC,0,1745222
gyrAp,0.5,1,1,ATCATTCGGCCCGAAAACAG,0,1765769
gyrAp,0.5,1,1,ATCATCTCAGACGGTGCCAA,0,1750820
gyrAp,0.5,1,1,ATCAGTTGTTGAAGGGGCAT,0,1764727
gyrAp,0.5,1,1,ATCAGTGGCTTAAACCTCGC,0,1768455
gyrAp,0.5,1,1,ATCAGTGAGGATACGGTGCA,0,1767487
gyrAp,0.5,1,1,ATCACGGGAGTCGCAGAAAA,0,1758094
gyrAp,0.5,1,1,ATCACCAGTCAGGGGTCGGA,0,1757296
gyrAp,0.5,1,1,ATCAATGATCGGGCTAATCT,0,1760331
gyrAp,0.5,1,1,ATCAATAGTCTCGGGTGACA,0,1749438
gyrAp,0.5,1,1,ATATGTGGGGTAAAACAGGC,0,1750128
gyrAp,0.5,1,1,ATATGTGCGGCGTTTAGTTC,0,1770691
gyrAp,0.5,1,1,ATATGCGGCAGTTAAAGACC,0,1767649
gyrAp,0.5,1,1,ATATGCGAGGCGTCTTTGCA,0,1760857
gyrAp,0.5,1,1,ATATCCATCCTCCGAGCCAG,0,1764536
gyrAp,0.5,1,1,ATATCAGTTTGCATCTCTAA,0,1769490
gyrAp,0.5,1,1,ATATACGTTAGCTAAATCAG,0,1756713
gyrAp,0.5,1,1,ATAGGTAAATGCAAGACAGT,0,1757838
gyrAp,0.5,1,1,ATAGAACTGGCCGTGCACTC,0,1758627
gyrAp,0.5,1,1,ATACGTGTCTTTGCAACCGA,0,1762451
gyrAp,0.5,1,1,ATACGCCATCGAGAGCCCAA,0,1756891
gyrAp,0.5,1,1,ATACCTTGCGACCCAGGGCT,0,1769726
gyrAp,0.5,1,1,ATACCAAAAGGTATGGGAAC,0,1744119
gyrAp,0.5,1,1,ATACAACATGAATCCATCTG,0,1754105
gyrAp,0.5,1,1,ATAATCGTCTCCGCAGGTAC,0,1745722
gyrAp,0.5,1,1,ATAATCCCTCTACAATCTGG,0,1766370
gyrAp,0.5,1,1,ATAAGGTGTCTTGTGCCATA,0,1760781
gyrAp,0.5,1,1,ATAAGGACGACGCATAATTG,0,1766413
gyrAp,0.5,1,1,ATAACTCTGAGCATATGACA,0,1747887
gyrAp,0.5,1,1,ATAAACGTTCGGTGGCGAGG,0,1755621
gyrAp,0.5,1,1,AGTTCGATTTTATCTGTCTC,0,1759331
gyrAp,0.5,1,1,AGTTCAGTTCTTTCGATGAA,0,1750444
gyrAp,0.5,1,1,AGTTAAAAGGCTCATATGCG,0,1765192
gyrAp,0.5,1,1,AGTGTTATTCAGAAAGGGTG,0,1748827
gyrAp,0.5,1,1,AGTGGTGCTGGATCGTGTTG,0,1763372
gyrAp,0.5,1,1,AGTGCGGAAGGTTTCTGGTG,0,1767033
gyrAp,0.5,1,1,AGTGCGCTAATGTCGCATAA,0,1750288
gyrAp,0.5,1,1,AGTGCATAGGCGTTGTGTTT,0,1760125
gyrAp,0.5,1,1,AGTGATGATACAGTCGCATC,0,1756488
gyrAp,0.5,1,1,AGTGAGATGTACGTCATCGT,0,1769439
gyrAp,0.5,1,1,AGTCTAGTAGCGGTTCGGGT,0,1768916
gyrAp,0.5,1,1,AGTCGTTATCGTATGAATCC,0,1747447
gyrAp,0.5,1,1,AGTATGAGACGAGGGAAAGC,0,1741795
gyrAp,0.5,1,1,AGTATAAATTTCGAGCACTA,0,1766835
gyrAp,0.5,1,1,AGTAGGTGACTGAGATTACG,0,1765888
gyrAp,0.5,1,1,AGTAGGCTCGTAGCAGATGC,0,1763650
gyrAp,0.5,1,1,AGTAGCCTCTCTCAGGCTGC,0,1759924
gyrAp,0.5,1,1,AGTAGACGGACATCCGGGTA,0,1755231
gyrAp,0.5,1,1,AGTACTTCGTTCCTATGTCT,0,1754454
gyrAp,0.5,1,1,AGTAACGTGCTGCATCAATC,0,1754958
gyrAp,0.5,1,1,AGTAAATCGGTTGAGCTTGA,0,1753475
gyrAp,0.5,1,1,AGGTTTATTCGGGTTTCGCT,0,1748918
gyrAp,0.5,1,1,AGGTCGAGCTGCTCAAATCG,0,1769126
gyrAp,0.5,1,1,AGGTCACAAAGCTACTGATC,0,1761832
gyrAp,0.5,1,1,AGGTATAGGCTGTTCCTATC,0,1768867
gyrAp,0.5,1,1,AGGGTTGAATAATTTAAACA,0,1749112
gyrAp,0.5,1,1,AGGGTCTGCTGGCATGTTTG,0,1748591
gyrAp,0.5,1,1,AGGGGGTGTTTCCGCCACTG,0,1770558
gyrAp,0.5,1,1,AGGGGGGCGGTTTAAGTGGT,0,1749644
gyrAp,0.5,1,1,AGGGCACCCACAGTCTTACG,0,1756600
gyrAp,0.5,1,1,AGGGCAATGCGTCGGTTCCA,0,1761836
gyrAp,0.5,1,1,AGGGATATCTATGGTAGTCG,0,1769621
gyrAp,0.5,1,1,AGGGAAGCGGTCTCAGCGTA,0,1768584
gyrAp,0.5,1,1,AGGCTGTATCGGAGCGCTAA,0,1749589
gyrAp,0.5,1,1,AGGCTGCGAGATCGCAAGCG,0,1752985
gyrAp,0.5,1,1,AGGCTCGTGCTCTTCAGTAC,0,1759918
gyrAp,0.5,1,1,AGGCTAGTGTCCTCCTGGCA,0,1749418
gyrAp,0.5,1,1,AGGCGTAGCACCCCTACACT,0,1749572
gyrAp,0.5,1,1,AGGCGCCGGGGACTGTTCCG,0,1767404
gyrAp,0.5,1,1,AGGCCTGTATCAGAGACCGC,0,1761892
gyrAp,0.5,1,1,AGGCCTGAGGCGGATGTATC,0,1764997
gyrAp,0.5,1,1,AGGCCAATGACATTCGTGGA,0,1768774
gyrAp,0.5,1,1,AGGATGCACCAAAGCACTTA,0,1764795
gyrAp,0.5,1,1,AGGAGTGACTGATATCCTCA,0,1760363
gyrAp,0.5,1,1,AGGAGGGTGACTAGGAGCGG,0,1751189
gyrAp,0.5,1,1,AGGACCCAATGGAGCGCAGC,0,1756324
gyrAp,0.5,1,1,AGGACAGAAAGTATCAGACA,0,1747293
gyrAp,0.5,1,1,AGCTGCGTACACAACTAAAT,0,1762991
gyrAp,0.5,1,1,AGCTGACCGAGATTTGTTAG,0,1752550
gyrAp,0.5,1,1,AGCTCAGAGAGTGATAGAGG,0,1745672
gyrAp,0.5,1,1,AGCTAGTAAAAGGTATTTCG,0,1757274
gyrAp,0.5,1,1,AGCTAGGGTCGAGAACGGGT,0,1753942
gyrAp,0.5,1,1,AGCTAACAGGATCCGCAGAT,0,1767634
gyrAp,0.5,1,1,AGCGGTAATCCGGCTCAGTA,0,1748742
gyrAp,0.5,1,1,AGCGAACCGCATTATGGGAG,0,1762377
gyrAp,0.5,1,1,AGCGAACACGGTACGAGTCA,0,1769594
gyrAp,0.5,1,1,AGCCTCATAACTTGGGTCAA,0,1751789
gyrAp,0.5,1,1,AGCCGGCCCTTTCCATATAG,0,1763151
gyrAp,0.5,1,1,AGCCGAGATTGTTAACTATT,0,1745080
gyrAp,0.5,1,1,AGCAACCATCATCTGTTTTC,0,1750929
gyrAp,0.5,1,1,AGATCACGTCAGCGTACCTG,0,1750209
gyrAp,0.5,1,1,AGAGTCCGACACCGGACCAT,0,1750625
gyrAp,0.5,1,1,AGAGTCACGTCATTCTCTCG,0,1743382
gyrAp,0.5,1,1,AGAGGACTACCGTGACTCGA,0,1757789
gyrAp,0.5,1,1,AGAGCTCGACCCATAAAGGA,0,1759029
gyrAp,0.5,1,1,AGAGAGCTGGGTACATGTCG,0,1752123
gyrAp,0.5,1,1,AGACGTCCGCACTCGGTGCG,0,1748109
gyrAp,0.5,1,1,AGACGAACTCGTGCCTACCT,0,1770153
gyrAp,0.5,1,1,AGACCGCTGGTGATCGGCCA,0,1760490
gyrAp,0.5,1,1,AGACCATCTAAACAGCGCAT,0,1747880
gyrAp,0.5,1,1,AGACATTCCCCTCGCCTTTT,0,1762826
gyrAp,0.5,1,1,AGACAGGAGGATAGCTTCAG,0,1757593
gyrAp,0.5,1,1,AGAATTTTTCAAGAGGCTCT,0,1759600
gyrAp,0.5,1,1,AGAAGGAGGGTCACCCTTGA,0,1742861
gyrAp,0.5,1,1,AGAACTTTGAGAGCGCCTAT,0,1761010
gyrAp,0.5,1,1,AGAACTAGAGGGAAATTTAG,0,1761995
gyrAp,0.5,1,1,AGAACGAACGCGATGCGCGA,0,1757782
gyrAp,0.5,1,1,ACTTTACTCCGCACTAAACG,0,1747759
gyrAp,0.5,1,1,ACTTGATGCGCCGCTCATAG,0,1759100
gyrAp,0.5,1,1,ACTTGAGGTGTATGAGTAAG,0,1769582
gyrAp,0.5,1,1,ACTGTGCTTTAATGAAGTTC,0,1745075
gyrAp,0.5,1,1,ACTGGCCCTACTGTACAGTC,0,1745837
gyrAp,0.5,1,1,ACTGATTACGTACAGATATA,0,1757417
gyrAp,0.5,1,1,ACTGATAGTATCTTATTTTC,0,1769559
gyrAp,0.5,1,1,ACTCACGACTACGCTAACGG,0,1746370
gyrAp,0.5,1,1,ACTAGGGAAAACACAACATG,0,1765950
gyrAp,0.5,1,1,ACTACCACCATTCGCATGTG,0,1768083
gyrAp,0.5,1,1,ACTAAGACAACCGTCGCGCA,0,1753998
gyrAp,0.5,1,1,ACGTTCATTGATACAATGCT,0,1762003
gyrAp,0.5,1,1,ACGTTACCCTTCCTACACGC,0,1768731
gyrAp,0.5,1,1,ACGTGGTTCTAACAAGTGCG,0,1745311
gyrAp,0.5,1,1,ACGTCAGAGGGCAATATTGA,0,1747721
gyrAp,0.5,1,1,ACGTACTCTAGTTTATCGTC,0,1767184
gyrAp,0.5,1,1,ACGTAAATAGCCCTGGGTAA,0,1745039
gyrAp,0.5,1,1,ACGGTCGAGGCCGGTTAGGT,0,1742339
gyrAp,0.5,1,1,ACGGGAGGCGTGTAGCCAAC,0,1765990
gyrAp,0.5,1,1,ACGGCGTTCAAAGTGTTACT,0,1770351
gyrAp,0.5,1,1,ACGGACAGATCGCCAATGAC,0,1765267
gyrAp,0.5,1,1,ACGCTTCAATATCACGCTCA,0,1754570
gyrAp,0.5,1,1,ACGATCTGATCGAGACTCCC,0,1743849
gyrAp,0.5,1,1,ACGATATACGGGGTGCACAT,0,1762842
gyrAp,0.5,1,1,ACGAGGTTTTCCGTGTGTAG,0,1757082
gyrAp,0.5,1,1,ACGAGCTTTATAGAGCTGTT,0,1765945
gyrAp,0.5,1,1,ACGAGATATCGGAATGTGAG,0,1761777
gyrAp,0.5,1,1,ACGACCACGTATTCTCTCGA,0,1750170
gyrAp,0.5,1,1,ACGACAGCACCGGTGTACTT,0,1751600
gyrAp,0.5,1,1,ACGAACCCCCGCCAGCACTT,0,1754813
gyrAp,0.5,1,1,ACGAAATTGAGGGTGATGGT,0,1764952
gyrAp,0.5,1,1,ACCTGCGACATGATCTATCA,0,1745991
gyrAp,0.5,1,1,ACCTGCACCGTAGTCCGGAA,0,1741868
gyrAp,0.5,1,1,ACCTGAGACGCGACAGATCC,0,1742053
gyrAp,0.5,1,1,ACCTAGGGCCAGCAATCCAG,0,1766335
gyrAp,0.5,1,1,ACCGGTGAGGAGAAATAGTG,0,1767613
gyrAp,0.5,1,1,ACCGGTCCAGAAATCCGCGA,0,1761231
gyrAp,0.5,1,1,ACCGGGTGTATCTGTAGGTC,0,1757198
gyrAp,0.5,1,1,ACCCTTTGGGGGGCTTTTGG,0,1753462
gyrAp,0.5,1,1,ACCCACCAACATCTGTCACT,0,1749444
gyrAp,0.5,1,1,ACCATAGTCTAAGATTCGTT,0,1769150
gyrAp,0.5,1,1,ACCAGTTCCGCGCATGCTAT,0,1746715
gyrAp,0.5,1,1,ACCAGTACTGGGTGAAACGC,0,1762893
gyrAp,0.5,1,1,ACCAGGGGGACTGACAACTT,0,1750449
gyrAp,0.5,1,1,ACCAGCCCCACTAACTCGGG,0,1754511
gyrAp,0.5,1,1,ACCAGACACGGAGCCGTAGA,0,1759825
gyrAp,0.5,1,1,ACCACTGGTTACCAGAACCT,0,1764462
gyrAp,0.5,1,1,ACCAAGGCTCAGCAGCCTGG,0,1742111
gyrAp,0.5,1,1,ACATTGGGAAGACGTCAGAG,0,1758703
gyrAp,0.5,1,1,ACATTATAGGTCCTGTATAG,0,1770614
gyrAp,0.5,1,1,ACATGCCAGATTAAAAAAAC,0,1755785
gyrAp,0.5,1,1,ACATAGTGTACATATCGAGC,0,1742207
gyrAp,0.5,1,1,ACAGTGGTTCTCGCTGCCTC,0,1762420
gyrAp,0.5,1,1,ACAGTCAGGTCATTATCTGT,0,1744587
gyrAp,0.5,1,1,ACAGCTTGTGAGAAGAGGAT,0,1746036
gyrAp,0.5,1,1,ACACTACCCCACGCCGCGGG,0,1744664
gyrAp,0.5,1,1,ACACCACGGCTAGGGATTAT,0,1751250
gyrAp,0.5,1,1,ACAAGTCCACCACAGTGACA,0,1755676
gyrAp,0.5,1,1,ACAAGCGATCGGCGGACGTA,0,1753016
gyrAp,0.5,1,1,AATTGTTACTCACGTTAGAT,0,1764301
gyrAp,0.5,1,1,AATTGGGAGGTAGAAGCACC,0,1757795
gyrAp,0.5,1,1,AATTGATTTATCTTTTTATT,0,1757480
gyrAp,0.5,1,1,AATTGAGATGGGAGAGCGAA,0,1758480
gyrAp,0.5,1,1,AATTCCTATAAAGAGTTGAT,0,1760743
gyrAp,0.5,1,1,AATTATTGCCGAGGGGTTCT,0,1750276
gyrAp,0.5,1,1,AATGTACAAGCAAACCCCGC,0,1749868
gyrAp,0.5,1,1,AATGGGGGGGCCGGGGTGCC,0,1753465
gyrAp,0.5,1,1,AATGCATATCGATCAAGGTG,0,1758215
gyrAp,0.5,1,1,AATGACATTACCGCAGTCCC,0,1767183
gyrAp,0.5,1,1,AATCGGTTTCAGGACTTAAT,0,1767622
gyrAp,0.5,1,1,AATCCCCTGCGCTAGAAGGA,0,1767761
gyrAp,0.5,1,1,AATCAGGTGTTGATCCGGGA,0,1757812
gyrAp,0.5,1,1,AATCAAATCCATAAACGTTC,0,1748524
gyrAp,0.5,1,1,AATATCTCATCACACTTAGC,0,1750403
gyrAp,0.5,1,1,AATAGGTCTGGTTCTGTGGT,0,1744259
gyrAp,0.5,1,1,AAGTTCTGAAGAGGATGCCC,0,1762661
gyrAp,0.5,1,1,AAGTGGGCACTGGGATTTTA,0,1745366
gyrAp,0.5,1,1,AAGTGCAGTAGAGAGGATTT,0,1742715
gyrAp,0.5,1,1,AAGTCCTCCCTATTTTGATC,0,1763980
gyrAp,0.5,1,1,AAGTAGCTTGTAGAACGGCG,0,1756306
gyrAp,0.5,1,1,AAGTACATATTCGTGCTTGC,0,1748777
gyrAp,0.5,1,1,AAGTAAAGGGCCATGACGCA,0,1770218
gyrAp,0.5,1,1,AAGTAAAATCCCGTGAACGC,0,1746916
gyrAp,0.5,1,1,AAGGGGTTAGCCGTCCTTCC,0,1769888
gyrAp,0.5,1,1,AAGGGGCAGTCCCCCGCGGT,0,1743771
gyrAp,0.5,1,1,AAGGCGTCGGAAATAATCAG,0,1768890
gyrAp,0.5,1,1,AAGGAGCAGATGCCACTGCC,0,1751880
gyrAp,0.5,1,1,AAGCGCTTGGCTACAAAGAC,0,1764739
gyrAp,0.5,1,1,AAGCCTATTGGAAAGCTAAC,0,1761295
gyrAp,0.5,1,1,AAGCAAGGGGGGGGGGGGAC,0,1750216
gyrAp,0.5,1,1,AAGATGACAGGTGGCACATG,0,1761084
gyrAp,0.5,1,1,AAGAGCAGTCCTGATGCGTG,0,1769779
gyrAp,0.5,1,1,AAGACCTTTTCTACGTGTAC,0,1761814
gyrAp,0.5,1,1,AACTGCGAATGTCTGAGTAA,0,1762733
gyrAp,0.5,1,1,AACTGACCCAGGACACACAA,0,1748892
gyrAp,0.5,1,1,AACTCGCAGGTTTTTTAAAT,0,1769530
gyrAp,0.5,1,1,AACTCAGCACGCTGGCGATT,0,1754048
gyrAp,0.5,1,1,AACTATGCTCGAGATAAAAC,0,1762204
gyrAp,0.5,1,1,AACGTGTTTTTACACGACAT,0,1768571
gyrAp,0.5,1,1,AACGTGTGACGTAAGTATGT,0,1750923
gyrAp,0.5,1,1,AACGGCAGCGAATCCGTGCG,0,1760367
gyrAp,0.5,1,1,AACGCACCGGCGTGACGTCC,0,1744935
gyrAp,0.5,1,1,AACGAAATCCCTTTCTCCAG,0,1768841
gyrAp,0.5,1,1,AACCTGAGCGCACCGGACCA,0,1754085
gyrAp,0.5,1,1,AACCGGATTTGCTTGGTAAC,0,1755907
gyrAp,0.5,1,1,AACCACGAGCAGTCCCAGTA,0,1767812
gyrAp,0.5,1,1,AACAGGTTGGCGAAACGTTC,0,1747254
gyrAp,0.5,1,1,AACAGACTGCCCAGTCCAAT,0,1753075
gyrAp,0.5,1,1,AACAACGGATCTTAGTGTGA,0,1743699
gyrAp,0.5,1,1,AAATTATTGTAGCCCCAGAA,0,1769275
gyrAp,0.5,1,1,AAATTAGGTGCCTCAGCTAA,0,1765601
gyrAp,0.5,1,1,AAATGTACCAACAGAACGGT,0,1755151
gyrAp,0.5,1,1,AAATCTAGGCGCCGGGACGG,0,1769781
gyrAp,0.5,1,1,AAATCCACAAAATTGCTGCG,0,1746397
gyrAp,0.5,1,1,AAATCAGATACTATCAGTCG,0,1762219
gyrAp,0.5,1,1,AAAGTAAGTAGAACTTTGGG,0,1747720
gyrAp,0.5,1,1,AAAGGTAGTGCTTCACACCC,0,1746873
gyrAp,0.5,1,1,AAAGCGTCCACTATAATTTA,0,1764427
gyrAp,0.5,1,1,AAAGCCTATCTACGAGATTT,0,1754998
gyrAp,0.5,1,1,AAAGAGGGGTTCCGCAGAAT,0,1767028
gyrAp,0.5,1,1,AAACCATCTTCAAGAAGAAA,0,1759276
gyrAp,0.5,1,1,AAAATCAATTAAAGCTATCA,0,1747406
gyrAp,0.5,1,1,AAAAGACCAGTACGTGTCTT,0,1763863
gyrAp,0.5,1,1,AAAAAGTGATTGAGGGCACG,0,1768176
gyrAp,0.5,1,1,AAAAAGTCAGGGGATGGTCT,0,1751905
gyrAp,0.5,1,1,AAAAAACAGACATCCCATAA,0,1748850
gyrAp,86.0,85,0,GGGTAGCAGATTTAGTTCAA,85,1751822
gyrAp,66.0,65,0,TTCACGATGGGAAGTACTAG,65,1763765
gyrAp,59.0,58,0,TTGGTTCATGGGAGCACAGT,58,1748327
gyrAp,59.0,58,0,TTACCGGATACTTACGTATC,58,1762410
gyrAp,49.0,48,0,ACCCGAGGATCGACATGTGA,48,1760865
gyrAp,48.0,47,0,GGTGCCAGACGTTGTAGAAC,47,1750688
gyrAp,48.0,47,0,AGAGCTCAGGACGTAACCGG,47,1756668
gyrAp,47.0,46,0,GTGGTAAGCAACGTCCCATC,46,1758991
gyrAp,45.0,44,0,TTCGCACTGTCATTCAGCGC,44,1757561
gyrAp,45.0,44,0,CGCTGTCGAGTACGTGGACG,44,1763492
gyrAp,45.0,44,0,AAGTCGCACATCTATTTGAA,44,1755321
gyrAp,43.0,42,0,GCCCTCGCCTATCCCTAGGT,42,1745558
gyrAp,43.0,42,0,AAGAATAGTTGCAGAAGGCT,42,1741880
gyrAp,42.0,41,0,CGTGTGGTGTTGCGGGTATT,41,1748581
gyrAp,41.0,40,0,GCTGGCAAACCACCCGGTCA,40,1768417
gyrAp,40.0,39,0,CGAGTCATATAAATAAGACC,39,1768211
gyrAp,39.0,38,0,GCGCAGGCCGTGCTGTGCTG,38,1747433
gyrAp,39.0,38,0,CGTGACGGTACAGGATCGAT,38,1761959
gyrAp,39.0,38,0,CGGTGAATCTTCGCGGTGGA,38,1767785
gyrAp,38.0,37,0,GATTTACTTGGCAGCCGAAG,37,1748699
gyrAp,38.0,37,0,CTTATGAGGGGCTTAACCGT,37,1758934
gyrAp,37.0,36,0,AGAGCGGGAGACATTTATTA,36,1754473
gyrAp,37.0,36,0,AACGTCATTCCTGGCAAAGT,36,1754108
gyrAp,36.0,35,0,TCCGCTTATAGTTCGGGTAC,35,1746301
gyrAp,36.0,35,0,GAAGACGCCGTGAGGGTTTA,35,1754833
gyrAp,36.0,35,0,ACCGACCGGACGAACATCAC,35,1754419
gyrAp,35.0,34,0,TAAACGGTGAGTCAACGAGG,34,1754021
gyrAp,35.0,34,0,GGGTGTTGCTCCGGACGAAG,34,1749558
gyrAp,35.0,34,0,AGGAGCCCATGACGGTTAAG,34,1751710
gyrAp,34.0,33,0,CCGCCTCTCGGACTAGCGGT,33,1753277
gyrAp,34.0,33,0,CCATTTTTTGACACACGGCC,33,1744579
gyrAp,34.0,33,0,ACTTTATAGAGCATGGATCG,33,1750743
gyrAp,33.0,32,0,TCCTGCCTTAGTCATCCAGA,32,1743631
gyrAp,32.0,31,0,GCACATTGCGAGAGTCAGGA,31,1757204
gyrAp,31.0,30,0,TACTTCTACATAAGACTCTT,30,1758393
gyrAp,31.0,30,0,GTAAACTATTCGCATACATT,30,1756805
gyrAp,31.0,30,0,CCGCAATAGCTGTTTCTACT,30,1747047
gyrAp,31.0,30,0,CCAATGTTAACTATCGCGTA,30,1768933
gyrAp,31.0,30,0,AGACTCATTCCTGCGATTAA,30,1754660
gyrAp,30.0,29,0,GTAGGCTGCGCGAGTCACCT,29,1742429
gyrAp,29.0,28,0,CGGGGGCATGAGTGAGATAA,28,1761431
gyrAp,29.0,28,0,ACCCGCAGGCGGCTTTACTT,28,1764912
gyrAp,28.0,27,0,TCGCAGCGGATAGCGTTTGA,27,1767644
gyrAp,28.0,27,0,GTCGATGCATCGCGCTCTTG,27,1761868
gyrAp,28.0,27,0,CGTTTGGTCTAGCGGCTGGT,27,1744391
gyrAp,28.0,27,0,CGACGCGTCAGTGAGGGCAG,27,1761625
gyrAp,27.0,26,0,TAAGTGTGAAGGTGCCAGTT,26,1759979
gyrAp,27.0,26,0,GTAGTTCAGCCGGCCGTCTG,26,1767137
gyrAp,27.0,26,0,CGGTCACAAAAAACGCAATT,26,1759528
gyrAp,27.0,26,0,AGTCTTCGGCGATCGAGTAT,26,1749332
gyrAp,27.0,26,0,ACTCAAGAACTGGTACTTCT,26,1759997
gyrAp,25.0,24,0,GAGCAAGCTATAAGGGAGAT,24,1744384
gyrAp,25.0,24,0,CGGGGTGGTTTAGCTTAACC,24,1759156
gyrAp,25.0,24,0,CCTTATGGAAGCAGGTGTTC,24,1757860
gyrAp,25.0,24,0,ATCCTCCTGTTGGTCATTTC,24,1770031
gyrAp,24.0,23,0,TTTCACTTGCGACAAATAAA,23,1769939
gyrAp,24.0,23,0,GAATGTTAGGTGCTCGCAAG,23,1767815
gyrAp,24.0,23,0,GAAAGTTCCTTTATCAGTTC,23,1768185
gyrAp,24.0,23,0,CAACTATGTGATTGCAGCGA,23,1748385
gyrAp,24.0,23,0,AGCGGGGCTACGACCAGTGC,23,1749918
gyrAp,23.0,22,0,TGACATCCAGATCCGGATCT,22,1758602
gyrAp,23.0,22,0,AGGGATCGTTGGCACACAAC,22,1750760
gyrAp,23.0,22,0,AGGCCAAAGAACCTCTTGAA,22,1745850
gyrAp,22.0,21,0,TCAGTGAGATAGGGATGACC,21,1745072
gyrAp,22.0,21,0,TAGCTCCCTGCTAGCCTATG,21,1749921
gyrAp,22.0,21,0,TAATAGATTGTCAGACAACC,21,1766550
gyrAp,22.0,21,0,GCAGCCCTCTTTATGGATAA,21,1766768
gyrAp,22.0,21,0,GAGCTTTATCTTCGGCCTAA,21,1748046
gyrAp,22.0,21,0,CCAATTAGCATGCGGCTCCA,21,1752317
gyrAp,21.0,20,0,TTGATAAGTCTGGCGATCTT,20,1743270
gyrAp,21.0,20,0,TTATCTTATTTGGACCCCGT,20,1753000
gyrAp,21.0,20,0,TATGGGAAAGTAAAGTGAAT,20,1759543
gyrAp,21.0,20,0,GGGGAAATCGTGTCCCTGTC,20,1759189
gyrAp,21.0,20,0,GGCGGTCGAGGTGACATACA,20,1761366
gyrAp,21.0,20,0,GATAATGTTCCACCCTCAGC,20,1744394
gyrAp,21.0,20,0,GACGGCCACGCATATGAATG,20,1770696
gyrAp,21.0,20,0,ATCAAAGGGTGCGCTCATGG,20,1765269
gyrAp,21.0,20,0,ACGCGCTTCGGGACTAATCC,20,1760378
gyrAp,21.0,20,0,AATCCTGATCTTAATGGTGC,20,1747053
gyrAp,20.0,19,0,TTCTCCTTGTAGAGCCAGGC,19,1767935
gyrAp,20.0,19,0,TAACGGGGGCGGCACCTTCT,19,1761313
gyrAp,19.0,18,0,TTCTATACCTCGTGTGAAGG,18,1757102
gyrAp,19.0,18,0,TATATGGCAATCGGTGTGAG,18,1749596
gyrAp,19.0,18,0,TAAGGACCAATCTGCCTATC,18,1765706
gyrAp,19.0,18,0,GGGATCTAGTCATCGCGAAA,18,1760489
gyrAp,19.0,18,0,GGCGTCTTGATCCGTACGAG,18,1764350
gyrAp,19.0,18,0,ATTCGAACTAGGGCGTTCAT,18,1747301
gyrAp,18.0,17,0,TCTAGCCGCTGAGTAATGGA,17,1743283
gyrAp,18.0,17,0,TCAACAGAGGAAGCCTCTAC,17,1751092
gyrAp,18.0,17,0,GTCCGCAAGCCATGCCAAGA,17,1759485
gyrAp,18.0,17,0,CCTCTGATCGGATCGGAAAT,17,1754471
gyrAp,18.0,17,0,CCAGGTACATTATAGAGTTG,17,1752454
gyrAp,18.0,17,0,ATTGATATAGCCCATATAAT,17,1747679
gyrAp,17.0,16,0,GTAGATGAGTGGATCGAGGC,16,1763909
gyrAp,17.0,16,0,CCGTAACGGCCGGATGAATT,16,1746049
gyrAp,17.0,16,0,CAGGAGGTCCCTCTTTTTTT,16,1752884
gyrAp,17.0,16,0,AGTTGACAAAGATACGGAGA,16,1767207
gyrAp,16.0,15,0,TTCGGAATGACCCTCAATCG,15,1762441
gyrAp,16.0,15,0,TCCATGTATGATTACGAATC,15,1752020
gyrAp,16.0,15,0,GGAATATCGTACCGGAACTC,15,1762132
gyrAp,16.0,15,0,AGCACACTAAAGACAGTGAC,15,1749929
gyrAp,16.0,15,0,ACATGGAGGCTAATAAATCT,15,1743313
gyrAp,16.0,15,0,ACAGGCACCATCCTAGCGGA,15,1764313
gyrAp,15.0,14,0,TCACCTACTATTTGAGCCAG,14,1757498
gyrAp,15.0,14,0,CGTCGTTGCGGATGGATTCA,14,1747637
gyrAp,15.0,14,0,AAACTACGGAGAACAGACGG,14,1749812
gyrAp,14.0,13,0,TCCATGGTTAACGTTCACAA,13,1741998
gyrAp,14.0,13,0,TAAATATACTCGACTACCTC,13,1743453
gyrAp,14.0,13,0,GTTGGGGCGCTCATTCCCTA,13,1741465
gyrAp,14.0,13,0,GACCACCGTTAGGCTTTAGT,13,1752649
gyrAp,14.0,13,0,ACATGTTGGGCGGCATTCCT,13,1753947
gyrAp,13.0,12,0,TTCATCAAGGGGCATAATTA,12,1751856
gyrAp,13.0,12,0,TGACTCGCATCGGCATAGTG,12,1750979
gyrAp,13.0,12,0,TCGAGTAACATGCCGGCCTC,12,1747586
gyrAp,13.0,12,0,CCGTCATTGATCCTTACTAA,12,1764145
gyrAp,13.0,12,0,AGCATAGGCCGGCTTATGGA,12,1764921
gyrAp,13.0,12,0,ACTTTGCAATGTTGCCATCA,12,1753208
gyrAp,13.0,12,0,AAACTCGGTTCCGTGTGTAA,12,1747622
gyrAp,12.0,11,0,TGCCTATGTACGTTTAGTGG,11,1768960
gyrAp,12.0,11,0,GGCAAGGTTGATGCGAAACT,11,1743392
gyrAp,12.0,11,0,CGGTTCGGTCATCCCCCTAT,11,1754083
gyrAp,12.0,11,0,ATGTGTTCAGTCTGTGGATA,11,1760894
gyrAp,12.0,11,0,AGTTTGACGGGCGCAATCAG,11,1756810
gyrAp,11.0,10,0,TTTGGTCAAAAAATGAACAC,10,1762206
gyrAp,11.0,10,0,TCCACTTAGGAATGGATCAA,10,1757859
gyrAp,11.0,10,0,TACGTTACCGTCTGTGTCCT,10,1769755
gyrAp,11.0,10,0,GTAGGTTTACAAGCTAGGAC,10,1770547
gyrAp,11.0,10,0,GTACTGGCAATAAAAGCAAA,10,1753223
gyrAp,11.0,10,0,GCCTAACGTCTGTATGTTCG,10,1741687
gyrAp,11.0,10,0,CCGCTATACGCTTAACTAGT,10,1769381
gyrAp,10.0,9,0,TTTCTTGGATATATAATTCT,9,1753405
gyrAp,10.0,9,0,TAAAGAAGGATTAAGTACCG,9,1753955
gyrAp,10.0,9,0,GTGGCCTCGGCCACACTGCT,9,1754668
gyrAp,10.0,9,0,GTGACGCTGAGCAGGGCACA,9,1750814
gyrAp,10.0,9,0,CGGTTCACGAAAAGCCTTCA,9,1754361
gyrAp,10.0,9,0,CATTGTTAGCTAGACAGACA,9,1769163
gyrAp,10.0,9,0,AGTTACAGAATGATAACTTG,9,1744592
gyrAp,10.0,9,0,AGCTGGCCGCCTATTCGCCT,9,1750032
gyrAp,9.0,8,0,TAATGCGGGTTGAAAGGGTT,8,1770446
gyrAp,9.0,8,0,GTGGTAGTTCGACTCATAAG,8,1745555
gyrAp,9.0,8,0,GGTTCGTTACAAAGTTAAGC,8,1769178
gyrAp,9.0,8,0,GCCTCCAGTGTACTTGGTTA,8,1746701
gyrAp,9.0,8,0,CTGGGTTTAGCGAAATGCCT,8,1759657
gyrAp,9.0,8,0,CGCAAAAAGGTGTTGCTTGT,8,1741442
gyrAp,9.0,8,0,AGAGAACTGTTTGCTCACGG,8,1760617
gyrAp,8.0,7,0,TTCCTAACTAGCCGAAACCA,7,1760204
gyrAp,8.0,7,0,GCTTTTATATATTCGATGCC,7,1753452
gyrAp,8.0,7,0,GCTGTGCGGTGTACCGAGAG,7,1759925
gyrAp,8.0,7,0,GCGTGCATAGATCCGTCAAA,7,1762950
gyrAp,8.0,7,0,GCGCATTTGCCGAACCGATC,7,1759106
gyrAp,8.0,7,0,CTCTGCTTAGCAGCGGGAAT,7,1748317
gyrAp,8.0,7,0,CCCCTTTGTAACTCATTCGA,7,1767403
gyrAp,8.0,7,0,ATTTTGTTGCAACTTACCCT,7,1761206
gyrAp,8.0,7,0,ATTTTCGCCGTGAACCAGAC,7,1743930
gyrAp,8.0,7,0,ATTTCTCAAATATTATATGT,7,1752417
gyrAp,8.0,7,0,ATAGTATCTCCAATCTTTAG,7,1753219
gyrAp,8.0,7,0,ACGCTGATATGCCCCTCTCT,7,1764109
gyrAp,7.0,6,0,TCTCGAACTTTTAAACAGCT,6,1759140
gyrAp,7.0,6,0,TCGGCGCAAGGGTGCGCGCC,6,1743689
gyrAp,7.0,6,0,GGACTGCCTTATAAAACATA,6,1746786
gyrAp,7.0,6,0,AAACACTGATACTTCCCTCT,6,1761439
gyrAp,6.0,5,0,TGGATTACGTCGCTATCCAG,5,1750872
gyrAp,6.0,5,0,TAAAGTCTACTCGTGCACAT,5,1750198
gyrAp,6.0,5,0,GGGCCGCTACGGCAGGTGTA,5,1747570
gyrAp,6.0,5,0,AGTTGTAGCTTAATGAGCCA,5,1761224
gyrAp,5.0,4,0,TTTCTCGACATATGTATCTC,4,1754402
gyrAp,5.0,4,0,TTGCGGCGTGAAGTACGTAG,4,1745412
gyrAp,5.0,4,0,TTATTTTTTCCATAGTCTTA,4,1744305
gyrAp,5.0,4,0,TGCCATGAGCGCTATGCGCC,4,1749833
gyrAp,5.0,4,0,TGCATACTGGGGTCCGGATG,4,1751307
gyrAp,5.0,4,0,TCAAGATTTGACAAACCGGT,4,1743518
gyrAp,5.0,4,0,GTTTTTCATGTCGGGTTATC,4,1743923
gyrAp,5.0,4,0,GTGAGTGATTTGTCCCAGGT,4,1745442
gyrAp,5.0,4,0,GCTTAAGCGAGGAGTTGACC,4,1752951
gyrAp,5.0,4,0,GCTACGTAGTCGGCAATGCG,4,1750783
gyrAp,5.0,4,0,GAAGCAAGGTATATTCTGGA,4,1767036
gyrAp,5.0,4,0,CTTTAGGAGATAGTCTATTC,4,1769153
gyrAp,5.0,4,0,ATTTTTATAAGTTGTTCGGA,4,1752821
gyrAp,5.0,4,0,ACTCCCCTCCAGGTTAGTCG,4,1752910
gyrAp,4.0,3,0,TCGACAGTCTTAAAGATAGT,3,1760882
gyrAp,4.0,3,0,GCTTTCACGATACTACCCAC,3,1746572
gyrAp,4.0,3,0,CTAATCCGAATCAATTTCCA,3,1761707
gyrAp,4.0,3,0,CGTCGGTGACTGGTTCGGGG,3,1754976
gyrAp,4.0,3,0,CGTAGATCGGAATCAAGGAG,3,1770412
gyrAp,4.0,3,0,CGGTCGGCGCGCTGGTAGGG,3,1748467
gyrAp,4.0,3,0,CGCAGCTTAGGTTTGCGGTA,3,1767828
gyrAp,4.0,3,0,CCCCGTCCTCTACAGTAACT,3,1755055
gyrAp,4.0,3,0,CAACGCGTGGGACGCCTAAC,3,1766796
gyrAp,4.0,3,0,AGTTGGGAGAACGCCTCATT,3,1762412
gyrAp,3.0,2,0,TTTTATCAAAGGGCTCTCGT,2,1766284
gyrAp,3.0,2,0,TTCCCAAGAATGGCTGGGAA,2,1746752
gyrAp,3.0,2,0,TGTCATATTAGATCGTGACT,2,1764804
gyrAp,3.0,2,0,TATCCATATAAATGGTATAC,2,1759681
gyrAp,3.0,2,0,TACCGTAGAGAATCTTCCCT,2,1756345
gyrAp,3.0,2,0,GTGAGTCTAGCTCTCCGACC,2,1769957
gyrAp,3.0,2,0,GGCGATCGCGTTCGGCAACT,2,1758831
gyrAp,3.0,2,0,CCTACGGTGTGGCTAAAGAA,2,1762194
gyrAp,3.0,2,0,CCCGGATAGCGTTTTATGCC,2,1763305
gyrAp,3.0,2,0,ATGTGTTGGCCAGCGTGTGA,2,1743620
gyrAp,3.0,2,0,AGGCGGTGGGGCTCATGAGT,2,1755570
gyrAp,2.0,1,0,TTAGCGCGCAGGTCAGCAAT,1,1750346
gyrAp,2.0,1,0,TGAGGTAAAAGTGAGTGGTT,1,1746385
gyrAp,2.0,1,0,TCTTAAACCGGTATTAGCTG,1,1767969
gyrAp,2.0,1,0,TCGTCGGTGGGCTGGGCTCG,1,1745304
gyrAp,2.0,1,0,TCCTCAATAGTGGCATCCCC,1,1752517
gyrAp,2.0,1,0,TCACTCCTCTTCCCTTTCAT,1,1751363
gyrAp,2.0,1,0,TATGTACGGCCAGGTATAGC,1,1768001
gyrAp,2.0,1,0,TAAGACCATGCAACACTAGA,1,1751082
gyrAp,2.0,1,0,GGTACCGCAGATGGACGGCC,1,1755580
gyrAp,2.0,1,0,GGATGAAACACCGTGAAGGA,1,1764362
gyrAp,2.0,1,0,GCGTTTCCAGGGTCGCTTCA,1,1760673
gyrAp,2.0,1,0,GCCTTTACTTTATTGATGGG,1,1764158
gyrAp,2.0,1,0,GAGAGTTATTGTTTTTATAA,1,1766758
gyrAp,2.0,1,0,GACCGCTGGTAGTTCCGGCG,1,1741497
gyrAp,2.0,1,0,CTTTGGTAGCCATTACAACC,1,1746526
gyrAp,2.0,1,0,CCTTTTTATTGGTCGTACGA,1,1748097
gyrAp,2.0,1,0,CCTTTGGCAAATTCAATGAT,1,1748663
gyrAp,2.0,1,0,CCTCATACATGCTCCAAGCG,1,1744438
gyrAp,2.0,1,0,CCTAAATGAGATAGAATTAG,1,1742837
gyrAp,2.0,1,0,CCGTTCCCCGGCCCAACACT,1,1770055
gyrAp,2.0,1,0,CCGTACTTGCGTCAGGTATG,1,1764403
gyrAp,2.0,1,0,CCCATTTCCACAGGACCGAT,1,1760341
gyrAp,2.0,1,0,CATTGTGGAACCATTTCACT,1,1753526
gyrAp,2.0,1,0,CAAAGTTGTAGCCAGGGCGT,1,1746275
gyrAp,2.0,1,0,AGTAGGAATAAGTGCTGGCC,1,1744365
gyrAp,2.0,1,0,ACGTGCACATGATATCTGAA,1,1748776
gyrAp,2.0,1,0,ACATGTCCGCGTAACCGGGG,1,1751621
gyrAp,2.0,1,0,AATAGAACGGCTGACGGATG,1,1758764
gyrAp,2.0,1,0,AAATGTGTCCATTAAATTTT,1,1744380
