name,relative_counts,ct,ct_0,barcode,ct_1,barcode_ind
zapB_predicted,0.6128663657658687,28228,17502,GCGGTACTGCTCGCTCGAAA,10726,5263746
zapB_predicted,1.165311653116531,3993,1844,AAGATTCGCGCTATTGATTA,2149,5267919
zapB_predicted,0.009523809523809525,210,209,GCATACTATTTTACGTGGCT,1,5277917
zapB_predicted,0.01764705882352941,171,169,GAGAAGCCGTCGTTGGCGTT,2,5265141
zapB_predicted,0.05454545454545454,114,109,CGCATTTAAAGCACCACGCT,5,5263455
zapB_predicted,0.02727272727272727,111,109,ACTCAGTCATCCGTTTTGCT,2,5284779
zapB_predicted,0.030927835051546393,98,96,TCCGCAATTAGGCAACCGAT,2,5265489
zapB_predicted,0.020618556701030927,97,96,AAAATTACATAGGCCTACTT,1,5263079
zapB_predicted,4.297872340425532,496,93,CTTATGTTAAATGGCGGAGT,403,5270152
zapB_predicted,0.021505376344086023,93,92,AGTCGGTGTGAGATAGGCAT,1,5268929
zapB_predicted,0.02197802197802198,91,90,GGGAATATCTAGAGATAAAG,1,5277455
zapB_predicted,0.02197802197802198,91,90,AAGGCGCACAAGAATCAGTA,1,5263027
zapB_predicted,0.02247191011235955,89,88,CGCCCGTCGAGTTCGATTGT,1,5269593
zapB_predicted,2.2823529411764705,277,84,GAATTCCGCGGATGTTCCCC,193,5265954
zapB_predicted,2.1785714285714284,265,83,AACTCCTATGGATCCTCTTT,182,5263003
zapB_predicted,2.36144578313253,277,82,TCGCAATTGAGGAGCCAATG,195,5264878
zapB_predicted,0.024691358024691357,81,80,AAGCAAGACCTTGAAGAGCC,1,5276823
zapB_predicted,3.0422535211267605,285,70,CGTCACACACTTTGAAGAAG,215,5280157
zapB_predicted,0.04411764705882353,69,67,GTTTCCATAGTCATTCGGAA,2,5266202
zapB_predicted,0.04477611940298507,68,66,GCTTCTTCAGGGAAAGTGCA,2,5263134
zapB_predicted,0.03125,64,63,AAATGTCGGCGCCGTAGCAG,1,5278518
zapB_predicted,3.5396825396825395,284,62,GGGTTATCGAGGTGGTTTTG,222,5263780
zapB_predicted,1.1904761904761905,136,62,GATCAGTGATTAGCTTACCA,74,5263621
zapB_predicted,0.03225806451612903,62,61,TTTGCTTTAGTCATACTGGT,1,5277496
zapB_predicted,0.03225806451612903,62,61,CGAACCAGGCTTGGGGCATC,1,5275541
zapB_predicted,0.03389830508474576,59,58,TTCCACTAACATATTAGAGA,1,5285280
zapB_predicted,3.9310344827586206,284,57,GTCTTGCTTACGCGATGGGG,227,5263038
zapB_predicted,4.0,288,57,ACAACTGCATAATTAGTTAT,231,5278526
zapB_predicted,19.228070175438596,1151,56,CAGACGTTATACTAGAGCTT,1095,5283085
zapB_predicted,0.03508771929824561,57,56,ACCTAAGCAGAACTGCCTCT,1,5266666
zapB_predicted,7.109090909090909,444,54,GTATCGGCGGCGCGTAGGAC,390,5278590
zapB_predicted,0.03636363636363636,55,54,GGGCCACCGGTAATCACAAT,1,5264068
zapB_predicted,0.05454545454545454,56,54,AAGGCAGATCGTCTAAATCC,2,5263328
zapB_predicted,6.814814814814815,420,53,TGAGAACTGAGATACATATT,367,5263236
zapB_predicted,16.339622641509433,917,52,GAACGATACATGCCGGTCTA,865,5264905
zapB_predicted,3.92,244,49,TCGAACCAGCTAGTCGCTTA,195,5265285
zapB_predicted,0.04,50,49,CACATTAGCGATGCTGTCGC,1,5277129
zapB_predicted,1.7959183673469388,135,48,TGATGACTCGGTTATCCGGA,87,5269992
zapB_predicted,0.04081632653061224,49,48,TCTAGGTGACCGGATTTGCG,1,5267253
zapB_predicted,0.04081632653061224,49,48,TCCGTGGTTGATACCTAGTA,1,5271877
zapB_predicted,0.04081632653061224,49,48,ATACTAAGGTCAGTAGATGA,1,5283222
zapB_predicted,0.04081632653061224,49,48,AGAGGTCAGTTGTGACTCAA,1,5278919
zapB_predicted,0.041666666666666664,48,47,CAACGGACGAATTAGGGTCA,1,5263804
zapB_predicted,0.041666666666666664,48,47,ATGCCATTGGCCGCCTCAGG,1,5282144
zapB_predicted,0.041666666666666664,48,47,AAACGCCGGCAGAGCAACCA,1,5279512
zapB_predicted,0.0425531914893617,47,46,TAGGACTTTATTATATGGTG,1,5281267
zapB_predicted,3.9130434782608696,224,45,TTTCCGAGCACGATGTGCGA,179,5282583
zapB_predicted,0.043478260869565216,46,45,TGCCTCTATTTTCATCATAC,1,5272337
zapB_predicted,0.06521739130434782,47,45,GGCATTCTACCGATGCTACT,2,5285004
zapB_predicted,5.434782608695652,294,45,GAGGATCTAAAGCAGAGGTT,249,5287903
zapB_predicted,0.043478260869565216,46,45,AGCGTTACGGGGCAGCGTAA,1,5267340
zapB_predicted,4.931818181818182,259,43,GTTAGCCAGAGTAGCGATCT,216,5288188
zapB_predicted,0.06818181818181818,45,43,GCTCTAGTTGACCTACATGT,2,5268888
zapB_predicted,5.113636363636363,267,43,CGGAAAACCAACTTATAAAA,224,5266964
zapB_predicted,3.627906976744186,197,42,TGTAATTGAGCACGATCTGA,155,5277574
zapB_predicted,0.046511627906976744,43,42,TCGCGCTGAAGCTTCCTAGC,1,5264396
zapB_predicted,0.046511627906976744,43,42,CCCGCCATTGATGGCTTTAT,1,5275812
zapB_predicted,0.046511627906976744,43,42,CAATGACACACTGCCATTTG,1,5264409
zapB_predicted,4.767441860465116,246,42,AAACTTCACCGGCGTCGAAT,204,5263838
zapB_predicted,3.7857142857142856,199,41,TATAAGGGTTTATGGGTATT,158,5268446
zapB_predicted,4.309523809523809,221,41,GGGTGTCTGACTGTATAGCT,180,5271286
zapB_predicted,6.976190476190476,333,41,GGGGATGGCCAGCAAGTGGT,292,5273582
zapB_predicted,3.6666666666666665,194,41,GATTTTAACGTACGAGGCAA,153,5271087
zapB_predicted,0.047619047619047616,42,41,CGGCTTCAGGAGGACGCTCG,1,5272033
zapB_predicted,0.047619047619047616,42,41,CACGCGCGTGGGTACAGCGG,1,5264183
zapB_predicted,4.761904761904762,240,41,ACTCTGCTGTTTAGAGTCCT,199,5279405
zapB_predicted,0.047619047619047616,42,41,ACCAATTAGGGTGAACCTAA,1,5264486
zapB_predicted,0.07142857142857142,43,41,AATACGCGACGTGCACTATC,2,5278094
zapB_predicted,3.8333333333333335,201,41,AAGACGAGCCTCAATACCAT,160,5273389
zapB_predicted,11.21951219512195,499,40,TTACAGTTCTCGGGGGTACT,459,5276256
zapB_predicted,0.12195121951219512,44,40,TGCCTACTTGACTTCACATT,4,5274129
zapB_predicted,3.682926829268293,190,40,GCCCTCCTAGATAGTATCCT,150,5284244
zapB_predicted,0.04878048780487805,41,40,GAGTAACATAAAACGAGAGT,1,5278737
zapB_predicted,0.04878048780487805,41,40,ATCGTCCTTAGTAACACTTG,1,5266487
zapB_predicted,0.05,40,39,CATGCCGATCATTCTTTAAA,1,5283089
zapB_predicted,2.3846153846153846,130,38,GTTTGAGCATTGGTCGCTTT,92,5277847
zapB_predicted,7.384615384615385,325,38,GTCCGAGTCTTGCAATTCCA,287,5266296
zapB_predicted,0.05128205128205128,39,38,GTATCGACATAGCGACATTA,1,5276930
zapB_predicted,0.07692307692307693,40,38,GGTCATATGTACGTTTGGAA,2,5288355
zapB_predicted,4.487179487179487,212,38,GAACACCGACAAGGCTTTCA,174,5273795
zapB_predicted,2.8974358974358974,150,38,ACAGTGTCGGCATCTGTGAC,112,5263530
zapB_predicted,0.1282051282051282,42,38,AACGTGATGCGAGTCAAGCG,4,5273530
zapB_predicted,9.763157894736842,407,37,TTCGGTTAGGCCCCGTGGTG,370,5265902
zapB_predicted,6.2631578947368425,274,37,TCTGCTCCTCAGAATGTAGT,237,5277763
zapB_predicted,0.05263157894736842,38,37,CTGTTCAATTGGCATTAGGG,1,5273003
zapB_predicted,0.05263157894736842,38,37,AGCTTCAGAATCCTGGCCCC,1,5267932
zapB_predicted,5.702702702702703,246,36,TCGGGCACTCGGGACGATTT,210,5264067
zapB_predicted,1.7027027027027026,98,36,GGGTGGGGACAGAGACGTAC,62,5272018
zapB_predicted,0.05405405405405406,37,36,GCCCGCCTAAACGATTGCGG,1,5279460
zapB_predicted,0.05405405405405406,37,36,CAGGGGTATTAGCTCTAGAC,1,5264915
zapB_predicted,0.05555555555555555,36,35,TGTGCATCATTTATAGGGTT,1,5272196
zapB_predicted,3.1944444444444446,149,35,TGGTATATCAGAGCACATGT,114,5275133
zapB_predicted,17.083333333333332,649,35,CCTTTTCGTGGGGCTTCGTT,614,5267880
zapB_predicted,3.861111111111111,173,35,ACCGTAGGCGCCAGAAGCCA,138,5284641
zapB_predicted,5.527777777777778,233,35,AATTTATATCGTATTTGACG,198,5268184
zapB_predicted,0.05714285714285714,35,34,TTCAACGACGGATCCGTTAG,1,5267900
zapB_predicted,0.08571428571428572,36,34,TCAGTTATCACTAGGTTCCT,2,5267507
zapB_predicted,5.857142857142857,238,34,GGCTCACAACACAATGGCCT,204,5264355
zapB_predicted,0.11428571428571428,37,34,GCTGAAAGGTGGGGACCATA,3,5282330
zapB_predicted,0.05714285714285714,35,34,CTATAACATTGTACGGCACG,1,5267693
zapB_predicted,2.8285714285714287,132,34,CATGAGCGTGAAACACGTCT,98,5284029
zapB_predicted,10.542857142857143,402,34,ATATGACAAACGTGATCCAT,368,5268093
zapB_predicted,0.11428571428571428,37,34,AGGTCATTAACGCCGTAGGT,3,5268373
zapB_predicted,5.714285714285714,233,34,AACCAAGAGCACCTCAACCA,199,5265319
zapB_predicted,6.5,253,33,TGTTGCCTCAAAGGACGCGA,220,5267651
zapB_predicted,0.058823529411764705,34,33,GTGTTCCACCGTATGCGCAT,1,5272483
zapB_predicted,6.264705882352941,245,33,CTCCTTTGGATGATTTCAGA,212,5263595
zapB_predicted,0.058823529411764705,34,33,CGGGCAGTATACTTGGGAAT,1,5263907
zapB_predicted,2.9411764705882355,132,33,CCTCCACTTCCTATAAAAGT,99,5272494
zapB_predicted,0.058823529411764705,34,33,CAGACTGGACTCGCACGCAT,1,5277128
zapB_predicted,5.411764705882353,216,33,ACTCTTGAGTTCGTGATCGC,183,5264472
zapB_predicted,5.666666666666667,218,32,GTTCCTGCATCCCAGCCAGT,186,5283435
zapB_predicted,6.333333333333333,240,32,GGTCCCAGGCCGAGCGACGA,208,5267174
zapB_predicted,0.06060606060606061,33,32,CTTAACCTCGCCTGTAAACT,1,5279706
zapB_predicted,0.06060606060606061,33,32,CTATGTCCCGGTGTCGTAAG,1,5288298
zapB_predicted,28.21212121212121,962,32,CATGAGCGACTCTCACAAAT,930,5274472
zapB_predicted,0.06060606060606061,33,32,ACCTTGGAGGGGCGAACCTT,1,5285542
zapB_predicted,0.09375,33,31,TCGGGGTAGCGCGGAATTAC,2,5264854
zapB_predicted,0.0625,32,31,GTTGAATCAAAGACTTGCCT,1,5287599
zapB_predicted,7.75,278,31,GTACGACTCGGCCACGACCC,247,5283382
zapB_predicted,16.75,566,31,GCGCATTCGGCAGATATCAC,535,5270176
zapB_predicted,0.0625,32,31,GCAGTCCCGGAAATAATTAA,1,5272099
zapB_predicted,4.5,174,31,GAATCGGTTGGATCCCCCAT,143,5278868
zapB_predicted,0.0625,32,31,CTCTTAGGTCGCCGCTCGAG,1,5266303
zapB_predicted,0.0625,32,31,CGACAATAACATCTCTGTCA,1,5280686
zapB_predicted,0.0625,32,31,CAAGCCGACATAACATAGTT,1,5272656
zapB_predicted,6.6875,244,31,ATTAGAGTGGAGTCTAATGC,213,5274629
zapB_predicted,0.0625,32,31,AGCGAGGATAGCAAATTAAA,1,5263125
zapB_predicted,0.0967741935483871,32,30,TTAGGACCCCGCACAACAGT,2,5285600
zapB_predicted,5.32258064516129,194,30,TTAAGAATTACCGCGTCTAT,164,5265788
zapB_predicted,0.06451612903225806,31,30,GTCGTATCATTCTCCCGACC,1,5283745
zapB_predicted,0.0967741935483871,32,30,GGATAATTTTTCCCGGCCAA,2,5281139
zapB_predicted,0.12903225806451613,33,30,GCCGTATGACCTCCAGAGAT,3,5270576
zapB_predicted,0.06451612903225806,31,30,GAAACTGTCATTGTCATGTT,1,5275606
zapB_predicted,0.06451612903225806,31,30,CGTGCGCCGGTTAACGATCT,1,5264536
zapB_predicted,0.06451612903225806,31,30,CGCCGCATAAGGCGCCCTTT,1,5282299
zapB_predicted,0.06451612903225806,31,30,AGGGCATTTTAGCCCGTCGC,1,5268145
zapB_predicted,0.06451612903225806,31,30,ACTGTAATTCCGGAACTTGA,1,5283911
zapB_predicted,0.06451612903225806,31,30,AAGAGCGGTCGTTCAACTAA,1,5275397
zapB_predicted,15.166666666666666,483,29,TTGCCCGATGTGTTTGAGCA,454,5264942
zapB_predicted,6.033333333333333,209,29,TCCAACTTCCGGCTTAATGT,180,5267857
zapB_predicted,0.06666666666666667,30,29,TATGCACTGATGTTTGCCTT,1,5284079
zapB_predicted,0.06666666666666667,30,29,GACACATTCCGGGCCGAGAA,1,5270377
zapB_predicted,0.06666666666666667,30,29,GAATGGAATATGTGATTGCT,1,5268855
zapB_predicted,3.566666666666667,135,29,CCTTCATCCCGCGCCGGCCC,106,5286375
zapB_predicted,0.06666666666666667,30,29,CCATTGGCACTATAATTGTA,1,5282219
zapB_predicted,0.06666666666666667,30,29,ATGTGTGATGTTTTCAGCAG,1,5274781
zapB_predicted,0.06666666666666667,30,29,ATCCAACACTCACCGTAACA,1,5270888
zapB_predicted,0.06666666666666667,30,29,AGTGTCTGGGCTACATTTGT,1,5276966
zapB_predicted,0.06666666666666667,30,29,AGGGAATAATTGAATCCACA,1,5276671
zapB_predicted,0.06666666666666667,30,29,AGCCGCAGCAATCCGCCCCT,1,5264649
zapB_predicted,0.06666666666666667,30,29,AACCTATTAGTCGCGGAGAT,1,5263105
zapB_predicted,7.482758620689655,244,28,GTTTCACGCACTGGTACATA,216,5280278
zapB_predicted,0.06896551724137931,29,28,GGTTCATGTCCGTCCGTTGG,1,5273962
zapB_predicted,0.20689655172413793,33,28,GGCGGTTTTTGAAGATAAGG,5,5266037
zapB_predicted,7.655172413793103,249,28,GAATACAAAGTGAGTGTTAA,221,5271620
zapB_predicted,4.172413793103448,148,28,CGGAGCAATAGAGGCGGCCT,120,5272134
zapB_predicted,0.06896551724137931,29,28,CATTGCGACTCAGTCCTAGT,1,5264098
zapB_predicted,0.06896551724137931,29,28,CAGTATTAATTATGCCTCTG,1,5273168
zapB_predicted,8.689655172413794,279,28,AGGCAACATCTACTCTGAGG,251,5268384
zapB_predicted,7.758620689655173,252,28,AGAGAGTTACGATTATTCAT,224,5269719
zapB_predicted,0.06896551724137931,29,28,AGACGAAGCTGCAGTAGACT,1,5283546
zapB_predicted,0.06896551724137931,29,28,AATTAGGAAAAGAAGAGGAT,1,5276931
zapB_predicted,14.931034482758621,460,28,AAGCGTCCATCGGTGCAGAA,432,5286986
zapB_predicted,0.07142857142857142,28,27,TATTAAACGAGGAAAGTGCT,1,5277748
zapB_predicted,0.07142857142857142,28,27,GTAGATTCCGGTGATAGAAC,1,5263359
zapB_predicted,0.07142857142857142,28,27,GGACTTTGTAATGCACGGCA,1,5274551
zapB_predicted,9.285714285714286,286,27,GCGTCCAATAGACCAGGAGT,259,5288301
zapB_predicted,0.07142857142857142,28,27,GCAGTCTTGGGTTGGGTCAA,1,5267940
zapB_predicted,7.178571428571429,227,27,CGAGAACGTCAAGGTTCTCT,200,5263108
zapB_predicted,0.07142857142857142,28,27,CCTGCATGCGCGGGTCGAGG,1,5288392
zapB_predicted,8.071428571428571,252,27,CCTCGAGTGCACATTCTAGT,225,5271586
zapB_predicted,0.07142857142857142,28,27,ATCCATGCAGTCATCTTACC,1,5272389
zapB_predicted,6.321428571428571,203,27,AGGACGTCTAGCGGAACCGT,176,5281916
zapB_predicted,0.07142857142857142,28,27,ACGAGGCCTGTAGATAAAGA,1,5275029
zapB_predicted,7.185185185185185,219,26,TCCCTTTCGGGTGATTACGA,193,5267403
zapB_predicted,0.07407407407407407,27,26,TATGATGCGCGTCGTTCGTT,1,5272213
zapB_predicted,8.444444444444445,253,26,TAAATGATCCGAGCTCGCGA,227,5265161
zapB_predicted,4.814814814814815,155,26,GCAAACGCGCTAGAAATCCT,129,5267196
zapB_predicted,3.4814814814814814,119,26,CGTGCAGCGGGAAATACTCT,93,5278809
zapB_predicted,0.07407407407407407,27,26,CCACGCACTCCTGTAGGAAG,1,5266232
zapB_predicted,33.2962962962963,924,26,CAATCTTTACGAGACAGTGT,898,5277686
zapB_predicted,0.07407407407407407,27,26,ATACTGGATTGCTATGGCTA,1,5275855
zapB_predicted,8.25925925925926,248,26,ACGTTACCTACCAAAACGTT,222,5274768
zapB_predicted,0.1111111111111111,28,26,ACCAGGTAGAACTTTGTCAC,2,5269732
zapB_predicted,0.07407407407407407,27,26,ACATCTGGTCTCTCCTTTGC,1,5287309
zapB_predicted,0.07407407407407407,27,26,AACTCCGACCGCTTCAACGT,1,5267544
zapB_predicted,0.07692307692307693,26,25,TCTGGGTGAAAAATGCATTC,1,5279121
zapB_predicted,16.653846153846153,457,25,TCGAGCCGTCGCGCACTGAA,432,5263411
zapB_predicted,0.07692307692307693,26,25,GTGTGACTATGATATCGTGC,1,5278187
zapB_predicted,7.576923076923077,221,25,GGGTTGCTCGCGTTTCGTTG,196,5275429
zapB_predicted,8.384615384615385,242,25,GGATTCTTGGCTCGTCCATT,217,5271488
zapB_predicted,7.038461538461538,207,25,GCAAGGTGTCTCAAATAACA,182,5267288
zapB_predicted,0.07692307692307693,26,25,GACGGACAGGCTCGGTGAGA,1,5269501
zapB_predicted,0.07692307692307693,26,25,CTTTCCCCCCCAGTCGCCCG,1,5267879
zapB_predicted,8.807692307692308,253,25,CTTTATAGCCAGGCTTAAAT,228,5268330
zapB_predicted,0.11538461538461539,27,25,CGCAGGTCTACCAAGGGGGA,2,5280483
zapB_predicted,0.07692307692307693,26,25,CCTGCACCCAGGTTATATAT,1,5282941
zapB_predicted,0.07692307692307693,26,25,CAAATCCACGGTACTAGGCA,1,5277771
zapB_predicted,0.11538461538461539,27,25,CAAACCGACGTCAAGTAAAC,2,5281268
zapB_predicted,20.923076923076923,568,25,ATGTCGTGCGAAGGCGCCAC,543,5264249
zapB_predicted,8.923076923076923,256,25,ATCACTTCCGGTGATATATA,231,5278490
zapB_predicted,0.11538461538461539,27,25,ATACAACGGCCGACCAAACC,2,5275351
zapB_predicted,0.07692307692307693,26,25,ACATGTAAGATTGCTAATTC,1,5287722
zapB_predicted,0.11538461538461539,27,25,AACTCAATGAGGGCTCCTAT,2,5263437
zapB_predicted,0.08,25,24,TTGTGACACTGCTGGTATTG,1,5280791
zapB_predicted,0.08,25,24,TTGGTTCTGTGAGAGGCCCA,1,5263347
zapB_predicted,0.28,30,24,TTGGGTTTTCAAATGCATGA,6,5273287
zapB_predicted,8.6,238,24,TCTCAGCTGGAAGGGAAGTT,214,5283753
zapB_predicted,0.08,25,24,TCCAAACAACACGCCACGTA,1,5279919
zapB_predicted,0.08,25,24,GTGTCGATGAATCGGCGCAA,1,5269856
zapB_predicted,9.24,254,24,GCCGGGTCTCGCAATTAACT,230,5263388
zapB_predicted,0.08,25,24,GAATAATCAAAGGCCGATAA,1,5266012
zapB_predicted,5.4,158,24,CTACCCGAAGTTAGCCGTAT,134,5278238
zapB_predicted,4.8,143,24,CGTTACGTCAACGTGGGGGT,119,5263137
zapB_predicted,0.08,25,24,CGCGGGGGGGTCGCCCTGTG,1,5266645
zapB_predicted,0.08,25,24,CATAATTTAGGGTCGGACGA,1,5267081
zapB_predicted,0.08333333333333333,24,23,TCGGGAAAGCGCTTTGGTTT,1,5274075
zapB_predicted,10.75,280,23,TCATGTCTGTTATATCGATG,257,5275926
zapB_predicted,0.08333333333333333,24,23,TCACGGTGAACGCCTCGCTA,1,5279963
zapB_predicted,8.916666666666666,236,23,TACCGGGTTGTCCGCGGATG,213,5268240
zapB_predicted,0.08333333333333333,24,23,GTCTCGTCTCCTGGCGAATC,1,5263993
zapB_predicted,17.958333333333332,453,23,GGTGCAAATTACACTCTGCA,430,5276629
zapB_predicted,0.125,25,23,GCTAACTTAATGGGGCCGAA,2,5268147
zapB_predicted,3.4583333333333335,105,23,GATTCGCATCATCCGTACAA,82,5266383
zapB_predicted,0.08333333333333333,24,23,GAGTTCAAATCTGTCCTCTT,1,5269792
zapB_predicted,0.08333333333333333,24,23,GAGTGCAAAATAGTCTCTTT,1,5272030
zapB_predicted,16.75,424,23,CGAATATCAACCCACTTTCT,401,5265530
zapB_predicted,3.7916666666666665,113,23,CCGGGCCATACATTCACGGC,90,5278441
zapB_predicted,6.666666666666667,182,23,ATCATGCAGTTCCATGAACA,159,5281885
zapB_predicted,7.666666666666667,206,23,AGCTAGGCGCTGCATCTGTG,183,5265956
zapB_predicted,0.08333333333333333,24,23,ACTACGATCTTGACCAGTCT,1,5281222
zapB_predicted,26.333333333333332,654,23,ACGGATAGGCAGGCTTCGGT,631,5267304
zapB_predicted,10.08695652173913,253,22,TCCGTTGGGGGGTTGTGCGA,231,5270469
zapB_predicted,0.13043478260869565,24,22,TCATCTTGCGCACCGCCTAT,2,5271274
zapB_predicted,9.434782608695652,238,22,GGGGACCGGTCGATTGCCTC,216,5265436
zapB_predicted,0.08695652173913043,23,22,GGCGAGTTCAGATTACGCGG,1,5276685
zapB_predicted,0.17391304347826086,25,22,GCCTAAAAATGTGCAATTGT,3,5270277
zapB_predicted,0.08695652173913043,23,22,GATCCCTCAGGCAGAAATTA,1,5270274
zapB_predicted,8.391304347826088,214,22,GAATTTTGCGCGCTAATCGG,192,5265510
zapB_predicted,3.9565217391304346,112,22,CGCAGTCCACGTATCGTTTC,90,5283243
zapB_predicted,4.782608695652174,131,22,CCCTATATCTTTGATCATGC,109,5276670
zapB_predicted,0.08695652173913043,23,22,CCCGCCCGCGGACGTCAGAC,1,5267832
zapB_predicted,0.13043478260869565,24,22,CATAGTCTCGGGGATCTTGA,2,5277091
zapB_predicted,0.08695652173913043,23,22,ATACAGATTGGTCTGTAGCT,1,5270975
zapB_predicted,0.08695652173913043,23,22,ACGTCAGCACTTACGGCTTA,1,5286243
zapB_predicted,4.217391304347826,118,22,AATTACTTTGACTATTACGA,96,5282535
zapB_predicted,0.09090909090909091,22,21,TGTAACCGGTGTAGCAGCAG,1,5286970
zapB_predicted,10.818181818181818,258,21,TCCAGAATCAGATGAAGTCC,237,5268831
zapB_predicted,0.13636363636363635,23,21,GGTGAGGACTCGATGGCATA,2,5277370
zapB_predicted,0.09090909090909091,22,21,GGTCCAGTGTGTTCCATCAA,1,5267366
zapB_predicted,0.09090909090909091,22,21,CTTCGCCAATCCTTAATCAG,1,5276344
zapB_predicted,0.13636363636363635,23,21,CTCCCCACACACATGCCCCA,2,5269025
zapB_predicted,11.363636363636363,270,21,CCTTGATTACCCATTGGATC,249,5275959
zapB_predicted,0.13636363636363635,23,21,CCCATCTGTTTCAAAAACTG,2,5268374
zapB_predicted,18.818181818181817,434,21,CAGACTCCTCACAAAATTGG,413,5268661
zapB_predicted,1.0909090909090908,44,21,AGTTCGACCTAGGCCGTCAG,23,5278189
zapB_predicted,19.863636363636363,457,21,AAAGTATACCGTACAGCCTA,436,5273892
zapB_predicted,0.09523809523809523,21,20,TTTCAGAGTGTCCAGCGGCC,1,5280160
zapB_predicted,10.523809523809524,240,20,TGATCTGCCAGAACCCGTAT,220,5277088
zapB_predicted,0.09523809523809523,21,20,TGATATGTTCGGCGGAGAGT,1,5284366
zapB_predicted,0.09523809523809523,21,20,GTCCTATTCCAGCAAAACTT,1,5273526
zapB_predicted,0.14285714285714285,22,20,GTATCTCCTTGGACAGCAGG,2,5270717
zapB_predicted,0.09523809523809523,21,20,GGTTGGCCACCCGATTGGCT,1,5277975
zapB_predicted,0.09523809523809523,21,20,GGGTCTGAAGGCACGCTGGT,1,5268258
zapB_predicted,9.761904761904763,224,20,GGCTGAGGGACGCTAACTGC,204,5272199
zapB_predicted,8.952380952380953,207,20,GCAACGGTATTATAGGGGCG,187,5270216
zapB_predicted,0.19047619047619047,23,20,GACGGAGTCTGTCTTACAAT,3,5272842
zapB_predicted,0.09523809523809523,21,20,CGGCTACCAGGGCCTTGTTC,1,5264011
zapB_predicted,9.523809523809524,219,20,CCTTTGTACTTAGGTCCGAA,199,5267636
zapB_predicted,9.238095238095237,213,20,ATCCTTGACATAACTCAATG,193,5269896
zapB_predicted,0.09523809523809523,21,20,AGGGATGGGCACGTTGGGTT,1,5273724
zapB_predicted,0.09523809523809523,21,20,AGAGCGATAAAGGACTGGCA,1,5267856
zapB_predicted,0.09523809523809523,21,20,ACGCCAAGGATGGGAGCGCG,1,5263749
zapB_predicted,0.23809523809523808,24,20,AACGGCTTCAACCACGTCGC,4,5277198
zapB_predicted,0.1,20,19,TTGGGAGCGGCCTGGACACA,1,5264721
zapB_predicted,0.1,20,19,TGTGGGGACATCTAGGTTTT,1,5287016
zapB_predicted,0.1,20,19,TCACGATCATGCGACCCCGA,1,5281597
zapB_predicted,0.1,20,19,GGCCCCTTTCGCAGAGACCT,1,5269748
zapB_predicted,5.65,131,19,GCTAGTTCATTTCTTTTGAG,112,5284662
zapB_predicted,0.1,20,19,CTACACCAGTGACCGGGGTG,1,5268887
zapB_predicted,0.2,22,19,CGTAAGGGATAGTTTAAGTG,3,5263821
zapB_predicted,18.1,380,19,CGGCCCCAGGCAGCTTTGCT,361,5264562
zapB_predicted,11.0,238,19,CGACATTAGTAATGCAGGGG,219,5270689
zapB_predicted,11.9,256,19,CCTAACGTCCGAGGGTTTGT,237,5276313
zapB_predicted,0.1,20,19,CCCCCGTAACTTGGCGGTTG,1,5280801
zapB_predicted,0.1,20,19,CAGTAAAGATTATCAATTCT,1,5284338
zapB_predicted,0.1,20,19,ATTCTCCGACCCTTGGCTTC,1,5265699
zapB_predicted,4.65,111,19,ATTCGGAGTATCCTAAGCAT,92,5282492
zapB_predicted,23.7,492,19,ATGCTCTCGTCGTGTTGTCT,473,5281932
zapB_predicted,25.3,524,19,ATCCCCTGCAAACCTCTCGG,505,5270166
zapB_predicted,0.1,20,19,ATCACCTCGTGCGTAAAGAT,1,5274081
zapB_predicted,10.7,232,19,AGGAAGGAAGTCAAGGCATC,213,5267738
zapB_predicted,13.31578947368421,270,18,TTCGGCCATTCGTCGATGAT,252,5266646
zapB_predicted,11.157894736842104,229,18,TTATTCATTCAATCCGGTCA,211,5265209
zapB_predicted,0.10526315789473684,19,18,TGGAACTGAGTCCATCGGTA,1,5277233
zapB_predicted,0.10526315789473684,19,18,TCTATCTACAGCATTGCTCT,1,5282084
zapB_predicted,0.10526315789473684,19,18,TCGTTATATTGGATCCACCG,1,5263568
zapB_predicted,21.42105263157895,424,18,TCGCTCCGACGTTATCCGCA,406,5276155
zapB_predicted,11.526315789473685,236,18,TCCAACACATCGTATACGCA,218,5288299
zapB_predicted,0.21052631578947367,21,18,TAGAGTCTGATATCGCCAGC,3,5273355
zapB_predicted,0.10526315789473684,19,18,TAGAGAACGGCTAAATATGC,1,5263258
zapB_predicted,12.421052631578947,253,18,GTTCGATGAAGGGGCTAGGT,235,5276635
zapB_predicted,12.368421052631579,252,18,GTAGTATTGATTTTCTTATC,234,5274153
zapB_predicted,12.157894736842104,248,18,GGCTGGCATAATCTGGAACT,230,5280366
zapB_predicted,0.10526315789473684,19,18,GGCGGGCGAGTCACTCCGGG,1,5280619
zapB_predicted,0.10526315789473684,19,18,GGAACTTGTCAATTAATTTT,1,5271471
zapB_predicted,14.368421052631579,290,18,GCGCGGGAGACAAATGATGT,272,5265905
zapB_predicted,0.10526315789473684,19,18,GCACGAGGAGTCATCGCGTA,1,5266387
zapB_predicted,0.10526315789473684,19,18,GAAGGGCTTCGTCCAGATAG,1,5285251
zapB_predicted,11.105263157894736,228,18,CTGGCCGGGATCAAGGAACT,210,5267523
zapB_predicted,9.31578947368421,194,18,CTCCACATCGAGAGTCCAGA,176,5266962
zapB_predicted,11.0,226,18,CGGCAAGCTGTCGTGATAAT,208,5275324
zapB_predicted,0.10526315789473684,19,18,CGCTCCAAAGGAAATTTCTA,1,5276753
zapB_predicted,0.21052631578947367,21,18,CCTAGCACGGGTATGCTGCT,3,5286077
zapB_predicted,8.894736842105264,186,18,CCACGAGTATGTGCTTTCAG,168,5275785
zapB_predicted,12.842105263157896,261,18,CAGTGGATACAGGTCGTATG,243,5271415
zapB_predicted,18.68421052631579,372,18,CACCGCCCAAGGCGCACGCA,354,5282088
zapB_predicted,5.368421052631579,119,18,CACATCTGTGGCGACAGGTC,101,5280364
zapB_predicted,0.10526315789473684,19,18,AGCCAGTCAAGGCTTGGGAC,1,5270082
zapB_predicted,0.10526315789473684,19,18,ACTTACATACCATGGGGATG,1,5276907
zapB_predicted,0.10526315789473684,19,18,ACGGGTCTCAGTTCAGACAC,1,5264138
zapB_predicted,0.10526315789473684,19,18,ACGCAACCCAAACGAGTCAA,1,5276843
zapB_predicted,11.421052631578947,234,18,AAGTGCAAGCTTTGGCTGGC,216,5270574
zapB_predicted,0.16666666666666666,19,17,TCTGATCTTCATTTGGTCGC,2,5282641
zapB_predicted,12.333333333333334,238,17,TCGGAGAGAACGGTCCATTG,221,5265318
zapB_predicted,11.333333333333334,220,17,TCCTTGCCGATAGCCGGACA,203,5280482
zapB_predicted,0.16666666666666666,19,17,TCCGTGTGGATTACTTCCTA,2,5274232
zapB_predicted,0.1111111111111111,18,17,GTTAGATCGTAACATCCTCT,1,5270879
zapB_predicted,23.5,439,17,GTGGCTGTGGGTCCATCGTC,422,5274155
zapB_predicted,20.944444444444443,393,17,GGCTAAGCAGGCATATGGTA,376,5277066
zapB_predicted,7.5,151,17,GGCGCAACTGTCCCGATTAC,134,5274040
zapB_predicted,0.1111111111111111,18,17,GGCATGCGCCACATAGGGTC,1,5278523
zapB_predicted,10.38888888888889,203,17,GCTGGGGAGAACTGATCCCA,186,5265848
zapB_predicted,13.222222222222221,254,17,GCTCCTTGAGAAAGGGGTAA,237,5280835
zapB_predicted,0.1111111111111111,18,17,GCACGGACCACGTAGCCTCA,1,5271505
zapB_predicted,7.666666666666667,154,17,CTGCCCTGCCGAGCCAAAAG,137,5267193
zapB_predicted,14.5,277,17,CCTCCGAAGTTATTGAGATG,260,5278318
zapB_predicted,0.1111111111111111,18,17,CCGGGTCTAAGAAATAGGTA,1,5270630
zapB_predicted,0.16666666666666666,19,17,CCGGGCACGATGCTTCAAAT,2,5286063
zapB_predicted,12.944444444444445,249,17,ATCCAAACATTCGGTTATAT,232,5264783
zapB_predicted,0.1111111111111111,18,17,AGTGTTCATCGGCCGACCAC,1,5279811
zapB_predicted,9.88888888888889,194,17,AGGCATACACCCACCCCCGA,177,5276673
zapB_predicted,0.1111111111111111,18,17,AGGATCATGGAAGAAGGGTT,1,5264916
zapB_predicted,0.1111111111111111,18,17,AGCTCAACTCAAAAGCTGTG,1,5281053
zapB_predicted,0.1111111111111111,18,17,AGACACATGAGGTTACGCAG,1,5267835
zapB_predicted,6.833333333333333,139,17,AGAATCGGCCACGCAACGGC,122,5263609
zapB_predicted,12.944444444444445,249,17,ACGTTTAGAGGCCATTGTCT,232,5276895
zapB_predicted,0.11764705882352941,17,16,TTGGCGTTCAACCCGTACGT,1,5285513
zapB_predicted,0.11764705882352941,17,16,TGTTCCACCAAGATTTTTTA,1,5285724
zapB_predicted,13.294117647058824,241,16,TGGCGAGGCCGACCCTGCGC,225,5282183
zapB_predicted,12.470588235294118,227,16,TGCGTTTGGCCGCCCCACAC,211,5268360
zapB_predicted,0.17647058823529413,18,16,TGCCGCTGGTTCAGGCTTTT,2,5286825
zapB_predicted,25.88235294117647,455,16,TGAGGTCGCAATGAGGGGGT,439,5282390
zapB_predicted,3.823529411764706,80,16,GTGCCTTGAATTCATGCTCT,64,5275131
zapB_predicted,0.11764705882352941,17,16,GGTGTGCCCCATAGTTCTGT,1,5278395
zapB_predicted,0.11764705882352941,17,16,GGTGAGGATGGTGGAAGGCA,1,5274018
zapB_predicted,0.11764705882352941,17,16,GGTAAAGGTGCCGGTGTGAG,1,5267031
zapB_predicted,0.11764705882352941,17,16,GCTAGAGCGGTATAGTCTTC,1,5275240
zapB_predicted,11.294117647058824,207,16,GCCTATCTTTCACCTGCCGC,191,5269716
zapB_predicted,0.11764705882352941,17,16,GCAGTTCGTGGGGAGGGTGA,1,5263434
zapB_predicted,10.764705882352942,198,16,GAGATAGGACAATGGATTCA,182,5279681
zapB_predicted,0.11764705882352941,17,16,GAACAGACTTCAGTCTTTTA,1,5279924
zapB_predicted,11.176470588235293,205,16,CTCCCGGGGCGGAATTACCA,189,5279861
zapB_predicted,10.882352941176471,200,16,CTATGTACACGTGAAAAGCA,184,5271008
zapB_predicted,0.11764705882352941,17,16,CCTGTAAGCCTTTGCTTCCC,1,5285127
zapB_predicted,0.11764705882352941,17,16,CCGTAAAAAGCCCTGAGCGT,1,5268758
zapB_predicted,0.11764705882352941,17,16,CCAGGTGATCCTGCATTTAC,1,5282741
zapB_predicted,0.11764705882352941,17,16,AGTATAACTTCGTAAACGGA,1,5274203
zapB_predicted,5.352941176470588,106,16,ACGTACACCGTATTAGCACT,90,5263726
zapB_predicted,22.647058823529413,400,16,AACGTGGTTAGTAAAGATCA,384,5264965
zapB_predicted,8.0625,143,15,TTGATTTTTATAGCTCATCT,128,5273007
zapB_predicted,0.125,16,15,TCCTCACATTGGTGATAATT,1,5276370
zapB_predicted,13.875,236,15,TATTGTACGGTCATCGAGGC,221,5283747
zapB_predicted,0.125,16,15,TACAAGCTACAACCTGCAGA,1,5283212
zapB_predicted,0.25,18,15,TAAGAGGAGAAGAACATGCT,3,5269899
zapB_predicted,6.625,120,15,GTATACCTGAATCCTCCATG,105,5273792
zapB_predicted,0.125,16,15,GGACCAGGCATAGAACCAGA,1,5267751
zapB_predicted,0.1875,17,15,GATCTAGAGCTGTGGCGTTT,2,5267037
zapB_predicted,0.125,16,15,CTTCCCCCTACGTGGGGTAA,1,5269839
zapB_predicted,6.0625,111,15,CGCAGTGCGCAGGGTTCTCC,96,5266236
zapB_predicted,0.125,16,15,CCCTTTATTCTTCACATTTC,1,5269798
zapB_predicted,0.125,16,15,CCCACTTGAAGACACAACCT,1,5286734
zapB_predicted,0.125,16,15,CACATGGAATAGGTAGATGC,1,5282608
zapB_predicted,11.9375,205,15,CACAGTCCGTCGTATGGGCA,190,5264925
zapB_predicted,39.75,650,15,ATTACGGCACCAACACCAGT,635,5276219
zapB_predicted,31.125,512,15,AGGTAGGGGCAATCCAAGCT,497,5272716
zapB_predicted,0.375,20,15,AGGAAAGTCGAGCACGTCTA,5,5279449
zapB_predicted,0.125,16,15,AGAAGAAACGCCATGAGAGC,1,5277972
zapB_predicted,7.625,136,15,ACTTGTGATGACTTTCCACT,121,5266780
zapB_predicted,0.125,16,15,ACGGTCCTATAGACGACCAC,1,5268096
zapB_predicted,0.13333333333333333,15,14,TTTCCCGAGTTAGTCTTGAT,1,5287504
zapB_predicted,33.13333333333333,510,14,TTTAGTCCGTTGGAAAAACC,496,5280705
zapB_predicted,0.13333333333333333,15,14,TTCTGTCTCTTGTCGTCAAC,1,5265182
zapB_predicted,0.13333333333333333,15,14,TGCTTCCAGCGGCCCGGTGC,1,5274716
zapB_predicted,0.13333333333333333,15,14,TGAACAGGGTCCGACAGGTT,1,5272130
zapB_predicted,13.6,217,14,TCTGTATAGATCCTCCCGTT,203,5265786
zapB_predicted,11.733333333333333,189,14,TCATGTAACATCGGCGAGTC,175,5264921
zapB_predicted,0.2,16,14,TATTTACATGCGACAATATT,2,5277482
zapB_predicted,14.266666666666667,227,14,GTCCGGTCTTGTCAAGTCAG,213,5272289
zapB_predicted,0.13333333333333333,15,14,GGTACGGACCGGGGGAGTGA,1,5266521
zapB_predicted,0.13333333333333333,15,14,GGGATGTGGCCCTGCTCCAG,1,5266290
zapB_predicted,0.13333333333333333,15,14,GGCACCAGATCTCGGAACAA,1,5272139
zapB_predicted,0.13333333333333333,15,14,GCGGTTTAGACGGCTTTTGT,1,5278013
zapB_predicted,15.866666666666667,251,14,GCCTGAGTAAGTAGTCCCGT,237,5268834
zapB_predicted,27.666666666666668,428,14,GCAAACTGTATAGCGTGTCA,414,5287815
zapB_predicted,13.466666666666667,215,14,GACCCTTAAGATACGACATT,201,5285117
zapB_predicted,16.266666666666666,257,14,CTCACCGAGCGTGCTGGGGA,243,5281070
zapB_predicted,13.733333333333333,219,14,CTAAAAACTGCCCTTCATCG,205,5283808
zapB_predicted,11.533333333333333,186,14,CGTTCTTTTTGATCGCCAGT,172,5264561
zapB_predicted,0.13333333333333333,15,14,CGGCCGGCGCCAGCCACCCG,1,5264112
zapB_predicted,0.13333333333333333,15,14,CCCACCCCGCACCGGACAGG,1,5276418
zapB_predicted,16.733333333333334,264,14,ATGCCCGGAGGCGACATAGG,250,5277929
zapB_predicted,0.13333333333333333,15,14,AGGGATCAGACCTCCGGGTT,1,5280773
zapB_predicted,0.13333333333333333,15,14,ACGCCGGGTCTGCCGAAGAA,1,5277616
zapB_predicted,16.8,265,14,ACGACTTATCTGGCCCTTCT,251,5286080
zapB_predicted,0.13333333333333333,15,14,AAGATAGTGGTTTGTAGAGG,1,5278166
zapB_predicted,13.066666666666666,209,14,AAGACATTACCCGCTACGGC,195,5271088
zapB_predicted,0.13333333333333333,15,14,AACTCAAGGCTTTACACCCA,1,5271634
zapB_predicted,0.13333333333333333,15,14,AACATCTGACCCGACCGAAT,1,5278319
zapB_predicted,0.13333333333333333,15,14,AAACGAGGTTCGTCCACTAA,1,5288021
zapB_predicted,9.5,145,13,TTCTGACGTCCACGGTTGCT,132,5276215
zapB_predicted,0.14285714285714285,14,13,TGTGCCTTCACTCTCGAACC,1,5269965
zapB_predicted,0.14285714285714285,14,13,TGGCACACAGTTGGCAAGTT,1,5284299
zapB_predicted,0.14285714285714285,14,13,TGATTTGACATACCGCAGTA,1,5279069
zapB_predicted,0.14285714285714285,14,13,TATTTCCCTCCCAATTTCCG,1,5275323
zapB_predicted,17.285714285714285,254,13,TAATACCAGACTCCGTTAAT,241,5263421
zapB_predicted,0.14285714285714285,14,13,GCGTCCCCGGGGAACCGCGT,1,5264993
zapB_predicted,10.785714285714286,163,13,GCGGAGTAGCATTATGACTG,150,5284364
zapB_predicted,25.571428571428573,370,13,GCATCGCCCCAGAGTGCCTA,357,5264585
zapB_predicted,19.0,278,13,GCACGGATCCTTATAGTTTA,265,5279904
zapB_predicted,0.14285714285714285,14,13,GATCCCATCGAGGGGATTCA,1,5267134
zapB_predicted,12.642857142857142,189,13,CTTTTATGCTATACTCGGTC,176,5272193
zapB_predicted,16.428571428571427,242,13,CTTTATAGAGCGGGGTAGCC,229,5268105
zapB_predicted,0.2857142857142857,16,13,CTGTAAAACCAAGAGAGCTA,3,5269626
zapB_predicted,0.14285714285714285,14,13,CCGAACGATTGCGTGGTTTA,1,5264507
zapB_predicted,0.35714285714285715,17,13,CCCGGTATTCCCATTTAGCA,4,5265129
zapB_predicted,34.142857142857146,490,13,CCAGGGAAAACTGTCATCAC,477,5282749
zapB_predicted,10.571428571428571,160,13,CCAATGGAAAACCAAGGTGT,147,5270882
zapB_predicted,15.642857142857142,231,13,CCAACGTTAGGCGTCAGAAG,218,5269937
zapB_predicted,0.14285714285714285,14,13,CAGGACAGCTCTCCTAAAGT,1,5269441
zapB_predicted,0.14285714285714285,14,13,CAAGAGTTCCCATAGAACTA,1,5268262
zapB_predicted,0.5,19,13,CAACACAGCCCGCTTAAAGA,6,5285510
zapB_predicted,0.21428571428571427,15,13,ATGATTGGTTCTATTACACG,2,5269139
zapB_predicted,0.14285714285714285,14,13,AGTTCCCAGATACACTGGAG,1,5287597
zapB_predicted,0.14285714285714285,14,13,AGTTCATAAGACGGTAACAG,1,5286167
zapB_predicted,0.14285714285714285,14,13,AGGTCCCCCCCGTTCTCTAT,1,5276312
zapB_predicted,0.21428571428571427,15,13,AGCGTGTGATTTAGAACTCG,2,5281110
zapB_predicted,0.14285714285714285,14,13,ACCATTTGGCCATATAGGTC,1,5278905
zapB_predicted,0.14285714285714285,14,13,ACCAGCGCCGGGTTGTAGTT,1,5269854
zapB_predicted,0.14285714285714285,14,13,AATTTTATAGGGAGTTGTCA,1,5273096
zapB_predicted,0.15384615384615385,13,12,TTATGTCTTGGGGGTAGGGT,1,5288230
zapB_predicted,0.15384615384615385,13,12,TGTACTTTGGCCGTCATAGG,1,5275362
zapB_predicted,0.15384615384615385,13,12,TGGAAGCGCTACCGTAGAAC,1,5266705
zapB_predicted,0.15384615384615385,13,12,TGAAGCCAGGTGGCACCCAC,1,5268673
zapB_predicted,12.76923076923077,177,12,TCTATTCACTGTTGTAATAT,165,5270981
zapB_predicted,0.3076923076923077,15,12,TCTAACGTCTTCAGCCTTTC,3,5284235
zapB_predicted,0.23076923076923078,14,12,TCACTAAACCAGCAAGATCT,2,5277952
zapB_predicted,0.15384615384615385,13,12,TCACACGCCCATACTATGAG,1,5281359
zapB_predicted,18.384615384615383,250,12,TATCTTAGATAAGATGCGCT,238,5269513
zapB_predicted,16.53846153846154,226,12,TAATTCGAAATGGGAGGTGA,214,5264906
zapB_predicted,0.15384615384615385,13,12,GTTTACCATGAAGGCGTAAC,1,5265515
zapB_predicted,0.15384615384615385,13,12,GTGCGGGACCTCACAGAACC,1,5263925
zapB_predicted,0.15384615384615385,13,12,GTGACAAGAAATTGAACTAC,1,5283147
zapB_predicted,17.384615384615383,237,12,GTCGTAGTGGCTCTCTGCCA,225,5280256
zapB_predicted,0.15384615384615385,13,12,GTCAAGTGTGCTTGATTACT,1,5274776
zapB_predicted,16.23076923076923,222,12,GTATCTTCGTCGTCATCTAA,210,5264418
zapB_predicted,14.538461538461538,200,12,GGGCTCGAAGCTGACACCAA,188,5266998
zapB_predicted,18.846153846153847,256,12,GGACCTCGTTGAGGTGTGTG,244,5275293
zapB_predicted,0.15384615384615385,13,12,GCGGCGCTGTCAAAGTCATC,1,5286186
zapB_predicted,0.15384615384615385,13,12,GCGCCTGCCCCCGGCGGGTT,1,5282241
zapB_predicted,0.15384615384615385,13,12,GCCGGAAGGGCGGGCAAGTT,1,5286181
zapB_predicted,16.53846153846154,226,12,GACAATCTGACCCGACTTTA,214,5270940
zapB_predicted,0.3076923076923077,15,12,CTCTTATTTAGCCCCTGGAC,3,5275412
zapB_predicted,19.307692307692307,262,12,CGATGAGGCGTAGGACATGA,250,5266994
zapB_predicted,0.15384615384615385,13,12,CCGGCTTAGCGCAGCCAGTA,1,5266163
zapB_predicted,0.23076923076923078,14,12,CCCACTATGGAGACGCGCGC,2,5273881
zapB_predicted,0.15384615384615385,13,12,ATCTCCCCATCAACCACTAC,1,5276205
zapB_predicted,0.15384615384615385,13,12,AGTCACCAATTCATGCAAGA,1,5263335
zapB_predicted,15.615384615384615,214,12,AGCTTCGGTCAAAGTAATTC,202,5287840
zapB_predicted,17.846153846153847,243,12,ACTACCCGAGCGTTCAAATT,231,5269663
zapB_predicted,17.23076923076923,235,12,ACGTTCCGGGTGAAAGACAC,223,5286183
zapB_predicted,0.15384615384615385,13,12,ACCCGAGTTTTAAGAGATTT,1,5269903
zapB_predicted,0.15384615384615385,13,12,AATGTCTTCCGGTTGCTGCC,1,5271456
zapB_predicted,18.615384615384617,253,12,AACCAAATTGAATTAAGAGG,241,5286006
zapB_predicted,0.16666666666666666,12,11,TTTTGTGCTGTCGTTAAAGT,1,5287645
zapB_predicted,17.0,214,11,TTCCATGGCCGGAACACAGT,203,5285722
zapB_predicted,0.16666666666666666,12,11,TTATGAGTGGTGTCTGAGCC,1,5281815
zapB_predicted,0.16666666666666666,12,11,TGCTATGTACGAGCACGTCG,1,5274493
zapB_predicted,4.0,58,11,TGAGTCCTAATATTGCCTGC,47,5265629
zapB_predicted,0.16666666666666666,12,11,TCTATGTTTGCCCCGTCCTA,1,5286221
zapB_predicted,16.75,211,11,GTCACCAAGGTCCACTTTTA,200,5265533
zapB_predicted,17.916666666666668,225,11,GGCCGTTAATAAATCTCTGA,214,5282570
zapB_predicted,0.16666666666666666,12,11,GGAGGTGATTTATTAATAAA,1,5263412
zapB_predicted,0.16666666666666666,12,11,GCAAGTACGCAACGAGCACA,1,5281705
zapB_predicted,22.25,277,11,GACGTTCGGTTATTGGAGGA,266,5284797
zapB_predicted,0.16666666666666666,12,11,CTGTCCAAGCGGAGAGACCC,1,5275697
zapB_predicted,0.25,13,11,CTCGGGCAGTTTAAAGAGAT,2,5273194
zapB_predicted,0.16666666666666666,12,11,CGTGTAAAGTTTTAATAAAT,1,5284938
zapB_predicted,0.16666666666666666,12,11,CGTCATCTGAATGGCTGGAG,1,5270299
zapB_predicted,0.16666666666666666,12,11,CGTATAATCTGCGCGTCGAG,1,5288271
zapB_predicted,12.666666666666666,162,11,CGCTAGCGACCGGCCGATGT,151,5277881
zapB_predicted,0.16666666666666666,12,11,CCGCAGCACAGCGAAATCGG,1,5277953
zapB_predicted,0.16666666666666666,12,11,CATCGAAGTGAAGATTAACG,1,5273508
zapB_predicted,10.833333333333334,140,11,CATAACTGAGCAATGCCTTC,129,5284653
zapB_predicted,0.25,13,11,CAGAGCTTTAGTGCGGCGCA,2,5276847
zapB_predicted,14.666666666666666,186,11,CACGTCCTCTACAAGCAACT,175,5283367
zapB_predicted,0.16666666666666666,12,11,CAAAATGAGAAATTCGTGGA,1,5285660
zapB_predicted,0.3333333333333333,14,11,ACTATTCCGGTATGCTGCGT,3,5281400
zapB_predicted,18.583333333333332,233,11,AATCTAAGCTCAGCTGCATC,222,5274306
zapB_predicted,0.16666666666666666,12,11,AAGTTGTTTGCCTCGCGCGC,1,5273693
zapB_predicted,0.16666666666666666,12,11,AAGCACGAGGCAATTGAAAT,1,5280750
zapB_predicted,6.75,91,11,AACTCTTTAGGTGAGGGCGA,80,5280672
zapB_predicted,0.18181818181818182,11,10,TGGGTGCTCGCTGGGCTGCA,1,5273583
zapB_predicted,41.81818181818182,469,10,TGCGGAAGGGTGATGGTCCG,459,5265166
zapB_predicted,33.81818181818182,381,10,TCGTGGGGAGTTAGCCGTAA,371,5281830
zapB_predicted,0.2727272727272727,12,10,TCCATCAGTCATTTCAGTAT,2,5272546
zapB_predicted,0.2727272727272727,12,10,TACGCTCACAACGCTAAACA,2,5276060
zapB_predicted,0.18181818181818182,11,10,TACCACAAGCGCTTAGCTCG,1,5266150
zapB_predicted,17.363636363636363,200,10,TAACTCGTCGGGGGCCATCC,190,5272776
zapB_predicted,12.818181818181818,150,10,GTAGCGCTCTTATGTTCTAT,140,5267767
zapB_predicted,0.2727272727272727,12,10,GTAATGTAGGTCGGAATAAT,2,5284241
zapB_predicted,10.272727272727273,122,10,GGTCAATTCCTGCGATGGAT,112,5282904
zapB_predicted,0.18181818181818182,11,10,GCTTAGGGGCTGCGCAATAT,1,5286745
zapB_predicted,0.18181818181818182,11,10,GCGTGATGTTAAGCGGGTAT,1,5272629
zapB_predicted,16.454545454545453,190,10,GCGGCAGTTTATGAAACGAA,180,5279310
zapB_predicted,0.18181818181818182,11,10,GCCTAAATTCGAAGCTAGCG,1,5269163
zapB_predicted,15.909090909090908,184,10,GCAGTTAATCTCACATTTGC,174,5273000
zapB_predicted,0.18181818181818182,11,10,GATCGGCAGTGAACATTATG,1,5265584
zapB_predicted,21.363636363636363,244,10,GATATCGTGGCGCGGGCGCT,234,5273775
zapB_predicted,0.18181818181818182,11,10,GAGCTTAACGGTAGAGACTT,1,5287688
zapB_predicted,0.18181818181818182,11,10,GAGCGTTCAACTTGTTCAAG,1,5277080
zapB_predicted,0.18181818181818182,11,10,CTTCCAAATGGGCGGCGGAA,1,5268364
zapB_predicted,0.18181818181818182,11,10,CTCGTCGTATTCTGAATATG,1,5279277
zapB_predicted,13.636363636363637,159,10,CTCAGAGGGTTGGCGCGCCT,149,5287607
zapB_predicted,0.18181818181818182,11,10,CCGGCTATATGGACCGTGAG,1,5265694
zapB_predicted,0.18181818181818182,11,10,CCCGTCGATTCCTCTGACCA,1,5265203
zapB_predicted,0.18181818181818182,11,10,CAGTCTTGTTATAAGTGACA,1,5269523
zapB_predicted,0.18181818181818182,11,10,CAGGCCAGCTCAGACCCGGT,1,5276486
zapB_predicted,0.18181818181818182,11,10,CACTTCGTGTAACTTCCGCA,1,5269215
zapB_predicted,11.090909090909092,131,10,CAAGGACCGAACCCTCGAGC,121,5263841
zapB_predicted,0.18181818181818182,11,10,AATCATTTACATACGTTTCT,1,5271313
zapB_predicted,0.2727272727272727,12,10,AATAGGAGTTCGATTCGAAT,2,5277913
zapB_predicted,20.818181818181817,238,10,AACCTAGCTTCATGGACCAG,228,5264863
zapB_predicted,0.18181818181818182,11,10,AACATACTTTTACTTAGATG,1,5284809
zapB_predicted,18.90909090909091,217,10,AAAAGTACCATATCGGAAGT,207,5271103
zapB_predicted,0.2,10,9,TTTTAGGTCATGGTCGGCAT,1,5280541
zapB_predicted,8.3,91,9,TTGGGCAGGACCTCATATGT,82,5271587
zapB_predicted,0.2,10,9,TTGAGCGCTGATATAACCCC,1,5273072
zapB_predicted,0.2,10,9,TTCAGTCCGCGGTGTACAAT,1,5285549
zapB_predicted,19.2,200,9,TGTCTAGTCCTCCACTGCTT,191,5274324
zapB_predicted,0.2,10,9,TGGCAATACGTCTGGTAGCT,1,5263474
zapB_predicted,16.8,176,9,TGCTTGGCAAATGGTCGCGC,167,5269773
zapB_predicted,17.8,186,9,TGCAAATCCGGGCAGCTCGG,177,5264351
zapB_predicted,9.5,103,9,TCGATGCCCCGTAGGCACGA,94,5267044
zapB_predicted,0.2,10,9,TCAAAGGTCCGACGTAGCTC,1,5273401
zapB_predicted,0.2,10,9,TAAGCCCCGGGGTGTCTAAC,1,5267696
zapB_predicted,0.2,10,9,GTGCGCAGCACGCGGGGATG,1,5269864
zapB_predicted,0.2,10,9,GCTGAAGGAAGTTCGATAAG,1,5267282
zapB_predicted,0.5,13,9,GATGCGCCTCCCCTCCAGGG,4,5275830
zapB_predicted,14.5,153,9,GAGGTACACTTAACGGGGCA,144,5265383
zapB_predicted,0.2,10,9,GAGGCCTGGACACACGTCCC,1,5267902
zapB_predicted,20.3,211,9,GAGAACTAGGATCAAAAGGC,202,5271308
zapB_predicted,0.2,10,9,GACACACGATTTGTGCTAAC,1,5276510
zapB_predicted,14.5,153,9,GAAGGCCCGCAATGCGATGT,144,5278343
zapB_predicted,22.3,231,9,GAAAACGTCGTCAGTGATGT,222,5274928
zapB_predicted,0.2,10,9,CTGTAGCGACTTGTCTTCCC,1,5270246
zapB_predicted,21.8,226,9,CTATGACCGACAATCCTGGA,217,5263082
zapB_predicted,18.5,193,9,CGGGCTGTTTATATTTTCGA,184,5271990
zapB_predicted,0.2,10,9,CCGAATCACATAGGTGTTGT,1,5275496
zapB_predicted,0.2,10,9,CCCTCTACTCGACTGGTAAT,1,5279937
zapB_predicted,18.8,196,9,ATTATGGGGGGAAACACAAC,187,5278921
zapB_predicted,0.2,10,9,ATTATGGACGTTTGCACGAG,1,5271608
zapB_predicted,20.2,210,9,AGGTAATTCAACTGATTGAA,201,5269666
zapB_predicted,0.3,11,9,AGATTGAAGGTGGGAGCCGG,2,5263615
zapB_predicted,25.4,262,9,ACGCGATCGTAGACTGGGGA,253,5275501
zapB_predicted,35.77777777777778,329,8,TTGTTCATGCTTACTGATAT,321,5285649
zapB_predicted,0.2222222222222222,9,8,TTGCAGTACGATAAGACATG,1,5285388
zapB_predicted,24.444444444444443,227,8,TTAGTGTAGAGATTCAGGTT,219,5278149
zapB_predicted,0.2222222222222222,9,8,TTAGGGAGTGTATCAATGTT,1,5268378
zapB_predicted,22.0,205,8,TTAATCCCGCCACATTTTTA,197,5286523
zapB_predicted,0.2222222222222222,9,8,TGATGATCGCATAGGCGCCA,1,5281696
zapB_predicted,0.3333333333333333,10,8,GGGGTCAGGCCATAATGCTA,2,5283256
zapB_predicted,0.2222222222222222,9,8,GGCGAGCTGGGTATAGCCAA,1,5274710
zapB_predicted,0.2222222222222222,9,8,GGCACTCCGACACCTGTGCA,1,5278853
zapB_predicted,0.2222222222222222,9,8,GCGGGATTGTTTTGAGCGGG,1,5268772
zapB_predicted,0.4444444444444444,11,8,GACGAGTTGACCCCAATTCA,3,5286391
zapB_predicted,0.2222222222222222,9,8,GACCAGGTAGCACCTTAACG,1,5278301
zapB_predicted,0.2222222222222222,9,8,GAATGGCTCGTGGCGATTTT,1,5273601
zapB_predicted,0.2222222222222222,9,8,CGTCTTCGATACAAGGATTT,1,5285517
zapB_predicted,0.2222222222222222,9,8,CGAACTCCCGGTGGGCAGGC,1,5269514
zapB_predicted,0.2222222222222222,9,8,CCCTGCTGCTGGAATTGATA,1,5286440
zapB_predicted,0.2222222222222222,9,8,CATGAGTCATCGCCTCGAAG,1,5271706
zapB_predicted,0.2222222222222222,9,8,CACCATCGCTAGAACCTCAA,1,5274700
zapB_predicted,0.2222222222222222,9,8,CAACAAAAATGGTTCCACCA,1,5273313
zapB_predicted,0.2222222222222222,9,8,ATTTTACAACATTTTCGTGT,1,5280177
zapB_predicted,0.2222222222222222,9,8,ATAGGGGTGTTGACTTGACT,1,5277406
zapB_predicted,0.2222222222222222,9,8,ATACGAACGACCGCGTGATT,1,5285720
zapB_predicted,0.3333333333333333,10,8,AGTGAGCTGCGCTACCTGCA,2,5266670
zapB_predicted,21.0,196,8,AGTAACTATAGTCGGACTGG,188,5274529
zapB_predicted,22.88888888888889,213,8,AGCATTTACCAGTGACACTT,205,5280838
zapB_predicted,46.55555555555556,426,8,ACTGCGCAGGCAGCCTGTCC,418,5283363
zapB_predicted,0.2222222222222222,9,8,ACGCCAGCCCATACGATTAA,1,5277025
zapB_predicted,0.2222222222222222,9,8,ACCCATCCGACGAAGATAGT,1,5278380
zapB_predicted,0.2222222222222222,9,8,ACATACCCCGGAATATAATC,1,5287081
zapB_predicted,10.777777777777779,104,8,AATACAAGGTGTAAGGCTAG,96,5282347
zapB_predicted,0.2222222222222222,9,8,AAGCACCCTCGTAAGTATGA,1,5284232
zapB_predicted,0.2222222222222222,9,8,AACATTCCCGAATATGTTTT,1,5268377
zapB_predicted,26.666666666666668,247,8,AAACGCCCACCTATCCCCCA,239,5280885
zapB_predicted,0.25,8,7,TTTGGGGTGAATTTCTTTCC,1,5280270
zapB_predicted,0.5,10,7,TTTGATAGTCTCATAGCCAT,3,5264248
zapB_predicted,27.5,226,7,TTGGATGGATGAAGGCATTT,219,5270891
zapB_predicted,0.25,8,7,TGCGGGAAATGTGAGTGACA,1,5282934
zapB_predicted,20.875,173,7,TCAAACAACAACGGGGAGTA,166,5277447
zapB_predicted,14.875,125,7,TAGGTCGAGGGTGAGCGTCC,118,5263686
zapB_predicted,0.25,8,7,TAGGAGATTGAATCTCCGCC,1,5283790
zapB_predicted,0.25,8,7,TACCTCTGGATTCTGTGAGA,1,5276644
zapB_predicted,16.75,140,7,TACATGCCACCTCCTTCGGA,133,5285327
zapB_predicted,0.375,9,7,GTTTCGCGGGCCAACACGCA,2,5284229
zapB_predicted,0.25,8,7,GGTGAGGACCCATCATTGGA,1,5277326
zapB_predicted,0.25,8,7,GGTAGGTAAATCCGGAGACG,1,5280725
zapB_predicted,0.375,9,7,GGTACCGTCTCTTCTGTCAC,2,5272004
zapB_predicted,0.25,8,7,GGCCTGACCTGGCAAACCAC,1,5267101
zapB_predicted,0.25,8,7,GCTCAAGCTCTAGAGCGTAC,1,5263439
zapB_predicted,0.25,8,7,GCGCAGGATGATGCATGAAC,1,5267459
zapB_predicted,29.25,240,7,GCCTGTATCAATTATCTAAA,233,5274519
zapB_predicted,0.25,8,7,GCCGTATTACTATTGGATTT,1,5264468
zapB_predicted,25.625,211,7,GCCCGCGAAACAAGATTTTT,204,5284462
zapB_predicted,0.25,8,7,GCAAAGCTAAGCCTGGCTGT,1,5278419
zapB_predicted,0.25,8,7,GACCTGTTACTAGACCCCTC,1,5285809
zapB_predicted,13.75,116,7,CTGCTTGCTTTGCATTTGTA,109,5267430
zapB_predicted,0.25,8,7,CGTTCCCAGATCGTCATTTG,1,5278060
zapB_predicted,23.75,196,7,CGCCGCGCCTGCCAGAACAA,189,5275997
zapB_predicted,0.25,8,7,CGCAAACGGCACACGCGCCT,1,5278483
zapB_predicted,0.25,8,7,CACTCCGTCACGACATCCAG,1,5266221
zapB_predicted,62.75,508,7,CAATGGACCAATAGTTCGGT,501,5278316
zapB_predicted,0.375,9,7,CAAACGTCAGCATCTGTCTC,2,5267033
zapB_predicted,13.375,113,7,ATGGTCACACGGAGCTGAAC,106,5285975
zapB_predicted,0.25,8,7,ATGGTCACACCGACTAAAGT,1,5276296
zapB_predicted,0.375,9,7,ATATAAGTAAACGCTAGGTG,2,5266748
zapB_predicted,15.875,133,7,ATAACGGTGATACGGGGAGC,126,5277707
zapB_predicted,0.375,9,7,AGTTTGCAGAAGGCAGAGCC,2,5280412
zapB_predicted,0.625,11,7,AGTCGGATGCACACAATGCA,4,5280840
zapB_predicted,0.25,8,7,ACTGCCAGAGTTTCGGACCC,1,5280224
zapB_predicted,26.5,218,7,ACTCGACTCCCGGCACGCTC,211,5271841
zapB_predicted,0.25,8,7,ACTCACCAGATCGTTTAAGA,1,5288397
zapB_predicted,0.25,8,7,ACCCCCGTCCTTCTCAGAAA,1,5287710
zapB_predicted,0.25,8,7,AATGACGTCACCATGAACTG,1,5266060
zapB_predicted,0.2857142857142857,7,6,TTGGTGGTCACACTTTGATA,1,5274482
zapB_predicted,0.2857142857142857,7,6,TGTTGTGGGTAGTCGATCGC,1,5277097
zapB_predicted,34.142857142857146,244,6,TCTATACTTTTAGCTCTCAA,238,5282426
zapB_predicted,0.2857142857142857,7,6,TCGCATGTATCACATAATGA,1,5273958
zapB_predicted,0.2857142857142857,7,6,TCCCCGGTCCGGATGCACTG,1,5270187
zapB_predicted,30.428571428571427,218,6,TCAGATTAATCATTGGCCTT,212,5280715
zapB_predicted,0.2857142857142857,7,6,TAGCCTGGTATTGTTGGGAA,1,5284725
zapB_predicted,37.285714285714285,266,6,TAAGGCCTTAATACAAATGT,260,5271028
zapB_predicted,0.2857142857142857,7,6,GTTGTAGGCCGACACCTTTG,1,5263415
zapB_predicted,37.142857142857146,265,6,GTGTTTGTTTACCTACCGTA,259,5265972
zapB_predicted,60.857142857142854,431,6,GGTGCTGGGATGCCCATTAT,425,5270779
zapB_predicted,0.2857142857142857,7,6,GGCTCTGTTTGAGTATTCAC,1,5286342
zapB_predicted,0.2857142857142857,7,6,GCCTCAAATAGCAACTCATA,1,5270860
zapB_predicted,0.42857142857142855,8,6,GAGGGCAGTCGGATTAGGTT,2,5287381
zapB_predicted,34.142857142857146,244,6,GACCCGTTCGCCCATCAAAG,238,5279869
zapB_predicted,27.142857142857142,195,6,GACAGGTGTCCGATCCTTGA,189,5287601
zapB_predicted,1.1428571428571428,13,6,GAAGGCTCCGTAACAGGGAA,7,5284328
zapB_predicted,0.2857142857142857,7,6,CTCGAGGGGTCGTTGGCGCA,1,5281993
zapB_predicted,0.5714285714285714,9,6,CTACGCGAATGTCTACCACA,3,5266384
zapB_predicted,28.285714285714285,203,6,CGCCATGGGGGGAGATAAGT,197,5268941
zapB_predicted,0.2857142857142857,7,6,CGAGCCAGACCTAGGTATCT,1,5285836
zapB_predicted,0.2857142857142857,7,6,CCTGTCCTACGTTATGGGAG,1,5269749
zapB_predicted,0.2857142857142857,7,6,CCTAGGCGCGGCAGAAGGTA,1,5286058
zapB_predicted,0.2857142857142857,7,6,CATATTGAATTGCGAGGTCA,1,5263321
zapB_predicted,26.571428571428573,191,6,CAGGATCATTTGTAGGGGGT,185,5288139
zapB_predicted,27.428571428571427,197,6,CACCTCCCCTTCGTGAAAAG,191,5274699
zapB_predicted,0.2857142857142857,7,6,CAACTCTTCGCACCTTAGAT,1,5277082
zapB_predicted,33.142857142857146,237,6,ATTCAATCTGTACGAACCTT,231,5277829
zapB_predicted,28.0,201,6,AGTCGTTTTTCGTTTGGGTA,195,5287604
zapB_predicted,36.57142857142857,261,6,AGAGTATGATCGTGTATGTC,255,5272071
zapB_predicted,35.42857142857143,253,6,ACATACTCGGAGTTAAACGT,247,5265531
zapB_predicted,0.2857142857142857,7,6,AACTTCCGTAGGCGTCAGGG,1,5273169
zapB_predicted,15.0,94,5,TTGGGTTTGACTGGTCAGCA,89,5280087
zapB_predicted,41.666666666666664,254,5,TTCGGACTCTCAACGTGAAG,249,5281831
zapB_predicted,0.5,7,5,TTACTAAAGTCGATCTATCA,2,5281833
zapB_predicted,0.3333333333333333,6,5,TGGCTGAAGTGCCGAATTCT,1,5282100
zapB_predicted,0.3333333333333333,6,5,TGGACGGTCCCGTTTCGTCC,1,5267704
zapB_predicted,0.3333333333333333,6,5,TGCTGTCGATTATCTCAGTT,1,5282723
zapB_predicted,0.3333333333333333,6,5,TCCATAGAATCCTCGTTGTT,1,5281827
zapB_predicted,41.166666666666664,251,5,TACGATCGTGCGAAGCGAAA,246,5274485
zapB_predicted,0.3333333333333333,6,5,GTTCGTTATGTAAGGCAGCG,1,5265824
zapB_predicted,71.83333333333333,435,5,GTTCGCGGGGAGTCCATACG,430,5265063
zapB_predicted,15.166666666666666,95,5,GTGGATGCCGCGCACAATAG,90,5265819
zapB_predicted,0.3333333333333333,6,5,GTGATCTTGTTCTTTGTGCC,1,5271730
zapB_predicted,0.3333333333333333,6,5,GTCATATTAACCAAAGTTGA,1,5281246
zapB_predicted,0.3333333333333333,6,5,GGTTCATAGGGACATTAACT,1,5276852
zapB_predicted,0.3333333333333333,6,5,GGTTATAGCCTAGTAGCGGG,1,5276865
zapB_predicted,19.0,118,5,GGGCGCATCAACGTGTGTGC,113,5266756
zapB_predicted,0.3333333333333333,6,5,GCACTCGAGCAATGCGAGAC,1,5280864
zapB_predicted,29.0,178,5,GAGGGTCCTGGGCAGACCCT,173,5267287
zapB_predicted,0.3333333333333333,6,5,CTTTATGAGGTACGTTGGGA,1,5269668
zapB_predicted,0.5,7,5,CTATCTTATTCAGACAAGAA,2,5282266
zapB_predicted,32.166666666666664,197,5,CTAGGTATAACTTGTCAGCA,192,5282043
zapB_predicted,0.3333333333333333,6,5,CTACCAACAGGTAAACCCCC,1,5276617
zapB_predicted,38.333333333333336,234,5,CGTATGTAAGAAAATTAGTC,229,5273426
zapB_predicted,39.833333333333336,243,5,CCTTCCCGTCCTGTTCTACT,238,5285404
zapB_predicted,34.5,211,5,CCGTGGCTAGGCGGACGTAT,206,5266757
zapB_predicted,0.5,7,5,CAGTCATGGCACCCTGGTCC,2,5284475
zapB_predicted,43.0,262,5,CAGGGCGGTACGTTTTATAT,257,5273330
zapB_predicted,0.3333333333333333,6,5,CACCTGACTTTGGAATGCAT,1,5280583
zapB_predicted,0.3333333333333333,6,5,CAATCCTTATCTGGATAATC,1,5270049
zapB_predicted,28.833333333333332,177,5,ATTATCTCCGAGGGAGGACA,172,5269799
zapB_predicted,42.666666666666664,260,5,ATGTTCCAAGGGCGTACGAA,255,5286060
zapB_predicted,0.3333333333333333,6,5,ATGCGAACTTATTGTACTGA,1,5278287
zapB_predicted,0.3333333333333333,6,5,ATCTACTCAACCGAACTCGG,1,5270591
zapB_predicted,30.5,187,5,ATACCGGCCGCCGGTCAGAT,182,5276221
zapB_predicted,45.0,274,5,AGGCGTTCCGATGTCCACAC,269,5264217
zapB_predicted,0.3333333333333333,6,5,AGCAATGTAGGCACACCCGT,1,5271120
zapB_predicted,81.0,490,5,AGAGTTCACTCACACCGGTA,485,5274038
zapB_predicted,0.3333333333333333,6,5,ACTAACGAATGATTTTGTGT,1,5267350
zapB_predicted,0.3333333333333333,6,5,AATTGGTACGTGCCTATTAG,1,5288203
zapB_predicted,0.5,7,5,AATGTCCGCACAGTGATACA,2,5273602
zapB_predicted,0.3333333333333333,6,5,AATGGCGGACGAGGTATTCA,1,5280707
zapB_predicted,31.0,190,5,AACTCAAAGCTCTTCCCATC,185,5266552
zapB_predicted,36.4,185,4,TTTTGTACTGTTATACGGAA,181,5273331
zapB_predicted,23.2,119,4,TTCCTAATTTAGCCGTCATC,115,5277753
zapB_predicted,0.4,5,4,TGTTCGAGCTTCGCTACATG,1,5281401
zapB_predicted,80.0,403,4,TGTCGCTCCGATGTACCCCT,399,5284321
zapB_predicted,44.6,226,4,TGGCCGGATTCGATTGGCCG,222,5286732
zapB_predicted,0.4,5,4,TGCATCTCCACAAGTCTAAT,1,5273406
zapB_predicted,0.4,5,4,TCTAAGGAGACTATTAGAAG,1,5273322
zapB_predicted,43.4,220,4,TCGGGGCGAATGTCGCTCTG,216,5276003
zapB_predicted,0.4,5,4,TCATCCCCTAAATTAGAAAC,1,5281937
zapB_predicted,75.8,382,4,TAAACCTTTGACCAACACTG,378,5285756
zapB_predicted,22.6,116,4,GTGCGCCAGTTTAAAATCCC,112,5282106
zapB_predicted,0.4,5,4,GCTTGCAGACGCTGGGCGAA,1,5264592
zapB_predicted,0.6,6,4,GATCTTGAGATGTTGACAAT,2,5284940
zapB_predicted,0.4,5,4,GAGCTCTTATAGAACACTGG,1,5269594
zapB_predicted,0.4,5,4,GAGCTCATTTATGACTTAGT,1,5286879
zapB_predicted,48.8,247,4,GACCCGTGATTGTTAATCTA,243,5267005
zapB_predicted,42.4,215,4,CTGGCAGTTTAAGATCGACA,211,5275980
zapB_predicted,0.4,5,4,CTCATCCTGCTTCTATTTTA,1,5275816
zapB_predicted,0.6,6,4,CTAGATCGCCTCCGAGTCCT,2,5287159
zapB_predicted,1.2,9,4,CGTGATCCGTCTAGTCTTCC,5,5280740
zapB_predicted,1.2,9,4,CGCGGACGGTGCAACCGTAA,5,5269046
zapB_predicted,0.4,5,4,CCTAGTAGCAGCCGGACCAG,1,5271515
zapB_predicted,45.0,228,4,ATTCGAGGCCACAGATTATT,224,5278345
zapB_predicted,35.0,178,4,ATGGCCGTGGGGAGTGGCCG,174,5281919
zapB_predicted,19.8,102,4,ATACCGCTGGAAGGTTGAAC,98,5287838
zapB_predicted,0.4,5,4,ATAATGCTCAACGTCAGATA,1,5275295
zapB_predicted,0.4,5,4,AGTCCGACCTCTGTGGTAGC,1,5282985
zapB_predicted,43.2,219,4,AGGGGAAGCGGCCCCGAGAG,215,5267677
zapB_predicted,0.4,5,4,AGAGTGCTCGGCGTGTGCGT,1,5273657
zapB_predicted,42.8,217,4,ACCGCTATAATACTGTTGAA,213,5272392
zapB_predicted,35.4,180,4,AATCGGGGGAAGTTAGAAGA,176,5286310
zapB_predicted,4.0,23,4,AACTAGACCAATCTAGGCAT,19,5263658
zapB_predicted,52.25,211,3,TTTTGTATAGATAGGCACCT,208,5280690
zapB_predicted,0.5,4,3,TTTACGTCCAGGTGACAGGA,1,5286254
zapB_predicted,28.75,117,3,TTGACAGAATTATTGATCCG,114,5272828
zapB_predicted,0.5,4,3,TTATTACTAAGCTGTGACCC,1,5279632
zapB_predicted,0.5,4,3,TTACTATCTGTATCAGTACC,1,5263405
zapB_predicted,25.75,105,3,TTACGTAGATACTTTGGACA,102,5286140
zapB_predicted,51.25,207,3,TTACGTAAGTCAGAGATCGG,204,5276447
zapB_predicted,53.0,214,3,TGGTGGAAGCGGTAACTCGC,211,5264125
zapB_predicted,0.5,4,3,TCTAAGCAGGGGGTCACCGC,1,5274239
zapB_predicted,44.75,181,3,TCCACCAGTCCGGGGTGGCC,178,5286508
zapB_predicted,31.75,129,3,TCATCTGGCAACCGTCTCGG,126,5282782
zapB_predicted,0.5,4,3,TATGGCGCGATGCAACTAGC,1,5284942
zapB_predicted,1.0,6,3,TAACGTCACCTAATCTTTCA,3,5275673
zapB_predicted,0.5,4,3,GTTATCTTTTGATGATCACC,1,5284637
zapB_predicted,114.0,458,3,GTCCCCGGAGACATTAGAAG,455,5279857
zapB_predicted,0.5,4,3,GGTGCCGCCAAGCTGTCCTT,1,5272695
zapB_predicted,0.5,4,3,GCTAGCGTTAAGCAGCTCAT,1,5280556
zapB_predicted,50.25,203,3,GCATGTGAATACAACGATAC,200,5272866
zapB_predicted,0.5,4,3,GATTGCCACTGGCATTACCC,1,5276899
zapB_predicted,58.0,234,3,GATCGTTACTCACTTTGCTC,231,5263603
zapB_predicted,0.5,4,3,GATAGTCAGGGATGGCGGCA,1,5269898
zapB_predicted,56.75,229,3,GAGTAACCGTTTTGAGGCAT,226,5283491
zapB_predicted,0.5,4,3,GAGCTCCTTGTCTACGCGCG,1,5267603
zapB_predicted,6.5,28,3,GAAGATACGGCTTTAATTCA,25,5269900
zapB_predicted,0.5,4,3,CTGCGGAGCAGGTTAGCGTA,1,5283879
zapB_predicted,0.5,4,3,CTCGAACTCAGCGTCGCGAA,1,5287161
zapB_predicted,107.75,433,3,CTCCATAATCGTCACGCCTC,430,5287843
zapB_predicted,132.75,533,3,CGCAGGTCTCAATCCTTTCA,530,5269147
zapB_predicted,0.5,4,3,CGCAATGCAGGGCAATAGAA,1,5268728
zapB_predicted,0.5,4,3,CCCCAGGGCTTGCTCTGACA,1,5277878
zapB_predicted,0.5,4,3,CCACACCATTCATACGCTGG,1,5287468
zapB_predicted,0.75,5,3,ATTATTTACAGGCCGAGATC,2,5271492
zapB_predicted,55.0,222,3,ATGTAGCTACGTATGCTTAG,219,5285103
zapB_predicted,57.0,230,3,ATGAACAGTACTCACGTCCC,227,5266980
zapB_predicted,0.5,4,3,ATCTGAGTATGGGAGCGAGA,1,5268108
zapB_predicted,49.25,199,3,ATCGGGTGGAAGAGTATAAG,196,5282061
zapB_predicted,0.5,4,3,ATATTGTGAGTTTAAAAAGG,1,5281349
zapB_predicted,32.0,130,3,AGTTAGCTTCAAATATAGTA,127,5279813
zapB_predicted,0.5,4,3,AGTGTGAGGGATAGCCATGC,1,5276715
zapB_predicted,0.5,4,3,AGGTGTTTGGTTCGGTATTA,1,5268086
zapB_predicted,0.5,4,3,AGCTTGAAGATTATATCACC,1,5264810
zapB_predicted,0.5,4,3,AGACCTTCATCCAGTTGTGT,1,5280712
zapB_predicted,47.5,192,3,ACGTAGTTGAGAAGGCAGCT,189,5273616
zapB_predicted,0.5,4,3,ACACGGTCGCTTCGTGAAAA,1,5263606
zapB_predicted,0.75,5,3,AAGGCCGTGCACCTTGCGCT,2,5263331
zapB_predicted,0.5,4,3,AAATTTCAGGGCTTACGACT,1,5282537
zapB_predicted,0.75,5,3,AAAATTCTAGCTGACGATTT,2,5275270
zapB_predicted,77.33333333333333,233,2,TTTGGGCCTGACCGTTTAAA,231,5282862
zapB_predicted,0.6666666666666666,3,2,TTGAGGAGAGAAGGTGATAC,1,5283468
zapB_predicted,0.6666666666666666,3,2,TTCGTCCGAGCACTTGCAGT,1,5271591
zapB_predicted,0.6666666666666666,3,2,TGGTCGGCCAAAATGTCCAT,1,5266571
zapB_predicted,0.6666666666666666,3,2,TGGGGGTCACCATAACCGTA,1,5283816
zapB_predicted,0.6666666666666666,3,2,TGAGAGATTCTGGGAGGGGC,1,5282467
zapB_predicted,154.0,463,2,TGAAGTGCGTTAGCAAATAT,461,5277427
zapB_predicted,0.6666666666666666,3,2,TCTGACTGACTGTGACGTCA,1,5279031
zapB_predicted,0.6666666666666666,3,2,TCTACAATTCTAAACTTTAA,1,5266693
zapB_predicted,0.6666666666666666,3,2,TCATAACTCCTGATTCCTGC,1,5266930
zapB_predicted,0.6666666666666666,3,2,TATCCAACAGTGGCTCTCGT,1,5263011
zapB_predicted,0.6666666666666666,3,2,TAGCCCAAGGGTCGTGGTAT,1,5271961
zapB_predicted,0.6666666666666666,3,2,GTCTGTTACCAAGTCAGAGG,1,5277971
zapB_predicted,72.33333333333333,218,2,GGGGAGGACGCCTCAAGCGA,216,5270136
zapB_predicted,0.6666666666666666,3,2,GGCTCAACGTGTAAAACGGG,1,5268149
zapB_predicted,87.0,262,2,GGATAGCATAACAAGACCTA,260,5269158
zapB_predicted,31.333333333333332,95,2,GCTTCCATACAGCTTCTGCG,93,5279525
zapB_predicted,0.6666666666666666,3,2,GCGTGTAGGGTTATATTTTC,1,5277499
zapB_predicted,76.33333333333333,230,2,CTCCTGGGCAATCCTACTAA,228,5265162
zapB_predicted,1.0,4,2,CGTGTTATGCAATCGTCTCG,2,5268351
zapB_predicted,0.6666666666666666,3,2,CGTCGAGCTCAATAGTGATG,1,5277578
zapB_predicted,80.0,241,2,CGTAGTCAGATCGGGCGAAG,239,5273658
zapB_predicted,77.33333333333333,233,2,CGCCTAACTGGGTCGCCATA,231,5271219
zapB_predicted,0.6666666666666666,3,2,CGATCGGTAAGAACGCGTCC,1,5281672
zapB_predicted,1.0,4,2,CCTGTCCTTCGATGTTTACA,2,5280296
zapB_predicted,175.66666666666666,528,2,CCTAGTAAATGTTATGGATG,526,5282614
zapB_predicted,60.666666666666664,183,2,CAAGTGCTGGCCTGTCAGGG,181,5285165
zapB_predicted,66.33333333333333,200,2,ATGGTACTTTTCACCACAGT,198,5284476
zapB_predicted,58.333333333333336,176,2,ATGAAAACGGAACACCGTAG,174,5280421
zapB_predicted,0.6666666666666666,3,2,AGGCAGGACGGCTAGTAATC,1,5286660
zapB_predicted,0.6666666666666666,3,2,AGCATCTCCGGGAAGGGGAC,1,5286409
zapB_predicted,0.6666666666666666,3,2,AGACGTCGGGGATCACTTAT,1,5282864
zapB_predicted,0.6666666666666666,3,2,ACCCTTTTGGACACCGCCGC,1,5278899
zapB_predicted,1.0,4,2,AATACTAGGCAGCTTTCCAA,2,5282572
zapB_predicted,0.6666666666666666,3,2,AAGGAGGCCGGAGCCTTGCA,1,5264680
zapB_predicted,0.6666666666666666,3,2,AAGCATGGAAGATTACACAT,1,5283685
zapB_predicted,0.6666666666666666,3,2,AAGAGTTTCGTGAATCAGAG,1,5266033
zapB_predicted,72.33333333333333,218,2,AACGGCACTAAACGATATCA,216,5268181
zapB_predicted,95.0,286,2,AACACCACCTCCCGGATCAT,284,5278457
zapB_predicted,69.0,208,2,AAATGCTAGAGCTTTGTTGA,206,5278317
zapB_predicted,1.0,2,1,TTTTATGTAGAACAATTAAC,1,5287717
zapB_predicted,109.0,218,1,TTTGCTAAAAACCAAATCGA,217,5273190
zapB_predicted,1.0,2,1,TTGAAATTGTGGGGGTCCGT,1,5271517
zapB_predicted,1.0,2,1,TTCGAAATGCGCAAGGTAGT,1,5278017
zapB_predicted,1.0,2,1,TGGCTATTGTGAGTATTTCC,1,5274480
zapB_predicted,83.5,167,1,TGCTGGTCCTGCTGCGGAAA,166,5282454
zapB_predicted,97.5,195,1,TCTGGTCTGGTGTAGACTGA,194,5269312
zapB_predicted,111.5,223,1,TCGCAAGACGAACAGAAGAT,222,5280073
zapB_predicted,94.0,188,1,TCAGTTCTTCGAGGCGTAAA,187,5264119
zapB_predicted,121.5,243,1,GTTGAGTCATCCCTATATAC,242,5288283
zapB_predicted,1.0,2,1,GTTACTGTAACCATCTGCGC,1,5271153
zapB_predicted,1.0,2,1,GTGTGTGAAGCTAGAGCATA,1,5267091
zapB_predicted,1.0,2,1,GTGCAAAGGGATCCCGGTAT,1,5284648
zapB_predicted,116.5,233,1,GTCTATTACTCTATACGGGT,232,5285780
zapB_predicted,111.0,222,1,GTCCTCGGTTAGGTGAGCTG,221,5267032
zapB_predicted,1.5,3,1,GGGGCCTGGTAAAATGGGTA,2,5280453
zapB_predicted,111.5,223,1,GCTACTCGACGGGGTCTGTG,222,5281847
zapB_predicted,114.0,228,1,GCTAAGGATCTCCTCTCTTA,227,5286389
zapB_predicted,1.0,2,1,GCCAGTTAGTGAAAATACGA,1,5271046
zapB_predicted,1.0,2,1,GCAACTCACGCTTTACAAGG,1,5285213
zapB_predicted,1.5,3,1,GATCATAGTTGTGTTCTATC,2,5267939
zapB_predicted,1.0,2,1,GACACGGAATTACCATATTA,1,5271424
zapB_predicted,104.5,209,1,GAAAACACACGGAGGACTGA,208,5276997
zapB_predicted,86.5,173,1,CTTATAGCATTGGTCGATCT,172,5278270
zapB_predicted,1.0,2,1,CGGGAACTTTGCATTCCCCC,1,5263958
zapB_predicted,1.0,2,1,CGGGAACTTGGATAAGCACC,1,5288186
zapB_predicted,125.5,251,1,CGCCCTCGAGGCCCGATCGT,250,5286392
zapB_predicted,1.0,2,1,CCGTCAGCTCGCTGGTCTCA,1,5282856
zapB_predicted,1.0,2,1,CATGCTAACAGCGATCTTAG,1,5287835
zapB_predicted,1.0,2,1,CAGCCTGCTAGAGCAACTCT,1,5269048
zapB_predicted,1.0,2,1,CAGCCAAAAGCTTTTTCGTC,1,5272792
zapB_predicted,10.5,21,1,CACGGTTACAGTTCTTATGC,20,5263304
zapB_predicted,1.0,2,1,CAATCCTAATTCTCGGGGAC,1,5272001
zapB_predicted,81.5,163,1,ATCGATTTTAGGGTTGCCAA,162,5281071
zapB_predicted,91.5,183,1,ATATAGGATAAGCCTAGACT,182,5264122
zapB_predicted,1.0,2,1,ATAGCGGGAACAGAGACGGT,1,5268422
zapB_predicted,101.5,203,1,ATAATTTTGTTTTCCTAATT,202,5279212
zapB_predicted,1.0,2,1,AGTAAAGTTTCAGTAGGACT,1,5263839
zapB_predicted,113.0,226,1,AGGGAACACTGCAGTGGGTG,225,5287603
zapB_predicted,125.0,250,1,AGATCTTGAAGGATTATATC,249,5270099
zapB_predicted,1.0,2,1,AGAATTCTTTGTTTGTAGGT,1,5278501
zapB_predicted,1.0,2,1,ACGCACTGAGTTACCTATTC,1,5268999
zapB_predicted,1.0,2,1,ACATTGAGGGAACCGTGCCA,1,5263365
zapB_predicted,94.5,189,1,AACACCAACGGGGCGAAAGA,188,5286229
zapB_predicted,1.0,2,1,AAACCAGAGTGTAGGACGCT,1,5287670
zapB_predicted,0.005154639175257732,193,193,GCGATATCAATTTGCGCCAG,0,5272977
zapB_predicted,0.008928571428571428,111,111,CTAACACGAAGCTCCCCGAC,0,5265199
zapB_predicted,0.00980392156862745,101,101,CAGAAGGGCGAGTATCCGGA,0,5267361
zapB_predicted,0.012048192771084338,82,82,CGCACGGATTCAGCACAGCT,0,5263215
zapB_predicted,0.012195121951219513,81,81,GCATCATTGCTGGATATTCA,0,5278444
zapB_predicted,0.012987012987012988,76,76,TCCAATAACTTTTCGTAGGA,0,5265700
zapB_predicted,0.013157894736842105,75,75,GGACGGACTAGGTAAAGGGT,0,5271964
zapB_predicted,0.013157894736842105,75,75,GGAAGAAAACTGTTCCCGAA,0,5264505
zapB_predicted,0.013513513513513514,73,73,ATGGTTACTGAGACCCTTGA,0,5263991
zapB_predicted,0.013888888888888888,71,71,ATAGTACTCCCTCGGAGACA,0,5265618
zapB_predicted,0.014705882352941176,67,67,TTGAGGGTCATCTGCCAGCA,0,5266680
zapB_predicted,0.014705882352941176,67,67,ACCGACGATGGGAGCACTGC,0,5273481
zapB_predicted,0.014925373134328358,66,66,ACTGATCGCGCGACTAATGG,0,5263473
zapB_predicted,0.015151515151515152,65,65,TGGATCAACAGTTGAATTTC,0,5265120
zapB_predicted,0.015151515151515152,65,65,GACGTGTAACGTTGGCAACT,0,5263546
zapB_predicted,0.015384615384615385,64,64,GCAAACAGATGCATACCTTG,0,5279747
zapB_predicted,0.015384615384615385,64,64,ATGTTCAGATTATGTCTTTG,0,5274621
zapB_predicted,0.015384615384615385,64,64,ACAACTCAGTGACCGGCGTA,0,5268785
zapB_predicted,0.015625,63,63,CCGTCGAAAGCTTGTCTCAA,0,5267976
zapB_predicted,0.016129032258064516,61,61,TCTCGTTAGTATTATCTGAA,0,5275688
zapB_predicted,0.016129032258064516,61,61,CTTCTCAAGGCTTAGCCACC,0,5286099
zapB_predicted,0.01639344262295082,60,60,TAGAATGTTCTGGCACCTGG,0,5264306
zapB_predicted,0.01639344262295082,60,60,GTGAAGCTGACAGCACCTAA,0,5272966
zapB_predicted,0.01639344262295082,60,60,CGATTCCCCAGGGAAGCGTG,0,5266136
zapB_predicted,0.016666666666666666,59,59,TTGGTCGAGTCTTCCCCTAC,0,5263301
zapB_predicted,0.017241379310344827,57,57,GAACGCGTTCTGAAGTCGAA,0,5274648
zapB_predicted,0.017241379310344827,57,57,CGGGATGACAGCCCTCTGAC,0,5263155
zapB_predicted,0.017543859649122806,56,56,TGGGCACGTAAAACGGGGTT,0,5264216
zapB_predicted,0.017543859649122806,56,56,ACAGCGGGAGACAAGACAAA,0,5267478
zapB_predicted,0.017857142857142856,55,55,AGGCTTGCGTGTCACTCATA,0,5263862
zapB_predicted,0.017857142857142856,55,55,ACGTCAGTGAAAAGCCTTGT,0,5268742
zapB_predicted,0.01818181818181818,54,54,TAAGAAGTAGCGTGCACACG,0,5266418
zapB_predicted,0.01818181818181818,54,54,GTGTCTGATCGCAAGATTAA,0,5277390
zapB_predicted,0.01818181818181818,54,54,GCAGTTCACCTTACAGCGGG,0,5263634
zapB_predicted,0.01818181818181818,54,54,GAGGAGTAACGCCTGGAGAA,0,5263158
zapB_predicted,0.01818181818181818,54,54,AGGGAGTTAAGGGTCTTGGT,0,5265837
zapB_predicted,0.01818181818181818,54,54,AGACACATTTCGTATCCACT,0,5272430
zapB_predicted,0.018867924528301886,52,52,ACCACGCCCTCAGCGGGCAT,0,5280621
zapB_predicted,0.019230769230769232,51,51,CACCGTTGGACTCGGAGAAA,0,5281058
zapB_predicted,0.0196078431372549,50,50,GCCATTGGAACAGCCTCGCA,0,5265245
zapB_predicted,0.0196078431372549,50,50,CGTCAACCATTGTTTGTCCA,0,5263472
zapB_predicted,0.0196078431372549,50,50,CCAGACGTCGAGAGGAGAAA,0,5278128
zapB_predicted,0.0196078431372549,50,50,ACCGTGTGACAGGGAAAATC,0,5269841
zapB_predicted,0.02,49,49,TCCAGTGTCTGGTTCGGAGT,0,5270694
zapB_predicted,0.02,49,49,ACCATAGTGCCGTATAGCTA,0,5263576
zapB_predicted,0.02040816326530612,48,48,TTCTGCGGGTCACCTTGAAT,0,5284367
zapB_predicted,0.02040816326530612,48,48,GCTAGTGATATACCATATTT,0,5265143
zapB_predicted,0.02040816326530612,48,48,CTAGGTATCAAGTGCAGCGG,0,5288200
zapB_predicted,0.02040816326530612,48,48,CCTTTTATAGTGCTAAAACC,0,5282517
zapB_predicted,0.02040816326530612,48,48,ACATGTTGAATCCAAGTAGA,0,5265508
zapB_predicted,0.02127659574468085,46,46,GTCATCAGCGTACATGAAAA,0,5264069
zapB_predicted,0.02127659574468085,46,46,CACATCGGGATCGGTGGCAT,0,5286092
zapB_predicted,0.021739130434782608,45,45,TGGGATAACGGCATCCCCAG,0,5271074
zapB_predicted,0.021739130434782608,45,45,TCTATATGCTAACAGCGCTA,0,5286700
zapB_predicted,0.021739130434782608,45,45,GCTAGCAGTAGCGGATAAAT,0,5278213
zapB_predicted,0.021739130434782608,45,45,CTTACTGCCACAGCCCTCCA,0,5277076
zapB_predicted,0.021739130434782608,45,45,CTCGATCAGCGCTTTATATT,0,5268725
zapB_predicted,0.021739130434782608,45,45,CATACTGTCCCAGTGAGGTG,0,5276932
zapB_predicted,0.021739130434782608,45,45,ACACCATAATGAGTACAAAA,0,5264560
zapB_predicted,0.022222222222222223,44,44,GTGTGGTTACCCACGATAAA,0,5274048
zapB_predicted,0.022222222222222223,44,44,GGCTCTGGTGGGTACGGTTA,0,5268107
zapB_predicted,0.022222222222222223,44,44,CTTAAAGAGGCAGATCTCAT,0,5264158
zapB_predicted,0.022222222222222223,44,44,CGGATTGCGCTATGCCGATG,0,5286020
zapB_predicted,0.022222222222222223,44,44,CATTGCAGCAAGCCCAGGCG,0,5268404
zapB_predicted,0.022222222222222223,44,44,ATAGGGGCGTTCCAAAACTA,0,5285234
zapB_predicted,0.022222222222222223,44,44,ATAAAAACTTCTAGAAGATA,0,5277141
zapB_predicted,0.022222222222222223,44,44,ACCGTCAGAGATCGAACCCT,0,5266904
zapB_predicted,0.022222222222222223,44,44,ACAAGGGGATAATACGTTCT,0,5265068
zapB_predicted,0.022727272727272728,43,43,TGCTACAGGCATGTTCACCA,0,5264980
zapB_predicted,0.022727272727272728,43,43,TCAATTTGATAGCCAGAGTT,0,5266779
zapB_predicted,0.022727272727272728,43,43,GGTGGAGTGAGTCCGGGCCT,0,5268968
zapB_predicted,0.022727272727272728,43,43,GAAATCCGGACCGGCACCTC,0,5265825
zapB_predicted,0.022727272727272728,43,43,CTGGGCGTTCGCACACCCCT,0,5279192
zapB_predicted,0.022727272727272728,43,43,CTACCGTTATTACCTGCGGT,0,5278059
zapB_predicted,0.022727272727272728,43,43,ACAGACGTGCCTGTAGAGCT,0,5269378
zapB_predicted,0.022727272727272728,43,43,ACAAAAAAGTTGCATGGCCG,0,5276805
zapB_predicted,0.023255813953488372,42,42,TTTCGGCTAAATTGGCTCTG,0,5272713
zapB_predicted,0.023255813953488372,42,42,TTTCGCTCCCAGTAGCAATA,0,5278037
zapB_predicted,0.023255813953488372,42,42,TGGACGAGCGGGCACGATTG,0,5267079
zapB_predicted,0.023255813953488372,42,42,TATGCCGCAAATAAAGCTAT,0,5266363
zapB_predicted,0.023255813953488372,42,42,GGACAGGAACTGACGAAGAT,0,5282348
zapB_predicted,0.023255813953488372,42,42,CAGCTGTGGCTAATGAGGGA,0,5278011
zapB_predicted,0.023809523809523808,41,41,TCCGGCTGGGTTTCAAAGCA,0,5265801
zapB_predicted,0.023809523809523808,41,41,GTGCTCCGCCCGACGAGTTC,0,5272376
zapB_predicted,0.023809523809523808,41,41,GCCAGGGTTGGGTCGCGATC,0,5268387
zapB_predicted,0.023809523809523808,41,41,GAACGACCATCTTACATCGT,0,5277315
zapB_predicted,0.023809523809523808,41,41,CTTTCGTTTAGATTGCGCAA,0,5270747
zapB_predicted,0.023809523809523808,41,41,CTGCGGAGTAAGGAAACATT,0,5263510
zapB_predicted,0.023809523809523808,41,41,CGACTTCAGTGTCATGGCAT,0,5268965
zapB_predicted,0.023809523809523808,41,41,CATCGGCCGCCCCTCTGGTC,0,5279885
zapB_predicted,0.023809523809523808,41,41,ATCTGCAAGGGTCCCGTTCG,0,5286192
zapB_predicted,0.023809523809523808,41,41,AAGGTGTGGATAGGCCATCG,0,5272212
zapB_predicted,0.024390243902439025,40,40,TTGCTGTCGGCGGAGTTATG,0,5267609
zapB_predicted,0.024390243902439025,40,40,TCTTCATACACGGGCTAGTA,0,5285997
zapB_predicted,0.024390243902439025,40,40,GCGTACGCCGCACCCTGGGT,0,5264401
zapB_predicted,0.024390243902439025,40,40,GCCACAGCACAAGTCCTCAA,0,5274098
zapB_predicted,0.024390243902439025,40,40,GAGTTGTGAGATAACGCTTT,0,5282823
zapB_predicted,0.024390243902439025,40,40,CCAGAGAGATGGACTGTTCT,0,5266356
zapB_predicted,0.024390243902439025,40,40,ACACAGGAATGTGTGTTATA,0,5265821
zapB_predicted,0.025,39,39,TCGGGTTGCCGACCAGGATT,0,5280592
zapB_predicted,0.025,39,39,GATTAACGACCTATGGGGAG,0,5278992
zapB_predicted,0.025,39,39,GAGACTAGATGAAGCGTTGA,0,5271896
zapB_predicted,0.025,39,39,GAACATGGTGGATTGCAGAT,0,5266694
zapB_predicted,0.025,39,39,CACGGCTACATAAGCGACAG,0,5276688
zapB_predicted,0.025,39,39,CAACATGGCGAGATACAGTA,0,5270892
zapB_predicted,0.025,39,39,ATTGCAGACCCCTACCTGGA,0,5273304
zapB_predicted,0.025,39,39,AGGTAATGTTGGGTGTGTTC,0,5277910
zapB_predicted,0.025,39,39,AAGGCGTCAGGTCGCTGGCA,0,5266416
zapB_predicted,0.025,39,39,AAGGCGGCAACAGCAGGTCC,0,5273134
zapB_predicted,0.02564102564102564,38,38,GACTCGGTCGGCGCTTTCCT,0,5277249
zapB_predicted,0.02564102564102564,38,38,CGGGCAATTGTGGGAGGGTG,0,5265469
zapB_predicted,0.02564102564102564,38,38,CGCACACTAACGACGTGGAA,0,5275147
zapB_predicted,0.02564102564102564,38,38,CATTAGGGCGACATATCATG,0,5268074
zapB_predicted,0.02564102564102564,38,38,CAATCTGCTCCCATCTGTGT,0,5275741
zapB_predicted,0.02564102564102564,38,38,AGGGCGGACTGCGCATTCGG,0,5271859
zapB_predicted,0.02631578947368421,37,37,TTAGTTTGGCTGGTGAACAT,0,5273696
zapB_predicted,0.02631578947368421,37,37,TGTTTCTGGCCGCCGTACAT,0,5263480
zapB_predicted,0.02631578947368421,37,37,TGAGTCGCAAATACCAACAG,0,5270275
zapB_predicted,0.02631578947368421,37,37,TCGCACTACCGGAAAGAATA,0,5270640
zapB_predicted,0.02631578947368421,37,37,GTCCCCGTCCGGAATCGGGG,0,5278546
zapB_predicted,0.02631578947368421,37,37,GGACTATGATGCATCTTCTA,0,5268449
zapB_predicted,0.02631578947368421,37,37,GCTGGAAGATGTTGTGACGG,0,5269570
zapB_predicted,0.02631578947368421,37,37,GCGGCTCGCGCCAAATCATG,0,5268054
zapB_predicted,0.02631578947368421,37,37,GATAAAAATGAATTCTTAGG,0,5263230
zapB_predicted,0.02631578947368421,37,37,CGGGCACTACTACCAGCCAA,0,5267831
zapB_predicted,0.02631578947368421,37,37,CCTTTTGCCCGGAGCAAGAG,0,5268304
zapB_predicted,0.02631578947368421,37,37,CCATTCAGAGCAAGGCCATT,0,5279674
zapB_predicted,0.02631578947368421,37,37,CAAGCGTCCCCGATCCGGCT,0,5282398
zapB_predicted,0.02631578947368421,37,37,ATTGTTTAACGGGGTGTAAG,0,5264042
zapB_predicted,0.02631578947368421,37,37,ATTACAAGCTGAGCCTATTA,0,5284313
zapB_predicted,0.02631578947368421,37,37,AGTGTACTCAACGTCAGAAT,0,5266187
zapB_predicted,0.02631578947368421,37,37,AGTCTGCCTAAGTGGTTCGT,0,5269787
zapB_predicted,0.02631578947368421,37,37,ACGGAAGTGCCATTCACTAG,0,5274598
zapB_predicted,0.02702702702702703,36,36,TGATCCCATTCACTACGACA,0,5270134
zapB_predicted,0.02702702702702703,36,36,TGAGCCTAGCGTGGCTTCTT,0,5267283
zapB_predicted,0.02702702702702703,36,36,TCGCTTCTGTGCCACTGAAT,0,5276342
zapB_predicted,0.02702702702702703,36,36,TCATCGCTGAATTGTAGAAA,0,5278038
zapB_predicted,0.02702702702702703,36,36,TATCATAAAGAGGGCAAGGC,0,5281092
zapB_predicted,0.02702702702702703,36,36,TAAGGCTCGCTCCGAGGGCA,0,5269160
zapB_predicted,0.02702702702702703,36,36,CGTGAGTAGCAAAGTATGCT,0,5286581
zapB_predicted,0.02702702702702703,36,36,CGACATCCTTCAGTTTGAAG,0,5281221
zapB_predicted,0.02702702702702703,36,36,CAGTCTGGCCTTCCCTTGAA,0,5284121
zapB_predicted,0.02702702702702703,36,36,CAAACCACTGCGAAATTATG,0,5266932
zapB_predicted,0.02702702702702703,36,36,ATCGAACGGGGCGAACATCT,0,5277145
zapB_predicted,0.02702702702702703,36,36,ATCACAGTTAACATGCGCTA,0,5264693
zapB_predicted,0.02702702702702703,36,36,AGATGCTCACATGGACATTG,0,5277489
zapB_predicted,0.02702702702702703,36,36,ACATCTCGGGGACTGTACCT,0,5287086
zapB_predicted,0.02702702702702703,36,36,AAGGTCCGGCAACTGAAGGT,0,5271339
zapB_predicted,0.02702702702702703,36,36,AAATGATTAATGAGATTCAG,0,5263560
zapB_predicted,0.027777777777777776,35,35,TTTACCACTGGGTTAGGCGA,0,5264459
zapB_predicted,0.027777777777777776,35,35,TTAACGACACTCTAGATGGT,0,5277057
zapB_predicted,0.027777777777777776,35,35,TCTGTTTTTGGACTGAAAGC,0,5281172
zapB_predicted,0.027777777777777776,35,35,TATAAGAAACGGGAAGCCTC,0,5265740
zapB_predicted,0.027777777777777776,35,35,GTACTTCGAGCAACGATCTT,0,5269998
zapB_predicted,0.027777777777777776,35,35,GAGTTGTACTCGCACCGGAA,0,5286622
zapB_predicted,0.027777777777777776,35,35,CACTGCGGGGATTAACGATG,0,5279224
zapB_predicted,0.027777777777777776,35,35,CACCCCCCACGTTTTTGGTG,0,5265856
zapB_predicted,0.027777777777777776,35,35,CAATGTTGCACGTTAATGCC,0,5284966
zapB_predicted,0.027777777777777776,35,35,ATCAACCACTAGCAGCAACT,0,5274004
zapB_predicted,0.027777777777777776,35,35,ACATAAAGGGCATAAAACGC,0,5269452
zapB_predicted,0.02857142857142857,34,34,TTCCTTGACCCTACGCCCGT,0,5266905
zapB_predicted,0.02857142857142857,34,34,TGTTGAATGGGCGTATTTTG,0,5273806
zapB_predicted,0.02857142857142857,34,34,TGTGCATTTTAGCGCGAGGT,0,5268757
zapB_predicted,0.02857142857142857,34,34,TATTCGAGTAATACCCGTGC,0,5284881
zapB_predicted,0.02857142857142857,34,34,GTGGCCGGTTGTTAGTGGGT,0,5277586
zapB_predicted,0.02857142857142857,34,34,GTCTGGGGCAGTCAAACAAG,0,5269288
zapB_predicted,0.02857142857142857,34,34,GCCATGGGGGGTACTGGGCG,0,5265681
zapB_predicted,0.02857142857142857,34,34,GATTAGTCACCTGTGCGGGA,0,5273512
zapB_predicted,0.02857142857142857,34,34,CTAAAGTCCTTGCTCACCGT,0,5284469
zapB_predicted,0.02857142857142857,34,34,CGGAATCGCGCGCCGATAAC,0,5271246
zapB_predicted,0.02857142857142857,34,34,CATCGAGAGGCTCCTAGTAC,0,5280108
zapB_predicted,0.02857142857142857,34,34,ATTGCTCCGTGGAATTATTA,0,5265003
zapB_predicted,0.02857142857142857,34,34,AGCTAAGGTCCACAGTAAAT,0,5278208
zapB_predicted,0.02857142857142857,34,34,AATCCGAGTTAAAATTGTCA,0,5269083
zapB_predicted,0.02857142857142857,34,34,AAGTGATGTCGCTTTCCCGA,0,5277386
zapB_predicted,0.029411764705882353,33,33,TTGGTATGCCTTCATAGCAT,0,5270766
zapB_predicted,0.029411764705882353,33,33,TTCGCTTTAAGGCTAATAGA,0,5264799
zapB_predicted,0.029411764705882353,33,33,TGTTGTACAGTGTATGGGAT,0,5263956
zapB_predicted,0.029411764705882353,33,33,TGGAACAGCCCTGGGCTTAC,0,5279752
zapB_predicted,0.029411764705882353,33,33,TATTCGTCTTGTCAATGGAT,0,5272267
zapB_predicted,0.029411764705882353,33,33,GGCGTGTGCCGCTGCCCCAT,0,5287511
zapB_predicted,0.029411764705882353,33,33,GGAGGAAAGGTACTGTGGAG,0,5279651
zapB_predicted,0.029411764705882353,33,33,GATGTAGGTCAGTTTTGTGC,0,5264927
zapB_predicted,0.029411764705882353,33,33,CTTCAGACCGTTAGTCGGAG,0,5282071
zapB_predicted,0.029411764705882353,33,33,CGGCCCACCAAACGGCGAGT,0,5265142
zapB_predicted,0.029411764705882353,33,33,CGCGTTCGTTTGTGTATGAC,0,5267700
zapB_predicted,0.029411764705882353,33,33,CCCGGAAGTTATTCGTCTCT,0,5274002
zapB_predicted,0.029411764705882353,33,33,ATGTTGAGCAATGCTACGTC,0,5264435
zapB_predicted,0.029411764705882353,33,33,AAGTGTGACAGTTATGGCGA,0,5267130
zapB_predicted,0.029411764705882353,33,33,AAGGTCCCCTTGCCTATTCC,0,5263673
zapB_predicted,0.030303030303030304,32,32,TCTGTGGACCAGGGGTAGGA,0,5271258
zapB_predicted,0.030303030303030304,32,32,TCTAACGCCTCCGACTTGGT,0,5277945
zapB_predicted,0.030303030303030304,32,32,TCAATATGATTCAGATAAGT,0,5279163
zapB_predicted,0.030303030303030304,32,32,TATCGACTAACATAAGGGTC,0,5274390
zapB_predicted,0.030303030303030304,32,32,TACGTGGCTGTCTCGTGGGT,0,5266297
zapB_predicted,0.030303030303030304,32,32,GTTGGGATTCGTACGGAATT,0,5267705
zapB_predicted,0.030303030303030304,32,32,GGTGCTAGATATTTTGCCGT,0,5272914
zapB_predicted,0.030303030303030304,32,32,GGTGCCAGCAATGCCGTGAA,0,5267541
zapB_predicted,0.030303030303030304,32,32,GGGGGAACGTTCATATTGTA,0,5265829
zapB_predicted,0.030303030303030304,32,32,GCGGCGACCATTAGATGTTG,0,5263672
zapB_predicted,0.030303030303030304,32,32,GCGCGGGTGCTGTGAACAAG,0,5270795
zapB_predicted,0.030303030303030304,32,32,GAATCGAGCACTCCGAGTTC,0,5266435
zapB_predicted,0.030303030303030304,32,32,GAAGTAGTGCCGACCTTGTG,0,5273599
zapB_predicted,0.030303030303030304,32,32,GAACCTTTCGCGGCGCGTCA,0,5265567
zapB_predicted,0.030303030303030304,32,32,CTGCTCATTCATTACTTCTT,0,5278296
zapB_predicted,0.030303030303030304,32,32,CTCACGTTAGGACGCCACAC,0,5264334
zapB_predicted,0.030303030303030304,32,32,CGTTGAGTACTAGGCTCAAG,0,5280322
zapB_predicted,0.030303030303030304,32,32,CGGATATATGGGCGTAGGAT,0,5279215
zapB_predicted,0.030303030303030304,32,32,CGCGCGCGATCGAACCCTTG,0,5276341
zapB_predicted,0.030303030303030304,32,32,CGAGTCTTCTTTTGGTATCA,0,5266802
zapB_predicted,0.030303030303030304,32,32,AGTCCGGAGCAGTAAAACCG,0,5276822
zapB_predicted,0.030303030303030304,32,32,AACTGCTGCAGTAGCTGGCA,0,5270889
zapB_predicted,0.030303030303030304,32,32,AACGAGAGGGGGAGGTGTTA,0,5273559
zapB_predicted,0.03125,31,31,TTTTACCGGGCTTCTGAGGG,0,5263999
zapB_predicted,0.03125,31,31,TGTGGTTGAAGCATGCCCGT,0,5275676
zapB_predicted,0.03125,31,31,TGGCACTGAGTGACCGAAGA,0,5268083
zapB_predicted,0.03125,31,31,TCTGCTGTTGAGGGATGACA,0,5264918
zapB_predicted,0.03125,31,31,TCAGCGGCTTCCCCTAGTAA,0,5273622
zapB_predicted,0.03125,31,31,TACGGAAGGTAATGGACTGC,0,5285859
zapB_predicted,0.03125,31,31,GAACGAGGCGGACATAGGCT,0,5271789
zapB_predicted,0.03125,31,31,CTTGATGCGAGAAAGTAGGT,0,5267461
zapB_predicted,0.03125,31,31,CTTCTCATCGGCGTAGATAA,0,5284296
zapB_predicted,0.03125,31,31,CTTCAAAGAGGCCACGGATA,0,5285601
zapB_predicted,0.03125,31,31,CGGGGGAAGTACAACACGAG,0,5279214
zapB_predicted,0.03125,31,31,CGGATGCAGTGTCGAAGTAC,0,5266304
zapB_predicted,0.03125,31,31,CGAACTCTCTTTCACAATAA,0,5278551
zapB_predicted,0.03125,31,31,CCATGTTTGGCCCCACTTCG,0,5276684
zapB_predicted,0.03125,31,31,CAGGCGTCGAAAGGCCAGGT,0,5267236
zapB_predicted,0.03125,31,31,CAGGCACAGGGGTAACGCAA,0,5280970
zapB_predicted,0.03125,31,31,CACGAAAGCCACGGTTGAAA,0,5267106
zapB_predicted,0.03125,31,31,CACCTACTGCGGAGTACGTG,0,5287719
zapB_predicted,0.03125,31,31,AGGTTACAGCCTGGGGTCAG,0,5268861
zapB_predicted,0.03125,31,31,ACGGCTGCCTGGATGCTTTA,0,5287481
zapB_predicted,0.03125,31,31,AAGGTCTTAGCCTCGGTGTC,0,5285447
zapB_predicted,0.03225806451612903,30,30,TTGTACAGGGGTCAGTCACG,0,5278470
zapB_predicted,0.03225806451612903,30,30,TGTTCTCTATATGATTCTGC,0,5263398
zapB_predicted,0.03225806451612903,30,30,TGGTGAGCACCTCATCACCC,0,5267999
zapB_predicted,0.03225806451612903,30,30,TGCTATCGTCTTTGGGCTCA,0,5266856
zapB_predicted,0.03225806451612903,30,30,TGAGGGGTGGGTACAGGTAG,0,5272493
zapB_predicted,0.03225806451612903,30,30,TATGTATACACGTAAGTAAG,0,5267474
zapB_predicted,0.03225806451612903,30,30,GTTTTCTCAGATGACTTTGC,0,5277318
zapB_predicted,0.03225806451612903,30,30,GTCGCTGAGGTCCCATCAGG,0,5267542
zapB_predicted,0.03225806451612903,30,30,GGGGAGATCAAGACGCGGAT,0,5278831
zapB_predicted,0.03225806451612903,30,30,GGCTGATTTGCTATGCAAAC,0,5284189
zapB_predicted,0.03225806451612903,30,30,GGCCGTCGCTGCTAGTTGTT,0,5274735
zapB_predicted,0.03225806451612903,30,30,GCTCACCGCGTGGATATTCC,0,5263291
zapB_predicted,0.03225806451612903,30,30,GCAGGCGTTGAATGCATAAT,0,5267460
zapB_predicted,0.03225806451612903,30,30,GATTGGATGTGCAGTTCCGT,0,5266370
zapB_predicted,0.03225806451612903,30,30,CTACGACGTTCGACAATCGT,0,5287594
zapB_predicted,0.03225806451612903,30,30,CGTTAGAAACTTACCTTTGT,0,5274226
zapB_predicted,0.03225806451612903,30,30,CGTAAGAGCTTTGTCTCGCA,0,5263845
zapB_predicted,0.03225806451612903,30,30,CCCAGGAGAGGACGGAGGAC,0,5267348
zapB_predicted,0.03225806451612903,30,30,CATCATCACAGCGAGCGTGA,0,5267365
zapB_predicted,0.03225806451612903,30,30,ATCGATAGAGATACCCTCAT,0,5269972
zapB_predicted,0.03225806451612903,30,30,ATACGTTTGGCCAATTCCAA,0,5285340
zapB_predicted,0.03225806451612903,30,30,AGGCTAATACAGTCTTAGGC,0,5269738
zapB_predicted,0.03225806451612903,30,30,ACGTATGCGTGTTATTGATA,0,5266307
zapB_predicted,0.03225806451612903,30,30,ACCGCTTCCGCGTCCCCCGA,0,5280651
zapB_predicted,0.03225806451612903,30,30,ACAATGCGTGTCTCTTGTAG,0,5281945
zapB_predicted,0.03225806451612903,30,30,AAGCACCTTGGGTCACACTT,0,5269931
zapB_predicted,0.03333333333333333,29,29,TTGATCACTATCAAGAGTCA,0,5263727
zapB_predicted,0.03333333333333333,29,29,TTCGGTACCGTCGTCTCGCC,0,5275296
zapB_predicted,0.03333333333333333,29,29,TGTCAAGCGTTATAAGCTAG,0,5282292
zapB_predicted,0.03333333333333333,29,29,TCCCGGACTCACTCCGAGGA,0,5279143
zapB_predicted,0.03333333333333333,29,29,GTTGGTGTCTGCACTTGGAT,0,5267998
zapB_predicted,0.03333333333333333,29,29,GTGTATTTCATGGGCACCCA,0,5270983
zapB_predicted,0.03333333333333333,29,29,GTAGGGAGTGCGATGAATTG,0,5267959
zapB_predicted,0.03333333333333333,29,29,GGTTAACACAATAGTAGGTT,0,5283951
zapB_predicted,0.03333333333333333,29,29,GCGACCAGATCTCGGATGTA,0,5272070
zapB_predicted,0.03333333333333333,29,29,GCGAAATACTCATCGCGTAG,0,5278485
zapB_predicted,0.03333333333333333,29,29,GCCACGCGTGGAGAATAGAA,0,5279066
zapB_predicted,0.03333333333333333,29,29,GCACGTCACATATCTAGTAT,0,5286889
zapB_predicted,0.03333333333333333,29,29,GACGTAGACCCCCACTATGT,0,5279016
zapB_predicted,0.03333333333333333,29,29,CTTCGCCGCAACGCATACTA,0,5282024
zapB_predicted,0.03333333333333333,29,29,CTGTGCCCGAGCACAGGCAA,0,5278586
zapB_predicted,0.03333333333333333,29,29,CTCCTCACCACAACTCGGCA,0,5263722
zapB_predicted,0.03333333333333333,29,29,CGCAAATTCTTGTCACGAGA,0,5267695
zapB_predicted,0.03333333333333333,29,29,CGACTTAACCACCTAGTTGG,0,5263471
zapB_predicted,0.03333333333333333,29,29,CCGGTGCCCAAGCGGGCTGC,0,5279200
zapB_predicted,0.03333333333333333,29,29,CCCGGGCATAACGTATTTGA,0,5277324
zapB_predicted,0.03333333333333333,29,29,CCCGACATAACTCGTGAGGG,0,5268699
zapB_predicted,0.03333333333333333,29,29,CAGAAGGCATTAGTCAATCC,0,5269027
zapB_predicted,0.03333333333333333,29,29,AGAGGTCTGGAGGAGTAAGG,0,5272779
zapB_predicted,0.03333333333333333,29,29,AGAGCTGAATGGTAAGGAGG,0,5269742
zapB_predicted,0.03333333333333333,29,29,ACCATTGCGGAAAGGGTCCG,0,5271940
zapB_predicted,0.03333333333333333,29,29,AACAAGCATATCGGCAAGGG,0,5268726
zapB_predicted,0.034482758620689655,28,28,TTATAGCCCGACTCTATGTA,0,5264812
zapB_predicted,0.034482758620689655,28,28,TGGTTCCGGGTTTCACTCTT,0,5265215
zapB_predicted,0.034482758620689655,28,28,TGGGAATTGGTTCTACACGA,0,5264029
zapB_predicted,0.034482758620689655,28,28,TCTGCGCGTCCAATTCGCAT,0,5271673
zapB_predicted,0.034482758620689655,28,28,TCAGTTCTCGTGCGCCCGTA,0,5279316
zapB_predicted,0.034482758620689655,28,28,GTATCGGTCTTCCAATTCTT,0,5263847
zapB_predicted,0.034482758620689655,28,28,GCTTTAGCTCCTATCAGAGT,0,5283744
zapB_predicted,0.034482758620689655,28,28,GCCGATCGCTGTGACGGGCT,0,5279822
zapB_predicted,0.034482758620689655,28,28,GAGCCGCTGGCTCGGTTGCG,0,5273760
zapB_predicted,0.034482758620689655,28,28,GAGAGTCGCATATTGAACTA,0,5279893
zapB_predicted,0.034482758620689655,28,28,GACCGTTGTCGAACCGGGGA,0,5274331
zapB_predicted,0.034482758620689655,28,28,CTGGGTTCAGCTGTTCGCTC,0,5278682
zapB_predicted,0.034482758620689655,28,28,CTAAGAGGTGCTGTGGCGCG,0,5282083
zapB_predicted,0.034482758620689655,28,28,CGTGGGTCGGGGAGCTCCAT,0,5267099
zapB_predicted,0.034482758620689655,28,28,CGACTGCTGACAATTGGAGT,0,5269914
zapB_predicted,0.034482758620689655,28,28,CCAGCGTGAGTTATCTGTAT,0,5273054
zapB_predicted,0.034482758620689655,28,28,CATTCCGTGGGGACCCAGAT,0,5264701
zapB_predicted,0.034482758620689655,28,28,ATGGGAGTGAAAGGCTTTTC,0,5269947
zapB_predicted,0.034482758620689655,28,28,ATGATTTACCTTACCGGTAG,0,5280260
zapB_predicted,0.034482758620689655,28,28,AGCACTGCTTGAACTGGTCG,0,5271161
zapB_predicted,0.034482758620689655,28,28,ACGAATGAGGTTCCGGTATT,0,5278676
zapB_predicted,0.034482758620689655,28,28,ACCAGGAAATGCCGACTTGT,0,5283814
zapB_predicted,0.034482758620689655,28,28,AATGGCCCAGGCAAGAACAA,0,5268472
zapB_predicted,0.034482758620689655,28,28,AAACGAGCAATGCAATACTA,0,5272197
zapB_predicted,0.03571428571428571,27,27,TGTTGATAAGAATAAAAATT,0,5263652
zapB_predicted,0.03571428571428571,27,27,TCGATTGGCCCCACGCGGGA,0,5274775
zapB_predicted,0.03571428571428571,27,27,TCCCGCGGGAACAAAACGAA,0,5264054
zapB_predicted,0.03571428571428571,27,27,TAAGATTCATGAGCGGTGAA,0,5281332
zapB_predicted,0.03571428571428571,27,27,GTTCGGTTCGTATCGCGTAA,0,5271502
zapB_predicted,0.03571428571428571,27,27,GTTCACGCTAATTGTCCATT,0,5279466
zapB_predicted,0.03571428571428571,27,27,GTCCATATGAGGTGATTAAT,0,5276062
zapB_predicted,0.03571428571428571,27,27,GTACTTCCAGTATAGGCGTA,0,5269302
zapB_predicted,0.03571428571428571,27,27,GGGGCCTCCGTTTGGGAGTG,0,5263272
zapB_predicted,0.03571428571428571,27,27,GCACGTCGTTAGAACGGTGA,0,5271588
zapB_predicted,0.03571428571428571,27,27,GCAAGTGTAGGTGCTTACTC,0,5279012
zapB_predicted,0.03571428571428571,27,27,GATTTCAATAGACATCGTGA,0,5279704
zapB_predicted,0.03571428571428571,27,27,GATTCGGACACGAATATCAG,0,5282892
zapB_predicted,0.03571428571428571,27,27,GATCTCTAAAGCACGCCCAG,0,5268868
zapB_predicted,0.03571428571428571,27,27,GACCTTCCATCCCTGCCCGA,0,5278321
zapB_predicted,0.03571428571428571,27,27,GACCGATCTCGACCGATCCT,0,5274233
zapB_predicted,0.03571428571428571,27,27,GAACGGCCTTCGCGAATAAG,0,5263106
zapB_predicted,0.03571428571428571,27,27,GAAAGTGACCACCGTATTGT,0,5279887
zapB_predicted,0.03571428571428571,27,27,CTAATAGGCTTTTATTGGTA,0,5270794
zapB_predicted,0.03571428571428571,27,27,CGGAGCTGAGAAATTTTCCA,0,5280088
zapB_predicted,0.03571428571428571,27,27,CGGACTGCGTTAGAAGAACG,0,5273487
zapB_predicted,0.03571428571428571,27,27,CCGCGTATGCGTCCTGAACT,0,5265575
zapB_predicted,0.03571428571428571,27,27,CACACGGAGACACCGAATAT,0,5273506
zapB_predicted,0.03571428571428571,27,27,ATCCATACCGACCTCAATAG,0,5278923
zapB_predicted,0.03571428571428571,27,27,AGACTCGGCCGTGTCCTCCG,0,5269991
zapB_predicted,0.03571428571428571,27,27,AGACAACGACTCAAGCATGA,0,5264167
zapB_predicted,0.03571428571428571,27,27,ACGGGTAGTGGAGCCCTTAG,0,5283961
zapB_predicted,0.03571428571428571,27,27,ACCTAAGATATGGGAACCTT,0,5279184
zapB_predicted,0.03571428571428571,27,27,ACACGTTGTTTTGAAGGCCG,0,5268863
zapB_predicted,0.03571428571428571,27,27,AATGATTCAGGAAAGTTTGC,0,5278285
zapB_predicted,0.03571428571428571,27,27,AATATGATTGACAATCAAGG,0,5263060
zapB_predicted,0.03571428571428571,27,27,AAGATAGCACAGCACCTTGT,0,5281860
zapB_predicted,0.037037037037037035,26,26,TTTGACGTAGCCATCGACGA,0,5278258
zapB_predicted,0.037037037037037035,26,26,TTCGCCATGACCAGGCCCTC,0,5267147
zapB_predicted,0.037037037037037035,26,26,TTCATTTTACACCGGTAGCT,0,5269963
zapB_predicted,0.037037037037037035,26,26,TTAGCAAGAGCTTAATGAGA,0,5284640
zapB_predicted,0.037037037037037035,26,26,TGTTAGCAAACTGGCGGTGG,0,5271141
zapB_predicted,0.037037037037037035,26,26,TGGTATCTACGGGCACGCCC,0,5265246
zapB_predicted,0.037037037037037035,26,26,TGGAGCCGTCCAAGTGGTGG,0,5270946
zapB_predicted,0.037037037037037035,26,26,TGAGGCGCGGCAAATTGTAA,0,5265683
zapB_predicted,0.037037037037037035,26,26,TATGGTGTGTGTCGTTATAC,0,5283876
zapB_predicted,0.037037037037037035,26,26,TATCGCTGGAGAGTCGGGGC,0,5272446
zapB_predicted,0.037037037037037035,26,26,TACGAACGACTCCTGCATGC,0,5270255
zapB_predicted,0.037037037037037035,26,26,GTTATGGAGGAACGTTAGTT,0,5270696
zapB_predicted,0.037037037037037035,26,26,GTAACCGTGTGCATTACCAT,0,5280449
zapB_predicted,0.037037037037037035,26,26,GGTCAGACTCTAATGAAACT,0,5286036
zapB_predicted,0.037037037037037035,26,26,GGTATCCGGGGCGTAAACGC,0,5274825
zapB_predicted,0.037037037037037035,26,26,GGGGGTGGCGACAGATATTG,0,5270351
zapB_predicted,0.037037037037037035,26,26,GGATACTTTTCGAGCGTTCT,0,5281619
zapB_predicted,0.037037037037037035,26,26,GGAACAACCACGACGTCTGA,0,5287350
zapB_predicted,0.037037037037037035,26,26,GCTACAGTAAGCCGTTTCAG,0,5275349
zapB_predicted,0.037037037037037035,26,26,GCGCGTGCGCAGCATTATAT,0,5271491
zapB_predicted,0.037037037037037035,26,26,GCCGTCAAGCATAGGATGTA,0,5277441
zapB_predicted,0.037037037037037035,26,26,GCCAAAAGATATGGCGTTGC,0,5275955
zapB_predicted,0.037037037037037035,26,26,GACAAGCTCGGTACTCGTCC,0,5273155
zapB_predicted,0.037037037037037035,26,26,GAACAATGGCCTCTAATCGA,0,5273924
zapB_predicted,0.037037037037037035,26,26,CTGGATGTAGGCCGGACCAA,0,5270604
zapB_predicted,0.037037037037037035,26,26,CTGCTCTCTCTATTAGAGAC,0,5288032
zapB_predicted,0.037037037037037035,26,26,CTCGTTATATATCCGCATAA,0,5285121
zapB_predicted,0.037037037037037035,26,26,CGTGATATGCTCGGGCGATA,0,5288329
zapB_predicted,0.037037037037037035,26,26,CGCCAAAGAACGTGCGTTTT,0,5271152
zapB_predicted,0.037037037037037035,26,26,CGACATTCCGCCACCATGGA,0,5280982
zapB_predicted,0.037037037037037035,26,26,CCTATATGTGCAAAGCAGAA,0,5277912
zapB_predicted,0.037037037037037035,26,26,CATCAACAGTCAACGGGGAA,0,5265249
zapB_predicted,0.037037037037037035,26,26,CAGGTAGGAAATTGAGACGG,0,5283178
zapB_predicted,0.037037037037037035,26,26,ATTGAACCAAGTACGAACGA,0,5284671
zapB_predicted,0.037037037037037035,26,26,ATGAACTGAACTATTGGGGG,0,5264881
zapB_predicted,0.037037037037037035,26,26,ATAGCTCCCTCGGGTAGACC,0,5275176
zapB_predicted,0.037037037037037035,26,26,AGGACTGGAGGCTCTAGGGT,0,5270704
zapB_predicted,0.037037037037037035,26,26,ACTATCGCCGCTATCCGCTA,0,5283012
zapB_predicted,0.037037037037037035,26,26,ACGTAACAGGCGGGGCGGTC,0,5286267
zapB_predicted,0.037037037037037035,26,26,ACGAACAACTTCTAGTGCCA,0,5264786
zapB_predicted,0.037037037037037035,26,26,ACATCGTCTTGACGTTATAT,0,5280524
zapB_predicted,0.037037037037037035,26,26,ACAGAAGCTGACCCACGTGG,0,5263653
zapB_predicted,0.037037037037037035,26,26,AAGTAGCGACAAGCGAGCAT,0,5275631
zapB_predicted,0.038461538461538464,25,25,TTTCGTCCAAGCTCTGGCGC,0,5270120
zapB_predicted,0.038461538461538464,25,25,TTCGCGTCACACGTGGAGTA,0,5269795
zapB_predicted,0.038461538461538464,25,25,TGCTATACCTTGGCACCCGA,0,5272032
zapB_predicted,0.038461538461538464,25,25,TGCGACTGCCACTTTCTTGG,0,5264140
zapB_predicted,0.038461538461538464,25,25,TGAGTCCCTTGTAAAGTGCG,0,5279430
zapB_predicted,0.038461538461538464,25,25,TGAGCAGTGCGGCTACTGTA,0,5267052
zapB_predicted,0.038461538461538464,25,25,TCTGCAGAGTTCATGATAGT,0,5279524
zapB_predicted,0.038461538461538464,25,25,TCTACACTTGTGTGGTAAGA,0,5276166
zapB_predicted,0.038461538461538464,25,25,TCGGGAAGGAGGTAACCGTA,0,5263677
zapB_predicted,0.038461538461538464,25,25,TACACGGATATCGTCCCAGC,0,5265678
zapB_predicted,0.038461538461538464,25,25,GTTGTGTTTGCCACAGCATT,0,5272129
zapB_predicted,0.038461538461538464,25,25,GGTACAAGGTGGGCAACCCC,0,5286531
zapB_predicted,0.038461538461538464,25,25,GGGTTAGGGCCTACGCGTTT,0,5283830
zapB_predicted,0.038461538461538464,25,25,GGGCAGCCGGAAATGTCTTG,0,5272808
zapB_predicted,0.038461538461538464,25,25,GGAAACTGCTTTTACCTACT,0,5274806
zapB_predicted,0.038461538461538464,25,25,GCTTGCACAACACAGGTAGG,0,5280112
zapB_predicted,0.038461538461538464,25,25,GCTACCTTGGACCCGTCTGA,0,5279826
zapB_predicted,0.038461538461538464,25,25,GCCTTCACCCTTGAAAAGGT,0,5270130
zapB_predicted,0.038461538461538464,25,25,GAAGAAGCATGCTTTCATAT,0,5280347
zapB_predicted,0.038461538461538464,25,25,CTTAACCTTGGCTAGAGATA,0,5263391
zapB_predicted,0.038461538461538464,25,25,CTGTACATGTCGAACCCCCT,0,5281563
zapB_predicted,0.038461538461538464,25,25,CTGGCCATTAAATGATCGCA,0,5271157
zapB_predicted,0.038461538461538464,25,25,CTGGCAAGGTCGGCGGTACT,0,5274794
zapB_predicted,0.038461538461538464,25,25,CGGTGCGGACTTCCGTTCTA,0,5271027
zapB_predicted,0.038461538461538464,25,25,CCGGCTTCGCATCAGCCTAT,0,5267859
zapB_predicted,0.038461538461538464,25,25,CCGCTTATGATGCGCGCCGT,0,5275236
zapB_predicted,0.038461538461538464,25,25,CATGCTGTCACTAAGCGGCC,0,5265680
zapB_predicted,0.038461538461538464,25,25,CATAATGGGCGGCGAGTCAG,0,5265380
zapB_predicted,0.038461538461538464,25,25,CACGTCCTGCATGCCCGCGA,0,5288328
zapB_predicted,0.038461538461538464,25,25,CACAGCCTCATCAAGAAATT,0,5274923
zapB_predicted,0.038461538461538464,25,25,CACACCCACTGATCCAACGA,0,5276150
zapB_predicted,0.038461538461538464,25,25,CAAAATGGATACAGGCCGGC,0,5280109
zapB_predicted,0.038461538461538464,25,25,ATTGTGTTCTTTAACAGCTA,0,5271441
zapB_predicted,0.038461538461538464,25,25,ATGCGATACGTTACAATCGA,0,5283070
zapB_predicted,0.038461538461538464,25,25,ATCTGGAGTAAGCGAGGATT,0,5281611
zapB_predicted,0.038461538461538464,25,25,AGTAGCTCAACCGTTTTTTG,0,5277232
zapB_predicted,0.038461538461538464,25,25,AGGGCAGTCTGGCGGACACA,0,5280849
zapB_predicted,0.038461538461538464,25,25,AGGATTTCGTATAACGAACT,0,5282515
zapB_predicted,0.04,24,24,TTCTAGCTAGTGAGTAGGCA,0,5285315
zapB_predicted,0.04,24,24,TTCCCTCCAGCTGCGGGTCA,0,5269496
zapB_predicted,0.04,24,24,TGTCCGCGATCCTCATCAAT,0,5265362
zapB_predicted,0.04,24,24,TGAATATGCAAAGGAGGGTC,0,5274740
zapB_predicted,0.04,24,24,TGAACGTAGACGTCGGCTGC,0,5286765
zapB_predicted,0.04,24,24,TCGTTACAGCCTACCGGTAG,0,5265713
zapB_predicted,0.04,24,24,TCGTACTGGCATACGGACAA,0,5271658
zapB_predicted,0.04,24,24,GGTCACGACATCCCCTCACG,0,5268471
zapB_predicted,0.04,24,24,GGGATAATCGTTGATCATAT,0,5269987
zapB_predicted,0.04,24,24,GGGAAGGCCACAGTTGGGGT,0,5267997
zapB_predicted,0.04,24,24,GGCAGCTATCCACTTTTGGG,0,5277781
zapB_predicted,0.04,24,24,GGAAAATAGACGGTTGGTTT,0,5282727
zapB_predicted,0.04,24,24,GCTAGGCCCGAGGCCGTACA,0,5273926
zapB_predicted,0.04,24,24,GCTAGCGAAGTGGGCCGTGA,0,5267391
zapB_predicted,0.04,24,24,GCGCTACCTCGCCTACGTGG,0,5276863
zapB_predicted,0.04,24,24,GCCCCTCTATTGGACGGAAC,0,5265152
zapB_predicted,0.04,24,24,GCCAAAAACGAATGTACCGT,0,5263384
zapB_predicted,0.04,24,24,GAGTGGGGAGTATTAATACA,0,5269783
zapB_predicted,0.04,24,24,GACTAGGAGCACTCCCCCAC,0,5280451
zapB_predicted,0.04,24,24,CTTGTTGAATGCATCCCACT,0,5287019
zapB_predicted,0.04,24,24,CTAAGACCGGCTGTTTGATT,0,5263816
zapB_predicted,0.04,24,24,CGTTATCAGACTCAATACAT,0,5271923
zapB_predicted,0.04,24,24,CGTAACGTTATCATTGTACA,0,5288374
zapB_predicted,0.04,24,24,CGGCTGGCAATTAAGAAAAC,0,5284410
zapB_predicted,0.04,24,24,CGGACTGTGTAAAAGGATAT,0,5272949
zapB_predicted,0.04,24,24,CGCCCCGTCTTCATTTACGT,0,5264815
zapB_predicted,0.04,24,24,CGCAGGAGACAGCTATCCCG,0,5278718
zapB_predicted,0.04,24,24,CCTACTTTGCGATTGGGGGA,0,5277534
zapB_predicted,0.04,24,24,CCGTGCAGCGTCTTTTATGT,0,5270132
zapB_predicted,0.04,24,24,CCGCTTGCCAAACCGTCCAC,0,5277558
zapB_predicted,0.04,24,24,CCCTTCACTCGCTTTGCGGA,0,5263950
zapB_predicted,0.04,24,24,CCACTGCGACCGGTACGCGT,0,5286707
zapB_predicted,0.04,24,24,ATGGCAAACTGCCGTGAGTT,0,5267633
zapB_predicted,0.04,24,24,ATATTGCTTTTGGTCGGGCA,0,5272763
zapB_predicted,0.04,24,24,AGGACGTACTGTCCACACTT,0,5285380
zapB_predicted,0.04,24,24,ACTTACCATGTCTTCTGGAC,0,5277024
zapB_predicted,0.04,24,24,ACCTGAGGGTCTAGAGTAGC,0,5269216
zapB_predicted,0.04,24,24,AACGTCGTCCACGGGAGGTA,0,5287784
zapB_predicted,0.04,24,24,AACATATATGTCTTTCCCCC,0,5272575
zapB_predicted,0.04,24,24,AAAAGCTCCCGAAGTCCTCA,0,5266731
zapB_predicted,0.041666666666666664,23,23,TTTAGCTGTGACAACATTAG,0,5277351
zapB_predicted,0.041666666666666664,23,23,TTGTTTTCAAGTGCGTCTGC,0,5279649
zapB_predicted,0.041666666666666664,23,23,TTGGCGGCATCATATATTGA,0,5277331
zapB_predicted,0.041666666666666664,23,23,TTGAAATGCCGTTGTCGAGG,0,5268352
zapB_predicted,0.041666666666666664,23,23,TTCTTGAGGTGGGTAAAGGT,0,5263150
zapB_predicted,0.041666666666666664,23,23,TGTGAGTGATCGTGTCCTAT,0,5272994
zapB_predicted,0.041666666666666664,23,23,TGGAGGGTGGATCTATCAAT,0,5284878
zapB_predicted,0.041666666666666664,23,23,TGCCCGAGACACAGCGTTGC,0,5268970
zapB_predicted,0.041666666666666664,23,23,TGAACTTAAGGACCGTGTGT,0,5284864
zapB_predicted,0.041666666666666664,23,23,TCTGGAGTCCGCAGGATCAT,0,5286169
zapB_predicted,0.041666666666666664,23,23,TCACTGACCTTAAGATCTCA,0,5268161
zapB_predicted,0.041666666666666664,23,23,TACAGGCGTCGTAGCGCTGT,0,5287986
zapB_predicted,0.041666666666666664,23,23,GTTTCTCGCCGAGCCCGACG,0,5271743
zapB_predicted,0.041666666666666664,23,23,GTACTCAGGGATGTCGGTGT,0,5264352
zapB_predicted,0.041666666666666664,23,23,GGTGGGATTCGATCCAAGAT,0,5271354
zapB_predicted,0.041666666666666664,23,23,GGTAATCAATGAAACTAGAG,0,5266357
zapB_predicted,0.041666666666666664,23,23,GGGTTGACGCACAAGCTACT,0,5282650
zapB_predicted,0.041666666666666664,23,23,GGGTAAAGCTAAATTTATGT,0,5274924
zapB_predicted,0.041666666666666664,23,23,GGGGTACCCCTGCATAAAAA,0,5274104
zapB_predicted,0.041666666666666664,23,23,GGCTTTTTCCTGCTAGAGGA,0,5268265
zapB_predicted,0.041666666666666664,23,23,GGATTTGCATACCCCGTTTC,0,5264159
zapB_predicted,0.041666666666666664,23,23,GGATTAAACTAGAACTGCGT,0,5276484
zapB_predicted,0.041666666666666664,23,23,GGATAGTATTCGCCTGATAC,0,5286958
zapB_predicted,0.041666666666666664,23,23,GGAGTGATAGAGGCGGGTGC,0,5283280
zapB_predicted,0.041666666666666664,23,23,GGAACCTGGGAAAGGTTATA,0,5285081
zapB_predicted,0.041666666666666664,23,23,GCTCTTTGAGCCTTAAGACA,0,5279480
zapB_predicted,0.041666666666666664,23,23,GCTCTGTGTTAATGATCTTA,0,5274778
zapB_predicted,0.041666666666666664,23,23,GCGTTGAATGCTCCCACTCC,0,5287657
zapB_predicted,0.041666666666666664,23,23,GCATCTGCGTAGACCATGCT,0,5284039
zapB_predicted,0.041666666666666664,23,23,GCACTGTATAGTTAAAGAGT,0,5273723
zapB_predicted,0.041666666666666664,23,23,GCAAGCGATATATTTACCCG,0,5288393
zapB_predicted,0.041666666666666664,23,23,GAGGGTCCGAACACGTCCGC,0,5278283
zapB_predicted,0.041666666666666664,23,23,GAGCCGACGCACGCTCCGAC,0,5266547
zapB_predicted,0.041666666666666664,23,23,GACCAAGTGTATTCTTATAT,0,5263149
zapB_predicted,0.041666666666666664,23,23,CTGGGTGTTTAAAGTCGCAT,0,5267585
zapB_predicted,0.041666666666666664,23,23,CTCTAGTGTCAGGTGTCTAC,0,5284707
zapB_predicted,0.041666666666666664,23,23,CGTGGACGCGACGAGCACTC,0,5272620
zapB_predicted,0.041666666666666664,23,23,CGGGTCGGGTCCCTTTTCGA,0,5274549
zapB_predicted,0.041666666666666664,23,23,CGCCGTTCACTGTTGTGGAT,0,5285566
zapB_predicted,0.041666666666666664,23,23,CGAGGGGCACATGAGAACCA,0,5269922
zapB_predicted,0.041666666666666664,23,23,CCAGCTAATTCTTCGAGTCA,0,5269611
zapB_predicted,0.041666666666666664,23,23,CATCGTATAAACGCTCGGTG,0,5283485
zapB_predicted,0.041666666666666664,23,23,CATATTGTCTACTTGGGAGT,0,5272388
zapB_predicted,0.041666666666666664,23,23,CAGTGCTACTGCAACGATTA,0,5271159
zapB_predicted,0.041666666666666664,23,23,CACAGAGATTTCCTGGTAGG,0,5267019
zapB_predicted,0.041666666666666664,23,23,CAACTTGGTAAGGACTTTTC,0,5274193
zapB_predicted,0.041666666666666664,23,23,ATTACCATTTGAGGCCGTCA,0,5277134
zapB_predicted,0.041666666666666664,23,23,ATGTATAGCACATCGGTCGG,0,5280097
zapB_predicted,0.041666666666666664,23,23,ATCGAGGTGTTATACGCAGA,0,5285036
zapB_predicted,0.041666666666666664,23,23,AGTCGGGAAGTAGACATTTC,0,5278736
zapB_predicted,0.041666666666666664,23,23,AGTAAGCCTCCCTATAATCC,0,5275393
zapB_predicted,0.041666666666666664,23,23,AGGCGGTCCGGAATTTATGC,0,5277400
zapB_predicted,0.041666666666666664,23,23,AGCATACTGCTCCAAGGCGT,0,5278236
zapB_predicted,0.041666666666666664,23,23,AGATGACGGAAGGTTATGCA,0,5280729
zapB_predicted,0.041666666666666664,23,23,AGATCAGTCCCAAAGTTAGT,0,5270228
zapB_predicted,0.041666666666666664,23,23,AGATCAAGTCGCTCTGGGGG,0,5276358
zapB_predicted,0.041666666666666664,23,23,ACTTGCTCGTTCCCGTGGTG,0,5276063
zapB_predicted,0.041666666666666664,23,23,ACTCACTCGTCTACTAGCTA,0,5265335
zapB_predicted,0.041666666666666664,23,23,ACCTGTGGGTAATATTTGGG,0,5278615
zapB_predicted,0.041666666666666664,23,23,ACATTGTCACCCGCTATTAG,0,5264724
zapB_predicted,0.041666666666666664,23,23,ACACTATCCGACATTTACAG,0,5276014
zapB_predicted,0.041666666666666664,23,23,ACACGGGATTAAGATCGTCC,0,5279195
zapB_predicted,0.041666666666666664,23,23,AATGCCACGAATAGTCGGCG,0,5274449
zapB_predicted,0.041666666666666664,23,23,AACGGGTAGTAGAATCGTCT,0,5264731
zapB_predicted,0.041666666666666664,23,23,AACAGGGAGGCGAGGAGCCA,0,5275099
zapB_predicted,0.043478260869565216,22,22,TTCTGCGAATAAAGGGCTAA,0,5269925
zapB_predicted,0.043478260869565216,22,22,TGTCCTTGCTCCCCACCGAC,0,5282291
zapB_predicted,0.043478260869565216,22,22,TGGATCGGCCCTGCTCGGAA,0,5265554
zapB_predicted,0.043478260869565216,22,22,TCTGAGTCGGATGGCAGGCA,0,5268971
zapB_predicted,0.043478260869565216,22,22,TCCGGCGGGGAGGCATAAAG,0,5286790
zapB_predicted,0.043478260869565216,22,22,TAGCGGTCTGAATGTATCTG,0,5268277
zapB_predicted,0.043478260869565216,22,22,TACTTGCCGTATACGCGGAG,0,5284695
zapB_predicted,0.043478260869565216,22,22,TACAGCACCCAGTGATGTCA,0,5270244
zapB_predicted,0.043478260869565216,22,22,GTTAATTCAATGACAGCGCG,0,5267974
zapB_predicted,0.043478260869565216,22,22,GTGTGTTCTTCATGCAAGGC,0,5284639
zapB_predicted,0.043478260869565216,22,22,GTGTCGTGTTTATTTAAGGT,0,5270258
zapB_predicted,0.043478260869565216,22,22,GTGCTTCCGGCTAAATACCA,0,5275413
zapB_predicted,0.043478260869565216,22,22,GTGCAAGTCTGGGAAAGCGG,0,5277935
zapB_predicted,0.043478260869565216,22,22,GTCCATCTGTCACTACACGA,0,5270256
zapB_predicted,0.043478260869565216,22,22,GTCACGTGTCCGGCCCTTCC,0,5272743
zapB_predicted,0.043478260869565216,22,22,GGTAGTGCGGGGATGTGTGA,0,5265441
zapB_predicted,0.043478260869565216,22,22,GGTAGGACTAATAGCGTGAG,0,5273394
zapB_predicted,0.043478260869565216,22,22,GGGTTTCAGACTCTAAGGGT,0,5263982
zapB_predicted,0.043478260869565216,22,22,GGGTGACGGTTGAGTATGAC,0,5274264
zapB_predicted,0.043478260869565216,22,22,GGGTACAACCCCAATAAACA,0,5287220
zapB_predicted,0.043478260869565216,22,22,GGCGTTGGAAAGGCGGTTAT,0,5275870
zapB_predicted,0.043478260869565216,22,22,GGCCTAATACGTATCCGTGC,0,5269303
zapB_predicted,0.043478260869565216,22,22,GGATGGTGACGCGTTATTTA,0,5266876
zapB_predicted,0.043478260869565216,22,22,GGACTGACAAGGAACTATAC,0,5282909
zapB_predicted,0.043478260869565216,22,22,GCTCGGGAGGCTACGACTAA,0,5274345
zapB_predicted,0.043478260869565216,22,22,GCGGACAGCGATGTTCCAAG,0,5282152
zapB_predicted,0.043478260869565216,22,22,GCGCAGCTCGTTCCGGGGGC,0,5278591
zapB_predicted,0.043478260869565216,22,22,GCACGTATCGGACACGATTA,0,5288206
zapB_predicted,0.043478260869565216,22,22,GCACAATATCTGCGTCCGGG,0,5269179
zapB_predicted,0.043478260869565216,22,22,GAGCGGCAATGCGTGCACGT,0,5286856
zapB_predicted,0.043478260869565216,22,22,GAGCATTCGGTCCTGGCTGA,0,5267243
zapB_predicted,0.043478260869565216,22,22,GACCTCGGTTACGGCTAGTA,0,5270137
zapB_predicted,0.043478260869565216,22,22,GAATACGTGATTGATCCAAT,0,5277479
zapB_predicted,0.043478260869565216,22,22,GAAACGGACGTAGCGTCCAG,0,5274720
zapB_predicted,0.043478260869565216,22,22,CTGGCTTGGACCTGGGTCTT,0,5271700
zapB_predicted,0.043478260869565216,22,22,CTCCCTTCACGGGTATGTCC,0,5274965
zapB_predicted,0.043478260869565216,22,22,CTATTTACCGCTGTGATCTA,0,5270025
zapB_predicted,0.043478260869565216,22,22,CTATAATAAGTAGGTACGGA,0,5265340
zapB_predicted,0.043478260869565216,22,22,CTACTTGGGGATACGAGGTT,0,5268479
zapB_predicted,0.043478260869565216,22,22,CTACGGTGTCTTTAATTGCG,0,5285264
zapB_predicted,0.043478260869565216,22,22,CGGTTGCCGTACGAAAAGAA,0,5268448
zapB_predicted,0.043478260869565216,22,22,CGGTATGATGGATAGAATGT,0,5287663
zapB_predicted,0.043478260869565216,22,22,CGGGAGAGGGGAAACAGGTG,0,5281856
zapB_predicted,0.043478260869565216,22,22,CGCAAACTAGCTCGGTTTTA,0,5271787
zapB_predicted,0.043478260869565216,22,22,CGATTATGAGTTATGATCCA,0,5273226
zapB_predicted,0.043478260869565216,22,22,CGACTCGGGTAAATGAGTAT,0,5276386
zapB_predicted,0.043478260869565216,22,22,CCACACGCCACGAATACACT,0,5278890
zapB_predicted,0.043478260869565216,22,22,CCAATGTCGTTTAGACGAAC,0,5264020
zapB_predicted,0.043478260869565216,22,22,CATAATATACGTCACCGTAG,0,5266841
zapB_predicted,0.043478260869565216,22,22,ATGAAAGTGCTGCTCATCGA,0,5284877
zapB_predicted,0.043478260869565216,22,22,AGAAGACTTGAATAACGGAG,0,5286164
zapB_predicted,0.043478260869565216,22,22,ACGTCACGGGGTTCTTTCAT,0,5271100
zapB_predicted,0.043478260869565216,22,22,ACCGCTTTCAAAAGTTGTTC,0,5263647
zapB_predicted,0.043478260869565216,22,22,ACCCTGTGCAATAAGCCGCT,0,5280155
zapB_predicted,0.043478260869565216,22,22,ACATCTCGAGCAGGCCGGTG,0,5273855
zapB_predicted,0.043478260869565216,22,22,AATTTTGCGTTGTTTGCTCA,0,5263086
zapB_predicted,0.043478260869565216,22,22,AATGAGCAATTGCAACCCTC,0,5272948
zapB_predicted,0.043478260869565216,22,22,AATCCATTATCAGGACCAGA,0,5277894
zapB_predicted,0.043478260869565216,22,22,AACTTGCGCAAGCCGCACGG,0,5265818
zapB_predicted,0.043478260869565216,22,22,AACAACATCCATATGCCGTG,0,5283417
zapB_predicted,0.043478260869565216,22,22,AAAGTACTTAACCAAGTTAC,0,5270498
zapB_predicted,0.043478260869565216,22,22,AAAAATATCTGTCGTGCCAC,0,5268899
zapB_predicted,0.045454545454545456,21,21,TTTATTCATTCCGCTGGTGT,0,5285564
zapB_predicted,0.045454545454545456,21,21,TTTACGAAATCGGTCGAGGC,0,5278817
zapB_predicted,0.045454545454545456,21,21,TTCGCTCCTAGGAGACAAGC,0,5279709
zapB_predicted,0.045454545454545456,21,21,TTCAATAATTGGGAATGGAC,0,5267194
zapB_predicted,0.045454545454545456,21,21,TTAACTTCCGCAACTATCAT,0,5270558
zapB_predicted,0.045454545454545456,21,21,TGTCTGGTTTTGCTTAAGGC,0,5284855
zapB_predicted,0.045454545454545456,21,21,TGTCCGCAAAAACAAAAGCT,0,5280908
zapB_predicted,0.045454545454545456,21,21,TGGCCCCTTAGTGCTTTGAT,0,5285535
zapB_predicted,0.045454545454545456,21,21,TGCGGGAACAGACGCGCAGA,0,5270201
zapB_predicted,0.045454545454545456,21,21,TGCGCCGTTTATATGGATGT,0,5286776
zapB_predicted,0.045454545454545456,21,21,TGATTGAAACCCCGATTGAG,0,5267785
zapB_predicted,0.045454545454545456,21,21,TGATCCAAAGCATATGTCTG,0,5265124
zapB_predicted,0.045454545454545456,21,21,TCTTTGACGGTGAGCGAATT,0,5284775
zapB_predicted,0.045454545454545456,21,21,TCTTTGAATGAGACAGAGCC,0,5270500
zapB_predicted,0.045454545454545456,21,21,TCGGGGACTATAAGTAGTGG,0,5278340
zapB_predicted,0.045454545454545456,21,21,TCGCACCGGCAAGAATCATA,0,5270188
zapB_predicted,0.045454545454545456,21,21,TCGACGTGGTAGAATACGCT,0,5267473
zapB_predicted,0.045454545454545456,21,21,TCCTCCGATGGCTGGACGTA,0,5281119
zapB_predicted,0.045454545454545456,21,21,TCCGGAGTGGCCATGTGACT,0,5280968
zapB_predicted,0.045454545454545456,21,21,TCCACATACCTATTGCCGTT,0,5273172
zapB_predicted,0.045454545454545456,21,21,TATAGTCAGAATTTCATTAT,0,5272524
zapB_predicted,0.045454545454545456,21,21,TAGCCGCCGCCGATCGAATT,0,5281699
zapB_predicted,0.045454545454545456,21,21,GTTGTTCTCCTATACAATGC,0,5270722
zapB_predicted,0.045454545454545456,21,21,GTTGTAATTTACTTTTCGAG,0,5276883
zapB_predicted,0.045454545454545456,21,21,GTTACCGTCAAACTTACAGT,0,5285585
zapB_predicted,0.045454545454545456,21,21,GTGTGCCACCGAGGATCACC,0,5268317
zapB_predicted,0.045454545454545456,21,21,GTCTCACGAGGTACAAGGGA,0,5277849
zapB_predicted,0.045454545454545456,21,21,GTCCAAAATCTTAAACAGTG,0,5283853
zapB_predicted,0.045454545454545456,21,21,GTAATGCAGAAATCTCTCTG,0,5276450
zapB_predicted,0.045454545454545456,21,21,GGGAACCAGACGGGAACGAA,0,5269791
zapB_predicted,0.045454545454545456,21,21,GGCTCTGTTGATTACCGCAA,0,5281515
zapB_predicted,0.045454545454545456,21,21,GGACTTGCGAGTGGCTCCAG,0,5284818
zapB_predicted,0.045454545454545456,21,21,GCTCTGGGCTGCCAACTCCG,0,5273907
zapB_predicted,0.045454545454545456,21,21,GCTATGTTAGCCTTACTCTT,0,5266342
zapB_predicted,0.045454545454545456,21,21,GCCTGCTACTCGGATGGACA,0,5286094
zapB_predicted,0.045454545454545456,21,21,GCAGTCATGAAATTCACGTC,0,5277442
zapB_predicted,0.045454545454545456,21,21,GCAGTAAGAAGTCGGGGGTT,0,5279226
zapB_predicted,0.045454545454545456,21,21,GCACGGTACATGTACATCTA,0,5277974
zapB_predicted,0.045454545454545456,21,21,GAGGCACCATATGGGCTGCT,0,5265741
zapB_predicted,0.045454545454545456,21,21,GACGTTGCAAGGCGGTGAAG,0,5266683
zapB_predicted,0.045454545454545456,21,21,CTGGGGACTGACAAAGTAAC,0,5280723
zapB_predicted,0.045454545454545456,21,21,CTGGAAGTATGACTGATTAT,0,5272460
zapB_predicted,0.045454545454545456,21,21,CTACATAGTAATAGCTCTAC,0,5269682
zapB_predicted,0.045454545454545456,21,21,CGTTATCTTGGGATTTGCCC,0,5266417
zapB_predicted,0.045454545454545456,21,21,CGTCACCAGGGCGTGTCTTA,0,5270453
zapB_predicted,0.045454545454545456,21,21,CGGTTCAGAAAGGGTGTTAG,0,5282181
zapB_predicted,0.045454545454545456,21,21,CGCCAGATTTGTTGGACTGA,0,5273801
zapB_predicted,0.045454545454545456,21,21,CGCATGTCCGTGACGTTAAA,0,5282019
zapB_predicted,0.045454545454545456,21,21,CGCAAAGCGTACTGGGCTTC,0,5275894
zapB_predicted,0.045454545454545456,21,21,CGAGTCGGCCAGGGAGTCCA,0,5269855
zapB_predicted,0.045454545454545456,21,21,CCCCAGAACATTATGCGGGG,0,5269630
zapB_predicted,0.045454545454545456,21,21,CCCAACCAGTGTCAAAAAGC,0,5283369
zapB_predicted,0.045454545454545456,21,21,CCAGAACAAACAGTGCATGT,0,5272950
zapB_predicted,0.045454545454545456,21,21,CCACGAAAATTGCTTAGGCA,0,5274558
zapB_predicted,0.045454545454545456,21,21,CATATCGGGCGCACCTAATA,0,5265860
zapB_predicted,0.045454545454545456,21,21,CATAATACTCCAACATATAT,0,5283813
zapB_predicted,0.045454545454545456,21,21,CAGGGGGTTCTCGCTTCCCG,0,5267113
zapB_predicted,0.045454545454545456,21,21,CACTGCAGATGACCTTTTTT,0,5276072
zapB_predicted,0.045454545454545456,21,21,CACGTCACTTTCGTGAATTA,0,5267901
zapB_predicted,0.045454545454545456,21,21,CACATACCTTGGGTCGGGCT,0,5284753
zapB_predicted,0.045454545454545456,21,21,CAACGTCCAACCTATCAATA,0,5269492
zapB_predicted,0.045454545454545456,21,21,ATTTGCAGATACCAACCTTT,0,5280508
zapB_predicted,0.045454545454545456,21,21,ATGTAATCTGTCCGCGAGAC,0,5271811
zapB_predicted,0.045454545454545456,21,21,ATGCGACGTGGGCCTGGCGT,0,5267814
zapB_predicted,0.045454545454545456,21,21,ATCTTGTCCTAACGGTACAG,0,5271945
zapB_predicted,0.045454545454545456,21,21,AGTGTTCTCACATACACGCG,0,5265974
zapB_predicted,0.045454545454545456,21,21,AGTGGCCAACCGCTCCATCC,0,5280799
zapB_predicted,0.045454545454545456,21,21,AGTCCGTGCCTTTCGTGATT,0,5264655
zapB_predicted,0.045454545454545456,21,21,AGGGACACTGCCACCACCGA,0,5277092
zapB_predicted,0.045454545454545456,21,21,AGCGGAGAGCCGTTGGCACA,0,5277480
zapB_predicted,0.045454545454545456,21,21,AGATATCGAACTGTTTTATT,0,5284351
zapB_predicted,0.045454545454545456,21,21,ACAAATCACGGACGGCGTTA,0,5266201
zapB_predicted,0.045454545454545456,21,21,AAATAGAGACAAATAACGTT,0,5272690
zapB_predicted,0.045454545454545456,21,21,AAAGGGGGGAAGAGACCGGC,0,5279321
zapB_predicted,0.047619047619047616,20,20,TTTTGTCCAGGGCTTGCCTC,0,5286499
zapB_predicted,0.047619047619047616,20,20,TTCACGGGGATTCCCGTTTC,0,5276967
zapB_predicted,0.047619047619047616,20,20,TTAATACTCGGCGAGGTGTC,0,5269670
zapB_predicted,0.047619047619047616,20,20,TGTCCTTGGTACCCACGGCT,0,5267592
zapB_predicted,0.047619047619047616,20,20,TGGTCTGGCCTGGCAGGCAT,0,5278920
zapB_predicted,0.047619047619047616,20,20,TGGTCGCTCTGCACTGCAAC,0,5284923
zapB_predicted,0.047619047619047616,20,20,TGATGCTCCTCATTACGATC,0,5283719
zapB_predicted,0.047619047619047616,20,20,TCGTCGCGCAGCTACCGTTC,0,5285166
zapB_predicted,0.047619047619047616,20,20,TCGGCTAATTTGCGAACTCG,0,5267057
zapB_predicted,0.047619047619047616,20,20,TCCGGACGATACCACGCGTG,0,5277167
zapB_predicted,0.047619047619047616,20,20,TCACGAAGCTATAATTGGTA,0,5263452
zapB_predicted,0.047619047619047616,20,20,TAGGCTCGTGGTCACCTCTT,0,5279708
zapB_predicted,0.047619047619047616,20,20,TAATTTTTCCGCTACATTAG,0,5283364
zapB_predicted,0.047619047619047616,20,20,TAAAGTTTAACAGTCATGTT,0,5279124
zapB_predicted,0.047619047619047616,20,20,GTGTGGGAGTGTTGACGCGT,0,5274368
zapB_predicted,0.047619047619047616,20,20,GTCTATGTGGTTCCGATGGT,0,5275516
zapB_predicted,0.047619047619047616,20,20,GTATCTACCTCGCCAGGGTG,0,5284904
zapB_predicted,0.047619047619047616,20,20,GTAGTTTAACTAAAAATTGG,0,5267632
zapB_predicted,0.047619047619047616,20,20,GTAATCAGACTCGCAGGTTA,0,5270044
zapB_predicted,0.047619047619047616,20,20,GGGCACTGGACGGATGACTC,0,5279103
zapB_predicted,0.047619047619047616,20,20,GGATGCAGTATGCTAGGTAC,0,5270376
zapB_predicted,0.047619047619047616,20,20,GGAACCTAGGGAGAGCGCAA,0,5266874
zapB_predicted,0.047619047619047616,20,20,GCGGAACCCCCCTGCCTATC,0,5270027
zapB_predicted,0.047619047619047616,20,20,GATTGCTGAGGTTAATCTTG,0,5285908
zapB_predicted,0.047619047619047616,20,20,GATCAGCACACGGTGGATTC,0,5268836
zapB_predicted,0.047619047619047616,20,20,GAGGCATAATAGGCTGACAG,0,5273533
zapB_predicted,0.047619047619047616,20,20,GACTAGATAAATCTCGTGTC,0,5265341
zapB_predicted,0.047619047619047616,20,20,GACAGCGAGATTTCAACGTA,0,5279892
zapB_predicted,0.047619047619047616,20,20,GAATCATCCATAGGTTCGGG,0,5279933
zapB_predicted,0.047619047619047616,20,20,GAAGTTCCATGTATATTGCA,0,5278634
zapB_predicted,0.047619047619047616,20,20,GAACCATTTTAACGATGCGC,0,5269328
zapB_predicted,0.047619047619047616,20,20,GAAAGCTGGCGCCATCCGTT,0,5277986
zapB_predicted,0.047619047619047616,20,20,CTGTCAACAGGGCGAGAGGG,0,5270280
zapB_predicted,0.047619047619047616,20,20,CTCTCTGATTACAGTGGTCC,0,5285120
zapB_predicted,0.047619047619047616,20,20,CTACTGCATCGCGGAGGTAT,0,5277635
zapB_predicted,0.047619047619047616,20,20,CGTCGCTGGGGTGTATCACT,0,5285745
zapB_predicted,0.047619047619047616,20,20,CGTAAAGACGCGGAGGGGAG,0,5276087
zapB_predicted,0.047619047619047616,20,20,CGGGTGAAATTCCACCTAAG,0,5266392
zapB_predicted,0.047619047619047616,20,20,CGAGTAAACGGTGCAGAAGG,0,5287530
zapB_predicted,0.047619047619047616,20,20,CCTCGCCGGTCCGGTGCTAC,0,5272724
zapB_predicted,0.047619047619047616,20,20,CCCGCACGCGCCACAACCGT,0,5287580
zapB_predicted,0.047619047619047616,20,20,CATTGCTTGTAAATTCGAGT,0,5271392
zapB_predicted,0.047619047619047616,20,20,CAGCCTGGGCTGTCCAAGCA,0,5279703
zapB_predicted,0.047619047619047616,20,20,CAGAGGGCGGGATTGTTGTT,0,5269246
zapB_predicted,0.047619047619047616,20,20,CACGATCAGAGTGGGGGCGC,0,5275567
zapB_predicted,0.047619047619047616,20,20,CACATCCAGAAGGACTAGCC,0,5277341
zapB_predicted,0.047619047619047616,20,20,CAATACTCGTACCGGGGTTT,0,5270097
zapB_predicted,0.047619047619047616,20,20,CAAGGTAGAGTGATATAGTT,0,5268511
zapB_predicted,0.047619047619047616,20,20,ATGGCAATCATGCCGACCCG,0,5285915
zapB_predicted,0.047619047619047616,20,20,ATCTAAAGAAATATAGTGAT,0,5268900
zapB_predicted,0.047619047619047616,20,20,ATCGCCATTATTGTAATGCA,0,5287849
zapB_predicted,0.047619047619047616,20,20,ATCCAGGTAGTGCTCCTGCA,0,5280219
zapB_predicted,0.047619047619047616,20,20,ATATCGTCGGCATTTGCGAT,0,5266289
zapB_predicted,0.047619047619047616,20,20,AGTCGTGCTCAGGTTTTCAC,0,5265989
zapB_predicted,0.047619047619047616,20,20,AGTCAGGAGGACTTTTAGGT,0,5286509
zapB_predicted,0.047619047619047616,20,20,AGGGCGGCGTCGCTGTCACA,0,5284741
zapB_predicted,0.047619047619047616,20,20,AGGAAGACTGTATGTACCCC,0,5266151
zapB_predicted,0.047619047619047616,20,20,AGACAGGACCCACCCATAGG,0,5285124
zapB_predicted,0.047619047619047616,20,20,ACTCTACCCTGGACAGGATC,0,5264669
zapB_predicted,0.047619047619047616,20,20,ACTATTCTTCGACGTTATGG,0,5281596
zapB_predicted,0.047619047619047616,20,20,ACTAATTTCTTTCGGTTCTA,0,5269559
zapB_predicted,0.047619047619047616,20,20,ACGTGGTTCGTGCACATGGT,0,5270273
zapB_predicted,0.047619047619047616,20,20,ACGAGAGGCTGGCCGCAGTT,0,5265581
zapB_predicted,0.047619047619047616,20,20,ACCGCGTGCAAACGTCATAA,0,5276387
zapB_predicted,0.047619047619047616,20,20,ACCATCTCTACCCGCAATTT,0,5275941
zapB_predicted,0.047619047619047616,20,20,ACACGGATGAGTCAATCTTG,0,5279461
zapB_predicted,0.047619047619047616,20,20,AATATCGATCTCACTATACG,0,5276558
zapB_predicted,0.047619047619047616,20,20,AAGTCGCAGACGGGAAAAGG,0,5276771
zapB_predicted,0.047619047619047616,20,20,AAGGTGAATGTGAAGGGCTA,0,5277751
zapB_predicted,0.047619047619047616,20,20,AACCCCGCGGTGTTATTTTC,0,5265392
zapB_predicted,0.047619047619047616,20,20,AACATTATCGTCACGGTTCG,0,5280348
zapB_predicted,0.05,19,19,TTTGCTTAAACAGTGCCGTC,0,5263863
zapB_predicted,0.05,19,19,TTGCATTTTATACGCCGAGA,0,5285133
zapB_predicted,0.05,19,19,TTATTCTATTATTACGAGAG,0,5286653
zapB_predicted,0.05,19,19,TTATCGCGCTTAGTTATAAC,0,5277391
zapB_predicted,0.05,19,19,TTATCCGGTGTATATCATGT,0,5270528
zapB_predicted,0.05,19,19,TTATACTATTAAGCCTGATA,0,5264188
zapB_predicted,0.05,19,19,TTAAATCCGTTGGAGGCCTT,0,5284660
zapB_predicted,0.05,19,19,TGGTTACCTTAAGCTCACTC,0,5268993
zapB_predicted,0.05,19,19,TGAGGCATTAAACCGATCTT,0,5263988
zapB_predicted,0.05,19,19,TCTCTGAGTTGTCCTCTAAA,0,5279983
zapB_predicted,0.05,19,19,TCGTAGCACACTTAACGCAA,0,5271950
zapB_predicted,0.05,19,19,TCGGTATATCGGAATCCAAT,0,5286114
zapB_predicted,0.05,19,19,TCAGCCACACAGCCTGCTAT,0,5274078
zapB_predicted,0.05,19,19,TAGATGTCGGCTGCTTCTCA,0,5276061
zapB_predicted,0.05,19,19,TACAACGCACGGCCTATACC,0,5263122
zapB_predicted,0.05,19,19,TAATAGAAGACGGGGCAGAA,0,5275893
zapB_predicted,0.05,19,19,GTTACGAGAAGAGGGAGCTA,0,5287129
zapB_predicted,0.05,19,19,GTCTCGGACAGGGTATAACA,0,5284015
zapB_predicted,0.05,19,19,GTCTCAATTTAGTAACGTTT,0,5272650
zapB_predicted,0.05,19,19,GTCAGGTGAATTGTCTACCA,0,5274228
zapB_predicted,0.05,19,19,GGGTAAATCCTTGCTACAGA,0,5268081
zapB_predicted,0.05,19,19,GGGCTGCTCATAGGACTTGA,0,5264465
zapB_predicted,0.05,19,19,GGCTTAGGATTCAATTCCCT,0,5283231
zapB_predicted,0.05,19,19,GGCCCATTATCGTTACGGTG,0,5266568
zapB_predicted,0.05,19,19,GGCAGTTGGACCCAGATCTC,0,5278870
zapB_predicted,0.05,19,19,GGAGCAAGTGGCAGTTTGCC,0,5268710
zapB_predicted,0.05,19,19,GCCTCGCTTCGAAAGAGGAG,0,5279920
zapB_predicted,0.05,19,19,GCCCGTGAGTACTATTCCTG,0,5264310
zapB_predicted,0.05,19,19,GCCAGAATAAGGCTGGTTCA,0,5280635
zapB_predicted,0.05,19,19,GCAGCGGCAATTCATTCCGA,0,5282716
zapB_predicted,0.05,19,19,GCACTGTTGCTAGCCACGAT,0,5270484
zapB_predicted,0.05,19,19,GCACCGGGGGTCGAAGTCAC,0,5282329
zapB_predicted,0.05,19,19,GAGTGGTAATACCTTTTTAC,0,5288011
zapB_predicted,0.05,19,19,GAGGTTTGAGCAATCGGTTA,0,5274149
zapB_predicted,0.05,19,19,GAGAATGCCTATGCTACGCT,0,5273999
zapB_predicted,0.05,19,19,GAATCATGTACGGAGCAGAG,0,5264849
zapB_predicted,0.05,19,19,GAAGCATGGACTGGTCCTCG,0,5267499
zapB_predicted,0.05,19,19,CTTGGATATGGTGTCCAGGG,0,5269521
zapB_predicted,0.05,19,19,CTTGCGGCTTTACAGAAGTC,0,5275831
zapB_predicted,0.05,19,19,CTTAGTAAAAACCCCGCGAT,0,5273774
zapB_predicted,0.05,19,19,CTCTCAAGATTTGATACCAT,0,5274676
zapB_predicted,0.05,19,19,CTCAATTCTAAGGATCCAGG,0,5268453
zapB_predicted,0.05,19,19,CTATCGGGGAGTAACAGACC,0,5267944
zapB_predicted,0.05,19,19,CGGTTGTAGTGAATAGGGTA,0,5278925
zapB_predicted,0.05,19,19,CGCAGACGGTCCCGCTACGT,0,5266965
zapB_predicted,0.05,19,19,CCTCTCGGTTCCTTAGCTTA,0,5276163
zapB_predicted,0.05,19,19,CCTATGGATAGGCTCAATGG,0,5269493
zapB_predicted,0.05,19,19,CCGGGTCATTTTGACTATTT,0,5274948
zapB_predicted,0.05,19,19,CCCAGCTCCTCTCCGATAAG,0,5274642
zapB_predicted,0.05,19,19,CAGGCAGTATGCACAAAGGG,0,5264277
zapB_predicted,0.05,19,19,CAGAATACGTACGCCGAACA,0,5271211
zapB_predicted,0.05,19,19,CACGGTTGACGTGGAGACCT,0,5265715
zapB_predicted,0.05,19,19,CACATTACGCGATTAAAGCA,0,5285130
zapB_predicted,0.05,19,19,CACATGAAGGTGCAACGGCT,0,5269494
zapB_predicted,0.05,19,19,CAAGCAGTAGGCACGACGCA,0,5265714
zapB_predicted,0.05,19,19,ATGACGCTGCTACACAGAGT,0,5274715
zapB_predicted,0.05,19,19,ATCTACTCCCGTTATACAGC,0,5264673
zapB_predicted,0.05,19,19,ATCCACAGCGTTAATTGAAG,0,5265566
zapB_predicted,0.05,19,19,ATATTCGAAACTTGCCTTCT,0,5268475
zapB_predicted,0.05,19,19,ATATGATAAGAAAGCACTAA,0,5264857
zapB_predicted,0.05,19,19,ATAAAGCAAGGCTTCTAATG,0,5282702
zapB_predicted,0.05,19,19,AGTCACCTTAAATCTGAAGG,0,5267152
zapB_predicted,0.05,19,19,AGGTCTGCCCTGCATTGGGT,0,5263630
zapB_predicted,0.05,19,19,AGCGGCGATAGAGTTCCGAA,0,5284615
zapB_predicted,0.05,19,19,ACTTACAGCCAAGATGCTGT,0,5272809
zapB_predicted,0.05,19,19,ACTATTCCCCGCTCTCCGAA,0,5287363
zapB_predicted,0.05,19,19,ACGTCTAAAGTTCTAGCTAG,0,5278368
zapB_predicted,0.05,19,19,ACGCCGGGGCAGAGAATCAC,0,5285235
zapB_predicted,0.05,19,19,AAGGGCAATTGCGCCGTTAC,0,5281841
zapB_predicted,0.05,19,19,AACTGTCATCCGGCGGCATT,0,5270894
zapB_predicted,0.05,19,19,AACATACTGACCCTCCGGTA,0,5283786
zapB_predicted,0.05,19,19,AACATAAGGGGTTTAACTGT,0,5274168
zapB_predicted,0.05263157894736842,18,18,TTGTTTACGTGATGCCTGCA,0,5272688
zapB_predicted,0.05263157894736842,18,18,TTGATCGATGCCAGGCGTGT,0,5264488
zapB_predicted,0.05263157894736842,18,18,TTCTGTATGTTGCGAGTCCT,0,5284269
zapB_predicted,0.05263157894736842,18,18,TTATGTCCTTGTGGCGGCTA,0,5279055
zapB_predicted,0.05263157894736842,18,18,TTAGTAAAACCAAGTTTCAG,0,5282147
zapB_predicted,0.05263157894736842,18,18,TTAGCCTTCGGGCGACCAAA,0,5274717
zapB_predicted,0.05263157894736842,18,18,TGTTGCCCGACTAATCCATG,0,5271657
zapB_predicted,0.05263157894736842,18,18,TGAGTGCAGGTTTTGGCTGT,0,5274779
zapB_predicted,0.05263157894736842,18,18,TGAACGTATGGGAGACATCG,0,5269413
zapB_predicted,0.05263157894736842,18,18,TCTTACGGATTCGCGGTGGT,0,5277486
zapB_predicted,0.05263157894736842,18,18,TCTTAAGTCTGACCGCGCCG,0,5275148
zapB_predicted,0.05263157894736842,18,18,TCTCGGTGAGAGGTCGCCCA,0,5264474
zapB_predicted,0.05263157894736842,18,18,TCGTCAAGTGGTATCAGTAA,0,5280929
zapB_predicted,0.05263157894736842,18,18,TCGTAAAGGTTAGTCACGAT,0,5268773
zapB_predicted,0.05263157894736842,18,18,TCCCAAGATTCTGACAAGTA,0,5272401
zapB_predicted,0.05263157894736842,18,18,TCAGCGTATTCGAGCTGGGA,0,5278211
zapB_predicted,0.05263157894736842,18,18,TATGTCAAATCGCGAACCAT,0,5270547
zapB_predicted,0.05263157894736842,18,18,TATCACTTTGATGCGTTTAG,0,5267543
zapB_predicted,0.05263157894736842,18,18,TAGATGCTTGTCAATGCCGC,0,5268433
zapB_predicted,0.05263157894736842,18,18,TACACTGAGCTTAAAGCGCT,0,5272427
zapB_predicted,0.05263157894736842,18,18,TAACGGGGGGTGGTAAAGCT,0,5279499
zapB_predicted,0.05263157894736842,18,18,TAAACATGAGCAACAGGGTG,0,5270193
zapB_predicted,0.05263157894736842,18,18,GTTGCGGGTGGCTATTTGCA,0,5265286
zapB_predicted,0.05263157894736842,18,18,GTTCCATGTACACTAAGCTG,0,5268895
zapB_predicted,0.05263157894736842,18,18,GTTACATTGGGGACAAGGGA,0,5286044
zapB_predicted,0.05263157894736842,18,18,GTGGGTCCGTGGGTGGAAAT,0,5267652
zapB_predicted,0.05263157894736842,18,18,GTGAAGGTGCAGGACCAGGT,0,5268427
zapB_predicted,0.05263157894736842,18,18,GTCGAGGCGCCTAGGGAGCT,0,5286533
zapB_predicted,0.05263157894736842,18,18,GGTTGCCCGAAGTGGAATTG,0,5282796
zapB_predicted,0.05263157894736842,18,18,GGTTGAGCGTCCGGCGGCCA,0,5269789
zapB_predicted,0.05263157894736842,18,18,GGTCACCCTACGCATCAGGG,0,5286521
zapB_predicted,0.05263157894736842,18,18,GGGTCCCGACACGCCCCCTG,0,5269273
zapB_predicted,0.05263157894736842,18,18,GGGGTCAGAGCTTAGGGAAA,0,5279949
zapB_predicted,0.05263157894736842,18,18,GGGAATGGTTCCACGAGACA,0,5263599
zapB_predicted,0.05263157894736842,18,18,GGCGCATGTCACAAGGTTGC,0,5268534
zapB_predicted,0.05263157894736842,18,18,GGCCGAACTTCAACATGCGT,0,5273634
zapB_predicted,0.05263157894736842,18,18,GGCAATCAGTAAAATGTTAG,0,5266681
zapB_predicted,0.05263157894736842,18,18,GGATGTAAGCATAGAGGGGA,0,5286413
zapB_predicted,0.05263157894736842,18,18,GGACTTTTGCTTCGCGCGTG,0,5265483
zapB_predicted,0.05263157894736842,18,18,GCTTAGATCCCACGGCCAGG,0,5281613
zapB_predicted,0.05263157894736842,18,18,GCTGACGAGGTCGTAACGCG,0,5276575
zapB_predicted,0.05263157894736842,18,18,GCTACCTCGATCCATCGTCC,0,5275292
zapB_predicted,0.05263157894736842,18,18,GCCGAGTCCGAGCTTCCCGA,0,5267108
zapB_predicted,0.05263157894736842,18,18,GCCCCAAGTGGGGCAGCTTC,0,5265379
zapB_predicted,0.05263157894736842,18,18,GCACCCAGTCCGTAGAAAGG,0,5273183
zapB_predicted,0.05263157894736842,18,18,GATCAGAACTCCTCGTCCCA,0,5274975
zapB_predicted,0.05263157894736842,18,18,GACAGTGGAGATTAAAAGGC,0,5284625
zapB_predicted,0.05263157894736842,18,18,GAATATGGGGCATGTAATTC,0,5282448
zapB_predicted,0.05263157894736842,18,18,CTTAAGTCCATTTGGGGAAC,0,5267370
zapB_predicted,0.05263157894736842,18,18,CTTAACCAAATTGGCGCATA,0,5264186
zapB_predicted,0.05263157894736842,18,18,CTGGGCATAATATGCTACCG,0,5268075
zapB_predicted,0.05263157894736842,18,18,CTGCTTAGACTTAACCAGTG,0,5267694
zapB_predicted,0.05263157894736842,18,18,CTGCCCAAACGATAACGCAT,0,5279782
zapB_predicted,0.05263157894736842,18,18,CTCTTTGAGGTCCCTCTATA,0,5266801
zapB_predicted,0.05263157894736842,18,18,CTCAGTTTAGCGTGCGTCAG,0,5271966
zapB_predicted,0.05263157894736842,18,18,CTATTAACTCCTAGTTGATC,0,5274808
zapB_predicted,0.05263157894736842,18,18,CGTTTTTACATGGCCGTAGA,0,5282978
zapB_predicted,0.05263157894736842,18,18,CGTCCAAGCCAGGGATCAAT,0,5267989
zapB_predicted,0.05263157894736842,18,18,CGGTAAACATGGTGAGAATA,0,5281223
zapB_predicted,0.05263157894736842,18,18,CGGGTATCCAGCACTTAAGT,0,5277323
zapB_predicted,0.05263157894736842,18,18,CGGGATTACCACAAGTTATT,0,5284201
zapB_predicted,0.05263157894736842,18,18,CGGACTGGTACTTAGAAGTA,0,5283746
zapB_predicted,0.05263157894736842,18,18,CGCGGGATTACGAATCGGGG,0,5282554
zapB_predicted,0.05263157894736842,18,18,CGCCACAAGTATCGCGTTTA,0,5281238
zapB_predicted,0.05263157894736842,18,18,CGAGCTGTTCGATCAAGGGA,0,5268751
zapB_predicted,0.05263157894736842,18,18,CCGTCCTGTCCTTTCGGAGG,0,5265596
zapB_predicted,0.05263157894736842,18,18,CCCGCCCTGGTGCCCTGAAT,0,5281052
zapB_predicted,0.05263157894736842,18,18,CCACCAAAAGCCTTAGTCGC,0,5285739
zapB_predicted,0.05263157894736842,18,18,CATAAGTGACAACAGCCCAA,0,5264097
zapB_predicted,0.05263157894736842,18,18,CAGATTGAACGAGGCCACGT,0,5283604
zapB_predicted,0.05263157894736842,18,18,CACCGGCGTTGAGGGTAGTC,0,5270890
zapB_predicted,0.05263157894736842,18,18,ATTGATATCATTAATGTTGC,0,5268354
zapB_predicted,0.05263157894736842,18,18,ATTGATAATGTAGCAATTTA,0,5279839
zapB_predicted,0.05263157894736842,18,18,ATGGGGGTAGTCTTCCGTTC,0,5278516
zapB_predicted,0.05263157894736842,18,18,ATGCACAGAGTAGTAACGTA,0,5275936
zapB_predicted,0.05263157894736842,18,18,ATGAGCTCGTCTAAGTGTAC,0,5272287
zapB_predicted,0.05263157894736842,18,18,ATGAAATGGGATATGGGAGT,0,5273617
zapB_predicted,0.05263157894736842,18,18,ATCAGCGGCGAGGCCAGGGT,0,5282304
zapB_predicted,0.05263157894736842,18,18,ATAGGGATTATCCGGAGGTT,0,5281497
zapB_predicted,0.05263157894736842,18,18,ATACAATGCGCTCGTGGGTA,0,5267281
zapB_predicted,0.05263157894736842,18,18,AGGTTTCAGTGGATAGTCAA,0,5269435
zapB_predicted,0.05263157894736842,18,18,AGGCACACTGCGGACCGTAA,0,5274870
zapB_predicted,0.05263157894736842,18,18,AGCACTGCGTTGCATATAGA,0,5268864
zapB_predicted,0.05263157894736842,18,18,AGCAATGCACCTTCGAAAAC,0,5284435
zapB_predicted,0.05263157894736842,18,18,ACTATTAAGTGGCATACCCT,0,5270538
zapB_predicted,0.05263157894736842,18,18,ACGCTGTCGATTTGGTGTTC,0,5280528
zapB_predicted,0.05263157894736842,18,18,ACGCGTCCTTAGAGACGACG,0,5263492
zapB_predicted,0.05263157894736842,18,18,ACCTTTTCCCCTTTAGTCGT,0,5286913
zapB_predicted,0.05263157894736842,18,18,ACCACGGAGTGACGGTTAAG,0,5270451
zapB_predicted,0.05263157894736842,18,18,ACCACGCATTTGCCACTTTC,0,5268261
zapB_predicted,0.05263157894736842,18,18,ACACGCTACAAGGTAATTTT,0,5274167
zapB_predicted,0.05263157894736842,18,18,ACAATCAGGTCTTCGGTTAC,0,5281028
zapB_predicted,0.05263157894736842,18,18,AATTGTGGAATTTCGCATTG,0,5264511
zapB_predicted,0.05263157894736842,18,18,AATATGGATCTCCCATTTCC,0,5276118
zapB_predicted,0.05263157894736842,18,18,AAGCGTATACAAGCGTACTA,0,5269756
zapB_predicted,0.05263157894736842,18,18,AACCGGGAACTGCCAACCCA,0,5288126
zapB_predicted,0.05263157894736842,18,18,AACCCAACATGGTTGGGTTT,0,5269072
zapB_predicted,0.05263157894736842,18,18,AAATTCAGTTCAAGCCCACA,0,5279934
zapB_predicted,0.05555555555555555,17,17,TTGCATTTAGGTCCAGTAAT,0,5274946
zapB_predicted,0.05555555555555555,17,17,TTCTAACATGTGTTCCGTCT,0,5274976
zapB_predicted,0.05555555555555555,17,17,TTCGCCGAGCCCAGCGCGTT,0,5263126
zapB_predicted,0.05555555555555555,17,17,TTATTGCATACAGCGAACAA,0,5275200
zapB_predicted,0.05555555555555555,17,17,TTACTTATTATTCACGGATC,0,5279549
zapB_predicted,0.05555555555555555,17,17,TGTTCAGAATGAGGGTCAAC,0,5276592
zapB_predicted,0.05555555555555555,17,17,TGTGGTCGTATTTGAGAACA,0,5269221
zapB_predicted,0.05555555555555555,17,17,TGTGGCCCGGGACAAAGAAA,0,5277664
zapB_predicted,0.05555555555555555,17,17,TGTATGGCCTACGGATACCT,0,5272982
zapB_predicted,0.05555555555555555,17,17,TGTACATATGCCTAAGTATG,0,5274988
zapB_predicted,0.05555555555555555,17,17,TGGTTATGCGTCAGCTACTG,0,5278434
zapB_predicted,0.05555555555555555,17,17,TGCTCACCCGCTACGCAAAT,0,5285624
zapB_predicted,0.05555555555555555,17,17,TCGTGACCTTCTTCGGGTCC,0,5286711
zapB_predicted,0.05555555555555555,17,17,TCGGTTACTCATCCCAGTTC,0,5274675
zapB_predicted,0.05555555555555555,17,17,TCGGGATTTCAAAGGCAACT,0,5273987
zapB_predicted,0.05555555555555555,17,17,TCGCGGTACAGCAGAGGTGC,0,5275795
zapB_predicted,0.05555555555555555,17,17,TCGCCATAGCGAGCTATGCC,0,5286656
zapB_predicted,0.05555555555555555,17,17,TCGCACTACTTACCTAAAAT,0,5284069
zapB_predicted,0.05555555555555555,17,17,TCGAACAGTTAGTCCAGGGG,0,5276887
zapB_predicted,0.05555555555555555,17,17,TCCGGCCATGCTAACTGTAA,0,5265877
zapB_predicted,0.05555555555555555,17,17,TCCCGGCAAGGAGACAGGCA,0,5286554
zapB_predicted,0.05555555555555555,17,17,TCCATTTTTGAAGGGCCAGG,0,5268711
zapB_predicted,0.05555555555555555,17,17,TCATCCCGACCAGCTGAGGA,0,5266519
zapB_predicted,0.05555555555555555,17,17,TAGAGTCGGCAATGGGGTTT,0,5266665
zapB_predicted,0.05555555555555555,17,17,TAATCATAGCGTACGTGCAG,0,5281649
zapB_predicted,0.05555555555555555,17,17,TAAGTGCGGCGCCAGTTGGA,0,5273161
zapB_predicted,0.05555555555555555,17,17,TAACCCAGCATTAATAACCA,0,5279057
zapB_predicted,0.05555555555555555,17,17,GTTTTTTGAGGATGGAAGCT,0,5273638
zapB_predicted,0.05555555555555555,17,17,GTTTGAGCCATTAGAGTCCA,0,5267815
zapB_predicted,0.05555555555555555,17,17,GTTATCCATGTTATTCGTGA,0,5268995
zapB_predicted,0.05555555555555555,17,17,GTTAGCGTGGCCTACAAGTA,0,5273511
zapB_predicted,0.05555555555555555,17,17,GTTACGTATCTGACCGTGTT,0,5278628
zapB_predicted,0.05555555555555555,17,17,GTGAATCACGCTGTGCCCAG,0,5285440
zapB_predicted,0.05555555555555555,17,17,GTCGGGATTCCCCTAAGGCA,0,5273741
zapB_predicted,0.05555555555555555,17,17,GTCCTCCAACCTCTTCAGTT,0,5277961
zapB_predicted,0.05555555555555555,17,17,GTCAATGGCCGTGGCAGTAC,0,5265399
zapB_predicted,0.05555555555555555,17,17,GTATTCTACACTCACCGGCA,0,5286062
zapB_predicted,0.05555555555555555,17,17,GGTCCTCCTTCACAAGTGTA,0,5264640
zapB_predicted,0.05555555555555555,17,17,GGGTCGCGGGTTTCTCGCCA,0,5287585
zapB_predicted,0.05555555555555555,17,17,GGGGATATTCTGTTGAGGGA,0,5277731
zapB_predicted,0.05555555555555555,17,17,GGGCCTATAGTATCATGGGC,0,5264850
zapB_predicted,0.05555555555555555,17,17,GGGAGCATCTAAGCAGCGCG,0,5274000
zapB_predicted,0.05555555555555555,17,17,GGCAGCTCCGCCGTCCCAAT,0,5279545
zapB_predicted,0.05555555555555555,17,17,GGAGGTTCAGAGGGCGCGGC,0,5277749
zapB_predicted,0.05555555555555555,17,17,GGAAGATTAGGATCCTCAAA,0,5277116
zapB_predicted,0.05555555555555555,17,17,GCTTGTTACAGAGGTATCCA,0,5272964
zapB_predicted,0.05555555555555555,17,17,GCTGCGATTTAACGACGATC,0,5288438
zapB_predicted,0.05555555555555555,17,17,GCCTTCCAAGAAGAGCTTCC,0,5267883
zapB_predicted,0.05555555555555555,17,17,GCCCTAGAAGAGTGAAACGC,0,5263509
zapB_predicted,0.05555555555555555,17,17,GCCATCAATGAGTCGCGCCC,0,5269788
zapB_predicted,0.05555555555555555,17,17,GATTTCAATCGTGTACCGAG,0,5267367
zapB_predicted,0.05555555555555555,17,17,GATGGCTACCCTCGGCTCTG,0,5273221
zapB_predicted,0.05555555555555555,17,17,GATATTTGATCTGAAATTAT,0,5283842
zapB_predicted,0.05555555555555555,17,17,GAGTTCAAGCTATCATACTT,0,5269241
zapB_predicted,0.05555555555555555,17,17,GAGTGCGGTGTATGTCTCGC,0,5274748
zapB_predicted,0.05555555555555555,17,17,GAGGTCCGCCTCCTATGTGC,0,5279398
zapB_predicted,0.05555555555555555,17,17,GAGGGGTAACTTCTTTGTAA,0,5265414
zapB_predicted,0.05555555555555555,17,17,GAGCTTTTAACATTGTGCCG,0,5280110
zapB_predicted,0.05555555555555555,17,17,CTTTTCCTCGGTATATGGCA,0,5273285
zapB_predicted,0.05555555555555555,17,17,CTTGTCTACCACAGTGGGCA,0,5271311
zapB_predicted,0.05555555555555555,17,17,CTTGTATCATCTCCCGTTCT,0,5272470
zapB_predicted,0.05555555555555555,17,17,CTTGCGCGCCATGGTTCGGG,0,5268488
zapB_predicted,0.05555555555555555,17,17,CTTAAGACTCACTTTTGCGA,0,5264547
zapB_predicted,0.05555555555555555,17,17,CTGTTGGACGATTTATTCGT,0,5281138
zapB_predicted,0.05555555555555555,17,17,CTGCCAGCGCTTTGAAAACT,0,5278781
zapB_predicted,0.05555555555555555,17,17,CTCCAGGGCCGTTACGTTCT,0,5277996
zapB_predicted,0.05555555555555555,17,17,CTACTACACGGGCCTTATTG,0,5274282
zapB_predicted,0.05555555555555555,17,17,CTACGTGCTCAATTAAAGAT,0,5264647
zapB_predicted,0.05555555555555555,17,17,CGTTGATATATAGTAGTTCG,0,5270374
zapB_predicted,0.05555555555555555,17,17,CGTTAGAAATTGCACGGCTC,0,5279437
zapB_predicted,0.05555555555555555,17,17,CGTGCCCCAAGTTAGCTAGA,0,5271796
zapB_predicted,0.05555555555555555,17,17,CGTCGGCATCGTGTTTGTCT,0,5282814
zapB_predicted,0.05555555555555555,17,17,CGGCTTAGTGTCAATCTAAC,0,5273154
zapB_predicted,0.05555555555555555,17,17,CGGCTCCTGCACGTGGACGT,0,5275075
zapB_predicted,0.05555555555555555,17,17,CGCTGGGTTTCCAAGTCCTA,0,5268076
zapB_predicted,0.05555555555555555,17,17,CGCTCTCCATGCAATTGCGG,0,5263163
zapB_predicted,0.05555555555555555,17,17,CGCGGGGGCAACGACCGAAT,0,5281315
zapB_predicted,0.05555555555555555,17,17,CGCATTAGGTTAGCGATGGG,0,5264583
zapB_predicted,0.05555555555555555,17,17,CCTTCGCCGAACCTCCTCAT,0,5267285
zapB_predicted,0.05555555555555555,17,17,CCGTAGCGGATGGCAACTTC,0,5272074
zapB_predicted,0.05555555555555555,17,17,CCGCCGTACCGTACAAGGTT,0,5268936
zapB_predicted,0.05555555555555555,17,17,CCGAAGAGAGGGTTGCAAAG,0,5271623
zapB_predicted,0.05555555555555555,17,17,CCCCCTATGTTGATCTTCTT,0,5283474
zapB_predicted,0.05555555555555555,17,17,CCCCAGGTGTCATGAAGATG,0,5267189
zapB_predicted,0.05555555555555555,17,17,CCATCGGCGAAGATCAAGAG,0,5281059
zapB_predicted,0.05555555555555555,17,17,CATAGGAATCGCGGATAGGA,0,5287415
zapB_predicted,0.05555555555555555,17,17,CATAATTGGTCGCGGCTAAA,0,5272210
zapB_predicted,0.05555555555555555,17,17,CAGCTTCAATAATTAAAAAC,0,5269917
zapB_predicted,0.05555555555555555,17,17,CAGCAATGACGTTAACGCCG,0,5278792
zapB_predicted,0.05555555555555555,17,17,CAAGAAGCGGGAAAATAACA,0,5280865
zapB_predicted,0.05555555555555555,17,17,CAAATATTGGTGATCCATTT,0,5286916
zapB_predicted,0.05555555555555555,17,17,ATGGCCCTTGACGCGAACGA,0,5274861
zapB_predicted,0.05555555555555555,17,17,ATCGGTCTGGTTGCTTCCCC,0,5283250
zapB_predicted,0.05555555555555555,17,17,AGTCGAATGTTCCTGCGTCT,0,5279308
zapB_predicted,0.05555555555555555,17,17,AGTCATCATAAGATTCATGA,0,5273963
zapB_predicted,0.05555555555555555,17,17,AGTAAGCTATATAGCCATTT,0,5280409
zapB_predicted,0.05555555555555555,17,17,AGGTTTATTGCGACCGGTGT,0,5273352
zapB_predicted,0.05555555555555555,17,17,AGGGTGCGTCTCCAAACTAA,0,5274668
zapB_predicted,0.05555555555555555,17,17,AGCCTTACGGTCCCGAATAT,0,5267734
zapB_predicted,0.05555555555555555,17,17,AGCCGCGGGAGAAGGACTTT,0,5264574
zapB_predicted,0.05555555555555555,17,17,AGACGGGTACTGGATCGTGG,0,5275564
zapB_predicted,0.05555555555555555,17,17,ACTTCAGCGGCTTTGTAAAT,0,5279670
zapB_predicted,0.05555555555555555,17,17,ACTAAGCGGGGGTGATACTA,0,5273305
zapB_predicted,0.05555555555555555,17,17,ACCGCAGGGGGGGTGACCCT,0,5266385
zapB_predicted,0.05555555555555555,17,17,ACCCAGGCTGCAGTTAATAA,0,5279621
zapB_predicted,0.05555555555555555,17,17,ACCAGACAACGCGACCTCGG,0,5273974
zapB_predicted,0.05555555555555555,17,17,ACATCCGGGTGTATGTAGTT,0,5275852
zapB_predicted,0.05555555555555555,17,17,AATGCTGCGCCTCGCTCACA,0,5284822
zapB_predicted,0.05555555555555555,17,17,AAGTCGGCTAGCTCCTAAGT,0,5280924
zapB_predicted,0.05555555555555555,17,17,AAGCTGTTACGTGGCATGCA,0,5276731
zapB_predicted,0.05555555555555555,17,17,AACGTCCATACCGTCGGACC,0,5267100
zapB_predicted,0.05555555555555555,17,17,AACCTCATTCCAACAATGAA,0,5274703
zapB_predicted,0.05555555555555555,17,17,AAACCATTCCGCGTACGGGT,0,5279970
zapB_predicted,0.058823529411764705,16,16,TTTTGCTAACCGCGTCTGAT,0,5269664
zapB_predicted,0.058823529411764705,16,16,TTTGCTTCGCATTTGGCAAA,0,5277902
zapB_predicted,0.058823529411764705,16,16,TTTGCCGGCGGTCCAATTGG,0,5266225
zapB_predicted,0.058823529411764705,16,16,TTTCATATTAGAGCGTTCCT,0,5269415
zapB_predicted,0.058823529411764705,16,16,TTGTTGACAGCGAAGTATCC,0,5271786
zapB_predicted,0.058823529411764705,16,16,TTGTGTTCGATCAGTGTCTG,0,5281723
zapB_predicted,0.058823529411764705,16,16,TTGTGATGCAGCGTCAAGAT,0,5264541
zapB_predicted,0.058823529411764705,16,16,TTCCAGGCCTGGTTAAAATC,0,5277373
zapB_predicted,0.058823529411764705,16,16,TTCAACAGGTATGGGTAGGG,0,5271590
zapB_predicted,0.058823529411764705,16,16,TTATTTGTTGTGCACTTCTA,0,5284692
zapB_predicted,0.058823529411764705,16,16,TTATGCACACATGGGTGAGT,0,5264359
zapB_predicted,0.058823529411764705,16,16,TTAAAGAAATTTGTTCCGTG,0,5267770
zapB_predicted,0.058823529411764705,16,16,TTAAACATTGCAATATGTCT,0,5273931
zapB_predicted,0.058823529411764705,16,16,TGTGCTGGCCCCGCCATTGG,0,5286084
zapB_predicted,0.058823529411764705,16,16,TGTACTTAAAATTACGGCCC,0,5267899
zapB_predicted,0.058823529411764705,16,16,TGGATGCAATCAATCGATTA,0,5276602
zapB_predicted,0.058823529411764705,16,16,TGCGTGCCAGCCTCTTACGA,0,5279435
zapB_predicted,0.058823529411764705,16,16,TGCCGTGAAGATGACAAAAT,0,5269394
zapB_predicted,0.058823529411764705,16,16,TGAGTGAATAATGAAAGGTG,0,5264734
zapB_predicted,0.058823529411764705,16,16,TGAGTACTTATTCATTATAT,0,5288109
zapB_predicted,0.058823529411764705,16,16,TGAGGCAGATGTAAGTGTTT,0,5266252
zapB_predicted,0.058823529411764705,16,16,TCTGTTCCCTATAAGGCCCT,0,5268065
zapB_predicted,0.058823529411764705,16,16,TCTACTTTCTTTCGGCGGAT,0,5263157
zapB_predicted,0.058823529411764705,16,16,TCCCGCCCTGACCTCATACA,0,5264404
zapB_predicted,0.058823529411764705,16,16,TCCCGAGACGGGATCCGAAT,0,5278466
zapB_predicted,0.058823529411764705,16,16,TCCACAACTTCGCCGTAGTG,0,5273191
zapB_predicted,0.058823529411764705,16,16,TCAGACCGAGTTGACTTGAC,0,5267098
zapB_predicted,0.058823529411764705,16,16,TAGGGCACTTCCTAAAGGGT,0,5266906
zapB_predicted,0.058823529411764705,16,16,TAGGGAGATCTCATTAACGC,0,5267819
zapB_predicted,0.058823529411764705,16,16,TAGACGGGTGATTCACGTTT,0,5270072
zapB_predicted,0.058823529411764705,16,16,TAAAGCAAGAATTAAATTAA,0,5270294
zapB_predicted,0.058823529411764705,16,16,GTTCGCGGTCAAGGAGACAG,0,5272965
zapB_predicted,0.058823529411764705,16,16,GTGCAAGAGTTTACAATGTA,0,5283342
zapB_predicted,0.058823529411764705,16,16,GTGAGGTTAAATGCGCAGGA,0,5278428
zapB_predicted,0.058823529411764705,16,16,GTCTATGTGGGCTGGTTGCG,0,5269224
zapB_predicted,0.058823529411764705,16,16,GTCACGAGTTCTACCCTCAA,0,5280428
zapB_predicted,0.058823529411764705,16,16,GTACTTCATTCTAGTACCGC,0,5267873
zapB_predicted,0.058823529411764705,16,16,GGTCTCTTGCTTGGATTTGA,0,5284166
zapB_predicted,0.058823529411764705,16,16,GGGCGGCTTTACCAGTTAGA,0,5277342
zapB_predicted,0.058823529411764705,16,16,GGATTATAGGGCGCCTTTAC,0,5271104
zapB_predicted,0.058823529411764705,16,16,GGATCAGAACATAAGTGGGG,0,5278405
zapB_predicted,0.058823529411764705,16,16,GGATAACTTGCCTAATCGGT,0,5270506
zapB_predicted,0.058823529411764705,16,16,GGACTAATTGGACGGTGGTC,0,5276735
zapB_predicted,0.058823529411764705,16,16,GGACGTTCAGCCCGTACGCA,0,5263604
zapB_predicted,0.058823529411764705,16,16,GGACGAGGCTTCCGAGTCCT,0,5271998
zapB_predicted,0.058823529411764705,16,16,GGAAAGGCGGACAAAATGCG,0,5268524
zapB_predicted,0.058823529411764705,16,16,GCGGTAGAGCGACGCGAGTA,0,5278346
zapB_predicted,0.058823529411764705,16,16,GCGCGCAGGCCAGAACAACT,0,5267619
zapB_predicted,0.058823529411764705,16,16,GCGACGCAAAGGTCGAGAGT,0,5269687
zapB_predicted,0.058823529411764705,16,16,GCCCCTTTCCATAAGGAGGG,0,5279193
zapB_predicted,0.058823529411764705,16,16,GCATCAGCATACTCGAGGTG,0,5283047
zapB_predicted,0.058823529411764705,16,16,GATTCACGCGGCTTAGGATT,0,5264789
zapB_predicted,0.058823529411764705,16,16,GATGGCGAGGTACCGCCGAG,0,5288175
zapB_predicted,0.058823529411764705,16,16,GATCATGCGGTGGAGTGGAC,0,5265105
zapB_predicted,0.058823529411764705,16,16,GATAGGCTAGCCCTTGTCTG,0,5275742
zapB_predicted,0.058823529411764705,16,16,GATAGCTTGGTCGATGCCAT,0,5266050
zapB_predicted,0.058823529411764705,16,16,GAGCGTGTAGTACCGCGCTC,0,5284333
zapB_predicted,0.058823529411764705,16,16,GACGCAGAGTGCTCCTTGCA,0,5286260
zapB_predicted,0.058823529411764705,16,16,GACCCGCGCGGTGGATACCA,0,5280859
zapB_predicted,0.058823529411764705,16,16,GAATGAATTTGTTGTCTCTC,0,5282150
zapB_predicted,0.058823529411764705,16,16,GAACTTTCTTTTTGACATGT,0,5278719
zapB_predicted,0.058823529411764705,16,16,CTTGGAGATCAATGCTTGTT,0,5275238
zapB_predicted,0.058823529411764705,16,16,CTGTGTCCTCCTCCATGCAG,0,5279411
zapB_predicted,0.058823529411764705,16,16,CTCGCACAGCGGTATCCTTG,0,5271967
zapB_predicted,0.058823529411764705,16,16,CTCCCGAGCGCTATACGGGC,0,5263061
zapB_predicted,0.058823529411764705,16,16,CGTTCGGGCGGAGGTGGCTT,0,5285614
zapB_predicted,0.058823529411764705,16,16,CGTATTGTTACAGGCTCCGC,0,5279631
zapB_predicted,0.058823529411764705,16,16,CGCTCCTGTTCTTCTAGAAT,0,5285422
zapB_predicted,0.058823529411764705,16,16,CGCAGGGATTGGACTTGGTT,0,5270690
zapB_predicted,0.058823529411764705,16,16,CGCAAAGTTGCCGCTAGTAT,0,5270346
zapB_predicted,0.058823529411764705,16,16,CGAGTTATGTCGTTCTTGAG,0,5276406
zapB_predicted,0.058823529411764705,16,16,CGAATAGTTAGCTATTGACT,0,5280389
zapB_predicted,0.058823529411764705,16,16,CGAAATATCGCCGATTGAAA,0,5264644
zapB_predicted,0.058823529411764705,16,16,CCTGGGGTAGAGGTACGGCT,0,5274714
zapB_predicted,0.058823529411764705,16,16,CCTGAACAGGATCAAGGAAT,0,5287854
zapB_predicted,0.058823529411764705,16,16,CCTCCCGTAGCTCGAGAGGT,0,5263909
zapB_predicted,0.058823529411764705,16,16,CCGTTTCCACTGCGAAAGAA,0,5267475
zapB_predicted,0.058823529411764705,16,16,CCGACGTACGTAATTAAGCG,0,5281655
zapB_predicted,0.058823529411764705,16,16,CCCCGCCATCCGGGGTGAGA,0,5266451
zapB_predicted,0.058823529411764705,16,16,CCACCAGGTGGGCACAACAT,0,5266036
zapB_predicted,0.058823529411764705,16,16,CATTGTTTGAACGACGGTCG,0,5285974
zapB_predicted,0.058823529411764705,16,16,CAGGCTCTGGATTATTTTTG,0,5280751
zapB_predicted,0.058823529411764705,16,16,CAGCGTATTACGGGTTTATC,0,5273825
zapB_predicted,0.058823529411764705,16,16,CAGATGGGGGTACTTAGTCA,0,5278445
zapB_predicted,0.058823529411764705,16,16,CACACTGAAACCACTTCGAG,0,5268928
zapB_predicted,0.058823529411764705,16,16,CACAAGAAGCGTCGGTTCAT,0,5272463
zapB_predicted,0.058823529411764705,16,16,CAAGGAAAGGAATACAGCAT,0,5280787
zapB_predicted,0.058823529411764705,16,16,ATTGCTCTCATGTGCCTAGT,0,5267579
zapB_predicted,0.058823529411764705,16,16,ATTAGGAGCGGATGGCGAAG,0,5274076
zapB_predicted,0.058823529411764705,16,16,ATGTATTTGCTGGGCTGTAC,0,5266556
zapB_predicted,0.058823529411764705,16,16,ATGGCATCGGCGGTAGTCAC,0,5278070
zapB_predicted,0.058823529411764705,16,16,ATGCGTCCTGACTACACTCT,0,5287902
zapB_predicted,0.058823529411764705,16,16,ATGAAGCGTCGATTATAGAT,0,5286381
zapB_predicted,0.058823529411764705,16,16,AGTTATAAGGTCCATCCCAC,0,5287440
zapB_predicted,0.058823529411764705,16,16,AGTGGGAACTGATGTACGGT,0,5265419
zapB_predicted,0.058823529411764705,16,16,AGTCAGAAATGAACTCGAGG,0,5273605
zapB_predicted,0.058823529411764705,16,16,AGGTGTTGACGGCACCCGTA,0,5287960
zapB_predicted,0.058823529411764705,16,16,AGGGTGTACATTCAGTATAG,0,5272409
zapB_predicted,0.058823529411764705,16,16,AGGGCTTTTAGATGGGATTG,0,5278520
zapB_predicted,0.058823529411764705,16,16,AGGCTGCTGTCGTACTCCGA,0,5270921
zapB_predicted,0.058823529411764705,16,16,AGGCAATTATTATTCCCACG,0,5287802
zapB_predicted,0.058823529411764705,16,16,AGGACTTCTCAATAGCAATT,0,5265163
zapB_predicted,0.058823529411764705,16,16,AGGAAGCGACAGCAAGACTA,0,5286315
zapB_predicted,0.058823529411764705,16,16,AGCTCTTCTCAACAAGCCGT,0,5286120
zapB_predicted,0.058823529411764705,16,16,AGCTCGTGGACTCTTGTGTT,0,5284972
zapB_predicted,0.058823529411764705,16,16,AGAACTTGCTGCCGTACGAT,0,5263539
zapB_predicted,0.058823529411764705,16,16,ACTTGTCCGAACTCCACTTG,0,5273149
zapB_predicted,0.058823529411764705,16,16,ACTTGGCGACATCGGGATAG,0,5270186
zapB_predicted,0.058823529411764705,16,16,ACTACCATGCGTGACGCATA,0,5263639
zapB_predicted,0.058823529411764705,16,16,ACGCCGTGGGGGGGTTGCTT,0,5281243
zapB_predicted,0.058823529411764705,16,16,ACGAATAGTGCGCGACTGGG,0,5273135
zapB_predicted,0.058823529411764705,16,16,AATTTGAATCACAGATGCAA,0,5278150
zapB_predicted,0.058823529411764705,16,16,AATTCGTTTTGCGTTGAGTG,0,5271209
zapB_predicted,0.058823529411764705,16,16,AATTACCTACATGCGCTCGT,0,5279734
zapB_predicted,0.058823529411764705,16,16,AATGGCATTCCCAATAGTCA,0,5263953
zapB_predicted,0.058823529411764705,16,16,AATCGGGTCACCCGGTTAAT,0,5268489
zapB_predicted,0.058823529411764705,16,16,AATAAACCGGTGAAGTAGAC,0,5272332
zapB_predicted,0.0625,15,15,TTTTCCCATGTGCACGGAAT,0,5286178
zapB_predicted,0.0625,15,15,TTTGGTCTGGGGTGTTGATA,0,5272128
zapB_predicted,0.0625,15,15,TTTGGCTGCGCATGCGAGAT,0,5271660
zapB_predicted,0.0625,15,15,TTTGCTGAGTTGGGTTTACG,0,5277543
zapB_predicted,0.0625,15,15,TTTATAATATGCAGACCTTG,0,5269304
zapB_predicted,0.0625,15,15,TTTAACAGAGCTGGTGTCAC,0,5265295
zapB_predicted,0.0625,15,15,TTGTAGAATGCTTGCGGCGG,0,5263080
zapB_predicted,0.0625,15,15,TTGAGTAGGCGCATTGGTGC,0,5266972
zapB_predicted,0.0625,15,15,TTGAAGATTTTCTCAAGTGT,0,5277192
zapB_predicted,0.0625,15,15,TGTTGCGAATCAATTTCAAG,0,5265208
zapB_predicted,0.0625,15,15,TGGTTGCAGTAGCATGCTGC,0,5284297
zapB_predicted,0.0625,15,15,TGGGCGGCGCGTACCGCTGA,0,5275911
zapB_predicted,0.0625,15,15,TGGGCACCACGTAATACTAG,0,5274247
zapB_predicted,0.0625,15,15,TGGATTACAGCGTTAGAGAA,0,5266700
zapB_predicted,0.0625,15,15,TGCTGGGCACTAAATGCAGG,0,5281724
zapB_predicted,0.0625,15,15,TGCGAGTTCATTTGCCTGCG,0,5285343
zapB_predicted,0.0625,15,15,TGCACTAAGCTTGAATTGAT,0,5280052
zapB_predicted,0.0625,15,15,TGATTTACGGACCAGCGTGT,0,5268818
zapB_predicted,0.0625,15,15,TCTTTGTGACATGGAGGTAA,0,5265557
zapB_predicted,0.0625,15,15,TCTTGCCATGTGTGAGAAGA,0,5287698
zapB_predicted,0.0625,15,15,TCTCTCAGCGGGAAGTACGT,0,5271825
zapB_predicted,0.0625,15,15,TCTAATTACAGGAGAAGACA,0,5275561
zapB_predicted,0.0625,15,15,TCGTGGCCCCACCCCGATCT,0,5269765
zapB_predicted,0.0625,15,15,TCGGACTAACTTAGACGCTT,0,5273692
zapB_predicted,0.0625,15,15,TCATTGATAGACTGAGCGTA,0,5273859
zapB_predicted,0.0625,15,15,TCACTGGGCCGTATGTAAGT,0,5264726
zapB_predicted,0.0625,15,15,TCACGGGCCAGCTTGGACAT,0,5281817
zapB_predicted,0.0625,15,15,TATCCAGGGGTCCCGAACCT,0,5265529
zapB_predicted,0.0625,15,15,TATATAATGTATGCTTCAAC,0,5264487
zapB_predicted,0.0625,15,15,TAGAATCATTTCCTGAGAGG,0,5269414
zapB_predicted,0.0625,15,15,TACGCGGCCCCATACCGAAG,0,5275579
zapB_predicted,0.0625,15,15,TAATAGCGATAGACGGGCAG,0,5271770
zapB_predicted,0.0625,15,15,TAAGTAGGGGCTTTGGCGGT,0,5269377
zapB_predicted,0.0625,15,15,TAACTATTAATAATCGAGTA,0,5276770
zapB_predicted,0.0625,15,15,TAACGATGCGTACCAGCGTG,0,5276384
zapB_predicted,0.0625,15,15,TAACGACGGAGCCAAGTCGT,0,5278078
zapB_predicted,0.0625,15,15,GTTCGGCAGTTGTATGCGAT,0,5266631
zapB_predicted,0.0625,15,15,GTGCATGCATTAGTAAAATG,0,5282443
zapB_predicted,0.0625,15,15,GTCTGGCCAACAGATGCTTA,0,5265716
zapB_predicted,0.0625,15,15,GTCGTGATTGGTCAACGGCA,0,5268282
zapB_predicted,0.0625,15,15,GTCGCATTTGCTTGTCATCG,0,5287362
zapB_predicted,0.0625,15,15,GTCCTGCTGTCTGTTCTTCC,0,5264703
zapB_predicted,0.0625,15,15,GTATTGGTGACGGGGCGGCA,0,5279183
zapB_predicted,0.0625,15,15,GTATGGTATGTCAATGCTGA,0,5270499
zapB_predicted,0.0625,15,15,GTAGACTGCAGTTTTCCTCT,0,5272451
zapB_predicted,0.0625,15,15,GTACCCTCCCCACGTTCCCA,0,5272548
zapB_predicted,0.0625,15,15,GTAACACACAGTGGGTGGGT,0,5282705
zapB_predicted,0.0625,15,15,GGTTATGGTCTGTGGTTCAC,0,5266157
zapB_predicted,0.0625,15,15,GGTCCCTATCTGGGACCTTA,0,5284135
zapB_predicted,0.0625,15,15,GGCTTGCAAATAATAATCAA,0,5270939
zapB_predicted,0.0625,15,15,GGCCTCTCTAAGCCCTGGTT,0,5265857
zapB_predicted,0.0625,15,15,GGCAATCACAATCCTAAGAC,0,5268204
zapB_predicted,0.0625,15,15,GCTTTCCCCGGTGGGCGGCG,0,5274922
zapB_predicted,0.0625,15,15,GCGTGTCACCTGATAGAGCT,0,5269739
zapB_predicted,0.0625,15,15,GCGGTTGTTGCATGTCGGCC,0,5269528
zapB_predicted,0.0625,15,15,GCCGTGAGCAGGGCGCGTAC,0,5287825
zapB_predicted,0.0625,15,15,GCCGTCGTTCCATAACCACT,0,5279433
zapB_predicted,0.0625,15,15,GCCGATATGTCCGTACGAGA,0,5276919
zapB_predicted,0.0625,15,15,GCCCCGGCGAGTACGCGAAT,0,5280858
zapB_predicted,0.0625,15,15,GCCCCCACGAAGCGTCATAT,0,5267237
zapB_predicted,0.0625,15,15,GCCAGAGTCTTAGGGCGTAA,0,5286820
zapB_predicted,0.0625,15,15,GATGACGCAATCCTGTGTTC,0,5265103
zapB_predicted,0.0625,15,15,GAGGTTTCTTCGGTGCAGTA,0,5266784
zapB_predicted,0.0625,15,15,GAGATCCTATGTCGCCTTTA,0,5286495
zapB_predicted,0.0625,15,15,GAGAGCGCTAACTAATCCCA,0,5273286
zapB_predicted,0.0625,15,15,GAGACGCACTGGGTTTATAT,0,5274441
zapB_predicted,0.0625,15,15,GACTTTCTTGTTGCTCCGCT,0,5287290
zapB_predicted,0.0625,15,15,GACGAGGGCGCTCGACTGGT,0,5264218
zapB_predicted,0.0625,15,15,GACCATGGCGTGGATGCATG,0,5264278
zapB_predicted,0.0625,15,15,GACATGTCCCCAGGGCAGGT,0,5280577
zapB_predicted,0.0625,15,15,GAATTGGTGGTAGTCCACTC,0,5276339
zapB_predicted,0.0625,15,15,GAATCCGGGCTATCATCCCC,0,5276340
zapB_predicted,0.0625,15,15,GAAGGATATCCGCAAACTCA,0,5280438
zapB_predicted,0.0625,15,15,CTTTCCCGACCCACATGGTA,0,5271075
zapB_predicted,0.0625,15,15,CTGTGACACTTTGACTGACT,0,5266237
zapB_predicted,0.0625,15,15,CTGTCGGTCAATGTGGACTA,0,5263239
zapB_predicted,0.0625,15,15,CTCTTCGCGTCTAGGCTTAC,0,5277357
zapB_predicted,0.0625,15,15,CTCTCCACTTGCCTGCTTAT,0,5270623
zapB_predicted,0.0625,15,15,CTCAACGGCCTAGCTCGTGG,0,5285799
zapB_predicted,0.0625,15,15,CTATTCAAAGATGTGGTGGT,0,5274436
zapB_predicted,0.0625,15,15,CTATGTTACCTTGGTTCCGA,0,5275177
zapB_predicted,0.0625,15,15,CTATAAGTGCTAATAGTGCC,0,5266053
zapB_predicted,0.0625,15,15,CTATAACGCCAAGACGCGGG,0,5286216
zapB_predicted,0.0625,15,15,CTAATGTGTACCCCTGTGCT,0,5269148
zapB_predicted,0.0625,15,15,CTAAGCCAGAGCAGTCCAGC,0,5266572
zapB_predicted,0.0625,15,15,CTAAAACTCTTGCACAAATG,0,5276508
zapB_predicted,0.0625,15,15,CGTATATTCCGCTATATTGG,0,5265102
zapB_predicted,0.0625,15,15,CGGTCAAAAGTAGTCCTGCT,0,5267935
zapB_predicted,0.0625,15,15,CGGGGACCGCTAAAGCGATT,0,5283675
zapB_predicted,0.0625,15,15,CGAGGCGCAGCCAACTATAA,0,5265459
zapB_predicted,0.0625,15,15,CGAATCTGGCTACTCGTCTT,0,5282728
zapB_predicted,0.0625,15,15,CCTGCCTTCGCAGACTTGAT,0,5280358
zapB_predicted,0.0625,15,15,CCGCTTATACTGCGCATAGT,0,5278266
zapB_predicted,0.0625,15,15,CCGCTCACAATGTTTCGCAA,0,5285703
zapB_predicted,0.0625,15,15,CCGAATCGAACTAATTAGAA,0,5272579
zapB_predicted,0.0625,15,15,CCCGACGCACGTTGCACTTC,0,5284206
zapB_predicted,0.0625,15,15,CCCACTCTCGATAGGCTTGT,0,5270511
zapB_predicted,0.0625,15,15,CCATCCAATGAGGAGGGACA,0,5266311
zapB_predicted,0.0625,15,15,CCAATGCTAGCGAAGGCGAA,0,5287740
zapB_predicted,0.0625,15,15,CCAAGTACGGGAGGGTGACC,0,5263329
zapB_predicted,0.0625,15,15,CATATGCCATGTTCGGTCCA,0,5284188
zapB_predicted,0.0625,15,15,CATACATAAGGCAGCACGGT,0,5265804
zapB_predicted,0.0625,15,15,CACTAGCCCTTTGATGAAAT,0,5283990
zapB_predicted,0.0625,15,15,CACGTGAGGTCACCTTGTGA,0,5282124
zapB_predicted,0.0625,15,15,CACCGGCCAAGCATCTACAC,0,5263783
zapB_predicted,0.0625,15,15,CAAATGATTATCGCCTAGTC,0,5272476
zapB_predicted,0.0625,15,15,CAAAAGCTCCCTGTGAATCT,0,5271824
zapB_predicted,0.0625,15,15,CAAAAATGCTACACTTCAAC,0,5278548
zapB_predicted,0.0625,15,15,ATTGCTGTATTACTCTGGGT,0,5281894
zapB_predicted,0.0625,15,15,ATTCAGCGCAAACCCTTACT,0,5265089
zapB_predicted,0.0625,15,15,ATTATTGGTATGGACAGCCC,0,5285382
zapB_predicted,0.0625,15,15,ATTATTCAATAAAGGGGTTT,0,5279495
zapB_predicted,0.0625,15,15,ATGGGTAGCAGTGGAGACAT,0,5272428
zapB_predicted,0.0625,15,15,ATGGATCTATTTGAGTTCTA,0,5268901
zapB_predicted,0.0625,15,15,ATGCTCAGCCACGACGACGG,0,5280282
zapB_predicted,0.0625,15,15,ATGCGACAGCAATTCTGATC,0,5272785
zapB_predicted,0.0625,15,15,ATGACCGGGGAGTGAGCTTA,0,5280668
zapB_predicted,0.0625,15,15,ATCGACAGGGCTCCGCAGTA,0,5269607
zapB_predicted,0.0625,15,15,ATCAGATACTAGGGGGATAA,0,5275009
zapB_predicted,0.0625,15,15,ATCAAGCTAAGTATGCACGA,0,5273826
zapB_predicted,0.0625,15,15,ATAAGTTTTCTTCCCGATAA,0,5277981
zapB_predicted,0.0625,15,15,ATAAGCTGTACTGGGGCGTA,0,5271025
zapB_predicted,0.0625,15,15,AGTTTGCAGCAAACAATTCA,0,5276793
zapB_predicted,0.0625,15,15,AGTTGATGGCAGATCGCCAT,0,5268012
zapB_predicted,0.0625,15,15,AGTGGCAGACCTCAAACTTA,0,5271446
zapB_predicted,0.0625,15,15,AGTGCGATTCTGGGGGGTGG,0,5265398
zapB_predicted,0.0625,15,15,AGGGTACGTTTAAAGGGGTA,0,5270765
zapB_predicted,0.0625,15,15,AGGCGCTGACTGTTCGGGGT,0,5277561
zapB_predicted,0.0625,15,15,AGGACATTTATCGTCTGGGG,0,5276524
zapB_predicted,0.0625,15,15,AGCCCGGGTCGAAATTCCGT,0,5269436
zapB_predicted,0.0625,15,15,AGCACCATGGGACGACTCAG,0,5275315
zapB_predicted,0.0625,15,15,AGAGGTTTAACCTTTCACTC,0,5263885
zapB_predicted,0.0625,15,15,AGAATTAACTCCGTCCGTGT,0,5277931
zapB_predicted,0.0625,15,15,ACTGCCTGGACTTCGATCTG,0,5263217
zapB_predicted,0.0625,15,15,ACTCTGTTTGGCATAGCAGA,0,5264727
zapB_predicted,0.0625,15,15,ACTAGAGGGCACTCATCAAG,0,5264820
zapB_predicted,0.0625,15,15,ACGGGTCTCCTAGGTCATTT,0,5269543
zapB_predicted,0.0625,15,15,ACGAACGCCCGGGGACGCGA,0,5276238
zapB_predicted,0.0625,15,15,ACCCTCCAGCGACAACTGCT,0,5279279
zapB_predicted,0.0625,15,15,ACATTGCATCCCGGACTGTG,0,5265903
zapB_predicted,0.0625,15,15,ACATGCGCAACTTAATGTAG,0,5285804
zapB_predicted,0.0625,15,15,ACACTAGGAACGCTATAACA,0,5272744
zapB_predicted,0.0625,15,15,AATCGAGATTTTAGTGACGT,0,5281915
zapB_predicted,0.0625,15,15,AAGTGTTTGAACTATTCCTA,0,5285125
zapB_predicted,0.0625,15,15,AAGGGAGGGATGCATATAAA,0,5280655
zapB_predicted,0.0625,15,15,AAGCGTTTGCATACCAGAGA,0,5265746
zapB_predicted,0.0625,15,15,AAGCCCCGAAAGCTCAGCAT,0,5274524
zapB_predicted,0.0625,15,15,AAGATGGACGGGTTGAGGAA,0,5287188
zapB_predicted,0.0625,15,15,AACTCGGCAATGGGTGTTTA,0,5283699
zapB_predicted,0.0625,15,15,AACGACACAGAACGACGGAG,0,5273971
zapB_predicted,0.0625,15,15,AACCCGTAGCTTACCTCGGG,0,5287087
zapB_predicted,0.0625,15,15,AACCCATCGTCACAGTCCGT,0,5286730
zapB_predicted,0.0625,15,15,AACATAGCTTCTATGTCATC,0,5263006
zapB_predicted,0.0625,15,15,AACAGTTTCCGCCAGATCGG,0,5280876
zapB_predicted,0.0625,15,15,AAATCTGGGTTCGGGAGAAA,0,5279733
zapB_predicted,0.0625,15,15,AAAGTCATTCATTGTCTGGC,0,5278355
zapB_predicted,0.0625,15,15,AAAGGGTAACTCATCGGAAG,0,5285749
zapB_predicted,0.0625,15,15,AAACATATTGCGACGACGGA,0,5278610
zapB_predicted,0.0625,15,15,AAAAGAACAGCACGGAGGCA,0,5281813
zapB_predicted,0.0625,15,15,AAAACCCCATTCAATGGGAA,0,5276768
zapB_predicted,0.0625,15,15,AAAAATAGGGCGCGTGTTTC,0,5285578
zapB_predicted,0.0625,15,15,AAAAAAGGGTGCGCGGTGCC,0,5264639
zapB_predicted,0.06666666666666667,14,14,TTTTAAACCCTGAACGGATT,0,5264070
zapB_predicted,0.06666666666666667,14,14,TTTGCGTGACTCTCATTAGT,0,5267419
zapB_predicted,0.06666666666666667,14,14,TTTCACCTGACATTAATGCC,0,5274382
zapB_predicted,0.06666666666666667,14,14,TTTATCATCTTGGCCACAGG,0,5286607
zapB_predicted,0.06666666666666667,14,14,TTTAGGTCATAGCAGATAGA,0,5274115
zapB_predicted,0.06666666666666667,14,14,TTTACGGTCGGAATACGCGT,0,5268213
zapB_predicted,0.06666666666666667,14,14,TTGTCCACCCAGACAGCCGT,0,5273777
zapB_predicted,0.06666666666666667,14,14,TTGTATGGGGAAGGGCTCAG,0,5267980
zapB_predicted,0.06666666666666667,14,14,TTGGGATTCCCTGAAGAGTA,0,5283789
zapB_predicted,0.06666666666666667,14,14,TTGGAGGAGTTCCGTCAGTT,0,5264566
zapB_predicted,0.06666666666666667,14,14,TTGACACCCTTCCCGCAGGA,0,5266562
zapB_predicted,0.06666666666666667,14,14,TTCCAGGCACTGGCCCGTAT,0,5286612
zapB_predicted,0.06666666666666667,14,14,TTCACGTAGCGAATACCGAA,0,5274100
zapB_predicted,0.06666666666666667,14,14,TTATACGATCCTTGGGGAGT,0,5282942
zapB_predicted,0.06666666666666667,14,14,TGTTTAACCGTAATTGGTCT,0,5286141
zapB_predicted,0.06666666666666667,14,14,TGTGGTGTCCCTACTACAGC,0,5273744
zapB_predicted,0.06666666666666667,14,14,TGTGCGTAGCTAAGGACCAC,0,5286095
zapB_predicted,0.06666666666666667,14,14,TGTCCATTCATTATTAGGAT,0,5285803
zapB_predicted,0.06666666666666667,14,14,TGTCAGCAAGGGCATGGAGA,0,5273219
zapB_predicted,0.06666666666666667,14,14,TGTACGCTCCGGGGCTACTT,0,5274271
zapB_predicted,0.06666666666666667,14,14,TGTAAAAGTCGCGTCGTCTC,0,5264395
zapB_predicted,0.06666666666666667,14,14,TGGGGTAGATTGAGATTGGA,0,5263418
zapB_predicted,0.06666666666666667,14,14,TGGCATCGCTTCGGCCCATA,0,5272325
zapB_predicted,0.06666666666666667,14,14,TGGCAATGTGATTCAAGGAA,0,5263071
zapB_predicted,0.06666666666666667,14,14,TGCGCCCCCGACCAAGTTGG,0,5284766
zapB_predicted,0.06666666666666667,14,14,TGAGCACTACTCGTGATATG,0,5285359
zapB_predicted,0.06666666666666667,14,14,TGACTTACAAGTCTCTGTCG,0,5269393
zapB_predicted,0.06666666666666667,14,14,TCTTCTATGGCCGGGCTTCA,0,5264257
zapB_predicted,0.06666666666666667,14,14,TCTACAGGGCGCCCAGTGTG,0,5274036
zapB_predicted,0.06666666666666667,14,14,TCGTGTTGCAGCGCAATTCA,0,5269608
zapB_predicted,0.06666666666666667,14,14,TCGGTTGGCAAGCTTGATGC,0,5285299
zapB_predicted,0.06666666666666667,14,14,TCGAGGTCGTCCGCATTCGC,0,5280046
zapB_predicted,0.06666666666666667,14,14,TCCGGTGCTACGCTGCGCAA,0,5280710
zapB_predicted,0.06666666666666667,14,14,TCATTGAACTTGCCTCTCTT,0,5277190
zapB_predicted,0.06666666666666667,14,14,TCATCCTGGGCCTAACAGAT,0,5287173
zapB_predicted,0.06666666666666667,14,14,TAGCCGTTTATCCGTACTGC,0,5270356
zapB_predicted,0.06666666666666667,14,14,TAGAGTTCCTGCGAGGCTCG,0,5286157
zapB_predicted,0.06666666666666667,14,14,TACAATAACCATTTAGGGAA,0,5266851
zapB_predicted,0.06666666666666667,14,14,TACAAAATTCGAGTCTTTAC,0,5278329
zapB_predicted,0.06666666666666667,14,14,TAACCGGCAGATATTTCTGG,0,5278663
zapB_predicted,0.06666666666666667,14,14,GTTACAAATTTAGGCGCATA,0,5268748
zapB_predicted,0.06666666666666667,14,14,GTGGAGCCGGATAGTATTCT,0,5281929
zapB_predicted,0.06666666666666667,14,14,GTGCTTTCGGTGAATTAGAT,0,5276383
zapB_predicted,0.06666666666666667,14,14,GTGACTTTATGATCTATCGT,0,5267812
zapB_predicted,0.06666666666666667,14,14,GTCTATTGGGCGTCTTAGGC,0,5265401
zapB_predicted,0.06666666666666667,14,14,GTCGCTTCTACACTTTAGGA,0,5263238
zapB_predicted,0.06666666666666667,14,14,GTAGAGCTACACTGATGCCT,0,5266718
zapB_predicted,0.06666666666666667,14,14,GTAGACCGGTGCTCGGGGAT,0,5267953
zapB_predicted,0.06666666666666667,14,14,GTACTGAGTTTTTGCTTGTG,0,5267720
zapB_predicted,0.06666666666666667,14,14,GGGCTAGCAGGGTTGGAGAA,0,5278773
zapB_predicted,0.06666666666666667,14,14,GGGCGCAGTAGAGGCGAACC,0,5266198
zapB_predicted,0.06666666666666667,14,14,GGCTCTTTGACGTTCTGCGC,0,5274386
zapB_predicted,0.06666666666666667,14,14,GGCTCTCGGGATCTAGCGCA,0,5282961
zapB_predicted,0.06666666666666667,14,14,GGATGCCTTGGCACGGGTAC,0,5272390
zapB_predicted,0.06666666666666667,14,14,GGACGGGTGGACAGTTGGGA,0,5283101
zapB_predicted,0.06666666666666667,14,14,GGAATTCGGGGGGGACGTTA,0,5269761
zapB_predicted,0.06666666666666667,14,14,GCGTTCTGACATCTAAGTAT,0,5282798
zapB_predicted,0.06666666666666667,14,14,GCGTCAAGGCATTCCCTCAT,0,5263041
zapB_predicted,0.06666666666666667,14,14,GCGATGAGGAGACCGGAGTA,0,5267885
zapB_predicted,0.06666666666666667,14,14,GCGAGTTCCTCGACATTAGG,0,5263199
zapB_predicted,0.06666666666666667,14,14,GCGACTGTTTCGGCTCCGGC,0,5269573
zapB_predicted,0.06666666666666667,14,14,GCCCGGCCGAATGGTTACGA,0,5268332
zapB_predicted,0.06666666666666667,14,14,GCCCACAAGCCAAATCCGCT,0,5267561
zapB_predicted,0.06666666666666667,14,14,GCCATGTCTAGCCTTGGGGA,0,5277149
zapB_predicted,0.06666666666666667,14,14,GCCATGCGTGAGCGTTCTAC,0,5267420
zapB_predicted,0.06666666666666667,14,14,GCCACCTGGGGTTCAGACTT,0,5270071
zapB_predicted,0.06666666666666667,14,14,GCATTGCGTGCGCCTGGTTA,0,5270552
zapB_predicted,0.06666666666666667,14,14,GCACGATTAATTGACAAAGG,0,5276561
zapB_predicted,0.06666666666666667,14,14,GCACAGCGGGCAGAGCTAAC,0,5264736
zapB_predicted,0.06666666666666667,14,14,GATTATAGGGTTCGGAGATG,0,5272088
zapB_predicted,0.06666666666666667,14,14,GATGCAGACAGGAAACGTGA,0,5276088
zapB_predicted,0.06666666666666667,14,14,GATCTTCACCATTTATTTAT,0,5271643
zapB_predicted,0.06666666666666667,14,14,GATAAGTACGATCGAAACCC,0,5272471
zapB_predicted,0.06666666666666667,14,14,GACCGGGACATATAGTACTG,0,5282452
zapB_predicted,0.06666666666666667,14,14,GAATCAGCCGCATGCCGGAC,0,5285483
zapB_predicted,0.06666666666666667,14,14,GAAGAGACTCGTGAACGGTC,0,5269252
zapB_predicted,0.06666666666666667,14,14,CTTGTTCTAGAGCATAGCGG,0,5264234
zapB_predicted,0.06666666666666667,14,14,CTTAAGCGGGCTATGGGCGC,0,5276057
zapB_predicted,0.06666666666666667,14,14,CTGGGTTAGTATCTGAATCT,0,5286794
zapB_predicted,0.06666666666666667,14,14,CTGGCGTACGGTACAATGAG,0,5267881
zapB_predicted,0.06666666666666667,14,14,CTGCCTTGCCAGCTTTCACG,0,5276583
zapB_predicted,0.06666666666666667,14,14,CTGCATTGGCAAACTCGTGA,0,5265705
zapB_predicted,0.06666666666666667,14,14,CTCGCAGCGGGGCAAAGTGA,0,5268414
zapB_predicted,0.06666666666666667,14,14,CTCATAGTGATCGAGAAAGG,0,5277371
zapB_predicted,0.06666666666666667,14,14,CTATGCTCTGTGTTCGGCAG,0,5279650
zapB_predicted,0.06666666666666667,14,14,CTATCGGCACGCTGTGAACA,0,5269465
zapB_predicted,0.06666666666666667,14,14,CTAGGCCAAGACATGCGTCT,0,5274505
zapB_predicted,0.06666666666666667,14,14,CGTTGTCGGTATAACACAAG,0,5286881
zapB_predicted,0.06666666666666667,14,14,CGGCAAGGTCATCAGACGTA,0,5266344
zapB_predicted,0.06666666666666667,14,14,CGCGAGGCTATAAGCATGTT,0,5270564
zapB_predicted,0.06666666666666667,14,14,CGCAGAAAGTACCCACTGAT,0,5286445
zapB_predicted,0.06666666666666667,14,14,CGATTGACTGTTAAGGGCGT,0,5274649
zapB_predicted,0.06666666666666667,14,14,CGAGCACTTAATGGACGGGC,0,5281665
zapB_predicted,0.06666666666666667,14,14,CCTCGGGAGGGCAGGCACCA,0,5273914
zapB_predicted,0.06666666666666667,14,14,CCTACGCGTCTAGAAAATAA,0,5278950
zapB_predicted,0.06666666666666667,14,14,CCGTGGCAGTCTTTGTCCTG,0,5285263
zapB_predicted,0.06666666666666667,14,14,CCGGTTCCGTTGTGTGTGGT,0,5268926
zapB_predicted,0.06666666666666667,14,14,CCGGTATCCGGAAGGGCGGT,0,5274579
zapB_predicted,0.06666666666666667,14,14,CCGGGTATATCACCGTTCAT,0,5283674
zapB_predicted,0.06666666666666667,14,14,CCGCTGATGTTAGCCGCCAC,0,5287535
zapB_predicted,0.06666666666666667,14,14,CCAGGTAGCATGTAGGGTAC,0,5286892
zapB_predicted,0.06666666666666667,14,14,CCAGGAACTTGACAACAAAC,0,5271871
zapB_predicted,0.06666666666666667,14,14,CCAACGCGACTACCTGGATA,0,5266803
zapB_predicted,0.06666666666666667,14,14,CAGTGTTTTTGGCATGGTGA,0,5271826
zapB_predicted,0.06666666666666667,14,14,CACTCTATGTGTTCGTATCT,0,5273480
zapB_predicted,0.06666666666666667,14,14,CACCTAGTTTCTCTTATGGT,0,5269575
zapB_predicted,0.06666666666666667,14,14,CAAGTCAAACATGGCCCGCC,0,5271855
zapB_predicted,0.06666666666666667,14,14,CAAATCGAGAAGGAACTTTT,0,5281949
zapB_predicted,0.06666666666666667,14,14,CAAAATCGGGGGAGGCCCAG,0,5282627
zapB_predicted,0.06666666666666667,14,14,ATTTTTATTCGGAGTGCTAT,0,5282370
zapB_predicted,0.06666666666666667,14,14,ATTACCTACAGTCAGGGACG,0,5268510
zapB_predicted,0.06666666666666667,14,14,ATGTTTAGGTAGCTTCAAGG,0,5272567
zapB_predicted,0.06666666666666667,14,14,ATGTGTCAGTTTGCGGGTTG,0,5281691
zapB_predicted,0.06666666666666667,14,14,ATGTCCAATGATCAAGGGAG,0,5281227
zapB_predicted,0.06666666666666667,14,14,ATGGTCTTCCCCAAGGCATA,0,5282193
zapB_predicted,0.06666666666666667,14,14,ATGGGCGAGGTTGACTTAAA,0,5270650
zapB_predicted,0.06666666666666667,14,14,ATGCAACAAGCCCGCGCCGA,0,5269993
zapB_predicted,0.06666666666666667,14,14,ATCGCAAAAACGTGGCCGAA,0,5265847
zapB_predicted,0.06666666666666667,14,14,ATCGAGGTCTAATCATATAC,0,5274011
zapB_predicted,0.06666666666666667,14,14,ATCATCACCCTGGTAACTGC,0,5272192
zapB_predicted,0.06666666666666667,14,14,ATATATTTCCTTGACGGGCA,0,5268473
zapB_predicted,0.06666666666666667,14,14,AGTGTAGTGCCTAGAGCGTT,0,5282855
zapB_predicted,0.06666666666666667,14,14,AGGTCATGAGTATAGAATGT,0,5264675
zapB_predicted,0.06666666666666667,14,14,AGGGTCCCGCCACATCCATT,0,5285039
zapB_predicted,0.06666666666666667,14,14,AGGCTGGGATCTCTAGACAT,0,5271294
zapB_predicted,0.06666666666666667,14,14,AGGCTACCGCGAGTGAGAAT,0,5282980
zapB_predicted,0.06666666666666667,14,14,AGCGACTTAACGTGTGTCTA,0,5280667
zapB_predicted,0.06666666666666667,14,14,AGCAACTACAGCTGGACGGC,0,5274285
zapB_predicted,0.06666666666666667,14,14,AGATCGCTAATTCGCGCAGA,0,5263680
zapB_predicted,0.06666666666666667,14,14,AGAGCGGTAAGGGCCACATT,0,5283459
zapB_predicted,0.06666666666666667,14,14,AGACCCTACCTCCGAGAGGC,0,5272841
zapB_predicted,0.06666666666666667,14,14,ACTCGGCCCCTAGGTGTGGT,0,5276034
zapB_predicted,0.06666666666666667,14,14,ACTCCCGGCCGTTAGGGTAG,0,5265104
zapB_predicted,0.06666666666666667,14,14,ACTACACTGCAATTCAGTGT,0,5272422
zapB_predicted,0.06666666666666667,14,14,ACCGTAAAATTACATTATAG,0,5281402
zapB_predicted,0.06666666666666667,14,14,ACCCCGGGAGCTGGATTCAC,0,5266088
zapB_predicted,0.06666666666666667,14,14,ACCAGGTGTATGAATGCTAT,0,5287070
zapB_predicted,0.06666666666666667,14,14,ACAGAGAGCACATCGCTTGC,0,5287268
zapB_predicted,0.06666666666666667,14,14,AATGAGTCAACTGGGTACCC,0,5279448
zapB_predicted,0.06666666666666667,14,14,AAGAGACGTGTCCTAAAGAC,0,5263597
zapB_predicted,0.06666666666666667,14,14,AACGTTGGCACGGGGGGGGG,0,5272959
zapB_predicted,0.06666666666666667,14,14,AACACATCCATGAGTAGATT,0,5276197
zapB_predicted,0.06666666666666667,14,14,AAAGTAGTGACGATATTTGG,0,5275095
zapB_predicted,0.06666666666666667,14,14,AAAGTAAGGGCTTAACCTGG,0,5281671
zapB_predicted,0.06666666666666667,14,14,AAACCTTCGCGTCCTTTAAG,0,5284713
zapB_predicted,0.06666666666666667,14,14,AAACATCACCGTCCTAAGTA,0,5271554
zapB_predicted,0.06666666666666667,14,14,AAAACCGATACCTTCGCGTC,0,5273763
zapB_predicted,0.07142857142857142,13,13,TTTGTTGTTGTGCAGGCGTC,0,5269868
zapB_predicted,0.07142857142857142,13,13,TTTGTCGTCCATATGTTAGG,0,5285365
zapB_predicted,0.07142857142857142,13,13,TTTCTTTCTGCGCGTGGTCA,0,5271151
zapB_predicted,0.07142857142857142,13,13,TTGGGCTGGTCTCCAGCTGT,0,5275123
zapB_predicted,0.07142857142857142,13,13,TTGCACACGGTAAAGAATGA,0,5285283
zapB_predicted,0.07142857142857142,13,13,TTGACCACCCTCAGCGATGG,0,5286494
zapB_predicted,0.07142857142857142,13,13,TTCCTCGGCTTCAGTCACGC,0,5276885
zapB_predicted,0.07142857142857142,13,13,TTATTGAGACCAGGTAGGGT,0,5283962
zapB_predicted,0.07142857142857142,13,13,TGTGGTGGTGGACGAGAAAA,0,5272402
zapB_predicted,0.07142857142857142,13,13,TGGGCACCAGTCGGTCATTC,0,5283967
zapB_predicted,0.07142857142857142,13,13,TGGCTCGATCTCAAGCGTCG,0,5285200
zapB_predicted,0.07142857142857142,13,13,TGAGTCTGGCCAGACTCTTT,0,5274118
zapB_predicted,0.07142857142857142,13,13,TGACAACCGGCCTTTTCGTG,0,5267600
zapB_predicted,0.07142857142857142,13,13,TCTTCTGTCATCTGCGAGAA,0,5281998
zapB_predicted,0.07142857142857142,13,13,TCTCCTGGTTCTGTTCCGAA,0,5266877
zapB_predicted,0.07142857142857142,13,13,TCGTCGTTATGTAATATGTT,0,5276845
zapB_predicted,0.07142857142857142,13,13,TCGGTGATCGTTATTCGCTA,0,5282977
zapB_predicted,0.07142857142857142,13,13,TCCGGCAGGTCTCTAGTATC,0,5282783
zapB_predicted,0.07142857142857142,13,13,TCCATGTGGCTGTTCTATGG,0,5266648
zapB_predicted,0.07142857142857142,13,13,TCAGTTTCCGTCGGGGGCGA,0,5264826
zapB_predicted,0.07142857142857142,13,13,TCAGTGATCACTTGATGGTA,0,5267679
zapB_predicted,0.07142857142857142,13,13,TATTTCCCTGGTCGCAGTTT,0,5268525
zapB_predicted,0.07142857142857142,13,13,TATTAATTAGTTACTTAGTA,0,5273758
zapB_predicted,0.07142857142857142,13,13,TAGGTTTGGATGTTGATGCA,0,5266450
zapB_predicted,0.07142857142857142,13,13,TACCATTAAGAAGGAGACAT,0,5271230
zapB_predicted,0.07142857142857142,13,13,TAAGTGGATCGGGGTTACTA,0,5285664
zapB_predicted,0.07142857142857142,13,13,TAAGTCACGTCCTGAATATC,0,5273535
zapB_predicted,0.07142857142857142,13,13,TAAGCTTAAAGCGCGTTCTC,0,5266873
zapB_predicted,0.07142857142857142,13,13,GTTTAGAAAATCCGTACTCG,0,5270352
zapB_predicted,0.07142857142857142,13,13,GTTGGCGAGGCATGGACAGC,0,5283103
zapB_predicted,0.07142857142857142,13,13,GTTCAGGAACCAGTAAAGGT,0,5268203
zapB_predicted,0.07142857142857142,13,13,GTGTACGACCCAACATGGAA,0,5282503
zapB_predicted,0.07142857142857142,13,13,GTGAGCAACACATTTATGGA,0,5271989
zapB_predicted,0.07142857142857142,13,13,GTCTTTGTCTGCACACGCGA,0,5269535
zapB_predicted,0.07142857142857142,13,13,GTCTGATATGCTAGGTTTCG,0,5271343
zapB_predicted,0.07142857142857142,13,13,GTCCCCACGCCACCGGGTTC,0,5272675
zapB_predicted,0.07142857142857142,13,13,GTCACTTATGGACTCCTACT,0,5265074
zapB_predicted,0.07142857142857142,13,13,GTCACAGTCCTTCGTACAGA,0,5278486
zapB_predicted,0.07142857142857142,13,13,GTACTTGCATGAGAACGATA,0,5282148
zapB_predicted,0.07142857142857142,13,13,GTACATTCGCGCGCTTCCTG,0,5273574
zapB_predicted,0.07142857142857142,13,13,GTAAGGTGCAGATGCGGTCG,0,5265250
zapB_predicted,0.07142857142857142,13,13,GTAAAGTATGTAGGATCGGG,0,5279633
zapB_predicted,0.07142857142857142,13,13,GGTACATACTTTTGTGAACC,0,5268406
zapB_predicted,0.07142857142857142,13,13,GGGTTTAGTCGCGCACGCGC,0,5264864
zapB_predicted,0.07142857142857142,13,13,GGGCCTTCAATTCGTTAACA,0,5281986
zapB_predicted,0.07142857142857142,13,13,GGCTCGAGGTCTGGAGAAGG,0,5277857
zapB_predicted,0.07142857142857142,13,13,GGCGTCAGGTGGCAAGAGGA,0,5280374
zapB_predicted,0.07142857142857142,13,13,GGCGCCGTGGCAAGATGCTC,0,5274251
zapB_predicted,0.07142857142857142,13,13,GGCCTTTCCGGTTAGGTATC,0,5287853
zapB_predicted,0.07142857142857142,13,13,GGCAAGGTCTTGATTCTTTA,0,5278464
zapB_predicted,0.07142857142857142,13,13,GGAAGGGTACGATCCAATAG,0,5270642
zapB_predicted,0.07142857142857142,13,13,GGAACCGGAAACCAGAACCC,0,5281027
zapB_predicted,0.07142857142857142,13,13,GCTGGTTTCAGACAACCGCA,0,5268059
zapB_predicted,0.07142857142857142,13,13,GCTGGGGGGTCAAGCTATCC,0,5268392
zapB_predicted,0.07142857142857142,13,13,GCTCGGGACGTTGGGGCCGG,0,5272758
zapB_predicted,0.07142857142857142,13,13,GCTACATGCGATTGTGAGAC,0,5279005
zapB_predicted,0.07142857142857142,13,13,GCACAACGTTGTATTGATGA,0,5264350
zapB_predicted,0.07142857142857142,13,13,GCAAGTTTGAAATACGGGGT,0,5276525
zapB_predicted,0.07142857142857142,13,13,GATTAATAGAGTTGGATCAG,0,5266001
zapB_predicted,0.07142857142857142,13,13,GATGAAATATCGGTCGTGAT,0,5281650
zapB_predicted,0.07142857142857142,13,13,GAGTACCGTGTACTCTGTGC,0,5274130
zapB_predicted,0.07142857142857142,13,13,GAGGGAAATGCTCGTGCCTT,0,5268897
zapB_predicted,0.07142857142857142,13,13,GAGGGAAATACGGTGAGCCA,0,5268231
zapB_predicted,0.07142857142857142,13,13,GACGATGGAAAGCAGGCGTC,0,5268176
zapB_predicted,0.07142857142857142,13,13,GACATGTTGCATCTTTTACA,0,5270341
zapB_predicted,0.07142857142857142,13,13,GACAAGGGTTCGAATCAGTT,0,5279660
zapB_predicted,0.07142857142857142,13,13,GAAGTTGTGCGGCTTATAAA,0,5264638
zapB_predicted,0.07142857142857142,13,13,GAAGGCCTATTGTATACAAC,0,5271816
zapB_predicted,0.07142857142857142,13,13,GAACAGAACCGTTAAGTCTC,0,5265987
zapB_predicted,0.07142857142857142,13,13,CTTGGCAACTACGTATGTAT,0,5281961
zapB_predicted,0.07142857142857142,13,13,CTTCGACGTTACGACAACCC,0,5276591
zapB_predicted,0.07142857142857142,13,13,CTGTCCCCCAAAAAATGTGA,0,5270084
zapB_predicted,0.07142857142857142,13,13,CTCTGTGATTGTTATAAATA,0,5271076
zapB_predicted,0.07142857142857142,13,13,CTCGAAATTTTTTGTACGAG,0,5286326
zapB_predicted,0.07142857142857142,13,13,CTATGCAGACAGGCATCGCT,0,5263241
zapB_predicted,0.07142857142857142,13,13,CTAAAGCGCCCGCCAACCCA,0,5277392
zapB_predicted,0.07142857142857142,13,13,CGTTTTGGTAAGGAACGAGC,0,5280603
zapB_predicted,0.07142857142857142,13,13,CGTTGAGTTACACTCCTCCC,0,5265556
zapB_predicted,0.07142857142857142,13,13,CGTTATTCAATTACGTCCTG,0,5285432
zapB_predicted,0.07142857142857142,13,13,CGTTACTCGGTCTCCCTACA,0,5283826
zapB_predicted,0.07142857142857142,13,13,CGTGGCTCGCCCGGATTCGC,0,5266709
zapB_predicted,0.07142857142857142,13,13,CGTCGGACGTAAGCGGTGTC,0,5280666
zapB_predicted,0.07142857142857142,13,13,CGTCATTGGTGGTGGATCAA,0,5277263
zapB_predicted,0.07142857142857142,13,13,CGTATAGGTAGAGTTCAGCA,0,5264785
zapB_predicted,0.07142857142857142,13,13,CGGGTGGCTATGGGGGTTGG,0,5273170
zapB_predicted,0.07142857142857142,13,13,CGGCGTTCCCATGAAAGAAC,0,5286843
zapB_predicted,0.07142857142857142,13,13,CGGACTCTAGACTCATCCAA,0,5283248
zapB_predicted,0.07142857142857142,13,13,CGGACGTGTCTCAATTCTCT,0,5266039
zapB_predicted,0.07142857142857142,13,13,CGGACATATCGCAAAGTCCT,0,5284842
zapB_predicted,0.07142857142857142,13,13,CGGAATCAATGAGAAATAAT,0,5273225
zapB_predicted,0.07142857142857142,13,13,CGCTGTGGCCACGCATCGAT,0,5267813
zapB_predicted,0.07142857142857142,13,13,CGCGGACATTAAAGACGTCA,0,5269603
zapB_predicted,0.07142857142857142,13,13,CGATGCATGGTCATTTGACA,0,5273119
zapB_predicted,0.07142857142857142,13,13,CGACCCGAGTAAATGCGGTT,0,5283575
zapB_predicted,0.07142857142857142,13,13,CGAATGATCAATCCGGTACT,0,5284922
zapB_predicted,0.07142857142857142,13,13,CCTGGACCTAAATTTGCACT,0,5264308
zapB_predicted,0.07142857142857142,13,13,CCTGAAGTAACATTCAACGG,0,5285352
zapB_predicted,0.07142857142857142,13,13,CCGTAGTTATGGGCGTTCCA,0,5275729
zapB_predicted,0.07142857142857142,13,13,CCGTAACAAATCAGTGTGAT,0,5268824
zapB_predicted,0.07142857142857142,13,13,CCGGTCATTAAGGGGTGTCT,0,5268838
zapB_predicted,0.07142857142857142,13,13,CCCAGGCTTATATGCTTTCA,0,5280620
zapB_predicted,0.07142857142857142,13,13,CCATGGGGCCACCCCGTTGT,0,5270203
zapB_predicted,0.07142857142857142,13,13,CCATGCCCGTCACTCGCAAG,0,5270164
zapB_predicted,0.07142857142857142,13,13,CCACTGGGGCACGCAAATTT,0,5283418
zapB_predicted,0.07142857142857142,13,13,CCAAAGTCGTGCACCGCGAG,0,5268830
zapB_predicted,0.07142857142857142,13,13,CATGGTCTCACCAGGGGAAG,0,5265210
zapB_predicted,0.07142857142857142,13,13,CATATCCCCTACCAATTTAC,0,5278616
zapB_predicted,0.07142857142857142,13,13,CAGTGTAACCTATCACTGCG,0,5280099
zapB_predicted,0.07142857142857142,13,13,CAGATTCCTACGATGTCAAC,0,5279938
zapB_predicted,0.07142857142857142,13,13,CAGAGACGGGTAAAACTTAA,0,5277235
zapB_predicted,0.07142857142857142,13,13,CACTCAGAACTTGGGAACCG,0,5273103
zapB_predicted,0.07142857142857142,13,13,CACACCCTTCGCTTTATCCA,0,5268152
zapB_predicted,0.07142857142857142,13,13,CAATGAGTGAGAAAGTATAC,0,5276701
zapB_predicted,0.07142857142857142,13,13,CAACTGTAGTGTTAATAGTT,0,5278738
zapB_predicted,0.07142857142857142,13,13,CAACGAACCTGGGTATATCT,0,5268816
zapB_predicted,0.07142857142857142,13,13,CAAAGCCTCAACCTTCGTGC,0,5272563
zapB_predicted,0.07142857142857142,13,13,ATTTGTCACCCATTTGGGTT,0,5285851
zapB_predicted,0.07142857142857142,13,13,ATTTGGCACGTGGGGGATAC,0,5284812
zapB_predicted,0.07142857142857142,13,13,ATTTAAAGGGCGGTAACCTT,0,5278358
zapB_predicted,0.07142857142857142,13,13,ATTGGCCCTCTGCTTTGGGA,0,5282218
zapB_predicted,0.07142857142857142,13,13,ATTCCTAGCTAGTGGCTGCT,0,5269272
zapB_predicted,0.07142857142857142,13,13,ATTAGTCGCCCCGTGTACCG,0,5274815
zapB_predicted,0.07142857142857142,13,13,ATTACCTGACCATGACCGGA,0,5277446
zapB_predicted,0.07142857142857142,13,13,ATGTATACTGCTTATTGTAC,0,5270865
zapB_predicted,0.07142857142857142,13,13,ATGGGACGCTGTTTCCTCGG,0,5269715
zapB_predicted,0.07142857142857142,13,13,ATGCAGATTTCCCATATAAC,0,5284703
zapB_predicted,0.07142857142857142,13,13,ATCGCGTACACCATCCTCCT,0,5270896
zapB_predicted,0.07142857142857142,13,13,ATCCGCAAAGATTAGAATAT,0,5286758
zapB_predicted,0.07142857142857142,13,13,ATCCCTAGTTTTACAATAAG,0,5264360
zapB_predicted,0.07142857142857142,13,13,ATCATAGGATCGTGCGTGAA,0,5265183
zapB_predicted,0.07142857142857142,13,13,ATACATCTTCGGTCTCCGGT,0,5267351
zapB_predicted,0.07142857142857142,13,13,AGTGATCTATTTGTTATAAC,0,5265412
zapB_predicted,0.07142857142857142,13,13,AGTCGAACACAAATATAAGT,0,5286559
zapB_predicted,0.07142857142857142,13,13,AGTCACACGGATCTGAACAG,0,5268639
zapB_predicted,0.07142857142857142,13,13,AGTAGCCAGGAGATTTCTGT,0,5270249
zapB_predicted,0.07142857142857142,13,13,AGTACGTAGCACCTTTATCG,0,5278066
zapB_predicted,0.07142857142857142,13,13,AGGCACATCACGATGTAGGT,0,5286877
zapB_predicted,0.07142857142857142,13,13,AGCTTTTCCCATTCATCCTT,0,5283028
zapB_predicted,0.07142857142857142,13,13,AGCGTTTAAACAGATGCTAT,0,5276216
zapB_predicted,0.07142857142857142,13,13,AGCGCACCATCGATTAGTAT,0,5284340
zapB_predicted,0.07142857142857142,13,13,AGCCGTTGCAGGGTCGGCAT,0,5279352
zapB_predicted,0.07142857142857142,13,13,ACTGTGGTATCGCCTTTCCC,0,5285909
zapB_predicted,0.07142857142857142,13,13,ACTCAATCGCGTGGCGAGTA,0,5269754
zapB_predicted,0.07142857142857142,13,13,ACGCCCATCTCGAGAGCCCC,0,5284386
zapB_predicted,0.07142857142857142,13,13,ACGCACCACTAAGAAACCGA,0,5267975
zapB_predicted,0.07142857142857142,13,13,ACCTTTTATGGTTGCAAAGG,0,5285342
zapB_predicted,0.07142857142857142,13,13,ACCCGTCATATGCACGCATT,0,5272465
zapB_predicted,0.07142857142857142,13,13,ACCACGGCTTCGTCGCTGGT,0,5281912
zapB_predicted,0.07142857142857142,13,13,ACACTGAGAATACGGAGTAT,0,5269560
zapB_predicted,0.07142857142857142,13,13,ACAATTGGTGGATAATCATA,0,5263661
zapB_predicted,0.07142857142857142,13,13,ACAAAGGTCGCCAGGAGTCT,0,5279553
zapB_predicted,0.07142857142857142,13,13,ACAAAGGGGACATGCTCCGT,0,5286844
zapB_predicted,0.07142857142857142,13,13,AATTCGAGGATGCATTAGCA,0,5272709
zapB_predicted,0.07142857142857142,13,13,AATCACGCCTCCCATTTTTA,0,5283245
zapB_predicted,0.07142857142857142,13,13,AAGTTAGAGATTCAAACCGA,0,5279264
zapB_predicted,0.07142857142857142,13,13,AAGCGGTAGTGGTGGGTAGC,0,5283700
zapB_predicted,0.07142857142857142,13,13,AAGCAACAACTCCCCACGTC,0,5271960
zapB_predicted,0.07142857142857142,13,13,AACTGACACACCGAGGGCAT,0,5285825
zapB_predicted,0.07142857142857142,13,13,AACGTACCAAAAGAGGATAT,0,5267768
zapB_predicted,0.07142857142857142,13,13,AACCTATAGTGATAGGAAAA,0,5287351
zapB_predicted,0.07142857142857142,13,13,AAATCTGACGTATCAGGTTG,0,5264794
zapB_predicted,0.07142857142857142,13,13,AAATCTCACGGTTGAGATAC,0,5286106
zapB_predicted,0.07142857142857142,13,13,AAAACCGTGCTGCAGTGGGA,0,5267698
zapB_predicted,0.07692307692307693,12,12,TTTGGACCTACCGAATACGC,0,5280027
zapB_predicted,0.07692307692307693,12,12,TTTGATTGCTACTGTCTGTT,0,5271368
zapB_predicted,0.07692307692307693,12,12,TTTGAATTTCTCAATGGGGT,0,5277312
zapB_predicted,0.07692307692307693,12,12,TTTGAAGTCCCTCTACCCCG,0,5272980
zapB_predicted,0.07692307692307693,12,12,TTTCAGGGACCGTTGTCTGT,0,5268716
zapB_predicted,0.07692307692307693,12,12,TTGGCTCATACCATCATAAA,0,5279365
zapB_predicted,0.07692307692307693,12,12,TTGACACGCCCGCTCTGGCT,0,5284071
zapB_predicted,0.07692307692307693,12,12,TTCTTGCACCTTCAATAGGC,0,5272234
zapB_predicted,0.07692307692307693,12,12,TTCGGTAACCAGGTCGCGCG,0,5275093
zapB_predicted,0.07692307692307693,12,12,TTCATCTAATGAACGTTCCG,0,5274973
zapB_predicted,0.07692307692307693,12,12,TTCAGGCGCATGATAACTCA,0,5276385
zapB_predicted,0.07692307692307693,12,12,TTAGTGCCACCGCGACGGGG,0,5270068
zapB_predicted,0.07692307692307693,12,12,TTAGACGGGGCTAGCAGAAA,0,5287455
zapB_predicted,0.07692307692307693,12,12,TTACGGGGATGGCTAAGGTT,0,5268300
zapB_predicted,0.07692307692307693,12,12,TTACGCCTAGAAGCTTTAGG,0,5267703
zapB_predicted,0.07692307692307693,12,12,TTAACACGAAGGTCGGCGAT,0,5269920
zapB_predicted,0.07692307692307693,12,12,TGGTATATAATACGGCGCAT,0,5286374
zapB_predicted,0.07692307692307693,12,12,TGGGAACCGTACAGTTTACA,0,5274550
zapB_predicted,0.07692307692307693,12,12,TGGCCGGGCATGGGATCGCT,0,5267421
zapB_predicted,0.07692307692307693,12,12,TGGAGCATCAAGCTGCCGCA,0,5284882
zapB_predicted,0.07692307692307693,12,12,TGATAGGGGCATGGCTGGTT,0,5278502
zapB_predicted,0.07692307692307693,12,12,TGAGCCCTGTAAGGGCGGCG,0,5283252
zapB_predicted,0.07692307692307693,12,12,TGAGACGCCTGTGATTTCGC,0,5283477
zapB_predicted,0.07692307692307693,12,12,TCTGTTACGCTGCAGTAGGG,0,5269395
zapB_predicted,0.07692307692307693,12,12,TCTGGCTGGTAGAAAAACGA,0,5280225
zapB_predicted,0.07692307692307693,12,12,TCGGCCAGATGACTCCGGAT,0,5277321
zapB_predicted,0.07692307692307693,12,12,TCGGCCACGCTAAGACGATA,0,5277551
zapB_predicted,0.07692307692307693,12,12,TCAGTTTAAGAATTGTGCAA,0,5278426
zapB_predicted,0.07692307692307693,12,12,TCAGGGTTCAACAGAACGAA,0,5269416
zapB_predicted,0.07692307692307693,12,12,TCACTAGCATCTTCCGTCTG,0,5265604
zapB_predicted,0.07692307692307693,12,12,TCACACTCGACTCGACGTAT,0,5283896
zapB_predicted,0.07692307692307693,12,12,TCAATAGTAACTGTACATCA,0,5270628
zapB_predicted,0.07692307692307693,12,12,TATGCTGGATATAGATGTGT,0,5267575
zapB_predicted,0.07692307692307693,12,12,TATGAGTGGGGGCGCGGACA,0,5263608
zapB_predicted,0.07692307692307693,12,12,TAGGGTCTACGAGCGGTCCA,0,5268278
zapB_predicted,0.07692307692307693,12,12,TAGGCTGAGTCCTGAAGATT,0,5275563
zapB_predicted,0.07692307692307693,12,12,TAGGATGACCAGGTCACCCT,0,5279265
zapB_predicted,0.07692307692307693,12,12,TACTCTCCGTTTCAACCTGC,0,5269005
zapB_predicted,0.07692307692307693,12,12,TACCGCTATGAGCTTGTCGG,0,5269561
zapB_predicted,0.07692307692307693,12,12,TAATAGTCAATGCCAACTAG,0,5264924
zapB_predicted,0.07692307692307693,12,12,TAACCCTCAATACACCGAGT,0,5273483
zapB_predicted,0.07692307692307693,12,12,TAAAGGTGATTGGAGAGATT,0,5284144
zapB_predicted,0.07692307692307693,12,12,GTTTGCGACGCGGTTCCGTA,0,5270962
zapB_predicted,0.07692307692307693,12,12,GTGGGTTTATTTATCCGCTA,0,5263456
zapB_predicted,0.07692307692307693,12,12,GTGGGGTAAGCTTGTCCTAA,0,5269557
zapB_predicted,0.07692307692307693,12,12,GTGGACCGTAGTCAACCTCA,0,5272540
zapB_predicted,0.07692307692307693,12,12,GTGAAGCCTGACGTAAACAT,0,5266046
zapB_predicted,0.07692307692307693,12,12,GTCTCGTAGCAGTATAGCTA,0,5285035
zapB_predicted,0.07692307692307693,12,12,GTCGCTTACCCATAACAGCA,0,5264079
zapB_predicted,0.07692307692307693,12,12,GTCGATAGCGGGCCAATTCC,0,5272323
zapB_predicted,0.07692307692307693,12,12,GTATTCTTATAGGTTGCTTT,0,5287382
zapB_predicted,0.07692307692307693,12,12,GTATTCAGTGTCAGTGCAGA,0,5270661
zapB_predicted,0.07692307692307693,12,12,GTATGAAAGTCTTCAGATTT,0,5264399
zapB_predicted,0.07692307692307693,12,12,GTACTACAGCTGAAATAGGC,0,5283430
zapB_predicted,0.07692307692307693,12,12,GTACAGATTCAGAAGAAGAC,0,5263140
zapB_predicted,0.07692307692307693,12,12,GTAAGGTGTAGGTAGAGTGT,0,5269683
zapB_predicted,0.07692307692307693,12,12,GGTTGGCCTTATTCTGCCCA,0,5283731
zapB_predicted,0.07692307692307693,12,12,GGTAGGTGTGGAATGTTATT,0,5269750
zapB_predicted,0.07692307692307693,12,12,GGGTTTGGACCCCCAGGCAA,0,5272988
zapB_predicted,0.07692307692307693,12,12,GGGTCATGGGTTGAGTCAAA,0,5272981
zapB_predicted,0.07692307692307693,12,12,GGGCGGATCAAGCTGACCAT,0,5275882
zapB_predicted,0.07692307692307693,12,12,GGGCACCGTCAAATGTGGAG,0,5285818
zapB_predicted,0.07692307692307693,12,12,GGCTGATTGTTTCCCGTATA,0,5274580
zapB_predicted,0.07692307692307693,12,12,GGCTAGGATATTGCCATTAT,0,5285819
zapB_predicted,0.07692307692307693,12,12,GGCTACGGGGGTGACGCATT,0,5283388
zapB_predicted,0.07692307692307693,12,12,GGAGATGCGCGTGTATAAAT,0,5284412
zapB_predicted,0.07692307692307693,12,12,GCTTGTTACTTAAATCAAAT,0,5275897
zapB_predicted,0.07692307692307693,12,12,GCGTAGCTGATACTTTCGAA,0,5277858
zapB_predicted,0.07692307692307693,12,12,GCGGGGATCACGAGCGCTCG,0,5271430
zapB_predicted,0.07692307692307693,12,12,GCGGGATCCCGTTGACGTGA,0,5268910
zapB_predicted,0.07692307692307693,12,12,GCGATACTGCGAACCGCAGT,0,5276174
zapB_predicted,0.07692307692307693,12,12,GCCAGACCAGAGGGGGCGTC,0,5271490
zapB_predicted,0.07692307692307693,12,12,GCATATGGGAGATAATATAA,0,5270749
zapB_predicted,0.07692307692307693,12,12,GCAGTGCGCTTAAAGACCTA,0,5275903
zapB_predicted,0.07692307692307693,12,12,GCAGTCGGTTCATTATTAGT,0,5279941
zapB_predicted,0.07692307692307693,12,12,GAGTGGCAGGGTCTAAAAGT,0,5264236
zapB_predicted,0.07692307692307693,12,12,GAGTCCCGTTAAGTCTGTAA,0,5277471
zapB_predicted,0.07692307692307693,12,12,GAGATTTCCATTCGGGCACA,0,5268155
zapB_predicted,0.07692307692307693,12,12,GAGATCACTTCATCCAGAAT,0,5265568
zapB_predicted,0.07692307692307693,12,12,GACGTAGGTACAGGGAACCA,0,5278686
zapB_predicted,0.07692307692307693,12,12,GACGGGCGAGATCACAGTAG,0,5270260
zapB_predicted,0.07692307692307693,12,12,GACGGGCATCGACGCAGGTA,0,5275394
zapB_predicted,0.07692307692307693,12,12,GACCGGCGAATCCGGCCAGG,0,5271928
zapB_predicted,0.07692307692307693,12,12,GAATTATCCATAGGGCTCAT,0,5268542
zapB_predicted,0.07692307692307693,12,12,GAAAGGGTCAATTGGCTTTC,0,5276739
zapB_predicted,0.07692307692307693,12,12,CTTGATGCGCTTGTTACTCT,0,5268509
zapB_predicted,0.07692307692307693,12,12,CTTGACTTCTACCACTGCGT,0,5263271
zapB_predicted,0.07692307692307693,12,12,CTTCGTCACGAAAACGGGTA,0,5275610
zapB_predicted,0.07692307692307693,12,12,CTGTGTAGCCGCAGCCTAGC,0,5264095
zapB_predicted,0.07692307692307693,12,12,CTGGCCGGCCAGGCCGGACG,0,5278282
zapB_predicted,0.07692307692307693,12,12,CTGCCCAAGCGTTGCGTCGA,0,5276442
zapB_predicted,0.07692307692307693,12,12,CTGCATGCGCATCGAGATGT,0,5277614
zapB_predicted,0.07692307692307693,12,12,CTGAGAGACCGCCCACCATT,0,5266027
zapB_predicted,0.07692307692307693,12,12,CTCTAGTCATAAAAATGGGA,0,5276472
zapB_predicted,0.07692307692307693,12,12,CTATGCCTAGCGATTCGGCT,0,5276352
zapB_predicted,0.07692307692307693,12,12,CTAGAACGACGTTGGTGACT,0,5263637
zapB_predicted,0.07692307692307693,12,12,CTAATTAGTTAACTTAGGAG,0,5273933
zapB_predicted,0.07692307692307693,12,12,CGTTAAGGATTTGTATCAAC,0,5280024
zapB_predicted,0.07692307692307693,12,12,CGTGCTCGGCGAACCCTCAA,0,5278192
zapB_predicted,0.07692307692307693,12,12,CGTGCGAAACATGCTTGGTT,0,5283991
zapB_predicted,0.07692307692307693,12,12,CGTCCAACTAGCCGGATCGC,0,5285678
zapB_predicted,0.07692307692307693,12,12,CGTCAACCCTGCTGGCTTTT,0,5282619
zapB_predicted,0.07692307692307693,12,12,CGTACGAAGAGGGAGGGGGT,0,5278217
zapB_predicted,0.07692307692307693,12,12,CGTAAACGCGAGCTTTTGGG,0,5273793
zapB_predicted,0.07692307692307693,12,12,CGGTATATTGGCTGATCAAT,0,5282354
zapB_predicted,0.07692307692307693,12,12,CGGGACGGTCGGGCACCACT,0,5273402
zapB_predicted,0.07692307692307693,12,12,CGGAGACAGCCGGAGGGCGA,0,5265338
zapB_predicted,0.07692307692307693,12,12,CGCGGGTAAGTGGATACATC,0,5266931
zapB_predicted,0.07692307692307693,12,12,CGCGATATTCAAAGTGCTAC,0,5279993
zapB_predicted,0.07692307692307693,12,12,CGATCGGCGGTTCCGTTCGC,0,5275770
zapB_predicted,0.07692307692307693,12,12,CGAAGGTGGTACCCTCGTCT,0,5283864
zapB_predicted,0.07692307692307693,12,12,CCTTCGTTCCGATGGACCCG,0,5272066
zapB_predicted,0.07692307692307693,12,12,CCGTTTGACGGTGGATGCGC,0,5285807
zapB_predicted,0.07692307692307693,12,12,CCGTTATCGTCCGAAGAAAT,0,5271340
zapB_predicted,0.07692307692307693,12,12,CCGTGACCAGTAAGTGCAAC,0,5276754
zapB_predicted,0.07692307692307693,12,12,CCGCTTATACAGGCACCGTT,0,5276120
zapB_predicted,0.07692307692307693,12,12,CCGAGTCCACGAATTCGCGC,0,5282687
zapB_predicted,0.07692307692307693,12,12,CCCGCTTGACTGATCAGGTT,0,5269627
zapB_predicted,0.07692307692307693,12,12,CCATCGTCGGAGTAAGCCTG,0,5286748
zapB_predicted,0.07692307692307693,12,12,CCAGAACAGGCTGACTAACT,0,5282559
zapB_predicted,0.07692307692307693,12,12,CAGTTAAATTTCTTGCCGAT,0,5264113
zapB_predicted,0.07692307692307693,12,12,CAGGCACCAGATGGCCCAGC,0,5278185
zapB_predicted,0.07692307692307693,12,12,CAGAGTTGGGTATTGCCAAT,0,5274199
zapB_predicted,0.07692307692307693,12,12,CAGAGTCTTAGAATAAAAAG,0,5279560
zapB_predicted,0.07692307692307693,12,12,CAGACATCGGGCTACCGCAG,0,5265127
zapB_predicted,0.07692307692307693,12,12,CACTTTTAAGCCTTTTGTCA,0,5274873
zapB_predicted,0.07692307692307693,12,12,CACTAGGCGAAGATCTGGTA,0,5275640
zapB_predicted,0.07692307692307693,12,12,CACACCCCATTTCAATATTT,0,5268689
zapB_predicted,0.07692307692307693,12,12,CAAACTCGAGCCATGCTGAC,0,5280911
zapB_predicted,0.07692307692307693,12,12,CAAAAAGTGGTTATATTTTA,0,5268299
zapB_predicted,0.07692307692307693,12,12,ATTCTCTCCTCGACCGGGAA,0,5269803
zapB_predicted,0.07692307692307693,12,12,ATGTACCCTGAAAACCATGT,0,5275369
zapB_predicted,0.07692307692307693,12,12,ATGGCCATATAGCGCAAGAG,0,5268355
zapB_predicted,0.07692307692307693,12,12,ATGCCATTATAGAGGCAGAT,0,5268310
zapB_predicted,0.07692307692307693,12,12,ATGCACTTTCAGCCGCTCAG,0,5277033
zapB_predicted,0.07692307692307693,12,12,ATCATGTGATCCGTGGCACA,0,5268033
zapB_predicted,0.07692307692307693,12,12,ATCAGAATCACCAGATTCTA,0,5286752
zapB_predicted,0.07692307692307693,12,12,ATAAAGCCATCCCACCTTCG,0,5280072
zapB_predicted,0.07692307692307693,12,12,AGTTTGTGATCCTAATGTTG,0,5280736
zapB_predicted,0.07692307692307693,12,12,AGTTGTCCTTACTGGGTTCT,0,5274103
zapB_predicted,0.07692307692307693,12,12,AGTGTACTAAGTAGGACCTG,0,5267138
zapB_predicted,0.07692307692307693,12,12,AGTATGAGGCGTGCGCGATC,0,5271969
zapB_predicted,0.07692307692307693,12,12,AGTACTTACCTGTGGGCGAA,0,5278288
zapB_predicted,0.07692307692307693,12,12,AGGGGGATTTAGTCCCGATC,0,5277241
zapB_predicted,0.07692307692307693,12,12,AGGGGCAGGGGCTAGGAAAA,0,5265121
zapB_predicted,0.07692307692307693,12,12,AGGACGCCGTTAGACCGTAA,0,5272580
zapB_predicted,0.07692307692307693,12,12,AGCGGTAGGAATCTAACCTG,0,5268197
zapB_predicted,0.07692307692307693,12,12,AGCCGTTATATGTCGCGATA,0,5286049
zapB_predicted,0.07692307692307693,12,12,AGCCGGATTGGAACGCCACG,0,5265071
zapB_predicted,0.07692307692307693,12,12,AGCCCGAGTGCCCGTTTATT,0,5273326
zapB_predicted,0.07692307692307693,12,12,AGAGATGATCATTAGATGGA,0,5265188
zapB_predicted,0.07692307692307693,12,12,AGACGTGTAGACTGACAGTG,0,5270382
zapB_predicted,0.07692307692307693,12,12,ACTTAATGTCAACAGCTTGC,0,5274488
zapB_predicted,0.07692307692307693,12,12,ACTGTGAAATTGACACAGCC,0,5279569
zapB_predicted,0.07692307692307693,12,12,ACTCTAAAGCCGTGGACGCT,0,5287359
zapB_predicted,0.07692307692307693,12,12,ACTCGTCCGATCCATGGGAC,0,5267491
zapB_predicted,0.07692307692307693,12,12,ACTAAGCAGGTTCACCTGAC,0,5273911
zapB_predicted,0.07692307692307693,12,12,ACGGCCGTTCCGAGAATCGT,0,5287826
zapB_predicted,0.07692307692307693,12,12,ACCTGTCAGTTACTCACGCT,0,5276167
zapB_predicted,0.07692307692307693,12,12,ACCGTAAGACAATTCCACGT,0,5266843
zapB_predicted,0.07692307692307693,12,12,ACCCTCACGCCATATGCGAA,0,5264817
zapB_predicted,0.07692307692307693,12,12,ACCCGGCGCTGGGGAGGATC,0,5282950
zapB_predicted,0.07692307692307693,12,12,ACAGGCTAATCGATGATCTC,0,5267323
zapB_predicted,0.07692307692307693,12,12,ACAAGGCCGAGCCCCTTTGC,0,5265417
zapB_predicted,0.07692307692307693,12,12,ACAACCAGAGAGGCATCCAG,0,5271355
zapB_predicted,0.07692307692307693,12,12,AATGCCATCCTGTGATTGTA,0,5274490
zapB_predicted,0.07692307692307693,12,12,AAGTTTAATAAGTACGTTCG,0,5282949
zapB_predicted,0.07692307692307693,12,12,AAGTCCCGCTCTTCCCACAG,0,5266475
zapB_predicted,0.07692307692307693,12,12,AAGGACGACTTGGTGTATTT,0,5274322
zapB_predicted,0.07692307692307693,12,12,AAGCGGGTAAAGGGTGGGTG,0,5278665
zapB_predicted,0.07692307692307693,12,12,AAGCGATCTGTCCGAAAGTT,0,5276497
zapB_predicted,0.07692307692307693,12,12,AACCTAGTAGAGAACTAAGC,0,5283592
zapB_predicted,0.07692307692307693,12,12,AAAGGTAACAAAAGTATCGA,0,5272657
zapB_predicted,0.07692307692307693,12,12,AAACGGGGATTTTTTCGTGA,0,5273961
zapB_predicted,0.07692307692307693,12,12,AAACATATGGTAACGTACCA,0,5275696
zapB_predicted,0.08333333333333333,11,11,TTTTAAATCCAGGAAGGGAC,0,5274927
zapB_predicted,0.08333333333333333,11,11,TTTGTAGGTTCCTAGAAGTG,0,5286534
zapB_predicted,0.08333333333333333,11,11,TTTGGCTTCTTGTGACCGCC,0,5273613
zapB_predicted,0.08333333333333333,11,11,TTGTGACGGCTTCAACGGGG,0,5276813
zapB_predicted,0.08333333333333333,11,11,TTGACGAATCTTCCGACCGT,0,5283095
zapB_predicted,0.08333333333333333,11,11,TTCTTTGGCTCTAGCATATT,0,5275156
zapB_predicted,0.08333333333333333,11,11,TTCTCGAGAGTATCCAGAAA,0,5269161
zapB_predicted,0.08333333333333333,11,11,TTCGTCCACTCGCACGGCAG,0,5266764
zapB_predicted,0.08333333333333333,11,11,TTCAACCCTGTATTATCTCT,0,5274250
zapB_predicted,0.08333333333333333,11,11,TTATATACGAGTGCGCTGTT,0,5280049
zapB_predicted,0.08333333333333333,11,11,TTAGTTCTCCACTGAACGAA,0,5279014
zapB_predicted,0.08333333333333333,11,11,TGTAATACTCTGCATACTTC,0,5285544
zapB_predicted,0.08333333333333333,11,11,TGTAACCAGAAACCTGTATA,0,5279511
zapB_predicted,0.08333333333333333,11,11,TGGTAATGATGGGGATGTTG,0,5284609
zapB_predicted,0.08333333333333333,11,11,TGGGCGGGCGATCACGCCAG,0,5264832
zapB_predicted,0.08333333333333333,11,11,TGGATTGGGCAGATGAAGAG,0,5279061
zapB_predicted,0.08333333333333333,11,11,TGGATTGAGAGCGCTGCGGA,0,5279420
zapB_predicted,0.08333333333333333,11,11,TGCTTCCGTCGGCTATACAG,0,5278922
zapB_predicted,0.08333333333333333,11,11,TGCTAACCCACTCAACCGGA,0,5273458
zapB_predicted,0.08333333333333333,11,11,TGCGTTGGTTGCCGCTCGGT,0,5268212
zapB_predicted,0.08333333333333333,11,11,TGATGATCTACGTGTTGCTT,0,5282642
zapB_predicted,0.08333333333333333,11,11,TGATGACAAAGTCTAAGTCG,0,5274172
zapB_predicted,0.08333333333333333,11,11,TGATCCGACACAGAATCGTC,0,5270466
zapB_predicted,0.08333333333333333,11,11,TGAGAGGGACTTGTATTTGC,0,5284413
zapB_predicted,0.08333333333333333,11,11,TGAATCCGTGATGTTGGGAA,0,5263865
zapB_predicted,0.08333333333333333,11,11,TGAAGCATCATATTTCTTGG,0,5267175
zapB_predicted,0.08333333333333333,11,11,TCTTAACTTCGGGGCGAGCT,0,5267755
zapB_predicted,0.08333333333333333,11,11,TCTGTTTCCTCCGGATAGGT,0,5263733
zapB_predicted,0.08333333333333333,11,11,TCTGTCTCAGTTCGGTCAGT,0,5270861
zapB_predicted,0.08333333333333333,11,11,TCTGGGTTCTACGGTCTTAC,0,5271970
zapB_predicted,0.08333333333333333,11,11,TCGTTCCTGCGTAGGAGAAC,0,5269332
zapB_predicted,0.08333333333333333,11,11,TCGGCCCCGCGCTTTCCGTT,0,5286834
zapB_predicted,0.08333333333333333,11,11,TCGGAACCCTAGGTGGCATG,0,5280698
zapB_predicted,0.08333333333333333,11,11,TCGCTCGTATCCTTCTATCT,0,5270624
zapB_predicted,0.08333333333333333,11,11,TCGACTGTTTAAAACGGGTG,0,5279666
zapB_predicted,0.08333333333333333,11,11,TCCGGGTTATGATGTCCTGA,0,5272496
zapB_predicted,0.08333333333333333,11,11,TCCAGATGTGTAAATTTCTG,0,5271236
zapB_predicted,0.08333333333333333,11,11,TCCAAGCAACATTTAAACGT,0,5281623
zapB_predicted,0.08333333333333333,11,11,TCATCTGCGTGCCATCGACG,0,5275224
zapB_predicted,0.08333333333333333,11,11,TCATCGTATACGCGGGACTA,0,5269637
zapB_predicted,0.08333333333333333,11,11,TCAGAAAGCGTATCCGGGCG,0,5279838
zapB_predicted,0.08333333333333333,11,11,TCAATACACATCCGGCCGAC,0,5269881
zapB_predicted,0.08333333333333333,11,11,TCAAAGTTCTTACGCCTGAA,0,5264046
zapB_predicted,0.08333333333333333,11,11,TATTGGGGGAGAGGATTTTG,0,5280934
zapB_predicted,0.08333333333333333,11,11,TATGCTTTTTGGAAGTCGAG,0,5279144
zapB_predicted,0.08333333333333333,11,11,TAGGGACTACCTTGTACTTG,0,5268031
zapB_predicted,0.08333333333333333,11,11,TAGGAGGTTTGGGTCCTTTC,0,5265037
zapB_predicted,0.08333333333333333,11,11,TAGGAACGTTAAGGGTACGG,0,5283810
zapB_predicted,0.08333333333333333,11,11,TAGAGAACATTTGTTAACGA,0,5265495
zapB_predicted,0.08333333333333333,11,11,TACGGCGCCCGTTGTGCACT,0,5285816
zapB_predicted,0.08333333333333333,11,11,TACACGGCCATACGAAGGGA,0,5267955
zapB_predicted,0.08333333333333333,11,11,GTTCCTCTCCATCAGGCTAG,0,5282983
zapB_predicted,0.08333333333333333,11,11,GTTACGCCGGCTAAAGTGGT,0,5277257
zapB_predicted,0.08333333333333333,11,11,GTTAATGTATTGCTAAGTGA,0,5283640
zapB_predicted,0.08333333333333333,11,11,GTGTTCAAGGACGGCAAATA,0,5279968
zapB_predicted,0.08333333333333333,11,11,GTGAGTCATTTCTATCAGAG,0,5274523
zapB_predicted,0.08333333333333333,11,11,GTGAGTCACGTTTTTAAATT,0,5282518
zapB_predicted,0.08333333333333333,11,11,GTGAGAGAAAGTCTGTCGAG,0,5279030
zapB_predicted,0.08333333333333333,11,11,GTCGGGTCCATCTCCGGTCC,0,5269152
zapB_predicted,0.08333333333333333,11,11,GTCGGATCCAGTTGCTTAGT,0,5274863
zapB_predicted,0.08333333333333333,11,11,GTCCACATTAAATATTAAGA,0,5277911
zapB_predicted,0.08333333333333333,11,11,GTAGCGATGTTCACTGGACG,0,5286715
zapB_predicted,0.08333333333333333,11,11,GTAAGGCAACGTTGTCTACC,0,5284305
zapB_predicted,0.08333333333333333,11,11,GGTTGCACGACGTATGGTGG,0,5278442
zapB_predicted,0.08333333333333333,11,11,GGTTCGTAATACCGTCAGTT,0,5284721
zapB_predicted,0.08333333333333333,11,11,GGTCTGACGCGCCGAGGCTC,0,5267614
zapB_predicted,0.08333333333333333,11,11,GGTATCCCGGTGACACTATG,0,5276474
zapB_predicted,0.08333333333333333,11,11,GGTAGTGTACCTTTGGAAAC,0,5269643
zapB_predicted,0.08333333333333333,11,11,GGTAGGAGCGCAGATCGGGG,0,5282686
zapB_predicted,0.08333333333333333,11,11,GGTAAGACGGAGGCGGGGCA,0,5266588
zapB_predicted,0.08333333333333333,11,11,GGGCTGCTTTATACAAAGGT,0,5284057
zapB_predicted,0.08333333333333333,11,11,GGGCTCGGATAGCAGCAAGT,0,5275519
zapB_predicted,0.08333333333333333,11,11,GGGCGCTCCATGCATGATCA,0,5275151
zapB_predicted,0.08333333333333333,11,11,GGGCAGAGCTCCCGCTGGCC,0,5285623
zapB_predicted,0.08333333333333333,11,11,GGCCAACCCAAGTTTGCAAC,0,5285469
zapB_predicted,0.08333333333333333,11,11,GGCAATCTATTCGAATTGGC,0,5276033
zapB_predicted,0.08333333333333333,11,11,GGAGTGTCATCTCTATGAAC,0,5274413
zapB_predicted,0.08333333333333333,11,11,GGAGTAAGCTATCCCCGACC,0,5269712
zapB_predicted,0.08333333333333333,11,11,GCTTAAATGTGACGACAGGT,0,5268569
zapB_predicted,0.08333333333333333,11,11,GCTCGAAGAAGTGCATTCCT,0,5267394
zapB_predicted,0.08333333333333333,11,11,GCGGCTAAGTTACGACGGGG,0,5267817
zapB_predicted,0.08333333333333333,11,11,GCGGACTTGTGGTGCCTTAC,0,5282345
zapB_predicted,0.08333333333333333,11,11,GCCGTGTCGTCCAGTTGTGA,0,5267353
zapB_predicted,0.08333333333333333,11,11,GCCCAATGACAGTCTCGTCT,0,5266561
zapB_predicted,0.08333333333333333,11,11,GCATTTTATTGCGATTGCAA,0,5267905
zapB_predicted,0.08333333333333333,11,11,GCATTTAGATGCGCCCTGCC,0,5266704
zapB_predicted,0.08333333333333333,11,11,GCAGGTAGTGATGGCTTAAT,0,5263403
zapB_predicted,0.08333333333333333,11,11,GATTTATCAATATTCAGAAC,0,5274022
zapB_predicted,0.08333333333333333,11,11,GATTGACGCAGCGTGATCAA,0,5273828
zapB_predicted,0.08333333333333333,11,11,GATGGTGGCTAAAGTCGCGC,0,5275695
zapB_predicted,0.08333333333333333,11,11,GATCGGCGAATGGTCTCGGA,0,5267890
zapB_predicted,0.08333333333333333,11,11,GATCAGAAGGAATGGGGGAG,0,5272391
zapB_predicted,0.08333333333333333,11,11,GATATATATAATACGGCTAC,0,5270336
zapB_predicted,0.08333333333333333,11,11,GATAAAGCGTAGTCAAGCGT,0,5278387
zapB_predicted,0.08333333333333333,11,11,GAGGACGGGGTCAATGCCAC,0,5268935
zapB_predicted,0.08333333333333333,11,11,GAGGACAGAATTGACCAGTA,0,5273094
zapB_predicted,0.08333333333333333,11,11,GAGGAACTTGCGGACACAGC,0,5282800
zapB_predicted,0.08333333333333333,11,11,GACCGTCTCCCCGGATGACA,0,5267916
zapB_predicted,0.08333333333333333,11,11,GACATAGACACTGACTTGTG,0,5275736
zapB_predicted,0.08333333333333333,11,11,GACACCTGCCCTTCTTAGGT,0,5265858
zapB_predicted,0.08333333333333333,11,11,GAATGCCGAACTACTGACCG,0,5280915
zapB_predicted,0.08333333333333333,11,11,GAATGAACCATGACCGCTAG,0,5267195
zapB_predicted,0.08333333333333333,11,11,GAATAAGTACAGTCATACGC,0,5271728
zapB_predicted,0.08333333333333333,11,11,GAACCGCGGATTCCTCAAAG,0,5281347
zapB_predicted,0.08333333333333333,11,11,CTTTAAGACCAAATATTATA,0,5279285
zapB_predicted,0.08333333333333333,11,11,CTTAGCCGCAGGTCACTGGG,0,5286190
zapB_predicted,0.08333333333333333,11,11,CTGTGCGATGCGGGTGCGCT,0,5278987
zapB_predicted,0.08333333333333333,11,11,CTGGTACAGCACGGAGCACG,0,5280379
zapB_predicted,0.08333333333333333,11,11,CTGACACTATAACGAAAGTC,0,5263248
zapB_predicted,0.08333333333333333,11,11,CTCGTAGTGGATCACATATC,0,5287138
zapB_predicted,0.08333333333333333,11,11,CTCGCGGATTCTTTTACTCC,0,5272508
zapB_predicted,0.08333333333333333,11,11,CTCCTAGCTAATTGGGCTCG,0,5267943
zapB_predicted,0.08333333333333333,11,11,CTCATGTAGGAATCGGGCCA,0,5274820
zapB_predicted,0.08333333333333333,11,11,CTCACGAAGTTGAGTACGGT,0,5272815
zapB_predicted,0.08333333333333333,11,11,CTAGCCTGGCACCAGGTCTA,0,5273699
zapB_predicted,0.08333333333333333,11,11,CTACGAGAGATTTTTCTTGG,0,5278471
zapB_predicted,0.08333333333333333,11,11,CTAAGTTGCGTAAATAATTA,0,5269699
zapB_predicted,0.08333333333333333,11,11,CTAAACTGCTCACACTGTAT,0,5274047
zapB_predicted,0.08333333333333333,11,11,CGTGTCGTGACTCCCCAAAG,0,5275179
zapB_predicted,0.08333333333333333,11,11,CGTGTCATGCCGGCTCGCTA,0,5270862
zapB_predicted,0.08333333333333333,11,11,CGTGGTAACCATTGGTTGTA,0,5277774
zapB_predicted,0.08333333333333333,11,11,CGTGCTCCAACCAGAAGGAC,0,5269201
zapB_predicted,0.08333333333333333,11,11,CGTCTATCGTACGAATGAGC,0,5263438
zapB_predicted,0.08333333333333333,11,11,CGTCCTCAATAGTGGTCGTC,0,5273555
zapB_predicted,0.08333333333333333,11,11,CGTAAGGTTTCGATCAAGTC,0,5263143
zapB_predicted,0.08333333333333333,11,11,CGGGTCCCATGCTGTGTAAT,0,5270776
zapB_predicted,0.08333333333333333,11,11,CGGGGCACGCGGTAAGGTCT,0,5273411
zapB_predicted,0.08333333333333333,11,11,CGGCGGCATGCGTCAGAAAA,0,5275829
zapB_predicted,0.08333333333333333,11,11,CGCGTACGGGGGTTGATCTA,0,5286480
zapB_predicted,0.08333333333333333,11,11,CGCCAGAATTAAAAATGCAA,0,5277893
zapB_predicted,0.08333333333333333,11,11,CGAGTTGTCTTTGCTTGAAG,0,5279522
zapB_predicted,0.08333333333333333,11,11,CGAACGGACTGCTTTGGGTA,0,5270046
zapB_predicted,0.08333333333333333,11,11,CCTGTTGATGGGTTCGAAAA,0,5286098
zapB_predicted,0.08333333333333333,11,11,CCTCGGGGGAGTCGTCTAAG,0,5264475
zapB_predicted,0.08333333333333333,11,11,CCTATAGGGGGCGTGGATCT,0,5282300
zapB_predicted,0.08333333333333333,11,11,CCTACCCCAAGTCCGGATAG,0,5281584
zapB_predicted,0.08333333333333333,11,11,CCGTGGACTTAAATGTTTGG,0,5269327
zapB_predicted,0.08333333333333333,11,11,CCGCTCGGCGCCACCCGGCG,0,5277639
zapB_predicted,0.08333333333333333,11,11,CCGAAGGTCCCGATCAGGCT,0,5286637
zapB_predicted,0.08333333333333333,11,11,CCCTTTAGATGAGTGATTGG,0,5267915
zapB_predicted,0.08333333333333333,11,11,CCCTGGTTAGCGCTCAGCAA,0,5285971
zapB_predicted,0.08333333333333333,11,11,CCCTCCCGTTCGTCCGCTGG,0,5287189
zapB_predicted,0.08333333333333333,11,11,CCCACATAATGCTTCCGGGA,0,5278986
zapB_predicted,0.08333333333333333,11,11,CCCAACAGGTTACAAGAAGA,0,5285094
zapB_predicted,0.08333333333333333,11,11,CCATTACCTTGGTGCTTGTT,0,5267631
zapB_predicted,0.08333333333333333,11,11,CCATCGGTCGTTTCACCAGT,0,5280207
zapB_predicted,0.08333333333333333,11,11,CCATATTCCGACACAGGTGG,0,5265248
zapB_predicted,0.08333333333333333,11,11,CCAGGCACGCAGACATATAA,0,5263977
zapB_predicted,0.08333333333333333,11,11,CCAGAATATGCGAGAAGTTT,0,5272135
zapB_predicted,0.08333333333333333,11,11,CATGCCACCCACATTCAGAT,0,5283566
zapB_predicted,0.08333333333333333,11,11,CATCGACGGATTAGTTGAGC,0,5267667
zapB_predicted,0.08333333333333333,11,11,CATCAATCAAAATGGTCTTG,0,5271707
zapB_predicted,0.08333333333333333,11,11,CAGTCATAGCAGCTTGTGTG,0,5275434
zapB_predicted,0.08333333333333333,11,11,CAGGCCACCGCGCTTCGGGA,0,5273316
zapB_predicted,0.08333333333333333,11,11,CAGATATGCTTTTGAGCAGA,0,5275633
zapB_predicted,0.08333333333333333,11,11,CACTCGCGCGTATGTCGTCT,0,5284958
zapB_predicted,0.08333333333333333,11,11,CACGCGATTTTTTGTGTTTC,0,5272835
zapB_predicted,0.08333333333333333,11,11,CACAGATTGTTGTCCCAATT,0,5282326
zapB_predicted,0.08333333333333333,11,11,CACAACTCATATGCCCTTGT,0,5283493
zapB_predicted,0.08333333333333333,11,11,CACAACACTGTGAGTTGAAC,0,5268664
zapB_predicted,0.08333333333333333,11,11,ATTGACTCGCGGAGTTGAAC,0,5271260
zapB_predicted,0.08333333333333333,11,11,ATTCGGCATAATATCTTCGC,0,5272760
zapB_predicted,0.08333333333333333,11,11,ATTCGATGCTAAAAGCGAAA,0,5265975
zapB_predicted,0.08333333333333333,11,11,ATTCCCGAGGGCGCATCAGC,0,5277594
zapB_predicted,0.08333333333333333,11,11,ATGGTTTAGTAGCGGGAAAG,0,5275259
zapB_predicted,0.08333333333333333,11,11,ATGCGCGCATTTTTGATCAT,0,5280149
zapB_predicted,0.08333333333333333,11,11,ATGACTGCGGAGAGCCATCT,0,5283610
zapB_predicted,0.08333333333333333,11,11,ATGACGTGTGGTATGTTCGT,0,5279874
zapB_predicted,0.08333333333333333,11,11,ATCTTTTGTCACCTGAGTGA,0,5267331
zapB_predicted,0.08333333333333333,11,11,ATCTCCCGAATAAACCGCAG,0,5285563
zapB_predicted,0.08333333333333333,11,11,ATCCCGCGTTTCGGAAAGCA,0,5272107
zapB_predicted,0.08333333333333333,11,11,ATCCACGTAGAGGAGTAAAC,0,5275416
zapB_predicted,0.08333333333333333,11,11,ATCAGTAGCCCCCACGCCCC,0,5272150
zapB_predicted,0.08333333333333333,11,11,ATATTACGCTGGCGGTCCCA,0,5277250
zapB_predicted,0.08333333333333333,11,11,ATATAGCTGATCGTTTGCTA,0,5274889
zapB_predicted,0.08333333333333333,11,11,ATAAAAAGCGAGCCTATCAG,0,5265743
zapB_predicted,0.08333333333333333,11,11,AGTTCTACATACTGCGTCGT,0,5267887
zapB_predicted,0.08333333333333333,11,11,AGTCGTGCTCTACACACGGT,0,5279582
zapB_predicted,0.08333333333333333,11,11,AGTATTAATCTGGTTTCGCA,0,5276552
zapB_predicted,0.08333333333333333,11,11,AGTAAGTCGGCCTGCTGTTG,0,5268691
zapB_predicted,0.08333333333333333,11,11,AGGTTTTCTTCTAGCTGCTT,0,5269648
zapB_predicted,0.08333333333333333,11,11,AGGTAGACTTGATGACCCTC,0,5274761
zapB_predicted,0.08333333333333333,11,11,AGGGTAAGTATGTTTGGAGT,0,5269752
zapB_predicted,0.08333333333333333,11,11,AGGGCCGTCTGTCCTAAGTC,0,5265820
zapB_predicted,0.08333333333333333,11,11,AGGCGGTTCGAACCGGTTAC,0,5274082
zapB_predicted,0.08333333333333333,11,11,AGGATACCGCGCGCAGACCT,0,5276935
zapB_predicted,0.08333333333333333,11,11,AGGAGATTCGTGACTCAATT,0,5279064
zapB_predicted,0.08333333333333333,11,11,AGGAGAATGGAAAGATGGTG,0,5274597
zapB_predicted,0.08333333333333333,11,11,AGCCTTATTCCGCACCAAGG,0,5268615
zapB_predicted,0.08333333333333333,11,11,AGCCGTCGCGTTAAAACCTA,0,5264995
zapB_predicted,0.08333333333333333,11,11,AGCAACGCACGCATCCGGGC,0,5265980
zapB_predicted,0.08333333333333333,11,11,AGATTGCTTGATGACCCCTA,0,5274086
zapB_predicted,0.08333333333333333,11,11,AGAGTAGCTTGGTTGTCGGA,0,5274640
zapB_predicted,0.08333333333333333,11,11,AGAGGCAGAGTGAAGGTTAG,0,5279936
zapB_predicted,0.08333333333333333,11,11,ACTTTTACAGCATCGATGCA,0,5270641
zapB_predicted,0.08333333333333333,11,11,ACTTACTGGGAGAACAGTTA,0,5285607
zapB_predicted,0.08333333333333333,11,11,ACTGGTGGGAAGGAGGGATC,0,5284276
zapB_predicted,0.08333333333333333,11,11,ACTGGCCACTACCCAGTATA,0,5279570
zapB_predicted,0.08333333333333333,11,11,ACGTAATAACCTTACCCGTC,0,5282134
zapB_predicted,0.08333333333333333,11,11,ACGGAGCCGCTAGTACCTAT,0,5279964
zapB_predicted,0.08333333333333333,11,11,ACGCTCATCCCACGGTGTAA,0,5266062
zapB_predicted,0.08333333333333333,11,11,ACGCGTTACCGGAAGGGAAA,0,5273906
zapB_predicted,0.08333333333333333,11,11,ACGCCAACCTACCACTGTAT,0,5279475
zapB_predicted,0.08333333333333333,11,11,ACGAGCACATGCCCAACCCT,0,5282308
zapB_predicted,0.08333333333333333,11,11,ACCTGCGCACGGGAGCGGGT,0,5288325
zapB_predicted,0.08333333333333333,11,11,ACCTCCGGGAGAAGCGTCTG,0,5266942
zapB_predicted,0.08333333333333333,11,11,ACCTATGCATGGCCAGTCAC,0,5284968
zapB_predicted,0.08333333333333333,11,11,ACACTGGCTGGAAGTCCGCG,0,5272621
zapB_predicted,0.08333333333333333,11,11,ACACCCGCAGGCGCTCTCTT,0,5268659
zapB_predicted,0.08333333333333333,11,11,AATTAAACCCGAGATTAAAT,0,5277914
zapB_predicted,0.08333333333333333,11,11,AATGTGTTAAATGGCCCTAA,0,5264190
zapB_predicted,0.08333333333333333,11,11,AATGGGCCAGGGGCGCTGCA,0,5272658
zapB_predicted,0.08333333333333333,11,11,AATGCGGTGCTGCCCCGAGG,0,5267039
zapB_predicted,0.08333333333333333,11,11,AATGAAATCGGCGTAGGTGA,0,5281542
zapB_predicted,0.08333333333333333,11,11,AATCGTTTTTTTATGACCGC,0,5275249
zapB_predicted,0.08333333333333333,11,11,AATCGGGCTAACCACCCTTT,0,5285931
zapB_predicted,0.08333333333333333,11,11,AATCACGGAACTCCAGACAC,0,5266369
zapB_predicted,0.08333333333333333,11,11,AATAAATTAGGTGCCCGATG,0,5267941
zapB_predicted,0.08333333333333333,11,11,AAGCGCGAGGCGAAACATTG,0,5275465
zapB_predicted,0.08333333333333333,11,11,AACTTTGAAACTGATAGCCG,0,5266419
zapB_predicted,0.08333333333333333,11,11,AACCTTAATATCATGTCATA,0,5288168
zapB_predicted,0.08333333333333333,11,11,AACCGAGGTAATTTTCTGCC,0,5270895
zapB_predicted,0.08333333333333333,11,11,AAATTAGCTTCGGTGTAGAC,0,5273092
zapB_predicted,0.09090909090909091,10,10,TTTTAGTCCTTTGTCTGTCG,0,5284619
zapB_predicted,0.09090909090909091,10,10,TTTCATAGATAATGACTCGT,0,5269793
zapB_predicted,0.09090909090909091,10,10,TTTATATCCTATTCGATACT,0,5280578
zapB_predicted,0.09090909090909091,10,10,TTTAGCGGGGTCCGTGAACC,0,5268904
zapB_predicted,0.09090909090909091,10,10,TTGTTTCGGTGGTCGAAGCC,0,5279765
zapB_predicted,0.09090909090909091,10,10,TTGTCCTGGTCACTGGGTCT,0,5285111
zapB_predicted,0.09090909090909091,10,10,TTGCACATCAGGGGGCATCG,0,5275107
zapB_predicted,0.09090909090909091,10,10,TTGAAGGGACAATAATCTGG,0,5273831
zapB_predicted,0.09090909090909091,10,10,TTGAAAGATTCTAGAGCGCT,0,5269948
zapB_predicted,0.09090909090909091,10,10,TTCTTGTAAGTATACTATCT,0,5275776
zapB_predicted,0.09090909090909091,10,10,TTCTTGGGCCAATAAGACAT,0,5274209
zapB_predicted,0.09090909090909091,10,10,TTCTTCCGAATCTAATCACA,0,5284456
zapB_predicted,0.09090909090909091,10,10,TTCGAATGATGCTGGCGGCT,0,5276350
zapB_predicted,0.09090909090909091,10,10,TTCCAATGCACGTTACCGGG,0,5267115
zapB_predicted,0.09090909090909091,10,10,TTACTGCCTGCCCGCACGTA,0,5274192
zapB_predicted,0.09090909090909091,10,10,TTACGACCCTTCGTCTTATA,0,5283143
zapB_predicted,0.09090909090909091,10,10,TGTCTAACAGTTATTTTCTA,0,5268428
zapB_predicted,0.09090909090909091,10,10,TGTCATTCTACACAGATATT,0,5281742
zapB_predicted,0.09090909090909091,10,10,TGGTTTGAGTCTCTTGGCAT,0,5265342
zapB_predicted,0.09090909090909091,10,10,TGGTGGCCCGTGCTCATGGT,0,5279992
zapB_predicted,0.09090909090909091,10,10,TGGTCGATTGTGCACGATTG,0,5265418
zapB_predicted,0.09090909090909091,10,10,TGGCGTGAGAATGTAGATGG,0,5280184
zapB_predicted,0.09090909090909091,10,10,TGGCCGGCAGGTTCAGCTGG,0,5270279
zapB_predicted,0.09090909090909091,10,10,TGGCCGATTCTAGCGGAACT,0,5269314
zapB_predicted,0.09090909090909091,10,10,TGGATTGAAGCGGGGTGCAG,0,5274817
zapB_predicted,0.09090909090909091,10,10,TGCAGGCTGCTCAGGTCAAT,0,5285402
zapB_predicted,0.09090909090909091,10,10,TGCACCATTTGTCGGTTGTA,0,5276146
zapB_predicted,0.09090909090909091,10,10,TGATCGCGCTCGATGTGTCA,0,5273909
zapB_predicted,0.09090909090909091,10,10,TGATAACTGGATTTGGTAAG,0,5270003
zapB_predicted,0.09090909090909091,10,10,TGAGCTCGTCTTGAACAGGC,0,5275938
zapB_predicted,0.09090909090909091,10,10,TGAGCAGATGCTTCCTTGAC,0,5265382
zapB_predicted,0.09090909090909091,10,10,TGAGACGATGGGTGGAACCG,0,5280881
zapB_predicted,0.09090909090909091,10,10,TGAAGAATAGCGAATCAGTT,0,5280579
zapB_predicted,0.09090909090909091,10,10,TGAACCAAAGCCCCCAGTGA,0,5263313
zapB_predicted,0.09090909090909091,10,10,TCTACGGGCTATGACAGTCG,0,5271487
zapB_predicted,0.09090909090909091,10,10,TCGGAGCCCTTTCTTCTTTA,0,5280355
zapB_predicted,0.09090909090909091,10,10,TCGGAAGCACACTTAGCAAT,0,5265009
zapB_predicted,0.09090909090909091,10,10,TCGCGTTCCCGGTGGTGATC,0,5267711
zapB_predicted,0.09090909090909091,10,10,TCCGGTAAGTAGTCCCCTCA,0,5284356
zapB_predicted,0.09090909090909091,10,10,TCCGAGTTCTCTCAAACTGA,0,5266566
zapB_predicted,0.09090909090909091,10,10,TCCCGTAAGACCTCGTGCCG,0,5283639
zapB_predicted,0.09090909090909091,10,10,TCAGGTCCTGAGTTGACCGT,0,5273273
zapB_predicted,0.09090909090909091,10,10,TATTCCCTTGGGCAGTACCC,0,5270995
zapB_predicted,0.09090909090909091,10,10,TATGGCTGAAACGTATCAGA,0,5282763
zapB_predicted,0.09090909090909091,10,10,TATGAGTAGCATGACTTGGA,0,5272268
zapB_predicted,0.09090909090909091,10,10,TATGAGGTTATAAAGGACAT,0,5271659
zapB_predicted,0.09090909090909091,10,10,TATCTATGATTTTAAACGCA,0,5266229
zapB_predicted,0.09090909090909091,10,10,TATAAGGCATGCGCCGAGTG,0,5267063
zapB_predicted,0.09090909090909091,10,10,TAGCTGTAAATAAGCCTATA,0,5264233
zapB_predicted,0.09090909090909091,10,10,TAGCAAGAGACTATTATGCG,0,5268245
zapB_predicted,0.09090909090909091,10,10,TACTATGCATCGTTAGGTCA,0,5265087
zapB_predicted,0.09090909090909091,10,10,TACGCACGAGGCCCGTGGGG,0,5268450
zapB_predicted,0.09090909090909091,10,10,TACAGGTTCCAAATAGGCAT,0,5282522
zapB_predicted,0.09090909090909091,10,10,TAAGGGAGTACTTGTATTCT,0,5273626
zapB_predicted,0.09090909090909091,10,10,TAACATCGCGTAAAAAATAT,0,5282350
zapB_predicted,0.09090909090909091,10,10,GTTTTCGGCGCATATTGGTT,0,5272282
zapB_predicted,0.09090909090909091,10,10,GTTTCCCGTGCCAGGAATGA,0,5270982
zapB_predicted,0.09090909090909091,10,10,GTTGCGGAGGGAATGTCTCT,0,5266054
zapB_predicted,0.09090909090909091,10,10,GTTGCCTGTCTGTCTACCGT,0,5266085
zapB_predicted,0.09090909090909091,10,10,GTTACGTATGTCTAACGGCG,0,5281510
zapB_predicted,0.09090909090909091,10,10,GTGTAATTTATCGCGCTCAA,0,5279126
zapB_predicted,0.09090909090909091,10,10,GTGGCTGGGGCTTAGTAGCC,0,5271454
zapB_predicted,0.09090909090909091,10,10,GTGGCTGATCGTCTAATAGA,0,5284122
zapB_predicted,0.09090909090909091,10,10,GTGGATAAGGGCGAGTGCAG,0,5281777
zapB_predicted,0.09090909090909091,10,10,GTGCTCCTAAGTTCTTCAGA,0,5274909
zapB_predicted,0.09090909090909091,10,10,GTGCGGTGAGGGGCTTTAAA,0,5278888
zapB_predicted,0.09090909090909091,10,10,GTGATCAGAACCTGGAATGT,0,5266549
zapB_predicted,0.09090909090909091,10,10,GTGACCCAATAGGTACATTA,0,5272764
zapB_predicted,0.09090909090909091,10,10,GTGAAAATTATGAGTACCAT,0,5283427
zapB_predicted,0.09090909090909091,10,10,GTCTGGTTAATCGTAATTCA,0,5275643
zapB_predicted,0.09090909090909091,10,10,GTCTGGCTTAGGGACTGCGG,0,5275743
zapB_predicted,0.09090909090909091,10,10,GTCTGGACTGGGGTCAAGGG,0,5274840
zapB_predicted,0.09090909090909091,10,10,GTCGTGACGTGGGACTTTTT,0,5287572
zapB_predicted,0.09090909090909091,10,10,GTACGACCGCCAAAACTCCA,0,5288036
zapB_predicted,0.09090909090909091,10,10,GTACAGCGATCTAGGAATGT,0,5282960
zapB_predicted,0.09090909090909091,10,10,GTAACATTGTGGGGACAAGC,0,5276856
zapB_predicted,0.09090909090909091,10,10,GGTTTGGCGCTTTCGCTCTT,0,5266210
zapB_predicted,0.09090909090909091,10,10,GGTGTTGTTTGTTCCTTCAC,0,5278575
zapB_predicted,0.09090909090909091,10,10,GGTGAGGGGAGCCTAATCCT,0,5284202
zapB_predicted,0.09090909090909091,10,10,GGTCCATTGTATGTATTTAT,0,5273781
zapB_predicted,0.09090909090909091,10,10,GGGTGCTGATTGTGGACAGG,0,5271862
zapB_predicted,0.09090909090909091,10,10,GGGTAATTATCTTGCAGTAT,0,5286431
zapB_predicted,0.09090909090909091,10,10,GGGCGCGCACCATCAATGAC,0,5275963
zapB_predicted,0.09090909090909091,10,10,GGCGGATTCTGGCTATCTTG,0,5282446
zapB_predicted,0.09090909090909091,10,10,GGCCCCAAACTGGCACCACG,0,5272951
zapB_predicted,0.09090909090909091,10,10,GGATAGCCCGGTGGTTTAAG,0,5274810
zapB_predicted,0.09090909090909091,10,10,GCTTGCACTTTGAGATCCAT,0,5265349
zapB_predicted,0.09090909090909091,10,10,GCTGTCAGCATACTTTTTAT,0,5278026
zapB_predicted,0.09090909090909091,10,10,GCTGGTCAACCGAGGCCAGA,0,5274391
zapB_predicted,0.09090909090909091,10,10,GCTGGGATTACTCAGCTGCA,0,5267772
zapB_predicted,0.09090909090909091,10,10,GCTGGATGTAGTAGTTGTTC,0,5273270
zapB_predicted,0.09090909090909091,10,10,GCTGAATAGGCTCCCGCATC,0,5267414
zapB_predicted,0.09090909090909091,10,10,GCTAAATCCGGGAGTTTTGG,0,5276686
zapB_predicted,0.09090909090909091,10,10,GCGTACTCTTTGCTGCTCAC,0,5283878
zapB_predicted,0.09090909090909091,10,10,GCGTAATATGTAAGGGTGGA,0,5275392
zapB_predicted,0.09090909090909091,10,10,GCGGTACAACGAGTAATTGG,0,5276655
zapB_predicted,0.09090909090909091,10,10,GCGGGTGGACCAGAAGGCAG,0,5284941
zapB_predicted,0.09090909090909091,10,10,GCGGGTGATAGCTACGACCG,0,5275025
zapB_predicted,0.09090909090909091,10,10,GCGGAGGGGACTCGCCGGTT,0,5283448
zapB_predicted,0.09090909090909091,10,10,GCGCCCGCTGAGCAGTTCGT,0,5281280
zapB_predicted,0.09090909090909091,10,10,GCCGCATTTCATATAATGTA,0,5267082
zapB_predicted,0.09090909090909091,10,10,GCCAATATCCAGAGTATAAG,0,5286689
zapB_predicted,0.09090909090909091,10,10,GCATTTGGGCACGCTATATC,0,5286827
zapB_predicted,0.09090909090909091,10,10,GCAGTCCGTAAAAGGTTATT,0,5273832
zapB_predicted,0.09090909090909091,10,10,GCAGACACTCGCGTTTTGAT,0,5266152
zapB_predicted,0.09090909090909091,10,10,GCACAGGGGATTACCGCCGC,0,5278158
zapB_predicted,0.09090909090909091,10,10,GATTGTGGGCTTTAGGGTTG,0,5275173
zapB_predicted,0.09090909090909091,10,10,GATGACCAGTAATGATAAAC,0,5274342
zapB_predicted,0.09090909090909091,10,10,GATATAAGGGTACCGCTAGG,0,5278893
zapB_predicted,0.09090909090909091,10,10,GAGGGTGGATGACTGGTTTT,0,5269354
zapB_predicted,0.09090909090909091,10,10,GAGGATCTACCATGGCACTT,0,5278856
zapB_predicted,0.09090909090909091,10,10,GAGCCGAACAGAGGGCCTCA,0,5273243
zapB_predicted,0.09090909090909091,10,10,GAGCCAACTTGGTGCCGAGT,0,5284350
zapB_predicted,0.09090909090909091,10,10,GAGCAGCTAAAAACGGGATA,0,5267413
zapB_predicted,0.09090909090909091,10,10,GAGATTATCAAACATTTGAG,0,5282979
zapB_predicted,0.09090909090909091,10,10,GACCGATCAATGCCTGCTCA,0,5280171
zapB_predicted,0.09090909090909091,10,10,GACCAACGGTGATTTATCCG,0,5285163
zapB_predicted,0.09090909090909091,10,10,GACAGCTAGTAATGTCGAGC,0,5280162
zapB_predicted,0.09090909090909091,10,10,GACAAGGCGGGTGGGCTAAG,0,5263305
zapB_predicted,0.09090909090909091,10,10,GAAAGATGTGCATCATCAAT,0,5282664
zapB_predicted,0.09090909090909091,10,10,GAAAAGAAGCGTAATGGTGT,0,5272405
zapB_predicted,0.09090909090909091,10,10,CTTTAGGGACCGTTGTCACC,0,5271089
zapB_predicted,0.09090909090909091,10,10,CTTTAACTTTTGTGTGAGTC,0,5286199
zapB_predicted,0.09090909090909091,10,10,CTTGTATGTCAATCATGCTT,0,5280346
zapB_predicted,0.09090909090909091,10,10,CTTGAGTGGTGATCTCATGA,0,5274211
zapB_predicted,0.09090909090909091,10,10,CTTCGCGGGAAACCCTCGCA,0,5263302
zapB_predicted,0.09090909090909091,10,10,CTTACGTCTCAAATGTTCGA,0,5284215
zapB_predicted,0.09090909090909091,10,10,CTTACCACTTGGATATTAGA,0,5263083
zapB_predicted,0.09090909090909091,10,10,CTTAATGGGACGCCAATCGA,0,5276557
zapB_predicted,0.09090909090909091,10,10,CTGTTGTAACAAGTCTACGA,0,5274839
zapB_predicted,0.09090909090909091,10,10,CTGGGCAGCGCCGGGTGTAA,0,5278741
zapB_predicted,0.09090909090909091,10,10,CTGCTCAGGAGTCAATGTGG,0,5284479
zapB_predicted,0.09090909090909091,10,10,CTGCGTTACAAAAATCCACA,0,5273513
zapB_predicted,0.09090909090909091,10,10,CTGCCTGGTCAAGCCGGCTA,0,5270631
zapB_predicted,0.09090909090909091,10,10,CTGAAATAATCAAAGTAGCG,0,5284793
zapB_predicted,0.09090909090909091,10,10,CTCGCTGTCAAGCGTCCACA,0,5277764
zapB_predicted,0.09090909090909091,10,10,CTCCGAGGGGGTGATCTGAG,0,5271931
zapB_predicted,0.09090909090909091,10,10,CTCATTCGCAAGGTGAGCAG,0,5267536
zapB_predicted,0.09090909090909091,10,10,CTCAGCAGCATAGAACGATA,0,5278873
zapB_predicted,0.09090909090909091,10,10,CTCAACTCGAGCCTACAGGA,0,5283384
zapB_predicted,0.09090909090909091,10,10,CTCAACCTAATACGGTCCAA,0,5278993
zapB_predicted,0.09090909090909091,10,10,CTATAGACATTACGTATTAT,0,5276002
zapB_predicted,0.09090909090909091,10,10,CTAACGCCAAATTTTGTCTC,0,5288326
zapB_predicted,0.09090909090909091,10,10,CTAACATTCACTGTAATCGA,0,5280599
zapB_predicted,0.09090909090909091,10,10,CGTTCATACTTCTGAAAGAG,0,5268025
zapB_predicted,0.09090909090909091,10,10,CGTTATTCACAAATTACGGG,0,5269897
zapB_predicted,0.09090909090909091,10,10,CGTCTTAAAGTTGTACAGGA,0,5282519
zapB_predicted,0.09090909090909091,10,10,CGTATCCGTTAAGGCTATGG,0,5267277
zapB_predicted,0.09090909090909091,10,10,CGTATAGCTATTCGTTCAGA,0,5285026
zapB_predicted,0.09090909090909091,10,10,CGGTAGCTGCATACTCGATG,0,5277786
zapB_predicted,0.09090909090909091,10,10,CGGGGCGGGCATGACGTTTT,0,5273652
zapB_predicted,0.09090909090909091,10,10,CGGGCTCCTCTAGATGTCTG,0,5284990
zapB_predicted,0.09090909090909091,10,10,CGGCTAAAAGATCGTCGTGT,0,5269941
zapB_predicted,0.09090909090909091,10,10,CGGCGAAGTGCGGGGTTGAT,0,5287142
zapB_predicted,0.09090909090909091,10,10,CGGCAAATTGTGTCGTGCCG,0,5270000
zapB_predicted,0.09090909090909091,10,10,CGGAATTTGATGGGTGCTCC,0,5285158
zapB_predicted,0.09090909090909091,10,10,CGAGGGACTGGTTAACTTAG,0,5286702
zapB_predicted,0.09090909090909091,10,10,CGAGGACGGACCCTAGGTGA,0,5276659
zapB_predicted,0.09090909090909091,10,10,CGACCACGGGCTCCAAAGGA,0,5282396
zapB_predicted,0.09090909090909091,10,10,CGAATTGCACTATGATAATG,0,5274371
zapB_predicted,0.09090909090909091,10,10,CGAACTGCTTGCTTGGGGAA,0,5280295
zapB_predicted,0.09090909090909091,10,10,CCTGCCCTCTAAAATAAGTA,0,5267407
zapB_predicted,0.09090909090909091,10,10,CCTCGTTAAGGAAACTGTGG,0,5279727
zapB_predicted,0.09090909090909091,10,10,CCGTCTATTCCCTTATGGCA,0,5277690
zapB_predicted,0.09090909090909091,10,10,CCGTATCCTGCCTACTGTTG,0,5278934
zapB_predicted,0.09090909090909091,10,10,CCGGCACTTCTAAATTTTAA,0,5270393
zapB_predicted,0.09090909090909091,10,10,CCGCTCGCTAGAGCTAATCT,0,5269522
zapB_predicted,0.09090909090909091,10,10,CCCTCGACCTCCTGGCGTAT,0,5279465
zapB_predicted,0.09090909090909091,10,10,CCCGTCACATCCGGGGGGAG,0,5269988
zapB_predicted,0.09090909090909091,10,10,CCCCTAGTCTGTTGAAATTG,0,5268359
zapB_predicted,0.09090909090909091,10,10,CCCCCGACCGATAATTAGAG,0,5277947
zapB_predicted,0.09090909090909091,10,10,CCCAGTGCGAGACCACGCGG,0,5264463
zapB_predicted,0.09090909090909091,10,10,CCCAGGTAAGTCATTTAAGC,0,5287804
zapB_predicted,0.09090909090909091,10,10,CCACGGACCGACGAATGAAG,0,5278308
zapB_predicted,0.09090909090909091,10,10,CCACACGAATCTCATTATAC,0,5282984
zapB_predicted,0.09090909090909091,10,10,CATCGTGGAATAACGCATAC,0,5286743
zapB_predicted,0.09090909090909091,10,10,CATACGTGATAGCTGCTCAA,0,5276706
zapB_predicted,0.09090909090909091,10,10,CAGTTTTTAGACTCGAAAAT,0,5285212
zapB_predicted,0.09090909090909091,10,10,CAGGACGTCAAAGCACTACG,0,5270868
zapB_predicted,0.09090909090909091,10,10,CAGGACATGCATCACAAAAA,0,5283054
zapB_predicted,0.09090909090909091,10,10,CAGATCTACAAAACGCTATT,0,5283273
zapB_predicted,0.09090909090909091,10,10,CAGATAACCTGGAAGTCCTA,0,5281745
zapB_predicted,0.09090909090909091,10,10,CACGCACGTGTTTACGGCGT,0,5282764
zapB_predicted,0.09090909090909091,10,10,CACCTCCTACGCGGACTGCA,0,5279043
zapB_predicted,0.09090909090909091,10,10,CACCTAGATGCCGACATAGG,0,5276218
zapB_predicted,0.09090909090909091,10,10,CACCACATGCCATATATTCC,0,5278210
zapB_predicted,0.09090909090909091,10,10,CAATGTGACGGAACACAGTA,0,5268778
zapB_predicted,0.09090909090909091,10,10,CAATGCCTCGTGTTTCGGAA,0,5265268
zapB_predicted,0.09090909090909091,10,10,CAAGCCGATTGATTTCGGAC,0,5269218
zapB_predicted,0.09090909090909091,10,10,CAACTAAACAAATGATTGTC,0,5282008
zapB_predicted,0.09090909090909091,10,10,CAAACTGTCCGCTGTCCCGC,0,5282294
zapB_predicted,0.09090909090909091,10,10,CAAAATCCGCAAGTCCACGT,0,5266375
zapB_predicted,0.09090909090909091,10,10,ATTTTGTTATAACAGTATGG,0,5284361
zapB_predicted,0.09090909090909091,10,10,ATTGAAACTTGTATACCGTA,0,5270655
zapB_predicted,0.09090909090909091,10,10,ATTCAGTACACAAGTCGCAT,0,5270047
zapB_predicted,0.09090909090909091,10,10,ATTCAGCTGAGCTTCTAAGG,0,5267097
zapB_predicted,0.09090909090909091,10,10,ATTATCTGTCCGGCATCACG,0,5276009
zapB_predicted,0.09090909090909091,10,10,ATGTGGCCAAGAAAATAAAC,0,5280082
zapB_predicted,0.09090909090909091,10,10,ATGCATCCCTGGGAATCGCC,0,5271988
zapB_predicted,0.09090909090909091,10,10,ATGAAGGAGGCCGATGCACG,0,5282760
zapB_predicted,0.09090909090909091,10,10,ATGAAAAACTTGCCCGTCTC,0,5271418
zapB_predicted,0.09090909090909091,10,10,ATCTACTTTGCTCAAGTCTG,0,5264160
zapB_predicted,0.09090909090909091,10,10,ATCGTGAGTCATAACTTATG,0,5268875
zapB_predicted,0.09090909090909091,10,10,ATCGCGTAAGTGGGACACTT,0,5275150
zapB_predicted,0.09090909090909091,10,10,ATCGCACTGTCTACGTAGCA,0,5286128
zapB_predicted,0.09090909090909091,10,10,ATCCGCACTTCAACAGGAGA,0,5275777
zapB_predicted,0.09090909090909091,10,10,ATCAGTATGAACTACGGAGA,0,5286028
zapB_predicted,0.09090909090909091,10,10,ATCAGGAAAGTGGGATTTGA,0,5268484
zapB_predicted,0.09090909090909091,10,10,ATATCAATTCCTAAGTAGTA,0,5287273
zapB_predicted,0.09090909090909091,10,10,ATATAACAAGCGTTCACACA,0,5265140
zapB_predicted,0.09090909090909091,10,10,ATAGTTGAAGGAGACGCTAG,0,5267576
zapB_predicted,0.09090909090909091,10,10,ATACTCCATAGAGTGGATGG,0,5266967
zapB_predicted,0.09090909090909091,10,10,ATACGTGGGTAACGGAAATT,0,5265272
zapB_predicted,0.09090909090909091,10,10,AGTGGTTGACATGTTTTTTG,0,5287092
zapB_predicted,0.09090909090909091,10,10,AGTCGGTCACTCGGGCTGCC,0,5274481
zapB_predicted,0.09090909090909091,10,10,AGGTCCCTCGGACACATATG,0,5267701
zapB_predicted,0.09090909090909091,10,10,AGGGTTGACGGTATCAGGTA,0,5273257
zapB_predicted,0.09090909090909091,10,10,AGGCTACAAAAATCACGCTA,0,5267586
zapB_predicted,0.09090909090909091,10,10,AGGCCTCAGAATGCTGATAG,0,5278455
zapB_predicted,0.09090909090909091,10,10,AGGCCAGTCGTGCGGCCTTC,0,5281789
zapB_predicted,0.09090909090909091,10,10,AGCTAGGGAAAGGTATTTTG,0,5286280
zapB_predicted,0.09090909090909091,10,10,AGCGGGGAGGTGGTCTTAAC,0,5283756
zapB_predicted,0.09090909090909091,10,10,AGCGGCGGTCGGAAGCAGAT,0,5276436
zapB_predicted,0.09090909090909091,10,10,AGCGCGCGAAAGGGCGCAAC,0,5286813
zapB_predicted,0.09090909090909091,10,10,AGATCACGTCCACTCACATA,0,5268146
zapB_predicted,0.09090909090909091,10,10,AGATCAACACGGTCACAGGC,0,5271807
zapB_predicted,0.09090909090909091,10,10,AGATAAACACCTACGGGGAT,0,5279828
zapB_predicted,0.09090909090909091,10,10,AGAGTTGTTATTTGGATAAC,0,5273908
zapB_predicted,0.09090909090909091,10,10,AGAGTGCGTAAATACTTAAC,0,5276483
zapB_predicted,0.09090909090909091,10,10,AGAGTCCGGGCGCGGCGTTA,0,5287022
zapB_predicted,0.09090909090909091,10,10,ACTAGGGTACGCTGCGTGCC,0,5281917
zapB_predicted,0.09090909090909091,10,10,ACGGGCTCCTTCACTAATAT,0,5284794
zapB_predicted,0.09090909090909091,10,10,ACGGGCGTCATGGCTTAAGG,0,5271648
zapB_predicted,0.09090909090909091,10,10,ACGCCACGTAATAACGCCTG,0,5268443
zapB_predicted,0.09090909090909091,10,10,ACGAGGTGCAGCACAGCGTC,0,5279164
zapB_predicted,0.09090909090909091,10,10,ACCATACCCTCGAGGCTGGA,0,5274796
zapB_predicted,0.09090909090909091,10,10,ACATGCTAGTGCCTGTTTTT,0,5271924
zapB_predicted,0.09090909090909091,10,10,ACACCACACTTGTCTTTTCC,0,5276674
zapB_predicted,0.09090909090909091,10,10,ACAAAACTCAGGGAATGAGC,0,5276038
zapB_predicted,0.09090909090909091,10,10,AATTGGCTTGAGGGTTTAAC,0,5275699
zapB_predicted,0.09090909090909091,10,10,AATTATTCTATTAGTTTTCT,0,5274344
zapB_predicted,0.09090909090909091,10,10,AATTAGTCACGACATATATC,0,5264331
zapB_predicted,0.09090909090909091,10,10,AATGGCCTAATAAGGTCCTA,0,5267256
zapB_predicted,0.09090909090909091,10,10,AATCAAGGACCGGGGGGCTT,0,5286789
zapB_predicted,0.09090909090909091,10,10,AAGTGGCCTCTATCTAAGCC,0,5284173
zapB_predicted,0.09090909090909091,10,10,AAGGTAGAATCGTGACACAG,0,5273834
zapB_predicted,0.09090909090909091,10,10,AAGGGCCGTGGCTCTTCACG,0,5274043
zapB_predicted,0.09090909090909091,10,10,AAGCGTTTCATCTCCAAAGT,0,5270322
zapB_predicted,0.09090909090909091,10,10,AAGCCATTTGAACGTTTCCT,0,5283071
zapB_predicted,0.09090909090909091,10,10,AAGAGCGAATATATGAGTGG,0,5263303
zapB_predicted,0.09090909090909091,10,10,AACTATATCTAGGACACAAG,0,5279168
zapB_predicted,0.09090909090909091,10,10,AACGTGGCTATACTGTATGG,0,5275255
zapB_predicted,0.09090909090909091,10,10,AAATTTAGGGCGTTGTAACC,0,5275979
zapB_predicted,0.09090909090909091,10,10,AAATGCATGAGGCGTAGGAC,0,5267265
zapB_predicted,0.09090909090909091,10,10,AAAGTGTCCCGATACTGCAA,0,5266820
zapB_predicted,0.1,9,9,TTTGTCGCTCTTTCAAGGCA,0,5267020
zapB_predicted,0.1,9,9,TTTATTTTTTCAACAGGGCA,0,5272919
zapB_predicted,0.1,9,9,TTTAGGAGTGGTAGCGGTAA,0,5284624
zapB_predicted,0.1,9,9,TTTACTCGACCAGGCTGGGG,0,5263891
zapB_predicted,0.1,9,9,TTTAAGAATAAAGGAAGTTG,0,5271367
zapB_predicted,0.1,9,9,TTGAAGGCGGGATATAGATA,0,5275683
zapB_predicted,0.1,9,9,TTCTTCGAGTAGGCCACGCT,0,5269880
zapB_predicted,0.1,9,9,TTCGTGTATGCACTCGGAGT,0,5264970
zapB_predicted,0.1,9,9,TTCGAATGGAGATTTGTCAA,0,5268912
zapB_predicted,0.1,9,9,TTCCCGAGCTGTGGACTACG,0,5284487
zapB_predicted,0.1,9,9,TTAGTTTTCCTACCGCACTA,0,5283297
zapB_predicted,0.1,9,9,TTACTGAGCGTCAGCATGTT,0,5280912
zapB_predicted,0.1,9,9,TTACGACGAGAGCAATCCAC,0,5279573
zapB_predicted,0.1,9,9,TGTTGGATGGGGATATTCAG,0,5283841
zapB_predicted,0.1,9,9,TGTGCGAAGTCGTAGACTAT,0,5269142
zapB_predicted,0.1,9,9,TGTAGCGGACCAGGTAAATT,0,5267610
zapB_predicted,0.1,9,9,TGGGCTCTCGAGGCCCCATT,0,5286462
zapB_predicted,0.1,9,9,TGGCCAGACAGTACTAAGTA,0,5266355
zapB_predicted,0.1,9,9,TGGATCGGGCTAAAAAACTA,0,5285010
zapB_predicted,0.1,9,9,TGCCCGGACAATTGAATACA,0,5266637
zapB_predicted,0.1,9,9,TGCCCCTATAGGCCCGGCGA,0,5273015
zapB_predicted,0.1,9,9,TGATTGTAGGGGGGCGCTGG,0,5263338
zapB_predicted,0.1,9,9,TGATGATGAACCGGCGGTTA,0,5266436
zapB_predicted,0.1,9,9,TGATCAATGTCAGTGCATCA,0,5266068
zapB_predicted,0.1,9,9,TCTTCCCATACTGTTGGGAC,0,5284760
zapB_predicted,0.1,9,9,TCTGCACACCCCCCTGTAGG,0,5284908
zapB_predicted,0.1,9,9,TCTAGGCGTCTAGGCGACGG,0,5287525
zapB_predicted,0.1,9,9,TCGTCAAGATAGGCTTAGGA,0,5265205
zapB_predicted,0.1,9,9,TCGTACTGTACCGGAAGATA,0,5266222
zapB_predicted,0.1,9,9,TCGCATCACACGGCTATCCC,0,5272752
zapB_predicted,0.1,9,9,TCCGGATCGTCGGTGTATGG,0,5267067
zapB_predicted,0.1,9,9,TCCGACTTCAGAACGCGATG,0,5268527
zapB_predicted,0.1,9,9,TCCAGCGGCATGAGGCGCTT,0,5284930
zapB_predicted,0.1,9,9,TCCAAGGGCGCCTTCTCGTT,0,5279847
zapB_predicted,0.1,9,9,TCATGCTGGCGAGTAAGATT,0,5283259
zapB_predicted,0.1,9,9,TCATGCGCACGGCGTATAAG,0,5284245
zapB_predicted,0.1,9,9,TCATACGAGTTGCTCGGAAT,0,5287446
zapB_predicted,0.1,9,9,TCAGAGGGCGGAAGAGCATG,0,5268008
zapB_predicted,0.1,9,9,TCACGAAAGAAAGCGCCGTA,0,5272016
zapB_predicted,0.1,9,9,TCAATGGTACGAGGATCGGG,0,5282145
zapB_predicted,0.1,9,9,TATTGCTTGTAAAGTTCTCG,0,5265320
zapB_predicted,0.1,9,9,TATTCGTGAGCGACGAGCGT,0,5287713
zapB_predicted,0.1,9,9,TATCTTGAACTGCGAAACAA,0,5263440
zapB_predicted,0.1,9,9,TATCTCCAACAGATAAAGGC,0,5268372
zapB_predicted,0.1,9,9,TATCGCTTGTTTGGCCGGCT,0,5276196
zapB_predicted,0.1,9,9,TATCCAAGAATTTGGCCCTA,0,5275300
zapB_predicted,0.1,9,9,TATATAGAAGTAAAGCCGGA,0,5275535
zapB_predicted,0.1,9,9,TATACGATTGGCACTTTAAT,0,5286982
zapB_predicted,0.1,9,9,TAGCGAGATGCCGTCGCTTT,0,5271645
zapB_predicted,0.1,9,9,TAGAGCCGTGTAATTGGCAG,0,5263902
zapB_predicted,0.1,9,9,TACGTTTCCGTTCAATACCA,0,5266565
zapB_predicted,0.1,9,9,TACGAGAAGTGGGGGCTACG,0,5264730
zapB_predicted,0.1,9,9,TACATTGACATGAACCGTGC,0,5285400
zapB_predicted,0.1,9,9,TAACGTCCTCAAACAGCGGT,0,5287464
zapB_predicted,0.1,9,9,TAACATTTGCCTGAACGCGT,0,5276349
zapB_predicted,0.1,9,9,GTTTAGTCACCTGAGTTTGT,0,5282932
zapB_predicted,0.1,9,9,GTTGCGCAAAAATCTTGTCG,0,5274982
zapB_predicted,0.1,9,9,GTTGATTGAACTCAGCTAAA,0,5279404
zapB_predicted,0.1,9,9,GTTGATTCGCGAGGTAATGC,0,5272558
zapB_predicted,0.1,9,9,GTTGAATGGTTCAGTTCATA,0,5277251
zapB_predicted,0.1,9,9,GTTCCAGTTGCTCTGACTGG,0,5281044
zapB_predicted,0.1,9,9,GTTCAGTCCGGTTCGACCCC,0,5273060
zapB_predicted,0.1,9,9,GTGGCCCATCTCGTGGTAAT,0,5271898
zapB_predicted,0.1,9,9,GTCTTGGAGGCGTCGGTAAT,0,5279162
zapB_predicted,0.1,9,9,GTCGAGCCGTGCCCGCTGGA,0,5282253
zapB_predicted,0.1,9,9,GTCCTTTCAGCCACAAGCGA,0,5278342
zapB_predicted,0.1,9,9,GTCAAACAGCATACAATGTT,0,5282059
zapB_predicted,0.1,9,9,GTATCCCTGGGGTAGGGACA,0,5274323
zapB_predicted,0.1,9,9,GTAATCTGTGAGGGCTATTT,0,5275183
zapB_predicted,0.1,9,9,GGTTGCGGTACTTATAGGTA,0,5271309
zapB_predicted,0.1,9,9,GGTGGGGCACCGGAGGTCGT,0,5265381
zapB_predicted,0.1,9,9,GGTGCGTATGCGTTTGGGCT,0,5279962
zapB_predicted,0.1,9,9,GGTGATTATGCGCTCTATGG,0,5275665
zapB_predicted,0.1,9,9,GGTGACACGAGAGGAAGCAT,0,5283267
zapB_predicted,0.1,9,9,GGTCAGGAGGCCTCCTGCGA,0,5287794
zapB_predicted,0.1,9,9,GGTATCGTTTTACGATATTC,0,5279982
zapB_predicted,0.1,9,9,GGTAACTAAGAGGGCTGGCT,0,5278207
zapB_predicted,0.1,9,9,GGGTTGGGAAAATAACTGGC,0,5263684
zapB_predicted,0.1,9,9,GGGTTCGAGGATGTAGGCTT,0,5275094
zapB_predicted,0.1,9,9,GGGTCGCGTTCCTTACTCAA,0,5266872
zapB_predicted,0.1,9,9,GGGGAAACGCTACGGGAACC,0,5265836
zapB_predicted,0.1,9,9,GGGCTACCTTGTGGTGTTCA,0,5284422
zapB_predicted,0.1,9,9,GGCTGGACGGGTTTAATGAT,0,5274116
zapB_predicted,0.1,9,9,GGATTTCTACCACGTATTCA,0,5267948
zapB_predicted,0.1,9,9,GGAGCTGCCACGTGGAGCCC,0,5273527
zapB_predicted,0.1,9,9,GGAGATCCGTTCCTCTTCAA,0,5285376
zapB_predicted,0.1,9,9,GGACTGAAAGAAAAGACGGC,0,5270248
zapB_predicted,0.1,9,9,GGAAGCGTGAGATAACTGTC,0,5265339
zapB_predicted,0.1,9,9,GGAACCGCGAGGCGTACAGC,0,5275159
zapB_predicted,0.1,9,9,GCTTTACGCAGTTGGGGTAA,0,5264027
zapB_predicted,0.1,9,9,GCTGTTTGGACGGAGTTTAT,0,5286687
zapB_predicted,0.1,9,9,GCGTGGTAAAGAATACTAAA,0,5266699
zapB_predicted,0.1,9,9,GCGTCGGTCCGCCAAGGACA,0,5276513
zapB_predicted,0.1,9,9,GCGTCGAGAGAAGTAGCGGT,0,5277539
zapB_predicted,0.1,9,9,GCGTAGCTCGCGCTCTAACG,0,5265602
zapB_predicted,0.1,9,9,GCGGGCCGGCCCTGGGTTAG,0,5273417
zapB_predicted,0.1,9,9,GCGGCTATTGTGGAGGGTAT,0,5272194
zapB_predicted,0.1,9,9,GCGGATAGCAATAATTGTGC,0,5268269
zapB_predicted,0.1,9,9,GCCTGTGCCAGGGGCTACAT,0,5270151
zapB_predicted,0.1,9,9,GCCCTTGCGTATCCTCGAGG,0,5275297
zapB_predicted,0.1,9,9,GCCCTCGGAACCCGTTACCG,0,5270304
zapB_predicted,0.1,9,9,GCCCCCGCGTCTGGCTGGGT,0,5263107
zapB_predicted,0.1,9,9,GCCCAGATCATTCTAATGCC,0,5276244
zapB_predicted,0.1,9,9,GCCATTCCCCCACAGTGCTC,0,5276089
zapB_predicted,0.1,9,9,GCATCATAAAAGTCCCCAGT,0,5283914
zapB_predicted,0.1,9,9,GCATACGTCGCTACAAGTCG,0,5269964
zapB_predicted,0.1,9,9,GCACCAATGATGACTGTAAG,0,5286586
zapB_predicted,0.1,9,9,GCAATGAAGCAGTCATGCAT,0,5270763
zapB_predicted,0.1,9,9,GCAACCGAGAGCCCTCTATA,0,5275632
zapB_predicted,0.1,9,9,GATTCTGGCAGAGGTCCAGA,0,5274809
zapB_predicted,0.1,9,9,GATTCCTATACACTATCGAC,0,5268948
zapB_predicted,0.1,9,9,GATGTTACGGAACCGGAGAG,0,5286611
zapB_predicted,0.1,9,9,GATGCGTGACTAATCGTAAC,0,5274864
zapB_predicted,0.1,9,9,GAGCTAGTCGAAGCACTGGT,0,5267080
zapB_predicted,0.1,9,9,GAGCCCGTTAACAGCACGCT,0,5272502
zapB_predicted,0.1,9,9,GAGCCAGGTAAAATAAACAC,0,5287224
zapB_predicted,0.1,9,9,GAGCCACAGGGCAGTGGTTT,0,5275436
zapB_predicted,0.1,9,9,GAGCATCGTGAGCCTGGCGA,0,5272666
zapB_predicted,0.1,9,9,GACATATATATACTGCGCTA,0,5287724
zapB_predicted,0.1,9,9,GACACTTCAGGTCATCACCC,0,5283754
zapB_predicted,0.1,9,9,GACACCCGACTATGAGCACT,0,5278988
zapB_predicted,0.1,9,9,GACAATCCCGGAAACGAATA,0,5286716
zapB_predicted,0.1,9,9,GACAAGGATCACCGTGGTCA,0,5273968
zapB_predicted,0.1,9,9,GAATGTTATTCACCACGCGG,0,5285460
zapB_predicted,0.1,9,9,GAAGAATATAGGCTATGCTT,0,5275664
zapB_predicted,0.1,9,9,GAACTAGAACTGTAGCGGCG,0,5268674
zapB_predicted,0.1,9,9,GAAACTTTATTCCGTGTATA,0,5265135
zapB_predicted,0.1,9,9,CTTGTCTAGAAGCACTGCTC,0,5275463
zapB_predicted,0.1,9,9,CTTGTAAAAAGTCATGATTC,0,5283999
zapB_predicted,0.1,9,9,CTTGGGCGTCCCGCGGAAGG,0,5265367
zapB_predicted,0.1,9,9,CTTATTTGCTTCTGATGGCG,0,5277340
zapB_predicted,0.1,9,9,CTTATTGTTATGTCGATCCA,0,5278082
zapB_predicted,0.1,9,9,CTTATATCCATCGAAGTTAA,0,5281261
zapB_predicted,0.1,9,9,CTGTTACTAATGCAGCGTCA,0,5273539
zapB_predicted,0.1,9,9,CTGTGGCGCAGTCCGATCGA,0,5265572
zapB_predicted,0.1,9,9,CTGTGAAAAAGCATGCTTTT,0,5263458
zapB_predicted,0.1,9,9,CTCGGTGTATGCTAAGTTGC,0,5263482
zapB_predicted,0.1,9,9,CTCGACCTCATGCCCGCAAG,0,5283272
zapB_predicted,0.1,9,9,CTCCTCTTTAAGGAGGTTTA,0,5271026
zapB_predicted,0.1,9,9,CTCCATGTCAATCTGATATC,0,5269381
zapB_predicted,0.1,9,9,CTCCACGAACCGCGGTTACG,0,5267615
zapB_predicted,0.1,9,9,CTATGAGGTACCGCCAAATA,0,5270149
zapB_predicted,0.1,9,9,CGTTCTTCTCAAACTCATAT,0,5270555
zapB_predicted,0.1,9,9,CGTCCCCAGCGGTATCAACT,0,5278580
zapB_predicted,0.1,9,9,CGGTGATTATCATTAGCCTG,0,5281205
zapB_predicted,0.1,9,9,CGGTCTTGACTGAACCACAT,0,5280941
zapB_predicted,0.1,9,9,CGGGTAGGGGAGAAGATCTT,0,5285259
zapB_predicted,0.1,9,9,CGGGGAGGTTAGCGGGTCAT,0,5282726
zapB_predicted,0.1,9,9,CGGCGCGGACCATCGATCAT,0,5283242
zapB_predicted,0.1,9,9,CGGCAGAATCTGCCGCGGGA,0,5263880
zapB_predicted,0.1,9,9,CGGATGCCTATCTCATTAGA,0,5269076
zapB_predicted,0.1,9,9,CGGATCGTCGGTGATCTAGT,0,5272131
zapB_predicted,0.1,9,9,CGGAACTCTCAGGTACAAGT,0,5275786
zapB_predicted,0.1,9,9,CGGAAAAAGATCTATAGACT,0,5284871
zapB_predicted,0.1,9,9,CGCTGGGCGAGAGCTGCGCT,0,5279705
zapB_predicted,0.1,9,9,CGCTGCTGGGCCTAGAAGCT,0,5280350
zapB_predicted,0.1,9,9,CGCCGGTTCCGCAGTTGCCC,0,5278226
zapB_predicted,0.1,9,9,CGATTTTGCGGTTCAGCACT,0,5263483
zapB_predicted,0.1,9,9,CGATGTAGGATATCTAAGCG,0,5263515
zapB_predicted,0.1,9,9,CGATAGGAGACGTCTCAGGA,0,5275808
zapB_predicted,0.1,9,9,CGAGGCCTCTGTATTCGAGA,0,5275961
zapB_predicted,0.1,9,9,CGAGGAACGTTAATTCAATA,0,5264043
zapB_predicted,0.1,9,9,CGACGCTTCCATTGGCGTGG,0,5269746
zapB_predicted,0.1,9,9,CGACCGAGTTCTGACAGATA,0,5272791
zapB_predicted,0.1,9,9,CCTTAAGACCAGGAGACTCG,0,5281722
zapB_predicted,0.1,9,9,CCTGGCTCCCCCTACCTGGG,0,5279281
zapB_predicted,0.1,9,9,CCTGCAGCATCTGTCCAAGC,0,5270479
zapB_predicted,0.1,9,9,CCTATTCCTTACATATAGCC,0,5274706
zapB_predicted,0.1,9,9,CCTATCAGGACTGTGTGTAC,0,5288140
zapB_predicted,0.1,9,9,CCGTTAGAAGAATTTAAGAA,0,5264738
zapB_predicted,0.1,9,9,CCGTGCCCTGTGCTTCCAAG,0,5283683
zapB_predicted,0.1,9,9,CCGTCCTACGAGTCGCCGAA,0,5283410
zapB_predicted,0.1,9,9,CCGTAAGGGGAATTGAATAG,0,5281942
zapB_predicted,0.1,9,9,CCGGATCTCCGATTACTTGC,0,5275181
zapB_predicted,0.1,9,9,CCGCTATTAGGCCTGATTGA,0,5263319
zapB_predicted,0.1,9,9,CCGCGATGGTTGACAGTCAA,0,5277806
zapB_predicted,0.1,9,9,CCGCACACAATTGGGGCGTG,0,5264425
zapB_predicted,0.1,9,9,CCGATAACCCCGGGGTTACG,0,5271516
zapB_predicted,0.1,9,9,CCGAAACTGCCGCGGGTTAG,0,5267736
zapB_predicted,0.1,9,9,CCCGCCATCTCTAGCAGTAC,0,5286875
zapB_predicted,0.1,9,9,CCCCCTTGAGCCCACGGTTT,0,5263728
zapB_predicted,0.1,9,9,CCCATCACGCCGTGCTCAAA,0,5272009
zapB_predicted,0.1,9,9,CCCACATAGAAGCGTGTCTG,0,5285156
zapB_predicted,0.1,9,9,CCATCTGAGGGAAAAAACTT,0,5288180
zapB_predicted,0.1,9,9,CCAGAAGAGATAAGGGCAGT,0,5270040
zapB_predicted,0.1,9,9,CCACGTGTATGCGGGAGTGT,0,5286864
zapB_predicted,0.1,9,9,CCACCGCATGCCCGGGCCTA,0,5264877
zapB_predicted,0.1,9,9,CCAAACACAACGTATTAATG,0,5263189
zapB_predicted,0.1,9,9,CATTGATAATTGCGCGCTTT,0,5277745
zapB_predicted,0.1,9,9,CATCTGGCAAAACAAGGCGC,0,5266166
zapB_predicted,0.1,9,9,CATCCACGTCGCACCCACCT,0,5282171
zapB_predicted,0.1,9,9,CATATTGGCATTGCCATTTA,0,5284542
zapB_predicted,0.1,9,9,CATAGAAGAGAGGATCTGGA,0,5264852
zapB_predicted,0.1,9,9,CAGGGAGTCAGGACATGGGA,0,5275052
zapB_predicted,0.1,9,9,CAGGCGCTGGGGTAGATCGG,0,5270222
zapB_predicted,0.1,9,9,CAGGACGGGGCACCGATCCT,0,5280173
zapB_predicted,0.1,9,9,CAGCCAAGTAGTTCGGAGTA,0,5287901
zapB_predicted,0.1,9,9,CAGCAATAATAGCGTTCGTC,0,5271741
zapB_predicted,0.1,9,9,CACCAGGGAGGCATCATGGT,0,5268023
zapB_predicted,0.1,9,9,CACACTCCACAGGGGGTAGT,0,5274108
zapB_predicted,0.1,9,9,CACACGAAGTGTACGGTCCT,0,5277932
zapB_predicted,0.1,9,9,CACACAACATGTATGGCTGT,0,5264100
zapB_predicted,0.1,9,9,CACAACCCACATAGCTCCGA,0,5268455
zapB_predicted,0.1,9,9,CAATACTCAGGCATGGGCTG,0,5283497
zapB_predicted,0.1,9,9,CAACGGCCACAATATTCAAT,0,5263218
zapB_predicted,0.1,9,9,CAACATCTTTTCTGCTTGCC,0,5270670
zapB_predicted,0.1,9,9,CAAATGCTCCCCATCATGAA,0,5277030
zapB_predicted,0.1,9,9,CAAATAGGGACATGGAACCA,0,5272757
zapB_predicted,0.1,9,9,ATTTGGGTCTCTAACGCACG,0,5283484
zapB_predicted,0.1,9,9,ATTGGCGTTGAAACACTGAA,0,5264162
zapB_predicted,0.1,9,9,ATTACGCCGGGTTAGAGGCA,0,5263511
zapB_predicted,0.1,9,9,ATGTTTCGCCTGTTTGGACC,0,5271353
zapB_predicted,0.1,9,9,ATGTGGTAAACAGGCCCTTT,0,5267021
zapB_predicted,0.1,9,9,ATGGTGTGTAACCGAATAAG,0,5263362
zapB_predicted,0.1,9,9,ATGGGCTTTATTAAGCTAGA,0,5279213
zapB_predicted,0.1,9,9,ATGGCCTCCAATTGCACATC,0,5269801
zapB_predicted,0.1,9,9,ATGCGCGAACTAGATGATGC,0,5273303
zapB_predicted,0.1,9,9,ATGCATACACGAGCTATCAT,0,5271139
zapB_predicted,0.1,9,9,ATGCACATCGGCCATGTTGC,0,5264875
zapB_predicted,0.1,9,9,ATGACGCAGAGACACCTTGC,0,5273424
zapB_predicted,0.1,9,9,ATCTTTGGGATCAAGGTTTT,0,5266014
zapB_predicted,0.1,9,9,ATCCTCTGTGTAAGCAAGTA,0,5286817
zapB_predicted,0.1,9,9,ATCCCGGTGATCGTGGGAGA,0,5284547
zapB_predicted,0.1,9,9,ATCACTTGCCCCTAGCGCAT,0,5266974
zapB_predicted,0.1,9,9,ATCAAATCAAAACTGCTTTA,0,5270198
zapB_predicted,0.1,9,9,ATATCCGATTCAATGATGCT,0,5268966
zapB_predicted,0.1,9,9,ATAGTCATTCGCAAGGCGTA,0,5268982
zapB_predicted,0.1,9,9,ATACGAAGTAAGTTAATACT,0,5267744
zapB_predicted,0.1,9,9,ATAAGGTCGGTTAAGTTTAC,0,5275854
zapB_predicted,0.1,9,9,ATAACTAGGGGTACGTGCTA,0,5271356
zapB_predicted,0.1,9,9,AGTTTACCCAATTGGACACT,0,5271627
zapB_predicted,0.1,9,9,AGTTGGAGAAGGCCCGTTAC,0,5273695
zapB_predicted,0.1,9,9,AGTGCGGACGTGGCTATTCC,0,5279616
zapB_predicted,0.1,9,9,AGTCTTTTTTTAAAACGGTA,0,5265675
zapB_predicted,0.1,9,9,AGTAACACGCGGACTGCGTC,0,5279482
zapB_predicted,0.1,9,9,AGGTGTGCTTGTCAACCCTC,0,5267518
zapB_predicted,0.1,9,9,AGGTGCAATAAGGATGGCGT,0,5281239
zapB_predicted,0.1,9,9,AGGTCTCAACACAGAGGCTC,0,5274786
zapB_predicted,0.1,9,9,AGGTAACGCGTGGCGCGGGT,0,5271665
zapB_predicted,0.1,9,9,AGGGGAGACTCAACGCATGC,0,5278927
zapB_predicted,0.1,9,9,AGGGATGCTCAAGGCTTAAT,0,5276260
zapB_predicted,0.1,9,9,AGGCTTGTCTGGTACTTATC,0,5282031
zapB_predicted,0.1,9,9,AGGCCATTGGTGGAGGAATG,0,5266002
zapB_predicted,0.1,9,9,AGGATAATAAACAAACGTGC,0,5278209
zapB_predicted,0.1,9,9,AGCTACGTCTTCTGGTTGAA,0,5267150
zapB_predicted,0.1,9,9,AGCGTGCCATGCTCCATGGA,0,5269612
zapB_predicted,0.1,9,9,AGCGGCCGGGCATCACATAA,0,5263159
zapB_predicted,0.1,9,9,AGCCAAGTAGTTAGTCTAGT,0,5277585
zapB_predicted,0.1,9,9,AGCACAGGCAGGCTAGAATC,0,5265507
zapB_predicted,0.1,9,9,AGCAAACTGCACTCACGGTC,0,5278716
zapB_predicted,0.1,9,9,AGAGAGTAAGACGATCCGCA,0,5272475
zapB_predicted,0.1,9,9,AGACACGAAACCCGATTCAA,0,5283038
zapB_predicted,0.1,9,9,ACTTTGGTAATGTGTATAGG,0,5265871
zapB_predicted,0.1,9,9,ACTGTATATGGCCGGTCTGT,0,5282364
zapB_predicted,0.1,9,9,ACTGAGGATATATGATTCTA,0,5266038
zapB_predicted,0.1,9,9,ACTCCTGCCTTAGCCAGCTA,0,5287977
zapB_predicted,0.1,9,9,ACTATGCGCATATGTGATGC,0,5265992
zapB_predicted,0.1,9,9,ACGTTGTACCCCACTTCCGT,0,5283030
zapB_predicted,0.1,9,9,ACGTCCGCTGTTATTGGTTC,0,5265125
zapB_predicted,0.1,9,9,ACGGTTGGTGCTTACCGGTT,0,5287568
zapB_predicted,0.1,9,9,ACGGTGTGGGATCTCGTTCT,0,5274918
zapB_predicted,0.1,9,9,ACGCGTTAGTTGTAGCATCG,0,5285583
zapB_predicted,0.1,9,9,ACGAGTCGGTAGGTGTTCTA,0,5281112
zapB_predicted,0.1,9,9,ACGACGCGCGAGGTACGGGA,0,5270028
zapB_predicted,0.1,9,9,ACGACCCGGACGTGTCAAAG,0,5276124
zapB_predicted,0.1,9,9,ACCTCGAGGTCGGAACGTTG,0,5285126
zapB_predicted,0.1,9,9,ACCTAGTAAACCAGACCAAG,0,5281404
zapB_predicted,0.1,9,9,ACCACAGTTGCAACATTTAA,0,5274017
zapB_predicted,0.1,9,9,ACAATTGGATAGTCTAGACT,0,5264513
zapB_predicted,0.1,9,9,ACAACGACTATGTACTGCCT,0,5282737
zapB_predicted,0.1,9,9,AATTGGGATTTTCGTGGCTA,0,5276828
zapB_predicted,0.1,9,9,AATCTTTCCTGGGAGCCCCT,0,5274385
zapB_predicted,0.1,9,9,AATCCACAGAGGTGCAGGAT,0,5288193
zapB_predicted,0.1,9,9,AATACAAAACAAGCGACCGA,0,5273989
zapB_predicted,0.1,9,9,AAGTCTACAAACGTCTGCCC,0,5273218
zapB_predicted,0.1,9,9,AAGGAGATCGTAGACTATAT,0,5267923
zapB_predicted,0.1,9,9,AAGCTCATAACGCTTTCAAG,0,5269324
zapB_predicted,0.1,9,9,AAGCCGGTTACTTTCCTGAC,0,5279917
zapB_predicted,0.1,9,9,AAGCCCGCTACAAGGAAAAG,0,5277674
zapB_predicted,0.1,9,9,AAGCCATTGGGGATTGACAG,0,5276012
zapB_predicted,0.1,9,9,AAGACTTCAGTTGCGCAAGC,0,5268259
zapB_predicted,0.1,9,9,AACTGTCATCAATACAACGT,0,5265754
zapB_predicted,0.1,9,9,AACTATCTCGCCACTCCATA,0,5286862
zapB_predicted,0.1,9,9,AACACGACTTTATCATACGA,0,5264292
zapB_predicted,0.1,9,9,AAATTCTTTCGAGACTCGTT,0,5275580
zapB_predicted,0.1,9,9,AAATCGCTGTATTGTCTCAA,0,5276182
zapB_predicted,0.1,9,9,AAAGTGTCGTAGCCGGCAAC,0,5286577
zapB_predicted,0.1,9,9,AAAACAAGGAGGTCAATCTA,0,5287708
zapB_predicted,0.1111111111111111,8,8,TTTTCCGGGAACAGTTAGTG,0,5285792
zapB_predicted,0.1111111111111111,8,8,TTTTCAGCGGCGGCCTTGAA,0,5270899
zapB_predicted,0.1111111111111111,8,8,TTTTAACGGAAGTGGGGCTA,0,5275431
zapB_predicted,0.1111111111111111,8,8,TTTGTGGGTTGTCAGAGCCT,0,5265211
zapB_predicted,0.1111111111111111,8,8,TTTCATATAGGTATGATTTT,0,5279922
zapB_predicted,0.1111111111111111,8,8,TTTAGTCAACCTTGACTTAG,0,5265400
zapB_predicted,0.1111111111111111,8,8,TTTAGGTGCATAAACGCGGC,0,5266126
zapB_predicted,0.1111111111111111,8,8,TTGTGAGATCGGCACTTGTA,0,5284488
zapB_predicted,0.1111111111111111,8,8,TTGTCGGTGAACGTATGTCC,0,5278683
zapB_predicted,0.1111111111111111,8,8,TTGGGCCTAACGGTAGTAGT,0,5263292
zapB_predicted,0.1111111111111111,8,8,TTGGACTATGAAAGCCCCAA,0,5264694
zapB_predicted,0.1111111111111111,8,8,TTCTATTCGGAAAGGACTGG,0,5276277
zapB_predicted,0.1111111111111111,8,8,TTCGTCACACACCACCACCT,0,5274613
zapB_predicted,0.1111111111111111,8,8,TTCCTGACTGCATTCGCGGT,0,5279597
zapB_predicted,0.1111111111111111,8,8,TTCCATGAATAATAGTGGAT,0,5272583
zapB_predicted,0.1111111111111111,8,8,TTCATGTTCTCTGCAACTCG,0,5286891
zapB_predicted,0.1111111111111111,8,8,TTCATACGCGGAAACCTTTC,0,5277234
zapB_predicted,0.1111111111111111,8,8,TTATCGGGCAACGAGGTGTG,0,5281859
zapB_predicted,0.1111111111111111,8,8,TTAGTATGCTTGGCCGAAAG,0,5277393
zapB_predicted,0.1111111111111111,8,8,TTAGGCAAGGTCGATTCCTG,0,5280593
zapB_predicted,0.1111111111111111,8,8,TTAGCTTCGCTGGCCGCGCG,0,5286910
zapB_predicted,0.1111111111111111,8,8,TTAGACTAGGTAACGGCCGG,0,5264848
zapB_predicted,0.1111111111111111,8,8,TTACGACCGGGGGGAGCATT,0,5263562
zapB_predicted,0.1111111111111111,8,8,TGTGTCGATTGGGCGTCAGG,0,5277444
zapB_predicted,0.1111111111111111,8,8,TGGTGTTGGGTATGCTTAAG,0,5263280
zapB_predicted,0.1111111111111111,8,8,TGGTCGGGGCGTGATTTAAT,0,5285426
zapB_predicted,0.1111111111111111,8,8,TGGTCCCTGGGTCGTCCACA,0,5272343
zapB_predicted,0.1111111111111111,8,8,TGGGTAACGTGCCAGGTTGG,0,5287470
zapB_predicted,0.1111111111111111,8,8,TGGCCTAGTATAAGGTATTA,0,5283031
zapB_predicted,0.1111111111111111,8,8,TGGCCAGTAACTTTAACCTG,0,5266569
zapB_predicted,0.1111111111111111,8,8,TGCCCGCAACCATCAAATCC,0,5265369
zapB_predicted,0.1111111111111111,8,8,TGCAAGTAGGGCTCGAGTGT,0,5286196
zapB_predicted,0.1111111111111111,8,8,TGCAAGGGTGTCCCCTGCAG,0,5278577
zapB_predicted,0.1111111111111111,8,8,TGATCCTCATTCCAGTGCGG,0,5276240
zapB_predicted,0.1111111111111111,8,8,TGAGTGTGCACAAGTAATAT,0,5272602
zapB_predicted,0.1111111111111111,8,8,TGAGCTAAGACTGCCCAAGG,0,5264044
zapB_predicted,0.1111111111111111,8,8,TGACACAAATCAAGTACTTA,0,5272872
zapB_predicted,0.1111111111111111,8,8,TGAACTCCCACCGCCAGTGG,0,5279243
zapB_predicted,0.1111111111111111,8,8,TGAAAGTCTTTATACGCCTA,0,5276938
zapB_predicted,0.1111111111111111,8,8,TGAAACAAGGCCGGCTAATC,0,5272366
zapB_predicted,0.1111111111111111,8,8,TCTTAATCGGTTGGCCTAGT,0,5280055
zapB_predicted,0.1111111111111111,8,8,TCTGTACTGGTACGCTGGTC,0,5270656
zapB_predicted,0.1111111111111111,8,8,TCTGATACATTGCTTCGTCC,0,5277666
zapB_predicted,0.1111111111111111,8,8,TCTCATGTTCAGACCGGACA,0,5270223
zapB_predicted,0.1111111111111111,8,8,TCTATATACGTTCCTTAAAG,0,5274770
zapB_predicted,0.1111111111111111,8,8,TCGGCATATAGGCCAATTCG,0,5270627
zapB_predicted,0.1111111111111111,8,8,TCGCTACCGGACTCAACGGA,0,5279612
zapB_predicted,0.1111111111111111,8,8,TCGCCCCTATAAATGGGCTA,0,5263564
zapB_predicted,0.1111111111111111,8,8,TCGAAGGGTGCTACTATGAA,0,5274892
zapB_predicted,0.1111111111111111,8,8,TCCTCAGGACAATGCCTTTG,0,5280083
zapB_predicted,0.1111111111111111,8,8,TCCTCAGATCCTGACAGGTT,0,5273844
zapB_predicted,0.1111111111111111,8,8,TCCTCACATAGGTGTCCGAA,0,5275097
zapB_predicted,0.1111111111111111,8,8,TCCGTGTGGGTATGTTGTAC,0,5270770
zapB_predicted,0.1111111111111111,8,8,TCCCCGCCAGGGCGCCAAAG,0,5269440
zapB_predicted,0.1111111111111111,8,8,TCCATCACCATCGGACTCGT,0,5263316
zapB_predicted,0.1111111111111111,8,8,TCATTAGTCTAGGGCTCTGA,0,5276711
zapB_predicted,0.1111111111111111,8,8,TCATCGTTAAGTACTCAGCA,0,5272501
zapB_predicted,0.1111111111111111,8,8,TCACAAACATAGACTACTCT,0,5275175
zapB_predicted,0.1111111111111111,8,8,TATTAAATTATTGGCAGTCC,0,5281667
zapB_predicted,0.1111111111111111,8,8,TATGTTGCCGTGTGCGGATA,0,5268425
zapB_predicted,0.1111111111111111,8,8,TATGCCGCTCAATAGCGTAC,0,5276786
zapB_predicted,0.1111111111111111,8,8,TATCTTCGAAACTACCGTTG,0,5263088
zapB_predicted,0.1111111111111111,8,8,TATCCTCGCGAGCCGTCCGT,0,5266728
zapB_predicted,0.1111111111111111,8,8,TACTGTTATATTTTCGCCAT,0,5277559
zapB_predicted,0.1111111111111111,8,8,TACTGCTCAAAGGGCCCCTG,0,5283216
zapB_predicted,0.1111111111111111,8,8,TACTCCAGCTTACCCTGTCC,0,5267104
zapB_predicted,0.1111111111111111,8,8,TACGGGGCTGTTCATGTCAA,0,5274173
zapB_predicted,0.1111111111111111,8,8,TACGGCCCATCACCGCATTC,0,5283630
zapB_predicted,0.1111111111111111,8,8,TACGCTCTGACCCAATACCA,0,5274908
zapB_predicted,0.1111111111111111,8,8,TACCTCAATATATAGGTGCT,0,5275635
zapB_predicted,0.1111111111111111,8,8,TACCGGAAGCGGTATGCTCG,0,5267676
zapB_predicted,0.1111111111111111,8,8,TACCCAGTTGTCGTGTACCT,0,5271929
zapB_predicted,0.1111111111111111,8,8,TACATTTGAGATCTACGGTC,0,5270375
zapB_predicted,0.1111111111111111,8,8,TACATACGGCTAGCATAATT,0,5272899
zapB_predicted,0.1111111111111111,8,8,TACATAATGAGTCTGGGCCT,0,5270471
zapB_predicted,0.1111111111111111,8,8,TACAAATTCCGGGGACCAGA,0,5275336
zapB_predicted,0.1111111111111111,8,8,TAAGAGGCCTGCCGTGTTTA,0,5284852
zapB_predicted,0.1111111111111111,8,8,TAACCAAGACTGGTTAGGTA,0,5273006
zapB_predicted,0.1111111111111111,8,8,GTTTCTAACCTTCTGCAATT,0,5282303
zapB_predicted,0.1111111111111111,8,8,GTTTATGTGGCTTTGGTAGA,0,5287850
zapB_predicted,0.1111111111111111,8,8,GTTTAGGTAACGAGACAGAG,0,5264855
zapB_predicted,0.1111111111111111,8,8,GTTTAGATCAAGGTGAAGTA,0,5265862
zapB_predicted,0.1111111111111111,8,8,GTTTACGTTAAGCACTGGGG,0,5277988
zapB_predicted,0.1111111111111111,8,8,GTTGGATGTGTCGATTCGAA,0,5270991
zapB_predicted,0.1111111111111111,8,8,GTTGACGGAGGTAGGACAGG,0,5277009
zapB_predicted,0.1111111111111111,8,8,GTTAATTATACTTAAACGCG,0,5278154
zapB_predicted,0.1111111111111111,8,8,GTGTGAAATTCATCATTGGT,0,5287153
zapB_predicted,0.1111111111111111,8,8,GTGTATCCGCCTGGCCAGGT,0,5276530
zapB_predicted,0.1111111111111111,8,8,GTGGGTGAGGGATTACCGAT,0,5285060
zapB_predicted,0.1111111111111111,8,8,GTGGGGATGTATTCGAGCGC,0,5268353
zapB_predicted,0.1111111111111111,8,8,GTGCTATGGTATTGAAGCGC,0,5269978
zapB_predicted,0.1111111111111111,8,8,GTCTTCGTGGGACGTAGTTC,0,5264502
zapB_predicted,0.1111111111111111,8,8,GTCTTCAAATATAACGACAT,0,5276862
zapB_predicted,0.1111111111111111,8,8,GTCGGTGTTTCTGCAGTGCA,0,5268193
zapB_predicted,0.1111111111111111,8,8,GTCGAGCCACTCTCGAAATC,0,5281209
zapB_predicted,0.1111111111111111,8,8,GTCCGTTTTCGGCTAACCTC,0,5263400
zapB_predicted,0.1111111111111111,8,8,GTCCGGGTGGCCTATTGAGC,0,5267309
zapB_predicted,0.1111111111111111,8,8,GTCCATATAGCAACTATGCA,0,5276937
zapB_predicted,0.1111111111111111,8,8,GTAGTATGCCTGCGCTTCTT,0,5275538
zapB_predicted,0.1111111111111111,8,8,GTAGGGGTTAATCCCGCCGT,0,5279166
zapB_predicted,0.1111111111111111,8,8,GTAGAATGCCGCAGCACGAC,0,5275115
zapB_predicted,0.1111111111111111,8,8,GTACTTGCACCGGACAAACA,0,5281240
zapB_predicted,0.1111111111111111,8,8,GTACGGAACGGCTTTGCTGC,0,5284048
zapB_predicted,0.1111111111111111,8,8,GTACGAAAGGGTGCTGACGA,0,5264169
zapB_predicted,0.1111111111111111,8,8,GTAAGGGCCAATCTCCTGAC,0,5276085
zapB_predicted,0.1111111111111111,8,8,GTAAATGGACGGTTGATCGA,0,5284088
zapB_predicted,0.1111111111111111,8,8,GGGTATGATCAAGTTTAATG,0,5281051
zapB_predicted,0.1111111111111111,8,8,GGGGGAGCATTAAGCCTCAT,0,5279776
zapB_predicted,0.1111111111111111,8,8,GGGCTCACACTGCTGCGAAG,0,5281143
zapB_predicted,0.1111111111111111,8,8,GGGCACGTTGACTACTGAGT,0,5281060
zapB_predicted,0.1111111111111111,8,8,GGCTTAGTATAAGCGCGCGT,0,5283019
zapB_predicted,0.1111111111111111,8,8,GGCTCGTTGAGTCTATCCAG,0,5281015
zapB_predicted,0.1111111111111111,8,8,GGCGTTGGTATCATTAGCGC,0,5279667
zapB_predicted,0.1111111111111111,8,8,GGCGGGTAAAAGATTTATTT,0,5271109
zapB_predicted,0.1111111111111111,8,8,GGCAACCACTCTTTAAAGCA,0,5274039
zapB_predicted,0.1111111111111111,8,8,GGATGACAGCCGGGCTACGT,0,5264797
zapB_predicted,0.1111111111111111,8,8,GGATCTCGCGTGCGTACAGG,0,5288153
zapB_predicted,0.1111111111111111,8,8,GGATCAAAGTCGTGGGACCA,0,5270422
zapB_predicted,0.1111111111111111,8,8,GGAGTAGGTAGCGTTCTACA,0,5288094
zapB_predicted,0.1111111111111111,8,8,GGAGGATTAGGTCATGGGGC,0,5279816
zapB_predicted,0.1111111111111111,8,8,GGACTAGGCGGCAAGCGACT,0,5277445
zapB_predicted,0.1111111111111111,8,8,GGACACAGGTTACGACCCTT,0,5271830
zapB_predicted,0.1111111111111111,8,8,GCTTGTTAACACCGGGACCA,0,5274396
zapB_predicted,0.1111111111111111,8,8,GCTTCTAAAGCCTATCATTA,0,5265906
zapB_predicted,0.1111111111111111,8,8,GCTTCACATACGTGGCAGTG,0,5285784
zapB_predicted,0.1111111111111111,8,8,GCTGTTCGCCGATCTTTGAC,0,5284306
zapB_predicted,0.1111111111111111,8,8,GCTCATCGTAATCTGTTGCT,0,5268677
zapB_predicted,0.1111111111111111,8,8,GCGTTGAACTTATGCATCGC,0,5268185
zapB_predicted,0.1111111111111111,8,8,GCGTTCATACTGATCTCATA,0,5285602
zapB_predicted,0.1111111111111111,8,8,GCGTGCGTTTAGACTAAGGC,0,5281224
zapB_predicted,0.1111111111111111,8,8,GCGTCCTACTCTCGACCGCG,0,5263186
zapB_predicted,0.1111111111111111,8,8,GCGTACCCTGGACTATTCTC,0,5274366
zapB_predicted,0.1111111111111111,8,8,GCGGCATGGAAGTGAACTCT,0,5270272
zapB_predicted,0.1111111111111111,8,8,GCGCAATCGCTTGCCGTCAA,0,5284911
zapB_predicted,0.1111111111111111,8,8,GCGATCGTTCCAGACAATCT,0,5273391
zapB_predicted,0.1111111111111111,8,8,GCGAGTTCCGGTACGCGGTT,0,5273742
zapB_predicted,0.1111111111111111,8,8,GCGAGTTAGAGGGGGCAGAC,0,5279368
zapB_predicted,0.1111111111111111,8,8,GCCTTACGGTGGCTGTTGGC,0,5286197
zapB_predicted,0.1111111111111111,8,8,GCCTCAGTTCAGCAGCCAAA,0,5271371
zapB_predicted,0.1111111111111111,8,8,GCCAGGGTGGGATGCACCTA,0,5268622
zapB_predicted,0.1111111111111111,8,8,GCCACGGGCAAAGATGGGAC,0,5275470
zapB_predicted,0.1111111111111111,8,8,GCCAACAAGCATCCGCCTTG,0,5270695
zapB_predicted,0.1111111111111111,8,8,GCATAGCAACTAAACGCATT,0,5268099
zapB_predicted,0.1111111111111111,8,8,GCACACCTTGACACGCTTGA,0,5274374
zapB_predicted,0.1111111111111111,8,8,GCAAGTCATGTCTGGGTGGT,0,5270649
zapB_predicted,0.1111111111111111,8,8,GATGACGAAACGGGAGTGTC,0,5286799
zapB_predicted,0.1111111111111111,8,8,GATGAAGTCGCAGCGGCACT,0,5279278
zapB_predicted,0.1111111111111111,8,8,GATCCTAACCGGTGTTATCT,0,5264410
zapB_predicted,0.1111111111111111,8,8,GATATAAGATTCCTGCGACG,0,5282494
zapB_predicted,0.1111111111111111,8,8,GATAGGCTAAACTCCCGAGT,0,5279280
zapB_predicted,0.1111111111111111,8,8,GAGTACGGGATGCTAATTTT,0,5269741
zapB_predicted,0.1111111111111111,8,8,GAGGGGGTGTCCTATAGTCC,0,5272500
zapB_predicted,0.1111111111111111,8,8,GAGCTCTCAGGGTAAGTTAT,0,5269433
zapB_predicted,0.1111111111111111,8,8,GAGCGCCATACGTATCTCTA,0,5277083
zapB_predicted,0.1111111111111111,8,8,GACTCTGAGTCTTGGATAAC,0,5282164
zapB_predicted,0.1111111111111111,8,8,GACTCCACGTTGTTTATGAA,0,5276630
zapB_predicted,0.1111111111111111,8,8,GACGGCGACAACAGCGAATG,0,5272037
zapB_predicted,0.1111111111111111,8,8,GACGCACGTAGATGATCGTT,0,5272888
zapB_predicted,0.1111111111111111,8,8,GACCCAACGCCGATGGGTTT,0,5287644
zapB_predicted,0.1111111111111111,8,8,GAATTAAGACATTTGCGATG,0,5277772
zapB_predicted,0.1111111111111111,8,8,GAATCAACTACACAATTGAT,0,5280816
zapB_predicted,0.1111111111111111,8,8,GAACATTGGTCTCGGGCACA,0,5280043
zapB_predicted,0.1111111111111111,8,8,GAAACGCCTCGAGGCGCTTT,0,5287008
zapB_predicted,0.1111111111111111,8,8,CTTCCGTGGGTACTGTCTGT,0,5280335
zapB_predicted,0.1111111111111111,8,8,CTTATGTCAAGACGTTCTGA,0,5286632
zapB_predicted,0.1111111111111111,8,8,CTTACGTGCCGTTTAATGAT,0,5267250
zapB_predicted,0.1111111111111111,8,8,CTTACAGTTGACGTGCTACT,0,5273093
zapB_predicted,0.1111111111111111,8,8,CTTAAATAGCTTAACCCTAG,0,5271416
zapB_predicted,0.1111111111111111,8,8,CTGTTTCTACGGAGTACAGC,0,5274926
zapB_predicted,0.1111111111111111,8,8,CTGTATTAGTGCCTGTAGTA,0,5266145
zapB_predicted,0.1111111111111111,8,8,CTGTACAAGAAACTTATAAC,0,5275767
zapB_predicted,0.1111111111111111,8,8,CTGTAATACTCGGGACCGCA,0,5274179
zapB_predicted,0.1111111111111111,8,8,CTGGCGGTAATGCTCCACTG,0,5269380
zapB_predicted,0.1111111111111111,8,8,CTGCATGCGTGTACGCTCAG,0,5280229
zapB_predicted,0.1111111111111111,8,8,CTGAGATCTGGCCACGTATA,0,5269420
zapB_predicted,0.1111111111111111,8,8,CTCTGGAGCATCTGGCTGGC,0,5270612
zapB_predicted,0.1111111111111111,8,8,CTCTAACTCGGAGTGGGGGT,0,5270788
zapB_predicted,0.1111111111111111,8,8,CTCGGAAGGGCGTCGGGCGT,0,5280147
zapB_predicted,0.1111111111111111,8,8,CTATGACGCATCCAGAACCT,0,5270764
zapB_predicted,0.1111111111111111,8,8,CTAGAGCTATGAATGCGATA,0,5286314
zapB_predicted,0.1111111111111111,8,8,CTAGAGCCAACCATGCTCCA,0,5267788
zapB_predicted,0.1111111111111111,8,8,CTACCACGAGAAAGCATTCC,0,5272087
zapB_predicted,0.1111111111111111,8,8,CTACAGAGTAGCACACTTCA,0,5266164
zapB_predicted,0.1111111111111111,8,8,CTAATCGCAGGCGTAGGCCA,0,5282305
zapB_predicted,0.1111111111111111,8,8,CGTTCACGTGTGAGTCACGA,0,5273529
zapB_predicted,0.1111111111111111,8,8,CGTGGGGCCACCGATTGCCT,0,5274309
zapB_predicted,0.1111111111111111,8,8,CGTGCCCGATCGTTCAAGGG,0,5285512
zapB_predicted,0.1111111111111111,8,8,CGTCACGGCTCATTGCTGCT,0,5272350
zapB_predicted,0.1111111111111111,8,8,CGTCAAATGGTTCCAGACCT,0,5288338
zapB_predicted,0.1111111111111111,8,8,CGTAAAGATGAGGGCCTTCC,0,5263600
zapB_predicted,0.1111111111111111,8,8,CGGTTAGCTGATTGAATATG,0,5281391
zapB_predicted,0.1111111111111111,8,8,CGGGTCCAGCCTCACAAGGT,0,5282393
zapB_predicted,0.1111111111111111,8,8,CGGCTCAATTTTAGACGGTT,0,5279467
zapB_predicted,0.1111111111111111,8,8,CGGCGTGATGCTGAAAAGAT,0,5271181
zapB_predicted,0.1111111111111111,8,8,CGGCCAGGCGTATGATATCG,0,5286665
zapB_predicted,0.1111111111111111,8,8,CGCGTAGTTCTCACTCCCCC,0,5265464
zapB_predicted,0.1111111111111111,8,8,CGCGGATTGTCCTGGAAGTG,0,5285582
zapB_predicted,0.1111111111111111,8,8,CGAGTTGTTTTAAATCTAGA,0,5280555
zapB_predicted,0.1111111111111111,8,8,CGAGCGCCTACGTAAAAGCT,0,5264922
zapB_predicted,0.1111111111111111,8,8,CGAGAAGGAGCAGTCACACT,0,5264222
zapB_predicted,0.1111111111111111,8,8,CGACGGGTTCTCGCTTCCCA,0,5276128
zapB_predicted,0.1111111111111111,8,8,CGAACCATGGTTTCGAACAA,0,5275445
zapB_predicted,0.1111111111111111,8,8,CGAAAGTTTGCGAACATCCG,0,5272285
zapB_predicted,0.1111111111111111,8,8,CCTAGTGCGAGAAGTGGGGT,0,5276780
zapB_predicted,0.1111111111111111,8,8,CCTAGCCGCTGGCCTGCCCA,0,5268329
zapB_predicted,0.1111111111111111,8,8,CCTAGAAGCTACCATTAGTA,0,5278260
zapB_predicted,0.1111111111111111,8,8,CCGGGCGACGAAGCTCCCAA,0,5275840
zapB_predicted,0.1111111111111111,8,8,CCGGCCTGGTGCGCGTGGTG,0,5263596
zapB_predicted,0.1111111111111111,8,8,CCGACCAGCCCGCTGGAGCA,0,5271229
zapB_predicted,0.1111111111111111,8,8,CCCTGGAGCTTCCAAGGTGG,0,5271287
zapB_predicted,0.1111111111111111,8,8,CCCCCATAGCAGTAAAATCT,0,5276910
zapB_predicted,0.1111111111111111,8,8,CCCCAGGTAAGTCGTAAGAG,0,5282854
zapB_predicted,0.1111111111111111,8,8,CCCCAAACTCGCGGATTTGG,0,5281866
zapB_predicted,0.1111111111111111,8,8,CCCATTTTTCGATTGGAGCC,0,5274295
zapB_predicted,0.1111111111111111,8,8,CCACTAGAAACGAAACGGTT,0,5267555
zapB_predicted,0.1111111111111111,8,8,CCACCCCTAGGGATTTATGA,0,5264741
zapB_predicted,0.1111111111111111,8,8,CCACCCAAAATACCTGTAAC,0,5266933
zapB_predicted,0.1111111111111111,8,8,CCAAACACCTTTCAACATAA,0,5278889
zapB_predicted,0.1111111111111111,8,8,CATTTAGACATAACCAATAA,0,5269131
zapB_predicted,0.1111111111111111,8,8,CATGGTGTACAGACTGTTGT,0,5265072
zapB_predicted,0.1111111111111111,8,8,CATGGCGCCCGCACGTGGTG,0,5284740
zapB_predicted,0.1111111111111111,8,8,CATAGTGTAGCTATTTTCAG,0,5263883
zapB_predicted,0.1111111111111111,8,8,CATAGTAAGACGCCTTTTTG,0,5283577
zapB_predicted,0.1111111111111111,8,8,CATAATTCCTAATCTGCATT,0,5267650
zapB_predicted,0.1111111111111111,8,8,CAGTGGAATATGCAGGTGGG,0,5275653
zapB_predicted,0.1111111111111111,8,8,CAGTCCAACGCTGCCCACTA,0,5282620
zapB_predicted,0.1111111111111111,8,8,CAGGTACTTGGCCAGGAATC,0,5286109
zapB_predicted,0.1111111111111111,8,8,CAGGTAAAAGCACGCCATCT,0,5273147
zapB_predicted,0.1111111111111111,8,8,CAGGGGGAAGACTATAAGAC,0,5286232
zapB_predicted,0.1111111111111111,8,8,CAGCCTTTGTCCAGGCCAGG,0,5268386
zapB_predicted,0.1111111111111111,8,8,CAGAGGTAGTTCGAATCGAA,0,5280917
zapB_predicted,0.1111111111111111,8,8,CAGAATAGCGGAGGGAGAAG,0,5266822
zapB_predicted,0.1111111111111111,8,8,CACTCCGGGGTGCTGTGCTT,0,5269669
zapB_predicted,0.1111111111111111,8,8,CACGTTCGAAGATTGGCTCA,0,5268961
zapB_predicted,0.1111111111111111,8,8,CACATAAGATCGAATTAACT,0,5284969
zapB_predicted,0.1111111111111111,8,8,CACACATTGGCTCGTCCTCA,0,5276913
zapB_predicted,0.1111111111111111,8,8,CACAACAGTTTACGCTTATG,0,5274582
zapB_predicted,0.1111111111111111,8,8,CAATGAGGATCCGTATAAGC,0,5263978
zapB_predicted,0.1111111111111111,8,8,CAAGTAGCCGAGCCTCCGAT,0,5268289
zapB_predicted,0.1111111111111111,8,8,CAACTCGCTCCTGTTTCAGG,0,5281857
zapB_predicted,0.1111111111111111,8,8,CAAAGGCCGATATAAACGTC,0,5281314
zapB_predicted,0.1111111111111111,8,8,CAAAACCTGCGCGCTCGGTC,0,5276621
zapB_predicted,0.1111111111111111,8,8,ATTTTTAAAATGTGTAAATC,0,5264206
zapB_predicted,0.1111111111111111,8,8,ATTGACGATCAACTAGCGCT,0,5265642
zapB_predicted,0.1111111111111111,8,8,ATTCGACTTCGGGGGTCCAG,0,5277766
zapB_predicted,0.1111111111111111,8,8,ATTAATGCCAGTCTGGAGTA,0,5271143
zapB_predicted,0.1111111111111111,8,8,ATGTTCGCCTCATGCCTATG,0,5273148
zapB_predicted,0.1111111111111111,8,8,ATGTGATTACCCCGGCAGCT,0,5268177
zapB_predicted,0.1111111111111111,8,8,ATGTAATGGGACGATATGCT,0,5281093
zapB_predicted,0.1111111111111111,8,8,ATGGACCCTCTATCTATGTG,0,5286602
zapB_predicted,0.1111111111111111,8,8,ATGCCTCTATGAGGTGCTGC,0,5263635
zapB_predicted,0.1111111111111111,8,8,ATCTTCTCGTACAGCAACGA,0,5272259
zapB_predicted,0.1111111111111111,8,8,ATCCTGTCAATAGTTGAAGG,0,5273262
zapB_predicted,0.1111111111111111,8,8,ATCCTCTTCATTTCATGTGC,0,5279751
zapB_predicted,0.1111111111111111,8,8,ATCCCTGAATGGTTCTGGCC,0,5276656
zapB_predicted,0.1111111111111111,8,8,ATCCACACCGTTGTGATTCT,0,5265472
zapB_predicted,0.1111111111111111,8,8,ATATAGGCCTATACAAGCTT,0,5277336
zapB_predicted,0.1111111111111111,8,8,ATAGCCCTGGCACGTAGTTA,0,5278995
zapB_predicted,0.1111111111111111,8,8,ATAGACATTGTATCGTATAC,0,5273776
zapB_predicted,0.1111111111111111,8,8,ATACGTACCTCATATTGGGT,0,5269532
zapB_predicted,0.1111111111111111,8,8,ATACCGTGATCAGCTCGAAG,0,5265364
zapB_predicted,0.1111111111111111,8,8,ATAAAGCTTCAGGATTTTCC,0,5269806
zapB_predicted,0.1111111111111111,8,8,AGTGGGTTCGTTCCCGCGTG,0,5283902
zapB_predicted,0.1111111111111111,8,8,AGTCTTTAACGGCAATCCAA,0,5278561
zapB_predicted,0.1111111111111111,8,8,AGTATGATACGAGGCAGGAG,0,5270159
zapB_predicted,0.1111111111111111,8,8,AGGGCGGCACGCGGCCCTGA,0,5286955
zapB_predicted,0.1111111111111111,8,8,AGGGCGGATTGAGAAAATTA,0,5286829
zapB_predicted,0.1111111111111111,8,8,AGGGAGAGCCGATACACCTA,0,5264908
zapB_predicted,0.1111111111111111,8,8,AGGGACAGACCGTAGCGATT,0,5270058
zapB_predicted,0.1111111111111111,8,8,AGGCTGAACTCCGTAGGCCG,0,5280758
zapB_predicted,0.1111111111111111,8,8,AGGCTATAGGATCATTGTAA,0,5284326
zapB_predicted,0.1111111111111111,8,8,AGGCAGCATCCTGGTAGCGG,0,5264851
zapB_predicted,0.1111111111111111,8,8,AGCTTTGGACCATGGCCCTC,0,5271912
zapB_predicted,0.1111111111111111,8,8,AGCATTGCAGCGTGACGTAA,0,5263641
zapB_predicted,0.1111111111111111,8,8,AGATGGAGGAGTTATAGCAT,0,5277206
zapB_predicted,0.1111111111111111,8,8,AGATGCATTGGTGTCCTAAC,0,5280113
zapB_predicted,0.1111111111111111,8,8,AGAGCTGTTGCGAAATTACC,0,5266353
zapB_predicted,0.1111111111111111,8,8,AGAGACTTCTACCGTCCGGG,0,5266476
zapB_predicted,0.1111111111111111,8,8,AGAACACAATGGCGAACGCA,0,5270948
zapB_predicted,0.1111111111111111,8,8,ACTTTGCCAACGGCGCCCAA,0,5278576
zapB_predicted,0.1111111111111111,8,8,ACTGCTGTTCGGAGCGGTCG,0,5279261
zapB_predicted,0.1111111111111111,8,8,ACTCTAGGTGCTGGCGCTTT,0,5279689
zapB_predicted,0.1111111111111111,8,8,ACTACATAGGCAATATGCCG,0,5276555
zapB_predicted,0.1111111111111111,8,8,ACGTGGCAGTACTGTTTCGA,0,5284975
zapB_predicted,0.1111111111111111,8,8,ACGGGTTGGCCGTACTTGAT,0,5268764
zapB_predicted,0.1111111111111111,8,8,ACGATACAGCTGCGTTTTAG,0,5269484
zapB_predicted,0.1111111111111111,8,8,ACGACCTACCCGCAGCTAGA,0,5276987
zapB_predicted,0.1111111111111111,8,8,ACGAAACCGGCTGGGGCGTT,0,5284316
zapB_predicted,0.1111111111111111,8,8,ACCATTCGAGACGGCGGCAA,0,5269852
zapB_predicted,0.1111111111111111,8,8,ACCAACGGTCTAAACCGCGG,0,5272429
zapB_predicted,0.1111111111111111,8,8,AATGCTAGTCGTCTAACCGA,0,5278506
zapB_predicted,0.1111111111111111,8,8,AATATCTTGTCACCCGACGG,0,5275030
zapB_predicted,0.1111111111111111,8,8,AATATAGTAGTTAAGAGCAT,0,5263569
zapB_predicted,0.1111111111111111,8,8,AAGTTGGATCTTTGAACACT,0,5270456
zapB_predicted,0.1111111111111111,8,8,AAGCTTTTTAGGTGCCTGTT,0,5275731
zapB_predicted,0.1111111111111111,8,8,AAGCTGGGCTCCTGCGGTTT,0,5280210
zapB_predicted,0.1111111111111111,8,8,AAGCCGAATTCATCTTACCA,0,5279065
zapB_predicted,0.1111111111111111,8,8,AAGATGGGCACGAATCATTC,0,5287365
zapB_predicted,0.1111111111111111,8,8,AACGTAAAAAAAGTTACATT,0,5271357
zapB_predicted,0.1111111111111111,8,8,AACACGCGCTATTGAGTGGC,0,5287377
zapB_predicted,0.1111111111111111,8,8,AAATGGCCCGACGACCTCTC,0,5286379
zapB_predicted,0.1111111111111111,8,8,AAATATCAGCCGTTATTACT,0,5274572
zapB_predicted,0.1111111111111111,8,8,AAAGATAAAGTCGGTGGAGT,0,5288314
zapB_predicted,0.125,7,7,TTTTCAGGTAGTCGGCCACG,0,5280124
zapB_predicted,0.125,7,7,TTTGCTAGATTCACGTAGCA,0,5273279
zapB_predicted,0.125,7,7,TTTCCTTTATGGCTCAATTC,0,5273562
zapB_predicted,0.125,7,7,TTGTCCTGACGATCAAGGTG,0,5283616
zapB_predicted,0.125,7,7,TTGTACTAAGCCCACCTAGT,0,5286502
zapB_predicted,0.125,7,7,TTGGGTAGGTTGCTCGGGAT,0,5269933
zapB_predicted,0.125,7,7,TTGGGCTCGATGACTATAGG,0,5278926
zapB_predicted,0.125,7,7,TTGGCATCCGCACACGGTTT,0,5263389
zapB_predicted,0.125,7,7,TTGCGCATGCATAATTCGGT,0,5278214
zapB_predicted,0.125,7,7,TTGCCCAGCGGAACCCCCCT,0,5275220
zapB_predicted,0.125,7,7,TTGCAAGGTCGTTAGTACGA,0,5272400
zapB_predicted,0.125,7,7,TTGAGACGTGGAGGCTTCGT,0,5277705
zapB_predicted,0.125,7,7,TTGACTTAAACCGACTCCCA,0,5265108
zapB_predicted,0.125,7,7,TTCGCAGTTGAAATACTCTA,0,5277807
zapB_predicted,0.125,7,7,TTCCCTAAAGGTGCCGCTCA,0,5265122
zapB_predicted,0.125,7,7,TTCCATGACTCCGGGTCGAT,0,5287533
zapB_predicted,0.125,7,7,TTCATAGTAAGTGGCCTTGG,0,5274113
zapB_predicted,0.125,7,7,TTATCTTACCGGGGTCTCAC,0,5264330
zapB_predicted,0.125,7,7,TTAGTCCCAAGGCAGGCACT,0,5287175
zapB_predicted,0.125,7,7,TTAGCTAAATGACTGGACAA,0,5275157
zapB_predicted,0.125,7,7,TTACTAAACTTGTTTTATCC,0,5268612
zapB_predicted,0.125,7,7,TTACGCCAACGGTTTTCTGC,0,5270748
zapB_predicted,0.125,7,7,TGTGGGGAGCTCCTGTGGTT,0,5285962
zapB_predicted,0.125,7,7,TGTGATAAGCGGGGATCACT,0,5280884
zapB_predicted,0.125,7,7,TGTCTCCGTCTCCTGGGAGA,0,5283765
zapB_predicted,0.125,7,7,TGTCTCCGGAAGATTCGAAG,0,5264745
zapB_predicted,0.125,7,7,TGTCCTGGACCGTGAGGTTT,0,5266603
zapB_predicted,0.125,7,7,TGTCCTAGACAATGATCGAG,0,5283343
zapB_predicted,0.125,7,7,TGTCCGGTAGTAAACTATAT,0,5285748
zapB_predicted,0.125,7,7,TGTCCAGGGGGGATTGACAG,0,5284694
zapB_predicted,0.125,7,7,TGTAGGGCCGATAAGAACTT,0,5270121
zapB_predicted,0.125,7,7,TGTAATTAATTTAGGGCCTG,0,5272339
zapB_predicted,0.125,7,7,TGGTGTGCACTGGACAGGCA,0,5284579
zapB_predicted,0.125,7,7,TGGTGTCTCCGTCATTGGTC,0,5271519
zapB_predicted,0.125,7,7,TGGCTTCAAGCATCAATGGA,0,5276689
zapB_predicted,0.125,7,7,TGCCGTGCGCCAACAAATTC,0,5274777
zapB_predicted,0.125,7,7,TGCCCATTAAAGGACTAAGG,0,5266551
zapB_predicted,0.125,7,7,TGCATTTACGGGTCCACCAC,0,5284150
zapB_predicted,0.125,7,7,TGCAAGCGGAGCATATGCGA,0,5277012
zapB_predicted,0.125,7,7,TGCAAATTCCACGACCTTGT,0,5265247
zapB_predicted,0.125,7,7,TGAGCGGTCATCTTCCGCCC,0,5269690
zapB_predicted,0.125,7,7,TGACGGCGGCACAAAGGGCA,0,5277882
zapB_predicted,0.125,7,7,TGACGATTAGAACCGAAGGA,0,5278257
zapB_predicted,0.125,7,7,TGAATAGGTAGCAGAAATGC,0,5275074
zapB_predicted,0.125,7,7,TGAAAGTTCTGTGATGTACA,0,5266782
zapB_predicted,0.125,7,7,TCTTAATTTCAAAACGTGCA,0,5276518
zapB_predicted,0.125,7,7,TCTAGCCTATGCTATTCGAA,0,5269400
zapB_predicted,0.125,7,7,TCTACGGTGAGCCCCTTAAG,0,5263850
zapB_predicted,0.125,7,7,TCGTGATCGTCCCTGGTGAA,0,5274454
zapB_predicted,0.125,7,7,TCGGTCGGCGTCCGGAATGG,0,5287792
zapB_predicted,0.125,7,7,TCGGCATTCAATTGCCACCG,0,5278964
zapB_predicted,0.125,7,7,TCGCTTCTTTGTAAGAATAA,0,5280866
zapB_predicted,0.125,7,7,TCCTAAGGTTTGTTCTCATG,0,5284403
zapB_predicted,0.125,7,7,TCCGGCAAAAGGCCGTCCGC,0,5281376
zapB_predicted,0.125,7,7,TCCGGAGCGCATTAGGGGCA,0,5266477
zapB_predicted,0.125,7,7,TCCCTTATTAAAAGCTCGCG,0,5269774
zapB_predicted,0.125,7,7,TCCCGCCCAGTTGTGCGAAC,0,5275862
zapB_predicted,0.125,7,7,TCCCATTGTCGTCCGCCGCA,0,5278130
zapB_predicted,0.125,7,7,TCCAGGCATTTTTGGTCCCT,0,5285747
zapB_predicted,0.125,7,7,TCATGATAGTCCATTTCATA,0,5288267
zapB_predicted,0.125,7,7,TCAAGACGTATTCGAAGCGG,0,5264279
zapB_predicted,0.125,7,7,TATGTCCGGTATTATGTGCC,0,5265656
zapB_predicted,0.125,7,7,TATCGAAATTAGCTTGCCCG,0,5267078
zapB_predicted,0.125,7,7,TATCCAGCATGGAGTGTTAC,0,5268409
zapB_predicted,0.125,7,7,TATAGCTCATTCGAATTCCC,0,5280000
zapB_predicted,0.125,7,7,TATACCAGTCGGGCTCTCAC,0,5283397
zapB_predicted,0.125,7,7,TAGGGCTCCTTGGTGGTGGC,0,5271863
zapB_predicted,0.125,7,7,TAGGAACCGAGTTGTCCGAG,0,5278427
zapB_predicted,0.125,7,7,TAGCTCGCCAGGTGGAGGGT,0,5274445
zapB_predicted,0.125,7,7,TAGAAAAAAGACTGGTTCCT,0,5285253
zapB_predicted,0.125,7,7,TACTTCGGTCAAGGTTGGAA,0,5285689
zapB_predicted,0.125,7,7,TACTACGTTCGCTTTTACTG,0,5283652
zapB_predicted,0.125,7,7,TACGAAGGGATGCCTCCTAG,0,5282200
zapB_predicted,0.125,7,7,TACCGCGACGACTGTTCATG,0,5281516
zapB_predicted,0.125,7,7,TACCACATATGTTTTTGCGC,0,5285140
zapB_predicted,0.125,7,7,TAATTTGGAGAAGCCGTCAC,0,5287982
zapB_predicted,0.125,7,7,TAATCAATCTTTCACTTTAC,0,5272338
zapB_predicted,0.125,7,7,TAATAACTCCAGTATACCTT,0,5283086
zapB_predicted,0.125,7,7,TAAAGTCACGTTCAGATCAG,0,5278212
zapB_predicted,0.125,7,7,TAAACGAAGTCACGTCAATG,0,5284282
zapB_predicted,0.125,7,7,GTTTACGATCTTGCCGCTCC,0,5281931
zapB_predicted,0.125,7,7,GTTAGGACCCTTTCAGTTCA,0,5266746
zapB_predicted,0.125,7,7,GTTAGCTCCGGCATGTGTGT,0,5268055
zapB_predicted,0.125,7,7,GTGGCGTGAAGGCAGGACGC,0,5283858
zapB_predicted,0.125,7,7,GTGGAGCCCACGCATCAACC,0,5265543
zapB_predicted,0.125,7,7,GTCTTTGTACCACATCCAGT,0,5266395
zapB_predicted,0.125,7,7,GTCGGTTTGCTGACCATATG,0,5274399
zapB_predicted,0.125,7,7,GTCGAGCCTGGCGTCTATTT,0,5271973
zapB_predicted,0.125,7,7,GTCCTCTGGACAGGAATCGA,0,5267245
zapB_predicted,0.125,7,7,GTCATGTATACAGGTCCAAC,0,5276908
zapB_predicted,0.125,7,7,GTCAGCCCATCCCACAAGCG,0,5286194
zapB_predicted,0.125,7,7,GTCACACAGTCACCATGTGG,0,5265076
zapB_predicted,0.125,7,7,GTAACCCAATCATGAAGATA,0,5282027
zapB_predicted,0.125,7,7,GGTTTTCAATGTGCGGCATT,0,5266056
zapB_predicted,0.125,7,7,GGTGGGCCGCAGCAGGGGGG,0,5275395
zapB_predicted,0.125,7,7,GGTGGAGAACTGCTGATACG,0,5287984
zapB_predicted,0.125,7,7,GGTATTTAGAATTATATGGG,0,5268423
zapB_predicted,0.125,7,7,GGTATGTCAGTGTTGGGATC,0,5269299
zapB_predicted,0.125,7,7,GGTACGGCCATCGGTATTTA,0,5284907
zapB_predicted,0.125,7,7,GGGTCGAGCTGGCCTAGGCG,0,5263004
zapB_predicted,0.125,7,7,GGGTCATAATACGCATCGAC,0,5264309
zapB_predicted,0.125,7,7,GGGGTTTGTTTCTTGCATCT,0,5279634
zapB_predicted,0.125,7,7,GGGCTTTACCACGGTCAGTT,0,5274320
zapB_predicted,0.125,7,7,GGGCTCCGTATTGATTGCCT,0,5276041
zapB_predicted,0.125,7,7,GGGCGTAGACCATTATTAAA,0,5283434
zapB_predicted,0.125,7,7,GGCTTCTCACTGACATGATA,0,5285817
zapB_predicted,0.125,7,7,GGCTCCCTGATAACGGCCAT,0,5285606
zapB_predicted,0.125,7,7,GGCTACGAAGAACGAATAGT,0,5287681
zapB_predicted,0.125,7,7,GGCGTAAGCAACGGGGTCAA,0,5280488
zapB_predicted,0.125,7,7,GGCGGTCTATGTTCCGGAAG,0,5275978
zapB_predicted,0.125,7,7,GGCGGGAGTATGGGTCACGT,0,5287930
zapB_predicted,0.125,7,7,GGCCTGTAACTTTCGCCGAC,0,5287057
zapB_predicted,0.125,7,7,GGCCACACGAGACTGTCATG,0,5275280
zapB_predicted,0.125,7,7,GGCAAGGAATCCAACGGCGA,0,5276151
zapB_predicted,0.125,7,7,GGAGGAGGCGTGCCGATCCA,0,5270994
zapB_predicted,0.125,7,7,GGACTCGGATGTGTCTACTG,0,5263735
zapB_predicted,0.125,7,7,GGAAGGACTCAAGGATGGCA,0,5284424
zapB_predicted,0.125,7,7,GGAACCCGTCCGATAAAGTC,0,5281199
zapB_predicted,0.125,7,7,GCTTTGGTATGAATCGTGTT,0,5286145
zapB_predicted,0.125,7,7,GCTTTCCCCGACACATAAAC,0,5286444
zapB_predicted,0.125,7,7,GCTTGGGTCTTCAAAAAGGG,0,5271011
zapB_predicted,0.125,7,7,GCTTCATATGGTCCAACTAT,0,5286906
zapB_predicted,0.125,7,7,GCTTATCACGAATAAGAATA,0,5272367
zapB_predicted,0.125,7,7,GCTGTTCACACTTCTGTAGT,0,5264828
zapB_predicted,0.125,7,7,GCTGGCACGCCGAGCAGGTC,0,5273099
zapB_predicted,0.125,7,7,GCTCTCACTCGCTTTTCAAA,0,5281964
zapB_predicted,0.125,7,7,GCTCGGCAGGAGGCTTCTGA,0,5278412
zapB_predicted,0.125,7,7,GCTATAATCGACTGGCTGAT,0,5273897
zapB_predicted,0.125,7,7,GCGGCATTGAACGACCATTG,0,5281953
zapB_predicted,0.125,7,7,GCGCTACCTCTGCTATATGA,0,5280798
zapB_predicted,0.125,7,7,GCGCGTACCCTTCAAAACTC,0,5268862
zapB_predicted,0.125,7,7,GCCTGTCGCTAGTCCGTTAG,0,5282888
zapB_predicted,0.125,7,7,GCCTCCCAGCAACCGTGGGA,0,5270898
zapB_predicted,0.125,7,7,GCCGCTGTGCTAAGAGACTA,0,5280461
zapB_predicted,0.125,7,7,GCCGATGACGAGGTGAGTAA,0,5285750
zapB_predicted,0.125,7,7,GCCCTGGGCTTGGATCCGGG,0,5267305
zapB_predicted,0.125,7,7,GCAGGGAAGGCTCGTCTGAA,0,5265685
zapB_predicted,0.125,7,7,GCAGCAAGACGTTTATTAGT,0,5284208
zapB_predicted,0.125,7,7,GCACCAGTCAATATCAGTTG,0,5264506
zapB_predicted,0.125,7,7,GCAAGCATAATAGATCCCCT,0,5280535
zapB_predicted,0.125,7,7,GATGCAGTCCCTGTCCGTGA,0,5274646
zapB_predicted,0.125,7,7,GATCTTCCACTCTTCTGGAG,0,5283398
zapB_predicted,0.125,7,7,GATCAGCCTTCCCATGTCAC,0,5265915
zapB_predicted,0.125,7,7,GATCAACCCGAAATCATAGT,0,5268494
zapB_predicted,0.125,7,7,GATATACACAATGGGCAAAA,0,5277143
zapB_predicted,0.125,7,7,GAGTATCGCATTGATCCCCT,0,5269951
zapB_predicted,0.125,7,7,GAGTAGGGCTACTCTTTTAT,0,5278056
zapB_predicted,0.125,7,7,GAGTAGGAGTTCTCGTGGCT,0,5285987
zapB_predicted,0.125,7,7,GAGCGTAAATTTAATGCTTC,0,5281390
zapB_predicted,0.125,7,7,GAGCAATGTTTAGGGTGTAC,0,5277093
zapB_predicted,0.125,7,7,GAGATACGTAAAATGGTCCC,0,5288303
zapB_predicted,0.125,7,7,GACTGTGGCGCTCATTATGT,0,5273565
zapB_predicted,0.125,7,7,GACTGACGAAACTTGTAAGG,0,5285191
zapB_predicted,0.125,7,7,GACGCTTGCTATCAGTTGAC,0,5264935
zapB_predicted,0.125,7,7,GACCTTTGTTCCATGGATGT,0,5269034
zapB_predicted,0.125,7,7,GACATACGAATATCTGGTTG,0,5270917
zapB_predicted,0.125,7,7,GACAGCGCTTCGACTCATGG,0,5286410
zapB_predicted,0.125,7,7,GAATCATAGTCATTCACTGT,0,5268762
zapB_predicted,0.125,7,7,GAAGTCAACTTACACTCGGC,0,5275333
zapB_predicted,0.125,7,7,GAAGTATAAGGCCGCCAACA,0,5285063
zapB_predicted,0.125,7,7,GAAGGTAGTTGTTGTTCAGC,0,5265202
zapB_predicted,0.125,7,7,GAACTGACGTACGTGCTCAT,0,5281310
zapB_predicted,0.125,7,7,GAACGCCTACCACTCCTTGA,0,5271470
zapB_predicted,0.125,7,7,GAAAGTAGTCACGAGATCCA,0,5271315
zapB_predicted,0.125,7,7,CTTTCACAAGGGCGCGTAAG,0,5271991
zapB_predicted,0.125,7,7,CTGTTTTAAATGAAACCTTC,0,5276091
zapB_predicted,0.125,7,7,CTGGCGATTGTCACTTGATG,0,5265582
zapB_predicted,0.125,7,7,CTGCAACAAGCACTGCGAGC,0,5276164
zapB_predicted,0.125,7,7,CTGACAGGCGACCCACGCCT,0,5277021
zapB_predicted,0.125,7,7,CTCTTTTCTTGTTGACCATT,0,5265999
zapB_predicted,0.125,7,7,CTCTTTCCTATATCCAAATG,0,5273882
zapB_predicted,0.125,7,7,CTCTTTCCACTTAATGCAGC,0,5281598
zapB_predicted,0.125,7,7,CTCGCTGAAATCCGCAGTCT,0,5279688
zapB_predicted,0.125,7,7,CTCCGTGCAGAGCGTCGTTC,0,5275158
zapB_predicted,0.125,7,7,CTCATCATACCTCGTCACGA,0,5265252
zapB_predicted,0.125,7,7,CTCACTGGGTGGTCGGCATA,0,5264144
zapB_predicted,0.125,7,7,CTATTTTCTCCCCCGGACAC,0,5275363
zapB_predicted,0.125,7,7,CTATTGTAAGAAAAGTTTCG,0,5267678
zapB_predicted,0.125,7,7,CTATCGGCTATCTGTCAGTC,0,5273232
zapB_predicted,0.125,7,7,CTATAGCAACATATAGATGG,0,5279995
zapB_predicted,0.125,7,7,CTATACTTCAAGACTTTAAT,0,5282302
zapB_predicted,0.125,7,7,CTAGGGTTTGGTAAGGCGGG,0,5285237
zapB_predicted,0.125,7,7,CTAGCTACGTAAACTGGTTT,0,5283717
zapB_predicted,0.125,7,7,CTACTGCTTGTCGTTAAAGT,0,5277575
zapB_predicted,0.125,7,7,CTACCTGAACAGCGCCTGCA,0,5271624
zapB_predicted,0.125,7,7,CTACCGTTAGTCTCGCGGAC,0,5282722
zapB_predicted,0.125,7,7,CTAAAATCCTTATAGAGGTG,0,5285965
zapB_predicted,0.125,7,7,CGTTAATATTTGGGAATATC,0,5271927
zapB_predicted,0.125,7,7,CGTCGGATCGTTGGGTAGTA,0,5286369
zapB_predicted,0.125,7,7,CGTAGCGGCTCCACATTTTT,0,5285366
zapB_predicted,0.125,7,7,CGTAATAAGTGAACGGACAG,0,5284133
zapB_predicted,0.125,7,7,CGGTTAAATCCCCTCGCTAT,0,5278855
zapB_predicted,0.125,7,7,CGGTGGTACATTTCCGTCAT,0,5281984
zapB_predicted,0.125,7,7,CGGTGGGATGCAACCTATTT,0,5286678
zapB_predicted,0.125,7,7,CGGTATAAGTCACCCGGATG,0,5276718
zapB_predicted,0.125,7,7,CGGGAGGGGCGACCTTTAAA,0,5284389
zapB_predicted,0.125,7,7,CGGCTCTCATACTATCGGGG,0,5270178
zapB_predicted,0.125,7,7,CGGCGACCAGTAATCCTTAG,0,5280050
zapB_predicted,0.125,7,7,CGGCCTCATTCCGCAGTGAT,0,5281284
zapB_predicted,0.125,7,7,CGGCCCGCCAACTAGGTTGA,0,5280527
zapB_predicted,0.125,7,7,CGGCAATCAATACGAGAAAA,0,5283712
zapB_predicted,0.125,7,7,CGGAGCACTTAGCTTCAGAG,0,5287366
zapB_predicted,0.125,7,7,CGCTGCGTTGGCTAGACGTC,0,5275510
zapB_predicted,0.125,7,7,CGCGGTACCGATGCTTTACA,0,5266747
zapB_predicted,0.125,7,7,CGCGCACCTGTGAAAATCCG,0,5279245
zapB_predicted,0.125,7,7,CGCGACAGGTACGTCTTTAG,0,5277059
zapB_predicted,0.125,7,7,CGCACGGTTCGTCCTTTGCG,0,5273761
zapB_predicted,0.125,7,7,CGATGGAGAATCGCGCGCCT,0,5280894
zapB_predicted,0.125,7,7,CGATGACTTCGTTCTGAATA,0,5269434
zapB_predicted,0.125,7,7,CGACCGGCCGCATTTTCAAT,0,5284879
zapB_predicted,0.125,7,7,CGAACGAAACTGTACCTCTC,0,5270902
zapB_predicted,0.125,7,7,CCTTCTAATGCCCTAAGGGT,0,5263435
zapB_predicted,0.125,7,7,CCTGTCCGGCGTCCGTACTC,0,5278903
zapB_predicted,0.125,7,7,CCTGGATCAACACGTTGTCG,0,5270775
zapB_predicted,0.125,7,7,CCTGCCGTATGGTATGCGAT,0,5282649
zapB_predicted,0.125,7,7,CCTCGTGTGACAGAGCAATT,0,5276717
zapB_predicted,0.125,7,7,CCTAGGGAAAGCTTTCTACA,0,5271381
zapB_predicted,0.125,7,7,CCTACAGCGTAACTCAATAG,0,5275954
zapB_predicted,0.125,7,7,CCGTTACGACCACGGGACGC,0,5276866
zapB_predicted,0.125,7,7,CCGTAACACTCTCGGCGCCA,0,5283159
zapB_predicted,0.125,7,7,CCGGCTCCATCATCTGCTCA,0,5287746
zapB_predicted,0.125,7,7,CCGCTCTAAGGAGATGCTGT,0,5284827
zapB_predicted,0.125,7,7,CCGAGCCGAACCGTCACTTT,0,5287882
zapB_predicted,0.125,7,7,CCGAAGGATAATAGCGCGTT,0,5281666
zapB_predicted,0.125,7,7,CCCTGCGAGGTTGGATGGCG,0,5269483
zapB_predicted,0.125,7,7,CCCGAGCAGCCCGGATTAAG,0,5264462
zapB_predicted,0.125,7,7,CCCCCATTGGTTAACTCGTA,0,5270327
zapB_predicted,0.125,7,7,CCCCAGCGGTAATTGGTGAT,0,5273544
zapB_predicted,0.125,7,7,CCCAGGTCGAAACCGGCAAA,0,5270062
zapB_predicted,0.125,7,7,CCATCTCGGCGGCCAGGTAG,0,5281254
zapB_predicted,0.125,7,7,CCATCAACCTCGCGACCTAT,0,5267077
zapB_predicted,0.125,7,7,CCACGCGTTATTCGAATTAA,0,5275374
zapB_predicted,0.125,7,7,CCACCGTCGTCATTGAGGAA,0,5276112
zapB_predicted,0.125,7,7,CCAAAGTCCTGGACCAGGGA,0,5287420
zapB_predicted,0.125,7,7,CATTGGGATCATACTGATGT,0,5286111
zapB_predicted,0.125,7,7,CATGCCAAACTCGCACGGGG,0,5279743
zapB_predicted,0.125,7,7,CATGCAGATGCGGGCCAAGT,0,5274297
zapB_predicted,0.125,7,7,CATCATAATTCTCGTCAGAA,0,5286557
zapB_predicted,0.125,7,7,CATAAGGTTGTCGCATTGCA,0,5270189
zapB_predicted,0.125,7,7,CAGTCCCTCTATCCGTCAGG,0,5287174
zapB_predicted,0.125,7,7,CAGTACTTGCGTGTCTCTAT,0,5286461
zapB_predicted,0.125,7,7,CAGGCTAACACCGATTAATT,0,5287017
zapB_predicted,0.125,7,7,CAGGAGTAGTACAAGTTGTC,0,5272845
zapB_predicted,0.125,7,7,CACTTGGGTCATCCAGTACT,0,5281772
zapB_predicted,0.125,7,7,CACTGACAGATGTATTCTGC,0,5266697
zapB_predicted,0.125,7,7,CACTAAGACCCTAGTCCTGC,0,5283345
zapB_predicted,0.125,7,7,CACCGGATTCCCTATGGACA,0,5272441
zapB_predicted,0.125,7,7,CACCGAGTTGGGCGGTTGGA,0,5281140
zapB_predicted,0.125,7,7,CACCACGAGGTGCAGAATGC,0,5268905
zapB_predicted,0.125,7,7,CACCAAATCGAACTCATTGG,0,5282574
zapB_predicted,0.125,7,7,CAATTTACTAATAAGAATGT,0,5284169
zapB_predicted,0.125,7,7,CAATTCGTAGCACGATCTGA,0,5263012
zapB_predicted,0.125,7,7,CAAGCAATCATAAACATATC,0,5275751
zapB_predicted,0.125,7,7,CAAGAAAACCTCTGGCAATA,0,5269740
zapB_predicted,0.125,7,7,ATTGGTGTTGCAGGGCAGAT,0,5281659
zapB_predicted,0.125,7,7,ATTCGTCATCAGGAGTAAAA,0,5287372
zapB_predicted,0.125,7,7,ATTCGGGCCGGAAATTTCAC,0,5274240
zapB_predicted,0.125,7,7,ATGTGGCTTTTGTCCCAGGA,0,5274837
zapB_predicted,0.125,7,7,ATGTATAGCACCATGATTCA,0,5266449
zapB_predicted,0.125,7,7,ATGGTGGAAATAAGGGATTT,0,5284044
zapB_predicted,0.125,7,7,ATGGGGGGATAATTGATGTT,0,5266226
zapB_predicted,0.125,7,7,ATGAGGTCAATCGAGCCCTA,0,5282780
zapB_predicted,0.125,7,7,ATCTTTGGTTGTCCTAGCAA,0,5287435
zapB_predicted,0.125,7,7,ATCTGTAGTAGGTAAGGTTC,0,5272243
zapB_predicted,0.125,7,7,ATCGTCAAAAACTGCCATGG,0,5278284
zapB_predicted,0.125,7,7,ATCGGTTCAGCAACAGCAAC,0,5273405
zapB_predicted,0.125,7,7,ATCGCTGAGGTGACTATCAC,0,5268996
zapB_predicted,0.125,7,7,ATCGAGATATTGTGTAGGTC,0,5278171
zapB_predicted,0.125,7,7,ATCGACTCAGATTGGAATCC,0,5286082
zapB_predicted,0.125,7,7,ATCCTACATTTAGTTGCGTT,0,5279108
zapB_predicted,0.125,7,7,ATCCGTGTGGTTGGTAGAAA,0,5283420
zapB_predicted,0.125,7,7,ATCCGTCTGTTCGTCGGCAT,0,5282816
zapB_predicted,0.125,7,7,ATCCGTAAAAGCTGGAGTTT,0,5268327
zapB_predicted,0.125,7,7,ATATAGTTAGGCGTTCTAGA,0,5273410
zapB_predicted,0.125,7,7,ATACCATTTGCCGCTTGTAA,0,5283050
zapB_predicted,0.125,7,7,ATACCAACCTTGTCAGCCTT,0,5264189
zapB_predicted,0.125,7,7,ATAATTGATCGCAGAACAGA,0,5272205
zapB_predicted,0.125,7,7,ATAAGGGACTAGGCCTATAA,0,5284471
zapB_predicted,0.125,7,7,ATAACTGGCCATTGTTGGAC,0,5272262
zapB_predicted,0.125,7,7,ATAAAATTTCTGAAAATCTA,0,5287983
zapB_predicted,0.125,7,7,AGTTTCATAACTCAATGCAT,0,5267399
zapB_predicted,0.125,7,7,AGTGGTGTGCAGCCTACAAC,0,5285701
zapB_predicted,0.125,7,7,AGTCTTGGTCAATAGTAGGC,0,5282958
zapB_predicted,0.125,7,7,AGTCCAGCGTCGAGTTTGAG,0,5270573
zapB_predicted,0.125,7,7,AGTCAGGCACCCTCATTCGT,0,5270579
zapB_predicted,0.125,7,7,AGTAGACGAGATGACTGACG,0,5265471
zapB_predicted,0.125,7,7,AGTACCCGTGGTCAATACAT,0,5267302
zapB_predicted,0.125,7,7,AGTAAGACCTCCGGCGACAT,0,5279923
zapB_predicted,0.125,7,7,AGTAAAGGATGTGCCGCACA,0,5274110
zapB_predicted,0.125,7,7,AGGTGCAGGCCACGGTCAGT,0,5280594
zapB_predicted,0.125,7,7,AGGTGAGGAATAGAACAATA,0,5272818
zapB_predicted,0.125,7,7,AGGTATAGTCACTCCACCTA,0,5279429
zapB_predicted,0.125,7,7,AGGGGCACTAGAGTCCGATT,0,5272462
zapB_predicted,0.125,7,7,AGGGATAGGACACTGATGAT,0,5268933
zapB_predicted,0.125,7,7,AGGCCACCGGGCAGTCGAGC,0,5287894
zapB_predicted,0.125,7,7,AGGACTCGCCAATCACCGAA,0,5285552
zapB_predicted,0.125,7,7,AGCGTCAACGAATGTGCTGG,0,5266821
zapB_predicted,0.125,7,7,AGCGCCTAATTTGTCCTTCA,0,5282626
zapB_predicted,0.125,7,7,AGCCGTCGGGAAATTGGCTC,0,5280772
zapB_predicted,0.125,7,7,AGAGGGATAAACCAATCCTT,0,5275880
zapB_predicted,0.125,7,7,AGAGCTTTTTCGACCTTAGG,0,5284014
zapB_predicted,0.125,7,7,AGAACTACGTGATTCACACA,0,5277937
zapB_predicted,0.125,7,7,ACTTTTATCTAGGGTTGGGT,0,5282658
zapB_predicted,0.125,7,7,ACTGTGTTCTATGTGTACAC,0,5270621
zapB_predicted,0.125,7,7,ACTGGCTCATTCCTGATAGT,0,5269966
zapB_predicted,0.125,7,7,ACTCTAAGCACAAAATGCCT,0,5285697
zapB_predicted,0.125,7,7,ACTAGAGCGCGCCCGAAATC,0,5267120
zapB_predicted,0.125,7,7,ACGTCCGGTAGCTTCCGACT,0,5282384
zapB_predicted,0.125,7,7,ACGGGCGGCTTGTCTGTGCA,0,5279036
zapB_predicted,0.125,7,7,ACGCTTGCACCAAAGAGTAC,0,5264516
zapB_predicted,0.125,7,7,ACGCGACAGCTGGTCACTAT,0,5275711
zapB_predicted,0.125,7,7,ACGAGCATAGGTGCGGGGAT,0,5279832
zapB_predicted,0.125,7,7,ACGAACTAGGGCATGCCGCT,0,5285226
zapB_predicted,0.125,7,7,ACGAAACCCCTATTTACTAG,0,5274963
zapB_predicted,0.125,7,7,ACGAAACCAGCAAAGGATTT,0,5278949
zapB_predicted,0.125,7,7,ACCGGCCTTAGCCTTTACTA,0,5285161
zapB_predicted,0.125,7,7,ACCATTCTTGTCTCCGCTAC,0,5276425
zapB_predicted,0.125,7,7,ACCAGAGGGATGGAAAACTT,0,5275278
zapB_predicted,0.125,7,7,ACCACGCGTCCCTTTTTGGT,0,5278244
zapB_predicted,0.125,7,7,ACCAAATCACGAGCCGATTA,0,5269753
zapB_predicted,0.125,7,7,ACATTTCGTATGGCCTGGAC,0,5285499
zapB_predicted,0.125,7,7,ACAGGTTTTATATTAGCCAG,0,5281367
zapB_predicted,0.125,7,7,ACACTGAATCGCCCGGGCGC,0,5283476
zapB_predicted,0.125,7,7,AATTTTTCTTACGATCGAGG,0,5285157
zapB_predicted,0.125,7,7,AATTTAACATCAGCGCGTGA,0,5286116
zapB_predicted,0.125,7,7,AATTCTTAGACTAACTGCGA,0,5285702
zapB_predicted,0.125,7,7,AATTATACGTACGGCAAAAT,0,5282033
zapB_predicted,0.125,7,7,AATCGCCTTACTTGATAGGT,0,5264412
zapB_predicted,0.125,7,7,AATAGGGTATTCTTTTTCTA,0,5263194
zapB_predicted,0.125,7,7,AATAATCCTTGTTTGGGTAT,0,5285946
zapB_predicted,0.125,7,7,AAGTTAGGGGTTCTTGTGCT,0,5274969
zapB_predicted,0.125,7,7,AAGTGCGTGGTAAGAGCGGT,0,5282003
zapB_predicted,0.125,7,7,AAGTCAACAAAGTGTCAGGT,0,5284767
zapB_predicted,0.125,7,7,AAGTAACGTCCGAACGTGCG,0,5285740
zapB_predicted,0.125,7,7,AAGCGCTACTATTCTAGAAT,0,5273541
zapB_predicted,0.125,7,7,AAGATTGGAGATGTAGGGTT,0,5285326
zapB_predicted,0.125,7,7,AACTGCGTCGAACGGAAACT,0,5267249
zapB_predicted,0.125,7,7,AACTAGAGAGTAACCGGATG,0,5272806
zapB_predicted,0.125,7,7,AACGGTACCGACAGCAGGAT,0,5273317
zapB_predicted,0.125,7,7,AACCGGATGCGCTTTTAGTC,0,5278397
zapB_predicted,0.125,7,7,AACCGAGGTAGAGCTGCACG,0,5284915
zapB_predicted,0.125,7,7,AACACACATCCACGGCTTCC,0,5264563
zapB_predicted,0.125,7,7,AAATCTGACTCATTCATCAC,0,5284489
zapB_predicted,0.125,7,7,AAACGCCAGGAACGCTCTAA,0,5263297
zapB_predicted,0.125,7,7,AAAATCCAGCGACTGTGTTG,0,5281212
zapB_predicted,0.125,7,7,AAAATAGTGCGACTAGGTAT,0,5274406
zapB_predicted,0.125,7,7,AAAACGGTTATGATGGGTGG,0,5273275
zapB_predicted,0.14285714285714285,6,6,TTTTGTCAGAAAGCTCTGGT,0,5273396
zapB_predicted,0.14285714285714285,6,6,TTTGGCTGACTACTACAACA,0,5273934
zapB_predicted,0.14285714285714285,6,6,TTTGCGACACACGTAATGGC,0,5263881
zapB_predicted,0.14285714285714285,6,6,TTTCTACGTGATATCGCCGA,0,5278307
zapB_predicted,0.14285714285714285,6,6,TTTCCAAAAAACCAGCATAA,0,5270424
zapB_predicted,0.14285714285714285,6,6,TTTCAGCCATGGAGCTTTCT,0,5272288
zapB_predicted,0.14285714285714285,6,6,TTGTTTAGGAGCTTCTCACC,0,5273474
zapB_predicted,0.14285714285714285,6,6,TTGTCCGTGCTACCATAGCA,0,5266025
zapB_predicted,0.14285714285714285,6,6,TTGTCCGATAGAGTGGGCAA,0,5287311
zapB_predicted,0.14285714285714285,6,6,TTGTAGGCAGCCAGGTGGCG,0,5279721
zapB_predicted,0.14285714285714285,6,6,TTGGTTAGGCAGGGCTTAGG,0,5269117
zapB_predicted,0.14285714285714285,6,6,TTGGCCGGATTAGCCTAGAA,0,5264004
zapB_predicted,0.14285714285714285,6,6,TTGGATATGCGTAGTGCAAT,0,5274949
zapB_predicted,0.14285714285714285,6,6,TTGCTACTGTCCATGTCAGT,0,5271383
zapB_predicted,0.14285714285714285,6,6,TTGCCGTTTCTACAGGTGTA,0,5288005
zapB_predicted,0.14285714285714285,6,6,TTGATTAACATTCGCTATGC,0,5283740
zapB_predicted,0.14285714285714285,6,6,TTCTGTCTGGTTGATAGGCG,0,5279678
zapB_predicted,0.14285714285714285,6,6,TTCTCTGGTCACGCGGCCCC,0,5273407
zapB_predicted,0.14285714285714285,6,6,TTCGGTTCCAGTGCCGGTTT,0,5265070
zapB_predicted,0.14285714285714285,6,6,TTCAGAATCGTCAGGTTGAG,0,5271791
zapB_predicted,0.14285714285714285,6,6,TTATTTCGCAGCCCTCTTAT,0,5270048
zapB_predicted,0.14285714285714285,6,6,TTATCGCGGCTGGTCCCACG,0,5277928
zapB_predicted,0.14285714285714285,6,6,TTAGAGTGCAGAATGCCGGG,0,5265088
zapB_predicted,0.14285714285714285,6,6,TTACTGGGCTGTCGGAAGTA,0,5265850
zapB_predicted,0.14285714285714285,6,6,TTAATCACAGGTACAGGTGT,0,5271073
zapB_predicted,0.14285714285714285,6,6,TGTGCTGATTGGTGGTTTTG,0,5286449
zapB_predicted,0.14285714285714285,6,6,TGTGCGCAGTCAGTAAATTA,0,5280757
zapB_predicted,0.14285714285714285,6,6,TGTGAGAGCGTATTGTGCAA,0,5272120
zapB_predicted,0.14285714285714285,6,6,TGTCCGAGGTGGATTGGCGG,0,5280793
zapB_predicted,0.14285714285714285,6,6,TGTATCGGGCGGGGGAAGGC,0,5280806
zapB_predicted,0.14285714285714285,6,6,TGTACTGTATCGTCTTCTGC,0,5269994
zapB_predicted,0.14285714285714285,6,6,TGGTTTTTATTGGGTCGAAA,0,5271818
zapB_predicted,0.14285714285714285,6,6,TGGTGTAGGCGCGAGTGAGA,0,5285454
zapB_predicted,0.14285714285714285,6,6,TGGTAGGGTAAATCACGGGG,0,5270544
zapB_predicted,0.14285714285714285,6,6,TGGGGTGCTCCGCTGGGGAT,0,5282466
zapB_predicted,0.14285714285714285,6,6,TGGCTGTGCGCCACATTCCC,0,5271785
zapB_predicted,0.14285714285714285,6,6,TGGCGGCTCAAAGTTGGGTT,0,5280045
zapB_predicted,0.14285714285714285,6,6,TGGCCACACTTGGTAATTGT,0,5278555
zapB_predicted,0.14285714285714285,6,6,TGGCCAAGACGGTATGAAAC,0,5269444
zapB_predicted,0.14285714285714285,6,6,TGGCAGCCGTCCCGCAATTG,0,5263522
zapB_predicted,0.14285714285714285,6,6,TGGATCAGGAAGATCATCGT,0,5275573
zapB_predicted,0.14285714285714285,6,6,TGGACTAGCCAGGTCTGAGA,0,5264707
zapB_predicted,0.14285714285714285,6,6,TGGACGGTTTTCTGATTAAC,0,5270575
zapB_predicted,0.14285714285714285,6,6,TGCTTTCTCCGATAGGGAAC,0,5272680
zapB_predicted,0.14285714285714285,6,6,TGCGCCATCCGAACACTATA,0,5266249
zapB_predicted,0.14285714285714285,6,6,TGCCTTCGTTAGCACCCTCT,0,5274429
zapB_predicted,0.14285714285714285,6,6,TGCCATCAGATTTCGAACGC,0,5288241
zapB_predicted,0.14285714285714285,6,6,TGAGCCGAAAGGAAGGCGCA,0,5283346
zapB_predicted,0.14285714285714285,6,6,TGACGGAGAGGGTGCGTTAC,0,5268476
zapB_predicted,0.14285714285714285,6,6,TGACGGAATCATTAAGATTG,0,5276634
zapB_predicted,0.14285714285714285,6,6,TGAAGCCGTCGAGAAACAGC,0,5263308
zapB_predicted,0.14285714285714285,6,6,TCTTTCAGTTTTCAGCGGAC,0,5265078
zapB_predicted,0.14285714285714285,6,6,TCTTCCTGACATAGGATGCT,0,5267978
zapB_predicted,0.14285714285714285,6,6,TCTTAGCAAACACTAATGGT,0,5274604
zapB_predicted,0.14285714285714285,6,6,TCTCGGTTACGCGAAGGGAT,0,5264936
zapB_predicted,0.14285714285714285,6,6,TCTACCCGAGTTTTCAATAT,0,5282745
zapB_predicted,0.14285714285714285,6,6,TCGTGTTTTCGCAGGTTCGA,0,5282199
zapB_predicted,0.14285714285714285,6,6,TCGTGTGTAGGGAGGTCGGA,0,5265520
zapB_predicted,0.14285714285714285,6,6,TCGTCATTTGGACCTCTAAG,0,5282258
zapB_predicted,0.14285714285714285,6,6,TCGTCAAAACCAGCTGTGTC,0,5287831
zapB_predicted,0.14285714285714285,6,6,TCGGTGCGCTCCGGTGTACA,0,5278848
zapB_predicted,0.14285714285714285,6,6,TCGGCGATAGCCAAGTGGTT,0,5265255
zapB_predicted,0.14285714285714285,6,6,TCGCGGGTATGATAATCTTT,0,5274664
zapB_predicted,0.14285714285714285,6,6,TCGAGCAACTCAACCTCGGA,0,5265623
zapB_predicted,0.14285714285714285,6,6,TCCTGTCCGATTCGTCTGTA,0,5270673
zapB_predicted,0.14285714285714285,6,6,TCCTCGCACGCATACTTAAT,0,5275973
zapB_predicted,0.14285714285714285,6,6,TCCTATATACTACCCCGCGA,0,5264792
zapB_predicted,0.14285714285714285,6,6,TCCCCGTAAGGGGACGGGGG,0,5265907
zapB_predicted,0.14285714285714285,6,6,TCCAAGTCTCGTTCGCCAGT,0,5279598
zapB_predicted,0.14285714285714285,6,6,TCATGTTAACAGTGTCTGCG,0,5280248
zapB_predicted,0.14285714285714285,6,6,TCATCCTGTTCAGTGTCTTC,0,5279728
zapB_predicted,0.14285714285714285,6,6,TCATCCAAGCGTCCTTACGC,0,5283698
zapB_predicted,0.14285714285714285,6,6,TCATCATTTTGTGGCGGAGT,0,5271166
zapB_predicted,0.14285714285714285,6,6,TCAGTTTATTAAACTTGTGT,0,5286198
zapB_predicted,0.14285714285714285,6,6,TCACTACTCTACATAAGTAA,0,5274380
zapB_predicted,0.14285714285714285,6,6,TCACTAAGCTGCTATAGGTC,0,5264073
zapB_predicted,0.14285714285714285,6,6,TCACGTATGTCGATACCTGT,0,5264483
zapB_predicted,0.14285714285714285,6,6,TCACGCAATGCCGAAGGGGT,0,5284568
zapB_predicted,0.14285714285714285,6,6,TCAATCGCTGCAGCCTTGGG,0,5280285
zapB_predicted,0.14285714285714285,6,6,TCAAGTGTAAGGATTTTGGG,0,5286766
zapB_predicted,0.14285714285714285,6,6,TCAAAAGCCATCCTTGTTGC,0,5274932
zapB_predicted,0.14285714285714285,6,6,TATTGTGCTTGCAAGATGGA,0,5264477
zapB_predicted,0.14285714285714285,6,6,TATTCGTCAGGTTAGCTCTT,0,5271899
zapB_predicted,0.14285714285714285,6,6,TATGGGGAAGTCCCTATATT,0,5265463
zapB_predicted,0.14285714285714285,6,6,TATCCGAGCCCCCAGGACGT,0,5278829
zapB_predicted,0.14285714285714285,6,6,TATAGTGTTAACGTGTAAGT,0,5282933
zapB_predicted,0.14285714285714285,6,6,TATAGTGCTGTGAGTCTCAA,0,5277522
zapB_predicted,0.14285714285714285,6,6,TATAGATCTGGGGTATTAGT,0,5281540
zapB_predicted,0.14285714285714285,6,6,TATACGACTGGAATATGGGG,0,5283651
zapB_predicted,0.14285714285714285,6,6,TATAAACGCGGACAGTTCTT,0,5263040
zapB_predicted,0.14285714285714285,6,6,TAGGCGTCCAAGGCAGATGG,0,5282463
zapB_predicted,0.14285714285714285,6,6,TAGGCGGACGGGGACGGACA,0,5272622
zapB_predicted,0.14285714285714285,6,6,TAGGAACACGTGTGGTCCAT,0,5279208
zapB_predicted,0.14285714285714285,6,6,TAGGAAAATAGGGAAGAGTT,0,5273930
zapB_predicted,0.14285714285714285,6,6,TAGCGAACTTGTTATCACTA,0,5275468
zapB_predicted,0.14285714285714285,6,6,TAGCAGTTGCCATTTTTACA,0,5285927
zapB_predicted,0.14285714285714285,6,6,TAGCAAGAAACCAGTATCGG,0,5286661
zapB_predicted,0.14285714285714285,6,6,TAGACCGATCGCTAACGGCA,0,5280058
zapB_predicted,0.14285714285714285,6,6,TACGTGCCCCACGTGTAGGG,0,5263187
zapB_predicted,0.14285714285714285,6,6,TACCAACCGGCGCTCACGCT,0,5286659
zapB_predicted,0.14285714285714285,6,6,TACACGCAAGGAGTTTTTAA,0,5281109
zapB_predicted,0.14285714285714285,6,6,TACACAGGGATTAGGAACTG,0,5278909
zapB_predicted,0.14285714285714285,6,6,TAATGACAGCAGGTGCTTAC,0,5270938
zapB_predicted,0.14285714285714285,6,6,TAATCTGGAATGACAGCAAC,0,5285865
zapB_predicted,0.14285714285714285,6,6,TAAGTCGGGGTAGACGTGGA,0,5273171
zapB_predicted,0.14285714285714285,6,6,TAAGAGTGGCCCTGTTGCTC,0,5264652
zapB_predicted,0.14285714285714285,6,6,TAACTCCCGCCAACGTCAAA,0,5272979
zapB_predicted,0.14285714285714285,6,6,GTTTTGAATATAAGTGCCGA,0,5263531
zapB_predicted,0.14285714285714285,6,6,GTTTTAGTCCATGCACAAAT,0,5264847
zapB_predicted,0.14285714285714285,6,6,GTTTGTCTCCGGGTACTGTG,0,5274875
zapB_predicted,0.14285714285714285,6,6,GTTCTTGGACTTTATAGGTA,0,5263386
zapB_predicted,0.14285714285714285,6,6,GTTCTCCTCGCGTCCCCGGA,0,5268211
zapB_predicted,0.14285714285714285,6,6,GTTACGAGACTAGGTCTCTA,0,5279004
zapB_predicted,0.14285714285714285,6,6,GTTACCCGCGGTCGGCAAAT,0,5275531
zapB_predicted,0.14285714285714285,6,6,GTGTCCGACGAAGTTCGCGG,0,5279753
zapB_predicted,0.14285714285714285,6,6,GTGGTATGACGTTCGGCCTT,0,5269471
zapB_predicted,0.14285714285714285,6,6,GTGAGCTTAGGCAAAAGCAA,0,5266523
zapB_predicted,0.14285714285714285,6,6,GTGACGGGCGGGCAGGTGGT,0,5285738
zapB_predicted,0.14285714285714285,6,6,GTGACGCAATTTTATGGGTT,0,5275110
zapB_predicted,0.14285714285714285,6,6,GTCTGCTAGCTGCTATCAAT,0,5269277
zapB_predicted,0.14285714285714285,6,6,GTCTCCGCTGGAATCCGTCT,0,5277394
zapB_predicted,0.14285714285714285,6,6,GTCGAACTTCGCTGCGCGTA,0,5264553
zapB_predicted,0.14285714285714285,6,6,GTCCTCAAAAGGGAATCCCA,0,5285873
zapB_predicted,0.14285714285714285,6,6,GTCAGTAGAGCACGGTACCT,0,5275940
zapB_predicted,0.14285714285714285,6,6,GTCACTTGTTGTGCGAAGTC,0,5267390
zapB_predicted,0.14285714285714285,6,6,GTCAACCTGTTGACGACTAT,0,5281935
zapB_predicted,0.14285714285714285,6,6,GTATGTTCAGTACTGTTCTG,0,5272081
zapB_predicted,0.14285714285714285,6,6,GTATGGTGACAGATTCGTGG,0,5277638
zapB_predicted,0.14285714285714285,6,6,GTAGGGGCTCGTCGTTACTT,0,5273472
zapB_predicted,0.14285714285714285,6,6,GTACTCATCGACACGCAACG,0,5284042
zapB_predicted,0.14285714285714285,6,6,GTAAGGGGTCTTGTGTGTTC,0,5276540
zapB_predicted,0.14285714285714285,6,6,GGTTTTGTTCTGACGACACC,0,5280852
zapB_predicted,0.14285714285714285,6,6,GGTTTGACAGTGCGACTACT,0,5266910
zapB_predicted,0.14285714285714285,6,6,GGTTAGGTAGCATGGCCATA,0,5281576
zapB_predicted,0.14285714285714285,6,6,GGTTAATGGAAAAGAAAGCC,0,5266777
zapB_predicted,0.14285714285714285,6,6,GGTTAACGGGGCGGTGACAT,0,5267162
zapB_predicted,0.14285714285714285,6,6,GGTGTAAAATTAGCGTTGCA,0,5267103
zapB_predicted,0.14285714285714285,6,6,GGTGGTCTTGGATAGCACCG,0,5287824
zapB_predicted,0.14285714285714285,6,6,GGTGAGTAATGCACGAGGCC,0,5274620
zapB_predicted,0.14285714285714285,6,6,GGTATGAAGCTTTAAGAAGA,0,5279654
zapB_predicted,0.14285714285714285,6,6,GGTAACAAAGCCCGTCCGCG,0,5286957
zapB_predicted,0.14285714285714285,6,6,GGGGGACTTAAGGGAGCGCA,0,5286895
zapB_predicted,0.14285714285714285,6,6,GGGGGAAATCTCGGTCAACC,0,5265712
zapB_predicted,0.14285714285714285,6,6,GGGGATAGTAGGTGCTATGT,0,5285370
zapB_predicted,0.14285714285714285,6,6,GGGGAGCTGATTAGGGGAAC,0,5287596
zapB_predicted,0.14285714285714285,6,6,GGGGAGAAAACTGCGTAAGG,0,5276046
zapB_predicted,0.14285714285714285,6,6,GGGCGCGAGAGGGTGTTACT,0,5265576
zapB_predicted,0.14285714285714285,6,6,GGGAGGGTCTTACTTGAGGA,0,5285411
zapB_predicted,0.14285714285714285,6,6,GGGAGAACCGTTAGTCTGAG,0,5264295
zapB_predicted,0.14285714285714285,6,6,GGGACGTGACCTAACTATTG,0,5275204
zapB_predicted,0.14285714285714285,6,6,GGGAACCGGTCCTCATAAGT,0,5287747
zapB_predicted,0.14285714285714285,6,6,GGCTTGGTCCGTTTCACATC,0,5276577
zapB_predicted,0.14285714285714285,6,6,GGCTGGGGTGTCGGACCTGC,0,5272342
zapB_predicted,0.14285714285714285,6,6,GGCTCGTTTCATAGTAACTC,0,5283383
zapB_predicted,0.14285714285714285,6,6,GGCGCCAATGTCCGTCTCAG,0,5266390
zapB_predicted,0.14285714285714285,6,6,GGCCTCGCCCGCATCGCAAA,0,5264671
zapB_predicted,0.14285714285714285,6,6,GGCCAGACGTGGTCGTCTTC,0,5265302
zapB_predicted,0.14285714285714285,6,6,GGCATGTCTTCCCATCGTCC,0,5268676
zapB_predicted,0.14285714285714285,6,6,GGCATCGACAGCTAGTACGA,0,5274364
zapB_predicted,0.14285714285714285,6,6,GGCACGTGTCCGACTCTTGG,0,5271140
zapB_predicted,0.14285714285714285,6,6,GGCACCTGACGATTTTGACT,0,5274401
zapB_predicted,0.14285714285714285,6,6,GGCACCGCCGCCGTTTCTGC,0,5271827
zapB_predicted,0.14285714285714285,6,6,GGCAAGCATGGTGTACATAA,0,5272707
zapB_predicted,0.14285714285714285,6,6,GGATACGCTCTGTATAACAG,0,5279218
zapB_predicted,0.14285714285714285,6,6,GGAGTCTTGACACCCGCGGC,0,5277239
zapB_predicted,0.14285714285714285,6,6,GGACAGAAGTCTACACTGAG,0,5275815
zapB_predicted,0.14285714285714285,6,6,GGAAACTCCTGACCGTTTTT,0,5267462
zapB_predicted,0.14285714285714285,6,6,GCTATTCGCAGTGTTTCGCT,0,5269785
zapB_predicted,0.14285714285714285,6,6,GCTAGTAGCTATCAGCTGCC,0,5272499
zapB_predicted,0.14285714285714285,6,6,GCTAGGTAGTTTCACATATC,0,5284684
zapB_predicted,0.14285714285714285,6,6,GCTAACTCGTCCTGTGTTAT,0,5268671
zapB_predicted,0.14285714285714285,6,6,GCGTTTACTATCGTGGGTAT,0,5270504
zapB_predicted,0.14285714285714285,6,6,GCGTTCACCTGTAATGTTCT,0,5279403
zapB_predicted,0.14285714285714285,6,6,GCGTGGCACATTTTAGGCAA,0,5272435
zapB_predicted,0.14285714285714285,6,6,GCGTCGCTTCCTATGATTGT,0,5267681
zapB_predicted,0.14285714285714285,6,6,GCGTCCGTTCATCCCTTACC,0,5272555
zapB_predicted,0.14285714285714285,6,6,GCGTCACATTCGCTACACAC,0,5263601
zapB_predicted,0.14285714285714285,6,6,GCGCTACATTCTCACTTAGC,0,5268994
zapB_predicted,0.14285714285714285,6,6,GCGAGAGGCAGAACAAAGTA,0,5273418
zapB_predicted,0.14285714285714285,6,6,GCCTCTTCTACGCGGGCAAG,0,5265440
zapB_predicted,0.14285714285714285,6,6,GCCGTGTCTTTGATATCGGG,0,5268301
zapB_predicted,0.14285714285714285,6,6,GCCGAGTATGCACGTACCTC,0,5263044
zapB_predicted,0.14285714285714285,6,6,GCCGAACCAATAACTAGGGT,0,5285951
zapB_predicted,0.14285714285714285,6,6,GCCAGAGATCACGATCGTAT,0,5275636
zapB_predicted,0.14285714285714285,6,6,GCATTTGGGGAGCGGAATTA,0,5284246
zapB_predicted,0.14285714285714285,6,6,GCATTTGCCGAGGACCTACG,0,5263260
zapB_predicted,0.14285714285714285,6,6,GCATGAGGCACAACTTTTGT,0,5279379
zapB_predicted,0.14285714285714285,6,6,GCAGGGAGTGGACCGACGTG,0,5266128
zapB_predicted,0.14285714285714285,6,6,GCACTCTGTCAGGTCCCCAG,0,5285613
zapB_predicted,0.14285714285714285,6,6,GCACTATTGTTTGTGGGACA,0,5274552
zapB_predicted,0.14285714285714285,6,6,GCACGAGAACTATACCGTGG,0,5273111
zapB_predicted,0.14285714285714285,6,6,GCACAGTTCGACATTGTGAA,0,5270566
zapB_predicted,0.14285714285714285,6,6,GCAATGCGCTCACCTTATCT,0,5278594
zapB_predicted,0.14285714285714285,6,6,GATTGTGATACTTCCGTGTA,0,5267969
zapB_predicted,0.14285714285714285,6,6,GATGTACTGATAGCTGAATC,0,5266473
zapB_predicted,0.14285714285714285,6,6,GATGCATGTGGCGCATCTTT,0,5271068
zapB_predicted,0.14285714285714285,6,6,GATCCATTCTTCATCGTTAC,0,5282865
zapB_predicted,0.14285714285714285,6,6,GAGTAGGGCGTATGCGCCAG,0,5286454
zapB_predicted,0.14285714285714285,6,6,GAGCGTCGGAACCAACCAAT,0,5263742
zapB_predicted,0.14285714285714285,6,6,GACTGCGTACCGAGTCTGGT,0,5265090
zapB_predicted,0.14285714285714285,6,6,GACTCTCAGTGATTATCTTG,0,5278867
zapB_predicted,0.14285714285714285,6,6,GACTCCAATCAACCTGCTCC,0,5286760
zapB_predicted,0.14285714285714285,6,6,GACCGATTCTCCTAAGTTAT,0,5278585
zapB_predicted,0.14285714285714285,6,6,GAATTGGGCTGAGATAATCT,0,5266101
zapB_predicted,0.14285714285714285,6,6,GAAGTGTAAGGTTGGTAGAA,0,5278401
zapB_predicted,0.14285714285714285,6,6,GAAGTGCGTATCAGGGATTG,0,5272844
zapB_predicted,0.14285714285714285,6,6,GAAGGTGTGTTCTGTTAGGA,0,5267845
zapB_predicted,0.14285714285714285,6,6,GAAGAGGTATGCCCTCTTCC,0,5264151
zapB_predicted,0.14285714285714285,6,6,GAACGGTACTGTCAACCCTT,0,5275968
zapB_predicted,0.14285714285714285,6,6,GAACCTGTGTATGCCTGTCT,0,5287508
zapB_predicted,0.14285714285714285,6,6,GAACAGAGATCCAATTTCAC,0,5282311
zapB_predicted,0.14285714285714285,6,6,GAACACCTTTGTGTTTCTGT,0,5284611
zapB_predicted,0.14285714285714285,6,6,GAAATCTGAACGGGTCTGGT,0,5263659
zapB_predicted,0.14285714285714285,6,6,GAAAAAATCCAAGTCACAAG,0,5280975
zapB_predicted,0.14285714285714285,6,6,CTTTTCCGTAATAGATCATT,0,5284362
zapB_predicted,0.14285714285714285,6,6,CTTTGCACTGTTGGCACCAG,0,5274427
zapB_predicted,0.14285714285714285,6,6,CTTTGACACGTTACGCTCGG,0,5276875
zapB_predicted,0.14285714285714285,6,6,CTTGCTACGCGCGCGTGAAG,0,5281727
zapB_predicted,0.14285714285714285,6,6,CTTCGCCTGCATCGTTGTTT,0,5285999
zapB_predicted,0.14285714285714285,6,6,CTTATGTCAGCTGTACCAGG,0,5263039
zapB_predicted,0.14285714285714285,6,6,CTTATGGCCGCTCATACGTA,0,5268235
zapB_predicted,0.14285714285714285,6,6,CTGTTCAGCTGCTGGTACTC,0,5283916
zapB_predicted,0.14285714285714285,6,6,CTGTTAAGAGCGGACAGGCG,0,5277795
zapB_predicted,0.14285714285714285,6,6,CTGGTTTACGCCGGGCTCGT,0,5277160
zapB_predicted,0.14285714285714285,6,6,CTGGTATGGGTCTGAACCAC,0,5281773
zapB_predicted,0.14285714285714285,6,6,CTGGCTTCTTGTGCGTTCGT,0,5280161
zapB_predicted,0.14285714285714285,6,6,CTGGCGTAGTTTGGATAAGA,0,5264929
zapB_predicted,0.14285714285714285,6,6,CTGCTACAAATTAATAAAAC,0,5283969
zapB_predicted,0.14285714285714285,6,6,CTGCCATCGGAACGTATCCA,0,5273756
zapB_predicted,0.14285714285714285,6,6,CTGCACAACGGCATGGTCTG,0,5273157
zapB_predicted,0.14285714285714285,6,6,CTCTTAGATTTGCTAAGAGA,0,5275221
zapB_predicted,0.14285714285714285,6,6,CTCTGGAGAATTTGCGGCCG,0,5268016
zapB_predicted,0.14285714285714285,6,6,CTCGGAGCGCATGCTGCAGA,0,5273864
zapB_predicted,0.14285714285714285,6,6,CTCCTGTAACGATACCGATG,0,5273302
zapB_predicted,0.14285714285714285,6,6,CTCATCGGAGCTCGTTCGCT,0,5273858
zapB_predicted,0.14285714285714285,6,6,CTCACATGTTATAAATTGGT,0,5284993
zapB_predicted,0.14285714285714285,6,6,CTATAATCGGATTCTGTCTT,0,5269747
zapB_predicted,0.14285714285714285,6,6,CTAGAGGATAAATAAAGTCT,0,5274790
zapB_predicted,0.14285714285714285,6,6,CTAGACGGAATTCAATCGAC,0,5269797
zapB_predicted,0.14285714285714285,6,6,CTACCTCAGCCTCAATTATC,0,5268771
zapB_predicted,0.14285714285714285,6,6,CTACCTAGTTCGACGGAATA,0,5263459
zapB_predicted,0.14285714285714285,6,6,CTACCCCTCAGCAATACGGA,0,5272377
zapB_predicted,0.14285714285714285,6,6,CTAATGATCGATTAGAGATC,0,5265841
zapB_predicted,0.14285714285714285,6,6,CGTGTAGATCAGGGGAACTA,0,5281943
zapB_predicted,0.14285714285714285,6,6,CGTGCTATTATCCCATTTGC,0,5275654
zapB_predicted,0.14285714285714285,6,6,CGTCAGTTAATTCGGGAAAT,0,5263867
zapB_predicted,0.14285714285714285,6,6,CGTCAACATGTGTCCGAGGA,0,5265725
zapB_predicted,0.14285714285714285,6,6,CGGCTCCGAACGTTTCGGGA,0,5274847
zapB_predicted,0.14285714285714285,6,6,CGGCCGAGCCATAGTTTTTT,0,5287051
zapB_predicted,0.14285714285714285,6,6,CGGCCCTAAGATAGTCACGA,0,5275383
zapB_predicted,0.14285714285714285,6,6,CGGACGTGGGGCAGCAATAC,0,5283176
zapB_predicted,0.14285714285714285,6,6,CGGAATGCATCATTTCAGGA,0,5281512
zapB_predicted,0.14285714285714285,6,6,CGCTGTCAGGTTAGTAAATC,0,5276730
zapB_predicted,0.14285714285714285,6,6,CGCTGCTGCTCGAGTGTCTT,0,5278088
zapB_predicted,0.14285714285714285,6,6,CGCGTCCAGTCGGTCGATCT,0,5282185
zapB_predicted,0.14285714285714285,6,6,CGCGCTTCCTAGTCCAAAGT,0,5271119
zapB_predicted,0.14285714285714285,6,6,CGCGCACCGCTTCAAGCCAC,0,5263805
zapB_predicted,0.14285714285714285,6,6,CGCGAGTTGCCGATACGCTA,0,5287259
zapB_predicted,0.14285714285714285,6,6,CGCGAAGTAATTATTGTCTG,0,5280214
zapB_predicted,0.14285714285714285,6,6,CGCCTGCGACTGGTGAGCAT,0,5275900
zapB_predicted,0.14285714285714285,6,6,CGCATCGGCTACGCATCAGT,0,5273633
zapB_predicted,0.14285714285714285,6,6,CGCACGCTTTTCATTCAAGG,0,5271341
zapB_predicted,0.14285714285714285,6,6,CGAGTCACGTAGGCGTAACG,0,5274868
zapB_predicted,0.14285714285714285,6,6,CGAGGGGAGAACCGTTAGTC,0,5266013
zapB_predicted,0.14285714285714285,6,6,CGAGCCGGCTAAGTAAGGAG,0,5265966
zapB_predicted,0.14285714285714285,6,6,CGACTCAGCACGAAGAGTTT,0,5273238
zapB_predicted,0.14285714285714285,6,6,CGACGCGGGGCCAAGTAGGA,0,5265352
zapB_predicted,0.14285714285714285,6,6,CGACCTAATCAGCATTAGCA,0,5276095
zapB_predicted,0.14285714285714285,6,6,CGAATAGCCCAAGCCTCAAT,0,5284590
zapB_predicted,0.14285714285714285,6,6,CGAACCCAATTATGCAAAAA,0,5277915
zapB_predicted,0.14285714285714285,6,6,CGAAAGAGGTTCTATTTTCT,0,5280500
zapB_predicted,0.14285714285714285,6,6,CCTGATTGGGGTCTTTAGGC,0,5269796
zapB_predicted,0.14285714285714285,6,6,CCTCCACTCGAGTGAGGGTT,0,5271273
zapB_predicted,0.14285714285714285,6,6,CCTAGTTAGAAAGGGCTTTA,0,5281622
zapB_predicted,0.14285714285714285,6,6,CCTAAAGGAGCATACCTCCT,0,5267769
zapB_predicted,0.14285714285714285,6,6,CCGTGTTGCGCGCGAGAATT,0,5286871
zapB_predicted,0.14285714285714285,6,6,CCGTGGGATTTGGTCGAGTG,0,5280771
zapB_predicted,0.14285714285714285,6,6,CCGGGTCGTCCACGATTGCG,0,5269466
zapB_predicted,0.14285714285714285,6,6,CCGGATAGACACTATTTTGT,0,5287697
zapB_predicted,0.14285714285714285,6,6,CCGCGACCAGCGTGTTCTTG,0,5272588
zapB_predicted,0.14285714285714285,6,6,CCGCCTTCCCTAGCCGCTGG,0,5282744
zapB_predicted,0.14285714285714285,6,6,CCGATCATAGAGGTGTGCGG,0,5272523
zapB_predicted,0.14285714285714285,6,6,CCGATACTGTGGCCCAGAGG,0,5265024
zapB_predicted,0.14285714285714285,6,6,CCCTTGAAGGACAGATCTGC,0,5265186
zapB_predicted,0.14285714285714285,6,6,CCCTGCTTCGCGTTGCTTGG,0,5287371
zapB_predicted,0.14285714285714285,6,6,CCCTCCCTCGCCGGTACGCG,0,5284780
zapB_predicted,0.14285714285714285,6,6,CCCTAGCTGACGCTTTCTCA,0,5276040
zapB_predicted,0.14285714285714285,6,6,CCCGTCGTACATACATCGTA,0,5265029
zapB_predicted,0.14285714285714285,6,6,CCCGTATACCTGCCCGACTG,0,5285062
zapB_predicted,0.14285714285714285,6,6,CCCGGTGCATACTAGAGGTT,0,5266474
zapB_predicted,0.14285714285714285,6,6,CCCGCAAATTGCAATAGTTG,0,5267466
zapB_predicted,0.14285714285714285,6,6,CCCGATACGGGTTGCTCGAA,0,5282224
zapB_predicted,0.14285714285714285,6,6,CCCGAGGCAGTGGCAAATTA,0,5284028
zapB_predicted,0.14285714285714285,6,6,CCCCGCAGCCCCGGCCTAGG,0,5280613
zapB_predicted,0.14285714285714285,6,6,CCCCGAGCTCGTTTTAAAAG,0,5267088
zapB_predicted,0.14285714285714285,6,6,CCATTGAGTTCGGTCGATGA,0,5276007
zapB_predicted,0.14285714285714285,6,6,CCATGTTGCAGTGTAATGTT,0,5266542
zapB_predicted,0.14285714285714285,6,6,CCATCAAATGTCCGCTTCAA,0,5264445
zapB_predicted,0.14285714285714285,6,6,CCAGTCCGAGTATGGTCACC,0,5275408
zapB_predicted,0.14285714285714285,6,6,CCAGGATGGGAGCAATTATT,0,5280231
zapB_predicted,0.14285714285714285,6,6,CCAGGATATTCAGACATCCT,0,5283794
zapB_predicted,0.14285714285714285,6,6,CCAATTGCAGGTCTACACTT,0,5272570
zapB_predicted,0.14285714285714285,6,6,CCAAACCACGTAGAGGTCAC,0,5285092
zapB_predicted,0.14285714285714285,6,6,CATGGGAACCAGCGCGCATA,0,5284281
zapB_predicted,0.14285714285714285,6,6,CAGTTCTTCGGGTAAGGATA,0,5274977
zapB_predicted,0.14285714285714285,6,6,CAGCCAGGGGTGTTTTGTAA,0,5264773
zapB_predicted,0.14285714285714285,6,6,CAGCAGGGAGCAAGCAGGGT,0,5279376
zapB_predicted,0.14285714285714285,6,6,CAGCACTCGACCACGGCAAG,0,5280179
zapB_predicted,0.14285714285714285,6,6,CAGCACGTGCGGTCCATCAT,0,5285858
zapB_predicted,0.14285714285714285,6,6,CAGACTGATTAGTAGAGGAA,0,5284821
zapB_predicted,0.14285714285714285,6,6,CACGTGTATCGGCCCGCAAT,0,5284967
zapB_predicted,0.14285714285714285,6,6,CACGTGAAAAGTTGGTCGCA,0,5265115
zapB_predicted,0.14285714285714285,6,6,CACGGGATTCCTCCTGATGC,0,5279244
zapB_predicted,0.14285714285714285,6,6,CACGCTGTCATACGGCTCCA,0,5275135
zapB_predicted,0.14285714285714285,6,6,CACGAAGTTTAAAAGTATGA,0,5263954
zapB_predicted,0.14285714285714285,6,6,CACCTGCAGCTAATAGGGAC,0,5278432
zapB_predicted,0.14285714285714285,6,6,CACCGTTCCAGTACACAAAT,0,5271160
zapB_predicted,0.14285714285714285,6,6,CACCCCGTACCCCCGTACTA,0,5286476
zapB_predicted,0.14285714285714285,6,6,CAATCGTGAACTCGTATCTG,0,5271036
zapB_predicted,0.14285714285714285,6,6,CAATATCCTTGACTAGGCTC,0,5275529
zapB_predicted,0.14285714285714285,6,6,CAAGTCGAAGCTCGACGACA,0,5275960
zapB_predicted,0.14285714285714285,6,6,CAAGGTTGATTTGAGCTGTG,0,5272952
zapB_predicted,0.14285714285714285,6,6,CAAGCGCTGAATTTGCCCGG,0,5276720
zapB_predicted,0.14285714285714285,6,6,CAACGGGCCTACCGATGAAC,0,5273489
zapB_predicted,0.14285714285714285,6,6,CAACGGCTAAGCCGTGTTTG,0,5268366
zapB_predicted,0.14285714285714285,6,6,ATTTGTTGCAGGTTAGGCGT,0,5278465
zapB_predicted,0.14285714285714285,6,6,ATTTGACAGTCGGTTCCGCA,0,5271382
zapB_predicted,0.14285714285714285,6,6,ATTTCGTTGACATTTGAAGC,0,5282168
zapB_predicted,0.14285714285714285,6,6,ATTGCCTACGAACTACTGTA,0,5278820
zapB_predicted,0.14285714285714285,6,6,ATTGAGGGATGTTGAAGGTA,0,5288091
zapB_predicted,0.14285714285714285,6,6,ATTGACGACGATCTCGCTAG,0,5268101
zapB_predicted,0.14285714285714285,6,6,ATTCCTTTCACCCCCTAACA,0,5286430
zapB_predicted,0.14285714285714285,6,6,ATTAGCAGTTTGATACATAT,0,5285791
zapB_predicted,0.14285714285714285,6,6,ATTAATGAAAGTTGTCGAGC,0,5283992
zapB_predicted,0.14285714285714285,6,6,ATTAAATAACGTGGCGGTGG,0,5283505
zapB_predicted,0.14285714285714285,6,6,ATGCGTTGGTCAGATTGTGC,0,5272436
zapB_predicted,0.14285714285714285,6,6,ATGAGCGCACTGCATTCTAG,0,5278186
zapB_predicted,0.14285714285714285,6,6,ATGAGCCTAAGTCCTGGGCA,0,5280414
zapB_predicted,0.14285714285714285,6,6,ATCCGTTTGATAGTCAGGAA,0,5267178
zapB_predicted,0.14285714285714285,6,6,ATCCCGTCCGACCATCTGGG,0,5271661
zapB_predicted,0.14285714285714285,6,6,ATCATCTTGTCTTAGCTTGC,0,5279593
zapB_predicted,0.14285714285714285,6,6,ATCACGCTTGACCTTGCCAC,0,5268526
zapB_predicted,0.14285714285714285,6,6,ATCAACGGCCCTCGTCTAAG,0,5275866
zapB_predicted,0.14285714285714285,6,6,ATATAGGTCTTCGCATGCCA,0,5279742
zapB_predicted,0.14285714285714285,6,6,ATAGCGTGCCTCCGCGATCC,0,5283770
zapB_predicted,0.14285714285714285,6,6,ATAGCGCAGGCAAACAGAGA,0,5268779
zapB_predicted,0.14285714285714285,6,6,ATACGTTTTCTGCCGCAGCT,0,5266924
zapB_predicted,0.14285714285714285,6,6,ATACCTAGAACGTGGAGACG,0,5277865
zapB_predicted,0.14285714285714285,6,6,ATACAATTAGAAGTCCAAGT,0,5282438
zapB_predicted,0.14285714285714285,6,6,ATAATGAAAAATGCGTAGTA,0,5266842
zapB_predicted,0.14285714285714285,6,6,AGTTTTACTGCACGACATGT,0,5271129
zapB_predicted,0.14285714285714285,6,6,AGTTGTAGGGCCTTGGAAGT,0,5282569
zapB_predicted,0.14285714285714285,6,6,AGTTGATTCTGACGTGAATT,0,5272300
zapB_predicted,0.14285714285714285,6,6,AGTTGATTCGGCCATGTCAA,0,5279455
zapB_predicted,0.14285714285714285,6,6,AGTCGCCATACGGCGTCGGC,0,5278453
zapB_predicted,0.14285714285714285,6,6,AGTCCCTATATCAGTATTGC,0,5285368
zapB_predicted,0.14285714285714285,6,6,AGTAAAGGGCGCGGCTGTCT,0,5268975
zapB_predicted,0.14285714285714285,6,6,AGGTGGGCTGTGGTCAAAAA,0,5271434
zapB_predicted,0.14285714285714285,6,6,AGGTCGGGTTCGGGTAATAT,0,5281033
zapB_predicted,0.14285714285714285,6,6,AGGTAAGTAACTCCTGCTGC,0,5263081
zapB_predicted,0.14285714285714285,6,6,AGGGGGGTATTTACTCTACA,0,5278944
zapB_predicted,0.14285714285714285,6,6,AGGGGGCGCAAAGCAACGGT,0,5271647
zapB_predicted,0.14285714285714285,6,6,AGGGCGGTAAATGGACGAAA,0,5287094
zapB_predicted,0.14285714285714285,6,6,AGGGAAAGTAGAGTAGTGTC,0,5263879
zapB_predicted,0.14285714285714285,6,6,AGGCGCCCGCCGGTTAAACA,0,5284654
zapB_predicted,0.14285714285714285,6,6,AGGCAAGGCCCTATCGCATA,0,5286411
zapB_predicted,0.14285714285714285,6,6,AGGAGTGGCTCCGCGTGTTT,0,5284467
zapB_predicted,0.14285714285714285,6,6,AGGAGGCTTAACGCCTTGCA,0,5279009
zapB_predicted,0.14285714285714285,6,6,AGGAAACGTCAGACTGGTCG,0,5266069
zapB_predicted,0.14285714285714285,6,6,AGCTTGCTAGGTTTAATTTT,0,5273224
zapB_predicted,0.14285714285714285,6,6,AGCTAAAGCTACAGGCCCTC,0,5280972
zapB_predicted,0.14285714285714285,6,6,AGCGGCGCGCTCGTGCCCGA,0,5266850
zapB_predicted,0.14285714285714285,6,6,AGCGGAGGAGTTTGTACAGG,0,5265600
zapB_predicted,0.14285714285714285,6,6,AGCGCTTGGATGCGGAGTGA,0,5280226
zapB_predicted,0.14285714285714285,6,6,AGCGCACAGGATGTTTATTA,0,5273967
zapB_predicted,0.14285714285714285,6,6,AGCCTTAGCTAGGGTCGGCT,0,5265832
zapB_predicted,0.14285714285714285,6,6,AGCCTCACAATCATGACCGC,0,5271337
zapB_predicted,0.14285714285714285,6,6,AGCCCTCACCGTCTTGTTTC,0,5266996
zapB_predicted,0.14285714285714285,6,6,AGCCCGTTATAGCAACAACA,0,5287687
zapB_predicted,0.14285714285714285,6,6,AGATCAAGGGACCCGAGAGG,0,5279015
zapB_predicted,0.14285714285714285,6,6,AGAGTCCCTTATTAGTACCA,0,5279313
zapB_predicted,0.14285714285714285,6,6,AGAGACACCGTCGGGAGACA,0,5273842
zapB_predicted,0.14285714285714285,6,6,AGAGAAGGAGACTCATTCTC,0,5283743
zapB_predicted,0.14285714285714285,6,6,AGACTGATGCGCATGGTCAA,0,5285759
zapB_predicted,0.14285714285714285,6,6,AGACGCAGCAGAGAAACCAG,0,5287090
zapB_predicted,0.14285714285714285,6,6,AGACAGCCGGAGTTGACCCC,0,5275988
zapB_predicted,0.14285714285714285,6,6,ACTTTTGAGGCGCCCACAAT,0,5287369
zapB_predicted,0.14285714285714285,6,6,ACTTTTAACAACAAATGATG,0,5265346
zapB_predicted,0.14285714285714285,6,6,ACTTAAAGATTCGACCTAGG,0,5287316
zapB_predicted,0.14285714285714285,6,6,ACTGTCCAGGCTGGTTATTG,0,5276440
zapB_predicted,0.14285714285714285,6,6,ACTCAACACGGGCGGAGTCT,0,5277687
zapB_predicted,0.14285714285714285,6,6,ACTATGAGGTTTCCTCCTCG,0,5275669
zapB_predicted,0.14285714285714285,6,6,ACTATCCTTCACAGCCTAGA,0,5281824
zapB_predicted,0.14285714285714285,6,6,ACTATCCGCAAGGTTACCCA,0,5280608
zapB_predicted,0.14285714285714285,6,6,ACGTTGTAGGCCTATCGCGG,0,5285247
zapB_predicted,0.14285714285714285,6,6,ACGTATCCCTCGTGGAGTTC,0,5271696
zapB_predicted,0.14285714285714285,6,6,ACGGTATATGATTTGACTTG,0,5279432
zapB_predicted,0.14285714285714285,6,6,ACGCTGGTGGAAATAATATG,0,5273151
zapB_predicted,0.14285714285714285,6,6,ACGCGTTTCCTGGTTTCTTA,0,5282187
zapB_predicted,0.14285714285714285,6,6,ACGCGATTGTGATGGTAAGG,0,5274387
zapB_predicted,0.14285714285714285,6,6,ACGAGGTGACGTCCATGAAA,0,5272865
zapB_predicted,0.14285714285714285,6,6,ACCTTCTGGCTATATGCTGA,0,5268703
zapB_predicted,0.14285714285714285,6,6,ACCTGTTTTCATCAAGGACT,0,5266361
zapB_predicted,0.14285714285714285,6,6,ACCTAAGCCAAACTTTTGTG,0,5269178
zapB_predicted,0.14285714285714285,6,6,ACCGAGAAGACGCTCGCCAT,0,5273173
zapB_predicted,0.14285714285714285,6,6,ACCCTGTCGGCCCTTTGGGA,0,5267129
zapB_predicted,0.14285714285714285,6,6,ACCCCCCCATGGTCCGAGCT,0,5276775
zapB_predicted,0.14285714285714285,6,6,ACCCAACCGGAAAACTTTAT,0,5287578
zapB_predicted,0.14285714285714285,6,6,ACCATGGTATTGTACCTTCG,0,5273628
zapB_predicted,0.14285714285714285,6,6,ACCAAGCGCGTCCTCCGAGA,0,5280104
zapB_predicted,0.14285714285714285,6,6,ACATTACTCCCATGGGTCCG,0,5270427
zapB_predicted,0.14285714285714285,6,6,ACATCCCACTGACGGGTCAC,0,5264432
zapB_predicted,0.14285714285714285,6,6,ACATACTCGGCCCCTCTGCG,0,5283955
zapB_predicted,0.14285714285714285,6,6,ACAGCACCTATTGGCACCTT,0,5286458
zapB_predicted,0.14285714285714285,6,6,ACACTCCTCGAAAACCAACA,0,5267058
zapB_predicted,0.14285714285714285,6,6,AATTTAGAAATCGAGCTTCA,0,5266195
zapB_predicted,0.14285714285714285,6,6,AATTATAGATAGCGGGATAT,0,5286578
zapB_predicted,0.14285714285714285,6,6,AATGGTACAATCTATGTGGG,0,5283576
zapB_predicted,0.14285714285714285,6,6,AATAGCAGTATGCTAATGAT,0,5284949
zapB_predicted,0.14285714285714285,6,6,AATACACATCCTATGGGTGT,0,5280689
zapB_predicted,0.14285714285714285,6,6,AAGTTCTCCAGGCTTGTCAT,0,5285144
zapB_predicted,0.14285714285714285,6,6,AAGTCTTATAGCAATGTAAG,0,5273468
zapB_predicted,0.14285714285714285,6,6,AAGGGCATGGAAATCGCCTC,0,5274414
zapB_predicted,0.14285714285714285,6,6,AAGGAGTCACGTATCAATCA,0,5281258
zapB_predicted,0.14285714285714285,6,6,AAGCTCTGTTGGCTTCTCAT,0,5273925
zapB_predicted,0.14285714285714285,6,6,AAGAATGAGGAGCTTCACAC,0,5281365
zapB_predicted,0.14285714285714285,6,6,AAGAAGGCATTTAAGGGTGG,0,5279921
zapB_predicted,0.14285714285714285,6,6,AACTGCAGGGCAGTTCGGCT,0,5265823
zapB_predicted,0.14285714285714285,6,6,AACTAATTGCATCGAGACTC,0,5272829
zapB_predicted,0.14285714285714285,6,6,AACTAACGTGGTAGTTCTTA,0,5282863
zapB_predicted,0.14285714285714285,6,6,AACGGCTTATATGGATCGCA,0,5282612
zapB_predicted,0.14285714285714285,6,6,AACGGCATAGGTAAACTAAT,0,5272730
zapB_predicted,0.14285714285714285,6,6,AACGCTACCGAACAGGAGCA,0,5267295
zapB_predicted,0.14285714285714285,6,6,AACGATGAAACTCAGGGCTG,0,5282667
zapB_predicted,0.14285714285714285,6,6,AACCTTCGGCGCGAGTCCGA,0,5283598
zapB_predicted,0.14285714285714285,6,6,AACCTGCCGACCTGCCCCTT,0,5271782
zapB_predicted,0.14285714285714285,6,6,AAATTACCACTCTTATGGAT,0,5283052
zapB_predicted,0.14285714285714285,6,6,AAACGGGTGGGTATTGCAAG,0,5271030
zapB_predicted,0.14285714285714285,6,6,AAACCGGTATGGCGGCCACA,0,5264897
zapB_predicted,0.14285714285714285,6,6,AAACCCCCGGTCCTCTCGAT,0,5270784
zapB_predicted,0.14285714285714285,6,6,AAACATACTCTAACTGCCAT,0,5263417
zapB_predicted,0.14285714285714285,6,6,AAAATGGGATTGATTGTCCG,0,5269996
zapB_predicted,0.14285714285714285,6,6,AAAAGTAAAAGTGTAAAATA,0,5266844
zapB_predicted,0.14285714285714285,6,6,AAAACGAGGTGTAAGTCAGC,0,5269182
zapB_predicted,0.16666666666666666,5,5,TTTTGGGATTTTCGTTCATT,0,5269418
zapB_predicted,0.16666666666666666,5,5,TTTTCTGGCACCACCCCGAC,0,5269809
zapB_predicted,0.16666666666666666,5,5,TTTTCTACGTCGATGGGGAC,0,5278099
zapB_predicted,0.16666666666666666,5,5,TTTGTTTTAGTAGGGAACGT,0,5284405
zapB_predicted,0.16666666666666666,5,5,TTTGGGGCAGCATCGTGTAG,0,5282869
zapB_predicted,0.16666666666666666,5,5,TTTCGGCCCCGGTCATAAAA,0,5285516
zapB_predicted,0.16666666666666666,5,5,TTTCGGACTCTTAACTAGTG,0,5264028
zapB_predicted,0.16666666666666666,5,5,TTTATTCCGTTCCATCGTTT,0,5263817
zapB_predicted,0.16666666666666666,5,5,TTTAGAGTCTCGGCTCCTGG,0,5269563
zapB_predicted,0.16666666666666666,5,5,TTTAAGACACTACGCCCGAA,0,5272778
zapB_predicted,0.16666666666666666,5,5,TTGTCTTCCATCTCGCCCAT,0,5278519
zapB_predicted,0.16666666666666666,5,5,TTGTCCTGCATCATCTCGCA,0,5281200
zapB_predicted,0.16666666666666666,5,5,TTGTAGGAGGATCGTGCGCT,0,5283772
zapB_predicted,0.16666666666666666,5,5,TTGGTGCCATCCAGTAGATG,0,5264884
zapB_predicted,0.16666666666666666,5,5,TTGGCTCGTAAGTGGTGGCA,0,5268280
zapB_predicted,0.16666666666666666,5,5,TTGCGTACAAAAGGAGTGCG,0,5268533
zapB_predicted,0.16666666666666666,5,5,TTGCCGCCAATAATCGATAG,0,5269468
zapB_predicted,0.16666666666666666,5,5,TTCTTAGGTCTCTTAAACCT,0,5270411
zapB_predicted,0.16666666666666666,5,5,TTCTGCTAGCGGGACGCTCG,0,5271725
zapB_predicted,0.16666666666666666,5,5,TTCGCGAGTACCAATCTAGG,0,5265742
zapB_predicted,0.16666666666666666,5,5,TTCGCCTCGAATCGTCCATT,0,5274540
zapB_predicted,0.16666666666666666,5,5,TTCCGTCTTTAATCCGTTTG,0,5274269
zapB_predicted,0.16666666666666666,5,5,TTCATAATCTAGCGGGACCG,0,5273239
zapB_predicted,0.16666666666666666,5,5,TTATTTCTCCGGAGATACTT,0,5282703
zapB_predicted,0.16666666666666666,5,5,TTATTAGTGGGGTAGCGGCA,0,5266830
zapB_predicted,0.16666666666666666,5,5,TTATGTCGTCCGCGCGAAAT,0,5287434
zapB_predicted,0.16666666666666666,5,5,TTATGCGGTACGGGCCGAAA,0,5281094
zapB_predicted,0.16666666666666666,5,5,TTATAATCCGGGGTAGGCTC,0,5274962
zapB_predicted,0.16666666666666666,5,5,TTAGCTGACATAGATCTTTC,0,5271784
zapB_predicted,0.16666666666666666,5,5,TTACAGCTACAGAAACGTCC,0,5268794
zapB_predicted,0.16666666666666666,5,5,TTAAGATCAATCAAATTAGT,0,5283088
zapB_predicted,0.16666666666666666,5,5,TTAACACACTCAGTCAACTG,0,5277998
zapB_predicted,0.16666666666666666,5,5,TTAAACTAATTGAGGGACAA,0,5276772
zapB_predicted,0.16666666666666666,5,5,TTAAAACTTGTGCCAGCTAA,0,5283544
zapB_predicted,0.16666666666666666,5,5,TGTTTTTAAGCTATGATCCC,0,5277045
zapB_predicted,0.16666666666666666,5,5,TGTTTAATGGTGTGGCAATG,0,5266055
zapB_predicted,0.16666666666666666,5,5,TGTGGTGTGTTTGAATCTGT,0,5284628
zapB_predicted,0.16666666666666666,5,5,TGTGCTCCACTAACCATGAA,0,5282247
zapB_predicted,0.16666666666666666,5,5,TGTCGCGTGAAGGGACACGG,0,5267479
zapB_predicted,0.16666666666666666,5,5,TGTAAGCGTTCCCCCGGGGG,0,5279827
zapB_predicted,0.16666666666666666,5,5,TGGTGCTGGGCTTCGTTGCA,0,5267046
zapB_predicted,0.16666666666666666,5,5,TGGTGCCGACTCATTATGTC,0,5278723
zapB_predicted,0.16666666666666666,5,5,TGGGTCTGGTTGGGCAACGC,0,5271905
zapB_predicted,0.16666666666666666,5,5,TGGCTAGATTCTATTTGCGC,0,5287683
zapB_predicted,0.16666666666666666,5,5,TGGCTACAACTCACCCGAAA,0,5273625
zapB_predicted,0.16666666666666666,5,5,TGGCCGACAGATGTGTACGC,0,5272140
zapB_predicted,0.16666666666666666,5,5,TGGCAGACACCTCAGGAAAT,0,5282312
zapB_predicted,0.16666666666666666,5,5,TGGAGCTACGGTATGATGGT,0,5267839
zapB_predicted,0.16666666666666666,5,5,TGGACTATATGTTGTAAGGG,0,5279298
zapB_predicted,0.16666666666666666,5,5,TGGACGTTGACAGTGCCTAC,0,5283796
zapB_predicted,0.16666666666666666,5,5,TGCTTTTGCAGAATCAAGTA,0,5285562
zapB_predicted,0.16666666666666666,5,5,TGCTTCCACCACCCGCGATA,0,5280001
zapB_predicted,0.16666666666666666,5,5,TGCTGCCATTGATTCCCATC,0,5275996
zapB_predicted,0.16666666666666666,5,5,TGCTCTGGGTGGGCTCACGA,0,5276276
zapB_predicted,0.16666666666666666,5,5,TGCGCGAGCAATATCCCGGG,0,5273655
zapB_predicted,0.16666666666666666,5,5,TGCGAAACGTCTGGTAGCAA,0,5278904
zapB_predicted,0.16666666666666666,5,5,TGCATATTCTCGATTAGGCA,0,5267818
zapB_predicted,0.16666666666666666,5,5,TGCATAGGAGGGAGATGCTC,0,5286655
zapB_predicted,0.16666666666666666,5,5,TGCACGTTCGTTGACTATCG,0,5268421
zapB_predicted,0.16666666666666666,5,5,TGCACGTGGGGGGAATCCGA,0,5269812
zapB_predicted,0.16666666666666666,5,5,TGCACCGACTAAGTACCAGT,0,5282182
zapB_predicted,0.16666666666666666,5,5,TGCAATACGAAGGCTCTTTC,0,5282490
zapB_predicted,0.16666666666666666,5,5,TGAGGTCAGATTACAGCCCA,0,5269542
zapB_predicted,0.16666666666666666,5,5,TGACTCTAAGCACCTGCCAT,0,5277609
zapB_predicted,0.16666666666666666,5,5,TGACCAAACATAGACCATTT,0,5284541
zapB_predicted,0.16666666666666666,5,5,TGACAGTAGTTATCTTATGG,0,5287811
zapB_predicted,0.16666666666666666,5,5,TGAAAGGGGCCATAACCAAC,0,5285102
zapB_predicted,0.16666666666666666,5,5,TGAAAAATCTCGATATCTCG,0,5273856
zapB_predicted,0.16666666666666666,5,5,TCTTTGTTGGCAGCTGGCCT,0,5277175
zapB_predicted,0.16666666666666666,5,5,TCTTATAGCTAGGTTGACCA,0,5265890
zapB_predicted,0.16666666666666666,5,5,TCTGGAGCGGGTCTTTTTGA,0,5267270
zapB_predicted,0.16666666666666666,5,5,TCTGCGATCTACGCAAGTGT,0,5272283
zapB_predicted,0.16666666666666666,5,5,TCTGCCCTTACTGGTACAGT,0,5265307
zapB_predicted,0.16666666666666666,5,5,TCTCAAAATTGGTACCAAGA,0,5270692
zapB_predicted,0.16666666666666666,5,5,TCTAGCTATCGGCGCGGGCA,0,5284426
zapB_predicted,0.16666666666666666,5,5,TCTACTCTTTTGCCGTTTGA,0,5287940
zapB_predicted,0.16666666666666666,5,5,TCGTAGGCTACAGTTCAGAT,0,5278798
zapB_predicted,0.16666666666666666,5,5,TCGTAAGCACCGCGCTACAT,0,5280952
zapB_predicted,0.16666666666666666,5,5,TCGGTAAGCACGAATTCAAT,0,5265909
zapB_predicted,0.16666666666666666,5,5,TCGGGCTAAAGTTATGCCCT,0,5268249
zapB_predicted,0.16666666666666666,5,5,TCGGAGATGGGGAGATGAAA,0,5265086
zapB_predicted,0.16666666666666666,5,5,TCGCTTCAGAACCATGTTCG,0,5271723
zapB_predicted,0.16666666666666666,5,5,TCGACCACCAGTATTGCGAG,0,5286512
zapB_predicted,0.16666666666666666,5,5,TCGAATCCTGAAGGGATGCC,0,5276517
zapB_predicted,0.16666666666666666,5,5,TCCCTTGTAACAGTCTTAGG,0,5285270
zapB_predicted,0.16666666666666666,5,5,TCCCGGATATGCCCTCCTAC,0,5285394
zapB_predicted,0.16666666666666666,5,5,TCCCGCTGTTTTGAGGCTTT,0,5264072
zapB_predicted,0.16666666666666666,5,5,TCCATCAAACAGGTCTTCCG,0,5263848
zapB_predicted,0.16666666666666666,5,5,TCATGGCGGGTGGATCTAAT,0,5270768
zapB_predicted,0.16666666666666666,5,5,TCAGCCAGGACTGAATCTCA,0,5268822
zapB_predicted,0.16666666666666666,5,5,TCACCGCTCGATGTCCCTTG,0,5266381
zapB_predicted,0.16666666666666666,5,5,TCAATTTCCGGCCTTGTTAG,0,5265267
zapB_predicted,0.16666666666666666,5,5,TCAACTTTGGTCCGACGTCA,0,5272078
zapB_predicted,0.16666666666666666,5,5,TCAAATACACCATGGTATAG,0,5283775
zapB_predicted,0.16666666666666666,5,5,TCAAAGTTGATCTGCCTTTC,0,5279824
zapB_predicted,0.16666666666666666,5,5,TCAAAGAGTTTTTAACATAC,0,5267476
zapB_predicted,0.16666666666666666,5,5,TATTTTCTACCAAAGTCTAA,0,5279778
zapB_predicted,0.16666666666666666,5,5,TATTCCAAACGTATATGAAG,0,5270024
zapB_predicted,0.16666666666666666,5,5,TATGTCGTCCGACCGTGACG,0,5273899
zapB_predicted,0.16666666666666666,5,5,TATGGTGGGTTCAGGGTAAT,0,5281736
zapB_predicted,0.16666666666666666,5,5,TATGGAGGTCCCGGCTAGAC,0,5284644
zapB_predicted,0.16666666666666666,5,5,TATCGTTCGAATAGCCGTAC,0,5269121
zapB_predicted,0.16666666666666666,5,5,TATCGGGTTAGGTGAGGGGT,0,5263623
zapB_predicted,0.16666666666666666,5,5,TATCGAGCATTAATAATTCA,0,5265253
zapB_predicted,0.16666666666666666,5,5,TATCGAACATTGCGCATATT,0,5269058
zapB_predicted,0.16666666666666666,5,5,TATAGGGGGTTACCAGTACA,0,5275103
zapB_predicted,0.16666666666666666,5,5,TAGGTGGGGCAGCGTCGTGA,0,5267083
zapB_predicted,0.16666666666666666,5,5,TAGGTCTTATAGCCACGGTC,0,5281987
zapB_predicted,0.16666666666666666,5,5,TAGACATGAACTCAAGAATT,0,5279412
zapB_predicted,0.16666666666666666,5,5,TACGGGACGCTCATCCCCGG,0,5278722
zapB_predicted,0.16666666666666666,5,5,TACCGGTGTGATACCAATAT,0,5264126
zapB_predicted,0.16666666666666666,5,5,TACATGTGCGGCGTGTGTGC,0,5283475
zapB_predicted,0.16666666666666666,5,5,TACAAACCGGCATAAACCGG,0,5280333
zapB_predicted,0.16666666666666666,5,5,TAATGGGAACGTATTAAACG,0,5288136
zapB_predicted,0.16666666666666666,5,5,TAATATCGTCCTGAACGCAG,0,5287550
zapB_predicted,0.16666666666666666,5,5,TAATAAGCTCTGTAGGGTTC,0,5264460
zapB_predicted,0.16666666666666666,5,5,TAAGGTACGCGTTCGGAGAG,0,5274673
zapB_predicted,0.16666666666666666,5,5,TAAGGGAGGATCCGCCCAGG,0,5263724
zapB_predicted,0.16666666666666666,5,5,TAACAGGAGTGGCGAAACGC,0,5271626
zapB_predicted,0.16666666666666666,5,5,TAAATGCAGTATTCAACTGT,0,5273998
zapB_predicted,0.16666666666666666,5,5,TAAAGTGGGGATGGAGGGCT,0,5273621
zapB_predicted,0.16666666666666666,5,5,TAAAGTCTCTATGTTCGATT,0,5265532
zapB_predicted,0.16666666666666666,5,5,TAAAGGAATCGGAAAAAGTA,0,5264763
zapB_predicted,0.16666666666666666,5,5,GTTTGCGATCTCCGTCGGCT,0,5263354
zapB_predicted,0.16666666666666666,5,5,GTTTCGTCCGGAAATGTCGT,0,5286262
zapB_predicted,0.16666666666666666,5,5,GTTGTTCACAGAGCCGCTCG,0,5281066
zapB_predicted,0.16666666666666666,5,5,GTTGAAGCGGCCTTTAGATG,0,5275925
zapB_predicted,0.16666666666666666,5,5,GTTCTCATGCGAGCGAGCGG,0,5287844
zapB_predicted,0.16666666666666666,5,5,GTTCGTATCTGGACGCTACA,0,5272590
zapB_predicted,0.16666666666666666,5,5,GTTCGCACACTCTAGGAGGG,0,5269031
zapB_predicted,0.16666666666666666,5,5,GTGTTTTTGTTGACACCCTC,0,5283854
zapB_predicted,0.16666666666666666,5,5,GTGTTCCACACAGGTTCGGA,0,5274854
zapB_predicted,0.16666666666666666,5,5,GTGTGGCGGGGCAAGTAACG,0,5285570
zapB_predicted,0.16666666666666666,5,5,GTGTCATGCACTCGCTGGGT,0,5272728
zapB_predicted,0.16666666666666666,5,5,GTGGTTTGTCGGAAGGAGGT,0,5264255
zapB_predicted,0.16666666666666666,5,5,GTGGGTATGGAACGGGACGA,0,5267707
zapB_predicted,0.16666666666666666,5,5,GTGGAACCCTTCTACGCTTT,0,5271621
zapB_predicted,0.16666666666666666,5,5,GTGGAAAGCACTAAATGATT,0,5277423
zapB_predicted,0.16666666666666666,5,5,GTGCTATGTCCACTCTGGCC,0,5278524
zapB_predicted,0.16666666666666666,5,5,GTGATGCCATTGAGATATAA,0,5277388
zapB_predicted,0.16666666666666666,5,5,GTCTTCGTGCGCGCCTCTAT,0,5271628
zapB_predicted,0.16666666666666666,5,5,GTCTTAATAGCACATGCGGC,0,5286907
zapB_predicted,0.16666666666666666,5,5,GTCTAGAAAGCATGGGGGTG,0,5285588
zapB_predicted,0.16666666666666666,5,5,GTCGAAGATTTTACCAGGCC,0,5278489
zapB_predicted,0.16666666666666666,5,5,GTCCGTCCGCGGGAGGCTCA,0,5284118
zapB_predicted,0.16666666666666666,5,5,GTCCGAAAGTGTTGTTGGTA,0,5282719
zapB_predicted,0.16666666666666666,5,5,GTCATACCCGCGAAATTGTC,0,5282143
zapB_predicted,0.16666666666666666,5,5,GTCAGGACACGCTCTGCATA,0,5269333
zapB_predicted,0.16666666666666666,5,5,GTCAATTCTTCGCCTAGATA,0,5287140
zapB_predicted,0.16666666666666666,5,5,GTATGACTGTGTTCTCACTT,0,5270553
zapB_predicted,0.16666666666666666,5,5,GTATCCACGCTTTGTACACA,0,5272849
zapB_predicted,0.16666666666666666,5,5,GTAGTGAGAAAGCCCCCAGT,0,5279571
zapB_predicted,0.16666666666666666,5,5,GTAGCGCGTAAGTCGCACCA,0,5271102
zapB_predicted,0.16666666666666666,5,5,GTAGAGATTAATTGTCCCGA,0,5270905
zapB_predicted,0.16666666666666666,5,5,GTACCACACTCGTTCAAGAT,0,5285254
zapB_predicted,0.16666666666666666,5,5,GTAACGGCGGTAGACTAGAT,0,5280902
zapB_predicted,0.16666666666666666,5,5,GTAACGAACCATACCGGCGA,0,5280732
zapB_predicted,0.16666666666666666,5,5,GTAACCCTCCTTACGCCCGG,0,5274683
zapB_predicted,0.16666666666666666,5,5,GGTTTGAGATGAGTACTATC,0,5271742
zapB_predicted,0.16666666666666666,5,5,GGTTTCGCCCAGCAGAGCTC,0,5286855
zapB_predicted,0.16666666666666666,5,5,GGTTCATATGGCGTCTTTAT,0,5279729
zapB_predicted,0.16666666666666666,5,5,GGTCGTCCAGGACCGAATGA,0,5286826
zapB_predicted,0.16666666666666666,5,5,GGTCCCAAGCAGGGTCATGG,0,5271303
zapB_predicted,0.16666666666666666,5,5,GGTACCCTAATACTCGTAAC,0,5276832
zapB_predicted,0.16666666666666666,5,5,GGTACATACAGTAGGTTGGT,0,5266973
zapB_predicted,0.16666666666666666,5,5,GGTAACTCGCCAGTGATCTT,0,5267251
zapB_predicted,0.16666666666666666,5,5,GGGTTAGTCGATCTATAATC,0,5285355
zapB_predicted,0.16666666666666666,5,5,GGGTGGTGGAAACACAGGAC,0,5278306
zapB_predicted,0.16666666666666666,5,5,GGGTGGAGATCTTATCCTGT,0,5273767
zapB_predicted,0.16666666666666666,5,5,GGGTATTTTATAACTCCTAG,0,5278633
zapB_predicted,0.16666666666666666,5,5,GGGTAGCATCGGGTCCCTCC,0,5266051
zapB_predicted,0.16666666666666666,5,5,GGGTACTTAACCATACAAGC,0,5283496
zapB_predicted,0.16666666666666666,5,5,GGGGAGAGCGGGCTTAACGT,0,5278794
zapB_predicted,0.16666666666666666,5,5,GGGCTATTGACGAGTGATCA,0,5274154
zapB_predicted,0.16666666666666666,5,5,GGGCGGAGGCTTATGCAGAA,0,5266458
zapB_predicted,0.16666666666666666,5,5,GGCTTTAAGCGCGTCCGCAA,0,5277926
zapB_predicted,0.16666666666666666,5,5,GGCTTGTATTGCTCCCAGAA,0,5267950
zapB_predicted,0.16666666666666666,5,5,GGCTGGCGCGACCACTGTGC,0,5273178
zapB_predicted,0.16666666666666666,5,5,GGCGTTCCCTCTCAGATGAG,0,5275219
zapB_predicted,0.16666666666666666,5,5,GGCGGGAACCGTCAACTGTC,0,5284045
zapB_predicted,0.16666666666666666,5,5,GGCCGTCACACACGTGTAAC,0,5263401
zapB_predicted,0.16666666666666666,5,5,GGCAAGGACACCATATCGGG,0,5274780
zapB_predicted,0.16666666666666666,5,5,GGATCCGAGGTCAGGTGGAA,0,5281493
zapB_predicted,0.16666666666666666,5,5,GGATCAAGGCCAAACTATCT,0,5272582
zapB_predicted,0.16666666666666666,5,5,GGAGCGAAGTACTGAGCTGT,0,5274819
zapB_predicted,0.16666666666666666,5,5,GGACTTGCCTTAAGGTACAG,0,5266049
zapB_predicted,0.16666666666666666,5,5,GGACTAGACAGTCTTTAATG,0,5285027
zapB_predicted,0.16666666666666666,5,5,GGACCGCTGGAGGTCGCAGC,0,5273957
zapB_predicted,0.16666666666666666,5,5,GGACCAGCTTGTTCAGGATG,0,5263868
zapB_predicted,0.16666666666666666,5,5,GGAATCCCACCCACACGAAC,0,5277685
zapB_predicted,0.16666666666666666,5,5,GGAATAGTTGAATCGCCCTT,0,5286932
zapB_predicted,0.16666666666666666,5,5,GCTTTGTCCGTCGTGATAAG,0,5263387
zapB_predicted,0.16666666666666666,5,5,GCTTGCTATACCGCGGTCAA,0,5267093
zapB_predicted,0.16666666666666666,5,5,GCTTCTTAGAGTTACGGCGG,0,5274236
zapB_predicted,0.16666666666666666,5,5,GCTGGTACAACAGCGTCCGT,0,5265868
zapB_predicted,0.16666666666666666,5,5,GCTCCCGCGTGAACGTCATA,0,5276848
zapB_predicted,0.16666666666666666,5,5,GCTCCATAGTCGTTAGCCTT,0,5274744
zapB_predicted,0.16666666666666666,5,5,GCTACATACAACGGGGACAG,0,5280855
zapB_predicted,0.16666666666666666,5,5,GCGTTCCGCGTCGTGCGGGT,0,5282924
zapB_predicted,0.16666666666666666,5,5,GCGGTGCACGTATCGGGGGA,0,5273335
zapB_predicted,0.16666666666666666,5,5,GCGGCGTCCTCGGCCCCCGG,0,5286909
zapB_predicted,0.16666666666666666,5,5,GCGCCATATATCCGTATCAC,0,5280882
zapB_predicted,0.16666666666666666,5,5,GCGCATGTTGGAATAATGAA,0,5270324
zapB_predicted,0.16666666666666666,5,5,GCGCAGTAAACCGTACAAGA,0,5270606
zapB_predicted,0.16666666666666666,5,5,GCGATTCGGAATTTCAAAGT,0,5284598
zapB_predicted,0.16666666666666666,5,5,GCGAAAGCGTGCATGGTCTC,0,5265634
zapB_predicted,0.16666666666666666,5,5,GCCTTCGCTGAAAGGCACCC,0,5266176
zapB_predicted,0.16666666666666666,5,5,GCCTTCGACGCCCCGTATCT,0,5272235
zapB_predicted,0.16666666666666666,5,5,GCCTGACTATCCGGCAATTA,0,5279618
zapB_predicted,0.16666666666666666,5,5,GCCCTTGTGGCAATGTCCGT,0,5276464
zapB_predicted,0.16666666666666666,5,5,GCCCGTACGCGCCGTACACG,0,5270470
zapB_predicted,0.16666666666666666,5,5,GCCCCTAAGTCGTCTTTCTA,0,5271524
zapB_predicted,0.16666666666666666,5,5,GCCCCGTGTACCATCGGGCT,0,5271978
zapB_predicted,0.16666666666666666,5,5,GCATTCGTGCGAACAGCATC,0,5267148
zapB_predicted,0.16666666666666666,5,5,GCATTAGAAGTATTTTTTGC,0,5285311
zapB_predicted,0.16666666666666666,5,5,GCATGGACGATGGGCTCATC,0,5277398
zapB_predicted,0.16666666666666666,5,5,GCAGTCGATCCACTACTTTA,0,5263898
zapB_predicted,0.16666666666666666,5,5,GCAGCATGGGCGAATGTCCC,0,5283348
zapB_predicted,0.16666666666666666,5,5,GCACTATGCCGTATTGTGTC,0,5272807
zapB_predicted,0.16666666666666666,5,5,GCACTAAGTAAACTTTGTTA,0,5274669
zapB_predicted,0.16666666666666666,5,5,GCACAGCTTAATCGCACTGT,0,5263361
zapB_predicted,0.16666666666666666,5,5,GCAAATTTCATAGCTAGCTA,0,5270131
zapB_predicted,0.16666666666666666,5,5,GCAAAAATTTGTACATTATA,0,5270205
zapB_predicted,0.16666666666666666,5,5,GATTTTTAGGCAGTAGCTAT,0,5274025
zapB_predicted,0.16666666666666666,5,5,GATTTGATACCCGATCAGAA,0,5279436
zapB_predicted,0.16666666666666666,5,5,GATGTCAACCACAACACGCC,0,5281361
zapB_predicted,0.16666666666666666,5,5,GATGGATCCTTCCTAAGAGT,0,5287454
zapB_predicted,0.16666666666666666,5,5,GATGAGCAGCTACGCTGTAG,0,5269596
zapB_predicted,0.16666666666666666,5,5,GATCTCAGCCTCAACCTGTA,0,5273757
zapB_predicted,0.16666666666666666,5,5,GATAGCTAAACTTCTAACCT,0,5264510
zapB_predicted,0.16666666666666666,5,5,GATACTGTCTACGAAGGTGA,0,5280353
zapB_predicted,0.16666666666666666,5,5,GAGTCCTTCGGGTGGTCACA,0,5285301
zapB_predicted,0.16666666666666666,5,5,GAGGTAGACTGCTAGTCTTT,0,5267838
zapB_predicted,0.16666666666666666,5,5,GAGGCCCTCAAACCAAAGCA,0,5278517
zapB_predicted,0.16666666666666666,5,5,GAGCGTGTAGGATATCGAAT,0,5285325
zapB_predicted,0.16666666666666666,5,5,GAGCGGTCGGCTGATCGTCA,0,5273150
zapB_predicted,0.16666666666666666,5,5,GAGCCCACAGTCTGAACTAA,0,5283440
zapB_predicted,0.16666666666666666,5,5,GACTTTCGATAAAATCTGCG,0,5275469
zapB_predicted,0.16666666666666666,5,5,GACTAAGATCATCCAGCGGC,0,5275245
zapB_predicted,0.16666666666666666,5,5,GACGAGCGGACGGCTAGGGG,0,5280208
zapB_predicted,0.16666666666666666,5,5,GACGACTTCCCCCCTCAGGT,0,5266191
zapB_predicted,0.16666666666666666,5,5,GACCTCTCCCCGCGTTCCCA,0,5263763
zapB_predicted,0.16666666666666666,5,5,GACCAAGCAGGAGATGCCAA,0,5270487
zapB_predicted,0.16666666666666666,5,5,GACATATGCCGTGCGTGGTG,0,5266907
zapB_predicted,0.16666666666666666,5,5,GACAATTTGGCTCTAAGTTA,0,5282424
zapB_predicted,0.16666666666666666,5,5,GAATCGTGGTTTACTAAGTA,0,5280914
zapB_predicted,0.16666666666666666,5,5,GAAGTTATCGCGAACCGGCA,0,5276364
zapB_predicted,0.16666666666666666,5,5,GAAGTCCTAATGTGTCAGGT,0,5285838
zapB_predicted,0.16666666666666666,5,5,GAAGGTCTCAACTATGCATA,0,5282166
zapB_predicted,0.16666666666666666,5,5,GAAGAAATCTCAGTCCGGAC,0,5286393
zapB_predicted,0.16666666666666666,5,5,GAACCTCAGGACCACATCAG,0,5268940
zapB_predicted,0.16666666666666666,5,5,GAAAAGAATTGACTCGAAGG,0,5266960
zapB_predicted,0.16666666666666666,5,5,CTTCCTGGCTAAGCGTTTGT,0,5264902
zapB_predicted,0.16666666666666666,5,5,CTTATCACCTGGGAGCCCAT,0,5279100
zapB_predicted,0.16666666666666666,5,5,CTGGGGCAATCCTTTGGGTT,0,5278481
zapB_predicted,0.16666666666666666,5,5,CTGGCACGCTATGAAGCCTT,0,5285109
zapB_predicted,0.16666666666666666,5,5,CTGGACAAATTATCAGGAGT,0,5267962
zapB_predicted,0.16666666666666666,5,5,CTGAGGCTGTTTAATAGTAC,0,5287307
zapB_predicted,0.16666666666666666,5,5,CTCTCCGCACGCGGAGAATC,0,5286269
zapB_predicted,0.16666666666666666,5,5,CTCGCCTTCATTGGACTCAC,0,5272484
zapB_predicted,0.16666666666666666,5,5,CTCGAGTCACTTCATTTGGT,0,5267480
zapB_predicted,0.16666666666666666,5,5,CTCCTGGAATATTCACGCAA,0,5277877
zapB_predicted,0.16666666666666666,5,5,CTCCGGGCGCGGCCGGGACG,0,5276808
zapB_predicted,0.16666666666666666,5,5,CTCCCGCTCCACGCGCGGAC,0,5273722
zapB_predicted,0.16666666666666666,5,5,CTCAGCGGAGATTGTGGTTG,0,5284154
zapB_predicted,0.16666666666666666,5,5,CTCACTTCAGTTTCACGGAT,0,5278901
zapB_predicted,0.16666666666666666,5,5,CTATCCACGCTCACGCAACT,0,5269989
zapB_predicted,0.16666666666666666,5,5,CTAGCTGGTAATCTGGTTTA,0,5276005
zapB_predicted,0.16666666666666666,5,5,CTAGACGGGGAGCATCTCTA,0,5270601
zapB_predicted,0.16666666666666666,5,5,CTACGTCGTTCCAGACTCTG,0,5283809
zapB_predicted,0.16666666666666666,5,5,CTACCTTGTCCATTAGTCTG,0,5287936
zapB_predicted,0.16666666666666666,5,5,CGTTGTTCCGCGACGGTGGT,0,5271956
zapB_predicted,0.16666666666666666,5,5,CGTTCTCCAGATTACGGAAC,0,5287559
zapB_predicted,0.16666666666666666,5,5,CGTTCCTCAAGAAAGTAGAA,0,5287852
zapB_predicted,0.16666666666666666,5,5,CGTTCACCCCGGTGCGTCGA,0,5283755
zapB_predicted,0.16666666666666666,5,5,CGTGGATGTAGGGCCTGCGT,0,5282657
zapB_predicted,0.16666666666666666,5,5,CGTAGCTTGTGCGGCATGTA,0,5285820
zapB_predicted,0.16666666666666666,5,5,CGTAGCTGGTTATACGTCAT,0,5275152
zapB_predicted,0.16666666666666666,5,5,CGTAGAACGTCAATTGGCTC,0,5285037
zapB_predicted,0.16666666666666666,5,5,CGTAATTATACGCTTCACAG,0,5265475
zapB_predicted,0.16666666666666666,5,5,CGGTTTTAGCGGTCGCACGC,0,5281245
zapB_predicted,0.16666666666666666,5,5,CGGTTTAATTAACTATTTTG,0,5269816
zapB_predicted,0.16666666666666666,5,5,CGGTTGAAGTTCCGGGATCT,0,5268528
zapB_predicted,0.16666666666666666,5,5,CGGTCGATCCTAGTCCCCTT,0,5285053
zapB_predicted,0.16666666666666666,5,5,CGGGTGTAGCTGGCCACTCA,0,5263957
zapB_predicted,0.16666666666666666,5,5,CGGGACGACTTGCTCAACAT,0,5267625
zapB_predicted,0.16666666666666666,5,5,CGGCTTGGCCCCATACATCC,0,5275888
zapB_predicted,0.16666666666666666,5,5,CGGCTTGACAGGTCAAAGCA,0,5275839
zapB_predicted,0.16666666666666666,5,5,CGGCGCATGGGCGCATAAGA,0,5263312
zapB_predicted,0.16666666666666666,5,5,CGGATGCTTTAGGCAAGTTC,0,5281741
zapB_predicted,0.16666666666666666,5,5,CGGAGTTCGATAAACCCCGA,0,5268749
zapB_predicted,0.16666666666666666,5,5,CGGACCTCTACTCCCACAGA,0,5288336
zapB_predicted,0.16666666666666666,5,5,CGCTCTTCTTTCGGTTCACA,0,5273235
zapB_predicted,0.16666666666666666,5,5,CGCTCCGAACGAACGTATTA,0,5288137
zapB_predicted,0.16666666666666666,5,5,CGCCGTCGCGACGACGCTTA,0,5286218
zapB_predicted,0.16666666666666666,5,5,CGCACCGGGGGGTAGCCTAG,0,5274547
zapB_predicted,0.16666666666666666,5,5,CGACGACTTGGTTTGGTCGT,0,5265494
zapB_predicted,0.16666666666666666,5,5,CGAAACTGGCTAGAAATTAT,0,5288090
zapB_predicted,0.16666666666666666,5,5,CCTTTGCTAACTCATTGTCA,0,5286246
zapB_predicted,0.16666666666666666,5,5,CCTTTGATGCCGGGGTCCAG,0,5272664
zapB_predicted,0.16666666666666666,5,5,CCTTGAGCTCCGGTGTGTCC,0,5272063
zapB_predicted,0.16666666666666666,5,5,CCTTAGATTGACCGCTCGAG,0,5277314
zapB_predicted,0.16666666666666666,5,5,CCTGCGATACGGAGCAAGCT,0,5274442
zapB_predicted,0.16666666666666666,5,5,CCTCTTCCTCAAAATACCGG,0,5276250
zapB_predicted,0.16666666666666666,5,5,CCTCTAAGATTGAAACTAGG,0,5277899
zapB_predicted,0.16666666666666666,5,5,CCTCGGCAAACGAATATTAC,0,5282383
zapB_predicted,0.16666666666666666,5,5,CCTCACGTTGCTTGCGGGTC,0,5270477
zapB_predicted,0.16666666666666666,5,5,CCGTGTGGACCCAGCTACGA,0,5269306
zapB_predicted,0.16666666666666666,5,5,CCGGGTAAGCCGTTTGTCCG,0,5280168
zapB_predicted,0.16666666666666666,5,5,CCGCCTCCTATTTGCTACGT,0,5286666
zapB_predicted,0.16666666666666666,5,5,CCGCCCTGTCGTAATACCGT,0,5272917
zapB_predicted,0.16666666666666666,5,5,CCGATATCGGTTGGAGGTTC,0,5288255
zapB_predicted,0.16666666666666666,5,5,CCGACGGTTATTTGCAAACT,0,5278008
zapB_predicted,0.16666666666666666,5,5,CCCTCTCATTCTCCTAGAAG,0,5264674
zapB_predicted,0.16666666666666666,5,5,CCCTCGGTTGACATGCCTGC,0,5268334
zapB_predicted,0.16666666666666666,5,5,CCCGTTCTCTCCGGGGCTGC,0,5270702
zapB_predicted,0.16666666666666666,5,5,CCCGGCGCGAGTAGCTGCGG,0,5276712
zapB_predicted,0.16666666666666666,5,5,CCCGATAACAGCGATGGTTG,0,5271933
zapB_predicted,0.16666666666666666,5,5,CCCATACGTGGCCCTCGTGA,0,5270085
zapB_predicted,0.16666666666666666,5,5,CCCACGCTCATGGTCCTGAC,0,5266893
zapB_predicted,0.16666666666666666,5,5,CCCAAAAAGAGGCGGTAAAC,0,5277610
zapB_predicted,0.16666666666666666,5,5,CCAGTTCACGAGGCCCCAAC,0,5266000
zapB_predicted,0.16666666666666666,5,5,CCAGGCATGGTACTGGATGC,0,5278690
zapB_predicted,0.16666666666666666,5,5,CCAGGATTGCTTGCGGAATG,0,5271373
zapB_predicted,0.16666666666666666,5,5,CCACTGGTGGCTTTGGATAT,0,5273071
zapB_predicted,0.16666666666666666,5,5,CCACGAATGACTCCAAGTCC,0,5276709
zapB_predicted,0.16666666666666666,5,5,CCACATTGCTCTCGCCACGG,0,5288076
zapB_predicted,0.16666666666666666,5,5,CCACATAGCGTTCTTAGAGA,0,5277147
zapB_predicted,0.16666666666666666,5,5,CCACAGAGTGCGTACAGGCG,0,5277791
zapB_predicted,0.16666666666666666,5,5,CCAACCGCAATAGGGGCACG,0,5286359
zapB_predicted,0.16666666666666666,5,5,CATTGGAAAGGTCCGTATTG,0,5269322
zapB_predicted,0.16666666666666666,5,5,CATTACGAGAGCATGGTCGT,0,5282540
zapB_predicted,0.16666666666666666,5,5,CATGGTTGGATTCGGCCGAT,0,5276357
zapB_predicted,0.16666666666666666,5,5,CATGGTTCCACACGATTCTT,0,5266420
zapB_predicted,0.16666666666666666,5,5,CATGGTACGTGTTACAAGCT,0,5266488
zapB_predicted,0.16666666666666666,5,5,CATCTACGTCTCCTTTGGTC,0,5273192
zapB_predicted,0.16666666666666666,5,5,CATCGCGGCACCTTTGGGGC,0,5271910
zapB_predicted,0.16666666666666666,5,5,CATACATGGCAAAAGATGTA,0,5282451
zapB_predicted,0.16666666666666666,5,5,CATAAGCAGTGTCGTCCCTT,0,5281983
zapB_predicted,0.16666666666666666,5,5,CATAAATACTATGAGCAGCC,0,5287851
zapB_predicted,0.16666666666666666,5,5,CAGTCGGCACAAACTACCTA,0,5275748
zapB_predicted,0.16666666666666666,5,5,CAGGAGTGAATAGCAGGAGC,0,5282014
zapB_predicted,0.16666666666666666,5,5,CAGGAAGTCCTTTTCTCGTG,0,5276918
zapB_predicted,0.16666666666666666,5,5,CAGCCCCGTACATCAAATTT,0,5269399
zapB_predicted,0.16666666666666666,5,5,CAGCAGTGTAGTTGTTATAT,0,5286324
zapB_predicted,0.16666666666666666,5,5,CAGATCCAATCGCGATTTGT,0,5273740
zapB_predicted,0.16666666666666666,5,5,CAGATAACGTGCCCCCGTCT,0,5264646
zapB_predicted,0.16666666666666666,5,5,CAGAATCTCTTCACCACTGT,0,5285646
zapB_predicted,0.16666666666666666,5,5,CACTGGGAAGCGGTTCTATT,0,5277773
zapB_predicted,0.16666666666666666,5,5,CACTCTCGGAGAGTGCATCC,0,5274581
zapB_predicted,0.16666666666666666,5,5,CACGTTCCAAATTTTGGCAG,0,5271295
zapB_predicted,0.16666666666666666,5,5,CACGTGGACACGTTGCGTGC,0,5282107
zapB_predicted,0.16666666666666666,5,5,CACCGCGCCGTGCGACCATT,0,5280976
zapB_predicted,0.16666666666666666,5,5,CACCCGGGGTGTTTACCACT,0,5284747
zapB_predicted,0.16666666666666666,5,5,CACATTAATAGATGCCACAA,0,5284971
zapB_predicted,0.16666666666666666,5,5,CACAGACCCGGTGAGCTGGT,0,5278839
zapB_predicted,0.16666666666666666,5,5,CACACAAGGGGAGTGTATCC,0,5279008
zapB_predicted,0.16666666666666666,5,5,CACAAGAGACTCGTATCCGC,0,5280424
zapB_predicted,0.16666666666666666,5,5,CAATAGTCTGCGCCATGGGG,0,5278789
zapB_predicted,0.16666666666666666,5,5,CAAGGTTAGTTCTCAAGCGT,0,5283827
zapB_predicted,0.16666666666666666,5,5,CAACCTTTTGTAGACGGCAA,0,5265201
zapB_predicted,0.16666666666666666,5,5,CAACCTGTTCGAGATATGGA,0,5285303
zapB_predicted,0.16666666666666666,5,5,CAAACACTGCTTCCGCTTCA,0,5275544
zapB_predicted,0.16666666666666666,5,5,CAAAAACCTAAGGTCCTACT,0,5266661
zapB_predicted,0.16666666666666666,5,5,ATTTGGTAAACCTCCTTAAG,0,5278409
zapB_predicted,0.16666666666666666,5,5,ATTTACCGATCTATTCGGGA,0,5286963
zapB_predicted,0.16666666666666666,5,5,ATTGTTACCTTGCGATCGTG,0,5267949
zapB_predicted,0.16666666666666666,5,5,ATTGTAGTATGTAGTAGTGG,0,5265802
zapB_predicted,0.16666666666666666,5,5,ATTGCATCCAACTCACAGTT,0,5266358
zapB_predicted,0.16666666666666666,5,5,ATTCGTTCCGGTTTCAGAAA,0,5265119
zapB_predicted,0.16666666666666666,5,5,ATTCCGCCCCGCCGCCGAGT,0,5283865
zapB_predicted,0.16666666666666666,5,5,ATTCCGCCACAGTAGTAAGA,0,5284659
zapB_predicted,0.16666666666666666,5,5,ATTATTCAACGCAGGCTGTC,0,5275207
zapB_predicted,0.16666666666666666,5,5,ATTAGTTATCACGCTTCATT,0,5264717
zapB_predicted,0.16666666666666666,5,5,ATGTTTGGCCCACTCCGATT,0,5277374
zapB_predicted,0.16666666666666666,5,5,ATGTTCCTGGGCCATACGAA,0,5280337
zapB_predicted,0.16666666666666666,5,5,ATGTGCTTGTTGGGAAACTG,0,5274352
zapB_predicted,0.16666666666666666,5,5,ATGTCTATAGGGGCTTGTTG,0,5288357
zapB_predicted,0.16666666666666666,5,5,ATGTCGAATCGCGTAACTCG,0,5263352
zapB_predicted,0.16666666666666666,5,5,ATGGGTAGACTCTTTTCTTC,0,5287513
zapB_predicted,0.16666666666666666,5,5,ATGGGGAGAGGGCCGATAAG,0,5275734
zapB_predicted,0.16666666666666666,5,5,ATGCCTTTGACATAATCCGC,0,5286562
zapB_predicted,0.16666666666666666,5,5,ATGCCCCTGGCGGCATGAAG,0,5273585
zapB_predicted,0.16666666666666666,5,5,ATGCAATCACGGCAAAGTCC,0,5268705
zapB_predicted,0.16666666666666666,5,5,ATGAGGTGACCTGGGCTATC,0,5270157
zapB_predicted,0.16666666666666666,5,5,ATGACTCTTCGGTGTTCATT,0,5284056
zapB_predicted,0.16666666666666666,5,5,ATCTAGGGATGCCGAGGTCA,0,5263908
zapB_predicted,0.16666666666666666,5,5,ATCGTTTAGCCGACCTTAAT,0,5283649
zapB_predicted,0.16666666666666666,5,5,ATCGTAGCGTCCATAATCTT,0,5279572
zapB_predicted,0.16666666666666666,5,5,ATCGGCATTTTTCGTCTTTG,0,5283677
zapB_predicted,0.16666666666666666,5,5,ATCCTTACTGAACCGCCCTT,0,5274912
zapB_predicted,0.16666666666666666,5,5,ATCCGGTATGGCTGCCGTAT,0,5277517
zapB_predicted,0.16666666666666666,5,5,ATCCCCCTGCATGCACCAAA,0,5265187
zapB_predicted,0.16666666666666666,5,5,ATCAATTTGCCCCGTGTAGT,0,5268029
zapB_predicted,0.16666666666666666,5,5,ATCAAAGCCGTGGCTCTTGT,0,5275407
zapB_predicted,0.16666666666666666,5,5,ATAGCTAGTTAGGGGTCCAT,0,5275511
zapB_predicted,0.16666666666666666,5,5,ATACGGGCGTAGGGTCTGCG,0,5280637
zapB_predicted,0.16666666666666666,5,5,ATACAGCACGAACGGGAGCC,0,5283198
zapB_predicted,0.16666666666666666,5,5,ATAATGCGAGCACCTTTGAC,0,5267386
zapB_predicted,0.16666666666666666,5,5,AGTTGTTCCAAGCTATTTTA,0,5276283
zapB_predicted,0.16666666666666666,5,5,AGTGTGCGTGTTGGTGCGAA,0,5263049
zapB_predicted,0.16666666666666666,5,5,AGTGTCCCTACACGAACTAA,0,5270750
zapB_predicted,0.16666666666666666,5,5,AGTGATTTCTCTGGAGCTAA,0,5287185
zapB_predicted,0.16666666666666666,5,5,AGTGAAATAGAACGGCAGTG,0,5266205
zapB_predicted,0.16666666666666666,5,5,AGTCTTTAAAGTATGTACCT,0,5270595
zapB_predicted,0.16666666666666666,5,5,AGTCTAGCGGCATGCCAAGG,0,5277174
zapB_predicted,0.16666666666666666,5,5,AGTCTAGAGCGCTACTGTTA,0,5266580
zapB_predicted,0.16666666666666666,5,5,AGTATCGGTGAATCGAAGGG,0,5285345
zapB_predicted,0.16666666666666666,5,5,AGTAGCGCCAGGCCCGGTCT,0,5270700
zapB_predicted,0.16666666666666666,5,5,AGGTCTGCGACCGCAGTTTT,0,5275171
zapB_predicted,0.16666666666666666,5,5,AGGTAATTCATTAGTGGGAG,0,5266209
zapB_predicted,0.16666666666666666,5,5,AGGGCTTACGGAACAAGGAA,0,5268833
zapB_predicted,0.16666666666666666,5,5,AGGAGTCCGATCTACCCGCC,0,5275305
zapB_predicted,0.16666666666666666,5,5,AGGAGTAACATATCCGTATC,0,5264114
zapB_predicted,0.16666666666666666,5,5,AGGAAAAATGAGCGCACCGA,0,5287027
zapB_predicted,0.16666666666666666,5,5,AGCGTAGCTTGAGCAAGTCG,0,5270554
zapB_predicted,0.16666666666666666,5,5,AGCCTCTCGCAGCGTCTTCG,0,5288413
zapB_predicted,0.16666666666666666,5,5,AGCCATTGTGGACTTGTAGG,0,5264732
zapB_predicted,0.16666666666666666,5,5,AGCACGGATTTCGCGGTCTT,0,5285129
zapB_predicted,0.16666666666666666,5,5,AGCAAGGGTTTAAAGATCGA,0,5283260
zapB_predicted,0.16666666666666666,5,5,AGATCGCGTAAGACCACGGC,0,5286087
zapB_predicted,0.16666666666666666,5,5,AGATAAGTAGCAACCCATAA,0,5275875
zapB_predicted,0.16666666666666666,5,5,AGAGTAGAAGAATCCGTCCG,0,5263443
zapB_predicted,0.16666666666666666,5,5,AGACTGGAAAGGCGGCGCAA,0,5279320
zapB_predicted,0.16666666666666666,5,5,AGACACTCCGTTGGTGAGGC,0,5276581
zapB_predicted,0.16666666666666666,5,5,ACTTTGCTAGGGATTTGAAC,0,5267611
zapB_predicted,0.16666666666666666,5,5,ACTGGCAAGTGAGCCCCTTA,0,5286961
zapB_predicted,0.16666666666666666,5,5,ACTCTTGACCCTGCGTTTCA,0,5272093
zapB_predicted,0.16666666666666666,5,5,ACTCTCCCCGCTCAGAGGTG,0,5273056
zapB_predicted,0.16666666666666666,5,5,ACTCAAAGTAGGACGGGCGA,0,5286479
zapB_predicted,0.16666666666666666,5,5,ACGTTTCTGATCCGTGGTCC,0,5276604
zapB_predicted,0.16666666666666666,5,5,ACGTATAAGTGCCCAGCGGA,0,5272042
zapB_predicted,0.16666666666666666,5,5,ACGTACAAGCATTCCTCTAT,0,5285476
zapB_predicted,0.16666666666666666,5,5,ACGGGTTAGATTAACTCCGA,0,5282527
zapB_predicted,0.16666666666666666,5,5,ACGGGCTAACAGGAATCCTC,0,5283498
zapB_predicted,0.16666666666666666,5,5,ACGCTCAGGTCACACCTATT,0,5267525
zapB_predicted,0.16666666666666666,5,5,ACGCATTTTCCAGTGGACTC,0,5272096
zapB_predicted,0.16666666666666666,5,5,ACGCAAAATCGGATGCTCCG,0,5267683
zapB_predicted,0.16666666666666666,5,5,ACCTTCCTGACCGCGTGCCC,0,5269495
zapB_predicted,0.16666666666666666,5,5,ACCTGGAAGGACGTTGCAGG,0,5271932
zapB_predicted,0.16666666666666666,5,5,ACCTAGGTCCAAATACCATC,0,5278402
zapB_predicted,0.16666666666666666,5,5,ACCGTAAAGTCCAGTTCGCT,0,5283093
zapB_predicted,0.16666666666666666,5,5,ACCGCACTTTGTGTGTTTCT,0,5280098
zapB_predicted,0.16666666666666666,5,5,ACCGAGGTTGCAGGGGCCTA,0,5275928
zapB_predicted,0.16666666666666666,5,5,ACCCTTTTTAGTGCCATTCT,0,5265002
zapB_predicted,0.16666666666666666,5,5,ACCCCTACGCAAATAAGACT,0,5288317
zapB_predicted,0.16666666666666666,5,5,ACCATTGAAATCAAACAGAT,0,5264537
zapB_predicted,0.16666666666666666,5,5,ACCAAGTAAGCTTTACCTAC,0,5265336
zapB_predicted,0.16666666666666666,5,5,ACCAAGAAGGAGCCACGAGA,0,5274887
zapB_predicted,0.16666666666666666,5,5,ACACTGTCATCATTGCCTTC,0,5286937
zapB_predicted,0.16666666666666666,5,5,ACACGGGGGCTTAACTCGGC,0,5269443
zapB_predicted,0.16666666666666666,5,5,ACAATAAGGCCTGGGTCTCT,0,5276206
zapB_predicted,0.16666666666666666,5,5,AATTCGGTTGTTTTACTGCC,0,5271760
zapB_predicted,0.16666666666666666,5,5,AATGGCCATTGCAAAAATAC,0,5284142
zapB_predicted,0.16666666666666666,5,5,AATGAAGTTATTCCTAAAAC,0,5266030
zapB_predicted,0.16666666666666666,5,5,AATCTTTACGCAGCGCTAGG,0,5282366
zapB_predicted,0.16666666666666666,5,5,AATAATAAGAACATTGGAAT,0,5279128
zapB_predicted,0.16666666666666666,5,5,AAGTTCAAACATCAGGCAAC,0,5265355
zapB_predicted,0.16666666666666666,5,5,AAGTACTGCTGTTCCAATGG,0,5284833
zapB_predicted,0.16666666666666666,5,5,AAGGTGAGTAAACTTTCAAA,0,5282936
zapB_predicted,0.16666666666666666,5,5,AAGGTAAGGTTGATCAGAGC,0,5270185
zapB_predicted,0.16666666666666666,5,5,AAGGGTCAAAGTAGGGTCCA,0,5274242
zapB_predicted,0.16666666666666666,5,5,AAGGCCTTCATTGTTCGCCA,0,5269667
zapB_predicted,0.16666666666666666,5,5,AAGGCAACGACTTTTGAGTT,0,5277891
zapB_predicted,0.16666666666666666,5,5,AAGCTCCAGGACCCTTTACT,0,5265297
zapB_predicted,0.16666666666666666,5,5,AAGCGAAGAGACCGGATGAC,0,5282381
zapB_predicted,0.16666666666666666,5,5,AAGAAAGTGGTAAAGGATTT,0,5270192
zapB_predicted,0.16666666666666666,5,5,AAGAAACAAGTATCCAGAGC,0,5277117
zapB_predicted,0.16666666666666666,5,5,AACCGGCAGGAAAAGCGGCT,0,5275809
zapB_predicted,0.16666666666666666,5,5,AACAGGCATGTTATGACGTA,0,5270880
zapB_predicted,0.16666666666666666,5,5,AAAGTTCACCTGTAGCGATA,0,5263916
zapB_predicted,0.16666666666666666,5,5,AAAGGAGGCGGCACCCTGTA,0,5265420
zapB_predicted,0.16666666666666666,5,5,AAAGCTAGGAAGCCGGTTCT,0,5263124
zapB_predicted,0.16666666666666666,5,5,AAACAGTTCACTTCACGCAA,0,5280464
zapB_predicted,0.16666666666666666,5,5,AAACACCCAGATATAAGTAC,0,5267264
zapB_predicted,0.16666666666666666,5,5,AAACAACAGAAGCCGGAGGA,0,5272827
zapB_predicted,0.16666666666666666,5,5,AAAAGTGGAGCTGCCCGGGA,0,5265325
zapB_predicted,0.2,4,4,TTTTTGAATGGTACACCCGC,0,5288017
zapB_predicted,0.2,4,4,TTTTTATAGTAGCGGATTGT,0,5285996
zapB_predicted,0.2,4,4,TTTTGAGAGTGTCTCTTCCA,0,5267560
zapB_predicted,0.2,4,4,TTTTCGCCCCAGGCCCGGCT,0,5266479
zapB_predicted,0.2,4,4,TTTTATTTTTTAGACTATCA,0,5288072
zapB_predicted,0.2,4,4,TTTGTGAAATATAGACAGCA,0,5274753
zapB_predicted,0.2,4,4,TTTGGGCGCTTTCGTTCCTT,0,5263535
zapB_predicted,0.2,4,4,TTTGGACAAGATACGGCATT,0,5276516
zapB_predicted,0.2,4,4,TTTGACTCTTTGGGACCAGA,0,5265838
zapB_predicted,0.2,4,4,TTTCCGTTTATCGGACCTCT,0,5276368
zapB_predicted,0.2,4,4,TTTCCATCTGCTTGAAAGTC,0,5285561
zapB_predicted,0.2,4,4,TTTCAAAGTCTCGTTACTCT,0,5272341
zapB_predicted,0.2,4,4,TTTAGTGTCTGAAAAGTCAA,0,5264811
zapB_predicted,0.2,4,4,TTTAGCTAAGACCGGAACCA,0,5266807
zapB_predicted,0.2,4,4,TTTAGCAGGAGACGTCTGAG,0,5277601
zapB_predicted,0.2,4,4,TTGTTCAAATAACGATGTCT,0,5268795
zapB_predicted,0.2,4,4,TTGTAAATCGGTCGTTCCAG,0,5274970
zapB_predicted,0.2,4,4,TTGCCCTATAGCGTTGTTGT,0,5269334
zapB_predicted,0.2,4,4,TTGCCAAGACCGGGATGGCT,0,5266131
zapB_predicted,0.2,4,4,TTGATTTCAAAATGTGCTTA,0,5273747
zapB_predicted,0.2,4,4,TTGAAAGCTGGACCCTCTAG,0,5269506
zapB_predicted,0.2,4,4,TTCTGCCGGTAGTTTCCGTG,0,5287873
zapB_predicted,0.2,4,4,TTCGGGAATTCATTACGTAA,0,5269702
zapB_predicted,0.2,4,4,TTCGGAAGTTCGGGCGCAAA,0,5285616
zapB_predicted,0.2,4,4,TTCGATTTGCTGATTCGTAC,0,5285621
zapB_predicted,0.2,4,4,TTCGACACGACTGCCGTTAC,0,5271376
zapB_predicted,0.2,4,4,TTCCGGTCAACGCTTATTTT,0,5268973
zapB_predicted,0.2,4,4,TTCATGATCGCTGGGGCTCG,0,5279228
zapB_predicted,0.2,4,4,TTCAGAAACGGGGACCAAGA,0,5277107
zapB_predicted,0.2,4,4,TTCAAGCGTTATTCGTCGAA,0,5270870
zapB_predicted,0.2,4,4,TTATTTTCATTAAAAACCAT,0,5269629
zapB_predicted,0.2,4,4,TTATGGAGTCATTATAACAT,0,5284549
zapB_predicted,0.2,4,4,TTATCTATCAGTTCTTCGGT,0,5263967
zapB_predicted,0.2,4,4,TTATATCACATCGTCGCGGT,0,5286797
zapB_predicted,0.2,4,4,TTAGGCCGGTTCCTTACTTC,0,5266527
zapB_predicted,0.2,4,4,TTAGCCCGACGAACGGCTCC,0,5286991
zapB_predicted,0.2,4,4,TTACCCCAGGCATAACAGTA,0,5276100
zapB_predicted,0.2,4,4,TTAAGGACCTTCATAGCTAA,0,5280220
zapB_predicted,0.2,4,4,TTAACATGGTCTATAGGCAG,0,5276042
zapB_predicted,0.2,4,4,TGTTGCAGAGTCTAAGGATA,0,5278052
zapB_predicted,0.2,4,4,TGTTCTCAGTGACAGGTTGT,0,5269255
zapB_predicted,0.2,4,4,TGTTAGCAGTGCGAACCCAC,0,5270065
zapB_predicted,0.2,4,4,TGTCTTAGGTGGAACGATAA,0,5274284
zapB_predicted,0.2,4,4,TGTAGTTCAGGGGGCGGCAG,0,5281264
zapB_predicted,0.2,4,4,TGTACCCTACATAACGTTTG,0,5270259
zapB_predicted,0.2,4,4,TGTAATTGGTGCAATCTTAG,0,5276353
zapB_predicted,0.2,4,4,TGGTAGAGCCAGGATACCAC,0,5269438
zapB_predicted,0.2,4,4,TGGTACAAGAACATTAACTG,0,5270908
zapB_predicted,0.2,4,4,TGGCGAGCTCCTTTAACGGG,0,5280638
zapB_predicted,0.2,4,4,TGGCCTAAAGCTGCGTATTG,0,5280598
zapB_predicted,0.2,4,4,TGGCCGCCACACTGGGGTCC,0,5270177
zapB_predicted,0.2,4,4,TGGCAACGCAAACGTATGAA,0,5263573
zapB_predicted,0.2,4,4,TGGAGGCAAGGGACCGCACA,0,5263156
zapB_predicted,0.2,4,4,TGGACGATAGGTCAGACACT,0,5266159
zapB_predicted,0.2,4,4,TGCTCTGTTTATAGTATGAA,0,5281237
zapB_predicted,0.2,4,4,TGCGATCGGAATTTTGATGC,0,5266848
zapB_predicted,0.2,4,4,TGCGATACAAATATGACAGC,0,5276239
zapB_predicted,0.2,4,4,TGCCGATTCTTATCTATAGT,0,5279641
zapB_predicted,0.2,4,4,TGCAGTACAAGGTCATTATT,0,5266652
zapB_predicted,0.2,4,4,TGATTGACTGCGACAACCAG,0,5275598
zapB_predicted,0.2,4,4,TGAGGGTAGGCTGATAACGT,0,5283304
zapB_predicted,0.2,4,4,TGAGATACGGTCAGGTGGCT,0,5277588
zapB_predicted,0.2,4,4,TGACGGTAGACTTATTCGCT,0,5265752
zapB_predicted,0.2,4,4,TGAAGGAGCTTGCAGGATTG,0,5286104
zapB_predicted,0.2,4,4,TGAAGAGAGATGACATCGGG,0,5280861
zapB_predicted,0.2,4,4,TCTTTTAACGGCAGAAGCCT,0,5268150
zapB_predicted,0.2,4,4,TCTTATCCAGTGTCGTTGAT,0,5279282
zapB_predicted,0.2,4,4,TCTCTTACGCCATTCCATGT,0,5282317
zapB_predicted,0.2,4,4,TCTCCACAGTCGTAAGACTA,0,5285453
zapB_predicted,0.2,4,4,TCTCACATCACGGGCAGCCG,0,5276594
zapB_predicted,0.2,4,4,TCTCAATTTGTCTGGGCTGC,0,5272015
zapB_predicted,0.2,4,4,TCTATCCGCAGCTCTTCCGT,0,5269165
zapB_predicted,0.2,4,4,TCGTTTCCTACTTGATCGGT,0,5268328
zapB_predicted,0.2,4,4,TCGTGTTCCTCACTTGCAGA,0,5268205
zapB_predicted,0.2,4,4,TCGGTTCAATGGGTTGGAGG,0,5277960
zapB_predicted,0.2,4,4,TCGGCCGGAACAAGACGTGG,0,5263339
zapB_predicted,0.2,4,4,TCGCGTGGCGTAGCTATTTC,0,5268932
zapB_predicted,0.2,4,4,TCGCGCCCATCCCGTCACAG,0,5263363
zapB_predicted,0.2,4,4,TCGCCGTAGTAAACTTAGGG,0,5281886
zapB_predicted,0.2,4,4,TCGATTGTGGAATTCAACCG,0,5280261
zapB_predicted,0.2,4,4,TCGATAAGTGCGTATACAGA,0,5270043
zapB_predicted,0.2,4,4,TCGACCTGTTAACGATTTTT,0,5277825
zapB_predicted,0.2,4,4,TCCTTGTGGCACTAATGTTA,0,5285389
zapB_predicted,0.2,4,4,TCCTGAAAGGCGCTTGGTAT,0,5279648
zapB_predicted,0.2,4,4,TCCTCGGATGTGGATCAAGA,0,5274739
zapB_predicted,0.2,4,4,TCCTCAGAAGATCCTTTAGA,0,5265030
zapB_predicted,0.2,4,4,TCCGTGGTAAGTTGGAGTCT,0,5272424
zapB_predicted,0.2,4,4,TCCGTACACTCGAAAAAGAG,0,5271521
zapB_predicted,0.2,4,4,TCCGCTCTGACCTTCCACCA,0,5285479
zapB_predicted,0.2,4,4,TCCGACGTTCACGTAAGGTT,0,5285861
zapB_predicted,0.2,4,4,TCCCTCTGGTCCGAAGATCT,0,5276811
zapB_predicted,0.2,4,4,TCCCTACCTGTGTGACGATT,0,5264946
zapB_predicted,0.2,4,4,TCCCGGATCGTGTCACACAC,0,5284444
zapB_predicted,0.2,4,4,TCCATGTTTTCCGTTTTACA,0,5284616
zapB_predicted,0.2,4,4,TCCAACAACACGGCTAGCGG,0,5272497
zapB_predicted,0.2,4,4,TCCAAAGGGCATGAGAGGAC,0,5264056
zapB_predicted,0.2,4,4,TCCAAAGCGGTCGCGCAACG,0,5280606
zapB_predicted,0.2,4,4,TCATGGTTTGAGAAGGTCAC,0,5274601
zapB_predicted,0.2,4,4,TCATCGCATATCTCGAGGTG,0,5279089
zapB_predicted,0.2,4,4,TCAGGACATTATCGCTTGTT,0,5288282
zapB_predicted,0.2,4,4,TCACTCGTGCGGCCCCCAAG,0,5263420
zapB_predicted,0.2,4,4,TATTGGGTGCGTCGGCACAG,0,5272717
zapB_predicted,0.2,4,4,TATGCATCAGCCAGTGATGT,0,5275102
zapB_predicted,0.2,4,4,TATGATGTCCATGGGGATTT,0,5287299
zapB_predicted,0.2,4,4,TATCTCCTAGGTCAATTAGT,0,5274734
zapB_predicted,0.2,4,4,TATCCTTTGTCTACTCGGTG,0,5286929
zapB_predicted,0.2,4,4,TATACTAGACTGTGTCATTT,0,5264045
zapB_predicted,0.2,4,4,TATACGAAGAACGTAAACAA,0,5277369
zapB_predicted,0.2,4,4,TATAAGGGATCCCGGGAGAC,0,5287329
zapB_predicted,0.2,4,4,TATAACTTTCGTAGTAATCT,0,5283840
zapB_predicted,0.2,4,4,TAGGCGTCCCCAGCCTATGG,0,5270485
zapB_predicted,0.2,4,4,TAGCTCCCAGGCAGTACGGA,0,5273630
zapB_predicted,0.2,4,4,TAGCGTCCATAATCTATCCT,0,5279375
zapB_predicted,0.2,4,4,TAGCCGACCAGGGCGTACGT,0,5275552
zapB_predicted,0.2,4,4,TAGATGCTATGTCAAACTGC,0,5279311
zapB_predicted,0.2,4,4,TAGAGTAGCCTCTGAATGTT,0,5267109
zapB_predicted,0.2,4,4,TAGACAAAAATATGTATGCA,0,5274373
zapB_predicted,0.2,4,4,TAGAATCTAAACTGGCTTAA,0,5280320
zapB_predicted,0.2,4,4,TACTGCCTGGTTAAGTGTTA,0,5280654
zapB_predicted,0.2,4,4,TACTGATAGTGCCGGGGGCT,0,5277536
zapB_predicted,0.2,4,4,TACTCTCATCTTTACCGTCT,0,5265959
zapB_predicted,0.2,4,4,TACTCATATCAGTGTCCTTA,0,5270202
zapB_predicted,0.2,4,4,TACGGCTTTCCCGACATAGT,0,5275279
zapB_predicted,0.2,4,4,TACACAAAGGGGGTGAATTA,0,5275515
zapB_predicted,0.2,4,4,TAATGGGTGCGGCAGTTTAA,0,5263725
zapB_predicted,0.2,4,4,TAATCCTAATTATTCGGAGG,0,5271208
zapB_predicted,0.2,4,4,TAACGCATTCCGCAAAACGA,0,5275565
zapB_predicted,0.2,4,4,TAACCCCTATTGGGTGCATG,0,5264521
zapB_predicted,0.2,4,4,TAACATCTCGCTTCCACAGT,0,5278679
zapB_predicted,0.2,4,4,TAAATAACAAAAGCGAGCGT,0,5269714
zapB_predicted,0.2,4,4,GTTGGGCCAACCGTCGCACC,0,5276633
zapB_predicted,0.2,4,4,GTTGCGGGACGCGGTATGGG,0,5276081
zapB_predicted,0.2,4,4,GTTCGTCGGAGAGCTTGTGT,0,5287448
zapB_predicted,0.2,4,4,GTTATAGTCGCCTGCATATA,0,5264161
zapB_predicted,0.2,4,4,GTTACTCCTCAGGATTGCTT,0,5284994
zapB_predicted,0.2,4,4,GTGTGCCCGCTCCCAGGAGG,0,5283374
zapB_predicted,0.2,4,4,GTGTCTCTTCGCGCCGCATC,0,5269173
zapB_predicted,0.2,4,4,GTGTACAGCACGTTCCGCTC,0,5264142
zapB_predicted,0.2,4,4,GTGGGTGGGCGTTAGCGTAC,0,5265402
zapB_predicted,0.2,4,4,GTGCGATCATGGGCATCAGC,0,5266243
zapB_predicted,0.2,4,4,GTGCAGCCCCTAGGGTTCGG,0,5284411
zapB_predicted,0.2,4,4,GTGAAGACAGCCGTCGTAAA,0,5285957
zapB_predicted,0.2,4,4,GTCTCGCTGGGTTTCACCGA,0,5270490
zapB_predicted,0.2,4,4,GTCGGGCGACCCAGCGACTA,0,5274227
zapB_predicted,0.2,4,4,GTCCGTATCAGCGCCAAGGC,0,5284699
zapB_predicted,0.2,4,4,GTCATGGTACGCACGGCTCA,0,5288380
zapB_predicted,0.2,4,4,GTATCTTCACGTTTGAACGT,0,5263464
zapB_predicted,0.2,4,4,GTAGTAACTTCACCCATGTG,0,5285054
zapB_predicted,0.2,4,4,GTAGGCTTAGAGTGTTCAAG,0,5272075
zapB_predicted,0.2,4,4,GTAGCGCGATTAGGAGGAGA,0,5283723
zapB_predicted,0.2,4,4,GTAGAACCACGGAAGTTAAA,0,5281503
zapB_predicted,0.2,4,4,GTACAGGCATCGGGCTTTTA,0,5276755
zapB_predicted,0.2,4,4,GTAATCGGACTTTCCACGGA,0,5275652
zapB_predicted,0.2,4,4,GTAAGTCACTTTGGATTAAT,0,5273697
zapB_predicted,0.2,4,4,GTAACTACCACTCTACCGGA,0,5279165
zapB_predicted,0.2,4,4,GTAACGGCAAATCTCAAAAC,0,5267477
zapB_predicted,0.2,4,4,GGTTTCAACTTACACCGAAC,0,5265480
zapB_predicted,0.2,4,4,GGTGGAATGATCGTATTTTT,0,5279111
zapB_predicted,0.2,4,4,GGTGCAATACCGGATATGGC,0,5271644
zapB_predicted,0.2,4,4,GGTCCCCATCCGAACTCCAT,0,5266389
zapB_predicted,0.2,4,4,GGTAGTTTAGCGAACAGTGC,0,5287895
zapB_predicted,0.2,4,4,GGTACGTCGGCATCAAGGCT,0,5285048
zapB_predicted,0.2,4,4,GGTAACTTACAGGCCTAGAT,0,5280236
zapB_predicted,0.2,4,4,GGGTTGTAGTGCAGGCCATT,0,5274378
zapB_predicted,0.2,4,4,GGGTTAGAGAGGAACTCGCT,0,5270657
zapB_predicted,0.2,4,4,GGGGTCAACGGGGGCCGCAG,0,5263654
zapB_predicted,0.2,4,4,GGGGATCTACGTCCCATGAT,0,5264956
zapB_predicted,0.2,4,4,GGGGAACACCTAAGTAACAT,0,5272415
zapB_predicted,0.2,4,4,GGGCGAGTACGGAAGCCGGC,0,5266732
zapB_predicted,0.2,4,4,GGGCCAGGTCACGCGGACGG,0,5286452
zapB_predicted,0.2,4,4,GGGCACAAACTGGGTCCGGT,0,5272678
zapB_predicted,0.2,4,4,GGGAGCCATATGCTAATGAC,0,5285498
zapB_predicted,0.2,4,4,GGGACTTTACTATTAGAGGA,0,5271369
zapB_predicted,0.2,4,4,GGGACCGTTCGGATGCCGGA,0,5263888
zapB_predicted,0.2,4,4,GGGACCGCTGAATAGAGCAC,0,5270338
zapB_predicted,0.2,4,4,GGGACCGACGCTGTAACACG,0,5286573
zapB_predicted,0.2,4,4,GGGAACGGTGTCCTCTCACT,0,5283401
zapB_predicted,0.2,4,4,GGGAAAGGGAGGAGAGGATA,0,5279410
zapB_predicted,0.2,4,4,GGCTGCGGCAGGCTCCCATG,0,5270307
zapB_predicted,0.2,4,4,GGCTCCCCCCCCTTGCAGAG,0,5271631
zapB_predicted,0.2,4,4,GGCTACCGGCTTTCTACCGG,0,5280048
zapB_predicted,0.2,4,4,GGCGGGCGATACAACGGCAG,0,5284137
zapB_predicted,0.2,4,4,GGCGGACGCCTATTAGGATA,0,5268675
zapB_predicted,0.2,4,4,GGCGCGGGGGGCTTAGTAGT,0,5267877
zapB_predicted,0.2,4,4,GGCCTATGAGCGATACGAGG,0,5283707
zapB_predicted,0.2,4,4,GGCCTACCTATACCCGTTAA,0,5281369
zapB_predicted,0.2,4,4,GGCCAAACATAATCGAATGT,0,5271406
zapB_predicted,0.2,4,4,GGCAGTCGGTTTTATCATGC,0,5285290
zapB_predicted,0.2,4,4,GGCAAGGAGCTGGTATGCTA,0,5276125
zapB_predicted,0.2,4,4,GGATTCGGTTCTTAGTGCGG,0,5283480
zapB_predicted,0.2,4,4,GGATGAGGAAATCCTAAGTT,0,5269056
zapB_predicted,0.2,4,4,GGATAGTGTAATTCTTAAGA,0,5283211
zapB_predicted,0.2,4,4,GGAGGAAGACTCTAGAAGCC,0,5268505
zapB_predicted,0.2,4,4,GGAGCTCGCGGTTCTAAGAC,0,5267456
zapB_predicted,0.2,4,4,GGAGCATTAAACAATCAACC,0,5270452
zapB_predicted,0.2,4,4,GGAGAGGTAGAAGACGTCTT,0,5271394
zapB_predicted,0.2,4,4,GGACTCCGGAGTCTACGGAG,0,5276064
zapB_predicted,0.2,4,4,GGACAGGAGTAGTATTGTTT,0,5277611
zapB_predicted,0.2,4,4,GGAACTTGGGGGCATTCCTA,0,5283563
zapB_predicted,0.2,4,4,GGAAAATGACGGACTTGTCC,0,5265692
zapB_predicted,0.2,4,4,GCTTGTTAAAGCCAGGGAGC,0,5286828
zapB_predicted,0.2,4,4,GCTTGGGCGTATCTACACAA,0,5282263
zapB_predicted,0.2,4,4,GCTTCGTGGCTAAAACACAG,0,5285040
zapB_predicted,0.2,4,4,GCTTCCTCACATATAGGAGT,0,5274670
zapB_predicted,0.2,4,4,GCTGGCTAGGCCGGGGTGAT,0,5263974
zapB_predicted,0.2,4,4,GCTGCGCAGGACAGCTTGAC,0,5276722
zapB_predicted,0.2,4,4,GCTGATCCTTAATCGGAATT,0,5281844
zapB_predicted,0.2,4,4,GCTCATAGGGCCCGGTAATG,0,5276803
zapB_predicted,0.2,4,4,GCTCATAACGAATCGTGCCC,0,5269227
zapB_predicted,0.2,4,4,GCTATGATACGATACCTACC,0,5284540
zapB_predicted,0.2,4,4,GCTAGATCTGAGCATGGCAA,0,5269576
zapB_predicted,0.2,4,4,GCTACGCCCTCAGGCTCTGC,0,5278006
zapB_predicted,0.2,4,4,GCTACAGAGGTGATGAATTT,0,5265701
zapB_predicted,0.2,4,4,GCGTGTCAGTTAAAGTCAAG,0,5277708
zapB_predicted,0.2,4,4,GCGGGGTAATATACGACAGC,0,5268969
zapB_predicted,0.2,4,4,GCGGATATAGCGTTGCCACC,0,5265509
zapB_predicted,0.2,4,4,GCGCGGCGGTTCCAAACCTG,0,5263732
zapB_predicted,0.2,4,4,GCGCGACCCATACTTACAGG,0,5276639
zapB_predicted,0.2,4,4,GCGATGATAAGATGTTCGAT,0,5269760
zapB_predicted,0.2,4,4,GCGAGCTATGCTTGCCATTA,0,5266496
zapB_predicted,0.2,4,4,GCCTTAGGCTGTTGTCCTGT,0,5280537
zapB_predicted,0.2,4,4,GCCGTTGGCCGGAAAAAGCT,0,5266781
zapB_predicted,0.2,4,4,GCCGCTAAGTCAAGCTGGGC,0,5272549
zapB_predicted,0.2,4,4,GCCCTTCTTTCATATAGCTG,0,5267792
zapB_predicted,0.2,4,4,GCCCTCACCGAGCAGGCGAA,0,5280650
zapB_predicted,0.2,4,4,GCCCGCTTAGGCCGGCGGTC,0,5281669
zapB_predicted,0.2,4,4,GCCCATAACAACGTGTCGCA,0,5276804
zapB_predicted,0.2,4,4,GCCCAATATGCGTTTTCGAC,0,5276448
zapB_predicted,0.2,4,4,GCCAAGATCGAACAACGACA,0,5273729
zapB_predicted,0.2,4,4,GCATGACATTGAAACATTGT,0,5273701
zapB_predicted,0.2,4,4,GCATAATCGAGCTCGGCGAC,0,5269599
zapB_predicted,0.2,4,4,GCAGGTCCTTGAGCTCCTAG,0,5266478
zapB_predicted,0.2,4,4,GCAGGGTTAAAACCATCTAT,0,5263782
zapB_predicted,0.2,4,4,GCAGGGGTATCGCCTGCGGC,0,5274494
zapB_predicted,0.2,4,4,GCAGCGCCTGATCGGGTTAA,0,5280647
zapB_predicted,0.2,4,4,GCACGCTGTTTTCGATGGGA,0,5285763
zapB_predicted,0.2,4,4,GCACCTCGAACCTTGCTAAT,0,5276503
zapB_predicted,0.2,4,4,GCACCTAATTAACTCACAGC,0,5275495
zapB_predicted,0.2,4,4,GCACAGGCTTCCCGTCAGAA,0,5279777
zapB_predicted,0.2,4,4,GCAATGCCGCCATTCCAAAA,0,5287231
zapB_predicted,0.2,4,4,GCAATCTTTAGTCATTAATA,0,5286282
zapB_predicted,0.2,4,4,GATTTTGGCTAGCTATCACT,0,5264000
zapB_predicted,0.2,4,4,GATTGTGGTGAGCCCCTGCA,0,5285424
zapB_predicted,0.2,4,4,GATTGACCCTCGAGCTATAC,0,5267735
zapB_predicted,0.2,4,4,GATGTCGCGTTGACCTCCAC,0,5284702
zapB_predicted,0.2,4,4,GATGGGTTACAATGAGGTGC,0,5267107
zapB_predicted,0.2,4,4,GATCGTGTCTTGGTAAGATT,0,5266651
zapB_predicted,0.2,4,4,GATCCCGACTAGCCTACCGA,0,5276608
zapB_predicted,0.2,4,4,GATATTTGAGAAGGGGAATG,0,5284550
zapB_predicted,0.2,4,4,GATATCCCTATGTCACGCAA,0,5274964
zapB_predicted,0.2,4,4,GATATCCAAGCTGATTCTCC,0,5273125
zapB_predicted,0.2,4,4,GATATACTGTAGTACTTACG,0,5269254
zapB_predicted,0.2,4,4,GATATACCCCACAATGTAAT,0,5269544
zapB_predicted,0.2,4,4,GATACGGTGGCGTTCTACTT,0,5280233
zapB_predicted,0.2,4,4,GATAACAGCCCTTAACACAT,0,5263062
zapB_predicted,0.2,4,4,GAGTTCAAATCTGTCAATGT,0,5268010
zapB_predicted,0.2,4,4,GAGTACTAAGTCAACCGGCG,0,5266309
zapB_predicted,0.2,4,4,GAGGTAGGGACGTTGAGCCC,0,5278727
zapB_predicted,0.2,4,4,GAGGCCCAGTGTATGTACGT,0,5280175
zapB_predicted,0.2,4,4,GAGGAGTGTTAAATGCGGTT,0,5266560
zapB_predicted,0.2,4,4,GAGCTACGCGTGGGTAAATG,0,5268037
zapB_predicted,0.2,4,4,GAGCGGGTTGCAACATAGTC,0,5278126
zapB_predicted,0.2,4,4,GAGCCGATCAACACCCCACA,0,5277354
zapB_predicted,0.2,4,4,GAGATGAACTGTGTCTTGAT,0,5276071
zapB_predicted,0.2,4,4,GAGACAGATTTTTGCCTGAG,0,5281779
zapB_predicted,0.2,4,4,GACTAATATGAGCTTTGCTT,0,5286858
zapB_predicted,0.2,4,4,GACGGTTGGCCAAGAAATCC,0,5277193
zapB_predicted,0.2,4,4,GACGCCCAATACATATAAGC,0,5273745
zapB_predicted,0.2,4,4,GACGAGGACGCGATATCAAG,0,5284772
zapB_predicted,0.2,4,4,GACCGTCTCGGGAAGCGGGT,0,5276879
zapB_predicted,0.2,4,4,GACCCATTGTGCAAGGAGTT,0,5268080
zapB_predicted,0.2,4,4,GACATCGCACAGGTGAACGT,0,5264077
zapB_predicted,0.2,4,4,GACAGCTCCCCCTAGTATTA,0,5288003
zapB_predicted,0.2,4,4,GACAGAAGATATCCGTTATT,0,5283489
zapB_predicted,0.2,4,4,GACACAGTGGCTAGGGGCAT,0,5279003
zapB_predicted,0.2,4,4,GACAACGGTATAGCACTATC,0,5276241
zapB_predicted,0.2,4,4,GAATCACGGGCTTCCCTATT,0,5282449
zapB_predicted,0.2,4,4,GAAGTTCAGCTCTCCCGTGC,0,5273986
zapB_predicted,0.2,4,4,GAAGCCGGAATACTCCATAG,0,5265892
zapB_predicted,0.2,4,4,GAAGATTAAGGGAGTGATTC,0,5273992
zapB_predicted,0.2,4,4,GAACGCACTGGATAGTGAGT,0,5280371
zapB_predicted,0.2,4,4,GAAATCGCTCGAAGCATGGA,0,5283020
zapB_predicted,0.2,4,4,GAAATCAGGGGTCTCTATTT,0,5284682
zapB_predicted,0.2,4,4,GAAAAGGTTCTACCTCGACA,0,5276983
zapB_predicted,0.2,4,4,CTTTTGCAATGCAGCAACTG,0,5280984
zapB_predicted,0.2,4,4,CTTTTAGATAAACGACCTTG,0,5284165
zapB_predicted,0.2,4,4,CTTTTAGAGTGAGATCTCCT,0,5280794
zapB_predicted,0.2,4,4,CTTCTTATGAAAGAATTAAC,0,5287699
zapB_predicted,0.2,4,4,CTTCTGGCCAAGCATTAGAC,0,5277497
zapB_predicted,0.2,4,4,CTTCGGCAAGAGCACAGGCT,0,5283567
zapB_predicted,0.2,4,4,CTTCACTAAGAAGAATTGGG,0,5268870
zapB_predicted,0.2,4,4,CTTATTATGTCGCCCGCGGA,0,5263501
zapB_predicted,0.2,4,4,CTTACCACAGGGCGTCGCTG,0,5271031
zapB_predicted,0.2,4,4,CTGTTGGCTAAGCAACTTTC,0,5272438
zapB_predicted,0.2,4,4,CTGTTCCTGAGGAGAAGCTT,0,5283013
zapB_predicted,0.2,4,4,CTGTGTGTTAATGTCTGGTC,0,5269524
zapB_predicted,0.2,4,4,CTGTGACCTGCGCTATATGT,0,5286701
zapB_predicted,0.2,4,4,CTGTCAATGTACCCTAGAGG,0,5272214
zapB_predicted,0.2,4,4,CTGGTCCGGTAATCTCGGTG,0,5282706
zapB_predicted,0.2,4,4,CTGGTAAGTGCGTACGTAAA,0,5277130
zapB_predicted,0.2,4,4,CTGGATGCATCGTGCACAGA,0,5286481
zapB_predicted,0.2,4,4,CTGCTTGAGCCCCGAATGGC,0,5268100
zapB_predicted,0.2,4,4,CTGCACTGATCCAAAAATCA,0,5287979
zapB_predicted,0.2,4,4,CTGACATTTAGGGGAACTCG,0,5279519
zapB_predicted,0.2,4,4,CTCTGTGCTCCAAAAGCCTT,0,5274746
zapB_predicted,0.2,4,4,CTCGTGACCTCATTTGGACG,0,5284219
zapB_predicted,0.2,4,4,CTCCTTATTGAAGTGTTCCC,0,5287619
zapB_predicted,0.2,4,4,CTCCTTAGTTGTATCTAGCA,0,5283910
zapB_predicted,0.2,4,4,CTCCCAAACATACCCTAGAG,0,5272147
zapB_predicted,0.2,4,4,CTCCAGTGGGGCGGATGCCA,0,5269437
zapB_predicted,0.2,4,4,CTCAACCTAAGCGAGCAAAG,0,5278587
zapB_predicted,0.2,4,4,CTATGAGTACGTGCCGAGCA,0,5267639
zapB_predicted,0.2,4,4,CTATCAAGTTTGCCTTGCGG,0,5276816
zapB_predicted,0.2,4,4,CTAGTGCAGCGGTGGATTAA,0,5264146
zapB_predicted,0.2,4,4,CTAGGGGACCCAGGTGCCAA,0,5283457
zapB_predicted,0.2,4,4,CTAGGGCTTTCGAGCGACCC,0,5268701
zapB_predicted,0.2,4,4,CTAGCGTTATTGGGGTATGA,0,5280533
zapB_predicted,0.2,4,4,CTACTGTTTTACCGCGAATT,0,5279084
zapB_predicted,0.2,4,4,CTACTCAGTCATCCCAAACG,0,5283456
zapB_predicted,0.2,4,4,CTAAGGCTCGAAGCTTACAG,0,5282879
zapB_predicted,0.2,4,4,CGTTTAAGGTCGGGTATTTG,0,5270707
zapB_predicted,0.2,4,4,CGTGGGAGGGTTAGGGCGAC,0,5271695
zapB_predicted,0.2,4,4,CGTGATTACCGAAGTAGAGT,0,5265958
zapB_predicted,0.2,4,4,CGTCACTTTCCAGTAGATGA,0,5286496
zapB_predicted,0.2,4,4,CGTACAATGCGAAGACAAGC,0,5279033
zapB_predicted,0.2,4,4,CGTAATTCGAAACTTCCAAA,0,5267796
zapB_predicted,0.2,4,4,CGTAATACTCAACTCCGAAA,0,5275500
zapB_predicted,0.2,4,4,CGGTTACGTCCCACATCTAC,0,5264275
zapB_predicted,0.2,4,4,CGGTGGCGTTTTAAACAAAC,0,5268823
zapB_predicted,0.2,4,4,CGGTAACCGAGGAAATCATC,0,5266214
zapB_predicted,0.2,4,4,CGGGTTCTTCATACAGGCGC,0,5267284
zapB_predicted,0.2,4,4,CGGGGAGCTGCCGCAACACA,0,5284861
zapB_predicted,0.2,4,4,CGGGAGTCATAATGCTTTAA,0,5276434
zapB_predicted,0.2,4,4,CGGCGCCAGACTGGTTTGGT,0,5281018
zapB_predicted,0.2,4,4,CGGCATGAAACCTCTAGTAC,0,5275112
zapB_predicted,0.2,4,4,CGGCACCAGCGGGCTACAGG,0,5279860
zapB_predicted,0.2,4,4,CGGATGCTTAAATACCTTCT,0,5264007
zapB_predicted,0.2,4,4,CGCTATACAGTGCAACCTCG,0,5279039
zapB_predicted,0.2,4,4,CGCGCGTGCAGAAAGGCGTA,0,5287841
zapB_predicted,0.2,4,4,CGCGAGTCGGAGGGTGGATG,0,5269472
zapB_predicted,0.2,4,4,CGCCGCCATCTATTGACCTT,0,5287524
zapB_predicted,0.2,4,4,CGCCAAGTAAGTGTTGCCGT,0,5279029
zapB_predicted,0.2,4,4,CGATTTTTGAGGCGGGAATG,0,5288190
zapB_predicted,0.2,4,4,CGACGAACCAGCCTAAGTGA,0,5269463
zapB_predicted,0.2,4,4,CGAAGGTTTAAGGCCTAACA,0,5275819
zapB_predicted,0.2,4,4,CGAAGACCCATAATTTATCG,0,5268431
zapB_predicted,0.2,4,4,CCTTAAGGCACGTCGGCTAT,0,5279241
zapB_predicted,0.2,4,4,CCTGCTCGTCAGGCCCCTGA,0,5273670
zapB_predicted,0.2,4,4,CCTGAAGGCGCAAAAATTGA,0,5287074
zapB_predicted,0.2,4,4,CCTGAAGCTGACCATTAATC,0,5274565
zapB_predicted,0.2,4,4,CCTATTTCGCCTTCTTCTCT,0,5284976
zapB_predicted,0.2,4,4,CCTAGCACGAAAGTTTACCA,0,5269127
zapB_predicted,0.2,4,4,CCTAATTCCCGCTGCCTTTG,0,5281229
zapB_predicted,0.2,4,4,CCTAATGCAAATTTTGATTA,0,5287994
zapB_predicted,0.2,4,4,CCGTTGGATCGTTTTACTCA,0,5279185
zapB_predicted,0.2,4,4,CCGTGATCGCAACACTGGCA,0,5265628
zapB_predicted,0.2,4,4,CCGTATACCTTTCGATAAGT,0,5276658
zapB_predicted,0.2,4,4,CCGTACTCCGGGGAGTTGTT,0,5270329
zapB_predicted,0.2,4,4,CCGGGCATCAGGAGCTAGTG,0,5271678
zapB_predicted,0.2,4,4,CCGGGAGCCTGAGTAATACC,0,5280319
zapB_predicted,0.2,4,4,CCGCTTTGAACCGGAACGCT,0,5271503
zapB_predicted,0.2,4,4,CCGCTCGGACCTGAACTACG,0,5275646
zapB_predicted,0.2,4,4,CCGCTAACCCTTAGTTTAAT,0,5267793
zapB_predicted,0.2,4,4,CCGCGTGAGTTATTACATTT,0,5282943
zapB_predicted,0.2,4,4,CCGATTACAACCTCCCGACC,0,5278298
zapB_predicted,0.2,4,4,CCGAGAAGAGGAAGGCTCTA,0,5272467
zapB_predicted,0.2,4,4,CCCTTCCATTAGGCTCGGGC,0,5283828
zapB_predicted,0.2,4,4,CCCTGGTTTAATGGCTCAGG,0,5276746
zapB_predicted,0.2,4,4,CCCTCTGTTTCTCGCAAGTA,0,5268004
zapB_predicted,0.2,4,4,CCCTCTCGTCCAAAACGGGA,0,5267889
zapB_predicted,0.2,4,4,CCCTCGACCACTTTTGACGT,0,5284092
zapB_predicted,0.2,4,4,CCCTAACTTCGTAACTAGAC,0,5264253
zapB_predicted,0.2,4,4,CCCGATGAGGATATTGTAAG,0,5272379
zapB_predicted,0.2,4,4,CCCGACTATTTTTGTTTTAA,0,5265069
zapB_predicted,0.2,4,4,CCCGAATGAAGGAGGGGTCT,0,5269136
zapB_predicted,0.2,4,4,CCCCCTATACGGTGTGGTCT,0,5283646
zapB_predicted,0.2,4,4,CCCATCGACCGAGTTCGCAT,0,5268678
zapB_predicted,0.2,4,4,CCATCGATTTGGTGCCCGCT,0,5286535
zapB_predicted,0.2,4,4,CCATATCTCCACCAAAAAAG,0,5266817
zapB_predicted,0.2,4,4,CCACGGATCGATTTGCGCTC,0,5268770
zapB_predicted,0.2,4,4,CCACCGGCTCCAATCTTGGT,0,5268627
zapB_predicted,0.2,4,4,CCAAGCGAAGCCTGAAGTTC,0,5275923
zapB_predicted,0.2,4,4,CCAAACGCCCTACCACTGGC,0,5277311
zapB_predicted,0.2,4,4,CATTCAGTATTTATTCGAAG,0,5263165
zapB_predicted,0.2,4,4,CATTAGGAGGTGTCTAGAGA,0,5270964
zapB_predicted,0.2,4,4,CATGTTAAGGCCGTGATCCC,0,5266169
zapB_predicted,0.2,4,4,CATGGGTTCCTGCAGAGTAT,0,5280436
zapB_predicted,0.2,4,4,CATGGGGACGTGGGGTGCTC,0,5280871
zapB_predicted,0.2,4,4,CATCTCCCGCCTGCTGTAAG,0,5266754
zapB_predicted,0.2,4,4,CATCTAGTCCTTCGAGTTTT,0,5266253
zapB_predicted,0.2,4,4,CATCGGACCAGGCAAGACGT,0,5272926
zapB_predicted,0.2,4,4,CATATATCGCTTTAAATATG,0,5277584
zapB_predicted,0.2,4,4,CATATAGCCCTAATCCGGAG,0,5278255
zapB_predicted,0.2,4,4,CATAATATCGGACCTCGTAC,0,5283684
zapB_predicted,0.2,4,4,CATAAACTCTCAGGCATGTG,0,5271997
zapB_predicted,0.2,4,4,CAGTTTTATTGTGATGCTTC,0,5266675
zapB_predicted,0.2,4,4,CAGTTATCAACGAAAATCCG,0,5273739
zapB_predicted,0.2,4,4,CAGTCCGTGTTCACTTAAAG,0,5264710
zapB_predicted,0.2,4,4,CAGTATCATGTGTTTTGGAT,0,5263191
zapB_predicted,0.2,4,4,CAGTAGACCTTCGGTAAGCT,0,5283452
zapB_predicted,0.2,4,4,CAGGTTGAACCCTGTGTGAA,0,5279745
zapB_predicted,0.2,4,4,CAGGTATCATCTCCGCATGT,0,5265745
zapB_predicted,0.2,4,4,CAGGGCATGAAGTCGCGAGG,0,5284117
zapB_predicted,0.2,4,4,CAGGAGTGCATTTGCCTGCC,0,5278976
zapB_predicted,0.2,4,4,CAGCAGCTCTTATCTACGCC,0,5263512
zapB_predicted,0.2,4,4,CAGAGTTTGTATTCGCCCGA,0,5263198
zapB_predicted,0.2,4,4,CAGAGGGACCCGAGTTCTTG,0,5273917
zapB_predicted,0.2,4,4,CACTGTGAACGCCGAGTTCT,0,5267379
zapB_predicted,0.2,4,4,CACTGGCTGGAAGGAGATTA,0,5270101
zapB_predicted,0.2,4,4,CACTACGGGCTGTCCTCCAT,0,5270883
zapB_predicted,0.2,4,4,CACGTCCACCGTTTTGGAGA,0,5273193
zapB_predicted,0.2,4,4,CACGAGATCACGTACAACCA,0,5286567
zapB_predicted,0.2,4,4,CACCGCGCCTATGCGGTTCC,0,5279513
zapB_predicted,0.2,4,4,CACAATGAGCATTTCTTCCC,0,5275479
zapB_predicted,0.2,4,4,CACAAAAAGATGAGCGTCAG,0,5287729
zapB_predicted,0.2,4,4,CAATGGGAATTGTGTCAACG,0,5282038
zapB_predicted,0.2,4,4,CAATCAGCTGTCAGACCTAA,0,5286069
zapB_predicted,0.2,4,4,CAAGGTCCTGACGATTTTTC,0,5272682
zapB_predicted,0.2,4,4,CAAGGATGATGGAGGCTGTA,0,5275523
zapB_predicted,0.2,4,4,CAAGCCGCGTCTGGGGGTGT,0,5264778
zapB_predicted,0.2,4,4,CAACTCTACATGCGAAGGAG,0,5275294
zapB_predicted,0.2,4,4,CAACTCAGACCTCCCTGTTA,0,5283917
zapB_predicted,0.2,4,4,CAAAGGTCACCGCAAGTACG,0,5280230
zapB_predicted,0.2,4,4,CAAACTGGAACTGAAGGAAA,0,5276690
zapB_predicted,0.2,4,4,CAAACCTCGACAAATGCCGC,0,5284979
zapB_predicted,0.2,4,4,ATTTGCACTTGTTCGGGGTC,0,5269345
zapB_predicted,0.2,4,4,ATTTCCCGTTTGTCCAGGGC,0,5274652
zapB_predicted,0.2,4,4,ATTCCCCTTCTGGGCTCAAT,0,5285762
zapB_predicted,0.2,4,4,ATTATTAGTTCACTTGATGC,0,5282060
zapB_predicted,0.2,4,4,ATTAATCGGCTCGCTAAGGA,0,5271349
zapB_predicted,0.2,4,4,ATGTGGGAATCGGTTTAGTG,0,5282462
zapB_predicted,0.2,4,4,ATGTGCTGGGATTGGATGAC,0,5281041
zapB_predicted,0.2,4,4,ATGTCGAGCGGGTAGTGCGC,0,5271457
zapB_predicted,0.2,4,4,ATGGGAGTAGTCTTTAAGCC,0,5279407
zapB_predicted,0.2,4,4,ATGGAACCTACCCAGGAGAT,0,5276698
zapB_predicted,0.2,4,4,ATGCTTAGGTCTTAACCGGT,0,5279378
zapB_predicted,0.2,4,4,ATGCTCATTCCGTATATGTA,0,5274174
zapB_predicted,0.2,4,4,ATGCCCCTCGTGGTATCACA,0,5275944
zapB_predicted,0.2,4,4,ATGAGGTGATCCCAAAATTT,0,5267745
zapB_predicted,0.2,4,4,ATGACTTCACGGATAACCAT,0,5286373
zapB_predicted,0.2,4,4,ATCTCAGACAATGCGATAAT,0,5263887
zapB_predicted,0.2,4,4,ATCGTGATAGCTGCTCGGTC,0,5286463
zapB_predicted,0.2,4,4,ATCGCTCCAATCGAGCGGTG,0,5277900
zapB_predicted,0.2,4,4,ATCCTGCTGTCGAGGAAGTT,0,5286215
zapB_predicted,0.2,4,4,ATCCTGATGAATTGTCAGCA,0,5280974
zapB_predicted,0.2,4,4,ATCCCCTTAGACCTAGGAAC,0,5272222
zapB_predicted,0.2,4,4,ATCCACGTATGTCGTGCTAT,0,5287419
zapB_predicted,0.2,4,4,ATCATATTATAGTGAGAGGT,0,5284600
zapB_predicted,0.2,4,4,ATCATAATTAGGAATCGCCC,0,5263042
zapB_predicted,0.2,4,4,ATCATAATGGGCCTACCGTG,0,5272983
zapB_predicted,0.2,4,4,ATCACCGGGCCACCAGAGTA,0,5282498
zapB_predicted,0.2,4,4,ATCACCCATCACTCCCTGGC,0,5272495
zapB_predicted,0.2,4,4,ATATTCCGTGGAACATAGAT,0,5283069
zapB_predicted,0.2,4,4,ATATTAATTATGCTATACGC,0,5265805
zapB_predicted,0.2,4,4,ATATATGCCCCAACCGTTAC,0,5265260
zapB_predicted,0.2,4,4,ATAGGGATCTCGCCTCAACT,0,5265597
zapB_predicted,0.2,4,4,ATACGGTTACATGGTCGTAA,0,5281073
zapB_predicted,0.2,4,4,ATACGGTCAGGCAGTTAGTG,0,5275971
zapB_predicted,0.2,4,4,AGTTGTGCGCCGACTGTAAC,0,5268397
zapB_predicted,0.2,4,4,AGTTGGACAGGTACGCGCTA,0,5285681
zapB_predicted,0.2,4,4,AGTTGCCTAATACGGATCTT,0,5269578
zapB_predicted,0.2,4,4,AGTTGCAGGAACGGACCTCT,0,5280387
zapB_predicted,0.2,4,4,AGTTCAGCCCAACCATAAGT,0,5286979
zapB_predicted,0.2,4,4,AGTTCAAAGCCGGGACCGGT,0,5272967
zapB_predicted,0.2,4,4,AGTGTCCTTTTCCTGAGGGG,0,5283542
zapB_predicted,0.2,4,4,AGTGAACTGTCACGGCTGCA,0,5276408
zapB_predicted,0.2,4,4,AGGTTATATTGGAGTCTGGT,0,5281950
zapB_predicted,0.2,4,4,AGGTTAGTATATGAGTGGTA,0,5263491
zapB_predicted,0.2,4,4,AGGTATTTGTCTTTGCATAG,0,5282555
zapB_predicted,0.2,4,4,AGGGCGCCATGTAGACGACA,0,5276884
zapB_predicted,0.2,4,4,AGGGAACTTTCGGTAGCTTA,0,5277896
zapB_predicted,0.2,4,4,AGGCATGTGCTTCGGCCGAC,0,5284909
zapB_predicted,0.2,4,4,AGGCACGAAAAACACGGTGA,0,5287314
zapB_predicted,0.2,4,4,AGGATTAGTGAATCTATGGC,0,5286634
zapB_predicted,0.2,4,4,AGGAGGTCCTGTCGGCAGAC,0,5283469
zapB_predicted,0.2,4,4,AGGACATGAGCAGTTAGTTG,0,5285135
zapB_predicted,0.2,4,4,AGGAAGCGCGTGCCATTCGA,0,5287927
zapB_predicted,0.2,4,4,AGCTAGCTAATTATATAGCT,0,5267374
zapB_predicted,0.2,4,4,AGCTACTCATAGGGTCGTAA,0,5279994
zapB_predicted,0.2,4,4,AGCTAAGGGTAATACGACTT,0,5267841
zapB_predicted,0.2,4,4,AGCCTTGGGAGTGCGTTCTA,0,5279787
zapB_predicted,0.2,4,4,AGCATATCCGCGCGGACCTT,0,5286650
zapB_predicted,0.2,4,4,AGCAATTGAGTTGCCCGTTC,0,5283650
zapB_predicted,0.2,4,4,AGCAACTTTACAATATGTGG,0,5269902
zapB_predicted,0.2,4,4,AGCAAACTGGCAGTCTTCGG,0,5281330
zapB_predicted,0.2,4,4,AGATTTTCGTATGTCTCTGT,0,5284003
zapB_predicted,0.2,4,4,AGATTACCGGGGTTACTTTG,0,5271238
zapB_predicted,0.2,4,4,AGATGCACAGTTGGAGGTAG,0,5277577
zapB_predicted,0.2,4,4,AGATCGGAAAGGGTACGTGC,0,5271247
zapB_predicted,0.2,4,4,AGATATGGTCAGCGACAAGT,0,5277869
zapB_predicted,0.2,4,4,AGAGGTGTATACCTCATGCG,0,5266300
zapB_predicted,0.2,4,4,AGAGCTACTGAGAGGCTCGA,0,5283624
zapB_predicted,0.2,4,4,AGACGCGGGCTACAAAATAG,0,5270911
zapB_predicted,0.2,4,4,AGACCGATTATCTATGCTCA,0,5286733
zapB_predicted,0.2,4,4,AGAATCTTGATCTGGGTAAT,0,5281586
zapB_predicted,0.2,4,4,AGAAGCGCGGAAACTCAGAC,0,5268263
zapB_predicted,0.2,4,4,AGAACGCATAGGAGGCAGCA,0,5267371
zapB_predicted,0.2,4,4,AGAAATGTAGATATTGGGAA,0,5280973
zapB_predicted,0.2,4,4,ACTGAGCTAAAATATAGCCA,0,5271194
zapB_predicted,0.2,4,4,ACTGAACATGCAGATGCTAT,0,5268237
zapB_predicted,0.2,4,4,ACTCTGAGGCTTAGCCCCAC,0,5279701
zapB_predicted,0.2,4,4,ACTCAATGATTATACGTCGG,0,5269281
zapB_predicted,0.2,4,4,ACTCAACCATAGTTCCATCC,0,5281933
zapB_predicted,0.2,4,4,ACTACTCTCGGGGACAGTTA,0,5271995
zapB_predicted,0.2,4,4,ACGTAGGAGTAGCGGCTTAT,0,5285657
zapB_predicted,0.2,4,4,ACGGGGGGCAATAACGATTT,0,5285199
zapB_predicted,0.2,4,4,ACGGGGGCCTTTTTAAACCT,0,5278416
zapB_predicted,0.2,4,4,ACGGGAATAAGGTCAACTAC,0,5272469
zapB_predicted,0.2,4,4,ACGGATGTCGTATACCCTAT,0,5281634
zapB_predicted,0.2,4,4,ACGCTTCTGTAATGTTTAGA,0,5280266
zapB_predicted,0.2,4,4,ACGCGGAGGGTGTTCAGTTA,0,5286425
zapB_predicted,0.2,4,4,ACGCATACAATCGAACCTAT,0,5275491
zapB_predicted,0.2,4,4,ACGATACTGTCATTTGGTCT,0,5275053
zapB_predicted,0.2,4,4,ACGAGACAAGCTGCGAAATA,0,5266909
zapB_predicted,0.2,4,4,ACCTTGATATTCTCCTCTCC,0,5277742
zapB_predicted,0.2,4,4,ACCTGGGCAGCAGCCAAACA,0,5276779
zapB_predicted,0.2,4,4,ACCGAGGCAGTGAGCCTTAA,0,5284418
zapB_predicted,0.2,4,4,ACCAGTATTTCGTGCATGCT,0,5287473
zapB_predicted,0.2,4,4,ACAGACGTTAGCACCTGCTT,0,5263685
zapB_predicted,0.2,4,4,ACACTGCAAGGGTCTCAGCC,0,5274367
zapB_predicted,0.2,4,4,ACACGGCCATGAACGCGTAT,0,5286868
zapB_predicted,0.2,4,4,ACACAGTAAGGGAGAGAACT,0,5285770
zapB_predicted,0.2,4,4,ACAATCCTGTGGTCCGGGCT,0,5267392
zapB_predicted,0.2,4,4,ACAAGTCGCAGGGACATTCC,0,5277741
zapB_predicted,0.2,4,4,ACAAATGATTCGTCGGACCT,0,5275306
zapB_predicted,0.2,4,4,AATGTTACCCGGAATAGTCT,0,5265411
zapB_predicted,0.2,4,4,AATGCCTTCGTGAAGCGGAC,0,5282273
zapB_predicted,0.2,4,4,AATCGGTGCGGGAGTGGGAG,0,5272138
zapB_predicted,0.2,4,4,AATAGTACCGTTGTTATTTT,0,5266022
zapB_predicted,0.2,4,4,AATAGGACCTTTCGTACAAG,0,5283029
zapB_predicted,0.2,4,4,AATAGCGCACGTAATAGAAG,0,5269449
zapB_predicted,0.2,4,4,AATAAGCCCGGTGACAGTAA,0,5266154
zapB_predicted,0.2,4,4,AAGTTGGCTTCTCCGAACCA,0,5270966
zapB_predicted,0.2,4,4,AAGTTGACGAGCGTGACTAT,0,5288281
zapB_predicted,0.2,4,4,AAGTCTACTGCACCGCTGAG,0,5263484
zapB_predicted,0.2,4,4,AAGGTGTATCGTTGATTCCA,0,5284280
zapB_predicted,0.2,4,4,AAGGTCGTCACTTGTCAAAT,0,5266175
zapB_predicted,0.2,4,4,AAGGAATAAATGCGTCTCCC,0,5279400
zapB_predicted,0.2,4,4,AAGCCGTACTACCAGCTCCT,0,5269346
zapB_predicted,0.2,4,4,AAGCCGTACGACTGGTGGCG,0,5272045
zapB_predicted,0.2,4,4,AAGACACGGTTGATCCGAGC,0,5264714
zapB_predicted,0.2,4,4,AACTCAGGCATCTGCAGGGT,0,5271091
zapB_predicted,0.2,4,4,AACTCAGACATGGCTACGCA,0,5265539
zapB_predicted,0.2,4,4,AACTACAGCTCACTATCCGA,0,5267446
zapB_predicted,0.2,4,4,AACGTTTACGAAGGCTAACT,0,5272439
zapB_predicted,0.2,4,4,AACGATCGTGCAACTGTCGC,0,5278668
zapB_predicted,0.2,4,4,AACCTGGGGGACGGGCAAGA,0,5264582
zapB_predicted,0.2,4,4,AACCGGGGGTCGCGCGACTA,0,5278803
zapB_predicted,0.2,4,4,AACCCGGGTCCACGACTGGA,0,5275214
zapB_predicted,0.2,4,4,AAATGCAGACACTGGAGATA,0,5276611
zapB_predicted,0.2,4,4,AAATCATATCCAAACTATCT,0,5266348
zapB_predicted,0.2,4,4,AAATAGACCGTTACACCCGC,0,5286540
zapB_predicted,0.2,4,4,AAAGGGATACCACCGGATGA,0,5277178
zapB_predicted,0.2,4,4,AAAGACGTAGTTTATCTGGC,0,5270209
zapB_predicted,0.2,4,4,AAACTCGCTACGAACACACG,0,5277488
zapB_predicted,0.2,4,4,AAACCAGTAACCAATTCCCG,0,5278242
zapB_predicted,0.2,4,4,AAACATTGGATGAGAGCATC,0,5268138
zapB_predicted,0.2,4,4,AAAAGGTGAGATTATAGCTA,0,5274107
zapB_predicted,0.2,4,4,AAAACTATTCGGGCAAGGAA,0,5263416
zapB_predicted,0.25,3,3,TTTTCCGCTGACAGTTGGTA,0,5278840
zapB_predicted,0.25,3,3,TTTTATTAACTCGGGTGGGC,0,5263952
zapB_predicted,0.25,3,3,TTTGCTCACTCCCGTATCTA,0,5268440
zapB_predicted,0.25,3,3,TTTGCTACTATCTGTAGCCG,0,5276165
zapB_predicted,0.25,3,3,TTTCTTTGGCACCGGGTCCG,0,5270122
zapB_predicted,0.25,3,3,TTTCCAGTCAGCTTTATAAA,0,5267040
zapB_predicted,0.25,3,3,TTTCATCAATTGCTAGACGG,0,5264354
zapB_predicted,0.25,3,3,TTTAAGTTTCAAAGATACAG,0,5267634
zapB_predicted,0.25,3,3,TTGTACTACGCCTGTTGAAT,0,5280844
zapB_predicted,0.25,3,3,TTGGGCGTGGTGGGCTCCAC,0,5266248
zapB_predicted,0.25,3,3,TTGGCTTTTATCAACCAGTA,0,5283660
zapB_predicted,0.25,3,3,TTGGAGAACGCACATTATAC,0,5264285
zapB_predicted,0.25,3,3,TTGCGATGGCAAGAGAACCA,0,5275312
zapB_predicted,0.25,3,3,TTGCATGCTCCAAGAAGATC,0,5278271
zapB_predicted,0.25,3,3,TTGATGTTAACCAGCCTTTC,0,5277073
zapB_predicted,0.25,3,3,TTGATGAATCTCTGGCCCTT,0,5277090
zapB_predicted,0.25,3,3,TTGATAGGCAGGAGCTGTTG,0,5287340
zapB_predicted,0.25,3,3,TTGACGGCTCTTTCAACAGG,0,5275130
zapB_predicted,0.25,3,3,TTGAACTTCAGGATTTACGG,0,5281710
zapB_predicted,0.25,3,3,TTCTTTCAGGGAAACCACAA,0,5286273
zapB_predicted,0.25,3,3,TTCTAGCCCGACCTCGAAGG,0,5263074
zapB_predicted,0.25,3,3,TTCGGGTCCTCAATCTTGTC,0,5264966
zapB_predicted,0.25,3,3,TTCGACGGAGGCTTCCGCCT,0,5264517
zapB_predicted,0.25,3,3,TTCGACGCGTCCAGCGCAAT,0,5264520
zapB_predicted,0.25,3,3,TTCCGCTTGCCACTAGGACC,0,5263265
zapB_predicted,0.25,3,3,TTCATTTCACCCTCCGGGAG,0,5276121
zapB_predicted,0.25,3,3,TTCACGTTAAACGCCGGCAT,0,5274102
zapB_predicted,0.25,3,3,TTCACGACAAAAACAATGGA,0,5287066
zapB_predicted,0.25,3,3,TTCAAGGTGACCGCACGCGA,0,5277948
zapB_predicted,0.25,3,3,TTAGTAGGTTTACTTCCGGC,0,5277026
zapB_predicted,0.25,3,3,TTACGTTGATGATCTGTCCT,0,5278685
zapB_predicted,0.25,3,3,TTACGAACACGCGCGAACAA,0,5285239
zapB_predicted,0.25,3,3,TTACATTAATCTTTGGGTAC,0,5279259
zapB_predicted,0.25,3,3,TTACAGTAATGCCCGCGAAG,0,5285015
zapB_predicted,0.25,3,3,TTAACACAACTCGTGCTGAC,0,5275514
zapB_predicted,0.25,3,3,TTAAACGGTCCGACGTTCGA,0,5267324
zapB_predicted,0.25,3,3,TGTCCGTCTCGATAGCCAGA,0,5267341
zapB_predicted,0.25,3,3,TGTATTGGAAAGACCTCGCT,0,5272485
zapB_predicted,0.25,3,3,TGTATAACAGATTGGCCCAC,0,5287353
zapB_predicted,0.25,3,3,TGTAAAGCTTAAGGTCATTC,0,5275405
zapB_predicted,0.25,3,3,TGGTTTGCGTAGATATGCCG,0,5283912
zapB_predicted,0.25,3,3,TGGGGTATTAAAATCGTATT,0,5281575
zapB_predicted,0.25,3,3,TGGGCTGTGTCTCACTAAAA,0,5274101
zapB_predicted,0.25,3,3,TGGGAGCAATATGGAGGTTG,0,5266536
zapB_predicted,0.25,3,3,TGGGAGATGGGCGCGTTCAA,0,5263358
zapB_predicted,0.25,3,3,TGGCCTTATTATGACAGGCT,0,5268886
zapB_predicted,0.25,3,3,TGGATGGCCATGCATATACG,0,5269665
zapB_predicted,0.25,3,3,TGGAGCTTATAAAGTCATCG,0,5288196
zapB_predicted,0.25,3,3,TGGACTGTGAAGCCTCGACA,0,5273500
zapB_predicted,0.25,3,3,TGCTCTTCGATTTTGAGTGT,0,5264320
zapB_predicted,0.25,3,3,TGCTCGAGAATCTCCTTCCC,0,5278612
zapB_predicted,0.25,3,3,TGCTAGAAAACGATCGAGTA,0,5271249
zapB_predicted,0.25,3,3,TGCGGGCGCTAGTACCTGTT,0,5285304
zapB_predicted,0.25,3,3,TGCGGGATATTCTTCTCGTA,0,5269447
zapB_predicted,0.25,3,3,TGCGACGTGCCGGCTTTAAA,0,5269052
zapB_predicted,0.25,3,3,TGCGAATTTACGTGGGTTAC,0,5283676
zapB_predicted,0.25,3,3,TGCCTCATGCTCGACCACCT,0,5267111
zapB_predicted,0.25,3,3,TGCATTATTGCGCGGTACGC,0,5275466
zapB_predicted,0.25,3,3,TGCAAGGTGCCTGATGGGCC,0,5275586
zapB_predicted,0.25,3,3,TGCAAAACGCGTTACAGGGT,0,5268520
zapB_predicted,0.25,3,3,TGATTTTCTTGTTCTAGAAT,0,5288096
zapB_predicted,0.25,3,3,TGATTTATCACTTGCACGGA,0,5272482
zapB_predicted,0.25,3,3,TGATTATGGCTCAGCGTGGT,0,5285694
zapB_predicted,0.25,3,3,TGATCTTATCGACTAGCTTG,0,5287417
zapB_predicted,0.25,3,3,TGAGCCTCAACGGACTCGCC,0,5267591
zapB_predicted,0.25,3,3,TGACAAGCGGCAGGGACAAT,0,5281706
zapB_predicted,0.25,3,3,TGAATCCGAGGAGTTCTGTG,0,5284618
zapB_predicted,0.25,3,3,TGAAAGCATAGGTCCTGAAG,0,5279053
zapB_predicted,0.25,3,3,TCTTTACGAATGATAACTCA,0,5281357
zapB_predicted,0.25,3,3,TCTTGACGTTACGCCTCGGC,0,5282034
zapB_predicted,0.25,3,3,TCTTCGGTTTTTGGCATGAT,0,5282623
zapB_predicted,0.25,3,3,TCTGTCCGATTCGGCCTCGG,0,5266950
zapB_predicted,0.25,3,3,TCTGGTCGTTGTCTGCTTAG,0,5284120
zapB_predicted,0.25,3,3,TCTGGATCTAATCTTTTTGA,0,5266733
zapB_predicted,0.25,3,3,TCTGCCGTTGGGAGCGCTAA,0,5285963
zapB_predicted,0.25,3,3,TCTCTTGAACTCGTTGTTAG,0,5282464
zapB_predicted,0.25,3,3,TCTCGCTAGGGTCGCCTACA,0,5270229
zapB_predicted,0.25,3,3,TCTCGCCAAATGTATCGGCA,0,5263992
zapB_predicted,0.25,3,3,TCTCCAAGCGATTGATAGTC,0,5268447
zapB_predicted,0.25,3,3,TCTACTTGTTAAAATCTCCG,0,5286255
zapB_predicted,0.25,3,3,TCGTTGAGCGCGCATACTCC,0,5288420
zapB_predicted,0.25,3,3,TCGTGACTCACAAGATCACA,0,5286579
zapB_predicted,0.25,3,3,TCGGGCATCGGGATTACTCA,0,5266576
zapB_predicted,0.25,3,3,TCGGCCGCCGGCCCTATTGA,0,5273255
zapB_predicted,0.25,3,3,TCGCGTTTAGTGGGTAGCAT,0,5281746
zapB_predicted,0.25,3,3,TCGCCTGTCCAGATAACGCT,0,5280913
zapB_predicted,0.25,3,3,TCGCCGATGGAGATGCTCAG,0,5278151
zapB_predicted,0.25,3,3,TCGCAACTATCCTGGAAAGT,0,5274298
zapB_predicted,0.25,3,3,TCGAGAACGAATAGCCCGGG,0,5287934
zapB_predicted,0.25,3,3,TCCTGTACGGCGGAAGTTTG,0,5265979
zapB_predicted,0.25,3,3,TCCTGTAAGGGTACAAGAGT,0,5273716
zapB_predicted,0.25,3,3,TCCTATGGATCTGACGCTAA,0,5283438
zapB_predicted,0.25,3,3,TCCGTGTTCTCCGACAGCAT,0,5285338
zapB_predicted,0.25,3,3,TCCGGATTGAATCAGTGGCG,0,5285414
zapB_predicted,0.25,3,3,TCCGGAGAAACATTTATTGA,0,5279180
zapB_predicted,0.25,3,3,TCCGGAAAAGTTCGATATTT,0,5263190
zapB_predicted,0.25,3,3,TCCCAGACGGCAGCGCCTTT,0,5279762
zapB_predicted,0.25,3,3,TCCAGCAGTCGGGTGACTAC,0,5282646
zapB_predicted,0.25,3,3,TCATTTAGCCCTTGTTCCAG,0,5286869
zapB_predicted,0.25,3,3,TCATTGGGCAAGACTCCGAT,0,5279081
zapB_predicted,0.25,3,3,TCACGTACACGGAAATGGGT,0,5273409
zapB_predicted,0.25,3,3,TCAATTGTGACTAGAATATG,0,5276278
zapB_predicted,0.25,3,3,TCAAATGAATTGCTAAATGT,0,5285470
zapB_predicted,0.25,3,3,TATTTTCGTAAACAGTGATT,0,5267854
zapB_predicted,0.25,3,3,TATTGAAGCGCGGCAATCGT,0,5279443
zapB_predicted,0.25,3,3,TATTACGTTGCGGTATTGAT,0,5286626
zapB_predicted,0.25,3,3,TATTACGTGGCCGCCCGCAA,0,5268532
zapB_predicted,0.25,3,3,TATGATACTGAAATCTGTCG,0,5264015
zapB_predicted,0.25,3,3,TATGACTTTACCATGGGGGA,0,5280782
zapB_predicted,0.25,3,3,TATCTGGACTTCCGTGGTTT,0,5275974
zapB_predicted,0.25,3,3,TATCGTTTATAGATGTATTG,0,5274395
zapB_predicted,0.25,3,3,TATCGGCTGTTAATTTTGGT,0,5264564
zapB_predicted,0.25,3,3,TATCCGGCATCCTATTACTC,0,5278095
zapB_predicted,0.25,3,3,TATCCCAGGGGCGATTTTTT,0,5264018
zapB_predicted,0.25,3,3,TATCAGGTCTTAGAGTTATA,0,5263259
zapB_predicted,0.25,3,3,TAGGTTCTACACGATTAGTG,0,5268649
zapB_predicted,0.25,3,3,TAGCATGCCTTCTTGTCCTG,0,5285421
zapB_predicted,0.25,3,3,TAGCAAGGCAGCCATGGAGA,0,5278871
zapB_predicted,0.25,3,3,TAGATGTCGATCACCCGGTC,0,5264415
zapB_predicted,0.25,3,3,TAGATCTGGAGCACGGTTCG,0,5287510
zapB_predicted,0.25,3,3,TAGAGTAACCTATTGGGACT,0,5276551
zapB_predicted,0.25,3,3,TAGACAATGCGTTTTCTCGG,0,5267697
zapB_predicted,0.25,3,3,TAGACAACGGCGATCGTTTT,0,5274718
zapB_predicted,0.25,3,3,TACTTTCACAGGCACTGAAC,0,5277449
zapB_predicted,0.25,3,3,TACTTGCGGGTTGAACCGCA,0,5272920
zapB_predicted,0.25,3,3,TACTCTGTGATGGGGTGTAC,0,5276299
zapB_predicted,0.25,3,3,TACTAGGTGCGTGCCACATG,0,5264802
zapB_predicted,0.25,3,3,TACGTAGGGGATTCAGCAAC,0,5280205
zapB_predicted,0.25,3,3,TACGCGCGGGAGAGAGCTAC,0,5280454
zapB_predicted,0.25,3,3,TACCCACTCCACGATCAATA,0,5270956
zapB_predicted,0.25,3,3,TACAGGGCATACTGCACACT,0,5275377
zapB_predicted,0.25,3,3,TAATGACGCCTAGTGAAACA,0,5278883
zapB_predicted,0.25,3,3,TAATCCTAGAAAGTGGATTA,0,5283778
zapB_predicted,0.25,3,3,TAATAATCTATGGCGACAGA,0,5267568
zapB_predicted,0.25,3,3,TAAGCGGAAAGTTCAGACGC,0,5279127
zapB_predicted,0.25,3,3,TAAGATGTCATAGGTGCGAC,0,5279698
zapB_predicted,0.25,3,3,TAACATTTCCTGGCGGGCGG,0,5281869
zapB_predicted,0.25,3,3,TAAATTCACGTATGAGAATG,0,5283091
zapB_predicted,0.25,3,3,TAAAAGGTACTAGATTACCC,0,5274583
zapB_predicted,0.25,3,3,GTTTAAAGAGTCCCGACGAT,0,5286598
zapB_predicted,0.25,3,3,GTTGGGGCCGTCCAAAATTA,0,5279324
zapB_predicted,0.25,3,3,GTTGCAGGGTTTATTCATGA,0,5269647
zapB_predicted,0.25,3,3,GTTGCAGGGCCACATCCCGT,0,5276284
zapB_predicted,0.25,3,3,GTTCTGTTGACTGTCAAAAC,0,5271938
zapB_predicted,0.25,3,3,GTTCTCACGTGCGGGTACAT,0,5266632
zapB_predicted,0.25,3,3,GTTCCCTAGAGGGGCTAAAC,0,5267290
zapB_predicted,0.25,3,3,GTTAGCGACAGCGGTTCGTA,0,5269924
zapB_predicted,0.25,3,3,GTTAGCACCACGTGTAACGC,0,5286123
zapB_predicted,0.25,3,3,GTTACGATACTCACCATTGG,0,5271431
zapB_predicted,0.25,3,3,GTTAACGGACATATCTGGAA,0,5264369
zapB_predicted,0.25,3,3,GTGTTGTTCGGTAGTACCGC,0,5288013
zapB_predicted,0.25,3,3,GTGTCGCCGCACATGTCTTT,0,5264357
zapB_predicted,0.25,3,3,GTGCATCCGGAGCAAGACGC,0,5286304
zapB_predicted,0.25,3,3,GTGAACTGGTGTGAGTGCTA,0,5269867
zapB_predicted,0.25,3,3,GTCTCGAACCTCGTGAATAT,0,5263699
zapB_predicted,0.25,3,3,GTCTCACACCGTTGTAATTA,0,5266137
zapB_predicted,0.25,3,3,GTCGTCCTCGGCTCCTCGAA,0,5275539
zapB_predicted,0.25,3,3,GTCGGTATGCTTATTAGATT,0,5269859
zapB_predicted,0.25,3,3,GTCGGCTACGTCGATAACAG,0,5287764
zapB_predicted,0.25,3,3,GTCGGCGGGAAATGTCCACT,0,5263360
zapB_predicted,0.25,3,3,GTCGGAGATTTAGCTGGTCT,0,5274234
zapB_predicted,0.25,3,3,GTCCTCAGTTCGTCGGTGCT,0,5279296
zapB_predicted,0.25,3,3,GTCCGTTCCATACAAGATCT,0,5268680
zapB_predicted,0.25,3,3,GTCATCCTCGATCCGGTCTT,0,5270455
zapB_predicted,0.25,3,3,GTCATATTACAGCGGGTTAC,0,5279011
zapB_predicted,0.25,3,3,GTCAGTGTTGTCATACTTGG,0,5287190
zapB_predicted,0.25,3,3,GTCAGGTATGCGATAGTGGC,0,5286345
zapB_predicted,0.25,3,3,GTCACAGAATCAAACAGAAA,0,5272881
zapB_predicted,0.25,3,3,GTCAAGAGGCATCTGCAACT,0,5280842
zapB_predicted,0.25,3,3,GTATGGTCATAAGCAGTTTG,0,5280505
zapB_predicted,0.25,3,3,GTATAGTGTTCTAAGTCGTC,0,5275651
zapB_predicted,0.25,3,3,GTATAAGAAAGGTCCCTTCA,0,5267834
zapB_predicted,0.25,3,3,GTAGTCAAATAGGACAAACT,0,5265038
zapB_predicted,0.25,3,3,GTAGGGAGGTTATGGTACGG,0,5280411
zapB_predicted,0.25,3,3,GTACAACGTATGTAAATTGT,0,5270580
zapB_predicted,0.25,3,3,GTAATATTGCACGGGAGTAA,0,5287598
zapB_predicted,0.25,3,3,GTAAAACGTTCCTCGACTAG,0,5270651
zapB_predicted,0.25,3,3,GGTGATCGGGGTATACCCTG,0,5276050
zapB_predicted,0.25,3,3,GGTCTGACAAGCGGCATCGA,0,5287863
zapB_predicted,0.25,3,3,GGTCTATTGTATTGGGCTCC,0,5283271
zapB_predicted,0.25,3,3,GGTCGGGGTGGGAACCCCGC,0,5276612
zapB_predicted,0.25,3,3,GGTCACGCCACAAAGACAGA,0,5271118
zapB_predicted,0.25,3,3,GGTATGGCAATGCCACCGCA,0,5270473
zapB_predicted,0.25,3,3,GGTATCGTTTTATCGCATAC,0,5265376
zapB_predicted,0.25,3,3,GGTAATTACTGGCTAGGTCC,0,5268079
zapB_predicted,0.25,3,3,GGTAAGCGTGGTCCCAAAAA,0,5285986
zapB_predicted,0.25,3,3,GGGTTGCCGCCTTGTATAGT,0,5271637
zapB_predicted,0.25,3,3,GGGTTCATATTGGGTCCCAC,0,5274343
zapB_predicted,0.25,3,3,GGGTCTTTGCTTTTCGCGCC,0,5263951
zapB_predicted,0.25,3,3,GGGTATGCCAGCACTTTTGA,0,5268239
zapB_predicted,0.25,3,3,GGGTATACTATGCCTAAATA,0,5265630
zapB_predicted,0.25,3,3,GGGGGGACCTACGGCGCTTA,0,5264051
zapB_predicted,0.25,3,3,GGGGCGCTTTGCCCTTGGAC,0,5282315
zapB_predicted,0.25,3,3,GGGGAACAGGGTTATGCAGA,0,5288293
zapB_predicted,0.25,3,3,GGGCTAGGGTAATACTAAAC,0,5266963
zapB_predicted,0.25,3,3,GGGCGCCCATCAGAGCGCGT,0,5264540
zapB_predicted,0.25,3,3,GGGCGATATCTGTGTCCCAA,0,5273755
zapB_predicted,0.25,3,3,GGGCCGACACATAACGTATA,0,5275890
zapB_predicted,0.25,3,3,GGGATGCAGAGGTGACTGTA,0,5272755
zapB_predicted,0.25,3,3,GGCTCATCAGTCAAATGATC,0,5263784
zapB_predicted,0.25,3,3,GGCTACAGGAGCAAGAGAGC,0,5280552
zapB_predicted,0.25,3,3,GGCGGAATTGATTATTTAAT,0,5285066
zapB_predicted,0.25,3,3,GGCGCGACATTGTCCCCTGT,0,5279056
zapB_predicted,0.25,3,3,GGCCTCGCTCGGTCAGGTTA,0,5276116
zapB_predicted,0.25,3,3,GGCCGGGCCGATCCAGACAC,0,5273796
zapB_predicted,0.25,3,3,GGCACGCTTAAGTGCTACTC,0,5288342
zapB_predicted,0.25,3,3,GGCACAGCACGCGTTGACAG,0,5282718
zapB_predicted,0.25,3,3,GGCACACTGATGTCAATTGC,0,5285353
zapB_predicted,0.25,3,3,GGATTCCGTGCAAAAGTTCA,0,5264449
zapB_predicted,0.25,3,3,GGATTAGGTGCTGTACTTTC,0,5286148
zapB_predicted,0.25,3,3,GGATAGCCTTTTCTACCGAG,0,5288075
zapB_predicted,0.25,3,3,GGATAAGTATATTTGGTGCT,0,5271429
zapB_predicted,0.25,3,3,GGAGTGCCGGTGGGATGGGG,0,5264538
zapB_predicted,0.25,3,3,GGAGGGACTCAAATGCGTGC,0,5286882
zapB_predicted,0.25,3,3,GGAGACCAGTTCCTAGCGTA,0,5268784
zapB_predicted,0.25,3,3,GGAGACACGTCAAGGGATGA,0,5278977
zapB_predicted,0.25,3,3,GGAGAATGTGTCATGCATCA,0,5278834
zapB_predicted,0.25,3,3,GGACCGGGGTGTGTGTCGGG,0,5267942
zapB_predicted,0.25,3,3,GGAACGCTTCACTGGGGTAC,0,5285025
zapB_predicted,0.25,3,3,GGAACAGTCGCCAACATAGT,0,5274888
zapB_predicted,0.25,3,3,GCTTTGTCGTTAACTTGGGT,0,5277327
zapB_predicted,0.25,3,3,GCTTTGGCCGTGTCGGGCCG,0,5271032
zapB_predicted,0.25,3,3,GCTTGTTCGAGATTCTAGGT,0,5284866
zapB_predicted,0.25,3,3,GCTTGAAGGGCAGACTCCTG,0,5264934
zapB_predicted,0.25,3,3,GCTTCGTTGCCCTGTAGGGA,0,5263351
zapB_predicted,0.25,3,3,GCTTAAGAGATGTAAGGTGC,0,5264733
zapB_predicted,0.25,3,3,GCTCAATGACAGATAGATTC,0,5284068
zapB_predicted,0.25,3,3,GCTATACGCCTCGTTTAACT,0,5282229
zapB_predicted,0.25,3,3,GCTAGTCTGTGTTTACTAAA,0,5271126
zapB_predicted,0.25,3,3,GCGTTGACTCGGTAAGACGC,0,5270257
zapB_predicted,0.25,3,3,GCGTCACATTGCTGTTGATC,0,5282952
zapB_predicted,0.25,3,3,GCGGTTCCGCGAGACCGCCT,0,5275061
zapB_predicted,0.25,3,3,GCGGTAGGCATTACCAAAGA,0,5270909
zapB_predicted,0.25,3,3,GCGGGGGGTCGGGTAGAAAC,0,5276030
zapB_predicted,0.25,3,3,GCGGGCTCATAAGGGCGTCA,0,5274478
zapB_predicted,0.25,3,3,GCGCGAGATCGGGAAGTATA,0,5269150
zapB_predicted,0.25,3,3,GCGCGACAATCGACGTTCTT,0,5271288
zapB_predicted,0.25,3,3,GCGCACGTAAGACAGTTTTT,0,5275018
zapB_predicted,0.25,3,3,GCCTTCTCGGCATGAGTAAT,0,5276758
zapB_predicted,0.25,3,3,GCCGGTTGCTGCCGGTCCAA,0,5280931
zapB_predicted,0.25,3,3,GCCGCGAAGGCTGTATTCTG,0,5286074
zapB_predicted,0.25,3,3,GCCGACAAGTAAAAGAATCG,0,5275595
zapB_predicted,0.25,3,3,GCCCACTGTCTCTCGAACAC,0,5270976
zapB_predicted,0.25,3,3,GCCATGCGTAGACAGGTATT,0,5274196
zapB_predicted,0.25,3,3,GCCAAGAATCATGCGAGGCC,0,5277270
zapB_predicted,0.25,3,3,GCCAAATCAGCGATGTCGAA,0,5270713
zapB_predicted,0.25,3,3,GCATTCATAGTTTGCCCTAC,0,5282922
zapB_predicted,0.25,3,3,GCATACGATTAACCCCCTAT,0,5268640
zapB_predicted,0.25,3,3,GCAGGCCGCGCTGGTAATGA,0,5269251
zapB_predicted,0.25,3,3,GCAGATGGCACATGATCCAC,0,5275927
zapB_predicted,0.25,3,3,GCAGACGGCCACCACGGAAG,0,5269525
zapB_predicted,0.25,3,3,GCACCCTAATATAGACCACC,0,5266343
zapB_predicted,0.25,3,3,GCACATTATGTATCCCGTGT,0,5287754
zapB_predicted,0.25,3,3,GCAATCCGGCCTCATACTCT,0,5264274
zapB_predicted,0.25,3,3,GCAATATGCTTACTGAGATT,0,5280775
zapB_predicted,0.25,3,3,GCAACTTTACGGAAACGATC,0,5267866
zapB_predicted,0.25,3,3,GCAAAAAGGGGTTGCCAAGT,0,5278997
zapB_predicted,0.25,3,3,GATGCCACGCTTTAAACCAT,0,5268267
zapB_predicted,0.25,3,3,GATGCAGACGACCTCCAGAT,0,5279186
zapB_predicted,0.25,3,3,GATCGGTTATCGAACCCGTG,0,5268611
zapB_predicted,0.25,3,3,GATCGGGTAGTTGGGGCGTA,0,5265603
zapB_predicted,0.25,3,3,GATCAGTGAGTGTTGAGGCT,0,5263184
zapB_predicted,0.25,3,3,GATCACACGCGTCCTCGAAC,0,5276496
zapB_predicted,0.25,3,3,GATATAAATTTTTAACTCCG,0,5267342
zapB_predicted,0.25,3,3,GATAAGCCGGAGAGATCTCC,0,5275414
zapB_predicted,0.25,3,3,GAGTGGTAATTTGTTGTATC,0,5279687
zapB_predicted,0.25,3,3,GAGTCGTCCCAACCCTATGA,0,5288009
zapB_predicted,0.25,3,3,GAGTATCGATCTCAACGCCT,0,5267753
zapB_predicted,0.25,3,3,GAGGTATTTCCAATCATGTG,0,5276609
zapB_predicted,0.25,3,3,GAGGTAGGTAACCGGTGAGG,0,5265803
zapB_predicted,0.25,3,3,GAGGCTAAGGTATTCTCCAT,0,5269601
zapB_predicted,0.25,3,3,GAGGAGATTCGGAGCGTGTT,0,5274448
zapB_predicted,0.25,3,3,GAGGAAATTTCGGCGCATAC,0,5270412
zapB_predicted,0.25,3,3,GAGAATTATCACGATCCTCG,0,5285462
zapB_predicted,0.25,3,3,GACTGTACTGAATCCCAAGC,0,5272731
zapB_predicted,0.25,3,3,GACGTCACTGCGCATAGAAT,0,5287560
zapB_predicted,0.25,3,3,GACGTATGATAATACCGAAG,0,5268009
zapB_predicted,0.25,3,3,GACGCTCGCGGTCAGGAGTC,0,5269084
zapB_predicted,0.25,3,3,GACGATGATGCGCAGCTTGA,0,5283049
zapB_predicted,0.25,3,3,GACCAGGCCTTAAGCGGTGA,0,5285850
zapB_predicted,0.25,3,3,GACAATTGCGACCGCTGGAA,0,5266233
zapB_predicted,0.25,3,3,GACAACGCCCACAGAGTCAC,0,5282286
zapB_predicted,0.25,3,3,GAATGGCATCCTTAGCGGAA,0,5279479
zapB_predicted,0.25,3,3,GAATCTTTGCAATAGACAAG,0,5278832
zapB_predicted,0.25,3,3,GAATATGGCAATGTCGAAAA,0,5270607
zapB_predicted,0.25,3,3,GAAGTGATTCTAGATGTCAT,0,5272992
zapB_predicted,0.25,3,3,GAAGCCCTATATATCTCATT,0,5277454
zapB_predicted,0.25,3,3,GAAGCAGTTGTTGAAACCAC,0,5286244
zapB_predicted,0.25,3,3,GAACTGGTTCGAGGCTGGCG,0,5271834
zapB_predicted,0.25,3,3,GAACCTTAATCTATCGGACG,0,5267577
zapB_predicted,0.25,3,3,GAAATTGTCATCGTTCCATT,0,5278197
zapB_predicted,0.25,3,3,GAAATTAAACTAAACGCCAG,0,5266399
zapB_predicted,0.25,3,3,GAAATGCAGAAGTTGCAGTA,0,5280116
zapB_predicted,0.25,3,3,GAAAGCTGAGTGCTGACGAC,0,5284359
zapB_predicted,0.25,3,3,CTTTTGCTACCCCCGGGCTC,0,5276790
zapB_predicted,0.25,3,3,CTTTCGCGCCGGCAGCATGG,0,5269274
zapB_predicted,0.25,3,3,CTTTCACTCTATCGATTCAA,0,5269767
zapB_predicted,0.25,3,3,CTTGGAATTCCTGCCGGTAT,0,5283721
zapB_predicted,0.25,3,3,CTTATATCCTGTTGAGAAGG,0,5274672
zapB_predicted,0.25,3,3,CTTACACTTGCCGTTTACCA,0,5278347
zapB_predicted,0.25,3,3,CTGGACAACGTCACCGTCAT,0,5275860
zapB_predicted,0.25,3,3,CTGCCATATCTTTAGAACCA,0,5271449
zapB_predicted,0.25,3,3,CTCTTAAGGAGTCCGCTCTC,0,5268487
zapB_predicted,0.25,3,3,CTCTGACCTTGTACTTTGAC,0,5285680
zapB_predicted,0.25,3,3,CTCGGAGTTAAGTGACTAAC,0,5263094
zapB_predicted,0.25,3,3,CTCCTTCTGCAAAGCATTTC,0,5265496
zapB_predicted,0.25,3,3,CTCCTGGAGTTCATACGATT,0,5279552
zapB_predicted,0.25,3,3,CTCCAATATTAGGGTCTCGT,0,5280819
zapB_predicted,0.25,3,3,CTCACTTAGATGTTATCGGA,0,5269548
zapB_predicted,0.25,3,3,CTCACGAGAACACACCTTCA,0,5285579
zapB_predicted,0.25,3,3,CTCACACCTCGGCATTTCTG,0,5280470
zapB_predicted,0.25,3,3,CTATAGGGTAATTTTGTGAT,0,5276068
zapB_predicted,0.25,3,3,CTAGGGCCATTTCATCTAAG,0,5271670
zapB_predicted,0.25,3,3,CTACCGTTAGCGGATCGATC,0,5266978
zapB_predicted,0.25,3,3,CTAAGCTGGCCCGATGCACG,0,5271212
zapB_predicted,0.25,3,3,CTAACTGGTAATCCATATCG,0,5273829
zapB_predicted,0.25,3,3,CTAACTGCACTATTACTGAA,0,5263622
zapB_predicted,0.25,3,3,CGTTTCGTTAGATTTGTATC,0,5277884
zapB_predicted,0.25,3,3,CGTTCACGACTTTGAAGATC,0,5265321
zapB_predicted,0.25,3,3,CGTGGCCTGCACGGTGAGAC,0,5275203
zapB_predicted,0.25,3,3,CGTGCAAGGTCCTAGCGAAA,0,5265200
zapB_predicted,0.25,3,3,CGTCGCAAGCTGACCAACTA,0,5268539
zapB_predicted,0.25,3,3,CGTCGAGATTACACGAATAA,0,5272023
zapB_predicted,0.25,3,3,CGTCCCAGAGTTGGTACTTA,0,5278859
zapB_predicted,0.25,3,3,CGTCACGTGGCGCACGCGTC,0,5276171
zapB_predicted,0.25,3,3,CGTAGGATACATCAGAACCA,0,5269547
zapB_predicted,0.25,3,3,CGTACGTTGTGGTTTGCATC,0,5276319
zapB_predicted,0.25,3,3,CGTAAGGCATCAACGCTGTC,0,5269198
zapB_predicted,0.25,3,3,CGGTTCCGCGCGTAGGGGTC,0,5269266
zapB_predicted,0.25,3,3,CGGTGTGTGAGACCGGTAAG,0,5263066
zapB_predicted,0.25,3,3,CGGTCTGCCAAGAGACCTCG,0,5273486
zapB_predicted,0.25,3,3,CGGTCCGATTTGAGGCTTCG,0,5270761
zapB_predicted,0.25,3,3,CGGTAGTCCGGATTGAATAT,0,5287954
zapB_predicted,0.25,3,3,CGGTAACTCACACCAAAGGG,0,5277152
zapB_predicted,0.25,3,3,CGGGTTTCTGCCCCGCTCGT,0,5267775
zapB_predicted,0.25,3,3,CGGGTGCATTAGTTGCCAGG,0,5273310
zapB_predicted,0.25,3,3,CGGGGATGCCGGTTAAGACT,0,5266641
zapB_predicted,0.25,3,3,CGGGCGTGAAGAACATATTT,0,5278022
zapB_predicted,0.25,3,3,CGGGCACAGTCACGTCTCCT,0,5279580
zapB_predicted,0.25,3,3,CGGCTGAGGGGGGAACAGAT,0,5264705
zapB_predicted,0.25,3,3,CGGCTATGACCTGAGGCGAA,0,5284924
zapB_predicted,0.25,3,3,CGGCTAATCCCGCCCCGACA,0,5277768
zapB_predicted,0.25,3,3,CGGCACTTAGAGCCTGGTTA,0,5280749
zapB_predicted,0.25,3,3,CGGAGGCACCCCGGAGCGTT,0,5278411
zapB_predicted,0.25,3,3,CGGACTAGCCTCAATTCGAA,0,5272431
zapB_predicted,0.25,3,3,CGGAATTATTTTGCACGGTG,0,5266846
zapB_predicted,0.25,3,3,CGCTTCTTCCCCTTATACGC,0,5268776
zapB_predicted,0.25,3,3,CGCTTCTGTGGCTTTAGTTC,0,5273791
zapB_predicted,0.25,3,3,CGCTTAGTTGTTTCTCTCCA,0,5268398
zapB_predicted,0.25,3,3,CGCTCCCGTTCCGAAGAAGT,0,5271312
zapB_predicted,0.25,3,3,CGCTAAGTAGATACCCCCCG,0,5284553
zapB_predicted,0.25,3,3,CGCGCCTATATGTATGTCCA,0,5276593
zapB_predicted,0.25,3,3,CGCAAGGACATCGCAGGAGC,0,5267246
zapB_predicted,0.25,3,3,CGATTACGAAAGGTTCAACC,0,5265688
zapB_predicted,0.25,3,3,CGATCTTAACGGAAAGTCCG,0,5278044
zapB_predicted,0.25,3,3,CGATAGATCCGGGGACATCT,0,5287412
zapB_predicted,0.25,3,3,CGAGGTCTGAACGGATTTAT,0,5267557
zapB_predicted,0.25,3,3,CGAGCTCACAATCGTATCGA,0,5283059
zapB_predicted,0.25,3,3,CGAGAGCCGAGACAATCGCA,0,5270893
zapB_predicted,0.25,3,3,CGACTCGGGGGAAATTCTGG,0,5274659
zapB_predicted,0.25,3,3,CGACGTGCAATTCGTTCCGC,0,5272714
zapB_predicted,0.25,3,3,CGACGCGGGTAACTGTAGGG,0,5263381
zapB_predicted,0.25,3,3,CGACCATCGTAATTCGGATC,0,5281884
zapB_predicted,0.25,3,3,CGACCAAGGGAGGCGAGGCA,0,5281864
zapB_predicted,0.25,3,3,CGAATTAGAACGCGTACCAA,0,5287227
zapB_predicted,0.25,3,3,CGAACGGAGTCTTGCTGGAA,0,5265164
zapB_predicted,0.25,3,3,CGAAAGAAATAGGCTTTGCT,0,5285765
zapB_predicted,0.25,3,3,CCTTTAGAGGAGCGAGGCAA,0,5284187
zapB_predicted,0.25,3,3,CCTTCTGCTTTTCCGGCCGT,0,5285575
zapB_predicted,0.25,3,3,CCTGGCGTAAAAGGAGAGGT,0,5283172
zapB_predicted,0.25,3,3,CCTGGAATAAATTATCCAGT,0,5270952
zapB_predicted,0.25,3,3,CCTGCGAAGGAACCATTTGA,0,5277733
zapB_predicted,0.25,3,3,CCTGCCGCACGTTCAAGACT,0,5275667
zapB_predicted,0.25,3,3,CCTGCATGCACCGCATCCCT,0,5277729
zapB_predicted,0.25,3,3,CCTGATGGCGATTCCATCCG,0,5263809
zapB_predicted,0.25,3,3,CCTGAATGTGTAGATTATCA,0,5271122
zapB_predicted,0.25,3,3,CCTCTCGGGCATTTCAAGTT,0,5286327
zapB_predicted,0.25,3,3,CCTCCTTAGGGTTAATCCGT,0,5286582
zapB_predicted,0.25,3,3,CCTCATCTTTCAGCGCATGG,0,5277144
zapB_predicted,0.25,3,3,CCTAGCAGCTGCAAGTGAAG,0,5275242
zapB_predicted,0.25,3,3,CCTACGCTAGCCTCCAATCC,0,5285912
zapB_predicted,0.25,3,3,CCGTCGGGTAGAGTGTGCGT,0,5281355
zapB_predicted,0.25,3,3,CCGTCCGTCACATGATCAAG,0,5263678
zapB_predicted,0.25,3,3,CCGTCATCGCGAGCCCTCCT,0,5285100
zapB_predicted,0.25,3,3,CCGTAGTTGAGAGCATTTTA,0,5272186
zapB_predicted,0.25,3,3,CCGGTATATGCGGACCGACC,0,5266937
zapB_predicted,0.25,3,3,CCGGCTCTGGTATCGGCGGC,0,5287706
zapB_predicted,0.25,3,3,CCGGACCAACCCGCCGACAT,0,5273431
zapB_predicted,0.25,3,3,CCGCTGGAATGTAAGGCTCC,0,5288290
zapB_predicted,0.25,3,3,CCGCTCTAACGCTTGGAGTG,0,5287848
zapB_predicted,0.25,3,3,CCGATAGCATTCAAATTTGT,0,5282470
zapB_predicted,0.25,3,3,CCGACTCATTTCTTGCCATT,0,5270577
zapB_predicted,0.25,3,3,CCGAATTCCGAGTGCAAGTA,0,5285924
zapB_predicted,0.25,3,3,CCGAACGACGTATTTCATGC,0,5270903
zapB_predicted,0.25,3,3,CCCTTTCTTAAGGTTGTCAA,0,5283035
zapB_predicted,0.25,3,3,CCCTTCACGACCGCAGTAAC,0,5270353
zapB_predicted,0.25,3,3,CCCTGCTACAACCGGTAGAT,0,5288205
zapB_predicted,0.25,3,3,CCCTAGTTTTAAGGCTGCAA,0,5269921
zapB_predicted,0.25,3,3,CCCGGGACCAACCTAACACC,0,5275444
zapB_predicted,0.25,3,3,CCCGACGATTATGCTTCCGC,0,5272922
zapB_predicted,0.25,3,3,CCCGAAGATCTTAACGGGCT,0,5282063
zapB_predicted,0.25,3,3,CCCCTCTTTTCATAAATACG,0,5287360
zapB_predicted,0.25,3,3,CCCCTACGCATTCGTGCCAT,0,5286694
zapB_predicted,0.25,3,3,CCCCGTTTAGACAGCGGAGG,0,5275347
zapB_predicted,0.25,3,3,CCCCCTGGGGTGAATCTGAA,0,5288219
zapB_predicted,0.25,3,3,CCCCATGCTGATAGTCCAGC,0,5283975
zapB_predicted,0.25,3,3,CCCACCTGGTGGCTTCAAGT,0,5279986
zapB_predicted,0.25,3,3,CCATTTTGTAGGTAGGACAT,0,5278000
zapB_predicted,0.25,3,3,CCATTCAGTCAAGCAGCGAA,0,5284491
zapB_predicted,0.25,3,3,CCATGGATTTGTATAATACC,0,5270053
zapB_predicted,0.25,3,3,CCATATCCGTCCAGCATGTT,0,5283220
zapB_predicted,0.25,3,3,CCATACGTTGCGTTCATGAA,0,5273943
zapB_predicted,0.25,3,3,CCAGTCACATAGCTAGACCT,0,5276933
zapB_predicted,0.25,3,3,CCAGCCGCGAGCGTTGAGGA,0,5272237
zapB_predicted,0.25,3,3,CCACTTATATGGACTGTACA,0,5282714
zapB_predicted,0.25,3,3,CCACTGCACTAGGGGCTATA,0,5268052
zapB_predicted,0.25,3,3,CCACGTTCGTAGTGGTAACT,0,5276716
zapB_predicted,0.25,3,3,CCACGCGCGCAAATTTGGAC,0,5273588
zapB_predicted,0.25,3,3,CCAATTATGGAAACTCCAGG,0,5264341
zapB_predicted,0.25,3,3,CCAATATTCTGCGGGGATTG,0,5278931
zapB_predicted,0.25,3,3,CCAATAATGAGATAGTCAGG,0,5277978
zapB_predicted,0.25,3,3,CCAACACTGTTCGGAGGATT,0,5288318
zapB_predicted,0.25,3,3,CATTTAGGATGTTAGGAGGC,0,5267170
zapB_predicted,0.25,3,3,CATTCACCGGTGATCGCTGT,0,5267864
zapB_predicted,0.25,3,3,CATTATCGGTGAGATCCGCG,0,5284218
zapB_predicted,0.25,3,3,CATTAGCGTTGGGTCTAGCT,0,5286376
zapB_predicted,0.25,3,3,CATCCTAGCGTGCCGTCACA,0,5284146
zapB_predicted,0.25,3,3,CAGTTTTGGTTAAGATAAGC,0,5282149
zapB_predicted,0.25,3,3,CAGTTGAAACGTACGCCACG,0,5284203
zapB_predicted,0.25,3,3,CAGTGTGACGCTTAAAGTGA,0,5272864
zapB_predicted,0.25,3,3,CAGTGCAGCCCCCATCATAT,0,5271758
zapB_predicted,0.25,3,3,CAGGACCGACGCATTGCTGC,0,5266234
zapB_predicted,0.25,3,3,CAGCCATCAGAGTAGGGAGT,0,5269888
zapB_predicted,0.25,3,3,CAGCAATCGCCACATGTTTC,0,5274270
zapB_predicted,0.25,3,3,CACTGGGAGCCGCAAACCCC,0,5279677
zapB_predicted,0.25,3,3,CACTGAACCAGTTTTCATTT,0,5272916
zapB_predicted,0.25,3,3,CACTAATCCTGACGGGGATC,0,5278379
zapB_predicted,0.25,3,3,CACGCCCTTGCTCCGTCATT,0,5268222
zapB_predicted,0.25,3,3,CACGCAGAGAGCTCTGTTCG,0,5287107
zapB_predicted,0.25,3,3,CACCTGCTACCCTTATTGGG,0,5273632
zapB_predicted,0.25,3,3,CACAGTTCACGAAACAGCGA,0,5278410
zapB_predicted,0.25,3,3,CACAGAGGCTGGAGTCTGCA,0,5276075
zapB_predicted,0.25,3,3,CACACCTGGACTAACCTGGT,0,5276011
zapB_predicted,0.25,3,3,CAATTCGGACTCGCAGATTC,0,5273184
zapB_predicted,0.25,3,3,CAATTCCTATTACTCATCCC,0,5280338
zapB_predicted,0.25,3,3,CAATGTTATCGGAAACCTTA,0,5263224
zapB_predicted,0.25,3,3,CAATACGTGTCATGTCCGAG,0,5283957
zapB_predicted,0.25,3,3,CAAGGTGGGTCCCCGACTGA,0,5285192
zapB_predicted,0.25,3,3,CAAGGTACCCCGAAGATTCA,0,5276710
zapB_predicted,0.25,3,3,CAAGCTAGGTAGGAAGTTTC,0,5274841
zapB_predicted,0.25,3,3,CAAGACTCAAGGCCTACCAC,0,5266086
zapB_predicted,0.25,3,3,CAAGACACATAGGGGGAGAA,0,5278058
zapB_predicted,0.25,3,3,CAACTTACTTTCCGAGGGAG,0,5270611
zapB_predicted,0.25,3,3,CAACCGCTTTGACCCCATAC,0,5274816
zapB_predicted,0.25,3,3,CAACCCGGTAGACTCCCGAC,0,5277032
zapB_predicted,0.25,3,3,CAACATCCTCGGGGTTTAAA,0,5267558
zapB_predicted,0.25,3,3,CAAATTCGTCCACGGTCCGT,0,5280636
zapB_predicted,0.25,3,3,CAAACGGAGTGCTAGTGGTG,0,5266995
zapB_predicted,0.25,3,3,ATTTTGTTTATGTAAAGGTC,0,5272693
zapB_predicted,0.25,3,3,ATTTGCAGGAACGCCCTTTA,0,5281595
zapB_predicted,0.25,3,3,ATTTCAGGGTCAGCTGTAGC,0,5283950
zapB_predicted,0.25,3,3,ATTGCGGTAGCAGGACATTT,0,5264987
zapB_predicted,0.25,3,3,ATTGCATCACATAAGTGCGC,0,5272094
zapB_predicted,0.25,3,3,ATTGCAGGAACGCCGAATGT,0,5263627
zapB_predicted,0.25,3,3,ATTGCAAGATACCAGTAGAT,0,5267862
zapB_predicted,0.25,3,3,ATTCTGTCCTCTACTCCCGT,0,5287431
zapB_predicted,0.25,3,3,ATTCTCGGACCCGGAGCCGG,0,5283402
zapB_predicted,0.25,3,3,ATTCTAGACGTGAAGCACGA,0,5277466
zapB_predicted,0.25,3,3,ATTCCCAATCAGTATCTGAC,0,5268709
zapB_predicted,0.25,3,3,ATTCCAGAATAGCCTCGAAA,0,5266961
zapB_predicted,0.25,3,3,ATTACTTTGGGGGATAGTGA,0,5286096
zapB_predicted,0.25,3,3,ATGTTGGGCGAGCAATATCC,0,5280435
zapB_predicted,0.25,3,3,ATGTCGTAAGCTTCGATCCA,0,5275718
zapB_predicted,0.25,3,3,ATGTCCACAAACCCCTTGGG,0,5283045
zapB_predicted,0.25,3,3,ATGTACTTGCACCAACAAAT,0,5282328
zapB_predicted,0.25,3,3,ATGGGTCAATCAAAACTGTG,0,5283574
zapB_predicted,0.25,3,3,ATGCGGGTTACTTGATAATG,0,5272466
zapB_predicted,0.25,3,3,ATGCCTTTGCAGGGGATACT,0,5270413
zapB_predicted,0.25,3,3,ATGCCACCTGTACCAGGTGG,0,5266293
zapB_predicted,0.25,3,3,ATGACCTTGCCCACCGCCGG,0,5288345
zapB_predicted,0.25,3,3,ATCTGATTGCACCAAGTTCC,0,5281100
zapB_predicted,0.25,3,3,ATCGTCATTCTGATATGTCG,0,5272584
zapB_predicted,0.25,3,3,ATCGGCCATGGGGCCATCCA,0,5287264
zapB_predicted,0.25,3,3,ATCGCGGGCTTAGACGGGGG,0,5281388
zapB_predicted,0.25,3,3,ATCGAACTTTCAAAAGATGT,0,5271681
zapB_predicted,0.25,3,3,ATCCGCACCTAATCTTCGAC,0,5288167
zapB_predicted,0.25,3,3,ATCATACCAACCCACTCAAT,0,5276323
zapB_predicted,0.25,3,3,ATCAGACTGTAATTCAGTAG,0,5264074
zapB_predicted,0.25,3,3,ATCAACCAGGGTGCTTTAAA,0,5275122
zapB_predicted,0.25,3,3,ATATGATGCCTGCTGTCAAC,0,5276748
zapB_predicted,0.25,3,3,ATATATCGGATCTAATTGTG,0,5286349
zapB_predicted,0.25,3,3,ATATAGTCCTACGCGCCCAG,0,5284768
zapB_predicted,0.25,3,3,ATAGGCACCGTTTTCGCGTC,0,5280737
zapB_predicted,0.25,3,3,ATAGCGTGCGATTAACTTTC,0,5263009
zapB_predicted,0.25,3,3,ATAGACCAAAGAGGGGCCAC,0,5270897
zapB_predicted,0.25,3,3,ATACAGGACATCTTGACGGC,0,5288058
zapB_predicted,0.25,3,3,ATAAAATGGGCAACAGCCGC,0,5279458
zapB_predicted,0.25,3,3,AGTTTAGACTCTGAATGCAT,0,5276553
zapB_predicted,0.25,3,3,AGTCCTAAACAAGCCGCGAA,0,5274133
zapB_predicted,0.25,3,3,AGTCATCTAATCTCGTACGA,0,5286994
zapB_predicted,0.25,3,3,AGTAAGACGCCTTGGGAGGA,0,5267146
zapB_predicted,0.25,3,3,AGGTTTGGACCGCGAAAAGC,0,5282556
zapB_predicted,0.25,3,3,AGGTCATTGGGAAAGTGTTG,0,5279825
zapB_predicted,0.25,3,3,AGGGTCTAAACTGGAATCGA,0,5269062
zapB_predicted,0.25,3,3,AGGGTCCTGTGTAGTTCTCT,0,5281855
zapB_predicted,0.25,3,3,AGGGGACGGTTGACTTCGGC,0,5264243
zapB_predicted,0.25,3,3,AGGGCGGTACGTCTAAGGTC,0,5270295
zapB_predicted,0.25,3,3,AGGGCCGATGTTATAGGCCG,0,5275746
zapB_predicted,0.25,3,3,AGGGAGCGTCACCCCCGTCC,0,5264735
zapB_predicted,0.25,3,3,AGGCACTCGAGGTGGTATAG,0,5276619
zapB_predicted,0.25,3,3,AGGATTCATATTTGGATACG,0,5274783
zapB_predicted,0.25,3,3,AGGAGAGCAAACAACATAAC,0,5278827
zapB_predicted,0.25,3,3,AGGACACTATGGAATCGTCT,0,5264196
zapB_predicted,0.25,3,3,AGCTGCTGCACCCCCGACCG,0,5282222
zapB_predicted,0.25,3,3,AGCTATGAGTGGCGGGGTTA,0,5275740
zapB_predicted,0.25,3,3,AGCTAACCTATTTCTTCCGC,0,5284204
zapB_predicted,0.25,3,3,AGCGGACATCTGGCAGCTAA,0,5285433
zapB_predicted,0.25,3,3,AGCGCAATGTCTTCCCAACA,0,5270083
zapB_predicted,0.25,3,3,AGCCGTAGAAAGCTTACGTA,0,5287832
zapB_predicted,0.25,3,3,AGCCGCTTGGTGGCATCCAG,0,5274091
zapB_predicted,0.25,3,3,AGCCAGTCAGAAAATCTGTT,0,5272019
zapB_predicted,0.25,3,3,AGCCAACGGTGAGGTACGCC,0,5275124
zapB_predicted,0.25,3,3,AGCAGCACGAACTTCTATCA,0,5267635
zapB_predicted,0.25,3,3,AGCACTCGCTACCCATGTAT,0,5274607
zapB_predicted,0.25,3,3,AGCACCATTTGGGTTTGTTA,0,5275271
zapB_predicted,0.25,3,3,AGATTGGTGTATGTAGGGGG,0,5286072
zapB_predicted,0.25,3,3,AGATGTAGGAGCTCAAAGGT,0,5269866
zapB_predicted,0.25,3,3,AGATCTCCAGTTGCGAACTA,0,5273248
zapB_predicted,0.25,3,3,AGATAGAGAACTCACGAAGG,0,5275485
zapB_predicted,0.25,3,3,AGAGTAGAAATGTAAGCTAA,0,5283877
zapB_predicted,0.25,3,3,AGAGCATGACGTACTACCCT,0,5267506
zapB_predicted,0.25,3,3,AGACTCTCCGGGCAAGCAGA,0,5271255
zapB_predicted,0.25,3,3,AGACGCTACTGCCCTTTCTT,0,5271949
zapB_predicted,0.25,3,3,AGACCCCCTCCGGTCGCGAT,0,5263582
zapB_predicted,0.25,3,3,AGAAACATCTAGTCTTTGGG,0,5265171
zapB_predicted,0.25,3,3,ACTTTAACACTCCGTAGTAC,0,5278627
zapB_predicted,0.25,3,3,ACTTATCTAACAGTCGGGAT,0,5287247
zapB_predicted,0.25,3,3,ACTGCGGGGGTACAGCTCTC,0,5263393
zapB_predicted,0.25,3,3,ACTCTTTATCACCCACGCCC,0,5285119
zapB_predicted,0.25,3,3,ACTCCTACATAAAAATATCG,0,5266752
zapB_predicted,0.25,3,3,ACTCCCGTACTACGAGGTCT,0,5263021
zapB_predicted,0.25,3,3,ACTCAGATTTAATCAAGCCC,0,5265787
zapB_predicted,0.25,3,3,ACGTTTTATCGCTTTGATGG,0,5264400
zapB_predicted,0.25,3,3,ACGTCATAGAGGTCAGGCGA,0,5285620
zapB_predicted,0.25,3,3,ACGTAGTAGGATGTGGCAAC,0,5266715
zapB_predicted,0.25,3,3,ACGTACCGCAGCGCCGTCAC,0,5272277
zapB_predicted,0.25,3,3,ACGGTCACGCTGCTCAAGGA,0,5279576
zapB_predicted,0.25,3,3,ACGGGTGCTCGGCCTTAAGA,0,5269384
zapB_predicted,0.25,3,3,ACGGACCGCTGTGCCAGCGT,0,5273787
zapB_predicted,0.25,3,3,ACGCGTAGAGTCTGCCCGTA,0,5285934
zapB_predicted,0.25,3,3,ACGCCTCGCGTACGGGACTT,0,5281496
zapB_predicted,0.25,3,3,ACGCCCGGACAGTATCCAAA,0,5271946
zapB_predicted,0.25,3,3,ACGAACCCGTTATAGCGCGT,0,5278791
zapB_predicted,0.25,3,3,ACCTGTTGCTAGGCGTGATG,0,5271361
zapB_predicted,0.25,3,3,ACCTCCGTGCGGAGAAGTGG,0,5280172
zapB_predicted,0.25,3,3,ACCGATCATCGATGCGCGAT,0,5276783
zapB_predicted,0.25,3,3,ACCGAGGTTTTCTACAAGTT,0,5287082
zapB_predicted,0.25,3,3,ACCCTAATTGGCTTCAGGCC,0,5282767
zapB_predicted,0.25,3,3,ACCCTAAGGGCCATGCCTGT,0,5279810
zapB_predicted,0.25,3,3,ACCCCAGCGGTGGGAATAGC,0,5269911
zapB_predicted,0.25,3,3,ACCCAGTCGCAGACGCCGTT,0,5284170
zapB_predicted,0.25,3,3,ACCATGATTACAATAGTGCA,0,5266422
zapB_predicted,0.25,3,3,ACCAGGACCCATCGCCAGCC,0,5279197
zapB_predicted,0.25,3,3,ACCAGCGGGGTAAAATGTAC,0,5264187
zapB_predicted,0.25,3,3,ACCACAACCTGGTATACCTT,0,5265657
zapB_predicted,0.25,3,3,ACCAATGGGCATCTATACCA,0,5270319
zapB_predicted,0.25,3,3,ACCAATGCGCTAGATGACGT,0,5286713
zapB_predicted,0.25,3,3,ACCAAACGCAGTTAATTTAC,0,5268281
zapB_predicted,0.25,3,3,ACATGCTAATGGGGGTCACA,0,5277538
zapB_predicted,0.25,3,3,ACATCTGTGCTGACAGGCCG,0,5269228
zapB_predicted,0.25,3,3,ACATCCGGTAGGATAGGTAC,0,5279858
zapB_predicted,0.25,3,3,ACAGTGGTCTCCGCTCGCTA,0,5285837
zapB_predicted,0.25,3,3,ACAGGTATTCTTCGGTAGTA,0,5267208
zapB_predicted,0.25,3,3,ACAGGGGCGGTTCCCACTAA,0,5273964
zapB_predicted,0.25,3,3,ACAGCTAGCGCTCTAATCAA,0,5277756
zapB_predicted,0.25,3,3,ACAGCGCAGAACGGGGTTGA,0,5287721
zapB_predicted,0.25,3,3,ACAGACTGCTAGTGGGCACA,0,5284382
zapB_predicted,0.25,3,3,ACAGACAGGACATTGCAAAT,0,5275920
zapB_predicted,0.25,3,3,ACACCTCTAGACATCTGTCG,0,5265282
zapB_predicted,0.25,3,3,ACACCTATCCAGCCAAAAAC,0,5279283
zapB_predicted,0.25,3,3,ACACCCGTTCGTCGGACATG,0,5268819
zapB_predicted,0.25,3,3,ACAATCGAATTTGAGGATGA,0,5269879
zapB_predicted,0.25,3,3,ACAATAGGTACGCAAACCGG,0,5283761
zapB_predicted,0.25,3,3,AATTGTTGATTAATTCGTAT,0,5275576
zapB_predicted,0.25,3,3,AATGCGTATGTTCTTCTACA,0,5283399
zapB_predicted,0.25,3,3,AATGCCTCACAAGGTTGTAC,0,5266424
zapB_predicted,0.25,3,3,AATCTTCCCAAGTGTAAAGG,0,5271215
zapB_predicted,0.25,3,3,AATCCCTGTCTTCCCTTTTG,0,5285468
zapB_predicted,0.25,3,3,AATCATTCTATGCCGGTGCG,0,5273988
zapB_predicted,0.25,3,3,AATATTATGCAATCAGGTTA,0,5266407
zapB_predicted,0.25,3,3,AATAGTGACAGGCTTGGACG,0,5272574
zapB_predicted,0.25,3,3,AAGGGCTGAAATTGCCCCGA,0,5270213
zapB_predicted,0.25,3,3,AAGCGAAACAGTAAGCGAGC,0,5283987
zapB_predicted,0.25,3,3,AAGCATTGTGTCCTTACGGG,0,5275019
zapB_predicted,0.25,3,3,AAGCAACTTGACTGCATGGG,0,5263781
zapB_predicted,0.25,3,3,AAGAGTCCTCCTATAGCCTG,0,5286212
zapB_predicted,0.25,3,3,AAGAGTACACAGCACGAAGA,0,5277126
zapB_predicted,0.25,3,3,AAGAAACATCGTTGACGCAA,0,5266437
zapB_predicted,0.25,3,3,AACTTAACGGTAAGTATCGA,0,5283715
zapB_predicted,0.25,3,3,AACGGCGGTCGCACTCAGCA,0,5285083
zapB_predicted,0.25,3,3,AACGAGTGGGGTATCATCAA,0,5281478
zapB_predicted,0.25,3,3,AACCTGAACCGTTGAATCAG,0,5283680
zapB_predicted,0.25,3,3,AACCCATAGAGTTTACCTTC,0,5268007
zapB_predicted,0.25,3,3,AACAGGCACCTTCAGCCTAT,0,5284646
zapB_predicted,0.25,3,3,AACAGGAGCACAGAGGATAA,0,5276122
zapB_predicted,0.25,3,3,AACACTCGAATTACGCCGGC,0,5265428
zapB_predicted,0.25,3,3,AACAAGTCTATGCCCGAGAC,0,5268529
zapB_predicted,0.25,3,3,AAATGGTATAGTGGCCAAAA,0,5263747
zapB_predicted,0.25,3,3,AAATCGTGCCGGTATGAGGA,0,5285095
zapB_predicted,0.25,3,3,AAATCGCGTAGCATTAATAT,0,5283606
zapB_predicted,0.25,3,3,AAATATGGAGCTGGTTAGAG,0,5271366
zapB_predicted,0.25,3,3,AAAGAGAGTTAACCCACTTC,0,5275686
zapB_predicted,0.25,3,3,AAACTATTTGACTCGGAGCC,0,5269199
zapB_predicted,0.25,3,3,AAACTATGCGGTAGTGTAAT,0,5275077
zapB_predicted,0.25,3,3,AAAAACATAATTTGACTGAA,0,5269075
zapB_predicted,0.3333333333333333,2,2,TTTGGTTTAGGAGGCGGGCA,0,5267400
zapB_predicted,0.3333333333333333,2,2,TTTGGACTTCTACTAACAAA,0,5278299
zapB_predicted,0.3333333333333333,2,2,TTTGATCCTGATCGAAGCGA,0,5269185
zapB_predicted,0.3333333333333333,2,2,TTTGAATTCGGGGACGTTCT,0,5265194
zapB_predicted,0.3333333333333333,2,2,TTTCTCGTTGTTACAAGTTC,0,5287126
zapB_predicted,0.3333333333333333,2,2,TTTCGCAGTTCAAATAAGTG,0,5272649
zapB_predicted,0.3333333333333333,2,2,TTTCCGTACTATGCCACTTA,0,5275121
zapB_predicted,0.3333333333333333,2,2,TTTCCAGTCCTGGTAGGCCC,0,5270629
zapB_predicted,0.3333333333333333,2,2,TTTACGGTAGGTAACCTCAT,0,5263279
zapB_predicted,0.3333333333333333,2,2,TTTAAATCGGGGTAAGCAGA,0,5276223
zapB_predicted,0.3333333333333333,2,2,TTGTGACGCTCAGTCAAAAA,0,5276006
zapB_predicted,0.3333333333333333,2,2,TTGGTCCGGTCATTGTACAT,0,5263318
zapB_predicted,0.3333333333333333,2,2,TTGGGCAGGATAGATATTTT,0,5272668
zapB_predicted,0.3333333333333333,2,2,TTGATCGAATAACCTGACTG,0,5267816
zapB_predicted,0.3333333333333333,2,2,TTGAGCTTGGCATGTAGAGC,0,5285006
zapB_predicted,0.3333333333333333,2,2,TTGAGAACAGTAATGGAGCA,0,5267984
zapB_predicted,0.3333333333333333,2,2,TTGAAGCTCCCGCCCGGGAC,0,5270501
zapB_predicted,0.3333333333333333,2,2,TTGAACTAAGGCTATCCTAT,0,5281099
zapB_predicted,0.3333333333333333,2,2,TTCTGGCATCCATTTCCGGA,0,5285653
zapB_predicted,0.3333333333333333,2,2,TTCTGCCTGTGGCGGCTGAA,0,5279943
zapB_predicted,0.3333333333333333,2,2,TTCTGCAGCTATTTCGTGGG,0,5266374
zapB_predicted,0.3333333333333333,2,2,TTCTCCATCCACAGCCTGGA,0,5270414
zapB_predicted,0.3333333333333333,2,2,TTCGTTCTGCTCCTGTCCTA,0,5273991
zapB_predicted,0.3333333333333333,2,2,TTCGTGGACTCTGAAGACGT,0,5282319
zapB_predicted,0.3333333333333333,2,2,TTCCTCTTATACCACACTCA,0,5287285
zapB_predicted,0.3333333333333333,2,2,TTCCTAATAGTCCAACATCC,0,5272274
zapB_predicted,0.3333333333333333,2,2,TTCCGGTCGATATTTACTTA,0,5265053
zapB_predicted,0.3333333333333333,2,2,TTCCGGATCTTGCCAGTCTG,0,5264920
zapB_predicted,0.3333333333333333,2,2,TTCCCGGGGTGCTCCAGCTG,0,5271320
zapB_predicted,0.3333333333333333,2,2,TTCCCCATGTAGTATTGGTT,0,5266298
zapB_predicted,0.3333333333333333,2,2,TTCCCAAGCCTCCAGGATTA,0,5282360
zapB_predicted,0.3333333333333333,2,2,TTCATGTCCCGGAGAGCACA,0,5275562
zapB_predicted,0.3333333333333333,2,2,TTCATATGGTATTTAGGGAA,0,5270615
zapB_predicted,0.3333333333333333,2,2,TTCATAACAGACAATGCGAA,0,5277824
zapB_predicted,0.3333333333333333,2,2,TTCAGTTCAGAGACTCCATT,0,5277212
zapB_predicted,0.3333333333333333,2,2,TTCACCTACCTTTTGTCTAA,0,5284463
zapB_predicted,0.3333333333333333,2,2,TTATCGGTCTGGTGGCTGTG,0,5267892
zapB_predicted,0.3333333333333333,2,2,TTATATGCAGCGTTCATTTT,0,5276375
zapB_predicted,0.3333333333333333,2,2,TTAGTGAACTTTCCGCCACT,0,5271097
zapB_predicted,0.3333333333333333,2,2,TTAGACTTATGTCAACATTA,0,5277443
zapB_predicted,0.3333333333333333,2,2,TTACTCAGTTAGGTTAGGCC,0,5282561
zapB_predicted,0.3333333333333333,2,2,TTACGTTGTCCGTTGGAAAT,0,5271154
zapB_predicted,0.3333333333333333,2,2,TTACGGATACCCCCTAGAGT,0,5279756
zapB_predicted,0.3333333333333333,2,2,TTACACACAAGCTGGTGGCT,0,5275574
zapB_predicted,0.3333333333333333,2,2,TTAATCACTCCACCTTGACA,0,5280607
zapB_predicted,0.3333333333333333,2,2,TTAATATGGTAGACGCTGAA,0,5267774
zapB_predicted,0.3333333333333333,2,2,TTAAGACGGCTTCTATGGAA,0,5270340
zapB_predicted,0.3333333333333333,2,2,TTAACTCCATACCCATGATT,0,5272533
zapB_predicted,0.3333333333333333,2,2,TTAACATGGTGATGGGGCTA,0,5271847
zapB_predicted,0.3333333333333333,2,2,TTAAATGTGCGATCACGGAG,0,5276177
zapB_predicted,0.3333333333333333,2,2,TGTTGGAGCATGGGCCAAAT,0,5275493
zapB_predicted,0.3333333333333333,2,2,TGTTGCGGCTAGCGACACTC,0,5283027
zapB_predicted,0.3333333333333333,2,2,TGTTATGTTTTACAGTGATT,0,5280833
zapB_predicted,0.3333333333333333,2,2,TGTGTGGAGGTGTCATTTCA,0,5269261
zapB_predicted,0.3333333333333333,2,2,TGTGAACTCGTACCGCCATT,0,5276631
zapB_predicted,0.3333333333333333,2,2,TGTCTAAGTGGCTATTTGAC,0,5267368
zapB_predicted,0.3333333333333333,2,2,TGTATGTTATCGATTATGTG,0,5279450
zapB_predicted,0.3333333333333333,2,2,TGTAGGGGGACGCAAGTGCT,0,5284808
zapB_predicted,0.3333333333333333,2,2,TGTAATGTAAGGGCAAGTAC,0,5277826
zapB_predicted,0.3333333333333333,2,2,TGTAAAGTTTACAGGATGTT,0,5278193
zapB_predicted,0.3333333333333333,2,2,TGGTCATGATATAACGGGCA,0,5267154
zapB_predicted,0.3333333333333333,2,2,TGGTATGAAATGGTGGGTTA,0,5286305
zapB_predicted,0.3333333333333333,2,2,TGGGGGTCTATATGGGGAAA,0,5274235
zapB_predicted,0.3333333333333333,2,2,TGGGCTTGAAAACCGTTTCG,0,5265437
zapB_predicted,0.3333333333333333,2,2,TGGGCTCATGTAAGCTCCGC,0,5285755
zapB_predicted,0.3333333333333333,2,2,TGGGCCAGGCACGGGTTTCC,0,5265477
zapB_predicted,0.3333333333333333,2,2,TGGGATGGGCATCCGCTCTT,0,5266918
zapB_predicted,0.3333333333333333,2,2,TGGGAAGGGACATGGCTTAC,0,5269819
zapB_predicted,0.3333333333333333,2,2,TGGCCTGATGGGGGTGTATT,0,5267360
zapB_predicted,0.3333333333333333,2,2,TGGCCAACCATTTCGCCACA,0,5263008
zapB_predicted,0.3333333333333333,2,2,TGGATCTCGCATCTACACCC,0,5285160
zapB_predicted,0.3333333333333333,2,2,TGGAGTTAATCGGGTACACC,0,5281031
zapB_predicted,0.3333333333333333,2,2,TGGAGTGCTTCAAAGCTCGG,0,5286165
zapB_predicted,0.3333333333333333,2,2,TGGAGTACCGAGGTCATCCC,0,5272741
zapB_predicted,0.3333333333333333,2,2,TGGAGCGTATTAAGAGCCGA,0,5284298
zapB_predicted,0.3333333333333333,2,2,TGGAGCGTAAATGCCGACGA,0,5281750
zapB_predicted,0.3333333333333333,2,2,TGCCTAGGAGGCTGGATTCG,0,5272318
zapB_predicted,0.3333333333333333,2,2,TGCAGGGGAACCGCTTTTGG,0,5286606
zapB_predicted,0.3333333333333333,2,2,TGCAGAAAACACAAGACTAT,0,5268851
zapB_predicted,0.3333333333333333,2,2,TGATGCTCGGAACGTCTGAC,0,5276025
zapB_predicted,0.3333333333333333,2,2,TGATGCCCAACGCACTTGTC,0,5277148
zapB_predicted,0.3333333333333333,2,2,TGATCGCGGGTCTGAGTGAT,0,5279617
zapB_predicted,0.3333333333333333,2,2,TGATAATTTAGAGTTTTCTA,0,5276173
zapB_predicted,0.3333333333333333,2,2,TGAGTGTGGACAGTTAGTCA,0,5263123
zapB_predicted,0.3333333333333333,2,2,TGAGGTTCATGATCCAGGTA,0,5276214
zapB_predicted,0.3333333333333333,2,2,TGAGGCGCTCTAGTAAGAAT,0,5271708
zapB_predicted,0.3333333333333333,2,2,TGAGACTGCAACATAAAGGA,0,5271443
zapB_predicted,0.3333333333333333,2,2,TGACCTCCTAGTATCGAGCT,0,5277714
zapB_predicted,0.3333333333333333,2,2,TGACCCCCGGAGAGTAAACT,0,5268756
zapB_predicted,0.3333333333333333,2,2,TGAAGTCAGCATTTAGAATT,0,5279439
zapB_predicted,0.3333333333333333,2,2,TGAAAGAGTCACAGTACGGC,0,5273227
zapB_predicted,0.3333333333333333,2,2,TGAAAACGAAGACCGAGATA,0,5273195
zapB_predicted,0.3333333333333333,2,2,TCTTTTGGAAAGGGTTGAGG,0,5278507
zapB_predicted,0.3333333333333333,2,2,TCTTGGGCATGACCCTAAAT,0,5272674
zapB_predicted,0.3333333333333333,2,2,TCTTCCATGTCCCGTACTAG,0,5272915
zapB_predicted,0.3333333333333333,2,2,TCTGGGTTTAGCCCTCGACC,0,5282699
zapB_predicted,0.3333333333333333,2,2,TCTGGACTAACTGGTAAGGT,0,5285947
zapB_predicted,0.3333333333333333,2,2,TCTGCCAAGTGACTGTTTTT,0,5282155
zapB_predicted,0.3333333333333333,2,2,TCTCGCAAAACCCCATCGGG,0,5277718
zapB_predicted,0.3333333333333333,2,2,TCTCATGGTCCCAAACCTTA,0,5279329
zapB_predicted,0.3333333333333333,2,2,TCTAAACATGGCTAGTAGAT,0,5278322
zapB_predicted,0.3333333333333333,2,2,TCGTTAGTGGCCGGACGCAA,0,5284781
zapB_predicted,0.3333333333333333,2,2,TCGTGTTAGGGCGTCGTAAA,0,5264071
zapB_predicted,0.3333333333333333,2,2,TCGTGGGCTAACCTGCAAGA,0,5283221
zapB_predicted,0.3333333333333333,2,2,TCGTAATTTTGACCTAATTC,0,5287958
zapB_predicted,0.3333333333333333,2,2,TCGGGTACGCATGCGCCCGT,0,5274183
zapB_predicted,0.3333333333333333,2,2,TCGGGATACGACTGCAAAGT,0,5273728
zapB_predicted,0.3333333333333333,2,2,TCGCTTCGCGCTGCACCGGG,0,5268003
zapB_predicted,0.3333333333333333,2,2,TCGCGTCGTCGCTCGTGCGG,0,5267837
zapB_predicted,0.3333333333333333,2,2,TCGCGCAAACGAATGAACCG,0,5278933
zapB_predicted,0.3333333333333333,2,2,TCGCAGGATGGACTGGATTT,0,5270869
zapB_predicted,0.3333333333333333,2,2,TCGATTCCGTCGTGCGCCAT,0,5282114
zapB_predicted,0.3333333333333333,2,2,TCGATCAGGAAGACGGCACA,0,5274507
zapB_predicted,0.3333333333333333,2,2,TCGAAAGGCAGCCCTTTATT,0,5269051
zapB_predicted,0.3333333333333333,2,2,TCCTGTAGGACACGGCTAAG,0,5267445
zapB_predicted,0.3333333333333333,2,2,TCCTGCACAGGTAAGCACAG,0,5270918
zapB_predicted,0.3333333333333333,2,2,TCCTCAAGATTTAGACAGCC,0,5287782
zapB_predicted,0.3333333333333333,2,2,TCCGGCGCCGGGCTATTGGA,0,5267188
zapB_predicted,0.3333333333333333,2,2,TCCGGATTGCTTACCATTCG,0,5269464
zapB_predicted,0.3333333333333333,2,2,TCCGAGTTACTGCTGGTAAT,0,5287845
zapB_predicted,0.3333333333333333,2,2,TCCCTCCCTCATGAGGGCGC,0,5274132
zapB_predicted,0.3333333333333333,2,2,TCCCTCCAGCATTTTCCATT,0,5283015
zapB_predicted,0.3333333333333333,2,2,TCCCGCCAGAACCTGTTGAG,0,5275370
zapB_predicted,0.3333333333333333,2,2,TCCCAAGCCTAAGCTATTGT,0,5278087
zapB_predicted,0.3333333333333333,2,2,TCCACTCTCCTGCGAGAAGG,0,5282065
zapB_predicted,0.3333333333333333,2,2,TCATTTCGATTTCCGATGTC,0,5279540
zapB_predicted,0.3333333333333333,2,2,TCATTCTGGGAAGACCTATG,0,5263090
zapB_predicted,0.3333333333333333,2,2,TCATTCATGGTTCCGGGGCT,0,5279251
zapB_predicted,0.3333333333333333,2,2,TCATTAGATACATGCTTGGC,0,5275008
zapB_predicted,0.3333333333333333,2,2,TCATGTGTCCTGTCATTCAA,0,5264221
zapB_predicted,0.3333333333333333,2,2,TCATGGGTGCTACCGAAGAA,0,5273610
zapB_predicted,0.3333333333333333,2,2,TCATGCGGTCTATGATCATT,0,5276740
zapB_predicted,0.3333333333333333,2,2,TCAGTTACAGACATCCGTCG,0,5266649
zapB_predicted,0.3333333333333333,2,2,TCAGTCACTGGCAATCAATC,0,5279110
zapB_predicted,0.3333333333333333,2,2,TCAGGTACGACTGATTTAGT,0,5280525
zapB_predicted,0.3333333333333333,2,2,TCAGGCCGAGAGTCTCGTGG,0,5274772
zapB_predicted,0.3333333333333333,2,2,TCAGAGTGTCCGGCAATTTT,0,5280562
zapB_predicted,0.3333333333333333,2,2,TCAGAGCCCTATAGGCTGAA,0,5263243
zapB_predicted,0.3333333333333333,2,2,TCACTTGCGTAGATCTAAAG,0,5265011
zapB_predicted,0.3333333333333333,2,2,TCACGGGGTTAAGTATTCAT,0,5264869
zapB_predicted,0.3333333333333333,2,2,TCACAAAAGGGGTAATTATA,0,5287935
zapB_predicted,0.3333333333333333,2,2,TCAATTACATAAAAAAAAAA,0,5268662
zapB_predicted,0.3333333333333333,2,2,TCAATAGGCATACGTCGCGC,0,5279002
zapB_predicted,0.3333333333333333,2,2,TCAAGTGCGGCATGCCCCTA,0,5279716
zapB_predicted,0.3333333333333333,2,2,TCAAAGTCTATCCTGTCGGA,0,5275648
zapB_predicted,0.3333333333333333,2,2,TCAAAAGTATCAAGGAACCC,0,5287938
zapB_predicted,0.3333333333333333,2,2,TATTTGCGAGCACGCGCCCC,0,5271835
zapB_predicted,0.3333333333333333,2,2,TATTTGAGTAGCGATCTTTG,0,5268305
zapB_predicted,0.3333333333333333,2,2,TATTCTGTGGGCATCACCAG,0,5280857
zapB_predicted,0.3333333333333333,2,2,TATTCGCCTCCCAGAGAGAA,0,5273812
zapB_predicted,0.3333333333333333,2,2,TATTCCTTAGGATTATGCAA,0,5282420
zapB_predicted,0.3333333333333333,2,2,TATTCCAGGATATCACCCTA,0,5270884
zapB_predicted,0.3333333333333333,2,2,TATTAGGATGTCAACATAAA,0,5263164
zapB_predicted,0.3333333333333333,2,2,TATCTCCTGAACAGAGTGTG,0,5265052
zapB_predicted,0.3333333333333333,2,2,TATCGGCCTGCCCTTGTGGG,0,5274644
zapB_predicted,0.3333333333333333,2,2,TATAGTTCACCTCAAGATAG,0,5269845
zapB_predicted,0.3333333333333333,2,2,TATAGTGAAACTCCTCCCGT,0,5282521
zapB_predicted,0.3333333333333333,2,2,TATAGCCACTGCTAATGTCG,0,5265870
zapB_predicted,0.3333333333333333,2,2,TATACGGGGCGCACGGTCAT,0,5264184
zapB_predicted,0.3333333333333333,2,2,TAGGTTAGAGCGCAACATCT,0,5284415
zapB_predicted,0.3333333333333333,2,2,TAGGCAGAGCCCCGTGCCTC,0,5285728
zapB_predicted,0.3333333333333333,2,2,TAGCTCGTTCAAGCAAGTCT,0,5267012
zapB_predicted,0.3333333333333333,2,2,TAGCGGTCCCAGTTAACTAT,0,5273779
zapB_predicted,0.3333333333333333,2,2,TAGCCGCGCCTAACTGGACA,0,5277940
zapB_predicted,0.3333333333333333,2,2,TAGATAGACGCACATTGATA,0,5279452
zapB_predicted,0.3333333333333333,2,2,TACTTGCATTTAAATGCCAC,0,5287554
zapB_predicted,0.3333333333333333,2,2,TACTGAACGACATCATCAGT,0,5274283
zapB_predicted,0.3333333333333333,2,2,TACTCAAGCGAAGTTATCTG,0,5265363
zapB_predicted,0.3333333333333333,2,2,TACGGGAGGTGGTGGTAACT,0,5282761
zapB_predicted,0.3333333333333333,2,2,TACGAGGACTGGTTTCATCT,0,5272652
zapB_predicted,0.3333333333333333,2,2,TACGAGCACGTCTAGGAGGT,0,5263657
zapB_predicted,0.3333333333333333,2,2,TACCATAGGGACGGGTTACC,0,5265452
zapB_predicted,0.3333333333333333,2,2,TACAGGGAACTTACAACTCG,0,5281260
zapB_predicted,0.3333333333333333,2,2,TAATTACTCAAGACGAGACG,0,5276227
zapB_predicted,0.3333333333333333,2,2,TAATGCTGGAAGTACTAGCG,0,5275807
zapB_predicted,0.3333333333333333,2,2,TAATGCGGAAATTGGCACGA,0,5282497
zapB_predicted,0.3333333333333333,2,2,TAATATCAGCTGGAACAGAG,0,5280831
zapB_predicted,0.3333333333333333,2,2,TAAGGCCTAATGGTCACTTT,0,5273463
zapB_predicted,0.3333333333333333,2,2,TAAGCGACGCAGAGGGTCAG,0,5286081
zapB_predicted,0.3333333333333333,2,2,TAAGACTTACGCGTTCTAGT,0,5287084
zapB_predicted,0.3333333333333333,2,2,TAAGAAGTTACAACTGATCT,0,5273307
zapB_predicted,0.3333333333333333,2,2,TAACGAGACAGAGCCGGGAT,0,5275709
zapB_predicted,0.3333333333333333,2,2,TAACCTCATTAGCCGACTGC,0,5282325
zapB_predicted,0.3333333333333333,2,2,TAACCGAAGTTCAATGGCAT,0,5268153
zapB_predicted,0.3333333333333333,2,2,TAACCATCTAGTGCACTCAG,0,5267668
zapB_predicted,0.3333333333333333,2,2,TAACAGTGATGGAGTCAAAT,0,5268165
zapB_predicted,0.3333333333333333,2,2,TAAAGCGTTGTTGCGGACCC,0,5282640
zapB_predicted,0.3333333333333333,2,2,TAAACTTCGTTTGCAGGCTA,0,5266741
zapB_predicted,0.3333333333333333,2,2,TAAACTGTAGAGTCATAAGA,0,5287846
zapB_predicted,0.3333333333333333,2,2,GTTTTATCTCCGGTTGGACT,0,5279877
zapB_predicted,0.3333333333333333,2,2,GTTTCGTATCACTGCGCAGA,0,5267754
zapB_predicted,0.3333333333333333,2,2,GTTTATCAGCATGCCACTTA,0,5266434
zapB_predicted,0.3333333333333333,2,2,GTTGTCTCGAGTAAACCATT,0,5268646
zapB_predicted,0.3333333333333333,2,2,GTTGGCACGCATAGGGAACG,0,5282010
zapB_predicted,0.3333333333333333,2,2,GTTCTGATTTCACACTTCAG,0,5273893
zapB_predicted,0.3333333333333333,2,2,GTTCATCCCTTTTTAAGGGG,0,5280103
zapB_predicted,0.3333333333333333,2,2,GTTCAGTTTGGGCCTTTGGG,0,5275201
zapB_predicted,0.3333333333333333,2,2,GTTATTGTTCTAAAGTTATA,0,5283008
zapB_predicted,0.3333333333333333,2,2,GTGTGTTTCCAGCGTGCGTT,0,5267532
zapB_predicted,0.3333333333333333,2,2,GTGTGCCTCCGTGTACTGCG,0,5277805
zapB_predicted,0.3333333333333333,2,2,GTGGTCTGCGCTCACTTAGA,0,5284085
zapB_predicted,0.3333333333333333,2,2,GTGCTGGGCACCGGGGCATT,0,5281494
zapB_predicted,0.3333333333333333,2,2,GTGCCTGCTTTTAGGAGTAC,0,5274736
zapB_predicted,0.3333333333333333,2,2,GTGCCTCGTGCGAGATGTTT,0,5272639
zapB_predicted,0.3333333333333333,2,2,GTGCCGGAGCGGCATGTATG,0,5282968
zapB_predicted,0.3333333333333333,2,2,GTGCCCGAAGCCGTAGTAAT,0,5275582
zapB_predicted,0.3333333333333333,2,2,GTGCAGGTTTGGCAGCAGGA,0,5272442
zapB_predicted,0.3333333333333333,2,2,GTGAGAGGGGCAGCAGACGG,0,5287766
zapB_predicted,0.3333333333333333,2,2,GTGACTATAGCTCGCATCGA,0,5285233
zapB_predicted,0.3333333333333333,2,2,GTGACAGGTGAGCTCTGTAT,0,5269162
zapB_predicted,0.3333333333333333,2,2,GTGAAATGGACCGAGGGGCA,0,5279367
zapB_predicted,0.3333333333333333,2,2,GTGAAAGACAAAAAAATTGA,0,5286981
zapB_predicted,0.3333333333333333,2,2,GTCTTGCAGTTGATACGGGA,0,5265484
zapB_predicted,0.3333333333333333,2,2,GTCTGAGACGGTGGTGTGAT,0,5284101
zapB_predicted,0.3333333333333333,2,2,GTCTGAGAAAGGTCATTCAC,0,5270740
zapB_predicted,0.3333333333333333,2,2,GTCTCTGCCCTTTCGCCGCT,0,5280363
zapB_predicted,0.3333333333333333,2,2,GTCTCAAAATATGTAGATGT,0,5286363
zapB_predicted,0.3333333333333333,2,2,GTCTATTCGGTCCACTTGGG,0,5263268
zapB_predicted,0.3333333333333333,2,2,GTCTAACTACTCGGTAAAAT,0,5263436
zapB_predicted,0.3333333333333333,2,2,GTCGCTCCACAGAAGTTTAC,0,5271869
zapB_predicted,0.3333333333333333,2,2,GTCCGATCAGCCTATTTTGA,0,5269342
zapB_predicted,0.3333333333333333,2,2,GTCCAGATAGGGCACGAGCA,0,5275492
zapB_predicted,0.3333333333333333,2,2,GTCAGGTGCAGAACTTTCTA,0,5279829
zapB_predicted,0.3333333333333333,2,2,GTCAGGCCGTTCGGTGGACC,0,5267266
zapB_predicted,0.3333333333333333,2,2,GTATACACGGATAATACTTC,0,5287682
zapB_predicted,0.3333333333333333,2,2,GTATAAAAGTACCAGTATTG,0,5265291
zapB_predicted,0.3333333333333333,2,2,GTAGTCACGCAATGCGGTCA,0,5267529
zapB_predicted,0.3333333333333333,2,2,GTAGGAGACCTTCCTTTCGG,0,5283872
zapB_predicted,0.3333333333333333,2,2,GTAGGAAGTTTATCGGTTCG,0,5275739
zapB_predicted,0.3333333333333333,2,2,GTAGCGGCGTATTGACCAAA,0,5265585
zapB_predicted,0.3333333333333333,2,2,GTACTACCTGCTCCTCGGAC,0,5288078
zapB_predicted,0.3333333333333333,2,2,GTAATTCGCTTTGTCCTCGC,0,5270033
zapB_predicted,0.3333333333333333,2,2,GTAATCAGAAAAAATTGAGA,0,5284103
zapB_predicted,0.3333333333333333,2,2,GTAAGTGGAGAGTCGAAACT,0,5279263
zapB_predicted,0.3333333333333333,2,2,GTAAGGGGTAAGAGGGTTTA,0,5271123
zapB_predicted,0.3333333333333333,2,2,GTAACCAGATCCATTTTGCA,0,5264016
zapB_predicted,0.3333333333333333,2,2,GTAAAGCGGTATGTCTCCAT,0,5284921
zapB_predicted,0.3333333333333333,2,2,GTAAACATTGGGTTTTCGGC,0,5282788
zapB_predicted,0.3333333333333333,2,2,GGTTGGAGTGTGTTTCGCCC,0,5279985
zapB_predicted,0.3333333333333333,2,2,GGTTCGAGGCAACTTAAACA,0,5278173
zapB_predicted,0.3333333333333333,2,2,GGTTCCCTCCCCAAGAGTGT,0,5288212
zapB_predicted,0.3333333333333333,2,2,GGTGGCTAGCTCTTGCCTGG,0,5266365
zapB_predicted,0.3333333333333333,2,2,GGTGCTACGTAGTACGCAGC,0,5280100
zapB_predicted,0.3333333333333333,2,2,GGTGCGCGGCACTGCCGCCA,0,5279732
zapB_predicted,0.3333333333333333,2,2,GGTCGTCCTTGATGAGAAGT,0,5282701
zapB_predicted,0.3333333333333333,2,2,GGTCAAATACGAGTTCTGCA,0,5265718
zapB_predicted,0.3333333333333333,2,2,GGTACGGGCCGCCACTAGTC,0,5269919
zapB_predicted,0.3333333333333333,2,2,GGTAAGCACCCCATAGAGCA,0,5270693
zapB_predicted,0.3333333333333333,2,2,GGGTTATTTAGAATCTTTAA,0,5278806
zapB_predicted,0.3333333333333333,2,2,GGGTTATCTGGTTGACTGGT,0,5268623
zapB_predicted,0.3333333333333333,2,2,GGGTGGTATAATGCCGGAAA,0,5275184
zapB_predicted,0.3333333333333333,2,2,GGGTGGAACTGGAGCGCGCT,0,5281344
zapB_predicted,0.3333333333333333,2,2,GGGGGGTAAGCCTTTTGTTG,0,5276636
zapB_predicted,0.3333333333333333,2,2,GGGGGACTGAGCCAATTTAA,0,5279078
zapB_predicted,0.3333333333333333,2,2,GGGGACACGTACAGTGCTCA,0,5284291
zapB_predicted,0.3333333333333333,2,2,GGGCTAATTATTTATCCGTG,0,5283482
zapB_predicted,0.3333333333333333,2,2,GGGCGAACACGGGCGTAAAA,0,5286061
zapB_predicted,0.3333333333333333,2,2,GGGCCTTGGCGACTGTACAT,0,5278826
zapB_predicted,0.3333333333333333,2,2,GGGCCAGTCTATTGGGAGAG,0,5263151
zapB_predicted,0.3333333333333333,2,2,GGGCCAAAGGCCGGTGACTG,0,5278065
zapB_predicted,0.3333333333333333,2,2,GGGATGTCGGCGTGACCGGG,0,5267472
zapB_predicted,0.3333333333333333,2,2,GGGACTGAGGCTGAGTGGTC,0,5263897
zapB_predicted,0.3333333333333333,2,2,GGGACCGCGCTTGGGTAAGC,0,5271290
zapB_predicted,0.3333333333333333,2,2,GGGACCGCGCAGTCAGCTAC,0,5265571
zapB_predicted,0.3333333333333333,2,2,GGCTTTTTACCCAATTAATA,0,5288226
zapB_predicted,0.3333333333333333,2,2,GGCTGCGTGGCGCTAGGTAA,0,5280291
zapB_predicted,0.3333333333333333,2,2,GGCTCGGGTCCGGGCATCAG,0,5274719
zapB_predicted,0.3333333333333333,2,2,GGCTCCAGCATATGGCTCCT,0,5278482
zapB_predicted,0.3333333333333333,2,2,GGCGGTGAACCGTCTGTATT,0,5280932
zapB_predicted,0.3333333333333333,2,2,GGCCTTGTTGCGTTTGTGTT,0,5286576
zapB_predicted,0.3333333333333333,2,2,GGCCTATGACGCGACTGGGT,0,5276893
zapB_predicted,0.3333333333333333,2,2,GGCCGTTTAGGGGCAAGCCT,0,5281318
zapB_predicted,0.3333333333333333,2,2,GGCCGCGTTCATTTTTTGCA,0,5276399
zapB_predicted,0.3333333333333333,2,2,GGCCACTAGCGTCAGAGGTC,0,5274137
zapB_predicted,0.3333333333333333,2,2,GGCATATCTGTAAGCATTAG,0,5282025
zapB_predicted,0.3333333333333333,2,2,GGCAGGGGATAGAGGCAGGA,0,5268850
zapB_predicted,0.3333333333333333,2,2,GGCAGGCCTCCACTTGTGTT,0,5270335
zapB_predicted,0.3333333333333333,2,2,GGCAGCGTTACCGCTATCGG,0,5279147
zapB_predicted,0.3333333333333333,2,2,GGCAAGACATGGAGTTAGGG,0,5273108
zapB_predicted,0.3333333333333333,2,2,GGATTAGACAACTTTCGCGC,0,5282136
zapB_predicted,0.3333333333333333,2,2,GGATGCTCACCCCCTGGGTT,0,5267786
zapB_predicted,0.3333333333333333,2,2,GGATAAGTGACATAGATAAA,0,5286684
zapB_predicted,0.3333333333333333,2,2,GGAGTGGTCTATGACCCCCT,0,5284650
zapB_predicted,0.3333333333333333,2,2,GGAGTGGCGACTGTTCGGTC,0,5267983
zapB_predicted,0.3333333333333333,2,2,GGAGGTTTGTGGAAGCTATG,0,5266461
zapB_predicted,0.3333333333333333,2,2,GGAGGAAGAGTGCCACGATG,0,5264332
zapB_predicted,0.3333333333333333,2,2,GGAGGAACATGTAAGGGAAA,0,5265107
zapB_predicted,0.3333333333333333,2,2,GGAGACCCCTACTGGGGTGC,0,5267443
zapB_predicted,0.3333333333333333,2,2,GGACTGGCTTGCCTTGCACC,0,5266685
zapB_predicted,0.3333333333333333,2,2,GGACGCCGCGACCCTGCTAG,0,5266806
zapB_predicted,0.3333333333333333,2,2,GGACCATATCGGTAACGTGG,0,5287411
zapB_predicted,0.3333333333333333,2,2,GGACACGCAGGCCTCCGATG,0,5271974
zapB_predicted,0.3333333333333333,2,2,GGAAGACATTAACCGCCGAG,0,5286636
zapB_predicted,0.3333333333333333,2,2,GGAACTCACTAATCACATGC,0,5266165
zapB_predicted,0.3333333333333333,2,2,GGAACTAGCTAATAACGTGG,0,5269794
zapB_predicted,0.3333333333333333,2,2,GGAACCAAACCGGTCGTGAC,0,5272035
zapB_predicted,0.3333333333333333,2,2,GGAACAAGTAAGGCCGCTTT,0,5276392
zapB_predicted,0.3333333333333333,2,2,GCTTTGTTTCCAAGTTACCG,0,5275366
zapB_predicted,0.3333333333333333,2,2,GCTTCCGATGCCCAGTGCGT,0,5280711
zapB_predicted,0.3333333333333333,2,2,GCTGTGTTAAAGTAGTAAGT,0,5281570
zapB_predicted,0.3333333333333333,2,2,GCTGTACACGCTACTAAATT,0,5267442
zapB_predicted,0.3333333333333333,2,2,GCTCTGTTACGCGGCGCTGA,0,5263488
zapB_predicted,0.3333333333333333,2,2,GCTCGGCTAGAGGCTGGGCG,0,5269571
zapB_predicted,0.3333333333333333,2,2,GCTCCATGAGCCTTGACCCT,0,5265631
zapB_predicted,0.3333333333333333,2,2,GCTCATAGGACACAAGATTC,0,5275772
zapB_predicted,0.3333333333333333,2,2,GCTCATAAATACCAGTAGCC,0,5268512
zapB_predicted,0.3333333333333333,2,2,GCTCAGCCTAGATAGGGTTC,0,5287432
zapB_predicted,0.3333333333333333,2,2,GCTCAAATAAAGCGCTAGAA,0,5273478
zapB_predicted,0.3333333333333333,2,2,GCTCAAACTCACTCGGCGTC,0,5286253
zapB_predicted,0.3333333333333333,2,2,GCTATCTCCGCAAAAGGATT,0,5270036
zapB_predicted,0.3333333333333333,2,2,GCTACGTCTCCAGTGCATCA,0,5270266
zapB_predicted,0.3333333333333333,2,2,GCGTACTCACTCGCGTTGGG,0,5271050
zapB_predicted,0.3333333333333333,2,2,GCGTACGGGGTAAATCAAAG,0,5277096
zapB_predicted,0.3333333333333333,2,2,GCGGCCTGACGATTTGATCC,0,5273473
zapB_predicted,0.3333333333333333,2,2,GCGGCAGGGACCCCACAGAG,0,5273137
zapB_predicted,0.3333333333333333,2,2,GCGGCAGCGCGTGGACTAAT,0,5282030
zapB_predicted,0.3333333333333333,2,2,GCGCCCTATAGGATCCTGCC,0,5282026
zapB_predicted,0.3333333333333333,2,2,GCGCCCAGGTCCGGCTTGCC,0,5276695
zapB_predicted,0.3333333333333333,2,2,GCGCCACTGGTTCTCTGGTT,0,5287651
zapB_predicted,0.3333333333333333,2,2,GCGCATACTAAAGGCTTCAG,0,5263478
zapB_predicted,0.3333333333333333,2,2,GCGAGTCATAGCCGCGAGAC,0,5270802
zapB_predicted,0.3333333333333333,2,2,GCGACGTGTTAATTTGGGTG,0,5278842
zapB_predicted,0.3333333333333333,2,2,GCGACCAGCAGTAAGCCACA,0,5267894
zapB_predicted,0.3333333333333333,2,2,GCCTTGTATCGGGGAGTGGA,0,5287251
zapB_predicted,0.3333333333333333,2,2,GCCTCGTGCAGACCTACGTC,0,5278503
zapB_predicted,0.3333333333333333,2,2,GCCTCGATAGCTGCGTAAAG,0,5270864
zapB_predicted,0.3333333333333333,2,2,GCCGGGGTGCTTTGAGTTTC,0,5284632
zapB_predicted,0.3333333333333333,2,2,GCCGCTGGTATCAAAGCATT,0,5263668
zapB_predicted,0.3333333333333333,2,2,GCCCGCGTGCCGGTAAGTTG,0,5273350
zapB_predicted,0.3333333333333333,2,2,GCCCGCCATTGCACTAACGT,0,5273627
zapB_predicted,0.3333333333333333,2,2,GCCCCGCGATGCCCGGCTCA,0,5266522
zapB_predicted,0.3333333333333333,2,2,GCCCCAGCACCCCTGCTGAA,0,5269641
zapB_predicted,0.3333333333333333,2,2,GCCCAATTCCGGTGAACGGC,0,5264461
zapB_predicted,0.3333333333333333,2,2,GCCATCTGAAACTGAACGCG,0,5277822
zapB_predicted,0.3333333333333333,2,2,GCCAGGTATTGAAGGCGACT,0,5274035
zapB_predicted,0.3333333333333333,2,2,GCCAGCCAGGGGGAACTTTG,0,5280410
zapB_predicted,0.3333333333333333,2,2,GCCACGTCTTTTGCCGATCG,0,5274302
zapB_predicted,0.3333333333333333,2,2,GCACTTCAGTGTCACAGAAG,0,5265351
zapB_predicted,0.3333333333333333,2,2,GCACTCTGCTCGTTGATATA,0,5267041
zapB_predicted,0.3333333333333333,2,2,GCACGTTAGGGGGTCAAGAC,0,5275967
zapB_predicted,0.3333333333333333,2,2,GCAAAGATGCGAAAGTGACC,0,5284153
zapB_predicted,0.3333333333333333,2,2,GCAAAAAGGATTGTTATGTG,0,5267662
zapB_predicted,0.3333333333333333,2,2,GATTTTAAAGCGGCGACTTA,0,5282204
zapB_predicted,0.3333333333333333,2,2,GATTGAAGTGTAGAGCGAAC,0,5269081
zapB_predicted,0.3333333333333333,2,2,GATGGTATCGCGATCCTTGT,0,5275439
zapB_predicted,0.3333333333333333,2,2,GATGAAGACGTCAGGGGACC,0,5267947
zapB_predicted,0.3333333333333333,2,2,GATCGTGAGCTCTCCTGGGC,0,5266203
zapB_predicted,0.3333333333333333,2,2,GATCGCCTGACCGGTTAGTT,0,5267501
zapB_predicted,0.3333333333333333,2,2,GATATCGCTGGTGTCGATCC,0,5284914
zapB_predicted,0.3333333333333333,2,2,GATAGGACGTTTTAACTGTA,0,5286296
zapB_predicted,0.3333333333333333,2,2,GATACAACTTGGAAGGCCGA,0,5283536
zapB_predicted,0.3333333333333333,2,2,GATAACGTTCCAGGTTGCTC,0,5276719
zapB_predicted,0.3333333333333333,2,2,GAGTGCCGGATACATTCGTG,0,5278097
zapB_predicted,0.3333333333333333,2,2,GAGTCCCTACATCTGCAATG,0,5275345
zapB_predicted,0.3333333333333333,2,2,GAGTAGCGAGACTGTACAAT,0,5284072
zapB_predicted,0.3333333333333333,2,2,GAGGTAGAGAGACATCTCAG,0,5278564
zapB_predicted,0.3333333333333333,2,2,GAGGTAGAATTGTGTCTGGC,0,5274508
zapB_predicted,0.3333333333333333,2,2,GAGGGATGTAAACATCCAAG,0,5279526
zapB_predicted,0.3333333333333333,2,2,GAGGAAAGCGTTTTATCTCG,0,5265109
zapB_predicted,0.3333333333333333,2,2,GAGCGTAATTGGAACAACAA,0,5263674
zapB_predicted,0.3333333333333333,2,2,GAGCCGGGGATCCAAACATT,0,5269693
zapB_predicted,0.3333333333333333,2,2,GAGCACGGGCGAAGCTTGGT,0,5264712
zapB_predicted,0.3333333333333333,2,2,GAGACCCTAATGCTGTTCCT,0,5277848
zapB_predicted,0.3333333333333333,2,2,GAGAATGCCGTTATTGTTGG,0,5287752
zapB_predicted,0.3333333333333333,2,2,GAGAACCGCCCCCAAAGCCT,0,5277811
zapB_predicted,0.3333333333333333,2,2,GACTGTAAGACAACGGAAGG,0,5276603
zapB_predicted,0.3333333333333333,2,2,GACTCTAAGCTTTCGCTTAC,0,5277535
zapB_predicted,0.3333333333333333,2,2,GACTCGAGTCGTGTAGACAA,0,5283590
zapB_predicted,0.3333333333333333,2,2,GACTCAACAGGCTCGGTGAT,0,5276737
zapB_predicted,0.3333333333333333,2,2,GACTACGTAGAGATCCCGCT,0,5274608
zapB_predicted,0.3333333333333333,2,2,GACGGTACGGTGTCTAAGCA,0,5278857
zapB_predicted,0.3333333333333333,2,2,GACGCGTGGTTATCGCTATT,0,5278256
zapB_predicted,0.3333333333333333,2,2,GACGCATAAGCTCTCGGCCA,0,5287552
zapB_predicted,0.3333333333333333,2,2,GACCATGATTTACGATTTTG,0,5270339
zapB_predicted,0.3333333333333333,2,2,GACATTACTCAATGAGGTTA,0,5286311
zapB_predicted,0.3333333333333333,2,2,GACATCAGCTGGTACGGGTT,0,5272562
zapB_predicted,0.3333333333333333,2,2,GACACGAGTACTGAGTGGTC,0,5265869
zapB_predicted,0.3333333333333333,2,2,GACACCGAACACATCCTGTG,0,5286041
zapB_predicted,0.3333333333333333,2,2,GACAAGCGTATAAGTTGGCC,0,5274141
zapB_predicted,0.3333333333333333,2,2,GACAACTGTATTACGGATGA,0,5283839
zapB_predicted,0.3333333333333333,2,2,GAATGTATTAATCCAGAACG,0,5280216
zapB_predicted,0.3333333333333333,2,2,GAATGAGCGGCCGTATCAAG,0,5283974
zapB_predicted,0.3333333333333333,2,2,GAATCTAATGTAGATCTACA,0,5268938
zapB_predicted,0.3333333333333333,2,2,GAATACTAACTCGGGACCGA,0,5268271
zapB_predicted,0.3333333333333333,2,2,GAAGCTTGAACTGGCTACAA,0,5281738
zapB_predicted,0.3333333333333333,2,2,GAAGAGTTACAACGCCTCAA,0,5275028
zapB_predicted,0.3333333333333333,2,2,GAACTTTACGAGCGATGGTC,0,5279517
zapB_predicted,0.3333333333333333,2,2,GAACTTCTCACTCCTTCCAG,0,5266330
zapB_predicted,0.3333333333333333,2,2,GAACGGACTCAGTCCTGGCG,0,5264492
zapB_predicted,0.3333333333333333,2,2,GAACCCAGGGTACGATACAA,0,5288064
zapB_predicted,0.3333333333333333,2,2,GAACAGCCGTTGATTGCATT,0,5263536
zapB_predicted,0.3333333333333333,2,2,GAACAGATAGGAACCCTCAG,0,5277525
zapB_predicted,0.3333333333333333,2,2,GAAATGTGACATAGAAGCGA,0,5271701
zapB_predicted,0.3333333333333333,2,2,CTTTTTAGTCTTCAGTATGT,0,5269222
zapB_predicted,0.3333333333333333,2,2,CTTTTGCCCGTCTCGGGTTA,0,5272305
zapB_predicted,0.3333333333333333,2,2,CTTTTACATCTGTAGCACAA,0,5272145
zapB_predicted,0.3333333333333333,2,2,CTTTGAGCTACCCATGAGCC,0,5263738
zapB_predicted,0.3333333333333333,2,2,CTTGTTCCAGTCAAATGAAA,0,5275498
zapB_predicted,0.3333333333333333,2,2,CTTGTGCATCACAGGTCTTG,0,5284544
zapB_predicted,0.3333333333333333,2,2,CTTGGTATACGGCGCGTCAT,0,5265761
zapB_predicted,0.3333333333333333,2,2,CTTCGTTCCCTGGAAGAATA,0,5286346
zapB_predicted,0.3333333333333333,2,2,CTTCGGCAATTAGGAGAAGA,0,5281938
zapB_predicted,0.3333333333333333,2,2,CTTCACATACATAGACTACC,0,5265570
zapB_predicted,0.3333333333333333,2,2,CTTATTAGATCCGTTAAGGA,0,5280935
zapB_predicted,0.3333333333333333,2,2,CTTAGTCTGTGCAGGGGTGA,0,5285911
zapB_predicted,0.3333333333333333,2,2,CTTAAACCTCGTTTGTAAGG,0,5267773
zapB_predicted,0.3333333333333333,2,2,CTGTGTAATCAGCACGGAGG,0,5285929
zapB_predicted,0.3333333333333333,2,2,CTGGTGGCCATCGTTTGGAC,0,5271386
zapB_predicted,0.3333333333333333,2,2,CTGGCCGGAGGCTGGACCCC,0,5275172
zapB_predicted,0.3333333333333333,2,2,CTGGCCCTAACACTGCAACT,0,5286972
zapB_predicted,0.3333333333333333,2,2,CTGGCATTGAAGGGATATTG,0,5288217
zapB_predicted,0.3333333333333333,2,2,CTGGAAGCACACCTGCCAGT,0,5284745
zapB_predicted,0.3333333333333333,2,2,CTGCACTTCAATAGCATTTG,0,5271365
zapB_predicted,0.3333333333333333,2,2,CTGCAATAAGTGTGTCTGAA,0,5264224
zapB_predicted,0.3333333333333333,2,2,CTGAGAGGCCGCGTCGGTTT,0,5288042
zapB_predicted,0.3333333333333333,2,2,CTGACTTGACTGTCTGAAGT,0,5281793
zapB_predicted,0.3333333333333333,2,2,CTGACGAATTAATCGGTTAT,0,5276407
zapB_predicted,0.3333333333333333,2,2,CTGAAGTTGGTCAACATATG,0,5279614
zapB_predicted,0.3333333333333333,2,2,CTCTGTGAGGTATCTTTGTT,0,5276388
zapB_predicted,0.3333333333333333,2,2,CTCTCCATCGGCGTGCTCGT,0,5275379
zapB_predicted,0.3333333333333333,2,2,CTCTCAGGTGGAATCCGCGT,0,5269878
zapB_predicted,0.3333333333333333,2,2,CTCTCACGTCTATCACTTGC,0,5266211
zapB_predicted,0.3333333333333333,2,2,CTCGTTTTCAAAAACTACCG,0,5264596
zapB_predicted,0.3333333333333333,2,2,CTCGTGGAATTCCCCACGAA,0,5269790
zapB_predicted,0.3333333333333333,2,2,CTCGGTTTGAATTCGAGTCG,0,5272434
zapB_predicted,0.3333333333333333,2,2,CTCGGTACAACAGCCCAATA,0,5271015
zapB_predicted,0.3333333333333333,2,2,CTCGACAGCCCGCCTCACCT,0,5277730
zapB_predicted,0.3333333333333333,2,2,CTCCTTCTGGCTATGCGGGT,0,5282417
zapB_predicted,0.3333333333333333,2,2,CTCCTCTGGTTGGTCCGCAA,0,5270057
zapB_predicted,0.3333333333333333,2,2,CTCCTCAGGCAGGGGTCCCA,0,5282568
zapB_predicted,0.3333333333333333,2,2,CTCCGATACCCCGTAACACG,0,5286833
zapB_predicted,0.3333333333333333,2,2,CTCCGAGGGTCGTGAGAACA,0,5286144
zapB_predicted,0.3333333333333333,2,2,CTCCCATTAGCCGTAGATAA,0,5276371
zapB_predicted,0.3333333333333333,2,2,CTCCCACCTAGTGCGTTTTA,0,5265984
zapB_predicted,0.3333333333333333,2,2,CTCATTTGATACCTATGTCC,0,5273236
zapB_predicted,0.3333333333333333,2,2,CTCATCGGGCATTGAGTGTA,0,5282439
zapB_predicted,0.3333333333333333,2,2,CTCACATTTCCCGGATCGAG,0,5286675
zapB_predicted,0.3333333333333333,2,2,CTATTTAGCACATGCCATTA,0,5284690
zapB_predicted,0.3333333333333333,2,2,CTATTCTCGGATAGGTAAGC,0,5263696
zapB_predicted,0.3333333333333333,2,2,CTACACTTTGTAAGCAATTC,0,5273553
zapB_predicted,0.3333333333333333,2,2,CTAATAAGCCGGGATACGAA,0,5276537
zapB_predicted,0.3333333333333333,2,2,CTAACGGGTAGCGGGAGTGC,0,5287478
zapB_predicted,0.3333333333333333,2,2,CTAACAAGGAGTGACACTTA,0,5273271
zapB_predicted,0.3333333333333333,2,2,CGTTTCAAAAAACCTTCTCT,0,5269960
zapB_predicted,0.3333333333333333,2,2,CGTTGCTCTTACGTATGCCT,0,5276979
zapB_predicted,0.3333333333333333,2,2,CGTTATCGGCGAGTACCCCT,0,5263688
zapB_predicted,0.3333333333333333,2,2,CGTGGTAATTCTTCATGTAA,0,5284675
zapB_predicted,0.3333333333333333,2,2,CGTCTCGATTTTTGTGACGA,0,5279198
zapB_predicted,0.3333333333333333,2,2,CGTCAATCCTCCCATGGGAC,0,5272733
zapB_predicted,0.3333333333333333,2,2,CGTATTTCATAACCTGAGGA,0,5265911
zapB_predicted,0.3333333333333333,2,2,CGTACTGGCGGGGCTTTCGG,0,5263205
zapB_predicted,0.3333333333333333,2,2,CGTAAGGGTGTTAAATCAGA,0,5273595
zapB_predicted,0.3333333333333333,2,2,CGTAACCGCTGGGAATTTAT,0,5268958
zapB_predicted,0.3333333333333333,2,2,CGGTTCTCTGTTGCGCTTTC,0,5282766
zapB_predicted,0.3333333333333333,2,2,CGGTGGCGCGATACTTTCTG,0,5267136
zapB_predicted,0.3333333333333333,2,2,CGGTCGGTTCATGGAATTAC,0,5283287
zapB_predicted,0.3333333333333333,2,2,CGGTACTGAATTTTACGTGA,0,5281462
zapB_predicted,0.3333333333333333,2,2,CGGGTAGACATCAGAAGATA,0,5263723
zapB_predicted,0.3333333333333333,2,2,CGGGGTAAGACACAGAGGTC,0,5274229
zapB_predicted,0.3333333333333333,2,2,CGGGGAAGGGCTTATTAATC,0,5264943
zapB_predicted,0.3333333333333333,2,2,CGGGCGGGTACACGCGAGTC,0,5286898
zapB_predicted,0.3333333333333333,2,2,CGGCTCAGATACCGGTAGGG,0,5270950
zapB_predicted,0.3333333333333333,2,2,CGGCGAGATTAATAGCTTGA,0,5278661
zapB_predicted,0.3333333333333333,2,2,CGGCCCCAGCTTACTCCGAT,0,5271403
zapB_predicted,0.3333333333333333,2,2,CGGACGTAGGCACACGGTTC,0,5283010
zapB_predicted,0.3333333333333333,2,2,CGGACGCATGGTCGTTACCC,0,5285907
zapB_predicted,0.3333333333333333,2,2,CGGAATCGACGCAGTGTAAG,0,5285038
zapB_predicted,0.3333333333333333,2,2,CGCTGGTACCGGGTGATCCA,0,5272619
zapB_predicted,0.3333333333333333,2,2,CGCTGGACTGGGACCTTCAC,0,5280081
zapB_predicted,0.3333333333333333,2,2,CGCTCGTCTAACTACCGTAT,0,5268013
zapB_predicted,0.3333333333333333,2,2,CGCTCACTGTCTAAGAGGCC,0,5284817
zapB_predicted,0.3333333333333333,2,2,CGCGTGGGTACGCAAGGACG,0,5270300
zapB_predicted,0.3333333333333333,2,2,CGCGTCTGGCTTTCTATGAG,0,5265957
zapB_predicted,0.3333333333333333,2,2,CGCGGCCAATGCCGAACGTT,0,5275972
zapB_predicted,0.3333333333333333,2,2,CGCGACTGTGATTACCGGCA,0,5267654
zapB_predicted,0.3333333333333333,2,2,CGATTTTTTGCGTCTACGAC,0,5270863
zapB_predicted,0.3333333333333333,2,2,CGATTAACTAAAAATGTAAT,0,5272022
zapB_predicted,0.3333333333333333,2,2,CGATGAGATCAACCGGCCTT,0,5286558
zapB_predicted,0.3333333333333333,2,2,CGATCAGTAAAGAACAGAAT,0,5271090
zapB_predicted,0.3333333333333333,2,2,CGATCACCCAGGCAATCAGC,0,5287905
zapB_predicted,0.3333333333333333,2,2,CGAGCGTACCGAGACCTCCT,0,5266394
zapB_predicted,0.3333333333333333,2,2,CGACCCCGGATTGGACATAA,0,5274492
zapB_predicted,0.3333333333333333,2,2,CGACAGCGCGCTGGCGGTAT,0,5264393
zapB_predicted,0.3333333333333333,2,2,CGACACTGCTCAACCGAATC,0,5279539
zapB_predicted,0.3333333333333333,2,2,CGACACCCTGCGTATCGAAG,0,5286902
zapB_predicted,0.3333333333333333,2,2,CGAAGACGACGCAGCGGTTT,0,5269424
zapB_predicted,0.3333333333333333,2,2,CGAAAACAGACTCCCCTGAG,0,5282293
zapB_predicted,0.3333333333333333,2,2,CCTTGATGAAGGTATGCCGT,0,5278012
zapB_predicted,0.3333333333333333,2,2,CCTTCTCGACCCATTGCGTA,0,5265288
zapB_predicted,0.3333333333333333,2,2,CCTTCCGTTTAGGAGAAATT,0,5274388
zapB_predicted,0.3333333333333333,2,2,CCTTAAGGGGCCTAATAGCA,0,5288402
zapB_predicted,0.3333333333333333,2,2,CCTGTATAGGCCCAATAATG,0,5263548
zapB_predicted,0.3333333333333333,2,2,CCTGCTTTAAGTGATGGGGG,0,5266753
zapB_predicted,0.3333333333333333,2,2,CCTCACGAGAACGGTATACG,0,5276993
zapB_predicted,0.3333333333333333,2,2,CCTAGTAAGACGGTTTGATG,0,5283200
zapB_predicted,0.3333333333333333,2,2,CCTAGAAGTAGATGAGTCAC,0,5269432
zapB_predicted,0.3333333333333333,2,2,CCTAGAACCCCTAGGAATGT,0,5279384
zapB_predicted,0.3333333333333333,2,2,CCTACTTTTGGTGTTATAGA,0,5263273
zapB_predicted,0.3333333333333333,2,2,CCTACTCCAAGCTGGCGAGA,0,5277127
zapB_predicted,0.3333333333333333,2,2,CCTACACTCTACCATTCCGG,0,5272578
zapB_predicted,0.3333333333333333,2,2,CCTAACCACACGGGCACTTG,0,5266775
zapB_predicted,0.3333333333333333,2,2,CCGTTGAGTAGTATCCAGCA,0,5265027
zapB_predicted,0.3333333333333333,2,2,CCGTCACTCTGCCTTAACAC,0,5267842
zapB_predicted,0.3333333333333333,2,2,CCGTATGCATAATGTCCGGA,0,5271917
zapB_predicted,0.3333333333333333,2,2,CCGGTTATTCTTTTCACGCC,0,5268164
zapB_predicted,0.3333333333333333,2,2,CCGGTTAGTTCTGGGATGGG,0,5284945
zapB_predicted,0.3333333333333333,2,2,CCGGTCTTAAATGTCTGTGC,0,5265749
zapB_predicted,0.3333333333333333,2,2,CCGGGTGGGCGCACGCTTAA,0,5273288
zapB_predicted,0.3333333333333333,2,2,CCGGGACGCTGGGGTCACAT,0,5275874
zapB_predicted,0.3333333333333333,2,2,CCGCGGTAGATTACGCAAAA,0,5287692
zapB_predicted,0.3333333333333333,2,2,CCGCGGCATCACCTAAGGTG,0,5283053
zapB_predicted,0.3333333333333333,2,2,CCGCCCTCAAAAACGCAGAT,0,5267157
zapB_predicted,0.3333333333333333,2,2,CCGAGAGCTACGTCGCCCTC,0,5285225
zapB_predicted,0.3333333333333333,2,2,CCGAGAAAAAATCTCAAATG,0,5263270
zapB_predicted,0.3333333333333333,2,2,CCCTCCACCCAGTACGGTAT,0,5281714
zapB_predicted,0.3333333333333333,2,2,CCCGGGCTTCATTCGTGCGA,0,5268660
zapB_predicted,0.3333333333333333,2,2,CCCGGATAAACCGTCTCAGG,0,5265599
zapB_predicted,0.3333333333333333,2,2,CCCGGACAAACTCGTTCGGT,0,5283084
zapB_predicted,0.3333333333333333,2,2,CCCGCGGAACTGCACAGCTC,0,5288435
zapB_predicted,0.3333333333333333,2,2,CCCGAATTGTCACCATGGAA,0,5273759
zapB_predicted,0.3333333333333333,2,2,CCCCTAAAACAATGCTGAAT,0,5265222
zapB_predicted,0.3333333333333333,2,2,CCCATCCCCCGCAGATAGGT,0,5276889
zapB_predicted,0.3333333333333333,2,2,CCCAGTTGCGTGCCGCTCCA,0,5282367
zapB_predicted,0.3333333333333333,2,2,CCATCCGCTTCTAGTAATTA,0,5286796
zapB_predicted,0.3333333333333333,2,2,CCATATCATCGGAACGCTTC,0,5264013
zapB_predicted,0.3333333333333333,2,2,CCAGGGAGATTCTGGACCAG,0,5282175
zapB_predicted,0.3333333333333333,2,2,CCAGACGCGTGGTGGTCTTC,0,5279399
zapB_predicted,0.3333333333333333,2,2,CCACTCTAGTCGAAGGTTTG,0,5277256
zapB_predicted,0.3333333333333333,2,2,CCACGCACATAAATCGGCGG,0,5281620
zapB_predicted,0.3333333333333333,2,2,CCACATTTGGCCAAGAAACG,0,5280047
zapB_predicted,0.3333333333333333,2,2,CCACACTTTCACTCTTATAG,0,5269244
zapB_predicted,0.3333333333333333,2,2,CCAACTGAGCACTCTCGTAA,0,5274603
zapB_predicted,0.3333333333333333,2,2,CATTTGGCTCCGCCCAACCG,0,5265168
zapB_predicted,0.3333333333333333,2,2,CATTTCCTGCGGATAACGTG,0,5271632
zapB_predicted,0.3333333333333333,2,2,CATTCTTACAAAGAGGCTTA,0,5284581
zapB_predicted,0.3333333333333333,2,2,CATTCATACAAGGGGGAGTG,0,5271709
zapB_predicted,0.3333333333333333,2,2,CATGGGTACGGTCGGACGGC,0,5271138
zapB_predicted,0.3333333333333333,2,2,CATGGATGAAGTGGACGAAC,0,5271364
zapB_predicted,0.3333333333333333,2,2,CATGGAGAGGGCGTACACCA,0,5286213
zapB_predicted,0.3333333333333333,2,2,CATCGGCTCCTGAAACGTTG,0,5268493
zapB_predicted,0.3333333333333333,2,2,CATCGCTTGAGATCTTAAAG,0,5284242
zapB_predicted,0.3333333333333333,2,2,CATCGCGTATGTATAGGGCA,0,5276426
zapB_predicted,0.3333333333333333,2,2,CATATATGTCACATAAACGA,0,5282729
zapB_predicted,0.3333333333333333,2,2,CATAGTACCCATCCAATGTA,0,5274865
zapB_predicted,0.3333333333333333,2,2,CATAACAAGAGTATTGGGTG,0,5280792
zapB_predicted,0.3333333333333333,2,2,CAGTTTCGGTTAGAGCGAGG,0,5265889
zapB_predicted,0.3333333333333333,2,2,CAGTGGAGGGCACAATGGCT,0,5274627
zapB_predicted,0.3333333333333333,2,2,CAGTCGAACTCTCTTGAATA,0,5272958
zapB_predicted,0.3333333333333333,2,2,CAGTATAGAGCGTCACGGGA,0,5277028
zapB_predicted,0.3333333333333333,2,2,CAGTAGGGTAGGTCGGTGAT,0,5271715
zapB_predicted,0.3333333333333333,2,2,CAGGCTAGATCAGCCGGTCA,0,5284407
zapB_predicted,0.3333333333333333,2,2,CAGGAAGGTCGGGCTTCGTG,0,5269810
zapB_predicted,0.3333333333333333,2,2,CAGGAAAAGCCCATTTCGAT,0,5284599
zapB_predicted,0.3333333333333333,2,2,CAGCAGCCGCCAATTGCTAA,0,5288022
zapB_predicted,0.3333333333333333,2,2,CAGCAAGCCACGGGTGTGCC,0,5274049
zapB_predicted,0.3333333333333333,2,2,CAGAAAGGAAACCCCGCACT,0,5275568
zapB_predicted,0.3333333333333333,2,2,CACTTCTTTCGGTGGTATGC,0,5283247
zapB_predicted,0.3333333333333333,2,2,CACGGAATGGAGCTGTAACT,0,5284683
zapB_predicted,0.3333333333333333,2,2,CACGATAAATCTTACGCTCT,0,5278669
zapB_predicted,0.3333333333333333,2,2,CACCGACGAAGGATCTGAAT,0,5278275
zapB_predicted,0.3333333333333333,2,2,CACCCCTCAGTAATACCTTT,0,5264518
zapB_predicted,0.3333333333333333,2,2,CACAGGATGGCCACGATTGA,0,5280889
zapB_predicted,0.3333333333333333,2,2,CAATCCGTCGGGGCAAAGGT,0,5275970
zapB_predicted,0.3333333333333333,2,2,CAAGTAGTGTCTCACCTACG,0,5267882
zapB_predicted,0.3333333333333333,2,2,CAAGCTCTTTTGCGAGTAAG,0,5269537
zapB_predicted,0.3333333333333333,2,2,CAAGCGCTCCGATATAATAT,0,5265493
zapB_predicted,0.3333333333333333,2,2,CAAGCACATGGCGTCAATCA,0,5266228
zapB_predicted,0.3333333333333333,2,2,CAACTACAACGATGATTGCA,0,5275689
zapB_predicted,0.3333333333333333,2,2,CAACGGCACAGACCACGCCC,0,5266480
zapB_predicted,0.3333333333333333,2,2,CAACCGACCGAACACCAGCA,0,5278684
zapB_predicted,0.3333333333333333,2,2,CAAAGATGAGATGGAGCCAC,0,5267934
zapB_predicted,0.3333333333333333,2,2,ATTTCGACTTTCCGCGTCAC,0,5285529
zapB_predicted,0.3333333333333333,2,2,ATTTACAATCATCTCCCACT,0,5275208
zapB_predicted,0.3333333333333333,2,2,ATTGGTGTACATTCTCTGAT,0,5273870
zapB_predicted,0.3333333333333333,2,2,ATTGGGAGGACAAACGACTA,0,5270753
zapB_predicted,0.3333333333333333,2,2,ATTGGCTACGACGGCTGGCC,0,5281025
zapB_predicted,0.3333333333333333,2,2,ATTGAAGAGCCCTAAGAGGA,0,5280733
zapB_predicted,0.3333333333333333,2,2,ATTCTTTGTCTTCGCCGCGA,0,5268438
zapB_predicted,0.3333333333333333,2,2,ATTCACAGGCGGTGACAAAT,0,5271241
zapB_predicted,0.3333333333333333,2,2,ATTCAAATACGTGTCTAGAT,0,5280661
zapB_predicted,0.3333333333333333,2,2,ATTATAGTCCGTGCAAGCTC,0,5281920
zapB_predicted,0.3333333333333333,2,2,ATTAACAGCTATAGATATCA,0,5286553
zapB_predicted,0.3333333333333333,2,2,ATGTCAACGGGTTATCGGAT,0,5278240
zapB_predicted,0.3333333333333333,2,2,ATGGCAATACTTATAGAACG,0,5264164
zapB_predicted,0.3333333333333333,2,2,ATGGATATCAGGAAAAAGTG,0,5274526
zapB_predicted,0.3333333333333333,2,2,ATGGAGCAATTCTAATCCGA,0,5266426
zapB_predicted,0.3333333333333333,2,2,ATGCTATCGGGCAATTCAGA,0,5279707
zapB_predicted,0.3333333333333333,2,2,ATGCGACCTTAGCGGCAGAC,0,5279894
zapB_predicted,0.3333333333333333,2,2,ATGATATGACACAAATCGAC,0,5267861
zapB_predicted,0.3333333333333333,2,2,ATGAGGTTGAGCAATGGGGA,0,5278421
zapB_predicted,0.3333333333333333,2,2,ATGAAGCCATTATACGCTCC,0,5282138
zapB_predicted,0.3333333333333333,2,2,ATCTGTTTTAAGACTGTGTC,0,5267524
zapB_predicted,0.3333333333333333,2,2,ATCTGGGGCCGTCGCTCACA,0,5267601
zapB_predicted,0.3333333333333333,2,2,ATCTGGCGGACGGGGTGCAT,0,5270536
zapB_predicted,0.3333333333333333,2,2,ATCTGCCGTTGGATCTGAAT,0,5282558
zapB_predicted,0.3333333333333333,2,2,ATCTCGTCCAGCATTGCTGA,0,5286744
zapB_predicted,0.3333333333333333,2,2,ATCTCCGAAGGGCCTAGAGA,0,5287911
zapB_predicted,0.3333333333333333,2,2,ATCTCCCCCTGCGGCGAGCG,0,5274077
zapB_predicted,0.3333333333333333,2,2,ATCTACTCAGATCGAGTAAA,0,5274930
zapB_predicted,0.3333333333333333,2,2,ATCGTTCACCTTCTTGAGCC,0,5267702
zapB_predicted,0.3333333333333333,2,2,ATCGTGATTCTGGGCGTAAG,0,5277200
zapB_predicted,0.3333333333333333,2,2,ATCGGTTGGTTTCCCGGGCT,0,5287869
zapB_predicted,0.3333333333333333,2,2,ATCGGCTACCGTTTCCGCTG,0,5282095
zapB_predicted,0.3333333333333333,2,2,ATCGGCGTTTCAGCCCGCGC,0,5267548
zapB_predicted,0.3333333333333333,2,2,ATCGCACGGATAGAACGCCA,0,5279908
zapB_predicted,0.3333333333333333,2,2,ATCGAACTGACCCGCTTAGT,0,5284759
zapB_predicted,0.3333333333333333,2,2,ATCCGCAGTGAATGGCGCTG,0,5275766
zapB_predicted,0.3333333333333333,2,2,ATCCGCAGGCGATGATGGTA,0,5274003
zapB_predicted,0.3333333333333333,2,2,ATCCCGAAAGGTCTGACTCA,0,5283869
zapB_predicted,0.3333333333333333,2,2,ATCATGTCCATTCTACGTGC,0,5276141
zapB_predicted,0.3333333333333333,2,2,ATCAGTACGCGACGTTCACG,0,5281362
zapB_predicted,0.3333333333333333,2,2,ATCAAAACGTACGCGTTGGC,0,5268113
zapB_predicted,0.3333333333333333,2,2,ATAGCAGGGCGTATATTGCT,0,5264413
zapB_predicted,0.3333333333333333,2,2,ATAGAGACAATACACTGAAC,0,5284865
zapB_predicted,0.3333333333333333,2,2,ATAGACACTCTCGAATAGGA,0,5265826
zapB_predicted,0.3333333333333333,2,2,ATAGACAAAAGTGGACTCTA,0,5270634
zapB_predicted,0.3333333333333333,2,2,ATACTCGACTCATACCGGGC,0,5272060
zapB_predicted,0.3333333333333333,2,2,ATACGGTTGGCGGTCGGGCG,0,5274784
zapB_predicted,0.3333333333333333,2,2,ATACCTGGCGCTCCGACTGA,0,5271218
zapB_predicted,0.3333333333333333,2,2,ATACCGGCCAGGCTACCTGA,0,5281956
zapB_predicted,0.3333333333333333,2,2,ATAAGTTATGGCTATCTTGA,0,5274090
zapB_predicted,0.3333333333333333,2,2,ATAAATGGACAAAGAGGGTT,0,5270069
zapB_predicted,0.3333333333333333,2,2,ATAAATAGAGATTTGTGGAG,0,5278063
zapB_predicted,0.3333333333333333,2,2,AGTTGGTGTAGGCGTGAGAC,0,5270418
zapB_predicted,0.3333333333333333,2,2,AGTTGAGAACACCATTGGAT,0,5266067
zapB_predicted,0.3333333333333333,2,2,AGTTCTGCTTCGGCAGCCTT,0,5272433
zapB_predicted,0.3333333333333333,2,2,AGTTCGGTGTCTACGGGTAA,0,5269805
zapB_predicted,0.3333333333333333,2,2,AGTTAGAGCCGGTTATTGGC,0,5269319
zapB_predicted,0.3333333333333333,2,2,AGTGTGACAGGGCAGGTCCA,0,5274788
zapB_predicted,0.3333333333333333,2,2,AGTGTCGCCCCATATTACTG,0,5274289
zapB_predicted,0.3333333333333333,2,2,AGTGCCTCGGTCGCCTAGTA,0,5277262
zapB_predicted,0.3333333333333333,2,2,AGTGATGCTGGAGGATGGCA,0,5285297
zapB_predicted,0.3333333333333333,2,2,AGTCTGCTTCCTAATATGCT,0,5287912
zapB_predicted,0.3333333333333333,2,2,AGTCGAGCTAGGCGCGAGGT,0,5275301
zapB_predicted,0.3333333333333333,2,2,AGTAGGCGGCTTCTACCGTG,0,5283215
zapB_predicted,0.3333333333333333,2,2,AGTACTCCTGTCCAGTCAAC,0,5284782
zapB_predicted,0.3333333333333333,2,2,AGTACTAGAGCCCGCTCAAC,0,5286705
zapB_predicted,0.3333333333333333,2,2,AGTAAGTGATCTACGGGTTG,0,5274031
zapB_predicted,0.3333333333333333,2,2,AGGTTTATGTATGGTATAAA,0,5284251
zapB_predicted,0.3333333333333333,2,2,AGGTGAAATGTGAGGATCCG,0,5278353
zapB_predicted,0.3333333333333333,2,2,AGGTCTCCTTTCAAGGTTTG,0,5281259
zapB_predicted,0.3333333333333333,2,2,AGGTAGTCATTAGCGAAGGA,0,5276882
zapB_predicted,0.3333333333333333,2,2,AGGTACGCGCAGAGAACAGT,0,5271059
zapB_predicted,0.3333333333333333,2,2,AGGTAAGGTAAAGATTCGCG,0,5273895
zapB_predicted,0.3333333333333333,2,2,AGGGTCTTTAATAGTAGATG,0,5278547
zapB_predicted,0.3333333333333333,2,2,AGGGGTACGCAGTCACGAGG,0,5286142
zapB_predicted,0.3333333333333333,2,2,AGGGGTAATGTAAGACGGAA,0,5275146
zapB_predicted,0.3333333333333333,2,2,AGGGGCGGGTTTCTCTTTAC,0,5265872
zapB_predicted,0.3333333333333333,2,2,AGGGGAACGTATGCGCAAGG,0,5283730
zapB_predicted,0.3333333333333333,2,2,AGGGCGTGGATGTATTGGGC,0,5263160
zapB_predicted,0.3333333333333333,2,2,AGGGCGACGCTCGAAGCTTT,0,5277615
zapB_predicted,0.3333333333333333,2,2,AGGCTCGCATGACGACTCGT,0,5278769
zapB_predicted,0.3333333333333333,2,2,AGGCTACATTTCCCATATGG,0,5267311
zapB_predicted,0.3333333333333333,2,2,AGGCGCACCATCCTCTTATT,0,5285298
zapB_predicted,0.3333333333333333,2,2,AGGAGTCACTAGGGCTTCCC,0,5288138
zapB_predicted,0.3333333333333333,2,2,AGGAGGCTGGCAGGTGCCTG,0,5288218
zapB_predicted,0.3333333333333333,2,2,AGGACAAAGAGGGGATCAAT,0,5278584
zapB_predicted,0.3333333333333333,2,2,AGGAACCTGCAGCGCATCTA,0,5287230
zapB_predicted,0.3333333333333333,2,2,AGCTGCAGTCGTATCAGCGT,0,5286609
zapB_predicted,0.3333333333333333,2,2,AGCTAGAAGAAAGGAAGTTC,0,5280863
zapB_predicted,0.3333333333333333,2,2,AGCGGCACGCGATTTCAAGG,0,5276058
zapB_predicted,0.3333333333333333,2,2,AGCGCCATAGCTAGCTTATA,0,5286335
zapB_predicted,0.3333333333333333,2,2,AGCGCCACGTATAATGCGTC,0,5268688
zapB_predicted,0.3333333333333333,2,2,AGCCTCTGGTGTGATAACGG,0,5268704
zapB_predicted,0.3333333333333333,2,2,AGCCGCTGACTACCGCAATA,0,5270988
zapB_predicted,0.3333333333333333,2,2,AGCCCGCAGCACGCCGCGAC,0,5284000
zapB_predicted,0.3333333333333333,2,2,AGCCCCACGGCGTTCGAGGG,0,5274042
zapB_predicted,0.3333333333333333,2,2,AGCAATGTCGTTCCCGACCA,0,5275399
zapB_predicted,0.3333333333333333,2,2,AGAGGAAGGCAGTGGACTCT,0,5286026
zapB_predicted,0.3333333333333333,2,2,AGACTGACTCATTATGGAAT,0,5268734
zapB_predicted,0.3333333333333333,2,2,AGACTATATATGTCCGAGTG,0,5280377
zapB_predicted,0.3333333333333333,2,2,AGACGAGTTGAGCCGGCTTT,0,5273636
zapB_predicted,0.3333333333333333,2,2,AGAAGTCCGCGGTACGTCCT,0,5281448
zapB_predicted,0.3333333333333333,2,2,AGAAATATCCCGCAAGAATG,0,5285392
zapB_predicted,0.3333333333333333,2,2,ACTTTGTTGGCTTAGTGATG,0,5284991
zapB_predicted,0.3333333333333333,2,2,ACTTCCTTTTCCCACGGTTG,0,5288195
zapB_predicted,0.3333333333333333,2,2,ACTGGAAAGCGGCTTTGCTT,0,5279042
zapB_predicted,0.3333333333333333,2,2,ACTCATCCGGCCCCATGACT,0,5284355
zapB_predicted,0.3333333333333333,2,2,ACTACGCCAGACAGAGCTCC,0,5268902
zapB_predicted,0.3333333333333333,2,2,ACTACGAGATGCGTGTGCTT,0,5275241
zapB_predicted,0.3333333333333333,2,2,ACGTTTTGATTTTCAACCCA,0,5283557
zapB_predicted,0.3333333333333333,2,2,ACGTCTTGGCACACGGCTAG,0,5273694
zapB_predicted,0.3333333333333333,2,2,ACGGTCATGGTCCGATTTAA,0,5281976
zapB_predicted,0.3333333333333333,2,2,ACGGCTTCACGGAGCATGGA,0,5269419
zapB_predicted,0.3333333333333333,2,2,ACGGCCACACCAAGGTAATG,0,5283073
zapB_predicted,0.3333333333333333,2,2,ACGGACTTGCATCACACTTC,0,5275976
zapB_predicted,0.3333333333333333,2,2,ACGCTTGGGCGTATCTGATG,0,5278080
zapB_predicted,0.3333333333333333,2,2,ACGCTAGTCTGATGACGGCC,0,5276576
zapB_predicted,0.3333333333333333,2,2,ACGCCCCACTGGACTGCGAG,0,5283223
zapB_predicted,0.3333333333333333,2,2,ACGAGTACAAGTTTTTGCTC,0,5264237
zapB_predicted,0.3333333333333333,2,2,ACGACCTTCGGGGCGTGGAA,0,5283094
zapB_predicted,0.3333333333333333,2,2,ACCTGAGATAATTGCAGAAC,0,5278184
zapB_predicted,0.3333333333333333,2,2,ACCGCCCAGAATGGTGAGGC,0,5271746
zapB_predicted,0.3333333333333333,2,2,ACCGCATTGTTGTAGGTAGT,0,5282244
zapB_predicted,0.3333333333333333,2,2,ACCCTGACTGTAAGGCCTCT,0,5266714
zapB_predicted,0.3333333333333333,2,2,ACCCGTATGTGAGCTGGATT,0,5282791
zapB_predicted,0.3333333333333333,2,2,ACCCAATCGCAATGGTTAGA,0,5269220
zapB_predicted,0.3333333333333333,2,2,ACCAGTTAGCACGGCAGAGC,0,5277537
zapB_predicted,0.3333333333333333,2,2,ACCAGCAAGCCTTCGCTTTC,0,5278188
zapB_predicted,0.3333333333333333,2,2,ACCACATTACGCAAAAGCAA,0,5271897
zapB_predicted,0.3333333333333333,2,2,ACCAAGAGTGCCGTAAGATG,0,5275243
zapB_predicted,0.3333333333333333,2,2,ACCAAAGTGTAAGTGTATCA,0,5271926
zapB_predicted,0.3333333333333333,2,2,ACATTCAAATGGGTGAATCC,0,5263785
zapB_predicted,0.3333333333333333,2,2,ACATGCCCTCAAGTCCAAAT,0,5285612
zapB_predicted,0.3333333333333333,2,2,ACAGGTTGACCAGCCAATAT,0,5264715
zapB_predicted,0.3333333333333333,2,2,ACAGGGATATGGAGAGGCCG,0,5278689
zapB_predicted,0.3333333333333333,2,2,ACACTAATCAGATTAGACTA,0,5264002
zapB_predicted,0.3333333333333333,2,2,ACACGCAATTTCTATACGGC,0,5274792
zapB_predicted,0.3333333333333333,2,2,ACACCGAACAGTAAGAAACG,0,5274812
zapB_predicted,0.3333333333333333,2,2,ACAAGAGGCACGGCCGTCCC,0,5277205
zapB_predicted,0.3333333333333333,2,2,ACAACGGTGCGGGGCGACGA,0,5264968
zapB_predicted,0.3333333333333333,2,2,AATTTCAATGGTGAGAGGCA,0,5267038
zapB_predicted,0.3333333333333333,2,2,AATTGTCGGCTCTTTGGTCT,0,5283817
zapB_predicted,0.3333333333333333,2,2,AATTATGCGTCGAAAGACAC,0,5282125
zapB_predicted,0.3333333333333333,2,2,AATGGTGTTAGGTTCTTAAA,0,5275211
zapB_predicted,0.3333333333333333,2,2,AATGCTAGTAAGATCAGGTT,0,5277067
zapB_predicted,0.3333333333333333,2,2,AATGCGTGGGCCAGCCGACA,0,5284184
zapB_predicted,0.3333333333333333,2,2,AATGCAATAAACACTATGAC,0,5281336
zapB_predicted,0.3333333333333333,2,2,AATCTCGCAGATAGGCCCTC,0,5287668
zapB_predicted,0.3333333333333333,2,2,AATCCTTATCACTCGCGGCG,0,5279535
zapB_predicted,0.3333333333333333,2,2,AATCCAGGGCCAAGCACACT,0,5276872
zapB_predicted,0.3333333333333333,2,2,AATCATCGGTCGGCCGGACC,0,5263324
zapB_predicted,0.3333333333333333,2,2,AATCAGTGCGCCAAATCACC,0,5269815
zapB_predicted,0.3333333333333333,2,2,AATATTGTTTCATAAATTTA,0,5280926
zapB_predicted,0.3333333333333333,2,2,AATAGTGCGTATCTGGGCCA,0,5283856
zapB_predicted,0.3333333333333333,2,2,AATACCTTGACTAAGGTTCG,0,5283807
zapB_predicted,0.3333333333333333,2,2,AATAACGGCTTTTTGGTCTC,0,5264684
zapB_predicted,0.3333333333333333,2,2,AAGTTCGGACCTCCTAATAC,0,5275192
zapB_predicted,0.3333333333333333,2,2,AAGTGCAGCACTAATGGAAC,0,5271142
zapB_predicted,0.3333333333333333,2,2,AAGGTCCCGATCATACTAAT,0,5273683
zapB_predicted,0.3333333333333333,2,2,AAGGAGGTGTTGCACTTGCG,0,5284709
zapB_predicted,0.3333333333333333,2,2,AAGCGGGCTGCCATTCAACA,0,5279194
zapB_predicted,0.3333333333333333,2,2,AAGCGGACGGTTGCTCAAAA,0,5274785
zapB_predicted,0.3333333333333333,2,2,AAGCAAGTAATACTGTCCGA,0,5265809
zapB_predicted,0.3333333333333333,2,2,AAGATTTAAACTTAGTCAAC,0,5277566
zapB_predicted,0.3333333333333333,2,2,AAGATTAGGCACTAACACTG,0,5281739
zapB_predicted,0.3333333333333333,2,2,AAGATGGAATGATTCAAGCC,0,5275044
zapB_predicted,0.3333333333333333,2,2,AAGAGGTGTGTTAAAGTATA,0,5286042
zapB_predicted,0.3333333333333333,2,2,AAGACTCAAGGAACCTGTAC,0,5278721
zapB_predicted,0.3333333333333333,2,2,AACTGAGCATAGACTGCACC,0,5283867
zapB_predicted,0.3333333333333333,2,2,AACTCTTTTGGGTTCACGTG,0,5265387
zapB_predicted,0.3333333333333333,2,2,AACTATGAAAGAGATAGGTT,0,5271350
zapB_predicted,0.3333333333333333,2,2,AACGGAATAGTAAAGACTAA,0,5271840
zapB_predicted,0.3333333333333333,2,2,AACCGTGGAAGAATATGGTG,0,5268036
zapB_predicted,0.3333333333333333,2,2,AAATTGTGCTCCAATTCCAA,0,5284496
zapB_predicted,0.3333333333333333,2,2,AAATTCGATGGGCGCGTGAA,0,5272989
zapB_predicted,0.3333333333333333,2,2,AAATGTATTGGTGGAGAGTT,0,5266575
zapB_predicted,0.3333333333333333,2,2,AAATGAGATCAGCGGCAACG,0,5274974
zapB_predicted,0.3333333333333333,2,2,AAATCAGCACATATTAGCAT,0,5281981
zapB_predicted,0.3333333333333333,2,2,AAAGTGATCCGACGGGAAAT,0,5270603
zapB_predicted,0.3333333333333333,2,2,AAAGGGGGGGGATAGGTAGA,0,5285104
zapB_predicted,0.3333333333333333,2,2,AAAGACTGTGTGGGTGTCAA,0,5273223
zapB_predicted,0.3333333333333333,2,2,AAACTTCAGGCGGTTTCTCT,0,5281653
zapB_predicted,0.3333333333333333,2,2,AAACCGGCGCATACGTTACT,0,5269872
zapB_predicted,0.3333333333333333,2,2,AAACAGTTTACGCGTAGCCC,0,5271105
zapB_predicted,0.3333333333333333,2,2,AAACAGGTGCAAGAACTCTA,0,5272883
zapB_predicted,0.3333333333333333,2,2,AAAATGGACTTTAACGCTAG,0,5281606
zapB_predicted,0.3333333333333333,2,2,AAAAGAGAGGCTCAGCAGGT,0,5264911
zapB_predicted,0.5,1,1,TTTTTCCTAACATTAGACGA,0,5266438
zapB_predicted,0.5,1,1,TTTTGTCGGCAAAAATGCGT,0,5272437
zapB_predicted,0.5,1,1,TTTTGCTCTCATGTCATTTT,0,5278874
zapB_predicted,0.5,1,1,TTTTCTGGAAAGCAAGTACG,0,5265535
zapB_predicted,0.5,1,1,TTTTCGGTTCTCTGTGGACA,0,5285361
zapB_predicted,0.5,1,1,TTTTCCCGGTACTCCGCAAG,0,5282082
zapB_predicted,0.5,1,1,TTTGGGTCACTATCGCCCGT,0,5263973
zapB_predicted,0.5,1,1,TTTGCGTTGTCGAGGGAGTC,0,5286483
zapB_predicted,0.5,1,1,TTTGAGAGGAAAAAGAATAT,0,5267580
zapB_predicted,0.5,1,1,TTTCTTCGCGAGGTCGAAAG,0,5266362
zapB_predicted,0.5,1,1,TTTCTGTTTCAGAAACCGAG,0,5284288
zapB_predicted,0.5,1,1,TTTCGGTAGATGAGGCTCTG,0,5265726
zapB_predicted,0.5,1,1,TTTACTCGGGCGCCGGTCAT,0,5285985
zapB_predicted,0.5,1,1,TTTAATAGGTAAACTCTTCC,0,5273057
zapB_predicted,0.5,1,1,TTGTTACCCTCCTTCATCAA,0,5284339
zapB_predicted,0.5,1,1,TTGTGGGGTTAGGTTACTGC,0,5284329
zapB_predicted,0.5,1,1,TTGTGGAACAGTTCTTGCTA,0,5273753
zapB_predicted,0.5,1,1,TTGTGAGGGCAAGCCCGAGG,0,5268544
zapB_predicted,0.5,1,1,TTGTGAGCTGTCGGGTGGTT,0,5266057
zapB_predicted,0.5,1,1,TTGTCACGTGGACGATGGAG,0,5286983
zapB_predicted,0.5,1,1,TTGTATAGACTGTCGTGCTT,0,5285721
zapB_predicted,0.5,1,1,TTGGGGTGCCCACCGGCGAG,0,5265720
zapB_predicted,0.5,1,1,TTGGGATAGCTCACAACTCA,0,5272957
zapB_predicted,0.5,1,1,TTGGCAAACATAAAGGAGCC,0,5271594
zapB_predicted,0.5,1,1,TTGCTCATCTGTAGGATTCT,0,5282252
zapB_predicted,0.5,1,1,TTGCGTCTGGAACGATTTGC,0,5272673
zapB_predicted,0.5,1,1,TTGCGCTTCTGGTACAAGAT,0,5288201
zapB_predicted,0.5,1,1,TTGCGAAGCCTGTAAAGCTT,0,5283738
zapB_predicted,0.5,1,1,TTGATTGGTACTATATGAGC,0,5280076
zapB_predicted,0.5,1,1,TTGATTCGATCCTAAGTCTC,0,5270167
zapB_predicted,0.5,1,1,TTGATTCCATACCCCTCCAA,0,5287701
zapB_predicted,0.5,1,1,TTGATGGTATTCTTAGTATA,0,5276714
zapB_predicted,0.5,1,1,TTGATCGGTGGCAACAAGCC,0,5268621
zapB_predicted,0.5,1,1,TTGAGAGACTTGGCCTGTGC,0,5279477
zapB_predicted,0.5,1,1,TTGACACCTGGAAGAAAGGA,0,5285910
zapB_predicted,0.5,1,1,TTGAAAATTCTGGTGTGTAG,0,5268307
zapB_predicted,0.5,1,1,TTCTTAAGAACAATAAGGGC,0,5273868
zapB_predicted,0.5,1,1,TTCTGCCTTACAAACGCTTA,0,5269546
zapB_predicted,0.5,1,1,TTCTGCATAGGTTGTCCCCC,0,5276556
zapB_predicted,0.5,1,1,TTCTCTGTGTTAGTTCGCAA,0,5263274
zapB_predicted,0.5,1,1,TTCTAGCATCCACAACATGT,0,5283802
zapB_predicted,0.5,1,1,TTCGTATGTTAGGTACGGTA,0,5266749
zapB_predicted,0.5,1,1,TTCGTAAGGAAAGAAAGGAG,0,5270317
zapB_predicted,0.5,1,1,TTCGCGCGACCTCATATCTG,0,5283058
zapB_predicted,0.5,1,1,TTCGCAGGGTCCGGCTGTGT,0,5275864
zapB_predicted,0.5,1,1,TTCGAGCGCTATGTAGACCG,0,5273854
zapB_predicted,0.5,1,1,TTCCTTAGGGGGTTTAAATG,0,5283251
zapB_predicted,0.5,1,1,TTCCCGAACGCGCCCAAGGT,0,5282663
zapB_predicted,0.5,1,1,TTCCACGATTCCCGCGGGCT,0,5273291
zapB_predicted,0.5,1,1,TTCATGAGACTTAGTGATAA,0,5273433
zapB_predicted,0.5,1,1,TTCAGGGAGGCGACAATGTT,0,5274332
zapB_predicted,0.5,1,1,TTATCTGACGCGGATATGCA,0,5275402
zapB_predicted,0.5,1,1,TTATCCTGTTATGGCCGTGA,0,5280071
zapB_predicted,0.5,1,1,TTATATTCATCAAGGTGTCT,0,5264543
zapB_predicted,0.5,1,1,TTAGTTACAAGTCCTTTCGG,0,5281300
zapB_predicted,0.5,1,1,TTAGGATGCTTGGTTTGACC,0,5279258
zapB_predicted,0.5,1,1,TTAGCGGCAAGAGGTAGTGG,0,5265403
zapB_predicted,0.5,1,1,TTAGATTACCTAGGGAAGTG,0,5264769
zapB_predicted,0.5,1,1,TTAGAGCACTTATCAATACA,0,5283487
zapB_predicted,0.5,1,1,TTAGAAAGAGCTATGTGGTA,0,5282946
zapB_predicted,0.5,1,1,TTACTAACGGCTCCCAGGCA,0,5281519
zapB_predicted,0.5,1,1,TTACGTTAGGAATAAGCCGT,0,5279984
zapB_predicted,0.5,1,1,TTACCTCCTAGTAATGCCAG,0,5271953
zapB_predicted,0.5,1,1,TTACAACACTTTTCCAAGTA,0,5282624
zapB_predicted,0.5,1,1,TTAATGTCTTATCCCATCAG,0,5285477
zapB_predicted,0.5,1,1,TTAAGGTTAGGCGTAGGCGA,0,5283365
zapB_predicted,0.5,1,1,TTAAGCCCCGGTGGCTTAAT,0,5285710
zapB_predicted,0.5,1,1,TTAACGCAAGTTCTTAGTGC,0,5267001
zapB_predicted,0.5,1,1,TTAACCTATTCACTTCATGT,0,5267567
zapB_predicted,0.5,1,1,TTAAACTTCCAGCGGTATGA,0,5273413
zapB_predicted,0.5,1,1,TTAAACATGCAAGGAAAGTC,0,5263477
zapB_predicted,0.5,1,1,TTAAAACTCATCTTAGATCC,0,5287575
zapB_predicted,0.5,1,1,TGTTTCCCACAATCAAAAGC,0,5268620
zapB_predicted,0.5,1,1,TGTTGGATTGACATCACCGA,0,5280139
zapB_predicted,0.5,1,1,TGTTGAGGGAAACGTTATCA,0,5277269
zapB_predicted,0.5,1,1,TGTTCTGGGGTCACATCGCG,0,5278924
zapB_predicted,0.5,1,1,TGTTCCCACCGACGCGGTTT,0,5285556
zapB_predicted,0.5,1,1,TGTTACTATTTGCAGTGGTC,0,5281906
zapB_predicted,0.5,1,1,TGTTACAATTACATCCGGAT,0,5268638
zapB_predicted,0.5,1,1,TGTGGTTTGGCCCAGACGCT,0,5287310
zapB_predicted,0.5,1,1,TGTGGTGACTGGGGGGATCT,0,5270390
zapB_predicted,0.5,1,1,TGTGGAACGATTTCCGTTCC,0,5264170
zapB_predicted,0.5,1,1,TGTGCGTCTTACAGATCCTG,0,5267464
zapB_predicted,0.5,1,1,TGTGCCAACGTAACCGAATC,0,5280321
zapB_predicted,0.5,1,1,TGTGAATGTCTTAGTATCTG,0,5287453
zapB_predicted,0.5,1,1,TGTCCCTCGAAGATCTACCC,0,5277430
zapB_predicted,0.5,1,1,TGTATATTTCACGAAGAGCT,0,5265744
zapB_predicted,0.5,1,1,TGTAGTATGACGAGGGAGAT,0,5284678
zapB_predicted,0.5,1,1,TGTACAGCTTTCAACAGCTG,0,5274884
zapB_predicted,0.5,1,1,TGTAACGTGTCACTGTTTTA,0,5286973
zapB_predicted,0.5,1,1,TGGTGTCTGATTTGCCGGCA,0,5273782
zapB_predicted,0.5,1,1,TGGTGGATATTTTGGATCTA,0,5264030
zapB_predicted,0.5,1,1,TGGTGATGTCGGACATTGGC,0,5270697
zapB_predicted,0.5,1,1,TGGTAATGCTGCAAGTTGCG,0,5276806
zapB_predicted,0.5,1,1,TGGGTCGCGCTAGAAAGTGA,0,5278582
zapB_predicted,0.5,1,1,TGGGTAACAGCCGCTTATGT,0,5267617
zapB_predicted,0.5,1,1,TGGGGTTGTGGGGCGGAACC,0,5282700
zapB_predicted,0.5,1,1,TGGGCAGGGTCATACGGTAC,0,5282618
zapB_predicted,0.5,1,1,TGGGACACTAATTGCTTAGC,0,5281176
zapB_predicted,0.5,1,1,TGGCGATGCGATATGGTCCC,0,5266567
zapB_predicted,0.5,1,1,TGGCCGGGGTGTTGGCCCTG,0,5274223
zapB_predicted,0.5,1,1,TGGCCCTACGACACTAGAAT,0,5277118
zapB_predicted,0.5,1,1,TGGCCCACTTGGATGGTGAG,0,5273645
zapB_predicted,0.5,1,1,TGGAGGTTTCACTTCCATGG,0,5269970
zapB_predicted,0.5,1,1,TGGAGAACTCCGCCACTAGC,0,5269995
zapB_predicted,0.5,1,1,TGGACGTCCGATTGGCATTT,0,5264814
zapB_predicted,0.5,1,1,TGGACGCGTCAGTGTTCACA,0,5284050
zapB_predicted,0.5,1,1,TGGACCGAATACGAAGTTTG,0,5274722
zapB_predicted,0.5,1,1,TGGAAAAGCACCTTTTGTGC,0,5288294
zapB_predicted,0.5,1,1,TGCTGGTTTACAGATCTAGT,0,5276687
zapB_predicted,0.5,1,1,TGCTATCGTTGCTTTGCCGT,0,5263864
zapB_predicted,0.5,1,1,TGCCTGGTGGGGATCCTGGG,0,5267840
zapB_predicted,0.5,1,1,TGCCGCGAAATCCCTATCTA,0,5275031
zapB_predicted,0.5,1,1,TGCCGACTAGCCGCACAGTC,0,5278468
zapB_predicted,0.5,1,1,TGCCCAGCGCCAAAGCTAAC,0,5272617
zapB_predicted,0.5,1,1,TGCCCACGGACTTCATTTGA,0,5280988
zapB_predicted,0.5,1,1,TGCCAACTCGTGTTCCTGGT,0,5275800
zapB_predicted,0.5,1,1,TGCATAGCTTGCGCAGCTAA,0,5265518
zapB_predicted,0.5,1,1,TGCAGACACTTAAAAACAAT,0,5275154
zapB_predicted,0.5,1,1,TGCAGAAAACCGAGCAACTG,0,5265661
zapB_predicted,0.5,1,1,TGCACAAATGATGAAGTGAT,0,5267621
zapB_predicted,0.5,1,1,TGCAAAAGGCCAACTCTGGT,0,5283359
zapB_predicted,0.5,1,1,TGATTATAAATGCAATGTGC,0,5283351
zapB_predicted,0.5,1,1,TGATCGATGATGCCCATTCC,0,5278072
zapB_predicted,0.5,1,1,TGATATCTGTTCGACGAAAA,0,5285520
zapB_predicted,0.5,1,1,TGAGTTTCGGTTACACACAT,0,5275871
zapB_predicted,0.5,1,1,TGAGGGTACTACCGTGGATT,0,5287234
zapB_predicted,0.5,1,1,TGAGGACGGGGCCGCGTTTG,0,5275421
zapB_predicted,0.5,1,1,TGAGAGGTACAGTAAAACCA,0,5286536
zapB_predicted,0.5,1,1,TGAGACCTTACGGGGAATCA,0,5278897
zapB_predicted,0.5,1,1,TGACCTTTCCAGTTGGAAAC,0,5265577
zapB_predicted,0.5,1,1,TGACCGGAACGCCTGAACCA,0,5284649
zapB_predicted,0.5,1,1,TGAATTCATATGGGTAGGGC,0,5284190
zapB_predicted,0.5,1,1,TGAATACAGATAAGTTCCGG,0,5269320
zapB_predicted,0.5,1,1,TGAAGTCTTGTCGGTATCAT,0,5283748
zapB_predicted,0.5,1,1,TGAAGCGGGTCTACTAAGGG,0,5267709
zapB_predicted,0.5,1,1,TGAAGAGGCCCCGATTATAT,0,5282873
zapB_predicted,0.5,1,1,TGAACCCCCGCTGGCCTCTC,0,5266246
zapB_predicted,0.5,1,1,TCTTTCTAACGAACATACCT,0,5273575
zapB_predicted,0.5,1,1,TCTTTATTTTGGTACTAATC,0,5286029
zapB_predicted,0.5,1,1,TCTTGTGTCAGTGGGGCATG,0,5270602
zapB_predicted,0.5,1,1,TCTTGGGGTATCGGCCGGAT,0,5272100
zapB_predicted,0.5,1,1,TCTTGGAGATTAGTGTTAAC,0,5270519
zapB_predicted,0.5,1,1,TCTTGACTCCTGAGTAGTTA,0,5271156
zapB_predicted,0.5,1,1,TCTTCTCAGAGATTTAACTC,0,5276449
zapB_predicted,0.5,1,1,TCTTCCCAGCATCTCGTGCT,0,5286347
zapB_predicted,0.5,1,1,TCTTAAAGGGTTCCCATGGT,0,5280616
zapB_predicted,0.5,1,1,TCTGTCTTTGACCAGTGAAA,0,5263922
zapB_predicted,0.5,1,1,TCTGGTGGGGTTATGGTGGT,0,5278086
zapB_predicted,0.5,1,1,TCTGGCCCCAATCCGTTTGT,0,5280992
zapB_predicted,0.5,1,1,TCTGGACACGAGCCTGGCAG,0,5274954
zapB_predicted,0.5,1,1,TCTGCTGGGGGGACTAAGTG,0,5285179
zapB_predicted,0.5,1,1,TCTGCGTGAATTAAGCGCGA,0,5272754
zapB_predicted,0.5,1,1,TCTCTATGCGGCCCTTAACC,0,5281828
zapB_predicted,0.5,1,1,TCTCGCCATTACTCGCTCAC,0,5276982
zapB_predicted,0.5,1,1,TCTCCTGTGCAAGGCCCGCT,0,5279528
zapB_predicted,0.5,1,1,TCTCCCGGCAAGATTCTTTA,0,5281195
zapB_predicted,0.5,1,1,TCTCCCATGCGTTAGAGGTA,0,5273846
zapB_predicted,0.5,1,1,TCTCAGAGATAGGGGGGGCA,0,5280182
zapB_predicted,0.5,1,1,TCTAGTTGGTCCCCATTAAA,0,5288291
zapB_predicted,0.5,1,1,TCTACAGGAACCAAACCATC,0,5271759
zapB_predicted,0.5,1,1,TCGTGGCTTGCAGGCACCCG,0,5274473
zapB_predicted,0.5,1,1,TCGTCTGGGGGTACTTCTGC,0,5286455
zapB_predicted,0.5,1,1,TCGTCATTCATAGCGAAATG,0,5275447
zapB_predicted,0.5,1,1,TCGTATCGAGGCCTGAGTTA,0,5265370
zapB_predicted,0.5,1,1,TCGTAACGTTGTTCCTATGA,0,5266824
zapB_predicted,0.5,1,1,TCGGGGTTGCGTACTCGGCA,0,5287941
zapB_predicted,0.5,1,1,TCGGGGTGCGCTACGGGTGG,0,5280293
zapB_predicted,0.5,1,1,TCGGGGCACCACACTGCACA,0,5263928
zapB_predicted,0.5,1,1,TCGGGCGATGGGCGTATAGC,0,5269298
zapB_predicted,0.5,1,1,TCGGCCACATTCTTGACCAG,0,5275282
zapB_predicted,0.5,1,1,TCGCGGGAATGTGTGCGGAC,0,5281326
zapB_predicted,0.5,1,1,TCGCAAAGGTCCCAAGCCCA,0,5267094
zapB_predicted,0.5,1,1,TCGATGTGCATCATATAGTG,0,5275149
zapB_predicted,0.5,1,1,TCGATCCGTGAGACGGAAGA,0,5286201
zapB_predicted,0.5,1,1,TCGATCAGGGTGTTGGGCTA,0,5277494
zapB_predicted,0.5,1,1,TCGATAGTCTAGTCTCTAAT,0,5266669
zapB_predicted,0.5,1,1,TCGATACACATAAAGCCCCT,0,5267599
zapB_predicted,0.5,1,1,TCGACGGACGTTAGATTAAC,0,5283352
zapB_predicted,0.5,1,1,TCGACCTGCTCTACGAGTTA,0,5272918
zapB_predicted,0.5,1,1,TCGAATGAGCAGCGGACGTA,0,5268057
zapB_predicted,0.5,1,1,TCGAAGTGCGACGTCGTTCG,0,5276149
zapB_predicted,0.5,1,1,TCCTTTGTCATTTTAGACTA,0,5276886
zapB_predicted,0.5,1,1,TCCTGCGCTTTGAAAGAGTC,0,5263884
zapB_predicted,0.5,1,1,TCCGGTCCGGGTAATGACTG,0,5274822
zapB_predicted,0.5,1,1,TCCGGGAGTGTTCAGGGAGC,0,5276802
zapB_predicted,0.5,1,1,TCCGGCGCCAGCGTGTGGGG,0,5286010
zapB_predicted,0.5,1,1,TCCGCGCTCCACTTCTCTGT,0,5269846
zapB_predicted,0.5,1,1,TCCCTGGAAATATTTTCATA,0,5273427
zapB_predicted,0.5,1,1,TCCCTGCGTCTGTAATTATC,0,5263145
zapB_predicted,0.5,1,1,TCCCGAATATTCGACTGAGC,0,5286139
zapB_predicted,0.5,1,1,TCCCCACTGGAACATATCAA,0,5283407
zapB_predicted,0.5,1,1,TCCCAATCCGAACCCTCACG,0,5286247
zapB_predicted,0.5,1,1,TCCATTCAACAGCTTGGCGA,0,5265719
zapB_predicted,0.5,1,1,TCCAGAGGAGCGGTTTTCGT,0,5286532
zapB_predicted,0.5,1,1,TCCACCATGGCGATGCTATT,0,5286272
zapB_predicted,0.5,1,1,TCCACCAGGTCAACGACGAC,0,5287236
zapB_predicted,0.5,1,1,TCCAATGTTAAGCAAACGCC,0,5269516
zapB_predicted,0.5,1,1,TCCAACTTTGGATGACATAG,0,5283799
zapB_predicted,0.5,1,1,TCATTAGGCTGGGGTTCTCT,0,5285716
zapB_predicted,0.5,1,1,TCATTAGACTGTCAGATATA,0,5287595
zapB_predicted,0.5,1,1,TCATCTAGAGGACTGATGCC,0,5279402
zapB_predicted,0.5,1,1,TCATATGCTAGCTTGGCCAA,0,5285654
zapB_predicted,0.5,1,1,TCATATCTGCCCTCGAACTA,0,5276578
zapB_predicted,0.5,1,1,TCATACGAACCAACAACTTG,0,5282889
zapB_predicted,0.5,1,1,TCAGTTTCAAGGTGTGTTAG,0,5281035
zapB_predicted,0.5,1,1,TCAGTGGTGAGAGAGTATCT,0,5273942
zapB_predicted,0.5,1,1,TCAGTCCGATTGTCCGCCGA,0,5274479
zapB_predicted,0.5,1,1,TCAGCTTAATCTTGCCCCGT,0,5263024
zapB_predicted,0.5,1,1,TCACCGAAATCGTATGATAA,0,5279888
zapB_predicted,0.5,1,1,TCACAACAATGTCAACGAGC,0,5270100
zapB_predicted,0.5,1,1,TCAATGTGAGACAGCCGCTA,0,5287727
zapB_predicted,0.5,1,1,TCAATACCCTTGTGACACCC,0,5280178
zapB_predicted,0.5,1,1,TCAACCTGTACAGCTAGCCT,0,5264765
zapB_predicted,0.5,1,1,TCAAATCCGGAGTCTTATGT,0,5268950
zapB_predicted,0.5,1,1,TCAAAGCCAGTCACGGGTCT,0,5280662
zapB_predicted,0.5,1,1,TATTTCGTCTTAAAGTATCT,0,5269913
zapB_predicted,0.5,1,1,TATTCGGACACTGTATTCCT,0,5277035
zapB_predicted,0.5,1,1,TATGCTGACCGACGGACGGT,0,5269442
zapB_predicted,0.5,1,1,TATGACCCGCCATAACTTGG,0,5276066
zapB_predicted,0.5,1,1,TATGAACTAACCCGTACGTT,0,5282804
zapB_predicted,0.5,1,1,TATCTGCCTCGCGTTGAGGT,0,5275806
zapB_predicted,0.5,1,1,TATCGCTGTCCTGATAGGTA,0,5273721
zapB_predicted,0.5,1,1,TATCCGGGAAACTCCAGCCA,0,5270561
zapB_predicted,0.5,1,1,TATATCCTAGATCGACGAGG,0,5283389
zapB_predicted,0.5,1,1,TAGTTTTCCATCACCAATAG,0,5271636
zapB_predicted,0.5,1,1,TAGGTGCACAATTAACGTTG,0,5269923
zapB_predicted,0.5,1,1,TAGGGAGACTGGGTCACTGT,0,5274886
zapB_predicted,0.5,1,1,TAGGCTCCGATTATTAGTAC,0,5275896
zapB_predicted,0.5,1,1,TAGGCAAGTTCCCCTTGCAG,0,5282414
zapB_predicted,0.5,1,1,TAGCTTGCGTCACGTAGGTC,0,5273055
zapB_predicted,0.5,1,1,TAGCTCGAGTAGCCGGCGGC,0,5281651
zapB_predicted,0.5,1,1,TAGCCGCGCAAATTTATTGT,0,5266142
zapB_predicted,0.5,1,1,TAGCCGACCGCATCACGCTA,0,5285835
zapB_predicted,0.5,1,1,TAGCAAGAGTGGGCCTGGAT,0,5285922
zapB_predicted,0.5,1,1,TAGAGCTCGGCTAATGTCCT,0,5281165
zapB_predicted,0.5,1,1,TACTCTCTAGCAGGCTAGGT,0,5268858
zapB_predicted,0.5,1,1,TACTCAGTGTGGGGTGTGTG,0,5279691
zapB_predicted,0.5,1,1,TACTAGGAGCAACGGTAAAC,0,5267502
zapB_predicted,0.5,1,1,TACGTTCTTTCATGTACGCG,0,5276023
zapB_predicted,0.5,1,1,TACGTGAGGCGGCCCATTAC,0,5286980
zapB_predicted,0.5,1,1,TACCGGGTCTGTAACGCGTT,0,5286591
zapB_predicted,0.5,1,1,TACAGGAGCAATGCCACGAA,0,5272026
zapB_predicted,0.5,1,1,TACAGGACCTACCTTACACC,0,5281088
zapB_predicted,0.5,1,1,TACACACGTACATGGTTACA,0,5274114
zapB_predicted,0.5,1,1,TACAATGATATGGACCTTAA,0,5271677
zapB_predicted,0.5,1,1,TAATCAGTTCACAGGGTTAC,0,5283214
zapB_predicted,0.5,1,1,TAAGCGCCTATACTTCGGAT,0,5283678
zapB_predicted,0.5,1,1,TAAGCCGGGCATGTACTCCT,0,5273256
zapB_predicted,0.5,1,1,TAAGCCCCTGAGAGTATGGC,0,5282820
zapB_predicted,0.5,1,1,TAAGATGTCTGTGTTAGTTC,0,5285518
zapB_predicted,0.5,1,1,TAACTTATGTATGACATCCT,0,5278687
zapB_predicted,0.5,1,1,TAACGTCGTCTTCTTACTTT,0,5282784
zapB_predicted,0.5,1,1,TAACGGGCTCGGCTAGTTTA,0,5278568
zapB_predicted,0.5,1,1,TAACGATGTCGGGAGCAGTA,0,5281513
zapB_predicted,0.5,1,1,TAAACTCGAGGAGCTGTGAA,0,5283919
zapB_predicted,0.5,1,1,TAAACTCCATATTTTGACTG,0,5280269
zapB_predicted,0.5,1,1,TAAACCCAACACAATTGCTC,0,5277114
zapB_predicted,0.5,1,1,TAAAAACGTGTTAACTCTCT,0,5276762
zapB_predicted,0.5,1,1,GTTTTGGTGTTGCGAACGTT,0,5268787
zapB_predicted,0.5,1,1,GTTTGTCTATGTTGGACTAG,0,5280796
zapB_predicted,0.5,1,1,GTTTGGATTCTAAATTTGAT,0,5276569
zapB_predicted,0.5,1,1,GTTTGAGCATCTCGGCGCTT,0,5284698
zapB_predicted,0.5,1,1,GTTTCCGTCCAAATTCAAAA,0,5282858
zapB_predicted,0.5,1,1,GTTTATCTCTCTCGTATTGG,0,5284754
zapB_predicted,0.5,1,1,GTTGGTCTCGGAAGTCGGGA,0,5264544
zapB_predicted,0.5,1,1,GTTGCATCTTAATGAACTTT,0,5276642
zapB_predicted,0.5,1,1,GTTGCACTTATGCACAGTTC,0,5273085
zapB_predicted,0.5,1,1,GTTGACAGCTAGCTCATCCA,0,5286646
zapB_predicted,0.5,1,1,GTTGAACATAAAGCGTCGTC,0,5278900
zapB_predicted,0.5,1,1,GTTCCTTATCTCCCGGAGAA,0,5287471
zapB_predicted,0.5,1,1,GTTCCCGGAATAAGAAATCA,0,5285285
zapB_predicted,0.5,1,1,GTTATGTTTCTCGCTATGAT,0,5284824
zapB_predicted,0.5,1,1,GTTATGGCGCTCCCCAGCGC,0,5263675
zapB_predicted,0.5,1,1,GTTACCAAGCCCAAGAGCCT,0,5265326
zapB_predicted,0.5,1,1,GTTAAACGCAAGTCCGCCGT,0,5271850
zapB_predicted,0.5,1,1,GTGTTATGAAAAGGGGGCAA,0,5279045
zapB_predicted,0.5,1,1,GTGTGGTCATCCTTCTCAAC,0,5273156
zapB_predicted,0.5,1,1,GTGTCAGTCCGTTGCCCCAT,0,5275430
zapB_predicted,0.5,1,1,GTGGTCGATAGTTTGGCAAT,0,5273603
zapB_predicted,0.5,1,1,GTGGGTGGTAAAATGTTGGA,0,5268011
zapB_predicted,0.5,1,1,GTGGCTATTTAGGTTCATTG,0,5272735
zapB_predicted,0.5,1,1,GTGGCGCAGGCCTGGCGTGG,0,5284019
zapB_predicted,0.5,1,1,GTGCTGGAGAACACTATGCG,0,5271433
zapB_predicted,0.5,1,1,GTGCGCATTCCCCGAGAGGG,0,5283857
zapB_predicted,0.5,1,1,GTGCCTCGTGACTGGCGCCA,0,5269558
zapB_predicted,0.5,1,1,GTGCCCCAGCAAGTGATGGC,0,5284314
zapB_predicted,0.5,1,1,GTGCCACCGCTTCTCGTAAC,0,5285685
zapB_predicted,0.5,1,1,GTGCACGAAGGCCGGGGGCG,0,5281090
zapB_predicted,0.5,1,1,GTGATTCCGTGCAAGAGGCA,0,5266259
zapB_predicted,0.5,1,1,GTGAGGTTTCGCAGTTAAGT,0,5284657
zapB_predicted,0.5,1,1,GTGACAGCCAATGAATATCG,0,5270720
zapB_predicted,0.5,1,1,GTGAACTGGATTGGTACCTG,0,5271453
zapB_predicted,0.5,1,1,GTCTTGGATCTATGCAACTT,0,5271158
zapB_predicted,0.5,1,1,GTCTGTCTATCGACGCTCCG,0,5277755
zapB_predicted,0.5,1,1,GTCTCCGGTGTATAGCTCTC,0,5276584
zapB_predicted,0.5,1,1,GTCTAGTGGCAATGTGGAAT,0,5266975
zapB_predicted,0.5,1,1,GTCGTCAGAACAAAGTTGCA,0,5273778
zapB_predicted,0.5,1,1,GTCGTAGACACATCATCTAC,0,5279978
zapB_predicted,0.5,1,1,GTCGGGCGAAGTCAATCTAA,0,5269226
zapB_predicted,0.5,1,1,GTCGGCTCTTGGGGTGCGCA,0,5278613
zapB_predicted,0.5,1,1,GTCGCTGGAAAACGCAAAGG,0,5278553
zapB_predicted,0.5,1,1,GTCGAAGTAACTCGCGTCGG,0,5280943
zapB_predicted,0.5,1,1,GTCCTCTCAACTTTTAGTCG,0,5276844
zapB_predicted,0.5,1,1,GTCCCGGCGAACAAATTCTC,0,5266388
zapB_predicted,0.5,1,1,GTCCACCGCAAACAGAACTT,0,5276867
zapB_predicted,0.5,1,1,GTCCAATTAGGCTGATTTCA,0,5274910
zapB_predicted,0.5,1,1,GTCATGACGTGCGCACTAGC,0,5270510
zapB_predicted,0.5,1,1,GTCATATTCTAGGTTATGTC,0,5288150
zapB_predicted,0.5,1,1,GTCAGGCCTTCGATACAAAA,0,5281842
zapB_predicted,0.5,1,1,GTCAGCTAATAGGCGCTTAT,0,5277467
zapB_predicted,0.5,1,1,GTCACGCCGTTATTCCACGT,0,5285050
zapB_predicted,0.5,1,1,GTCAATCCCGTGCCTGCTCC,0,5276788
zapB_predicted,0.5,1,1,GTCAAAGTAGTGTGATGTGG,0,5287479
zapB_predicted,0.5,1,1,GTATTGCGTGGTGGTAGAAT,0,5268997
zapB_predicted,0.5,1,1,GTATAAGACCATGTAACCTC,0,5268954
zapB_predicted,0.5,1,1,GTAGTGTTGTCGAGCCACTG,0,5263035
zapB_predicted,0.5,1,1,GTAGATCGTCCTCGTTTAGG,0,5269305
zapB_predicted,0.5,1,1,GTAGAAATTAGGACTAGGGA,0,5264291
zapB_predicted,0.5,1,1,GTACTTTCCAATTTTGTATT,0,5271018
zapB_predicted,0.5,1,1,GTACGTAGCTGACATATATC,0,5286184
zapB_predicted,0.5,1,1,GTACGGGTCTTCTTTTCCTA,0,5269184
zapB_predicted,0.5,1,1,GTACCTTTTCTGGGGAAGCG,0,5267982
zapB_predicted,0.5,1,1,GTACCGCCAGTATTGAGAGA,0,5280563
zapB_predicted,0.5,1,1,GTACCGACACGAACTTCAAC,0,5265919
zapB_predicted,0.5,1,1,GTAAGAGGGGGCGGTACGGG,0,5278795
zapB_predicted,0.5,1,1,GTAACGGTACTTGCAGGGTG,0,5286853
zapB_predicted,0.5,1,1,GTAAAACGTGCGTACAACGG,0,5276650
zapB_predicted,0.5,1,1,GGTTTGGTCCAGATTTCTTC,0,5275418
zapB_predicted,0.5,1,1,GGTTTGGGCAGTGGGTTCTA,0,5280144
zapB_predicted,0.5,1,1,GGTTTACAGGCTCCTAGTAT,0,5288277
zapB_predicted,0.5,1,1,GGTTCCCGCGGGCTTCATTA,0,5282887
zapB_predicted,0.5,1,1,GGTTCATGTCACGGAATTTG,0,5264972
zapB_predicted,0.5,1,1,GGTTAGTGTACCACCACCGT,0,5275014
zapB_predicted,0.5,1,1,GGTGTTACCAGGGTATTCAT,0,5271748
zapB_predicted,0.5,1,1,GGTGTCGTTTAGCAACAGGC,0,5270026
zapB_predicted,0.5,1,1,GGTGGTTGATTGTCGGAAGG,0,5272525
zapB_predicted,0.5,1,1,GGTGGGTGCAAGCGCGTAGT,0,5271414
zapB_predicted,0.5,1,1,GGTGGGATGTGTGAGGGCAT,0,5283187
zapB_predicted,0.5,1,1,GGTGGCTTTCCGGCATTGCC,0,5284093
zapB_predicted,0.5,1,1,GGTGCATCGCAAGAATGTTG,0,5269208
zapB_predicted,0.5,1,1,GGTCGATCCCTCTACATCAG,0,5280312
zapB_predicted,0.5,1,1,GGTAGGCTACTCACGCGGAG,0,5273268
zapB_predicted,0.5,1,1,GGTACGCAGCAAGAGTGTAA,0,5266063
zapB_predicted,0.5,1,1,GGTAAGGATTCAGGTAGGAG,0,5279625
zapB_predicted,0.5,1,1,GGGTGCTCACGGCACTATGG,0,5277732
zapB_predicted,0.5,1,1,GGGTCCTTTAACTCTATCAT,0,5273464
zapB_predicted,0.5,1,1,GGGTCATTCTCTTCAAGGGG,0,5265324
zapB_predicted,0.5,1,1,GGGTAGGTGCGGAAAACCAG,0,5275269
zapB_predicted,0.5,1,1,GGGGAACCCACGATTAGAAT,0,5264746
zapB_predicted,0.5,1,1,GGGCCGACCGAAGCACATAG,0,5276018
zapB_predicted,0.5,1,1,GGGCAGCTTGTTGCATTTGG,0,5281105
zapB_predicted,0.5,1,1,GGGATTAATCATGGTATGTC,0,5272659
zapB_predicted,0.5,1,1,GGGATACCGCCCAGCAAGTG,0,5283426
zapB_predicted,0.5,1,1,GGGAGTACCCGAAATGTCTA,0,5283151
zapB_predicted,0.5,1,1,GGGACTCCATGTGTTGTTAT,0,5269545
zapB_predicted,0.5,1,1,GGGAAATGCACCAATCCCCG,0,5287759
zapB_predicted,0.5,1,1,GGGAAAGCCACAGATCCTAT,0,5271162
zapB_predicted,0.5,1,1,GGCTGTCGAGGGATTTTTCT,0,5269389
zapB_predicted,0.5,1,1,GGCTCCTCTGGTACTATTTC,0,5279557
zapB_predicted,0.5,1,1,GGCTCAAGGTCAGGTTGGTT,0,5271213
zapB_predicted,0.5,1,1,GGCGGGCGTCATAGAGGAAA,0,5267035
zapB_predicted,0.5,1,1,GGCGCCCACATCGAGAGTAT,0,5282208
zapB_predicted,0.5,1,1,GGCGATACCCTCGGTTTGTG,0,5272112
zapB_predicted,0.5,1,1,GGCCTTATATGTGAGGGCGA,0,5273234
zapB_predicted,0.5,1,1,GGCCTACTAATAGACCCCCA,0,5267562
zapB_predicted,0.5,1,1,GGCCTACATCACCTGCGTGC,0,5269071
zapB_predicted,0.5,1,1,GGCCCCGACTGGGTCGCATT,0,5277533
zapB_predicted,0.5,1,1,GGCCAGCTGGTCATTGCTCC,0,5266132
zapB_predicted,0.5,1,1,GGCAATTAGCACTAAGCTGT,0,5285056
zapB_predicted,0.5,1,1,GGCAAGAGTCGCGGGACAGG,0,5280465
zapB_predicted,0.5,1,1,GGCAAACTTGACGGGTTAAT,0,5278062
zapB_predicted,0.5,1,1,GGATTGAATCGAAGCCGTAG,0,5273008
zapB_predicted,0.5,1,1,GGATTATCGCAGTATGCAGC,0,5264928
zapB_predicted,0.5,1,1,GGATCCTAGACGACAGCAGT,0,5265859
zapB_predicted,0.5,1,1,GGATCAAAACCCAGGTGTAC,0,5276825
zapB_predicted,0.5,1,1,GGATAGAGGCTCTGATTAAA,0,5275325
zapB_predicted,0.5,1,1,GGAGTCAGCCTCACCTGCGA,0,5264650
zapB_predicted,0.5,1,1,GGAGTATGGTCTACTGGGTC,0,5276855
zapB_predicted,0.5,1,1,GGAGGGAAATGTATCAAGAC,0,5270556
zapB_predicted,0.5,1,1,GGAGGCGGTAGTAATGTTAC,0,5267200
zapB_predicted,0.5,1,1,GGAGGACCCTCCCGGGCGGC,0,5283102
zapB_predicted,0.5,1,1,GGAGAGATTATGGGGGAGAT,0,5279476
zapB_predicted,0.5,1,1,GGACCCCGCCAGTCCATGTC,0,5272762
zapB_predicted,0.5,1,1,GGACCATCGTGATCGACTCT,0,5269744
zapB_predicted,0.5,1,1,GGAAGATAAAATCCACGGGT,0,5269219
zapB_predicted,0.5,1,1,GGAACGTCCCACGCGTACAG,0,5267010
zapB_predicted,0.5,1,1,GCTTTTGAATAGTAACCCAT,0,5275962
zapB_predicted,0.5,1,1,GCTTGTTGCATGCAATCCAA,0,5278370
zapB_predicted,0.5,1,1,GCTTCGGCGCTATGACTCGA,0,5286378
zapB_predicted,0.5,1,1,GCTTAAGGATACGGCAAGCG,0,5273269
zapB_predicted,0.5,1,1,GCTGGATCAATGGCTTGCTC,0,5287772
zapB_predicted,0.5,1,1,GCTGCGGGTCCAGTAGCGTC,0,5287553
zapB_predicted,0.5,1,1,GCTGAGCAGTCATCCTCGCC,0,5284379
zapB_predicted,0.5,1,1,GCTCTGGAAAGAGCTACGTG,0,5287331
zapB_predicted,0.5,1,1,GCTCGTTCAATATCAGGGGT,0,5275513
zapB_predicted,0.5,1,1,GCTCGCCATTGAACGATGAG,0,5283189
zapB_predicted,0.5,1,1,GCTCGCAGCAGGAACTTACT,0,5273321
zapB_predicted,0.5,1,1,GCTCCGTGTCTCTTCAGTCC,0,5285128
zapB_predicted,0.5,1,1,GCTCATTGCCGGCCGTCCAT,0,5264725
zapB_predicted,0.5,1,1,GCTATCAGTTTCCTTATGTA,0,5286385
zapB_predicted,0.5,1,1,GCTATATGATTCGGCTATTC,0,5264281
zapB_predicted,0.5,1,1,GCTAGTGCCTGGACCACATA,0,5287503
zapB_predicted,0.5,1,1,GCTACAGAGCTCTAGCGAAC,0,5271976
zapB_predicted,0.5,1,1,GCTAATGCAGATTGTTCTAA,0,5264898
zapB_predicted,0.5,1,1,GCTAACGATTTGCTTCGCTA,0,5281196
zapB_predicted,0.5,1,1,GCGTTGCTGCAAGTGTGCCG,0,5272552
zapB_predicted,0.5,1,1,GCGTGGTAAGTTTTTACTTA,0,5287916
zapB_predicted,0.5,1,1,GCGTGGGTGAGCGTCAATGA,0,5284731
zapB_predicted,0.5,1,1,GCGTGATATTTATCTTGTTG,0,5263541
zapB_predicted,0.5,1,1,GCGTGATATGTTCCTCAATC,0,5264973
zapB_predicted,0.5,1,1,GCGTGACGGCGACTGTTGGG,0,5279836
zapB_predicted,0.5,1,1,GCGTCGTACGCCTTCTGAAT,0,5269300
zapB_predicted,0.5,1,1,GCGTAGTGAGTCTAAACCCA,0,5288264
zapB_predicted,0.5,1,1,GCGGGTCGTCTTTGACTTGA,0,5267647
zapB_predicted,0.5,1,1,GCGGCGTCTTAGAATTTCCC,0,5263754
zapB_predicted,0.5,1,1,GCGGACAGCCGTTCCAAGAC,0,5270620
zapB_predicted,0.5,1,1,GCGCCGCAATGTATTTTTTA,0,5277332
zapB_predicted,0.5,1,1,GCGCCCGCAATCTGGTACCT,0,5280785
zapB_predicted,0.5,1,1,GCGCCAATACTGGTTCTTGG,0,5271903
zapB_predicted,0.5,1,1,GCGCATCCTCGCTCGGCCCG,0,5287358
zapB_predicted,0.5,1,1,GCGCAGCTCTTAAAGGCTCG,0,5265981
zapB_predicted,0.5,1,1,GCGCAGAGCCGAGTTCCCTC,0,5271999
zapB_predicted,0.5,1,1,GCGACAGATAAAAATTCCTT,0,5277199
zapB_predicted,0.5,1,1,GCGAACTGGATCATCGTCTG,0,5276138
zapB_predicted,0.5,1,1,GCGAACCTCTAGAAACCTTC,0,5264711
zapB_predicted,0.5,1,1,GCCTGTTAAGGACCTTATAA,0,5273220
zapB_predicted,0.5,1,1,GCCTGAAGAACATTCAGCTT,0,5265967
zapB_predicted,0.5,1,1,GCCTCCCGGAACCGTGGCAT,0,5274186
zapB_predicted,0.5,1,1,GCCGTGCCTAAGAACCGAGT,0,5269006
zapB_predicted,0.5,1,1,GCCGTCGCTATGCAGTATAA,0,5276247
zapB_predicted,0.5,1,1,GCCGCGATCACCTGTCGCTT,0,5269836
zapB_predicted,0.5,1,1,GCCGCCATTTATTCAACTTC,0,5280713
zapB_predicted,0.5,1,1,GCCCGACTTATTAGAGACTA,0,5269248
zapB_predicted,0.5,1,1,GCCCGACTGGTTCATAACCT,0,5282577
zapB_predicted,0.5,1,1,GCCCAACTTACGCAGCTGAA,0,5267354
zapB_predicted,0.5,1,1,GCCATACGTACATAGCAAGT,0,5281732
zapB_predicted,0.5,1,1,GCCAGGTAATGTAGGGTGTA,0,5269287
zapB_predicted,0.5,1,1,GCCAGGACATGGCCGTCGTG,0,5276225
zapB_predicted,0.5,1,1,GCCAGCCTCGGAGACTCAAG,0,5283545
zapB_predicted,0.5,1,1,GCCAGCATAAAACGACTTAG,0,5263337
zapB_predicted,0.5,1,1,GCCACGGCACGTGACCTCAC,0,5265961
zapB_predicted,0.5,1,1,GCATTTTAAGGCGATACGTG,0,5266804
zapB_predicted,0.5,1,1,GCATTCCTCTGTGTCATAAT,0,5284387
zapB_predicted,0.5,1,1,GCATCTGACCGGAGTCAGGT,0,5282080
zapB_predicted,0.5,1,1,GCATCTCACACGCGCAACAG,0,5281997
zapB_predicted,0.5,1,1,GCATCGTCGGGTACGGCTTT,0,5268467
zapB_predicted,0.5,1,1,GCATAGCCAAGTCGAACTTT,0,5280477
zapB_predicted,0.5,1,1,GCATAAATGGCAGGTTCAAC,0,5278971
zapB_predicted,0.5,1,1,GCAGTTAACGTTCGAGAGAT,0,5287258
zapB_predicted,0.5,1,1,GCAGGACTTTGAGAGTCCGT,0,5277265
zapB_predicted,0.5,1,1,GCAGCGGCACACAGTTATGG,0,5266878
zapB_predicted,0.5,1,1,GCAGCCAATTCAGTCATTGT,0,5269379
zapB_predicted,0.5,1,1,GCAGCCAACCTACGAGGTGG,0,5275048
zapB_predicted,0.5,1,1,GCACGTTCGAGTCTCGGAGG,0,5277142
zapB_predicted,0.5,1,1,GCAACTGTGGTCGAAAGTGT,0,5274013
zapB_predicted,0.5,1,1,GCAACTAGCTTTATCGGAGG,0,5265579
zapB_predicted,0.5,1,1,GCAACGTCCTAGTCAGGCGT,0,5263197
zapB_predicted,0.5,1,1,GCAAAGGGTGCTCGGGTAGT,0,5275769
zapB_predicted,0.5,1,1,GCAAAATGGCTCCCAGTATG,0,5272331
zapB_predicted,0.5,1,1,GATTTACGGCACCATATCAA,0,5282154
zapB_predicted,0.5,1,1,GATTGTGGCCTTCGTCAGGT,0,5265216
zapB_predicted,0.5,1,1,GATTCTGGGATTCGCTGAGG,0,5287223
zapB_predicted,0.5,1,1,GATTCAACAATAGCTGTCCA,0,5264867
zapB_predicted,0.5,1,1,GATTACGCGGGGTTCTATCC,0,5276373
zapB_predicted,0.5,1,1,GATGTTTTTAACTAACGTCT,0,5273794
zapB_predicted,0.5,1,1,GATGGAGGAAAGCGTACGTT,0,5279712
zapB_predicted,0.5,1,1,GATGCGACCATAGATTCTGA,0,5279348
zapB_predicted,0.5,1,1,GATCTTGGTCGGTATGAGGT,0,5266231
zapB_predicted,0.5,1,1,GATCGCTTGTCATGGTCAGC,0,5266601
zapB_predicted,0.5,1,1,GATCGCGTATGTGGACGTAC,0,5271460
zapB_predicted,0.5,1,1,GATCGACCGCCCCGCCCGCC,0,5272569
zapB_predicted,0.5,1,1,GATCGAAAAAAGTTCCCTGG,0,5276140
zapB_predicted,0.5,1,1,GATATGTCGCAATAGGTTAA,0,5279731
zapB_predicted,0.5,1,1,GATATGGGTAGACGTTCGAG,0,5286987
zapB_predicted,0.5,1,1,GATAACGCTTATTGCTCCGC,0,5271272
zapB_predicted,0.5,1,1,GATAAACGGGAAAATGCGAA,0,5275039
zapB_predicted,0.5,1,1,GAGTTGCCGTATTTCTGTAT,0,5282491
zapB_predicted,0.5,1,1,GAGTGTCTGAGGCACATTGC,0,5271057
zapB_predicted,0.5,1,1,GAGTCTCCCCTGGCTCAGGC,0,5264318
zapB_predicted,0.5,1,1,GAGTCTACGCCGGCCCTGAG,0,5281226
zapB_predicted,0.5,1,1,GAGTCATAGGGAGGCAACTG,0,5265270
zapB_predicted,0.5,1,1,GAGGCCAAGGGTATACAAGT,0,5265337
zapB_predicted,0.5,1,1,GAGCGTGATTTGAGATCCCA,0,5278801
zapB_predicted,0.5,1,1,GAGAGGATAGCATCAGAAGA,0,5270146
zapB_predicted,0.5,1,1,GAGACACCTTTAAACGCGAC,0,5263915
zapB_predicted,0.5,1,1,GACTCGAAGGCCGTTGGATG,0,5275120
zapB_predicted,0.5,1,1,GACTAGCTGCTTTTGGTATA,0,5282805
zapB_predicted,0.5,1,1,GACTAGATTCTTTATGTGCA,0,5282372
zapB_predicted,0.5,1,1,GACTACTATTGCAGCGAAAT,0,5287248
zapB_predicted,0.5,1,1,GACGGGTGTGGCGGAGGCAG,0,5279548
zapB_predicted,0.5,1,1,GACGCAGTAGGTCAGTTAAG,0,5285988
zapB_predicted,0.5,1,1,GACGACTAAGAAACCCATCA,0,5264858
zapB_predicted,0.5,1,1,GACGAACGTAACGTTTACCT,0,5274333
zapB_predicted,0.5,1,1,GACCTCAACATCTGGTATTA,0,5283403
zapB_predicted,0.5,1,1,GACCGTCCCATGGGGAAGGC,0,5278433
zapB_predicted,0.5,1,1,GACCGTACATCCATTAAGGG,0,5284584
zapB_predicted,0.5,1,1,GACCGATCCGCCGCAAGGAG,0,5269932
zapB_predicted,0.5,1,1,GACCCAGGTCTCATTTCCAA,0,5280480
zapB_predicted,0.5,1,1,GACCACGGTCATCTCGCCTT,0,5278344
zapB_predicted,0.5,1,1,GACCACCCAGTTTATCTGGG,0,5270076
zapB_predicted,0.5,1,1,GACCAATTAAAGAGGGCATT,0,5268444
zapB_predicted,0.5,1,1,GACATTATGCGGAATTTTGC,0,5264467
zapB_predicted,0.5,1,1,GACACCACAGCACACAGCGA,0,5271227
zapB_predicted,0.5,1,1,GACAAGCTTATGGGTACCGC,0,5268411
zapB_predicted,0.5,1,1,GAATCTGTCCTTGGCCAGGA,0,5265490
zapB_predicted,0.5,1,1,GAATACAGTCAGAGGTCAAT,0,5284661
zapB_predicted,0.5,1,1,GAAGTTTGCTTGGGCAAGCC,0,5285500
zapB_predicted,0.5,1,1,GAAGCGTTCAATATTCGTCT,0,5282271
zapB_predicted,0.5,1,1,GAACGACACAGCACCTGCAG,0,5271952
zapB_predicted,0.5,1,1,GAACCCGGAATCTTACTATA,0,5270900
zapB_predicted,0.5,1,1,GAAATGAGTTAGATTGGCGC,0,5284023
zapB_predicted,0.5,1,1,GAAATAGACGGTAGCGAGAA,0,5273485
zapB_predicted,0.5,1,1,GAAACCCTAAAAGGGTGGTA,0,5272089
zapB_predicted,0.5,1,1,GAAAACCATACGGCTTTGGT,0,5287785
zapB_predicted,0.5,1,1,CTTTGTGTGGGTCTTTATAA,0,5266695
zapB_predicted,0.5,1,1,CTTTGTGAAATAGCTTGCAG,0,5270102
zapB_predicted,0.5,1,1,CTTTGAAAGGGAAGGTCGGA,0,5269253
zapB_predicted,0.5,1,1,CTTTCGTCTCCATAGCGAGT,0,5272960
zapB_predicted,0.5,1,1,CTTTCATACCCGCATTAAGG,0,5286928
zapB_predicted,0.5,1,1,CTTTATTTTTTAATAAAGAC,0,5283164
zapB_predicted,0.5,1,1,CTTGTGAGATATCGATCCGG,0,5282636
zapB_predicted,0.5,1,1,CTTGGGTATGTCAGGAGGCA,0,5264653
zapB_predicted,0.5,1,1,CTTCTTACCGACGTACTATA,0,5268285
zapB_predicted,0.5,1,1,CTTCTGCGATACCGCGTGAG,0,5281812
zapB_predicted,0.5,1,1,CTTCTGCCGACGCATGGGCT,0,5282104
zapB_predicted,0.5,1,1,CTTCTGCCCGAGGCAAATTA,0,5274224
zapB_predicted,0.5,1,1,CTTCTACGGAAAACGCACAG,0,5267455
zapB_predicted,0.5,1,1,CTTCGTTGTTGGTCCTGATT,0,5275237
zapB_predicted,0.5,1,1,CTTCCCTCCGAAGGTCACAT,0,5283795
zapB_predicted,0.5,1,1,CTTACTAGGCACCTAAGTCA,0,5284997
zapB_predicted,0.5,1,1,CTTACGCGGGACATTACCTC,0,5268949
zapB_predicted,0.5,1,1,CTTAAGATGAACCCCCGACG,0,5264642
zapB_predicted,0.5,1,1,CTGTTTGTGAAGACAAATGT,0,5264907
zapB_predicted,0.5,1,1,CTGTTGTGCCGAAATGTGTA,0,5277501
zapB_predicted,0.5,1,1,CTGTGTAGGGCTTGATGCCT,0,5279097
zapB_predicted,0.5,1,1,CTGTGCGAATGGCTAATCTG,0,5282900
zapB_predicted,0.5,1,1,CTGGTGCTTCATATTGAGGG,0,5282710
zapB_predicted,0.5,1,1,CTGGGGCATCCGCATGCGGA,0,5280706
zapB_predicted,0.5,1,1,CTGGGATTAGGCAGCATATT,0,5277384
zapB_predicted,0.5,1,1,CTGCTTCCTAGCGATGCCGG,0,5268178
zapB_predicted,0.5,1,1,CTGCGCGAGATATACTTGTA,0,5272526
zapB_predicted,0.5,1,1,CTGCCATATCCATTTTTAAT,0,5267515
zapB_predicted,0.5,1,1,CTGCAGACCGTGCCCCAGCG,0,5263449
zapB_predicted,0.5,1,1,CTGATACGCGAGTAGATGAA,0,5280028
zapB_predicted,0.5,1,1,CTGAGGCAGGCCCAACCTAC,0,5277074
zapB_predicted,0.5,1,1,CTCGAGAGCCGCACAGGAGC,0,5272634
zapB_predicted,0.5,1,1,CTCAGACACCCCGTCCCTCC,0,5278408
zapB_predicted,0.5,1,1,CTCACTCGGTTGGCGCGTAC,0,5287427
zapB_predicted,0.5,1,1,CTATTGTACGCTGGTCGATC,0,5283158
zapB_predicted,0.5,1,1,CTATGTTAGAATCGCCGTAC,0,5286629
zapB_predicted,0.5,1,1,CTATGCTCTACAATTATATG,0,5277564
zapB_predicted,0.5,1,1,CTATCTATATGTCTGGGTAA,0,5273727
zapB_predicted,0.5,1,1,CTAGTTTCCGTCTCTCTTAC,0,5273106
zapB_predicted,0.5,1,1,CTAGTGGGTGCAGCGGGATT,0,5268898
zapB_predicted,0.5,1,1,CTAGCGATTATTGCCCGTTC,0,5263448
zapB_predicted,0.5,1,1,CTAGATAGCAGCGTATCGGA,0,5269824
zapB_predicted,0.5,1,1,CTAGAGTCCGTGGTCACAGG,0,5276538
zapB_predicted,0.5,1,1,CTAGACTCCCCCCTGGCGTA,0,5283081
zapB_predicted,0.5,1,1,CTACTGCAGAATCCTTCACT,0,5282689
zapB_predicted,0.5,1,1,CTACCGCAGTCTAAATTTCC,0,5281656
zapB_predicted,0.5,1,1,CTACACAGGCACACGCTAGT,0,5277831
zapB_predicted,0.5,1,1,CTACAAGGGTTTGCAGCATT,0,5269644
zapB_predicted,0.5,1,1,CTAAGGACGACCGATCTTTA,0,5288327
zapB_predicted,0.5,1,1,CTAAGGACACGCGGAGGGTT,0,5275476
zapB_predicted,0.5,1,1,CTAAGATTGACGGGCGGATT,0,5273244
zapB_predicted,0.5,1,1,CTAAGATACGAGCGGGATTA,0,5287718
zapB_predicted,0.5,1,1,CTAACCATGATTTGGATATC,0,5276314
zapB_predicted,0.5,1,1,CGTTTGCTGGGCAACGGCAA,0,5269520
zapB_predicted,0.5,1,1,CGTTCTTTCTCGCTTGCACT,0,5285619
zapB_predicted,0.5,1,1,CGTGCTGACGACCCTGCGTG,0,5287881
zapB_predicted,0.5,1,1,CGTGCCCTGGATCATGCCTC,0,5274041
zapB_predicted,0.5,1,1,CGTCTTGGAAGGACCGAATG,0,5272990
zapB_predicted,0.5,1,1,CGTCGGTTACGGTATTCACT,0,5271919
zapB_predicted,0.5,1,1,CGTCGGGTGCAAGGTTAAGG,0,5269151
zapB_predicted,0.5,1,1,CGTCGGGAGGATGCCAGTGC,0,5283664
zapB_predicted,0.5,1,1,CGTCGCATAGTGAGTCTAGT,0,5274169
zapB_predicted,0.5,1,1,CGTCATCCTGCAAGCTATTC,0,5281926
zapB_predicted,0.5,1,1,CGTAGTCGCGACGCGGACGA,0,5263537
zapB_predicted,0.5,1,1,CGGTTGCCACGTTGAGCCGC,0,5267538
zapB_predicted,0.5,1,1,CGGTTGCAGAAGACTAGCAA,0,5274968
zapB_predicted,0.5,1,1,CGGTGATCTCCTCTTCCCTA,0,5280629
zapB_predicted,0.5,1,1,CGGTCGTTGGGGATATCTAG,0,5284026
zapB_predicted,0.5,1,1,CGGTAGTAAATTCATAGTTC,0,5272034
zapB_predicted,0.5,1,1,CGGTAACGTCCGTAATGATC,0,5287803
zapB_predicted,0.5,1,1,CGGGGAACAATACAAACCCA,0,5281228
zapB_predicted,0.5,1,1,CGGGCTGTATCACTGCGTTA,0,5277531
zapB_predicted,0.5,1,1,CGGGCAGACAATCAGAGGTG,0,5287618
zapB_predicted,0.5,1,1,CGGGAGGTTGGCAGCAGGCC,0,5284885
zapB_predicted,0.5,1,1,CGGGACAAGCGTAACTCTTG,0,5275965
zapB_predicted,0.5,1,1,CGGCGCTGACGGAATCAAAG,0,5282221
zapB_predicted,0.5,1,1,CGGCCTTCATGATCAGGAAT,0,5276970
zapB_predicted,0.5,1,1,CGGCCTCCGAACCCCGGGTT,0,5273348
zapB_predicted,0.5,1,1,CGGCCATCAAATTCCCGTGA,0,5266161
zapB_predicted,0.5,1,1,CGGCATCCGCTGGATCACGC,0,5280253
zapB_predicted,0.5,1,1,CGGCAGTGATTAGAAGGGGT,0,5268515
zapB_predicted,0.5,1,1,CGCTTTCTTCCGTTTCAACT,0,5283511
zapB_predicted,0.5,1,1,CGCTTTCGTGGATACGGGAC,0,5264494
zapB_predicted,0.5,1,1,CGCTTCCGAAGATACAATGA,0,5266440
zapB_predicted,0.5,1,1,CGCTCTTTATCCGCGCGGGG,0,5266349
zapB_predicted,0.5,1,1,CGCTCACGCACCGCTCCTCA,0,5273698
zapB_predicted,0.5,1,1,CGCGTTTTCCCGACAAGTAA,0,5280763
zapB_predicted,0.5,1,1,CGCGGGAAAAGTCGAAGATT,0,5279551
zapB_predicted,0.5,1,1,CGCGGATGAATAGCCATTGT,0,5280362
zapB_predicted,0.5,1,1,CGCGGATAGTGGGTGGCCCC,0,5269717
zapB_predicted,0.5,1,1,CGCCTTGTATTCGTACGGGA,0,5268721
zapB_predicted,0.5,1,1,CGCCTGGGGTTGGACCTGAG,0,5270559
zapB_predicted,0.5,1,1,CGCCTGAAATCTAGGTCGTT,0,5284414
zapB_predicted,0.5,1,1,CGCCGGCTAAGCTATTATCA,0,5280127
zapB_predicted,0.5,1,1,CGCCCCGCCAAGAGGTGATT,0,5271713
zapB_predicted,0.5,1,1,CGCCACCTGATCATTTCCCT,0,5276827
zapB_predicted,0.5,1,1,CGCATTCCTGCACCAGACGA,0,5280368
zapB_predicted,0.5,1,1,CGCAGGCCCCTTAGAGTGGC,0,5278771
zapB_predicted,0.5,1,1,CGCACGGTTCGTCCTTTTCG,0,5273773
zapB_predicted,0.5,1,1,CGCACGAACCAGTCCGGTAG,0,5286278
zapB_predicted,0.5,1,1,CGCACCGCTTAAGCGGAGTC,0,5280790
zapB_predicted,0.5,1,1,CGCACCCGGATTAGGTGAAG,0,5270415
zapB_predicted,0.5,1,1,CGATTCACGGACTACGTTCG,0,5270133
zapB_predicted,0.5,1,1,CGATTCAAGCCTCGCTAATG,0,5274528
zapB_predicted,0.5,1,1,CGATGAAAACCTTCTGGTCG,0,5276894
zapB_predicted,0.5,1,1,CGAGCTCACTGCCATAAGAA,0,5284253
zapB_predicted,0.5,1,1,CGAGACGTAAGTACCTAAGG,0,5263333
zapB_predicted,0.5,1,1,CGACGTATTTCGCTTGAAAT,0,5280176
zapB_predicted,0.5,1,1,CGACCTATTTTCCTGGAATC,0,5282415
zapB_predicted,0.5,1,1,CGACCTACGCCCTTCAGTGA,0,5265212
zapB_predicted,0.5,1,1,CGACCACAGGTCTATTCGAG,0,5266982
zapB_predicted,0.5,1,1,CGAAGGTAAAATAAGATGAC,0,5283535
zapB_predicted,0.5,1,1,CGAAGGGAAATGTACTGGTT,0,5283710
zapB_predicted,0.5,1,1,CGAACGACCGGCCATGGAAG,0,5280481
zapB_predicted,0.5,1,1,CGAACCAAATCCTCCATAAG,0,5284559
zapB_predicted,0.5,1,1,CGAACACAATATTTAAAGGG,0,5273619
zapB_predicted,0.5,1,1,CGAAAGCAGCGGAAGATCTG,0,5266713
zapB_predicted,0.5,1,1,CCTTGCATAAGCCAAAGAAC,0,5282450
zapB_predicted,0.5,1,1,CCTTGATACATGAACTCGAC,0,5279514
zapB_predicted,0.5,1,1,CCTTCTTTAGATAAATATCT,0,5282274
zapB_predicted,0.5,1,1,CCTTATATTCAGCTCAGTAA,0,5287880
zapB_predicted,0.5,1,1,CCTTAATGCTCAACGATCAC,0,5276890
zapB_predicted,0.5,1,1,CCTGACAAAGGTATGCATAA,0,5278579
zapB_predicted,0.5,1,1,CCTCTGCGTCAAACGGCTAC,0,5286605
zapB_predicted,0.5,1,1,CCTCCTCTAAGCGGGGCAAC,0,5283051
zapB_predicted,0.5,1,1,CCTAGTTCACTACGTATTCG,0,5273685
zapB_predicted,0.5,1,1,CCTACACTTCCGTCTGTGAG,0,5268516
zapB_predicted,0.5,1,1,CCGTTATATACTATATTGAT,0,5271842
zapB_predicted,0.5,1,1,CCGTGGCCTGTGTAGTAATG,0,5269323
zapB_predicted,0.5,1,1,CCGTCACGAAACTCTTTAAA,0,5280056
zapB_predicted,0.5,1,1,CCGGTCGGTTGTCAGAAGCA,0,5263278
zapB_predicted,0.5,1,1,CCGGTCCAGTCCCTGAACGT,0,5284801
zapB_predicted,0.5,1,1,CCGGGTAAATGCCCGGAGCC,0,5283611
zapB_predicted,0.5,1,1,CCGGCTTACGTTTTTATTAG,0,5282267
zapB_predicted,0.5,1,1,CCGCTCCCTGCATGTAACTG,0,5279798
zapB_predicted,0.5,1,1,CCGATAAGTGCCTTATAGTA,0,5263135
zapB_predicted,0.5,1,1,CCGACCAGCGTCAACCGGCT,0,5274913
zapB_predicted,0.5,1,1,CCGACACGGTTGTATTACCC,0,5269123
zapB_predicted,0.5,1,1,CCGACAAGCCCTTTGATCCC,0,5282742
zapB_predicted,0.5,1,1,CCGAAAATGAGTATCAGTGT,0,5273531
zapB_predicted,0.5,1,1,CCCTTTTACCGAGGATCGCC,0,5268755
zapB_predicted,0.5,1,1,CCCTTTCTTACCTGGCTCGT,0,5275998
zapB_predicted,0.5,1,1,CCCTGGTGAAATTCCCGTCC,0,5276359
zapB_predicted,0.5,1,1,CCCTCTGCCCCCGAGATAAC,0,5277936
zapB_predicted,0.5,1,1,CCCGGCCTAAGGATACTCGG,0,5273765
zapB_predicted,0.5,1,1,CCCGCAAGAGGCCCTCTCGG,0,5266406
zapB_predicted,0.5,1,1,CCCGATGCGTCCTAGAAGAT,0,5287095
zapB_predicted,0.5,1,1,CCCCTCGGATCGTTCCAGAC,0,5276774
zapB_predicted,0.5,1,1,CCCCGCAGGGACCCGTTGGC,0,5265621
zapB_predicted,0.5,1,1,CCCCCGAGACACGGTATTAA,0,5281460
zapB_predicted,0.5,1,1,CCCCAGGCCCCATTTGACGA,0,5285367
zapB_predicted,0.5,1,1,CCCATGGAGCTGTCAGTCCC,0,5276172
zapB_predicted,0.5,1,1,CCCAGGGGTGCCACGATGTC,0,5267801
zapB_predicted,0.5,1,1,CCATGGCAAAGTCCGTGTAC,0,5271125
zapB_predicted,0.5,1,1,CCATCAACCGGACCTTCACA,0,5265421
zapB_predicted,0.5,1,1,CCATATTGATTCAAAACACG,0,5264440
zapB_predicted,0.5,1,1,CCAGTTGGCGTAGCTTACTG,0,5264307
zapB_predicted,0.5,1,1,CCAGACGATCCAACGTTTTA,0,5284863
zapB_predicted,0.5,1,1,CCACTCTGATAACGGCGGCC,0,5271574
zapB_predicted,0.5,1,1,CCACTAGGCAGGGCTCTGAA,0,5273643
zapB_predicted,0.5,1,1,CCACAAGCGGTCGGGTGCAG,0,5281652
zapB_predicted,0.5,1,1,CCAAACGAGGAACGCACTAA,0,5281700
zapB_predicted,0.5,1,1,CCAAAATGTGCGGGAACCCT,0,5269200
zapB_predicted,0.5,1,1,CATTTCGCCACAGCTCGCAG,0,5277576
zapB_predicted,0.5,1,1,CATTGGGCTTAAGAGTACGA,0,5286568
zapB_predicted,0.5,1,1,CATTGCTTGCTATCTTCCAC,0,5271299
zapB_predicted,0.5,1,1,CATTCTGATTCGTTTTAGAA,0,5263476
zapB_predicted,0.5,1,1,CATTACTGTCGCAGAATTCA,0,5282704
zapB_predicted,0.5,1,1,CATGTCCCGATCTTACTATA,0,5263414
zapB_predicted,0.5,1,1,CATCGTTCATGTCCACCAAG,0,5267680
zapB_predicted,0.5,1,1,CATCGAGTGCACCTGGCGTC,0,5282957
zapB_predicted,0.5,1,1,CATCCGTTCATCAATAATGC,0,5268175
zapB_predicted,0.5,1,1,CATCCGCTCAACACATCGAT,0,5273174
zapB_predicted,0.5,1,1,CATCCAGTACGAGCCGCAGC,0,5280611
zapB_predicted,0.5,1,1,CATCATCATCTTCGGTATCG,0,5266455
zapB_predicted,0.5,1,1,CATCACGGTGCTAGCTCAGT,0,5263968
zapB_predicted,0.5,1,1,CATCACCGGAATTGAGCGAT,0,5288362
zapB_predicted,0.5,1,1,CATATGCTATGTTCAGGATT,0,5283922
zapB_predicted,0.5,1,1,CATATCTATGTTGGAATGCC,0,5278079
zapB_predicted,0.5,1,1,CATAATCTTCGAGAAGCGCG,0,5279046
zapB_predicted,0.5,1,1,CATAAGATATGTCCGTCACG,0,5271233
zapB_predicted,0.5,1,1,CAGTTGCGCTATGGCCCGCG,0,5279748
zapB_predicted,0.5,1,1,CAGTTAGTACAAACAACCTC,0,5274844
zapB_predicted,0.5,1,1,CAGTCTGAGTCTTGTGACGT,0,5272517
zapB_predicted,0.5,1,1,CAGTCGTCGCCTTAGGTAAC,0,5282447
zapB_predicted,0.5,1,1,CAGTCGATGGAATTTAATGC,0,5270283
zapB_predicted,0.5,1,1,CAGTACTGCCTTGACGCCTA,0,5265998
zapB_predicted,0.5,1,1,CAGTAAATGGATTCGAATGC,0,5269580
zapB_predicted,0.5,1,1,CAGGTGAGCTCCTTCCGCAG,0,5270961
zapB_predicted,0.5,1,1,CAGGGTTCACGATCTCCTGG,0,5282630
zapB_predicted,0.5,1,1,CAGGCTCCGCGATGTAATTA,0,5265347
zapB_predicted,0.5,1,1,CAGGCTCAGCTACTTTTAAC,0,5273799
zapB_predicted,0.5,1,1,CAGGCGAGCAAGAGCACCAG,0,5266968
zapB_predicted,0.5,1,1,CAGGAGCCTCGACCCAGGCA,0,5274834
zapB_predicted,0.5,1,1,CAGGAACTGCAAGCGTTTCT,0,5272198
zapB_predicted,0.5,1,1,CAGCTTCCGCTACAGTCAGG,0,5277598
zapB_predicted,0.5,1,1,CAGCTGATCCTAAATTTGCT,0,5264573
zapB_predicted,0.5,1,1,CAGCGCCACTAGATCGCGAC,0,5263494
zapB_predicted,0.5,1,1,CAGCAGGGGAGAGAGAATTT,0,5278007
zapB_predicted,0.5,1,1,CAGAGGTCCAATGAATCCGT,0,5263963
zapB_predicted,0.5,1,1,CACTGTTGCGTCCGCAGTCA,0,5285848
zapB_predicted,0.5,1,1,CACTGGCAAGTGATGTAGAA,0,5266162
zapB_predicted,0.5,1,1,CACTGCACCGAAAATCGCTA,0,5276721
zapB_predicted,0.5,1,1,CACTACGAGACCGAGAATGA,0,5272065
zapB_predicted,0.5,1,1,CACGTTCGTCTCGGGAAGAC,0,5272137
zapB_predicted,0.5,1,1,CACGTGCCCGTCCGGATTTA,0,5282697
zapB_predicted,0.5,1,1,CACGTAGAGCGGCGTGCGGG,0,5287122
zapB_predicted,0.5,1,1,CACGGACAATAACACTGTCT,0,5273639
zapB_predicted,0.5,1,1,CACGCGGTGTAGGGACGTTA,0,5282306
zapB_predicted,0.5,1,1,CACGCCTTGCTACTTTGCTC,0,5288247
zapB_predicted,0.5,1,1,CACCCTCCGCCACGAGGACG,0,5267500
zapB_predicted,0.5,1,1,CACCCTACTCATAACTTGTG,0,5272461
zapB_predicted,0.5,1,1,CACCCTACGGGATTGTAGCC,0,5283032
zapB_predicted,0.5,1,1,CACCCCCTCGGTACACCCTA,0,5264180
zapB_predicted,0.5,1,1,CACATTGGCGTTTCACCCAT,0,5285533
zapB_predicted,0.5,1,1,CACATCGCTATAAGACTCTA,0,5286750
zapB_predicted,0.5,1,1,CACAGTCAATGAATGGCGGA,0,5266301
zapB_predicted,0.5,1,1,CACAGTAGGTTAATTCTACT,0,5276691
zapB_predicted,0.5,1,1,CACAGCTGGGGGCTTTTTAC,0,5284441
zapB_predicted,0.5,1,1,CACAGCCTCCCCACGCGGAA,0,5267423
zapB_predicted,0.5,1,1,CACACTTTTTATACACGATT,0,5278793
zapB_predicted,0.5,1,1,CACACAGGGGACGGCATTTT,0,5265424
zapB_predicted,0.5,1,1,CACAATTATTCTCTATTAGT,0,5280484
zapB_predicted,0.5,1,1,CAATTTCTTTAACCAGATAG,0,5274842
zapB_predicted,0.5,1,1,CAATGGTTTGCCGCCCTCCT,0,5280137
zapB_predicted,0.5,1,1,CAATGGCAATCGCACCGAGG,0,5276726
zapB_predicted,0.5,1,1,CAATGCGCTGGCACCGAACA,0,5275991
zapB_predicted,0.5,1,1,CAATCTACCATGCTCCCGGG,0,5283483
zapB_predicted,0.5,1,1,CAATACCGTGAACATACAGG,0,5287976
zapB_predicted,0.5,1,1,CAAGTTCGCGTTCCGCGCCT,0,5275828
zapB_predicted,0.5,1,1,CAAGGCCTACTTGGACCACA,0,5265192
zapB_predicted,0.5,1,1,CAACTCTCAATACCTAGTTC,0,5272769
zapB_predicted,0.5,1,1,CAACGAACTCACGAACTTTC,0,5267777
zapB_predicted,0.5,1,1,CAACCGGTCGCCTCGGGTCC,0,5286583
zapB_predicted,0.5,1,1,CAACAGACATGCTCCCTAGT,0,5272868
zapB_predicted,0.5,1,1,CAACACTGGTTTGTTGTACG,0,5275227
zapB_predicted,0.5,1,1,CAAATGTAGATACAAACAAC,0,5281675
zapB_predicted,0.5,1,1,CAAAGGTGTTGTTTACTGAT,0,5288025
zapB_predicted,0.5,1,1,CAAAGAAGCCAGGACTCCTG,0,5275937
zapB_predicted,0.5,1,1,CAAACATTATCTATGCGACT,0,5282734
zapB_predicted,0.5,1,1,CAAAAGGGTTGCCAGGAACC,0,5287295
zapB_predicted,0.5,1,1,ATTTTCGCGGATTTATCGCC,0,5282740
zapB_predicted,0.5,1,1,ATTTCTGCGGCTACTCATGT,0,5273542
zapB_predicted,0.5,1,1,ATTTCGCCTAACCATGGTAT,0,5273425
zapB_predicted,0.5,1,1,ATTTAGTTCGGCGCCTACCT,0,5271081
zapB_predicted,0.5,1,1,ATTTAGGCGTCGTCTACAGT,0,5275612
zapB_predicted,0.5,1,1,ATTTAAGCGGTATCATGGTA,0,5282173
zapB_predicted,0.5,1,1,ATTGTCGTATGGTGTTCAAA,0,5283913
zapB_predicted,0.5,1,1,ATTGCTGGGGTCCCGCACCG,0,5286030
zapB_predicted,0.5,1,1,ATTGCGCTCTATTCTTGTGC,0,5269642
zapB_predicted,0.5,1,1,ATTGCACATTCAACCCTTAA,0,5266345
zapB_predicted,0.5,1,1,ATTGCAAGCTGTAAGTTAAA,0,5280709
zapB_predicted,0.5,1,1,ATTGAACTAGGTGCTAGTAA,0,5279227
zapB_predicted,0.5,1,1,ATTCGGTTATCCTGGATTGA,0,5287545
zapB_predicted,0.5,1,1,ATTCGGGGATCCGTAATCGA,0,5273488
zapB_predicted,0.5,1,1,ATTCGCTTGTCGTCGTCACT,0,5264096
zapB_predicted,0.5,1,1,ATTCCTAGGTGGGGACATGA,0,5282906
zapB_predicted,0.5,1,1,ATTCCCGTTGTGATCGTCCT,0,5278393
zapB_predicted,0.5,1,1,ATTCATTCTGGGCTAGCCCT,0,5287653
zapB_predicted,0.5,1,1,ATTCATCTGAACGGCAGTTG,0,5280334
zapB_predicted,0.5,1,1,ATTCAGGTTGAAGGCCGGCT,0,5271526
zapB_predicted,0.5,1,1,ATTCACAACACGTAGCGCTT,0,5275566
zapB_predicted,0.5,1,1,ATTCAAAAGCGAAAGCTTAA,0,5273904
zapB_predicted,0.5,1,1,ATTATATTGCCTCCCCCATA,0,5285785
zapB_predicted,0.5,1,1,ATTACTGATAGAATGATGCG,0,5270323
zapB_predicted,0.5,1,1,ATTACCCTACATATACCAAT,0,5264200
zapB_predicted,0.5,1,1,ATTACATCCTAGCCAAGCTT,0,5280523
zapB_predicted,0.5,1,1,ATTAAGAGATCAAGCGTTGA,0,5277673
zapB_predicted,0.5,1,1,ATTAACCACATATTCATTGG,0,5268221
zapB_predicted,0.5,1,1,ATGTTTGGCTGCGACTAGCA,0,5278035
zapB_predicted,0.5,1,1,ATGTGGACCGCATGCCGTAT,0,5267347
zapB_predicted,0.5,1,1,ATGTGAGGGGGGCTTCTCAC,0,5265149
zapB_predicted,0.5,1,1,ATGTCTCCGTCAGTGTAGGA,0,5284186
zapB_predicted,0.5,1,1,ATGGTCATGCCTTTCAGCGA,0,5283203
zapB_predicted,0.5,1,1,ATGGGGCTGAAATGACGGCT,0,5268930
zapB_predicted,0.5,1,1,ATGGGAGAGGTTCTGTGCGA,0,5276430
zapB_predicted,0.5,1,1,ATGGCATCCCAGATGAATTT,0,5286302
zapB_predicted,0.5,1,1,ATGCCAGCCCATAAGTGACA,0,5271127
zapB_predicted,0.5,1,1,ATGAGATTTCGGCGTAATCG,0,5278990
zapB_predicted,0.5,1,1,ATCTTTTTTGGAAGTCACCT,0,5268643
zapB_predicted,0.5,1,1,ATCTCAAGTCAGCGGTCTAT,0,5277456
zapB_predicted,0.5,1,1,ATCTACAGAAAATGAACCAG,0,5274074
zapB_predicted,0.5,1,1,ATCGCCTAGATGCTCCACGC,0,5266204
zapB_predicted,0.5,1,1,ATCATTGACCAAGATCGGAT,0,5279873
zapB_predicted,0.5,1,1,ATCACGATACATACAACTAG,0,5266788
zapB_predicted,0.5,1,1,ATCAAGATTCGAAATTACGG,0,5279268
zapB_predicted,0.5,1,1,ATATTGGCAGAGTCGAAATA,0,5263286
zapB_predicted,0.5,1,1,ATATTCATTGCGGGAGGTGC,0,5263067
zapB_predicted,0.5,1,1,ATATCTTTTAAATGGACCTA,0,5286456
zapB_predicted,0.5,1,1,ATATAACGTCATGCGATGCC,0,5279518
zapB_predicted,0.5,1,1,ATAGGGGCAACATGGGTGGG,0,5277830
zapB_predicted,0.5,1,1,ATAGATTAATGCAGTTGTAA,0,5285751
zapB_predicted,0.5,1,1,ATACGTAAACCGTGGGGGAT,0,5276785
zapB_predicted,0.5,1,1,ATACATTGCCACCATAAGCG,0,5271762
zapB_predicted,0.5,1,1,ATAATTTGGACCCCAGGAGC,0,5267622
zapB_predicted,0.5,1,1,ATAATCTGTCCTCAACATCA,0,5267299
zapB_predicted,0.5,1,1,ATAATCGTTCACATGGGATA,0,5275180
zapB_predicted,0.5,1,1,ATAATAGTAAACGTCTAGGG,0,5285565
zapB_predicted,0.5,1,1,ATAAGAACCGGCACCTTATT,0,5275881
zapB_predicted,0.5,1,1,ATAAAGTTTCGGTAGAGATA,0,5272691
zapB_predicted,0.5,1,1,ATAAAGGGACTTTGCGGTCT,0,5286396
zapB_predicted,0.5,1,1,ATAAAACAATGGTAGATCAA,0,5265878
zapB_predicted,0.5,1,1,AGTTGCACTAGCCTCGGCGA,0,5270585
zapB_predicted,0.5,1,1,AGTTCTCGGGACTGTCGGAG,0,5274831
zapB_predicted,0.5,1,1,AGTTCTATCGAATTAATGGT,0,5264385
zapB_predicted,0.5,1,1,AGTTCCTCCTATATACGATA,0,5275076
zapB_predicted,0.5,1,1,AGTTCACCATATGCGATGGG,0,5268275
zapB_predicted,0.5,1,1,AGTTACGGACTCTGCCTTAT,0,5287749
zapB_predicted,0.5,1,1,AGTGTCTCTTGATGTTAATC,0,5272468
zapB_predicted,0.5,1,1,AGTGTATCGGGATGCAACTT,0,5287589
zapB_predicted,0.5,1,1,AGTGGTATCCTAACTAGCGC,0,5268629
zapB_predicted,0.5,1,1,AGTGGGCAATAATAACGAAT,0,5278291
zapB_predicted,0.5,1,1,AGTGGCTCAAAGTCAAGGGC,0,5286117
zapB_predicted,0.5,1,1,AGTGGATACGGACAGAAGAT,0,5287586
zapB_predicted,0.5,1,1,AGTGATTTCCTATAAAGGAA,0,5288426
zapB_predicted,0.5,1,1,AGTGACAGCAAGTGGAAAAG,0,5285459
zapB_predicted,0.5,1,1,AGTCTGCTGCGATGTGCTGT,0,5278729
zapB_predicted,0.5,1,1,AGTCTCTGGTCAGAACCAGA,0,5276078
zapB_predicted,0.5,1,1,AGTCACACCGGTGTAGGCCA,0,5287733
zapB_predicted,0.5,1,1,AGGTTTCTTTAATTGTTTTG,0,5284080
zapB_predicted,0.5,1,1,AGGTGCGGTTGCGGTTACGT,0,5287063
zapB_predicted,0.5,1,1,AGGTGAAAGTTCGTATTTAT,0,5278136
zapB_predicted,0.5,1,1,AGGTCCGTGATCTAAAGGAA,0,5270589
zapB_predicted,0.5,1,1,AGGTACTATATTGGAAAAGC,0,5275524
zapB_predicted,0.5,1,1,AGGTACCCCTTTGGAGACGG,0,5267762
zapB_predicted,0.5,1,1,AGGTACACTCCCGGATCTTC,0,5280850
zapB_predicted,0.5,1,1,AGGGTGACGGTGATCCTGTC,0,5270582
zapB_predicted,0.5,1,1,AGGGTCTTTAAATAGTAGCG,0,5280294
zapB_predicted,0.5,1,1,AGGGCTAAATAGACACAGAG,0,5264651
zapB_predicted,0.5,1,1,AGGGATTAAAGCTCTTTTGC,0,5288079
zapB_predicted,0.5,1,1,AGGGAATGCGTATAGTGTGG,0,5287337
zapB_predicted,0.5,1,1,AGGCGTTTGCTAGGCCTGTC,0,5272352
zapB_predicted,0.5,1,1,AGGCCAGTGTTTCCCTCGAT,0,5280165
zapB_predicted,0.5,1,1,AGGCATAGCAGGGAGATACT,0,5268865
zapB_predicted,0.5,1,1,AGGATCAACATGCTGAAGCC,0,5265619
zapB_predicted,0.5,1,1,AGGACGGGTTATTCCATAGG,0,5268088
zapB_predicted,0.5,1,1,AGCTTCGTAGAAAAAAAAGC,0,5285936
zapB_predicted,0.5,1,1,AGCTGGTTCGAGGGATGGAG,0,5263904
zapB_predicted,0.5,1,1,AGCGTGCCGCGTGGTTCTCT,0,5271393
zapB_predicted,0.5,1,1,AGCGGGCTACCGAACATGGG,0,5273707
zapB_predicted,0.5,1,1,AGCCGTTGGGCTCGCTCTAC,0,5286059
zapB_predicted,0.5,1,1,AGCCAGCGGACAAGGTACTT,0,5275340
zapB_predicted,0.5,1,1,AGCATCTCTCGTACTTTTCA,0,5276004
zapB_predicted,0.5,1,1,AGCATAGCCCAGAATCAACG,0,5269074
zapB_predicted,0.5,1,1,AGCAGCCCCGCCTGATTGAT,0,5274307
zapB_predicted,0.5,1,1,AGATGGAAACACGAATAGGG,0,5288292
zapB_predicted,0.5,1,1,AGATATTCTTGTTAGTAAAT,0,5282600
zapB_predicted,0.5,1,1,AGAGACTAAAACTTATCCAC,0,5272095
zapB_predicted,0.5,1,1,AGACACAAGGTGTAACCTGT,0,5274350
zapB_predicted,0.5,1,1,AGAAGAATATGGCCCAGAAA,0,5272136
zapB_predicted,0.5,1,1,AGAACTGGCCGTTCCGGCAC,0,5265677
zapB_predicted,0.5,1,1,AGAAAAGCCCAGATGCTACA,0,5280658
zapB_predicted,0.5,1,1,ACTTCTTGTCTGAATTATCC,0,5282441
zapB_predicted,0.5,1,1,ACTCGTGTTTCTAGCCCAAG,0,5277487
zapB_predicted,0.5,1,1,ACTCGTCGGGTCGGCAAATT,0,5267292
zapB_predicted,0.5,1,1,ACTCACGCCCCAAATAAGCT,0,5282580
zapB_predicted,0.5,1,1,ACTAGGCCCAAGCTAAAATG,0,5269734
zapB_predicted,0.5,1,1,ACTAGAGTGATACCCACCCA,0,5270796
zapB_predicted,0.5,1,1,ACTAAGAGATTGACCCATTT,0,5276176
zapB_predicted,0.5,1,1,ACGTTTCCGGCGGCTCTGCT,0,5282801
zapB_predicted,0.5,1,1,ACGTCACCTCGGGGCGGTCT,0,5263558
zapB_predicted,0.5,1,1,ACGTATCCTGGCATGGCCCA,0,5268061
zapB_predicted,0.5,1,1,ACGTAGTTGTGACCTCAACT,0,5284474
zapB_predicted,0.5,1,1,ACGGTAACCGAAGTAGTCCG,0,5288308
zapB_predicted,0.5,1,1,ACGGGTTCTCATAGTTGAGC,0,5277704
zapB_predicted,0.5,1,1,ACGGGTACAGGCTCGGATAG,0,5274867
zapB_predicted,0.5,1,1,ACGGGCGCAAGTCCCATTCC,0,5282813
zapB_predicted,0.5,1,1,ACGGCCACTTCTCGGTTAAG,0,5286832
zapB_predicted,0.5,1,1,ACGGACTCCACAAAGACATT,0,5283702
zapB_predicted,0.5,1,1,ACGCGTCGTAGCATAATCTC,0,5263756
zapB_predicted,0.5,1,1,ACGCGGGTAGGTTACTGTGT,0,5268462
zapB_predicted,0.5,1,1,ACGCCAGGTTAGCATATCTA,0,5274587
zapB_predicted,0.5,1,1,ACGCAGTCTGGAACTAATGG,0,5264411
zapB_predicted,0.5,1,1,ACGCAGCACATGAAGCCATT,0,5271124
zapB_predicted,0.5,1,1,ACGATGTCTCCAGTTTAATA,0,5277701
zapB_predicted,0.5,1,1,ACGATGGAGTTGGCATCGCA,0,5273283
zapB_predicted,0.5,1,1,ACGATACATTTCCTGAAACT,0,5272638
zapB_predicted,0.5,1,1,ACCTTTCAGACATGGCGGAT,0,5280126
zapB_predicted,0.5,1,1,ACCTTGCAAGGTCTTGCGGG,0,5273662
zapB_predicted,0.5,1,1,ACCTGAAAGGCAAAGGAGTA,0,5278152
zapB_predicted,0.5,1,1,ACCTCCAATCTATCAATGAA,0,5285064
zapB_predicted,0.5,1,1,ACCTAAGTGGACGAGTGTAA,0,5278273
zapB_predicted,0.5,1,1,ACCGACGGTGGTAATCGGGG,0,5271292
zapB_predicted,0.5,1,1,ACCCTATTGCTACCTATGCG,0,5286486
zapB_predicted,0.5,1,1,ACCCCCAGAAGTTAAACGTA,0,5283144
zapB_predicted,0.5,1,1,ACCCATAGTAACCCCGCGCA,0,5276142
zapB_predicted,0.5,1,1,ACCAGGGTAGTCGCACTTTC,0,5279972
zapB_predicted,0.5,1,1,ACCACACGTCAACCCTCTGG,0,5281617
zapB_predicted,0.5,1,1,ACCACAACTCTCTCTGTGGG,0,5284906
zapB_predicted,0.5,1,1,ACATGTGATCATAGAGCTGC,0,5279611
zapB_predicted,0.5,1,1,ACATGTCACGTAAGGGGGGC,0,5282532
zapB_predicted,0.5,1,1,ACATGGCACCAAATCTAGCT,0,5278377
zapB_predicted,0.5,1,1,ACATCTAGACGGTCTGAACC,0,5280738
zapB_predicted,0.5,1,1,ACAGGGTTACGTCTGGACTC,0,5285139
zapB_predicted,0.5,1,1,ACAGGACAACGTAGTCATGT,0,5287226
zapB_predicted,0.5,1,1,ACAGGAAAAGTTAGGCGTAT,0,5276347
zapB_predicted,0.5,1,1,ACAGCGTATTACAGTGCGCA,0,5275138
zapB_predicted,0.5,1,1,ACAGCGGCCAAATGCCAGCT,0,5263955
zapB_predicted,0.5,1,1,ACAGCGCAATGCGGCAGTCA,0,5269278
zapB_predicted,0.5,1,1,ACAGCATTACAGCGGTCCGG,0,5263185
zapB_predicted,0.5,1,1,ACAGACATATCCGAAACAGA,0,5282248
zapB_predicted,0.5,1,1,ACACTTGACTCATCAGGAGA,0,5270143
zapB_predicted,0.5,1,1,ACACCTGCCCGTGAGGGTCA,0,5267699
zapB_predicted,0.5,1,1,ACACCTATGAGAATAGTTAA,0,5271055
zapB_predicted,0.5,1,1,ACACCGGGCTATCTAGAGGT,0,5282045
zapB_predicted,0.5,1,1,ACACATCCGGCTGGCCTATC,0,5272410
zapB_predicted,0.5,1,1,ACAAGGAGGCCAAGACGGTC,0,5285867
zapB_predicted,0.5,1,1,ACAAGAGGCGCTTCGTTATC,0,5285781
zapB_predicted,0.5,1,1,ACAAAAGCCGGATCAATAGC,0,5274379
zapB_predicted,0.5,1,1,AATTTTGACACCGCTTCGAG,0,5271737
zapB_predicted,0.5,1,1,AATTTGATACCGCGTTAGCA,0,5275745
zapB_predicted,0.5,1,1,AATTGGTACTCCAGTTTGGG,0,5265219
zapB_predicted,0.5,1,1,AATTCCATATAAAATCTATC,0,5273476
zapB_predicted,0.5,1,1,AATTAGTTTGACACACTGAG,0,5269871
zapB_predicted,0.5,1,1,AATTAGCACAGTCATTTAGT,0,5280344
zapB_predicted,0.5,1,1,AATGTTTATATAGCGACACC,0,5283278
zapB_predicted,0.5,1,1,AATCGTGAGGCACTTTGACA,0,5269676
zapB_predicted,0.5,1,1,AATCGCGATAGAATAGTCTT,0,5275132
zapB_predicted,0.5,1,1,AATCCTTTGCTCACATTTTA,0,5282474
zapB_predicted,0.5,1,1,AATCCATTTAGTCGATAAGA,0,5284992
zapB_predicted,0.5,1,1,AATCCACCAGAATGATGAGT,0,5288269
zapB_predicted,0.5,1,1,AATAGCCTAGCTCATAGGCA,0,5278093
zapB_predicted,0.5,1,1,AATAATCAGCAGAGTGCCCA,0,5263192
zapB_predicted,0.5,1,1,AATAACAAGGGTTGCATCGA,0,5270009
zapB_predicted,0.5,1,1,AAGTGGACACAAGGCGCCAC,0,5263998
zapB_predicted,0.5,1,1,AAGTGAGGACTCAGGGCCGC,0,5266061
zapB_predicted,0.5,1,1,AAGTCCAGCGATGCACCGCG,0,5272204
zapB_predicted,0.5,1,1,AAGTAGAGCATCGGTTTTAA,0,5281564
zapB_predicted,0.5,1,1,AAGGCTGGTGAAGCTCACTT,0,5268084
zapB_predicted,0.5,1,1,AAGGCGGATACCTGTGAAGA,0,5284905
zapB_predicted,0.5,1,1,AAGGACATGCAGTAAGTCAT,0,5285049
zapB_predicted,0.5,1,1,AAGCCTCCTGCTAAGGCCCT,0,5270989
zapB_predicted,0.5,1,1,AAGCAGGTTGCTATTGAAGC,0,5273738
zapB_predicted,0.5,1,1,AAGAGTGCGGTGGGGTTGCT,0,5277084
zapB_predicted,0.5,1,1,AAGAGTAGCTACAGATTGAG,0,5275744
zapB_predicted,0.5,1,1,AAGACAAATGTAGCTACGCC,0,5264250
zapB_predicted,0.5,1,1,AACTCTCAAGGGCGGCCGGC,0,5285174
zapB_predicted,0.5,1,1,AACTATTCGTGTGCATACAA,0,5283286
zapB_predicted,0.5,1,1,AACTAGCCAGGAATTAGCAT,0,5264974
zapB_predicted,0.5,1,1,AACTAAGGCAAGAAGACTCA,0,5275190
zapB_predicted,0.5,1,1,AACGTGGCGGAACGCCACCA,0,5264866
zapB_predicted,0.5,1,1,AACGGCACCCAACTACGCAT,0,5282799
zapB_predicted,0.5,1,1,AACGATTCGGATCAAGGGGG,0,5272049
zapB_predicted,0.5,1,1,AACCGAGCGCTACAGACAGA,0,5288197
zapB_predicted,0.5,1,1,AACCAGTCTATTGGAAGCAG,0,5265305
zapB_predicted,0.5,1,1,AACATGTTCCGAGGGAAAAT,0,5263289
zapB_predicted,0.5,1,1,AACAGCTCTTGAAGGGATGG,0,5276127
zapB_predicted,0.5,1,1,AACAATCGCGCGGGTAACAC,0,5267528
zapB_predicted,0.5,1,1,AAATTCTGGCGGTACTAGCC,0,5285194
zapB_predicted,0.5,1,1,AAATTCGCCGGTCCGAGACG,0,5263015
zapB_predicted,0.5,1,1,AAATGGTACTGACATTTTTA,0,5287490
zapB_predicted,0.5,1,1,AAATGGGGTAGCTGCTGGAT,0,5281042
zapB_predicted,0.5,1,1,AAATGGAACAACCAGGGCTA,0,5284761
zapB_predicted,0.5,1,1,AAAGTCCTCCTTGTCAATCA,0,5282882
zapB_predicted,0.5,1,1,AAAGGGACGGTTAGCCCACC,0,5285484
zapB_predicted,0.5,1,1,AAAGCGTAGGACACGCAACT,0,5285879
zapB_predicted,0.5,1,1,AAAGAGCTAGGATGTATAGC,0,5272215
zapB_predicted,0.5,1,1,AAACTTGTAGCAAAACATTA,0,5265721
zapB_predicted,0.5,1,1,AAACAGTCGCATCAGTCCCA,0,5264772
zapB_predicted,0.5,1,1,AAACAGGGAGTAAGCAAGTG,0,5276300
zapB_predicted,0.5,1,1,AAAATCACAGTCACTGCTCG,0,5273813
zapB_predicted,0.5,1,1,AAAAGAGGATCCGAGCATCC,0,5263030
zapB_predicted,0.5,1,1,AAAACTCACAGCACAGCAGA,0,5275833
zapB_predicted,0.5,1,1,AAAACAATTCAAATTGTGGT,0,5287679
zapB_predicted,0.5,1,1,AAAAAGTTAGGTCTCGGTAC,0,5278595
zapB_predicted,0.5,1,1,AAAAAGGCGAGAAAAGAAGC,0,5287408
zapB_predicted,475.0,474,0,GTTCTACTTGCAGACCATTA,474,5270805
zapB_predicted,442.0,441,0,ACGCGGGGAAGTCGTTGTAG,441,5280779
zapB_predicted,298.0,297,0,GCCTACGCGACGGTTGCCAC,297,5282098
zapB_predicted,276.0,275,0,TCGAGCACTTCCATTGCGGT,275,5268283
zapB_predicted,243.0,242,0,AGGTCAAGTTTTTGCAGGGA,242,5271300
zapB_predicted,240.0,239,0,GCCGTACGCGGGTGGAGACT,239,5282039
zapB_predicted,235.0,234,0,GCTGTTGTTCACTGCCATTC,234,5263995
zapB_predicted,231.0,230,0,AAAACGTCAACCATATTCCT,230,5264356
zapB_predicted,229.0,228,0,AATCCTCACCAACCTCTATG,228,5280183
zapB_predicted,226.0,225,0,CTATGTCCCTGTTGTGCAGA,225,5282587
zapB_predicted,223.0,222,0,GATGAGATGTTACGCCTTAT,222,5286507
zapB_predicted,216.0,215,0,ACAGTAGAGAAAAGAACTAT,215,5271994
zapB_predicted,211.0,210,0,ATACAATGGACGCAATTTCA,210,5285214
zapB_predicted,207.0,206,0,CGGATGATCCTGTAGGAGCT,206,5268763
zapB_predicted,205.0,204,0,CGCACTATACCCCCTCAAAC,204,5269059
zapB_predicted,197.0,196,0,GGTCGTTTAAATAACTACTC,196,5275726
zapB_predicted,185.0,184,0,CGCAGAGGGATTTTAACCAT,184,5286300
zapB_predicted,182.0,181,0,TTCACTATTATATGGGGCAC,181,5269047
zapB_predicted,181.0,180,0,ACCGCGAATATGTGGGTACA,180,5285758
zapB_predicted,171.0,170,0,CCACGCGTCCATAACATTTT,170,5264957
zapB_predicted,170.0,169,0,GATCTGCGGCCGTGTGGTTT,169,5273272
zapB_predicted,169.0,168,0,AATGCTTAGTAGACGTCGCT,168,5284236
zapB_predicted,166.0,165,0,GCATCAAGATCTTAGTAATT,165,5282465
zapB_predicted,139.0,138,0,GAGTTCACCGAGGTGAGAAG,138,5283486
zapB_predicted,128.0,127,0,TCTCAGCGGTGAGTTAAACG,127,5266673
zapB_predicted,97.0,96,0,TGCTAACAAAGCCTCATCCC,96,5266564
zapB_predicted,93.0,92,0,AGGAAGCATCCTTCGGACTA,92,5270584
zapB_predicted,83.0,82,0,CGTATCGCGGCGCTGCGAAC,82,5283299
zapB_predicted,58.0,57,0,GAGCGAGTGTCCTGATCTTC,57,5266548
zapB_predicted,20.0,19,0,GGAGCATTCCTTGGTGTCCG,19,5287864
zapB_predicted,4.0,3,0,CGTTGTTAAATCACTAGATC,3,5280163
zapB_predicted,3.0,2,0,ACAAGCGCTGGCGCCAGATG,2,5280837
zapB_predicted,2.0,1,0,TTGGGTGTCGAGTTGCGTAA,1,5268700
zapB_predicted,2.0,1,0,TTAGAATACAATAAGTAATT,1,5283861
zapB_predicted,2.0,1,0,TGTCAGGGCACAACATTACG,1,5287865
zapB_predicted,2.0,1,0,TGCTGCCTTTTGACCGATTT,1,5277790
zapB_predicted,2.0,1,0,TGCCGGTACAAGGAGCGCCT,1,5283632
zapB_predicted,2.0,1,0,TGAGATGAAGGTCCCGTAGG,1,5288414
zapB_predicted,2.0,1,0,TGAATTGGTATTCTGGCCGA,1,5282202
zapB_predicted,2.0,1,0,TCTAGATAGTTATATCTTAT,1,5284701
zapB_predicted,2.0,1,0,TATTCACTTAGGTTACATAA,1,5267036
zapB_predicted,2.0,1,0,TACGGCAAGAAGATACTTAA,1,5272677
zapB_predicted,2.0,1,0,GGTCAGGTCCGGTTCACCTG,1,5274356
zapB_predicted,2.0,1,0,GGGTCGTTAGCAATCTGCGA,1,5267310
zapB_predicted,2.0,1,0,GCCTATTGGACGTCATGCAT,1,5282752
zapB_predicted,2.0,1,0,GCAAGGGACATGTACGTAAG,1,5269055
zapB_predicted,2.0,1,0,GACTGGTCTGGAGAGCTTAC,1,5268358
zapB_predicted,2.0,1,0,GAAACGCAGTGGCACTGGTT,1,5267255
zapB_predicted,2.0,1,0,CTGTGACCTGTGTGTCCGAT,1,5286623
zapB_predicted,2.0,1,0,CGGCGATATCTATCACTGGT,1,5272324
zapB_predicted,2.0,1,0,CGAAGGGACCAGCTTAAAGT,1,5264595
zapB_predicted,2.0,1,0,CCTCAGTAAGGGCATGCCTT,1,5276985
zapB_predicted,2.0,1,0,CCGTGGCGAACACTGGCATT,1,5286778
zapB_predicted,2.0,1,0,CCGAAAAAAGGCGCCAGGTT,1,5280437
zapB_predicted,2.0,1,0,CCAAAACTTGAACAGCATAC,1,5282964
zapB_predicted,2.0,1,0,CATTGGTCGCTTCCTAGTCA,1,5283229
zapB_predicted,2.0,1,0,CAGTAAGTTATTTGGAATAG,1,5271861
zapB_predicted,2.0,1,0,CAACTAGCCCCTCGTGAGAT,1,5284268
zapB_predicted,2.0,1,0,ATTCGTTGCCACGTTAATGG,1,5263320
zapB_predicted,2.0,1,0,AGGCCTGAGGGCATCCAAAG,1,5267406
zapB_predicted,2.0,1,0,ACGGTCGCGATATTACTACA,1,5287659
zapB_predicted,2.0,1,0,AAAGCGTTACATCCCGTGCC,1,5278846
