name,relative_counts,ct,ct_0,barcode,ct_1,barcode_ind
ompRp4,5.897838899803537,3509,508,CCCGGCGGACAGGCTTTACG,3001,2924609
ompRp4,61.875,501,7,GACGGGCAAGTGGACTCGGA,494,2930472
ompRp4,133.66666666666666,402,2,AAACTGGTTCGGCTTCCTTG,400,2932955
ompRp4,187.0,374,1,ATTCTCGTGCGTTAGATGTA,373,2916391
ompRp4,172.5,345,1,GTTCGGTCGAGGGGGTACCT,344,2918461
ompRp4,78.75,317,3,CCTGCACGGCATGCTACGCT,314,2937693
ompRp4,73.75,297,3,TAGCTCTTTCCCCTGACCTG,294,2929505
ompRp4,19.846153846153847,269,12,AGTAACACTTCAACGTAGGT,257,2915809
ompRp4,36.42857142857143,260,6,CTTGGTCAGCCAGTTTGTTT,254,2909546
ompRp4,62.75,253,3,AGCGCCCCCTGAAAGCGTGA,250,2923207
ompRp4,33.285714285714285,238,6,CACTTCTGGCTGGTTGATGT,232,2926274
ompRp4,74.0,223,2,TCAAACATTACGTCTTAATG,221,2916484
ompRp4,55.5,224,3,ATCTTAACAAGGTTTAAGGA,221,2931028
ompRp4,54.75,221,3,TCATGGTCAGTATGTGACAC,218,2936313
ompRp4,104.0,208,1,AGAGATTCGTTTTGCCTAGT,207,2925370
ompRp4,69.0,208,2,TACCCGTAGAACTGGGGGAA,206,2926590
ompRp4,29.428571428571427,211,6,GGGGGAGAAAGCCGATGAGA,205,2919843
ompRp4,50.5,204,3,GCTCGTATGGATCACCGATT,201,2934589
ompRp4,50.25,203,3,TGGTCCTCAGCCTAGGCGCA,200,2914396
ompRp4,28.428571428571427,204,6,TTCTTACATAACCCAAAGGT,198,2915352
ompRp4,32.666666666666664,200,5,CACCTACAGTAGACGGGTTC,195,2914923
ompRp4,97.0,194,1,TAAATGGCTAGATCCCCTTC,193,2921476
ompRp4,30.833333333333332,189,5,CGTTATTACTTTAATCACAA,184,2907924
ompRp4,92.5,185,1,AAGCCGTGAGTAGTGAGATA,184,2918466
ompRp4,91.5,183,1,AAAGGCGCGCCGGGCACTAC,182,2921745
ompRp4,85.5,171,1,AACGCAAGCGAGACAGCGGC,170,2937298
ompRp4,84.0,168,1,CCAAAATTGTGGTGCGTTAA,167,2919901
ompRp4,33.6,171,4,CAAAGGACGATGTAAGCCGA,167,2926790
ompRp4,55.666666666666664,168,2,TCACTTACATAGTCGTGTCC,166,2916934
ompRp4,83.5,167,1,GGCTGAGTCGCCCCACCTAT,166,2920260
ompRp4,83.0,166,1,TTGCGGATATTAGGATCAAC,165,2923206
ompRp4,54.0,163,2,GGTACGGTCGCATTTCCCGA,161,2920065
ompRp4,53.666666666666664,162,2,CGCCTCCAGATGGGCGTTTA,160,2910838
ompRp4,52.333333333333336,158,2,GAACGGGTGTCGGGAGCCGA,156,2919701
ompRp4,6.826086956521739,178,22,CCTTCTTTTCTGGCCCAATT,156,2911602
ompRp4,52.333333333333336,158,2,AGCTAGATGTAGCCGCCGGT,156,2928504
ompRp4,78.5,157,1,AGCGAACATACATCCTGTCA,156,2910818
ompRp4,51.333333333333336,155,2,TCAAGCAGATACCAATTTGG,153,2937505
ompRp4,30.8,157,4,ATCTGACACCAGCGCTATAT,153,2922768
ompRp4,30.8,157,4,ACTGGTATATCCATTCCCCG,153,2911599
ompRp4,37.75,153,3,TCTAATACCGGACTGCAACG,150,2908028
ompRp4,75.0,150,1,GTGGGTTCCGCAAATACTGT,149,2907978
ompRp4,50.0,151,2,GACCATCTTGGTACACCTCA,149,2937860
ompRp4,75.0,150,1,CTAATTCACACATTTCACCC,149,2926542
ompRp4,74.5,149,1,GCGCCGCCCTGTTTTGATGG,148,2914366
ompRp4,49.666666666666664,150,2,CGATAATTTCTCATTTTACT,148,2914833
ompRp4,21.0,152,6,GACCTCAGTGACGCCAGCCA,146,2908395
ompRp4,28.8,147,4,TACGGGAAAGATCACGTGTG,143,2922771
ompRp4,71.5,143,1,CCGGGGCTCGGAGGTACAAA,142,2929708
ompRp4,47.666666666666664,144,2,CAAGCCTTGATTTGAACCGC,142,2912110
ompRp4,23.5,145,5,TAGGCATAGACGAAAGAGGA,140,2908684
ompRp4,70.5,141,1,CCTGGTGCAACCAGGCTCCT,140,2935181
ompRp4,20.0,145,6,TGGTCAAAGAAATACCATGC,139,2909308
ompRp4,46.666666666666664,141,2,TCAACGGATCTGGCAGTCCT,139,2925549
ompRp4,46.666666666666664,141,2,CTGTTATTATAGATGTTGAT,139,2909701
ompRp4,69.0,138,1,CTAGTAACAGAACACTACCA,137,2920703
ompRp4,68.5,137,1,TACCTCCCAAGCCAGATCGC,136,2930430
ompRp4,44.666666666666664,135,2,CTAGGTCTATGGTTTCTCTG,133,2909879
ompRp4,14.777777777777779,140,8,CTAGATTATGCTTGTGCGTC,132,2911375
ompRp4,65.0,130,1,ATAGGATTTTGGAGTCATGA,129,2908029
ompRp4,64.0,128,1,TTCATCTCGAATTAAATGAA,127,2923011
ompRp4,64.0,128,1,TGACCGCAGACACATTGTGA,127,2910475
ompRp4,18.285714285714285,133,6,AGTTACCCTCTAGGCATGGT,127,2913340
ompRp4,7.9375,141,15,TAGAAGTGTCAGATGTGGGG,126,2914365
ompRp4,31.75,129,3,CCGTTGCGCGGATCGGCACT,126,2907699
ompRp4,25.2,129,4,GGTCTGGCGAGGGGTGTTTA,125,2919841
ompRp4,63.0,126,1,CCGGCATTCACATATAACTA,125,2928506
ompRp4,62.5,125,1,AGGTGTTGTTTCTTATCAAA,124,2933103
ompRp4,31.25,127,3,ACATCGTGGTCAGGAAGCTT,124,2907925
ompRp4,62.0,124,1,CGCACCTTATGATGTGTCAC,123,2915341
ompRp4,20.666666666666668,128,5,CCGCGAGCCAAGTCTCCAGC,123,2923654
ompRp4,15.375,129,7,CGACGGCATCTCGTTTTCTC,122,2934568
ompRp4,30.75,125,3,ATAAGGTGCGAGGGACGCAT,122,2922001
ompRp4,60.5,121,1,TTGCTGCCAACTCAATCGCA,120,2916234
ompRp4,60.5,121,1,TTCTTTCTTAACGACCTTGT,120,2916007
ompRp4,40.0,121,2,CGCCGAAAGTCTCAAGGGGG,119,2921693
ompRp4,39.666666666666664,120,2,AGCCAGGTGACGGCCTCATT,118,2929378
ompRp4,59.0,118,1,AGAGTGAATGAAGACTACAT,117,2917806
ompRp4,39.0,118,2,CTATACGGTGGTCTCTCGCT,116,2909542
ompRp4,14.625,123,7,ATAGTAACGGCCAACAGTGT,116,2927643
ompRp4,58.0,116,1,CTGCTAGATACCTACGAAAC,115,2912913
ompRp4,57.0,114,1,ACTAAGTACCCGCCTATTGC,113,2936204
ompRp4,28.25,115,3,GTAACCGGAATATACAGTTA,112,2930361
ompRp4,56.0,112,1,TCGAGGCCACACAACACACT,111,2927204
ompRp4,28.0,114,3,CTCCCTTAAGTGCCAACCTG,111,2917362
ompRp4,55.0,110,1,TTGTTAGATCGACGGGTGTT,109,2921423
ompRp4,22.0,113,4,GACCCACTTAGGTCATTCCT,109,2913595
ompRp4,5.45,127,19,TGCCACATCCATGGTGCCAC,108,2916326
ompRp4,18.166666666666668,113,5,CGGACTGGGGGTTGCGTTAA,108,2910597
ompRp4,27.25,111,3,AAAACTGGGCTGGCGTAAAA,108,2912848
ompRp4,54.0,108,1,GCGCGATGTAGATTTTTCAA,107,2909042
ompRp4,17.833333333333332,111,5,CGACTTGATCGCATCCAACA,106,2908378
ompRp4,11.777777777777779,113,8,CACCCTGGTCGGTAGTATGT,105,2910271
ompRp4,53.0,106,1,ATATTGATGCTGAACAAGAG,105,2911072
ompRp4,52.5,105,1,TAGCAATCTCTCTGGGGATA,104,2929826
ompRp4,26.25,107,3,CATCGATGGGAGCTATCTGG,104,2920185
ompRp4,12.875,109,7,CTCGGGTTGCCGGGGATTGT,102,2909176
ompRp4,20.4,105,4,TCTTTCTGCGGGTCAGGTCC,101,2930673
ompRp4,12.75,108,7,GCTCACGTCTGTAGCAGGCC,101,2911469
ompRp4,51.0,102,1,AAGGGCAGATACGTAAACCT,101,2918475
ompRp4,33.666666666666664,102,2,TGAAGCGGTACTCCTCCTTA,100,2908799
ompRp4,16.833333333333332,105,5,CGCTTCTAAAGGGACTCCTC,100,2920276
ompRp4,50.0,100,1,CCCTGTCTAAAGCTCACCGC,99,2917586
ompRp4,25.0,102,3,CACTTGCCATAATTCGCGGG,99,2918710
ompRp4,50.0,100,1,ACCCTGGATGTCGCGCGCAA,99,2915839
ompRp4,33.0,100,2,GCGTACTCGACCTATTCATA,98,2914367
ompRp4,24.75,101,3,ACCCCCACGGGTTCCGTTGA,98,2933299
ompRp4,49.0,98,1,CAGGAAAAGTAGAAATAACT,97,2910611
ompRp4,32.666666666666664,99,2,CACGGGTGATAGAACCGACT,97,2911632
ompRp4,5.705882352941177,112,16,CAGGCCTCTCTGCATGAGGT,96,2911986
ompRp4,48.0,96,1,ACGCGCGGTCAGTTAGTAAG,95,2921962
ompRp4,31.666666666666668,96,2,TGTGTGGCGTACCCCTATGT,94,2930615
ompRp4,10.555555555555555,102,8,TGGGACTTGGAGTCACCATA,94,2921038
ompRp4,47.5,95,1,GCTCTCATTATTTCTAATAT,94,2908942
ompRp4,23.5,96,3,TGACCATTCGTTACGGTGAG,93,2917263
ompRp4,47.0,94,1,GCTTTCGCGGCCTTAAGACC,93,2913613
ompRp4,18.6,96,4,GGTGGGGGTATATTATGACC,92,2921359
ompRp4,23.25,95,3,CTTCTGGCAAGTGATTAACT,92,2930459
ompRp4,46.0,92,1,TGCCGGCACAAACCTTTTAC,91,2919084
ompRp4,30.666666666666668,93,2,TGAGGACCCAACCACGAGGT,91,2932977
ompRp4,11.5,98,7,GTAACGTTCGGTGGCCGTAT,91,2919422
ompRp4,7.666666666666667,102,11,CGTATCAGGGCAGACCGTGA,91,2929114
ompRp4,15.333333333333334,96,5,CAGAAATAGTTGGCGGAACG,91,2936253
ompRp4,23.0,94,3,AATTAAGGGTGGGTAATCCC,91,2938297
ompRp4,18.2,94,4,CAGTTATGAACTGGACATTG,90,2924089
ompRp4,10.0,97,8,GGTTTGCAACGAACAGGGTT,89,2910031
ompRp4,45.0,90,1,GGTGTGACCTTCAGAGGGAA,89,2933802
ompRp4,45.0,90,1,CTGTGCATATCAGCATTTCT,89,2919102
ompRp4,45.0,90,1,ACGAGGATGTCCGGACGACT,89,2925352
ompRp4,29.666666666666668,90,2,TCGAAACCTCAGTTCATCAT,88,2928870
ompRp4,44.5,89,1,TCAGTCTACGAGAATCCTTA,88,2924573
ompRp4,22.25,91,3,TACAACGTCACGCTATACAT,88,2915346
ompRp4,44.0,88,1,TTTCCGCCGGCGGGCTGATC,87,2922236
ompRp4,6.769230769230769,99,12,GAGTATACACCAGAAGGATA,87,2914436
ompRp4,29.333333333333332,89,2,CAATCGTACGCCGAGCCTAA,87,2929673
ompRp4,29.0,88,2,ATGGAGGGAAACAAAGTTCA,86,2911739
ompRp4,9.666666666666666,94,8,ACTATGCTAAAAGCGTGTTG,86,2908994
ompRp4,43.0,86,1,GATCCAAAGCCCCCGGGGAG,85,2927697
ompRp4,43.0,86,1,CGTTAAGAGCGGGAAGTGCA,85,2925470
ompRp4,28.666666666666668,87,2,CAGCCGGTGTTACGAAGCCC,85,2910918
ompRp4,42.5,85,1,TTACTCCCGCGTTATAACTT,84,2936060
ompRp4,42.0,84,1,TCCTCACGAAAGTTGCGAGA,83,2928454
ompRp4,21.0,86,3,GGGCCGACCTTATGATTCAA,83,2909672
ompRp4,42.0,84,1,AGAGCCGACCGCGGCATCCC,83,2911419
ompRp4,28.0,85,2,ACACCATACCAATGCTTTTA,83,2936188
ompRp4,42.0,84,1,AATACCGGGCAGTTTCCATA,83,2919392
ompRp4,41.5,83,1,TAGCAGTCAGGGTATGAGTG,82,2925124
ompRp4,13.833333333333334,87,5,GGTGCGCCAACACAGATTGG,82,2931410
ompRp4,11.857142857142858,88,6,GGGGTAGCCTTATCGATGCT,82,2913913
ompRp4,13.833333333333334,87,5,CCTACAGTGAATTCGATGGG,82,2911598
ompRp4,20.75,85,3,CATTAAGGCGCCAGCCTTAC,82,2930748
ompRp4,27.666666666666668,84,2,AGTGTGTAACCATTTAGGCG,82,2917387
ompRp4,41.0,82,1,GTCCGCTCAGTACTGAGTGG,81,2907719
ompRp4,20.5,84,3,GATGCCAGGCTTCACATCTT,81,2936574
ompRp4,41.0,82,1,CTTGCGTCAGGACAGAAGTT,81,2921994
ompRp4,27.0,82,2,TGCAACCGTCCCGGGTCGTG,80,2924392
ompRp4,16.2,84,4,GTAAGTCTAGAAGCCAGGGA,80,2930226
ompRp4,4.764705882352941,96,16,CAATGGCTGTTATCCAGTAT,80,2927202
ompRp4,40.5,81,1,CAAGTTGGTAACGAAAAGAG,80,2909592
ompRp4,11.571428571428571,86,6,AACTACCCGATCCATAGATT,80,2924079
ompRp4,16.0,83,4,TCGTCGATCCAGCTTGGCTG,79,2909432
ompRp4,40.0,80,1,GGCTTTAGGTGAGAACGCAT,79,2908275
ompRp4,40.0,80,1,CGACTGGCTACCCTGTTCGG,79,2910557
ompRp4,16.0,83,4,CGACCCTCTTTGTGCACCTA,79,2921135
ompRp4,26.666666666666668,81,2,CCCTGGGAAGGATCAACTTT,79,2926730
ompRp4,13.333333333333334,84,5,AGTTTAACCTTCAAGGGCTA,79,2923400
ompRp4,13.333333333333334,84,5,AATGAGAACGATTGCGACCC,79,2925609
ompRp4,19.75,81,3,TTAGGTTAACTCCCAGCGTA,78,2908484
ompRp4,26.333333333333332,80,2,CGTTGCTGAAAGTATCTAGA,78,2923904
ompRp4,6.583333333333333,89,11,AGAACCGGAATTGTCGTGTT,78,2909334
ompRp4,39.0,78,1,GGTTTGGGAAACTCGTGTTT,77,2921192
ompRp4,19.5,80,3,CGTTGCCACATTTTTCGTTT,77,2916566
ompRp4,15.6,81,4,AACTGGAAATTAATGGCAGG,77,2918228
ompRp4,38.5,77,1,TCATCTCTGAATGTTAGCGC,76,2937517
ompRp4,25.666666666666668,78,2,GTTGTCGGCCCGGATGATAC,76,2914441
ompRp4,38.5,77,1,GGCCCCGATGAGTGTAATAA,76,2914489
ompRp4,38.5,77,1,GACTCAGAGTTCACGCACCA,76,2908351
ompRp4,15.4,80,4,CGGAGCAATTTCAGTAGACA,76,2923012
ompRp4,19.25,79,3,ACGCCTTTTATTTACGAAAA,76,2911266
ompRp4,15.4,80,4,ACCGAGTACATAGGTGTGTT,76,2911597
ompRp4,25.333333333333332,77,2,TTAGGTGTTGAGCTAAAGCA,75,2934994
ompRp4,38.0,76,1,TGGAGGCCGTGTGTGGGACA,75,2912923
ompRp4,38.0,76,1,TGCAAGTCTGTGGCAATATG,75,2909877
ompRp4,25.333333333333332,77,2,ACAGGAAGAGTGTGATCACT,75,2931412
ompRp4,25.333333333333332,77,2,AAGTGACGATGATATTTCAA,75,2931847
ompRp4,25.333333333333332,77,2,AAGGACTCTGTTCCCAACTC,75,2915107
ompRp4,37.5,75,1,TTACTCAAGCGCACTGGCGA,74,2917420
ompRp4,15.0,78,4,GTTGCTAACCTACGAGCCAA,74,2910955
ompRp4,25.0,76,2,CGGTTGGCAGGCCAGGTCAT,74,2919610
ompRp4,5.357142857142857,87,13,ATCTGCGCCTCGATAAACGT,74,2916739
ompRp4,37.5,75,1,AAATGATTATTTAATGTTTA,74,2933933
ompRp4,18.5,76,3,TCATCTTACTTTAAATACAG,73,2920115
ompRp4,24.666666666666668,75,2,GGGTTAACCCTGACAATTCT,73,2933960
ompRp4,37.0,74,1,CATTAGTCCAACAGAATCAT,73,2930711
ompRp4,37.0,74,1,CACTAAATGATGCATTATAC,73,2932166
ompRp4,24.666666666666668,75,2,ACTATACCGCTTTGGAGGAA,73,2912422
ompRp4,18.5,76,3,ACCGTATTACTGGGTTGTAC,73,2921567
ompRp4,24.666666666666668,75,2,ACAAAATGGGTAACGGCAAT,73,2910345
ompRp4,24.666666666666668,75,2,AAAACACGACAGTTACAAGC,73,2935779
ompRp4,36.5,73,1,TAGCCTCGCAGTCGCCGATG,72,2920256
ompRp4,36.5,73,1,GTTGATAGCCTATCAATGTT,72,2924031
ompRp4,18.25,75,3,GGTCCCAGGCTGACCCAGTT,72,2934139
ompRp4,18.25,75,3,CTAAGAAAGACGCCGACCAC,72,2917523
ompRp4,36.5,73,1,AAGCGCTGGCAACTTAAGCA,72,2908888
ompRp4,36.0,72,1,TGAGTATAATGTGTCGAGAG,71,2909434
ompRp4,36.0,72,1,TCTTTTACAAGAGCTGCTTC,71,2937437
ompRp4,24.0,73,2,TAGCACTCAGGCCATAATTC,71,2928756
ompRp4,18.0,74,3,GAGCGCTCTATGCCTAACCC,71,2924755
ompRp4,12.0,76,5,CATGATGCGGCTTGTATTAA,71,2912275
ompRp4,36.0,72,1,CAATTTGTAGTTTGTTCACA,71,2919182
ompRp4,6.545454545454546,81,10,AAAGTAAGTATGCTTAACGT,71,2923754
ompRp4,35.5,71,1,GGCCATATAATAGGCGCAGC,70,2921128
ompRp4,11.833333333333334,75,5,GAGTCATCGATATGTATTGA,70,2909083
ompRp4,8.875,77,7,CAGTCTCACCCAGTATATTC,70,2929255
ompRp4,23.666666666666668,72,2,CAACCTTCACATTCCTTCTG,70,2908800
ompRp4,17.75,73,3,ATAATCGTCCCGCACGAACA,70,2915699
ompRp4,35.5,71,1,AAGGCATGTCCAGATATGCG,70,2926221
ompRp4,23.333333333333332,71,2,TTAAAGCGAGGTTTAAGAAG,69,2928833
ompRp4,35.0,70,1,CCAAAACCGGACCCAATATA,69,2932585
ompRp4,35.0,70,1,AGGTTTCATCAACCGTGTTC,69,2915253
ompRp4,7.0,78,9,AAGCCCGCGTGAGCCCTAAT,69,2911820
ompRp4,34.5,69,1,GTCCCGCCTATCAGGCGTAT,68,2924371
ompRp4,13.8,72,4,GCACAGCGGCAGAGTACGAA,68,2912135
ompRp4,23.0,70,2,GAGAACCGAAATCGGAACGT,68,2913641
ompRp4,34.0,68,1,TGTGGTTCCTTGTGCCGGTG,67,2910791
ompRp4,9.714285714285714,73,6,TCCCCCCCTCCTAGAGTCAT,67,2911613
ompRp4,11.333333333333334,72,5,TCAAACCGGACAGATTGGCG,67,2913752
ompRp4,34.0,68,1,TAACGTCCTGTGTCAAGTCG,67,2935332
ompRp4,34.0,68,1,GGAGCTAGCGGGACTCACTT,67,2937100
ompRp4,13.4,70,4,CTCTGGAATGTTCTCACGCC,66,2926159
ompRp4,16.75,69,3,CGGGTCCATAGGATGGGACA,66,2912608
ompRp4,13.4,70,4,CCAAGGGTGCGACGTTGCGA,66,2926285
ompRp4,4.466666666666667,80,14,CAGTGTACGTTAAACGATTC,66,2907780
ompRp4,33.5,67,1,AAACATCCACTACCTCACTA,66,2917540
ompRp4,16.5,68,3,TGACGAACGCCCCTCAATGA,65,2923884
ompRp4,16.5,68,3,TCATGCCTGGGGAGGCCATC,65,2927731
ompRp4,22.0,67,2,TCAAACTCGTGAACAAGATG,65,2926111
ompRp4,4.714285714285714,78,13,TACTGGCTACCGGCCACGCA,65,2932171
ompRp4,16.5,68,3,GTCAATGAGTCTCTACCTGA,65,2918531
ompRp4,33.0,66,1,GCCAGCTGAGCTGGATTGCT,65,2925284
ompRp4,7.222222222222222,72,8,TTGGATGAGTCAAAGGCGAT,64,2911005
ompRp4,7.222222222222222,72,8,TATCGGAGCATTACAAACGG,64,2927535
ompRp4,21.666666666666668,66,2,TAACTCCCATGCAACACATT,64,2917212
ompRp4,32.5,65,1,GTTGGTGTATTGGAGACTTA,64,2935502
ompRp4,10.833333333333334,69,5,GTTACCGAATTTCAATAGCA,64,2926588
ompRp4,6.5,73,9,GGTGTTGAACTGGAGTGAGG,64,2934044
ompRp4,21.666666666666668,66,2,GCCCCGGTCGAGAGTTCTGT,64,2915782
ompRp4,32.5,65,1,CTTCACTTTTCCAGCCCACA,64,2927725
ompRp4,10.833333333333334,69,5,ACCCCGTATGGCGAACGCGT,64,2910233
ompRp4,32.0,64,1,TTTGAATACGTTATCGGTTT,63,2917236
ompRp4,32.0,64,1,GATTTTATCCCGAAGCAGTA,63,2934585
ompRp4,32.0,64,1,GATGTCCCACAACGGATCAG,63,2922449
ompRp4,32.0,64,1,CCAAGAGTCTCCCATTCTTT,63,2930038
ompRp4,9.142857142857142,69,6,CAGAGGTCCCACACCTCGGA,63,2908349
ompRp4,21.333333333333332,65,2,ACTGCAAAGTCCCGACATAC,63,2925889
ompRp4,31.5,63,1,TGTTAATCTCACGCTCTTTG,62,2927323
ompRp4,21.0,64,2,TGTATGCTTAGCAAACTAGG,62,2929591
ompRp4,21.0,64,2,GTCCTATTTCGTATACGCGA,62,2921658
ompRp4,12.6,66,4,GCATCTGCAATCCGCAGTTC,62,2926436
ompRp4,21.0,64,2,GACCCCACACAGTCCAATAG,62,2919819
ompRp4,21.0,64,2,ATTCCAGTAACCGAAGGTGG,62,2929977
ompRp4,31.5,63,1,AAGCGCGCATGTAACTGAGA,62,2915926
ompRp4,31.5,63,1,AAGATACTTTTGGTCAACAC,62,2911822
ompRp4,10.333333333333334,66,5,TAGAAAACGGCGTTGATTCA,61,2909309
ompRp4,31.0,62,1,GAGGTCGAAATTCCAGTATC,61,2936573
ompRp4,12.4,65,4,CGGCCCAAACACGGATTTGT,61,2908350
ompRp4,8.857142857142858,67,6,CATAGCGACAGCCAACAAAG,61,2920372
ompRp4,20.666666666666668,63,2,CACGAGACCCTCCCACTGGA,61,2910276
ompRp4,10.333333333333334,66,5,AGGACCTTATGTGAGCGCCC,61,2916899
ompRp4,20.666666666666668,63,2,ACGGGATACAAAGTCGCAAT,61,2929611
ompRp4,12.4,65,4,ACGATCTAGCGTGTTCGTGT,61,2930060
ompRp4,15.5,64,3,AAGAATAGAACGCTCTGGGG,61,2914215
ompRp4,31.0,62,1,AACTTTGAACCCGCATTTAG,61,2937434
ompRp4,30.5,61,1,TTAAGAGCGAAGCTCATGTA,60,2910821
ompRp4,12.2,64,4,TGGAGTCCGCCTTGCGAGTA,60,2908422
ompRp4,20.333333333333332,62,2,TCCTTTTACCCCTTGATTCC,60,2930131
ompRp4,7.625,67,7,TCCGCTGCGCGTAGAACGCA,60,2925326
ompRp4,20.333333333333332,62,2,GGATCCTGGCCCCGGATTAT,60,2917665
ompRp4,30.5,61,1,GCTTGTCATACATTCATTCA,60,2936575
ompRp4,12.2,64,4,GAGGCAGGGAGTCACTTTTT,60,2924778
ompRp4,30.5,61,1,CAAGGCATCCGTATGAATGA,60,2936961
ompRp4,12.2,64,4,ATGTGCACGGATCGTGAAAC,60,2936114
ompRp4,30.5,61,1,AGTCAGCCCATGCAGGTAGT,60,2926587
ompRp4,30.5,61,1,AGGATTATGTTTGGTAAAAC,60,2918730
ompRp4,30.5,61,1,AAGTCTCTTGTGTTTTACTC,60,2916398
ompRp4,30.5,61,1,AAATTTAGCACCCAACTAAC,60,2930853
ompRp4,30.0,60,1,TTCTGTTTTATAGCGTCCGC,59,2916461
ompRp4,30.0,60,1,TGAGCAGTCCAGGCGGTGTA,59,2908914
ompRp4,7.5,66,7,TCGCCTGTCGGTAGTGGCTG,59,2928739
ompRp4,7.5,66,7,GTCATTCTTTTTTACCTTAC,59,2919396
ompRp4,6.0,68,9,GCCCAAAAAGCGATCAGTAT,59,2937637
ompRp4,30.0,60,1,GAGAAGCATCCAACCCTTAA,59,2917808
ompRp4,20.0,61,2,CGCGATCTCATCGCGTCATG,59,2930601
ompRp4,30.0,60,1,CATGTCTTTGAGGAACCGCA,59,2933271
ompRp4,11.8,62,4,TTCTTCGCTAATCGTTTGGT,58,2921045
ompRp4,19.666666666666668,60,2,TGAACACAATATTCAGCTTA,58,2910559
ompRp4,11.8,62,4,TGAAATAGTCACGGTTCGGT,58,2913702
ompRp4,29.5,59,1,GAGGTTCCTCGTGGTCAACG,58,2921087
ompRp4,19.666666666666668,60,2,CCGTCTGCCCAGCAACGGCA,58,2915993
ompRp4,29.5,59,1,ATACAAGTAGCTGCTTTTCG,58,2914316
ompRp4,19.666666666666668,60,2,ACAATATTTGAAGTTAGTTG,58,2914342
ompRp4,19.333333333333332,59,2,TTATATCCAATCAGAGGTTT,57,2917317
ompRp4,19.333333333333332,59,2,GTACCGATCTCACCGTTACA,57,2912871
ompRp4,14.5,60,3,GCACCCTACTAAACTGTCCT,57,2931676
ompRp4,6.444444444444445,65,8,GACGGAGAGTAGGCCTGATA,57,2921570
ompRp4,9.666666666666666,62,5,CATTTGGGGCCGATTAATGT,57,2917562
ompRp4,19.333333333333332,59,2,ATTGGAACAGAGTAACTCGT,57,2928903
ompRp4,19.333333333333332,59,2,AGTGGATCCCGAAATACTTA,57,2907695
ompRp4,29.0,58,1,AGAGTGTATATTTGGGACTT,57,2933808
ompRp4,8.285714285714286,63,6,ACCGCGGTTTCACGTGACTT,57,2911845
ompRp4,29.0,58,1,AAGCGATGGCGTGTGGCCGG,57,2934774
ompRp4,14.25,59,3,GGCGCCCGCCAGCGTATTGT,56,2929297
ompRp4,11.4,60,4,CGGACTGCTCATGGTTGGGC,56,2908401
ompRp4,19.0,58,2,CGCCAATGAAAGGAGTCTCA,56,2909465
ompRp4,19.0,58,2,CCCCGTCCTACCTGAACATG,56,2930911
ompRp4,19.0,58,2,CAGCGCGAATCCCACGAACA,56,2911226
ompRp4,28.5,57,1,ACCCCAGCAGCGGCCAGATA,56,2935243
ompRp4,19.0,58,2,AAACTGACTAATCCTTACCT,56,2919426
ompRp4,8.0,61,6,TACCGTGTCTGTTCGGGGTA,55,2930746
ompRp4,28.0,56,1,GGAGTGGTATTAAGGACATT,55,2917717
ompRp4,14.0,58,3,GCCCCCCTAACGTTGTAACA,55,2911611
ompRp4,11.2,59,4,GAGCTTACACAGTTCTTTAG,55,2919462
ompRp4,28.0,56,1,CTCATCGACGAAGACCATTT,55,2915418
ompRp4,14.0,58,3,CCGTCCAGATGTGCGTTCAA,55,2920382
ompRp4,18.666666666666668,57,2,CAGTCATTCACTCATCGCGG,55,2932064
ompRp4,9.333333333333334,60,5,ATCGACTGGTGGTTCTGATT,55,2931413
ompRp4,8.0,61,6,ATAGGCAGTAAAAACCCGGA,55,2928563
ompRp4,7.0,62,7,ACGTGCAACGGGAAATTGTC,55,2914894
ompRp4,14.0,58,3,ACCACTATGGGTCACCTGAT,55,2937556
ompRp4,9.333333333333334,60,5,ACACAGACGCCACGGTTATG,55,2921209
ompRp4,11.0,58,4,TTCGCATGACGGCACGAGGG,54,2937445
ompRp4,18.333333333333332,56,2,TCCTTGTAGCAGTTCGTACT,54,2910424
ompRp4,18.333333333333332,56,2,GTTGGGAATCTTTCGCATCA,54,2935252
ompRp4,13.75,57,3,GCTAATTTGCAAACGGAGAT,54,2928045
ompRp4,27.5,55,1,CTCTGTTCGTCTCGCAATCA,54,2910984
ompRp4,5.5,63,9,CGATATCTGGGCGGCCCATG,54,2911071
ompRp4,5.0,64,10,CCCTACCTGTCCGAACAGGG,54,2930603
ompRp4,27.5,55,1,CCATCAGCATTCCTATTCCA,54,2936083
ompRp4,27.5,55,1,CAATTATAATCCTCCAAATT,54,2913197
ompRp4,27.5,55,1,AGGATGGCTTGGTTACAGCA,54,2910188
ompRp4,27.5,55,1,AGCGGCGATGTGCTTTTTCG,54,2938076
ompRp4,13.5,56,3,TTTTAACTAATGTCGCAGGC,53,2916194
ompRp4,18.0,55,2,TTGTTCCTAATGACCTTTTT,53,2928614
ompRp4,27.0,54,1,TTCAGTTAAGGCGCTTCTGT,53,2913734
ompRp4,6.0,61,8,TGGTCGTGTGACTCGGTTTT,53,2916191
ompRp4,18.0,55,2,GTAGATGTCATCCGCAGTCG,53,2926002
ompRp4,27.0,54,1,GCCACCCTACTGTTGACCGT,53,2913378
ompRp4,9.0,58,5,GACGCAAGGTCGTTTATGGT,53,2925329
ompRp4,10.8,57,4,CGTAGCCGCGGGTCTTACTA,53,2936039
ompRp4,10.8,57,4,CCAACCATGTAACGAGGTGG,53,2931252
ompRp4,13.5,56,3,ACCCATCTAAACGTCGGGTA,53,2930066
ompRp4,27.0,54,1,ACACGCTGTACACGAACGAC,53,2932067
ompRp4,10.6,56,4,TTCACACGGAAGCGTCGTAG,52,2908221
ompRp4,26.5,53,1,TCGCCGTTGACGTTCAGTAG,52,2908428
ompRp4,26.5,53,1,CGTTGAGCCCGGTATAGCCT,52,2922951
ompRp4,10.6,56,4,CCCGCAGGGGGAATCGGTGT,52,2911321
ompRp4,17.666666666666668,54,2,AATGGCGAGCGTTCAGTACA,52,2923409
ompRp4,10.4,55,4,TCGTTGACCCCGGACTGGCT,51,2929501
ompRp4,13.0,54,3,GCATATTTACTGAACCTAGT,51,2924374
ompRp4,8.666666666666666,56,5,CTTCGTGGTTTGCTGGTGAC,51,2916083
ompRp4,26.0,52,1,CTCGTTAGACATTGTACTCG,51,2926455
ompRp4,10.4,55,4,CGTGATACCAGTGGCAGGCA,51,2917353
ompRp4,17.333333333333332,53,2,ATTCCACAAGTTAAATAGCT,51,2933038
ompRp4,26.0,52,1,ATGCGTGAGTAGGAAGTGGG,51,2910922
ompRp4,26.0,52,1,ATCAGAAATGAAAGCTCTTT,51,2917720
ompRp4,26.0,52,1,AGAGGAAATTAGGGGTCTTT,51,2926112
ompRp4,17.333333333333332,53,2,ACGTATGATTGTATACGTTG,51,2916534
ompRp4,26.0,52,1,AACGTTTTTTATTAGCCGTC,51,2937643
ompRp4,25.5,51,1,TTCGATTGACGATTGACGAG,50,2933365
ompRp4,25.5,51,1,TGCTATTTCGGGTGCAAATC,50,2935732
ompRp4,10.2,54,4,TCACGCTCCTACTCTCAGAA,50,2909433
ompRp4,12.75,53,3,TACTGATGATGAGTCTGTGA,50,2914510
ompRp4,25.5,51,1,GTTCGATATAACGCACTGTC,50,2936201
ompRp4,25.5,51,1,GGGGTCATGACTGGTACGGT,50,2933116
ompRp4,25.5,51,1,GATGCATACACCCATTGACC,50,2913661
ompRp4,7.285714285714286,56,6,CTTGTTCGGCTGTTACTTCA,50,2929172
ompRp4,4.636363636363637,60,10,CGTTCCGCCTTAAACATGGG,50,2924074
ompRp4,5.666666666666667,58,8,CGTTAAGATAGATAGCGAGC,50,2926574
ompRp4,10.2,54,4,CATGAACTCTCAACTGATCT,50,2934404
ompRp4,25.5,51,1,CACTTAAGTTCAATAGGACT,50,2908177
ompRp4,17.0,52,2,AGACTCCAAGCTGCTTCTTA,50,2920830
ompRp4,25.5,51,1,ACGCTTTTCTTCCGATGCGC,50,2920485
ompRp4,5.1,59,9,ACATCGCATAGCTCATCTGT,50,2914259
ompRp4,12.75,53,3,ACATAGGGGACATGGGCTGA,50,2921644
ompRp4,25.5,51,1,AATACGGGACACGAGGTGAT,50,2928008
ompRp4,7.142857142857143,55,6,TGCGCCTTGAGTCCCCCCTA,49,2914041
ompRp4,12.5,52,3,GGTGGCAATATCGCCCTGAA,49,2911606
ompRp4,16.666666666666668,51,2,GGTATAGGGTAGCGACATGC,49,2929203
ompRp4,25.0,50,1,CTTTTTGGGGAAAGTCGGGT,49,2918702
ompRp4,12.5,52,3,CTGTTCTACTGAGTGACCAT,49,2920312
ompRp4,10.0,53,4,CGGGACCCCGGTGTAAGACG,49,2929038
ompRp4,12.5,52,3,CGAATGCAACTCGTTCTCAC,49,2925985
ompRp4,25.0,50,1,CAGTCAGTATCACGCAAGTT,49,2924632
ompRp4,25.0,50,1,ATCGCAACAGAAAAAACTGC,49,2924978
ompRp4,25.0,50,1,AGGTTTTAGTGTGGTTCACC,49,2933894
ompRp4,9.8,52,4,TGGGGTTAAGCCAAGCCTGT,48,2933929
ompRp4,24.5,49,1,GTTTGCACGCGTGAGGGGAC,48,2925350
ompRp4,7.0,54,6,GTGCATACCAAACATTTACT,48,2930360
ompRp4,4.9,57,9,GGTAGCGGGTACGAACCTAT,48,2922839
ompRp4,8.166666666666666,53,5,GGCGTCGGTCAAGTTGCCTA,48,2912001
ompRp4,24.5,49,1,GGCCCTATGGTGCGGTAAGG,48,2934113
ompRp4,5.444444444444445,56,8,GACCTATCCCTGTTGGACAG,48,2921217
ompRp4,7.0,54,6,GAAGGCCATTGCTACCGGGG,48,2923461
ompRp4,9.8,52,4,CGTCATCTACCGCCGTCCCA,48,2915513
ompRp4,24.5,49,1,CGCCGCGTGCATGAGAGATC,48,2931150
ompRp4,3.2666666666666666,62,14,CGAGGGGGTGACGGATCCCC,48,2907888
ompRp4,6.125,55,7,CCATAACGGATACGGTGAGT,48,2908693
ompRp4,16.333333333333332,50,2,CAGGGCGCGATACAAAAAGT,48,2913970
ompRp4,8.166666666666666,53,5,CACTTGTTATTACGTATGCT,48,2924820
ompRp4,16.333333333333332,50,2,ATCCGTTTAGTGGTGGCCGT,48,2909251
ompRp4,4.9,57,9,AGCTGTTAATGCTGAGTAAT,48,2913940
ompRp4,24.5,49,1,ACCGTTGGTCAACGGTGAAA,48,2924273
ompRp4,5.444444444444445,56,8,AACAGGTTATGAGCCTAGAG,48,2930763
ompRp4,24.5,49,1,AAAAGGACACTGACTCCGGA,48,2920804
ompRp4,8.0,52,5,TGAACATGTGAGGTGTTACA,47,2918986
ompRp4,24.0,48,1,GTTAGTTTTCGCCGCGCCTA,47,2907755
ompRp4,8.0,52,5,GTGGGTGCAATGCTTACTTA,47,2913648
ompRp4,16.0,49,2,GTCCTAGACATAGCTTAACC,47,2919753
ompRp4,16.0,49,2,GGGTCTGTTAATAACCTGGT,47,2922654
ompRp4,6.857142857142857,53,6,GAATCAAAGGGGGGCGCTCA,47,2918185
ompRp4,12.0,50,3,CTCGGTCCAAAGATGATGCA,47,2926070
ompRp4,16.0,49,2,CTCCACCGGCCCTACTGAGA,47,2922969
ompRp4,24.0,48,1,CCCACCCTCGCTCTGAGGAG,47,2924387
ompRp4,9.6,51,4,CATCCGGGGTTACGCGGTGT,47,2908181
ompRp4,4.8,56,9,CAACAAGAAACCGCCGAGCT,47,2932142
ompRp4,16.0,49,2,ATGTTTTAATTGATCTGGCT,47,2919568
ompRp4,24.0,48,1,AGACTCGCAAGGGCGCATCT,47,2917934
ompRp4,12.0,50,3,AAATCAGCCCCGATTCAGAA,47,2910042
ompRp4,15.666666666666666,48,2,TGGGCTCGCTCAGATTACCT,46,2908479
ompRp4,23.5,47,1,TGAAGGCTACGTAGTAAGGT,46,2925872
ompRp4,3.9166666666666665,57,11,GGTCTCCGTTAGTGTGTTCG,46,2916878
ompRp4,23.5,47,1,GCGCGTCCCGCCGTGATCTT,46,2930730
ompRp4,23.5,47,1,CTGTCCGCTAAAGGGCAGAG,46,2937160
ompRp4,5.222222222222222,54,8,CCTACAATGGAAGCATCGAA,46,2911096
ompRp4,23.5,47,1,ATTCCATTGTTTTGTTACGC,46,2912809
ompRp4,23.5,47,1,AGAGCCTTATTCGTCCGAGA,46,2912742
ompRp4,7.833333333333333,51,5,ACCTCAGGTTGTCGGCGGTA,46,2925705
ompRp4,9.4,50,4,AAGGGATTAGAGACGAGGAC,46,2932066
ompRp4,6.714285714285714,52,6,AAATCCCAAAGGGTCAAGGA,46,2922268
ompRp4,23.0,46,1,TTGCAACGGGGTCGTCAAGA,45,2918022
ompRp4,15.333333333333334,47,2,TGACCAAAATTAGAGTACCC,45,2916246
ompRp4,7.666666666666667,50,5,TCACTCCGTACTGGTCGGGG,45,2914119
ompRp4,23.0,46,1,TACGACTACCCCTGTGCCCT,45,2917996
ompRp4,7.666666666666667,50,5,GCATTCGTCATTGCGGGGAC,45,2907977
ompRp4,9.2,49,4,GACAGGGTGGCCACTCGCTT,45,2909893
ompRp4,15.333333333333334,47,2,GAACAAGAGGAGTAGGAAGA,45,2923347
ompRp4,23.0,46,1,CCGGGAGGGAACACCCTTGC,45,2932967
ompRp4,15.333333333333334,47,2,CATGTTCTAGACTACGATAG,45,2932322
ompRp4,15.333333333333334,47,2,CACGTCGTGCGTGCACACAG,45,2924720
ompRp4,23.0,46,1,CAATAAAGCTGTTGCCATGG,45,2922353
ompRp4,22.5,45,1,TGTCCTGCCCTCCTTATATG,44,2932627
ompRp4,15.0,46,2,TGACCCATGCACTACTTGGT,44,2915783
ompRp4,22.5,45,1,TCAGAGCGTTGCTATCTAGA,44,2928331
ompRp4,22.5,45,1,TACTGGATGTATGAGCGGCT,44,2925469
ompRp4,15.0,46,2,GTATAAACCCACTGGATTCA,44,2922202
ompRp4,15.0,46,2,GGGCTACACTGGATCCAGGG,44,2925874
ompRp4,22.5,45,1,GCATTGTGCTAACAGATTTC,44,2925428
ompRp4,15.0,46,2,CCTAGGTCTACGACATTATG,44,2924683
ompRp4,22.5,45,1,AGCAAGGGACTACTTCCTTG,44,2925215
ompRp4,22.5,45,1,ACACTATCATCGGACACCGT,44,2911470
ompRp4,22.0,44,1,TTCTTGTTTCTAAGGGGAAC,43,2909518
ompRp4,11.0,46,3,TTCGAAATACCAGAACTAAG,43,2908499
ompRp4,22.0,44,1,TGGTTTAATGTGGTTATGGT,43,2921479
ompRp4,14.666666666666666,45,2,TGGAGGGGAACATGTGGTAA,43,2921416
ompRp4,11.0,46,3,TGCTGCCGATGTATACACTC,43,2931077
ompRp4,4.0,53,10,TATTCGACTACTAAGTCGCT,43,2908465
ompRp4,22.0,44,1,TACGGCATAAGAAAGTTTAC,43,2927403
ompRp4,11.0,46,3,GTTGTAACGGGCTGATCGCG,43,2909011
ompRp4,8.8,47,4,GTCGTGGCTTTCATGTGTTT,43,2917005
ompRp4,7.333333333333333,48,5,GTAGGGCGTGATAACGGGGG,43,2911993
ompRp4,14.666666666666666,45,2,GGTTAAAACGTGTTCGTCCC,43,2921155
ompRp4,14.666666666666666,45,2,GGGTCCGTGCCGCCAATTAA,43,2934869
ompRp4,22.0,44,1,CTGTTGCCCATGGTCGTAAT,43,2912360
ompRp4,11.0,46,3,CTCGAGTAACGTCGTCGTAT,43,2931882
ompRp4,11.0,46,3,CTCCCACACTTAGGGTATGA,43,2938114
ompRp4,5.5,50,7,CGGCCTTTAATGTCAGTAAT,43,2908114
ompRp4,22.0,44,1,CCGATTCCAGCGCGGGAGGC,43,2917953
ompRp4,14.666666666666666,45,2,CAGGATGTCTTGTGGCACTG,43,2920084
ompRp4,22.0,44,1,CAACTACAAAAATAATGACG,43,2937090
ompRp4,14.666666666666666,45,2,ATGACTTTCGGGGCTGAGGT,43,2935972
ompRp4,14.666666666666666,45,2,ATAGCGTTGCTCTGTGAGAG,43,2910165
ompRp4,11.0,46,3,AGTAGAAACTAAGTTTTTTC,43,2927381
ompRp4,22.0,44,1,AACTTTGCGTACAGCATGTA,43,2935319
ompRp4,6.142857142857143,48,6,TGACTGACCATAGGCTGGCC,42,2911160
ompRp4,4.777777777777778,50,8,GGGTGAACAACCCTGTTCGA,42,2930898
ompRp4,21.5,43,1,GCTGCGTCAGCATATGTATG,42,2932654
ompRp4,10.75,45,3,GCGCATTCTGGCGTTTGCGG,42,2928301
ompRp4,21.5,43,1,GCAGACGATTGATGACTTTG,42,2918978
ompRp4,21.5,43,1,GATCGGTTCGATTAGGCGCA,42,2937859
ompRp4,21.5,43,1,GATCACAGTTGTCTAGTCGC,42,2931158
ompRp4,10.75,45,3,CTTTACAGACTGGCGATGCA,42,2923872
ompRp4,21.5,43,1,CTACGAGGGGTTTATATGCT,42,2919908
ompRp4,21.5,43,1,CGATGCCCAGCGCGCGACCG,42,2924784
ompRp4,10.75,45,3,CCGATGTTCCAAGCTTGAGG,42,2913714
ompRp4,21.5,43,1,CCAATGTCCCACCAATTTGT,42,2912585
ompRp4,7.166666666666667,47,5,CAGGGTCATTGCCCGGCCTA,42,2922522
ompRp4,10.75,45,3,ATGCCGTGTGACGGGACCGA,42,2912649
ompRp4,7.166666666666667,47,5,AGTATAGTTTACGTTTCGCA,42,2925581
ompRp4,14.333333333333334,44,2,AGGTATAGCCTGAGTAAATA,42,2924715
ompRp4,6.142857142857143,48,6,ACTCTGGTTCCACAAAAATT,42,2912298
ompRp4,21.5,43,1,AATGTATCCGGTTGGTTAAG,42,2935170
ompRp4,21.0,42,1,TGGAGCATGAGCCGGTGTGT,41,2915490
ompRp4,14.0,43,2,TGATTTCTGCCACTTGGGGA,41,2913562
ompRp4,21.0,42,1,TCAAAGCGCACGGAGGCGAT,41,2937938
ompRp4,8.4,45,4,TATCATCCCTGGCGTTCGCA,41,2911473
ompRp4,21.0,42,1,TAGCCCAGAGTTTAGCTTCC,41,2912128
ompRp4,21.0,42,1,GTACACCATGTTTATGACGG,41,2923484
ompRp4,7.0,46,5,GGTACGAGCCGTGTAGACAC,41,2929286
ompRp4,21.0,42,1,GCCGTGGTTAGACGTGTATA,41,2910163
ompRp4,21.0,42,1,GCCGGGGCACGGAGATCTAG,41,2920352
ompRp4,21.0,42,1,CGTTGTACAGGCTGTACCGC,41,2918613
ompRp4,4.2,50,9,CGGCGTGTCGTTATTACTTA,41,2923719
ompRp4,5.25,48,7,CCGCCACCCAGGGCAGATTG,41,2908075
ompRp4,7.0,46,5,CAGTAGTAGACTCTGGAATA,41,2917082
ompRp4,14.0,43,2,CACATTGGGTGAAACCCTGG,41,2930186
ompRp4,21.0,42,1,AAAGAGCATGTCTTCGTTAG,41,2932610
ompRp4,20.5,41,1,TTCCCGTTGTATCACGATGG,40,2912853
ompRp4,13.666666666666666,42,2,TGTTGCTGATGGAGGGAACT,40,2911924
ompRp4,20.5,41,1,TGTGGTACTAATGCTTTATT,40,2928321
ompRp4,5.125,47,7,TGACGCAGTGGAAGTGGATA,40,2928041
ompRp4,13.666666666666666,42,2,TCCTCGAAGAGCTCGCGAGG,40,2931840
ompRp4,13.666666666666666,42,2,TCCAACCCAGGGTAATTGCC,40,2911019
ompRp4,20.5,41,1,TCAGGAGCGATTGCTAGTCA,40,2912707
ompRp4,20.5,41,1,GTTCACGGGTCCTTATCAAC,40,2937028
ompRp4,20.5,41,1,GTGCTGTCATGCGGGTAGCC,40,2936898
ompRp4,10.25,43,3,GTAAACTTACCTCACAGGCT,40,2928261
ompRp4,20.5,41,1,GGATACCAGGTGTCCGGCCA,40,2921071
ompRp4,13.666666666666666,42,2,GGAGGCCCTGCATCATCTAG,40,2934170
ompRp4,20.5,41,1,CTCAGCCTGTGATAATCTGA,40,2916173
ompRp4,10.25,43,3,CGGAGCTAGTCAGCAAGATG,40,2937518
ompRp4,13.666666666666666,42,2,CCTTAGTGATAGAATGCTCA,40,2918196
ompRp4,5.125,47,7,CCGTAAGTTAAACGGGTAGA,40,2910488
ompRp4,10.25,43,3,CCCATCTCTATTGACCTAAC,40,2915375
ompRp4,13.666666666666666,42,2,CCCATCAACGCTTCCTCGGT,40,2933273
ompRp4,13.666666666666666,42,2,ATTCGGGTTTGCCGTTACAA,40,2929325
ompRp4,10.25,43,3,ATGGACGCATACGAAAGGGA,40,2914611
ompRp4,13.666666666666666,42,2,AGAGCTGATCCGAGGAACCC,40,2935470
ompRp4,20.5,41,1,ACGCGTCTTGCGAGGAGATT,40,2910996
ompRp4,8.2,44,4,ACCTGCTTATCGTCCCGGCT,40,2927009
ompRp4,20.5,41,1,ACAGGCACCATACTGGTGGA,40,2912322
ompRp4,20.5,41,1,ACAAAGATCTACTAATAGAT,40,2909892
ompRp4,13.666666666666666,42,2,AATATGCCACACGGCTTCAT,40,2924900
ompRp4,20.0,40,1,TTGACGCCAACGAAACGCTC,39,2925690
ompRp4,13.333333333333334,41,2,TTCTATGTAGATAAAATGTC,39,2934894
ompRp4,20.0,40,1,TGCACGATAGCCTCCCTTAC,39,2927431
ompRp4,13.333333333333334,41,2,TGATGGACCGTAGACATAAC,39,2908414
ompRp4,8.0,43,4,TGATAGTCGGGTCTCGATCC,39,2913561
ompRp4,20.0,40,1,TCTGGAAATGGTGGGGGCGA,39,2915641
ompRp4,13.333333333333334,41,2,GCGCACTTAATTTCTGTCTG,39,2917417
ompRp4,20.0,40,1,GCGAGCGCAGTGCATGAACG,39,2920245
ompRp4,13.333333333333334,41,2,GCACTGTCACCGTCTTGGTT,39,2929349
ompRp4,4.444444444444445,47,8,CTGAGGATGCGTCGGTAGGT,39,2911376
ompRp4,20.0,40,1,CTCGGTGCAGGGTATCGTGA,39,2915784
ompRp4,13.333333333333334,41,2,CTCGAAATGTGTACCATCAG,39,2936455
ompRp4,13.333333333333334,41,2,CCTGCAGAGTATGAGGACGG,39,2916523
ompRp4,13.333333333333334,41,2,ATTCAACCAAAAAGACCCAC,39,2930300
ompRp4,20.0,40,1,AGTTGTTTTTGTGTCAACAT,39,2922557
ompRp4,13.333333333333334,41,2,AGGAACAAGGGCCTTCTGGT,39,2911028
ompRp4,20.0,40,1,AGACACAAGCAGAGTTACGT,39,2923813
ompRp4,13.333333333333334,41,2,ACCTTACATCAAAGACTACG,39,2914330
ompRp4,13.0,40,2,TTTTGGATCGCGACAGCGCT,38,2910612
ompRp4,5.571428571428571,44,6,TTGTTCACGACGAGCGGCTA,38,2936415
ompRp4,3.0,50,12,TTGCTCTCATAGGAAGGTTA,38,2913755
ompRp4,9.75,41,3,TGGCTCACGTCGCGAGATTA,38,2935800
ompRp4,13.0,40,2,TGCGACCCAGGATGTGCGTC,38,2916410
ompRp4,13.0,40,2,TGATCAGGGGCGTTAGATAC,38,2933596
ompRp4,19.5,39,1,TCACCCAGTGTAGATATGTT,38,2922819
ompRp4,13.0,40,2,GGTAGCGAGCAATCTGGAAA,38,2913456
ompRp4,9.75,41,3,GGATTTGGGTTAGGGCGGCT,38,2919134
ompRp4,4.875,45,7,GAGTGTCTGTGAGACTTTTG,38,2909612
ompRp4,19.5,39,1,CTGCGTCAAGAAACTGGTTT,38,2929829
ompRp4,7.8,42,4,CTAGCCCAGCAACTACTCTT,38,2928164
ompRp4,7.8,42,4,CGGTGACGGAAGAGCTGCAA,38,2925384
ompRp4,13.0,40,2,CGAATCTAGCTACGGCAGAT,38,2920219
ompRp4,5.571428571428571,44,6,CCCTCAATGAGAACCGGGTG,38,2932636
ompRp4,13.0,40,2,CACGGTACTTCTCAGGAGAT,38,2933501
ompRp4,9.75,41,3,ATTAGCAGGAGAAACGCTAT,38,2911238
ompRp4,19.5,39,1,ATCGGTCGTGGGGTCAAGTC,38,2913387
ompRp4,13.0,40,2,ATCGCAATTTCGCTTGGAAC,38,2910692
ompRp4,19.5,39,1,ACTATTTTCCCTTATACGTT,38,2929270
ompRp4,19.5,39,1,ACGCGTAGAGCCAGTTATCT,38,2934017
ompRp4,6.5,43,5,ACCCACAATCTGAATTATAT,38,2922034
ompRp4,19.5,39,1,AATATGTTTCTACATAGCTG,38,2910718
ompRp4,6.5,43,5,AAGCAGGCGGTTACTCCAAC,38,2914795
ompRp4,19.5,39,1,AAACTGTGGTCTAGACCTCC,38,2914832
ompRp4,19.0,38,1,TTACCGAGGTTCTTCCTTAA,37,2918186
ompRp4,12.666666666666666,39,2,TGTTCGCTCACAGTCTGCAA,37,2932429
ompRp4,19.0,38,1,TATGTACAAGTTATGGCTTA,37,2925172
ompRp4,19.0,38,1,GTCTAGGTTCGGGCCGCTGC,37,2920070
ompRp4,12.666666666666666,39,2,GTATAGAGATCAGAATGTCT,37,2912170
ompRp4,7.6,41,4,GCTGGAAACATCCCCACACA,37,2916592
ompRp4,19.0,38,1,GAGTTTATATCCACACACGT,37,2927326
ompRp4,12.666666666666666,39,2,CTGCTGATCACCGGTAGAAT,37,2919868
ompRp4,7.6,41,4,CGTCGTGCAAGTCATTCGCA,37,2918092
ompRp4,19.0,38,1,CGGATGAGGGGGCGTCGTAA,37,2918507
ompRp4,9.5,40,3,CGAGTAGCATTGAATTTGCA,37,2918469
ompRp4,19.0,38,1,CCCTCTATGAACCGGGGTGA,37,2912000
ompRp4,6.333333333333333,42,5,CATAGCCGTAGGTTCGAGAA,37,2918758
ompRp4,7.6,41,4,CATAATTGCTTTCATCGGTG,37,2913737
ompRp4,19.0,38,1,AGTCATGGTATTAGTTCGCA,37,2910719
ompRp4,3.4545454545454546,47,10,ACACAAGTCGTTTGGAATAT,37,2931359
ompRp4,7.6,41,4,AATGAACGATCCACAAGCGC,37,2928394
ompRp4,4.222222222222222,45,8,AAGAGTTGTCTGGGGAGACC,37,2924156
ompRp4,7.6,41,4,AACATAGATATTATCCTGCT,37,2930378
ompRp4,19.0,38,1,AAAGGGCCAAGTATTCTGGA,37,2923968
ompRp4,12.333333333333334,38,2,TTTGGTTGATGCCGATAGTA,36,2915801
ompRp4,5.285714285714286,42,6,TTTGCAGCATGGGACTTGTC,36,2908398
ompRp4,3.3636363636363638,46,10,TTTACCTCTGCCCTTCGACA,36,2914715
ompRp4,12.333333333333334,38,2,TGTTTACTTACCTTCGCTAT,36,2925052
ompRp4,7.4,40,4,TCCGTTGGTCTTCCGTACAG,36,2916462
ompRp4,6.166666666666667,41,5,TACCTGCACTGCAGCGGATC,36,2921365
ompRp4,3.7,45,9,GGTGGTGACGGCTCCAAACG,36,2921196
ompRp4,6.166666666666667,41,5,GGGACTCTTTGGTACGACGA,36,2925737
ompRp4,12.333333333333334,38,2,GCTCGGAAAACGCCGGATTA,36,2909538
ompRp4,18.5,37,1,GACTCAACACGATAGGCCCA,36,2936976
ompRp4,6.166666666666667,41,5,GACGGAACAATACTCTCATA,36,2907941
ompRp4,18.5,37,1,CTTTGACGATATAGAGTGGA,36,2914796
ompRp4,18.5,37,1,CGTCCCATATTAGTGGGCAA,36,2917845
ompRp4,18.5,37,1,CCCATTCATTCGGAGTGGTC,36,2922666
ompRp4,18.5,37,1,CCAGCTGGAATGTTTTCTTA,36,2928146
ompRp4,18.5,37,1,CCAAGCCGCCGCTTCCGGCA,36,2933751
ompRp4,12.333333333333334,38,2,CACGACACGCCGCTGCTGTT,36,2915854
ompRp4,18.5,37,1,CACCGTAACCGCGGTCACGT,36,2911544
ompRp4,12.333333333333334,38,2,CACATCCTAGAGACACAAAA,36,2926680
ompRp4,18.5,37,1,CAAAAGTTTACTCGCAAACA,36,2935326
ompRp4,18.5,37,1,AGACATCAGGACACAATATG,36,2921526
ompRp4,18.5,37,1,AAGCGCTACCTTTCATGTGT,36,2916333
ompRp4,6.0,40,5,TGGAGAACGCATAAACGCGC,35,2933397
ompRp4,6.0,40,5,TGCGTCGCACATAGGGGCGT,35,2927362
ompRp4,18.0,36,1,TCGAAGCCCGGCAATTCTCC,35,2918708
ompRp4,18.0,36,1,TCAGGCGTGGCCTTGGGCGT,35,2930281
ompRp4,18.0,36,1,TAATAGTCGGGTGTAGGACG,35,2925138
ompRp4,3.6,44,9,GTCCGTGAGCGGGCTTGATC,35,2911288
ompRp4,18.0,36,1,GTAAGTACGCTAGCTAAAAA,35,2915015
ompRp4,12.0,37,2,GGTCACCATGCGAGGCCGTT,35,2930983
ompRp4,18.0,36,1,GGCCGAGAAAGCTGCTATGT,35,2925551
ompRp4,9.0,38,3,GGCAAGCGCTACATGTGTCT,35,2920906
ompRp4,12.0,37,2,GAAAGACAACACACTTTCGA,35,2918533
ompRp4,18.0,36,1,CTTCCGAGAGTTATTTCAGG,35,2930087
ompRp4,5.142857142857143,41,6,CCGTGGTCGAGCAATGCCTC,35,2921315
ompRp4,12.0,37,2,CCGTAGCCGTCCGGCTCGAC,35,2922347
ompRp4,4.0,43,8,CCGGACAACATCCACCCTCG,35,2930661
ompRp4,18.0,36,1,CACCTCAGACCGAACGGAGA,35,2923604
ompRp4,12.0,37,2,CAATGTAGCCACCGTTTCGA,35,2908692
ompRp4,12.0,37,2,CAACTCGACAGCGTGTTTGC,35,2908302
ompRp4,4.0,43,8,ATTAACGGCCAAGTTGGTGT,35,2909220
ompRp4,7.2,39,4,ATCTGGGACAGCCGGAAGTA,35,2915621
ompRp4,12.0,37,2,ATCTACCAGGTATCTGACGG,35,2909198
ompRp4,6.0,40,5,ATCGACATCCACGTGCTGTG,35,2909038
ompRp4,18.0,36,1,ATCCAGGTGCCGCGATATAT,35,2933477
ompRp4,18.0,36,1,AGTTGGAGTGAACGGTGCAG,35,2910892
ompRp4,18.0,36,1,ACATAACCGATGCAAGTCTT,35,2914118
ompRp4,18.0,36,1,AACGCTTTAGCACGGTAGAT,35,2916727
ompRp4,4.375,41,7,TTTGGTTTAATCAGCCGGTT,34,2910327
ompRp4,11.666666666666666,36,2,TGTACACCAATCTCTGAGAA,34,2924212
ompRp4,8.75,37,3,TCCCCGTGATCATTGTGATC,34,2908741
ompRp4,17.5,35,1,TATATAGCCCACAACAACCC,34,2914242
ompRp4,5.0,40,6,TAAGTGACATCGATGAATAT,34,2928327
ompRp4,8.75,37,3,GTTACAGGATCCACTACGTT,34,2930368
ompRp4,8.75,37,3,GTCTGGAACTTAGAGAGCTC,34,2912764
ompRp4,17.5,35,1,GCCCAATTGTAAAGTTTTCA,34,2933440
ompRp4,11.666666666666666,36,2,GCAATGAGTGGACTAACTGG,34,2919068
ompRp4,7.0,38,4,GACTTTGATTCGAAGCGCGT,34,2934910
ompRp4,17.5,35,1,GAAACCCGTACTGATATGGG,34,2908845
ompRp4,3.888888888888889,42,8,CGTCTAGACGCACGGCTGAA,34,2918393
ompRp4,17.5,35,1,CGCATATGAGCCCTGGTCAA,34,2924028
ompRp4,11.666666666666666,36,2,CAGTATGGACTCCGCGGTTT,34,2921152
ompRp4,17.5,35,1,CAAAATCCAGTTAAGATGCT,34,2908931
ompRp4,4.375,41,7,ATTCGCTATGCTCTGGCCAT,34,2913539
ompRp4,5.833333333333333,39,5,ATATTCCGTCCGGGCCTTAT,34,2933765
ompRp4,17.5,35,1,AGTTTTTTGCCTCCTATGTC,34,2936378
ompRp4,11.666666666666666,36,2,AGTCATCCAAGAGAACACAC,34,2936769
ompRp4,17.5,35,1,AGCCGTTCACAATAGGGATG,34,2935190
ompRp4,11.666666666666666,36,2,ACTGAGCTGGCAGGTCAGGA,34,2914907
ompRp4,17.5,35,1,AAGAGCCCCGGCAGATGACA,34,2921722
ompRp4,7.0,38,4,AACTATTTAGCGCTCCAGTC,34,2937683
ompRp4,17.0,34,1,TTATTAAAGTGGGTCCGAGG,33,2930891
ompRp4,17.0,34,1,TGCCGCGCCGCAAACCAATG,33,2912240
ompRp4,8.5,36,3,TATCCAGCCTCCGACCTATC,33,2929004
ompRp4,5.666666666666667,38,5,TACGGACAGACAAATGATAT,33,2918301
ompRp4,17.0,34,1,GTAGTCGTGTAACCAGTCGT,33,2923538
ompRp4,17.0,34,1,GTAGAGTCCCGGGTTTTCAT,33,2930240
ompRp4,11.333333333333334,35,2,GGCGTGTTGGAACCCTCTGT,33,2930225
ompRp4,17.0,34,1,GGCCAAGTAAAAGATAATCT,33,2913713
ompRp4,17.0,34,1,GGAGGAACCGTGTTACGGAG,33,2932899
ompRp4,17.0,34,1,GGAGCACTGCGTTGGGTAGA,33,2938252
ompRp4,17.0,34,1,GCAGGCCTCAAATGGAGCTA,33,2916110
ompRp4,8.5,36,3,CTTGCATACGGAATGCTATG,33,2908308
ompRp4,11.333333333333334,35,2,CTGGTTCGGTGGGAGGCCCT,33,2926791
ompRp4,3.7777777777777777,41,8,CTCAACATGAGTTAAGTGTG,33,2912972
ompRp4,17.0,34,1,CTATATGTGGCCGGAACACT,33,2908665
ompRp4,11.333333333333334,35,2,CCGCAACCCAAGGCGCTAGT,33,2925385
ompRp4,17.0,34,1,CCACGGGTTGAAGCCAGGAC,33,2929146
ompRp4,4.25,40,7,CCAAGAGCCGTCACAGAAAT,33,2916942
ompRp4,17.0,34,1,CAGACTTCCGTAGGCGTGAT,33,2932451
ompRp4,11.333333333333334,35,2,ATTCATTGACCTTGAATTTA,33,2911719
ompRp4,11.333333333333334,35,2,ACTTGATTGGGGCTAGACAC,33,2914043
ompRp4,3.090909090909091,43,10,ACTAGAACCCTTACGCGGTC,33,2912481
ompRp4,5.666666666666667,38,5,ACGTCCGAAACAGAGAGGTT,33,2930088
ompRp4,5.666666666666667,38,5,ACGGATGAGATGAACCCACA,33,2935063
ompRp4,4.714285714285714,38,6,TCCCAGTATTACGCGCTTCA,32,2927907
ompRp4,16.5,33,1,TCACTACTTGGCCTCGGACA,32,2924446
ompRp4,8.25,35,3,GGGATTGCGTACACCGGATA,32,2922352
ompRp4,11.0,34,2,GCTACCAGCGAATTATCTTC,32,2908066
ompRp4,16.5,33,1,GCGTATAAACGTATCTGCCC,32,2920957
ompRp4,5.5,37,5,GCCGTAGGCCCTCTAGGACA,32,2908677
ompRp4,16.5,33,1,GCCGAAGGTATAGTTGAAAG,32,2935183
ompRp4,8.25,35,3,GATGGCCCTGGGCCAGAAGC,32,2923177
ompRp4,16.5,33,1,GACGGCAAGTAATGGATAGG,32,2927111
ompRp4,6.6,36,4,CTTCGCGCCGGGTCCGCAGT,32,2916273
ompRp4,4.714285714285714,38,6,CGTGGGGATTTCGAGCATGT,32,2925280
ompRp4,16.5,33,1,CGGTGAACCAGTTGAGGTTA,32,2937359
ompRp4,16.5,33,1,CGGACGCTAGAAGGGGGTGT,32,2932355
ompRp4,16.5,33,1,CGAGTTCGGCAAAGACAATA,32,2909777
ompRp4,11.0,34,2,CCCCCGGCTGATGAAACGTT,32,2916412
ompRp4,16.5,33,1,ATCTCCGGCGGCTAGAGCAA,32,2907736
ompRp4,4.714285714285714,38,6,ACATCCAGAACGAATTTCGT,32,2911073
ompRp4,16.5,33,1,AATGCTCCAACCATCGGTAA,32,2935998
ompRp4,6.6,36,4,AAGTCATATGCCATTATATG,32,2927620
ompRp4,11.0,34,2,AAGCCTGAAACGGGTCTCGA,32,2911630
ompRp4,11.0,34,2,AAAGTGATAGCGGTCCTAGC,32,2924265
ompRp4,8.0,34,3,TTGAGGTTTTAGGGCTTGAT,31,2908588
ompRp4,4.0,38,7,TGGTCTAAGGGACCCAGCAA,31,2936587
ompRp4,8.0,34,3,TCGTGTCTTGCCCCCGTGCG,31,2909459
ompRp4,3.5555555555555554,39,8,TCGAATGAGGGATTGCCGAA,31,2911183
ompRp4,10.666666666666666,33,2,TCATCTGGTTCGCTTTCCCA,31,2917928
ompRp4,8.0,34,3,TATGGGCTATCAAACGGTAG,31,2929683
ompRp4,10.666666666666666,33,2,TAGGTGAGTAAGGCAGCCCC,31,2927463
ompRp4,10.666666666666666,33,2,TAATGGGGATAGCTGGCCGT,31,2913174
ompRp4,16.0,32,1,TAATCTAGAATTGAGACTGT,31,2920119
ompRp4,5.333333333333333,36,5,TAAAATTTCTAGCTGCGAGA,31,2924248
ompRp4,10.666666666666666,33,2,GGCGCGCCACTTACCATCCT,31,2925514
ompRp4,10.666666666666666,33,2,GCCAAGGGTTCACTAACGGT,31,2908668
ompRp4,6.4,35,4,GCACCGCTGGCGGTTCCGGG,31,2930665
ompRp4,6.4,35,4,GAGCTCCTCTGATACTCCCC,31,2922318
ompRp4,10.666666666666666,33,2,CGATCGGAAGCTTCGGGAAC,31,2930475
ompRp4,2.6666666666666665,42,11,CCCCTGTAGCGATTGCCCTT,31,2932522
ompRp4,16.0,32,1,CCATTGACGCGGAAGAGGAT,31,2929318
ompRp4,16.0,32,1,CAATACAAGTCGGTTGAGCT,31,2934887
ompRp4,16.0,32,1,ACTACTTTATTTCGTAGATG,31,2937768
ompRp4,8.0,34,3,ACGCGGTCGCTGTTTCCCCT,31,2908441
ompRp4,6.2,34,4,TTTCAAGGCTGGGTCCGTAT,30,2934829
ompRp4,7.75,33,3,TTGAACGCGTACGTTTGAAA,30,2910653
ompRp4,10.333333333333334,32,2,TGTGACCAGGTATCATCCGT,30,2922362
ompRp4,15.5,31,1,TCTGGCAGCCGAACACCTTT,30,2927790
ompRp4,5.166666666666667,35,5,TCGGCGTTACCGATCCTCAC,30,2912079
ompRp4,2.8181818181818183,40,10,TATTTCTTTGAGCTTCTGCT,30,2918573
ompRp4,15.5,31,1,GGTAGTCATATCGCCGTGCC,30,2926796
ompRp4,7.75,33,3,GCGATACGATTCTTTTAGAA,30,2929226
ompRp4,7.75,33,3,CTCTAGACTACTTCCACCTA,30,2913488
ompRp4,4.428571428571429,36,6,CTCACGGAGGAGTGTCAGTT,30,2927327
ompRp4,15.5,31,1,CTATGACTGCATCCAGTGAC,30,2936283
ompRp4,15.5,31,1,CGGCGACTCGACTTTTCGAT,30,2908118
ompRp4,5.166666666666667,35,5,CGCCTTATAAGATAGTTAAA,30,2925579
ompRp4,3.4444444444444446,38,8,CGAGTCTTTTCTTACGGTGT,30,2918916
ompRp4,10.333333333333334,32,2,CCCACTACAACATGGTCCCT,30,2918676
ompRp4,10.333333333333334,32,2,CACTTCACTAGGGAAAGCTT,30,2917855
ompRp4,7.75,33,3,CACAGTCCTAGGCTCGGTAT,30,2916072
ompRp4,7.75,33,3,CAATCGCGGCGTCCTTACGG,30,2908675
ompRp4,6.2,34,4,CAAATAGAAGACAATAGCGT,30,2916603
ompRp4,15.5,31,1,ATGTGAGAACATACAGGCGA,30,2909643
ompRp4,15.5,31,1,ATCGATATATTCTACCTGGA,30,2920077
ompRp4,15.5,31,1,ATATAGTCGTGGCCTTAGCG,30,2916450
ompRp4,15.5,31,1,AGAGAGCCGCTGTCCGTCAA,30,2934379
ompRp4,7.75,33,3,ACTCTTTTAAATGATTTCGC,30,2938298
ompRp4,15.5,31,1,AACAAGTTTATTAGTCTCGA,30,2914661
ompRp4,3.3333333333333335,37,8,TGCTTCCGAGTTGGTTGCGT,29,2932399
ompRp4,10.0,31,2,TATCCAGCTAGAGGTTTATC,29,2921622
ompRp4,6.0,33,4,GTTGCTTGCATGTTAGTCCA,29,2930594
ompRp4,10.0,31,2,GGTGGCATGACCCGCCACAA,29,2912713
ompRp4,6.0,33,4,GGGCTCCTGAACGCACGCGT,29,2924135
ompRp4,15.0,30,1,GCGGCGATATGTTTGCGTAA,29,2910654
ompRp4,6.0,33,4,GCGAAAGATAAGTCCCACGG,29,2910665
ompRp4,15.0,30,1,GATACAGAATCTAGTGGTGA,29,2916388
ompRp4,10.0,31,2,CTTTACCAGCAAGGACATTC,29,2927077
ompRp4,15.0,30,1,CTGTGTAATCCCCGCGCCAA,29,2920934
ompRp4,10.0,31,2,CGGAGGACTTAGATAAAGTT,29,2936493
ompRp4,15.0,30,1,CGCATATCGAGAAGGTTTAG,29,2914275
ompRp4,10.0,31,2,CGCAATCTAGATTTCTTTTA,29,2907954
ompRp4,3.3333333333333335,37,8,CCCGGCTCCTGCTTTCCAGT,29,2918626
ompRp4,15.0,30,1,CATGGCTTTCTATCCACATC,29,2908826
ompRp4,10.0,31,2,CAGGCGTGGATCCGGGAACT,29,2923015
ompRp4,6.0,33,4,AGCCGCGCTACAGAAGGATT,29,2929831
ompRp4,6.0,33,4,AGATCTGGACAATGATATAG,29,2936571
ompRp4,15.0,30,1,AGACAGCGTCATCACCATAT,29,2921115
ompRp4,9.666666666666666,30,2,TGCATAGGACATGGGCGTTA,28,2931102
ompRp4,4.833333333333333,33,5,TGATCGCAGGGGATGCTAGA,28,2918303
ompRp4,9.666666666666666,30,2,GTGAATGGTTTAAAATTTGC,28,2907908
ompRp4,7.25,31,3,GCTATTTCCCGAGCATATGC,28,2924029
ompRp4,9.666666666666666,30,2,GCGACCGACGCGAGGAGGGC,28,2920964
ompRp4,5.8,32,4,GATGAGGCCATGGGTGCAAG,28,2924637
ompRp4,9.666666666666666,30,2,GAGATAACACTCCAGGCATC,28,2915528
ompRp4,14.5,29,1,CTTGGGTGTAAAAGTAAAAG,28,2927538
ompRp4,14.5,29,1,CGCCTTAGACTAGCAGGACT,28,2924819
ompRp4,14.5,29,1,CGCCCTATACCGCTCTCAAA,28,2909154
ompRp4,14.5,29,1,ATTAGCAGGACCTTTGATGT,28,2910694
ompRp4,4.142857142857143,34,6,ATGTGTGTTGGGGGTAGGAT,28,2908544
ompRp4,14.5,29,1,AGACCCCGACTTTAGTGTTA,28,2932224
ompRp4,14.5,29,1,AATCGTCGCCTATTAGCTCC,28,2908995
ompRp4,5.8,32,4,AATAGTATTCCGCCGGGGCA,28,2915277
ompRp4,7.0,30,3,TTTTCGTACAATCACTGAGC,27,2920279
ompRp4,14.0,28,1,TTTATTATTCTTCACTCCAA,27,2927255
ompRp4,14.0,28,1,TTGCTTTCGCTGGGCGAGAT,27,2929076
ompRp4,14.0,28,1,TGCGTCCCAGTGCCTACCGT,27,2934037
ompRp4,4.666666666666667,32,5,TGCCTCAACGCTGCTAGGCA,27,2920851
ompRp4,14.0,28,1,TATGACATGCTAAGTGTGTG,27,2930764
ompRp4,7.0,30,3,GTTTTTCGACTTGTCGCCCC,27,2923066
ompRp4,9.333333333333334,29,2,GTGGCGCGAGTGATTATGAG,27,2915109
ompRp4,4.0,33,6,GTGAGAAACGTCGATGGGCA,27,2934558
ompRp4,14.0,28,1,GTCCATTACATGCTATTGTT,27,2914377
ompRp4,14.0,28,1,GTACTTTGAGGCTTGTTCAT,27,2917213
ompRp4,14.0,28,1,GTAAACCAAATGGTACACGA,27,2933363
ompRp4,9.333333333333334,29,2,GGGGTGTAGGGGTTTTCGTC,27,2908135
ompRp4,14.0,28,1,GGCGTTCTCCCGTAGGAACG,27,2928228
ompRp4,4.0,33,6,GATTATTGACCCGCGGGAAT,27,2911206
ompRp4,7.0,30,3,GATTAGAGTTCCAAGACTGG,27,2921387
ompRp4,14.0,28,1,CTGGTCCTTGGTTTAAGATG,27,2925826
ompRp4,2.5454545454545454,37,10,CTGGGTATAGTTTTTGGCAT,27,2923825
ompRp4,3.111111111111111,35,8,CCTGTGTCGGGTTCCCGTCC,27,2926010
ompRp4,14.0,28,1,CCATTATATCAGTACGTAGC,27,2918631
ompRp4,3.5,34,7,ATGACCAGATAACGGCAGTC,27,2935938
ompRp4,5.6,31,4,ATATTGTCGAGCTTCACGGA,27,2931357
ompRp4,9.333333333333334,29,2,AGTCGTCACCGCTTGAACTG,27,2930709
ompRp4,13.5,27,1,TTTAACCTATGTTGTCTTAA,26,2931057
ompRp4,13.5,27,1,TTCATTGGGAGCACCAAAAA,26,2937022
ompRp4,13.5,27,1,TGGTATCCTGCTAGCCTCGT,26,2920955
ompRp4,13.5,27,1,TGGGGGCGCCTTCGTGTTTA,26,2917260
ompRp4,9.0,28,2,TACCCTAACACCGTCGGCAT,26,2934115
ompRp4,13.5,27,1,TAAGCGATTCTGCATCTACA,26,2933542
ompRp4,9.0,28,2,GGGAATGTAAGCTATCTCCT,26,2918697
ompRp4,13.5,27,1,GCACCCTAGAATCTTGCTGC,26,2934373
ompRp4,13.5,27,1,GAAGTTAAAGAAACACGGAC,26,2922119
ompRp4,13.5,27,1,CTTTGTTTCGTCATGCATAT,26,2909157
ompRp4,13.5,27,1,CTGGTCTCCTAAACACAACA,26,2922650
ompRp4,13.5,27,1,CTCCTGCGCCACCGGTCTCA,26,2917698
ompRp4,2.7,35,9,ATCGATGGATGAGCTGTTCC,26,2914509
ompRp4,6.5,28,3,TTTGGTGAAGAGTGGATCCT,25,2926132
ompRp4,13.0,26,1,TGTGTGCCAATCCAAATCAT,25,2915377
ompRp4,6.5,28,3,TATCGGTACAAACTGGAGCC,25,2923464
ompRp4,3.25,32,7,TAGATGCGGAAGATTCCTAC,25,2916927
ompRp4,5.2,29,4,CTTCTATTCATCGCTTTTTG,25,2918762
ompRp4,8.666666666666666,27,2,CTCTACGACACGCTCCGAAT,25,2916831
ompRp4,5.2,29,4,CGGTCCTGTATGGACGTGAT,25,2933624
ompRp4,8.666666666666666,27,2,CGGATCTCATTACTACAAAA,25,2920564
ompRp4,6.5,28,3,CGGAGGCCTTTAGGCTTCTT,25,2908714
ompRp4,13.0,26,1,CCCGAGGATCCTGGTCGAAT,25,2919253
ompRp4,8.666666666666666,27,2,ATTCTGTTAAGCGTGCAGTA,25,2914613
ompRp4,5.2,29,4,AGATCACGACATAGTTGCAT,25,2924760
ompRp4,5.2,29,4,ACGCCAGTCTTCTGGGAAAC,25,2921238
ompRp4,6.5,28,3,ACAGTAGTTTAGGTTCGCAT,25,2907706
ompRp4,13.0,26,1,AATACTCGAGAGAACCTCTT,25,2915379
ompRp4,4.333333333333333,30,5,AAGACTCACAGGGCGGCCTG,25,2908823
ompRp4,13.0,26,1,AAACTAACGCGCAATTGTAT,25,2923859
ompRp4,13.0,26,1,AAAATGTCTGGAATTACACC,25,2916447
ompRp4,6.25,27,3,TGGTGTACAGGTACTACCAT,24,2918883
ompRp4,12.5,25,1,TGGTATCTTTTGAGCTGCAT,24,2917779
ompRp4,12.5,25,1,TCAGAAGATACTCGTTGATA,24,2925045
ompRp4,12.5,25,1,TAATCGTTGCGAAGCCCGTA,24,2914387
ompRp4,6.25,27,3,GTGTAGGATTTGAAGACCCT,24,2909159
ompRp4,3.5714285714285716,30,6,GTAGGTTACTTGGGGCTGTA,24,2909861
ompRp4,12.5,25,1,GCGTACCAAGTACTGGGAGG,24,2915018
ompRp4,12.5,25,1,CGCTCATTCGTACCTGCTGC,24,2928159
ompRp4,12.5,25,1,CCGCCTTAAATTCCAGCGTA,24,2908425
ompRp4,5.0,28,4,CCATAGAAAAGCGAGATGAT,24,2922354
ompRp4,12.5,25,1,CCAGGGTCACGTCCGTGCAA,24,2929138
ompRp4,6.25,27,3,ATTGTTTTCATTCGTTCAGT,24,2917012
ompRp4,3.125,31,7,ATTGATTCCCGGAAGGCTGG,24,2919266
ompRp4,8.333333333333334,26,2,ATGATTACCTGTCCGAAATA,24,2934481
ompRp4,12.5,25,1,ATCGATAGTACAGGATTGCT,24,2913311
ompRp4,8.333333333333334,26,2,AATAAAAAGCCAATGTTCGA,24,2911380
ompRp4,12.0,24,1,TTTGCGCAAGATACGTGTGG,23,2933186
ompRp4,12.0,24,1,TTCGAGACAGCAAAAGTGGA,23,2915759
ompRp4,12.0,24,1,TGTAGTGACGCAGCACCGAC,23,2916413
ompRp4,12.0,24,1,TGCGTAATTACCTAACCCGT,23,2920831
ompRp4,3.0,30,7,GTTGTGTGGTAAGTATCAAA,23,2922485
ompRp4,3.4285714285714284,29,6,GAAAAGTATAATGTACTCCC,23,2926272
ompRp4,6.0,26,3,CTGGGGAGGCGTTGAAATGT,23,2934084
ompRp4,3.4285714285714284,29,6,CGGGCCGCCGGCCACAACGC,23,2915545
ompRp4,8.0,25,2,CGGACTAAGTCCCGATATAG,23,2923259
ompRp4,2.6666666666666665,31,8,CAACGTATTCCTACATCCCA,23,2909908
ompRp4,6.0,26,3,ATTAAATCATAACATTCGAG,23,2926473
ompRp4,4.8,27,4,ATATAAGCTACTCGAAGAGC,23,2934428
ompRp4,12.0,24,1,AAACAGATAAACGTATCAGG,23,2927395
ompRp4,3.8333333333333335,27,5,TTTCCAACTTTATCTACCGT,22,2933340
ompRp4,11.5,23,1,TACTGTTAATTGTCAACTGT,22,2937084
ompRp4,7.666666666666667,24,2,GGAGGTCTCAGGTACGACAA,22,2924213
ompRp4,3.2857142857142856,28,6,GCCTAGGATCGTACTAGCGC,22,2931045
ompRp4,11.5,23,1,GAAGCAAGGAATGTTCGTCG,22,2924699
ompRp4,7.666666666666667,24,2,CCGGGTCATATCAGGCCGTT,22,2920915
ompRp4,2.3,31,9,CCCGTCATGCGGAGCCGTGT,22,2916487
ompRp4,7.666666666666667,24,2,CATTGTCGACTCTTTTACTC,22,2915920
ompRp4,11.5,23,1,ATTAGATCTAGGCCTGCGAG,22,2919453
ompRp4,5.5,24,3,TGTCCATCCCATCAAGAATA,21,2937644
ompRp4,11.0,22,1,TGGGCGTGGTACAGAATTGT,21,2919353
ompRp4,11.0,22,1,GTGGTGTGGACCCAATTTTC,21,2924332
ompRp4,2.4444444444444446,29,8,GTCCCAGGATAATACCCGGG,21,2924661
ompRp4,5.5,24,3,GCCGGGGCGCGTCAGCGTAC,21,2909177
ompRp4,11.0,22,1,GATCGGGTGTGGGCTCGAAG,21,2917045
ompRp4,3.6666666666666665,26,5,CCGCGCGTCAGAGGCCCTTC,21,2910137
ompRp4,5.5,24,3,ACGCCTGCCGTGCAGCGGTT,21,2909241
ompRp4,5.5,24,3,AATTGCCCGTAATGGCGGCC,21,2918392
ompRp4,2.75,28,7,AACTAGCTGAGGTGGACTTT,21,2908740
ompRp4,4.2,24,4,TTCTTGCACATGATTGTGCT,20,2911248
ompRp4,2.3333333333333335,28,8,GTACAGCGCTTTGCACCCTT,20,2917207
ompRp4,7.0,22,2,GCGTCGAGTCGTGATGGCGT,20,2928527
ompRp4,10.5,21,1,GATGGCCCAAGACTCCCGTA,20,2934662
ompRp4,2.3333333333333335,28,8,CGGCGACTCTGGCCGTCTGT,20,2919553
ompRp4,7.0,22,2,CATAAATCGAGATCATTACG,20,2914893
ompRp4,7.0,22,2,ACCCGCCTCCACTGTATCAG,20,2930037
ompRp4,5.0,22,3,TTTCATGCTTCTCGAGCCCA,19,2911448
ompRp4,5.0,22,3,TGCCGGGATCACCAGGTGTT,19,2930823
ompRp4,3.3333333333333335,24,5,CCAAGGACCGATGCAGCTGA,19,2911134
ompRp4,6.666666666666667,21,2,AAGCCTCGATAAAGGGCAGC,19,2921119
ompRp4,6.666666666666667,21,2,AACCTCACCCTTCCGGTGAG,19,2937430
ompRp4,9.5,19,1,TCCTTCAAGTCCCGGGCGGA,18,2920315
ompRp4,9.5,19,1,TCATCGTAAGCCTCTGAGTA,18,2929781
ompRp4,3.1666666666666665,23,5,TATTCCTCGAAGTGTCTTGT,18,2908941
ompRp4,9.5,19,1,TATATACCAGCGTGCAATCA,18,2909880
ompRp4,3.1666666666666665,23,5,TAGCCTAGAAGGTTACTGTA,18,2914590
ompRp4,9.5,19,1,CTTTCCTACGTTAAGTAAGT,18,2925179
ompRp4,9.5,19,1,CTTACTACTCGTACTCCAAT,18,2913484
ompRp4,9.5,19,1,CCCCTCAAGGTTGGAAAAAT,18,2931379
ompRp4,6.333333333333333,20,2,AGGCCAGTGCGTGCCTACCT,18,2916725
ompRp4,3.8,22,4,ACATACGTTCTGAACGCCGA,18,2931006
ompRp4,4.75,21,3,ACAACGACCCTGTTGATAGT,18,2928894
ompRp4,9.0,18,1,TCGCATTCGGTACAGCCCCT,17,2910920
ompRp4,3.6,21,4,TAACCATCTGCGCGCCTGTT,17,2934840
ompRp4,2.5714285714285716,23,6,GGATGTTTTCGAATTCTATA,17,2932617
ompRp4,9.0,18,1,CTCCCACACTTATTGTGGAA,17,2919332
ompRp4,6.0,19,2,CTCAGAGCCTGACCCCCGGA,17,2935504
ompRp4,6.0,19,2,CCGCAGTCACATCGGAGATC,17,2927909
ompRp4,4.5,20,3,ATGGATTTCAAGCATTCCAC,17,2915308
ompRp4,3.6,21,4,ATACAAAGTTATACCCGCAT,17,2934539
ompRp4,9.0,18,1,AGTCTAGGCAACCCAGATGT,17,2931467
ompRp4,9.0,18,1,AGTCAACTCGGGAGAAGCCA,17,2928960
ompRp4,9.0,18,1,ACACGTAAGGTTATCGTAAA,17,2914730
ompRp4,8.5,17,1,TGGTTAAACCGGAGTGGAAG,16,2927942
ompRp4,8.5,17,1,TATGCATCCCCGCACATTCT,16,2920918
ompRp4,2.8333333333333335,21,5,GTCCCAAACGTCATCGGACC,16,2923709
ompRp4,8.5,17,1,CTCAAACTTGACACGCTTTT,16,2911670
ompRp4,8.5,17,1,CATGTCCATCCGAATCTGTC,16,2920799
ompRp4,4.25,19,3,CAATCATCACTATACGCTCG,16,2927170
ompRp4,4.25,19,3,AGACCGACCGGATAGTTTCG,16,2916962
ompRp4,8.0,16,1,TTTGGCTTAACAAACTCGAC,15,2909379
ompRp4,4.0,18,3,TAGCGTCAGCTAAGAGTTAA,15,2909694
ompRp4,8.0,16,1,GTAATGTAGCTGTTAGTTCC,15,2931655
ompRp4,8.0,16,1,GCGTAGCTGCGATTGTCCTT,15,2926431
ompRp4,1.7777777777777777,23,8,CTATACTAGATTGCTTCGGT,15,2912169
ompRp4,5.333333333333333,17,2,CGGTGCGTAAATGGCACTAA,15,2918160
ompRp4,4.0,18,3,CGAGACCCGCACATCCGTGC,15,2913642
ompRp4,5.333333333333333,17,2,CCCTGACCGAGGTAAATAGC,15,2922109
ompRp4,3.2,19,4,CCCACCTAACGTACGGATTA,15,2930242
ompRp4,8.0,16,1,CAGTACCAACAACTCGGCTA,15,2909206
ompRp4,1.7777777777777777,23,8,ATATGAGGGACCTTCGTCCT,15,2930338
ompRp4,8.0,16,1,AGGATGGGTTAGAGTTAAGG,15,2915293
ompRp4,8.0,16,1,AAACGAGCGCGAGGGTATAT,15,2912514
ompRp4,7.5,15,1,GCGTAAGGACATGCGAGGTT,14,2921561
ompRp4,3.0,18,4,GAAAGGTTTTAACAATTCCA,14,2911605
ompRp4,3.75,17,3,CGCTAACTCCCACTTTACTT,14,2924911
ompRp4,7.5,15,1,ATGGCAAAGGTAACGGACGA,14,2908611
ompRp4,7.5,15,1,ATGCTGCTAGAATTGAAGAA,14,2911566
ompRp4,3.75,17,3,ACTTTCGTTACCCGTGGTAT,14,2921077
ompRp4,5.0,16,2,ACGGCTGCGTCCGGGCTATT,14,2933475
ompRp4,1.875,21,7,AAGCTTTGCCCCCTTATCAA,14,2910000
ompRp4,4.666666666666667,15,2,TTCACGTAGTTAGATGTAGT,13,2917211
ompRp4,4.666666666666667,15,2,GTCATTGCGTAATCCCCGGG,13,2933131
ompRp4,7.0,14,1,CTCAGGCCATAGTTCTCCCT,13,2926686
ompRp4,4.666666666666667,15,2,CCCTTGGCTAAATACGTGCG,13,2932870
ompRp4,3.5,16,3,CAGCGAGGTGGTTGCGTGCC,13,2909130
ompRp4,3.5,16,3,ATTGGTATCTCAAAAATAAT,13,2915552
ompRp4,4.666666666666667,15,2,ACTACAATTGCTGGCTACAT,13,2921874
ompRp4,2.3333333333333335,18,5,ACCAGGCTCTTTATCAAAGT,13,2932417
ompRp4,4.666666666666667,15,2,AACCCATTAGCGTTACAAGG,13,2909473
ompRp4,2.1666666666666665,17,5,TCTTCTCTGCACGAGGCCCC,12,2910403
ompRp4,6.5,13,1,TCGTCCTGACAACAGTATGG,12,2918539
ompRp4,6.5,13,1,TCCAGGAAACCTCTGAGTAG,12,2924130
ompRp4,6.5,13,1,TCAGAGATATTCTTCTTCCT,12,2918714
ompRp4,6.5,13,1,GAGTGACTAAGGTTACCGTT,12,2918827
ompRp4,2.6,16,4,GACCAAAGAAAGGATATTTA,12,2928819
ompRp4,6.5,13,1,CGTGATACCATCATGTGTAT,12,2907726
ompRp4,1.8571428571428572,18,6,ATTCATACCACGAGTCAGAA,12,2937763
ompRp4,1.8571428571428572,18,6,ACATTTCAAACTCTTATCAT,12,2928443
ompRp4,3.25,15,3,AATCCGGTAGCACTCGGAAT,12,2910966
ompRp4,2.0,16,5,TTTTTGACCAAGCGCTGTCT,11,2925692
ompRp4,4.0,13,2,GTCTGGTTTACAGGGCTCCA,11,2913452
ompRp4,2.4,15,4,GTCAATTTTGTGGATGGGCA,11,2909845
ompRp4,6.0,12,1,GGAGAATCGTTCGATTCAGA,11,2931060
ompRp4,6.0,12,1,GCCGGTTATTGGACAGTTTT,11,2912439
ompRp4,6.0,12,1,CTAACGCTACAACATTTGGG,11,2914176
ompRp4,4.0,13,2,CAAGTTTATGACGATGCCCT,11,2933752
ompRp4,6.0,12,1,AAGTGATCACTGCTCTAGTA,11,2922646
ompRp4,4.0,13,2,AAGGTCAGGCCAACAGGGAT,11,2909070
ompRp4,3.6666666666666665,12,2,TTATGTGCCGAAATGCGGAA,10,2934120
ompRp4,2.75,13,3,TCAGGCAGCCGGCAGCACTT,10,2914913
ompRp4,3.6666666666666665,12,2,GATCGACCAATAGGAATTAT,10,2916623
ompRp4,5.5,11,1,GAGGCCTGCAGCCGACATTC,10,2909162
ompRp4,2.75,13,3,GACTAAGCCATCAAGTAGCA,10,2931244
ompRp4,3.6666666666666665,12,2,CTTGCAGCGGGATGTATGGA,10,2921621
ompRp4,3.6666666666666665,12,2,AGCTAGTACAGATGCTGCGA,10,2912361
ompRp4,3.6666666666666665,12,2,ACTAGAAGAGGTTTAAGGTG,10,2915494
ompRp4,3.3333333333333335,11,2,TTTTCTGACACCGTCCTCGA,9,2924428
ompRp4,3.3333333333333335,11,2,GGGACATTCCATGAGAGCGA,9,2933529
ompRp4,3.3333333333333335,11,2,GGAACATGTTTACTGCGGGA,9,2915515
ompRp4,5.0,10,1,CGCTGGACCGATCGCTCTGT,9,2907928
ompRp4,1.1111111111111112,17,8,CGCGTACTTGCGAACAGCGA,9,2933502
ompRp4,5.0,10,1,CGAACTCGTTAGTGGAGCAG,9,2927036
ompRp4,5.0,10,1,CCCGACAGCTTCGACTTTGT,9,2909084
ompRp4,5.0,10,1,ATTACATCGTTTCGCTATTG,9,2916009
ompRp4,5.0,10,1,ACATCATGAACGTATCTAGT,9,2916917
ompRp4,2.5,12,3,AATTAGACTCGCTACGCTGA,9,2927773
ompRp4,4.5,9,1,TTGGCTCGTAGCTCTGGATA,8,2917255
ompRp4,3.0,10,2,TTCCGACACGTTATGTCGCT,8,2920772
ompRp4,4.5,9,1,GTTAATATGATACAGGTCGA,8,2910430
ompRp4,4.5,9,1,GTGTCCATAGCGAGTAGTCA,8,2925304
ompRp4,1.8,12,4,GTCCAGGGGTTACGCTGAAT,8,2915413
ompRp4,2.25,11,3,GCTGGCTGTACGGCCCGGAA,8,2926852
ompRp4,1.8,12,4,GATCCTGTAACGACTTTCTA,8,2926864
ompRp4,1.0,16,8,GAGCTTTTGGCCCACTGGAT,8,2907961
ompRp4,3.0,10,2,CCGTCCAATGAATCGTCGGC,8,2928163
ompRp4,4.5,9,1,ATTGTGAGCGGACACGTTGA,8,2930581
ompRp4,4.5,9,1,ACCGATATCGAGAGAAGTGT,8,2911076
ompRp4,4.5,9,1,AAGCATGCGATATCTCGAGT,8,2916891
ompRp4,2.6666666666666665,9,2,TGGAAACGGCCCCAGAAGTA,7,2921062
ompRp4,4.0,8,1,TAGGACTTAGAGCACACGTG,7,2920144
ompRp4,2.6666666666666665,9,2,GAGACGGCCCACGCTACCGT,7,2917966
ompRp4,4.0,8,1,CGGGCCTGCACGTTACATCA,7,2926023
ompRp4,2.6666666666666665,9,2,CATATGAAGTGCAAACTCCA,7,2923304
ompRp4,1.6,11,4,CATAGGGGCACTTAGATTCA,7,2915764
ompRp4,1.6,11,4,ATTAGCTATCCAGGGGCTTA,7,2928561
ompRp4,2.6666666666666665,9,2,AAGATAAAGCTCCTATATGA,7,2929574
ompRp4,3.5,7,1,CTTGGCTGACCCCCCTACGA,6,2925301
ompRp4,1.75,9,3,CAAGATACGTCGAGGTCCAA,6,2924921
ompRp4,1.5,8,3,TATCTTAGTTAGTAGATCGC,5,2919304
ompRp4,3.0,6,1,TATCCGGTTTAGAGTAGCGT,5,2934397
ompRp4,3.0,6,1,GCTCGACTCGGCACCGAGCT,5,2912684
ompRp4,3.0,6,1,CCCGTGTTGCGCGGTTGGGT,5,2934453
ompRp4,2.0,7,2,CATATGCCGTCCAGAACCAT,5,2911703
ompRp4,3.0,6,1,CAAGTTTCCATATCAGGTTG,5,2924512
ompRp4,1.2,9,4,ATGATATTCCGGGGCTCGCA,5,2914773
ompRp4,2.5,5,1,TCCGCTAATATGCTGACTTT,4,2912597
ompRp4,2.5,5,1,GACACCATTAACTTGCACCT,4,2924589
ompRp4,0.5,13,9,CTCTTGCCATGACCGGGAAC,4,2908115
ompRp4,1.6666666666666667,6,2,CAGTCCCTGGTGGATGTTTA,4,2923133
ompRp4,2.0,4,1,TTTGGAGGGGTGCGAATCCA,3,2913920
ompRp4,1.3333333333333333,5,2,TTTAATTAAAATGCACATAA,3,2907829
ompRp4,1.3333333333333333,5,2,TCGCTCGCAGACGGTGTACA,3,2915853
ompRp4,2.0,4,1,GTTCATGTTTCGCCATATCT,3,2914977
ompRp4,1.0,6,3,GATAGATCAAAGCTTTGGAC,3,2912166
ompRp4,1.3333333333333333,5,2,CCCGCGCACGCGCAACGTAC,3,2910691
ompRp4,0.75,5,3,TTCTCACAAGGCGGCGGCCC,2,2912554
ompRp4,1.0,4,2,TTCGATCGAACAGTTCGTTA,2,2918976
ompRp4,0.6,6,4,TGCCCCCGGAGTGATGTGGA,2,2932921
ompRp4,0.5,7,5,TGACAATAGGGTTTAGCGAA,2,2926941
ompRp4,0.6,6,4,TCTTTCGAACACATTGTATT,2,2920218
ompRp4,1.5,3,1,TAGAGCAGCAGAGCACATTA,2,2907781
ompRp4,1.5,3,1,GTTAGACTTCTAATCTTTCA,2,2920224
ompRp4,1.5,3,1,GTCTCGGCTGTGCTCCGTGT,2,2931460
ompRp4,1.5,3,1,GGTTGGGCGCAGCCACGCAT,2,2923569
ompRp4,1.0,4,2,GCCTTCAAATAGGTCTGGCA,2,2908948
ompRp4,1.0,4,2,GCCATTCAGTCTAGCATCAT,2,2927954
ompRp4,1.0,4,2,CTTGTTGATTATTAATATCT,2,2933925
ompRp4,1.5,3,1,CGCTGCCGTCCGATAAAGGT,2,2927607
ompRp4,0.3333333333333333,10,8,CGCCGCCATACGAATAAACA,2,2921362
ompRp4,1.0,4,2,CCATTTGTCGTCGGGCGCGA,2,2918306
ompRp4,0.6,6,4,CAACGTTAAGAATCTCCGAT,2,2916107
ompRp4,1.0,4,2,CAAACGCGCTGGAGAGCAAG,2,2928665
ompRp4,1.5,3,1,CAAAAGGATTTACAATTTTG,2,2910340
ompRp4,0.42857142857142855,8,6,ATGGTCATAATTTTTTTAAA,2,2925283
ompRp4,1.0,4,2,ATGGAAGGTGTAAGCGGGAT,2,2911153
ompRp4,1.5,3,1,AGCGGGGTCAAGGTACCGTA,2,2913190
ompRp4,1.5,3,1,ACGCTCTATGACGGTAGTGT,2,2914213
ompRp4,0.75,5,3,ACCGGTTAGGCGAAGTGTCA,2,2911760
ompRp4,0.42857142857142855,8,6,ACCAACCCGAATCCGGTGCG,2,2918484
ompRp4,1.5,3,1,ACAAATGCATTGGTATGACA,2,2924452
ompRp4,1.0,2,1,TTTGTCGAATATTGAGCAAC,1,2927005
ompRp4,1.0,2,1,TTTGAGTTACGTGGTAACTG,1,2911963
ompRp4,1.0,2,1,TTGCGGCTGCACGTCTCTCA,1,2928242
ompRp4,1.0,2,1,TTGCGCTAACGGTGAGCTGT,1,2914065
ompRp4,1.0,2,1,TTGAACATGGGCATTGAGGA,1,2937910
ompRp4,1.0,2,1,TTCGTATACTATTCAGGACT,1,2936147
ompRp4,1.0,2,1,TGTCTTAATTCAATCGACTT,1,2934114
ompRp4,0.2,10,9,TGTATCCGGTACCGCGGCAG,1,2921503
ompRp4,0.5,4,3,TGTAGGTCCCGCCAAACTCT,1,2912761
ompRp4,0.2857142857142857,7,6,TGTACCAGGTCCGTTCTCCA,1,2925949
ompRp4,1.0,2,1,TGCTTAAGCAACCAGAGTAA,1,2922306
ompRp4,0.6666666666666666,3,2,TGCGTCTGCGAAGTCCAACA,1,2917409
ompRp4,0.5,4,3,TGCGCGGTTGGCCGGGCTTG,1,2926383
ompRp4,0.5,4,3,TGCATTAAAAGGGAGTTCAA,1,2927347
ompRp4,1.0,2,1,TGCAAGGTAGACGCGAACCT,1,2929171
ompRp4,1.0,2,1,TGATTGTGAAGGTATCTTCA,1,2929805
ompRp4,1.0,2,1,TGAGGACATTGCAATGTAAT,1,2929331
ompRp4,1.0,2,1,TGACCATAGGATTGGCTGGG,1,2917465
ompRp4,0.6666666666666666,3,2,TCTTGATGGTACTATTTCGC,1,2914564
ompRp4,0.3333333333333333,6,5,TCTTCTGACGAAGCCGCATA,1,2910763
ompRp4,1.0,2,1,TCTGACTTCGACCGAAGGAT,1,2933780
ompRp4,1.0,2,1,TCTACTGCTGGGCGCTGGGT,1,2909368
ompRp4,0.6666666666666666,3,2,TCGTCGAGAGCTCTCCGATC,1,2924059
ompRp4,0.2222222222222222,9,8,TCCTTCCCAGACCCATATAT,1,2914962
ompRp4,1.0,2,1,TCCTGATGCATGTCGCAATT,1,2930869
ompRp4,1.0,2,1,TCAGGTCCCGTGGAACCACA,1,2933863
ompRp4,1.0,2,1,TATGTGTTCACGCAATTCAT,1,2912753
ompRp4,0.2857142857142857,7,6,TATGTCGTACAACGATACTT,1,2911177
ompRp4,1.0,2,1,TATGAATGCTGATACAGCCG,1,2921440
ompRp4,0.5,4,3,TATCGCCTTAATAGGGTTTG,1,2910738
ompRp4,1.0,2,1,TATACAGTTTAGGCAGTCTG,1,2921875
ompRp4,0.6666666666666666,3,2,TATAACGGATCTAAAGTACT,1,2923835
ompRp4,0.6666666666666666,3,2,TAGGGCAAGACAGTGACAAG,1,2931766
ompRp4,1.0,2,1,TAGATAGAGGGCTGTCTGAA,1,2923856
ompRp4,0.6666666666666666,3,2,TAGAGTACGTCGCCTGAGAG,1,2936151
ompRp4,0.4,5,4,TAGAGCATACATTGTTCGTC,1,2911955
ompRp4,0.2857142857142857,7,6,TACCGGCAGCATGGACAATA,1,2933630
ompRp4,1.0,2,1,TAAGCACTTCGTATAATTCA,1,2926028
ompRp4,0.3333333333333333,6,5,TAAGAAACTCCCGATGGGGT,1,2922214
ompRp4,1.0,2,1,TAACCTGTGATAGATCTGTG,1,2933520
ompRp4,0.5,4,3,TAACCTGTCTACTAAGACCA,1,2936969
ompRp4,1.0,2,1,TAACAGGCCGTCTACTGTCT,1,2918424
ompRp4,0.2222222222222222,9,8,TAACACTGCGAAAGGGTCGT,1,2928265
ompRp4,0.18181818181818182,11,10,GTTTGGAAACAACATAGCAA,1,2933976
ompRp4,0.5,4,3,GTTTCGTGCTTCACATGTAT,1,2909990
ompRp4,0.6666666666666666,3,2,GTTATTTAAGTCGGCGATTG,1,2924041
ompRp4,1.0,2,1,GTTAGCGCAGGATTCGCCTA,1,2930924
ompRp4,0.4,5,4,GTCGATGGACTATAACAGGT,1,2912607
ompRp4,1.0,2,1,GTCCGTACCACACCGAAACA,1,2937444
ompRp4,0.6666666666666666,3,2,GGTTGGATACCGGAATTGCT,1,2923313
ompRp4,0.4,5,4,GGTGTTCTACCCATTTCAAA,1,2924035
ompRp4,0.4,5,4,GGTGCCTTGCGATAATTCTA,1,2936123
ompRp4,0.5,4,3,GGTACGGGGCTACCCTGTGA,1,2909270
ompRp4,0.16666666666666666,12,11,GGTACATGCCAGATGTAATG,1,2917065
ompRp4,1.0,2,1,GGGGCCGGGCGTATTATTGT,1,2911729
ompRp4,0.3333333333333333,6,5,GGGACCCGGATGCACGATAC,1,2936762
ompRp4,0.6666666666666666,3,2,GGGAACAGTTGTACCGCACT,1,2914382
ompRp4,1.0,2,1,GGATGTGTTCGATTAGAAAT,1,2923010
ompRp4,1.0,2,1,GGATGAACAGCGTTCCATGA,1,2917470
ompRp4,0.6666666666666666,3,2,GGAGCAAAATCTGCGGTGCA,1,2908039
ompRp4,0.2222222222222222,9,8,GGAGAATAGCTCGTTATCAG,1,2915647
ompRp4,0.4,5,4,GGACCAATTGTTGGTCGAGA,1,2928381
ompRp4,0.6666666666666666,3,2,GGAAGATCGCACTGTATCCG,1,2924564
ompRp4,0.25,8,7,GCTGATCATGTGAATTGAAC,1,2909976
ompRp4,0.2,10,9,GCTCGAATGCCTGAAACTTG,1,2924756
ompRp4,1.0,2,1,GCTCAGCGTTCGAACGTGAC,1,2911249
ompRp4,0.4,5,4,GCTAGGATTTTAATGTAAAA,1,2911237
ompRp4,1.0,2,1,GCGTCAAGCCCGGTTGTATA,1,2910219
ompRp4,1.0,2,1,GCGTAATGACAAGTCGTCTA,1,2929603
ompRp4,0.2,10,9,GCGGGTATGCCGCGACGGCA,1,2908841
ompRp4,1.0,2,1,GCGGCCCTGGAGGTTAAACT,1,2932615
ompRp4,0.6666666666666666,3,2,GCGCAGGACAAGTCCCTATA,1,2938194
ompRp4,0.6666666666666666,3,2,GCGATATTCGGGATTCCATA,1,2934595
ompRp4,0.2857142857142857,7,6,GCCCAGATCACAATATTATG,1,2914685
ompRp4,0.4,5,4,GCATATTCGTAATGTTCAAA,1,2917110
ompRp4,1.0,2,1,GCAACCGGTTGAATGCCTGC,1,2908309
ompRp4,0.6666666666666666,3,2,GATTCAATCTGCAGCTCACC,1,2920694
ompRp4,0.6666666666666666,3,2,GATGCACTTCTTATGGAGTT,1,2933625
ompRp4,1.0,2,1,GATCTCCTGGTCTACTTTGC,1,2924592
ompRp4,1.0,2,1,GAGTTCTAAAACCTACCCCA,1,2919686
ompRp4,1.0,2,1,GAGTGCCACGCTTCAGACGA,1,2921885
ompRp4,0.6666666666666666,3,2,GAGTGAACTCCCAACGTCCT,1,2937769
ompRp4,0.2857142857142857,7,6,GAGCCAATTCCCGCTTAGCT,1,2913134
ompRp4,0.5,4,3,GACGGAAGAAACTAGGTACT,1,2921653
ompRp4,1.0,2,1,GACCTAGCTCCGATCAATCT,1,2910799
ompRp4,0.6666666666666666,3,2,GACAGATACGACTCTTTTGA,1,2911590
ompRp4,0.4,5,4,GACAACTGTGTCACACAGAT,1,2918125
ompRp4,1.0,2,1,GAATCGGAGATTTTCGTTTT,1,2908645
ompRp4,0.2857142857142857,7,6,GAAAAGCAGTTTAGGTCCAA,1,2934447
ompRp4,0.5,4,3,CTTTTTTAGAGCAATAGTTT,1,2923792
ompRp4,0.6666666666666666,3,2,CTTTTTGGCTTCACATCGTA,1,2908357
ompRp4,1.0,2,1,CTTGCGCTAGACATCATTGA,1,2916167
ompRp4,1.0,2,1,CTTCGGCGCAGTTCCACGGC,1,2934277
ompRp4,0.6666666666666666,3,2,CTTCAAGGTACAGCGGTGTC,1,2933676
ompRp4,0.3333333333333333,6,5,CTGTTCCCCTTGATTATTAA,1,2929026
ompRp4,0.2857142857142857,7,6,CTGGGTAGAGAGACCATTGT,1,2929384
ompRp4,1.0,2,1,CTGGCTTATGCATTGTACCC,1,2916073
ompRp4,0.5,4,3,CTCTAGAAGCAGTAACTTCT,1,2912098
ompRp4,0.6666666666666666,3,2,CTCGTGACAGCGTGATTGTT,1,2913487
ompRp4,0.5,4,3,CTCACGTCTTGAAGCGCTGC,1,2932150
ompRp4,1.0,2,1,CTATTTTGGCGTTTAGCTGA,1,2908674
ompRp4,0.6666666666666666,3,2,CTACTGTGCGAAATCTGGTT,1,2933342
ompRp4,0.2222222222222222,9,8,CGTCTTGATTGAAGCCAAAC,1,2913067
ompRp4,0.3333333333333333,6,5,CGTACGATTTTCCCGATGTA,1,2927213
ompRp4,0.6666666666666666,3,2,CGGTAGGTTTTTCCACGGAG,1,2929068
ompRp4,0.6666666666666666,3,2,CGGATCCTGCCCAAAGACAT,1,2911101
ompRp4,0.5,4,3,CGCCGTTCTTCGTAAGACTC,1,2912296
ompRp4,1.0,2,1,CGCCGTTATAAGCCCGTGTA,1,2909208
ompRp4,0.5,4,3,CGCCGTCTCGGCCTCGCGTA,1,2917902
ompRp4,0.6666666666666666,3,2,CGATAGTTTACTCTCCTCCA,1,2928332
ompRp4,1.0,2,1,CGAGTGCTGGAATGCCCGTA,1,2908273
ompRp4,1.0,2,1,CGAATCAAGGTGTCGAATGA,1,2910304
ompRp4,1.0,2,1,CCTCCCGCGCTGCGCTCCAG,1,2926711
ompRp4,0.6666666666666666,3,2,CCTCAGCACAAGTGCCGGTT,1,2935604
ompRp4,1.0,2,1,CCTAACTCGCCGGCTTTTCC,1,2934878
ompRp4,0.2857142857142857,7,6,CCTAACAGAAGACGGGGAGC,1,2938008
ompRp4,1.0,2,1,CCTAAATGCTGCTGAAGATC,1,2933901
ompRp4,0.6666666666666666,3,2,CCGGCGGCAAGCGTAAATTA,1,2915323
ompRp4,0.4,5,4,CCATTCCATATACTCTTGTT,1,2910497
ompRp4,1.0,2,1,CCAGGGGTCTGTCCAAGCGA,1,2923941
ompRp4,0.6666666666666666,3,2,CCAGCCCTAAGGGGCCGAAT,1,2932372
ompRp4,0.4,5,4,CCACCCGCGTCTCCCCACGC,1,2907905
ompRp4,0.3333333333333333,6,5,CCAACCCGGCCCACTTACAT,1,2934234
ompRp4,0.3333333333333333,6,5,CATTTAGTCCCTGACTTGGA,1,2927321
ompRp4,1.0,2,1,CATAAGTTAATCGAGGGTCT,1,2937364
ompRp4,1.0,2,1,CAGTTGCCCTGTTTCAGAAG,1,2930870
ompRp4,1.0,2,1,CAGCGAGCACCTAATCTGGC,1,2931591
ompRp4,0.18181818181818182,11,10,CAGATCTCGTAGAAACGGCG,1,2909814
ompRp4,0.4,5,4,CAGATCAAGATTGAAGGGAG,1,2913296
ompRp4,1.0,2,1,CACCCCGGCGCCGTTAGTGC,1,2923689
ompRp4,0.6666666666666666,3,2,CACCCCGCCTGCTCCTTGAT,1,2928165
ompRp4,0.5,4,3,CACATAAAACGGCGTTGGTA,1,2924920
ompRp4,1.0,2,1,CAACAATAGCGGTCATCTGG,1,2926754
ompRp4,0.6666666666666666,3,2,CAAATAGCGTGGTGGGACGT,1,2928926
ompRp4,0.6666666666666666,3,2,CAAAACGTTGTCAATATGTT,1,2918628
ompRp4,1.0,2,1,ATTGGCAAGCCCGTTTCTAG,1,2933396
ompRp4,1.0,2,1,ATTGCTCAAGCGAACATTCC,1,2909731
ompRp4,0.3333333333333333,6,5,ATTCTAGGGCGACAAGTGAC,1,2923178
ompRp4,1.0,2,1,ATTAGCGAGTACTGACGTTA,1,2932043
ompRp4,0.6666666666666666,3,2,ATGTTAAACTGGAGTGTATC,1,2933541
ompRp4,1.0,2,1,ATGTAACCCTTGGCAGTACG,1,2929766
ompRp4,0.6666666666666666,3,2,ATGCCTCCGGGAACGCAAGT,1,2928928
ompRp4,0.6666666666666666,3,2,ATCTACGAGGTGGTTTTGAC,1,2927786
ompRp4,1.0,2,1,ATCGGTATTGGCCCTAATGG,1,2928389
ompRp4,0.6666666666666666,3,2,ATCCTGTTCATCCGTCGCGA,1,2935336
ompRp4,0.3333333333333333,6,5,ATCCGTGGTAAGGGACTTCT,1,2913011
ompRp4,0.6666666666666666,3,2,ATCCGCAGTGAAGATTCATG,1,2921643
ompRp4,0.5,4,3,ATCATCGCTCTAACACGAGT,1,2928840
ompRp4,1.0,2,1,ATACTAGGCTATTCGTCTAA,1,2925749
ompRp4,0.6666666666666666,3,2,ATACAATTTTCTGTCGCTCA,1,2912509
ompRp4,1.0,2,1,AGTTTCTATGTCTAAGGAGC,1,2910959
ompRp4,0.6666666666666666,3,2,AGTGTCGATGACCCTCGTGG,1,2919861
ompRp4,0.2222222222222222,9,8,AGGTAACCGAAAGGGTCCCT,1,2931691
ompRp4,0.6666666666666666,3,2,AGGGCAAGTCTAGCTCATAC,1,2908443
ompRp4,0.6666666666666666,3,2,AGCGTGAGCTATTGAGTCAG,1,2915694
ompRp4,0.2857142857142857,7,6,AGCCCCATTCTGTCATTATC,1,2933543
ompRp4,1.0,2,1,AGCCAATTGGTTGGCCGTGG,1,2926971
ompRp4,1.0,2,1,AGCATCTTACTCCCAGCCTG,1,2921792
ompRp4,0.5,4,3,AGATAGGTAGCGGTAATCCC,1,2916923
ompRp4,0.6666666666666666,3,2,AGAAAAAGACTTCTTGTACC,1,2921623
ompRp4,0.5,4,3,ACTTGGTTTTCATATATATG,1,2926886
ompRp4,1.0,2,1,ACGGTCAGCGTCTGGAGGAG,1,2921012
ompRp4,0.5,4,3,ACGGATATGAGATCCTCGTC,1,2912986
ompRp4,0.2857142857142857,7,6,ACCGGTGGGCCGCTGACTCC,1,2912304
ompRp4,0.6666666666666666,3,2,ACCCGGTAGCAAAACAGAAC,1,2909559
ompRp4,0.4,5,4,ACCCGCGAGGCCTCAGGCTC,1,2925630
ompRp4,0.6666666666666666,3,2,ACCATGCCGCAACGCTTGAT,1,2922585
ompRp4,0.6666666666666666,3,2,ACATAACGTGGCAGAGTTAG,1,2913032
ompRp4,0.6666666666666666,3,2,ACAGGTAACAAGCGTTTGCT,1,2913069
ompRp4,0.2,10,9,ACAAGTTTAACGTTCTCGAT,1,2929379
ompRp4,0.6666666666666666,3,2,ACAAGCGGGAAGCCTTGCAG,1,2931138
ompRp4,0.2857142857142857,7,6,ACAACCGCGCCAGGTGTTGG,1,2930119
ompRp4,0.6666666666666666,3,2,AAGGGCACTGGCTAGACCAA,1,2921590
ompRp4,0.4,5,4,AAGGCGAATTGTAATAAGCA,1,2907831
ompRp4,0.2,10,9,AAGGAACAGTTATGTTAACA,1,2938154
ompRp4,0.5,4,3,AAGACAATTGGATCAGAATG,1,2915698
ompRp4,1.0,2,1,AACCTGGGTGACAACGTGCA,1,2918680
ompRp4,0.2857142857142857,7,6,AACATATTTAGTCCGTCGAA,1,2907960
ompRp4,0.6666666666666666,3,2,AAACAGTCGCAGGGTCCGAG,1,2927234
ompRp4,0.047619047619047616,20,20,CGTTTTGAAGTCAAGGGTTC,0,2909516
ompRp4,0.05263157894736842,18,18,ACGACAGAAAACCAATGTAG,0,2917046
ompRp4,0.05555555555555555,17,17,GCCCCGGGCCTTGGGCCAAG,0,2928920
ompRp4,0.06666666666666667,14,14,ATCCCGGGTGGTCGGCCCAA,0,2924316
ompRp4,0.07142857142857142,13,13,CTGGGTTTTACGGTTGTTTA,0,2934236
ompRp4,0.07142857142857142,13,13,CCGCTAGCCACTTCCCCCAG,0,2913783
ompRp4,0.07692307692307693,12,12,GTCTTGATCGCTCGGATCGT,0,2918420
ompRp4,0.08333333333333333,11,11,TATATGTTGGTGATGTACTA,0,2936245
ompRp4,0.08333333333333333,11,11,TAGCGTTTGTCATGAGTCGT,0,2909085
ompRp4,0.08333333333333333,11,11,ACAGGGAAAATGTCGCCAGT,0,2929517
ompRp4,0.08333333333333333,11,11,AATGAGGTTGGAGCGTCCCA,0,2928335
ompRp4,0.09090909090909091,10,10,TTCTTGAAGACATTTAATGT,0,2933738
ompRp4,0.09090909090909091,10,10,TAAGCGTAACTCTAGCTCTG,0,2937947
ompRp4,0.09090909090909091,10,10,GGAAGACACGACGCTAGCTA,0,2921335
ompRp4,0.09090909090909091,10,10,GAGTACCGACCCCTCAGTGG,0,2921647
ompRp4,0.09090909090909091,10,10,GAGCACGCGCCTTATCACGA,0,2910234
ompRp4,0.09090909090909091,10,10,CCCGCATTGTAACCACAACA,0,2925224
ompRp4,0.09090909090909091,10,10,CAGGAAAGGTCCTTGGTACA,0,2930443
ompRp4,0.09090909090909091,10,10,ATCTCTCTCAACAAAACCCG,0,2911694
ompRp4,0.09090909090909091,10,10,AGAAGCCAATTCAGAGTTAG,0,2917240
ompRp4,0.1,9,9,TTAATTGCAGCAGCAAACTT,0,2923685
ompRp4,0.1,9,9,TCAGATGGAGGAGTGAATTC,0,2932105
ompRp4,0.1,9,9,TATGAGTGCGGGCTACTTTT,0,2913612
ompRp4,0.1,9,9,TATCTCGACCCAACGAGGCG,0,2925614
ompRp4,0.1,9,9,GTGTTGCTGAGGGTACCCCA,0,2908924
ompRp4,0.1,9,9,GGACTCTTGGGTGGGGAATA,0,2934063
ompRp4,0.1,9,9,CGGCTTCGTCTTAGTCCGAA,0,2933979
ompRp4,0.1,9,9,CCTTGATCCCAACTTCCTGA,0,2922988
ompRp4,0.1,9,9,CCGTAGAGAATGTTTTCGTA,0,2924275
ompRp4,0.1,9,9,CCAGGCACTGATCAGATCGA,0,2914328
ompRp4,0.1,9,9,ATAGAAACATAGCCTCGGAC,0,2926550
ompRp4,0.1,9,9,ACGGGGCTGTGAGATTTTGG,0,2916667
ompRp4,0.1,9,9,AATGGGGAAGGCACAGTAGG,0,2912739
ompRp4,0.1,9,9,AAGGCAATACCAAAACGTGC,0,2930203
ompRp4,0.1111111111111111,8,8,TTAGATATCGGACAGATTGT,0,2929273
ompRp4,0.1111111111111111,8,8,TGTACCTATCCCTGGAACAG,0,2914799
ompRp4,0.1111111111111111,8,8,TGCTGCTTAGAACCTTGGCA,0,2913035
ompRp4,0.1111111111111111,8,8,TCTCAACCAATATGGTGTCC,0,2913455
ompRp4,0.1111111111111111,8,8,TCCGTTTCAGGAACCGCGAG,0,2911758
ompRp4,0.1111111111111111,8,8,TCCAGACCGCCGCCGTTGGA,0,2935258
ompRp4,0.1111111111111111,8,8,TAACACTTCAGACTTCCCTA,0,2912277
ompRp4,0.1111111111111111,8,8,GGTCCCGCGTCAAAATCAAA,0,2932603
ompRp4,0.1111111111111111,8,8,GGCCATGTTGGCCTTCATGG,0,2929873
ompRp4,0.1111111111111111,8,8,GCTTGAGCAGTAGCCACCTA,0,2915088
ompRp4,0.1111111111111111,8,8,GATGAGAGGAATCTACTTGG,0,2908885
ompRp4,0.1111111111111111,8,8,CGGCATATATACGATGAACC,0,2931258
ompRp4,0.1111111111111111,8,8,CGCGGCTGGACCGGCTGCAG,0,2925150
ompRp4,0.1111111111111111,8,8,CACACTACATCCTGCCAAGT,0,2914944
ompRp4,0.1111111111111111,8,8,CACACAGATACGAACGAGTC,0,2935994
ompRp4,0.1111111111111111,8,8,CAATATCATAGTAAGATCGC,0,2918382
ompRp4,0.1111111111111111,8,8,ATAGGAATTAAAGGCCTGAG,0,2926508
ompRp4,0.1111111111111111,8,8,AGGGTTAGCACAGAATGCAT,0,2908846
ompRp4,0.1111111111111111,8,8,AGCCTGACGGAACCTGGACG,0,2933384
ompRp4,0.1111111111111111,8,8,AGCAAGGTCGTTGGGGGTGG,0,2910238
ompRp4,0.1111111111111111,8,8,AACACCGCGGTCTGCGCTTA,0,2921366
ompRp4,0.125,7,7,TTTGGCTCTTCGCTGAACCA,0,2922123
ompRp4,0.125,7,7,TTGCCCAGCATTCTGGCGCT,0,2921120
ompRp4,0.125,7,7,TGATTTTCACACCGGAACTC,0,2927257
ompRp4,0.125,7,7,TCAAAATCCGTAAATGTATG,0,2922053
ompRp4,0.125,7,7,TAGCGCGCCTAACATTCCAG,0,2923674
ompRp4,0.125,7,7,TAGAGACCCTTTTGGGGAAC,0,2922215
ompRp4,0.125,7,7,TACCCAGTACAGTAAGCAAA,0,2926544
ompRp4,0.125,7,7,TAACTCCCCAATTACACCAA,0,2913899
ompRp4,0.125,7,7,GTGCGTACGTCCTTGTACAG,0,2917857
ompRp4,0.125,7,7,GCTGTGCTTACAGTGTACCC,0,2913018
ompRp4,0.125,7,7,GCGTTCGAACAGGCCAATCT,0,2921190
ompRp4,0.125,7,7,GCGATAGGCACGTACTTAGC,0,2919633
ompRp4,0.125,7,7,GATTTCTGATTCACAGCGGC,0,2929471
ompRp4,0.125,7,7,GACAGGTAAACACATCTTGC,0,2917539
ompRp4,0.125,7,7,CTTGGTCCTACAAGTCTCCA,0,2913403
ompRp4,0.125,7,7,CTTGAGGTCCCAGTGTTGAG,0,2927406
ompRp4,0.125,7,7,CTGGGGTAGCACTTCGGATA,0,2934172
ompRp4,0.125,7,7,CGGTTTCATAGGATTCCGTT,0,2914958
ompRp4,0.125,7,7,CGACAGGTTCGAACAGCGGA,0,2918127
ompRp4,0.125,7,7,CGAACGCCACGACGCAGAAA,0,2917117
ompRp4,0.125,7,7,CCTGCCCCATAACTTTGACC,0,2936080
ompRp4,0.125,7,7,CCCTAGAATCCGCCGCTTAG,0,2929717
ompRp4,0.125,7,7,CATTGAACCCCCGCACCTCG,0,2908406
ompRp4,0.125,7,7,CAAATCTCCAGGTAGTTATA,0,2923307
ompRp4,0.125,7,7,ATGTGGGGCTCCTGAACGTG,0,2934766
ompRp4,0.125,7,7,AGTATTAGTAGGGAAAGATG,0,2911879
ompRp4,0.125,7,7,AGCACTGAACCTACACATGC,0,2930043
ompRp4,0.125,7,7,ACTTGTTCCCGCCGTAAAGG,0,2929276
ompRp4,0.125,7,7,ACTTACCGTATGGACTGCCG,0,2923147
ompRp4,0.125,7,7,ACATCTGGTGCTTGACAAAA,0,2934515
ompRp4,0.125,7,7,ACACCTGGGCATCACGATCA,0,2924142
ompRp4,0.125,7,7,AACTCATGCACCGGTGAAAT,0,2933706
ompRp4,0.125,7,7,AAAAGCGGGAAACGAAACAG,0,2907999
ompRp4,0.14285714285714285,6,6,TTTGGGATGGGCGGTCACGA,0,2908542
ompRp4,0.14285714285714285,6,6,TTTGCGTCTTCGAAGGGGTA,0,2926087
ompRp4,0.14285714285714285,6,6,TTTCAGGAGAGCGTAGGAAC,0,2932436
ompRp4,0.14285714285714285,6,6,TTGTTCGGGCCGCATGTCTT,0,2934280
ompRp4,0.14285714285714285,6,6,TTGCCGGCGTTTCACAGGTC,0,2922970
ompRp4,0.14285714285714285,6,6,TTCTGTTGGGTAGGAAAGAC,0,2932251
ompRp4,0.14285714285714285,6,6,TTCGGGTCGGTTTGATGACA,0,2915334
ompRp4,0.14285714285714285,6,6,TTCGATATGGAATGTAAGTT,0,2921770
ompRp4,0.14285714285714285,6,6,TTAGGAAGGTTCATTTACGT,0,2920491
ompRp4,0.14285714285714285,6,6,TGTATGTTACTTATACGGTC,0,2932127
ompRp4,0.14285714285714285,6,6,TCGCTTACTTCATATAATAG,0,2931979
ompRp4,0.14285714285714285,6,6,TCCCTCAAGGCGAAACATCA,0,2935485
ompRp4,0.14285714285714285,6,6,TACGTAGAATGACCCATCCA,0,2928954
ompRp4,0.14285714285714285,6,6,TACCATCTCGCTCGTAAATC,0,2937481
ompRp4,0.14285714285714285,6,6,GTTGCGGGGCCTCTTTTTTC,0,2926834
ompRp4,0.14285714285714285,6,6,GTCCTCGGCCGGAGCCGGCG,0,2928124
ompRp4,0.14285714285714285,6,6,GTCCGATGGAAACATCTTCT,0,2918703
ompRp4,0.14285714285714285,6,6,GTCCGAATATAGAACGGAGT,0,2908256
ompRp4,0.14285714285714285,6,6,GTACGCTCCGGGGTTTAGGG,0,2929277
ompRp4,0.14285714285714285,6,6,GGGGAGGACGGCGTCTACGT,0,2913877
ompRp4,0.14285714285714285,6,6,GGCATATACGGGATTGATCT,0,2913623
ompRp4,0.14285714285714285,6,6,GGCAGTATCCCCACACTTAA,0,2920155
ompRp4,0.14285714285714285,6,6,GGACCGTAGCTAAAGCAGTC,0,2910644
ompRp4,0.14285714285714285,6,6,GGAACATCCCAACGCGGTCT,0,2923905
ompRp4,0.14285714285714285,6,6,GCTCAACCAGCGTTCGACAA,0,2925938
ompRp4,0.14285714285714285,6,6,GCTATCTTAATGGCGACCGT,0,2913565
ompRp4,0.14285714285714285,6,6,GCCAGCTAAAAGGAACCGCA,0,2916780
ompRp4,0.14285714285714285,6,6,GATCGCAGATACGTGCGTTC,0,2922619
ompRp4,0.14285714285714285,6,6,GACTTATACCCACAAAGCAA,0,2913839
ompRp4,0.14285714285714285,6,6,GACTGTCAAGCGCACCACTA,0,2927572
ompRp4,0.14285714285714285,6,6,CTCAACCGATAGCTTCGTTC,0,2908161
ompRp4,0.14285714285714285,6,6,CGTCCGACTTCTCAGAGACA,0,2913501
ompRp4,0.14285714285714285,6,6,CGAGTATAATGTTCAGCCTC,0,2928116
ompRp4,0.14285714285714285,6,6,CCCGCTGCTATATCGCGGGC,0,2910018
ompRp4,0.14285714285714285,6,6,CCAGTATTGGCAAACAGATG,0,2919591
ompRp4,0.14285714285714285,6,6,CATCCTAATCTTACTAGGAA,0,2934624
ompRp4,0.14285714285714285,6,6,CACCGGTGGCCACCGAGTTA,0,2921728
ompRp4,0.14285714285714285,6,6,ATTATAGCAGAGTTCGCTCA,0,2911406
ompRp4,0.14285714285714285,6,6,ATTAGGGAAAGCTGCGATTA,0,2927283
ompRp4,0.14285714285714285,6,6,ATGGGCAGCGAGTATCCAGG,0,2925513
ompRp4,0.14285714285714285,6,6,ATAGCAGAACTGAGGCAGTA,0,2922824
ompRp4,0.14285714285714285,6,6,AGTCTGCACCTGCAGTACGG,0,2928272
ompRp4,0.14285714285714285,6,6,AGTATGCTGCAAGTACGGTT,0,2916444
ompRp4,0.14285714285714285,6,6,AGGGACAACTCACCTCTGAC,0,2913412
ompRp4,0.14285714285714285,6,6,AGGCCAGCCCTCAGATTACT,0,2930597
ompRp4,0.14285714285714285,6,6,AGGATTGTCGGTGTTCTGCT,0,2917708
ompRp4,0.14285714285714285,6,6,AGACCCCCAAGTCTACGACG,0,2914812
ompRp4,0.14285714285714285,6,6,ACGAGCCCTTCCACGGGGTC,0,2927606
ompRp4,0.14285714285714285,6,6,ACGACATATGGACGGGTCGG,0,2915855
ompRp4,0.14285714285714285,6,6,ACCGTGGGCTAAGGTATAAG,0,2922259
ompRp4,0.14285714285714285,6,6,ACATTTCCTTGTGAGGCGAG,0,2930001
ompRp4,0.14285714285714285,6,6,AAGGATTAGGCACGATCACC,0,2913237
ompRp4,0.14285714285714285,6,6,AAGAGGCCCCAAAAGCGTAT,0,2910510
ompRp4,0.14285714285714285,6,6,AAATGCCTTCGCCCGTTGGT,0,2934088
ompRp4,0.14285714285714285,6,6,AAAGTGGGCCTCGGCGGTTT,0,2915626
ompRp4,0.14285714285714285,6,6,AAAGACGCTCGTTGGGCGGC,0,2914192
ompRp4,0.16666666666666666,5,5,TTTCTTATCCATATGTGCTT,0,2922037
ompRp4,0.16666666666666666,5,5,TTGTATCGCATATCGTAGGA,0,2924444
ompRp4,0.16666666666666666,5,5,TTGCGCACCCACCAGCATGT,0,2920944
ompRp4,0.16666666666666666,5,5,TTGCCTGTCATTTTCAAGTC,0,2909797
ompRp4,0.16666666666666666,5,5,TTCTGCACAAGGCAAAGGGT,0,2927813
ompRp4,0.16666666666666666,5,5,TTAGAAATATGCAGTGTCAT,0,2932791
ompRp4,0.16666666666666666,5,5,TGTTAGCAAGCCTGCGCCAG,0,2913869
ompRp4,0.16666666666666666,5,5,TGTCCAGTGAACTACAGCGG,0,2916226
ompRp4,0.16666666666666666,5,5,TGGGTGACGTGTGCCGGGTC,0,2918024
ompRp4,0.16666666666666666,5,5,TGGACGGTAACGATCGGTTG,0,2923176
ompRp4,0.16666666666666666,5,5,TGCTCAGGGCATTAAGACAG,0,2931502
ompRp4,0.16666666666666666,5,5,TGCGTAGATCCTCAGATGTA,0,2936742
ompRp4,0.16666666666666666,5,5,TGATGGGTATCTCACACCCA,0,2913587
ompRp4,0.16666666666666666,5,5,TCTTGCAGTCATTTGCAATT,0,2936371
ompRp4,0.16666666666666666,5,5,TCGTTGAGCCCTAAGCTCAA,0,2915246
ompRp4,0.16666666666666666,5,5,TCGTCTTGATGTGACACACC,0,2925784
ompRp4,0.16666666666666666,5,5,TCGGGGGAGCTTGAAATCAG,0,2915055
ompRp4,0.16666666666666666,5,5,TCGGACAACAATCTTTACAC,0,2912869
ompRp4,0.16666666666666666,5,5,TCGCCCGTACAATGGGATAA,0,2927070
ompRp4,0.16666666666666666,5,5,TCGCACTCGCAGAGTAGGAA,0,2927340
ompRp4,0.16666666666666666,5,5,TCGATTTGTTGGGTAGCGCA,0,2922113
ompRp4,0.16666666666666666,5,5,TCGAAATATTTGAGCGGGCT,0,2937697
ompRp4,0.16666666666666666,5,5,TCATGTCTTTTTCCCAAGGG,0,2916675
ompRp4,0.16666666666666666,5,5,TCAGTTGTGGGACTGTGCCT,0,2910069
ompRp4,0.16666666666666666,5,5,TCAGCGCTGGCTAGGCAGCT,0,2913277
ompRp4,0.16666666666666666,5,5,TCAGCCACAGTGGGGTTTCT,0,2909545
ompRp4,0.16666666666666666,5,5,TATTGTGCGTGCTGGGAAAG,0,2926489
ompRp4,0.16666666666666666,5,5,TATGAGCTGCAGGTACAAGT,0,2923403
ompRp4,0.16666666666666666,5,5,TAGATTCGGGCCAAGATTAC,0,2920178
ompRp4,0.16666666666666666,5,5,TACCGGGACGCTTCCATGCG,0,2914194
ompRp4,0.16666666666666666,5,5,TACACTGGGGAGGAGGTTGT,0,2923481
ompRp4,0.16666666666666666,5,5,TAACTATGCATGATATCGTG,0,2915141
ompRp4,0.16666666666666666,5,5,GTTTACCTTTGGGGTGTAAC,0,2908487
ompRp4,0.16666666666666666,5,5,GTTACGACAAGTCGCACTTC,0,2922405
ompRp4,0.16666666666666666,5,5,GTGTCGGAGTCTCCATTGTG,0,2928111
ompRp4,0.16666666666666666,5,5,GTGTCCTAAACACTCGTACT,0,2907758
ompRp4,0.16666666666666666,5,5,GTCTTGCATTGGCTATGCCA,0,2925387
ompRp4,0.16666666666666666,5,5,GTCTAGTGGCCCAGTTGAAG,0,2925694
ompRp4,0.16666666666666666,5,5,GGTGCTCTCAACATGAACGT,0,2917484
ompRp4,0.16666666666666666,5,5,GGTCATATACCGTGTCGAAT,0,2916797
ompRp4,0.16666666666666666,5,5,GGTACGATAGTGGAGACTGA,0,2908445
ompRp4,0.16666666666666666,5,5,GGGTGCATAAGAACTGGTAG,0,2915350
ompRp4,0.16666666666666666,5,5,GGGGTGGCTTCTCCAAAGTT,0,2916445
ompRp4,0.16666666666666666,5,5,GGGGGTCGCGCCCCACCTGT,0,2938003
ompRp4,0.16666666666666666,5,5,GGGCGTCTATTGCACATATG,0,2931639
ompRp4,0.16666666666666666,5,5,GGGCAAGAATTGTTTTAAAA,0,2933334
ompRp4,0.16666666666666666,5,5,GGCTAGCGACCTACCACCCC,0,2930370
ompRp4,0.16666666666666666,5,5,GGCGATTTAGTTGTATGATG,0,2928616
ompRp4,0.16666666666666666,5,5,GCTGTTAGGATTGTGGACGC,0,2915357
ompRp4,0.16666666666666666,5,5,GCTCGTATTTCGGCGGGCGT,0,2914570
ompRp4,0.16666666666666666,5,5,GCGGCGACGCGGATCACGTC,0,2930341
ompRp4,0.16666666666666666,5,5,GCGCTTATGAACCTACGGCG,0,2915512
ompRp4,0.16666666666666666,5,5,GCCCACCAGACGGTGGTAGT,0,2913790
ompRp4,0.16666666666666666,5,5,GCATGCGCGTGACAGCCATA,0,2916668
ompRp4,0.16666666666666666,5,5,GCAGTTTAGCTTGCAGTGGT,0,2914530
ompRp4,0.16666666666666666,5,5,GCACATTCTGGTAACACCGT,0,2909200
ompRp4,0.16666666666666666,5,5,GCACACTTACAGCGATAGCC,0,2911862
ompRp4,0.16666666666666666,5,5,GATGCCAGTTTCAATCGGGG,0,2928652
ompRp4,0.16666666666666666,5,5,GATACCTGTGCATATGGGGT,0,2936785
ompRp4,0.16666666666666666,5,5,GAGTCCAAGTAGCAGCGCGG,0,2921826
ompRp4,0.16666666666666666,5,5,GAGGTATCGGGTCGCGCATC,0,2913303
ompRp4,0.16666666666666666,5,5,GAGCTAACGTGTACTTTCTT,0,2908163
ompRp4,0.16666666666666666,5,5,GAGCCATTTAGTGGATACAT,0,2926710
ompRp4,0.16666666666666666,5,5,GACTACACTGAATCATGTAT,0,2910104
ompRp4,0.16666666666666666,5,5,GAAGACACTTGATCACAGAG,0,2908646
ompRp4,0.16666666666666666,5,5,CTTCACCATTTGGGAACCAA,0,2927028
ompRp4,0.16666666666666666,5,5,CTGACGCCCCCTGCTAATCT,0,2910395
ompRp4,0.16666666666666666,5,5,CTGACCGGGTTAGATTCGGT,0,2929451
ompRp4,0.16666666666666666,5,5,CTATGTGATAACGTCACAAT,0,2929751
ompRp4,0.16666666666666666,5,5,CTATCGGGTTTGGTATGCTT,0,2928245
ompRp4,0.16666666666666666,5,5,CTAGTCCCGGCTATTACAAT,0,2918328
ompRp4,0.16666666666666666,5,5,CGTAGTAGGTGATCTTCCCA,0,2926649
ompRp4,0.16666666666666666,5,5,CGTAGATCAGCGGGCCTCCA,0,2914296
ompRp4,0.16666666666666666,5,5,CGTACGTGGGTAGGCGGCTT,0,2933518
ompRp4,0.16666666666666666,5,5,CGCGGGTGGTCTGGAACCCA,0,2911413
ompRp4,0.16666666666666666,5,5,CGATCATGCTGGCTGCTTGT,0,2926138
ompRp4,0.16666666666666666,5,5,CGAGACCAGACATTCCCTTA,0,2938074
ompRp4,0.16666666666666666,5,5,CCTACTTCAGTTCTGGCCCA,0,2926872
ompRp4,0.16666666666666666,5,5,CCGTCATAGTCCGTTACAAT,0,2924877
ompRp4,0.16666666666666666,5,5,CCGCGGGCTTGTGGTGCAGG,0,2916726
ompRp4,0.16666666666666666,5,5,CCCCCCAGGCGCACCGACTT,0,2915414
ompRp4,0.16666666666666666,5,5,CCCCAAAGATGGTACAGGTA,0,2915874
ompRp4,0.16666666666666666,5,5,CCCACTGAACCAGATTAGCA,0,2929806
ompRp4,0.16666666666666666,5,5,CAGTAGGGTGTACCAATATC,0,2910235
ompRp4,0.16666666666666666,5,5,CAGGCCAAGGATTCCGGTTG,0,2922340
ompRp4,0.16666666666666666,5,5,CAGCCGCAAACTACATTCCC,0,2933236
ompRp4,0.16666666666666666,5,5,CACCCAGTCGTTGAGTATCA,0,2924350
ompRp4,0.16666666666666666,5,5,CACACTACAGACCCGCGGGA,0,2924252
ompRp4,0.16666666666666666,5,5,CACAATCATGTCCTCTGTAT,0,2931423
ompRp4,0.16666666666666666,5,5,CAATCTTATGGGTAAGCGAA,0,2926478
ompRp4,0.16666666666666666,5,5,CAACGTTGGGGGCAAACATT,0,2918945
ompRp4,0.16666666666666666,5,5,CAAAGTCCGCACTGGGACAT,0,2918251
ompRp4,0.16666666666666666,5,5,CAAAAGGTCGATGATTAGAC,0,2928299
ompRp4,0.16666666666666666,5,5,ATTTAGGATTCTAGATCGAG,0,2915736
ompRp4,0.16666666666666666,5,5,ATTGACGTCAGGGTGACCTT,0,2908148
ompRp4,0.16666666666666666,5,5,ATGTACTGGTTCCCGCTTTA,0,2912302
ompRp4,0.16666666666666666,5,5,ATGCGGGCGGAGAGTTCAAA,0,2929412
ompRp4,0.16666666666666666,5,5,ATCTCCAGGATTGGCTTCGA,0,2922002
ompRp4,0.16666666666666666,5,5,ATCATCCGGCGCCCGCAGCA,0,2911103
ompRp4,0.16666666666666666,5,5,AGGTGGGAGACTCTCCTCAA,0,2916598
ompRp4,0.16666666666666666,5,5,AGCTGTAACCTTTAACTGTA,0,2936512
ompRp4,0.16666666666666666,5,5,AGCAAGACGCAGCGTAATCA,0,2926812
ompRp4,0.16666666666666666,5,5,ACTTGGATAACAGACTCCTG,0,2931535
ompRp4,0.16666666666666666,5,5,ACGTTTGCATTCATGATTGT,0,2919577
ompRp4,0.16666666666666666,5,5,ACGGGCGAGTATAGCGCTCA,0,2935404
ompRp4,0.16666666666666666,5,5,ACCTGCTCTCGGGCTCCCAG,0,2914466
ompRp4,0.16666666666666666,5,5,ACCGTGGGCTGCTACAAAAT,0,2936230
ompRp4,0.16666666666666666,5,5,ACCCCGGCCATCCAGGGGTA,0,2926428
ompRp4,0.16666666666666666,5,5,ACCCCAATAGGGGCAAGACT,0,2911296
ompRp4,0.16666666666666666,5,5,ACCATGCTTGGTAGCGGAAC,0,2918513
ompRp4,0.16666666666666666,5,5,ACCAAATTGCTAGCGCCCTT,0,2923924
ompRp4,0.16666666666666666,5,5,ACATTCCCCGATCGATTGTA,0,2911631
ompRp4,0.16666666666666666,5,5,ACATCCAAATACTTTAGTGA,0,2932467
ompRp4,0.16666666666666666,5,5,AATAACTACGTGGGCTCTAT,0,2918042
ompRp4,0.16666666666666666,5,5,AAGTCGTACCTCTTACCCGC,0,2908400
ompRp4,0.16666666666666666,5,5,AAGAACGAGTAAGGTCCGCA,0,2925056
ompRp4,0.16666666666666666,5,5,AACGCCACTTGAAATACCGA,0,2908711
ompRp4,0.16666666666666666,5,5,AACGATGATTGGGGTCTACA,0,2935679
ompRp4,0.2,4,4,TTTTTTAATTCGCCTACCAT,0,2921514
ompRp4,0.2,4,4,TTTTGGCGCACTTATTCATA,0,2923186
ompRp4,0.2,4,4,TTTTCAACGGGCCTAATTCA,0,2927866
ompRp4,0.2,4,4,TTTCGAGGTTAGGTTCGTGC,0,2922734
ompRp4,0.2,4,4,TTTCACGATTGGTGATGAAG,0,2937955
ompRp4,0.2,4,4,TTCTTCCTTTCCGCCTCTAG,0,2929422
ompRp4,0.2,4,4,TTCTCCGTTAGGTCGGCGCA,0,2929468
ompRp4,0.2,4,4,TTCTCCACACACGGTAGGGT,0,2918831
ompRp4,0.2,4,4,TTCCACCGGAGGGCTCAGAT,0,2926684
ompRp4,0.2,4,4,TTATGCGTTATCGGACCTCA,0,2919952
ompRp4,0.2,4,4,TTAAGCTATGGCTAGCAGAG,0,2909506
ompRp4,0.2,4,4,TTAAAACGGACACAGGATTA,0,2929828
ompRp4,0.2,4,4,TGTTGGGAAGGGTCACAATC,0,2929403
ompRp4,0.2,4,4,TGTTCATGTGAAGGAGGTCC,0,2921795
ompRp4,0.2,4,4,TGTAAATATGTGCGCTAGGG,0,2919894
ompRp4,0.2,4,4,TGGTCAGATAGTGTTTGGCA,0,2922770
ompRp4,0.2,4,4,TGGTAACGGTGATGTACGAG,0,2937592
ompRp4,0.2,4,4,TGGGTCTTATAGAATACGGC,0,2921841
ompRp4,0.2,4,4,TGGGTCGGTGTCCTCCTTAC,0,2916106
ompRp4,0.2,4,4,TGCTTCCTGAAAAGAAACCT,0,2925912
ompRp4,0.2,4,4,TGCTACACCGCCTACAGCCG,0,2935169
ompRp4,0.2,4,4,TGCGATAGTCGGTACTCGTA,0,2910321
ompRp4,0.2,4,4,TGCCGGACTTTAAGTTTCCC,0,2924272
ompRp4,0.2,4,4,TGCACCTTATAAGGCGGAGA,0,2913830
ompRp4,0.2,4,4,TGATACGTTGCAACGTAGTT,0,2909716
ompRp4,0.2,4,4,TGACGGGCTCTCAGTGGTTC,0,2933211
ompRp4,0.2,4,4,TGACCCGTCCGTAGAAACGT,0,2933716
ompRp4,0.2,4,4,TCTTTGAAAGGTAAAGGTAG,0,2924725
ompRp4,0.2,4,4,TCTTGGGGTGGGTGGAGATT,0,2913510
ompRp4,0.2,4,4,TCGTTGGAGCTGGCTATTAC,0,2910537
ompRp4,0.2,4,4,TCGTCGGCCTCGGAAAGTCT,0,2936628
ompRp4,0.2,4,4,TCGGCAGTAGAGAAATGTTA,0,2928881
ompRp4,0.2,4,4,TCGCTCCGTTAATCCGGACT,0,2936166
ompRp4,0.2,4,4,TCCATTATTCTAAGCAAGCT,0,2926276
ompRp4,0.2,4,4,TCCAGATACTCGAACGCTCG,0,2933617
ompRp4,0.2,4,4,TCAGTACAGCAACAGACCAG,0,2919520
ompRp4,0.2,4,4,TATTGGAAGAAGGGGGTCTG,0,2923262
ompRp4,0.2,4,4,TATGTAGATTGGAGGTATTT,0,2919524
ompRp4,0.2,4,4,TAGTTGAGGGGTCTCGTCGA,0,2918922
ompRp4,0.2,4,4,TACGAGAACCAACAGTATTA,0,2924783
ompRp4,0.2,4,4,TACCTAAGAAGGCTCAGAAA,0,2928070
ompRp4,0.2,4,4,TACATGGATCACCTCCAACT,0,2928654
ompRp4,0.2,4,4,TACATATCCGGCAAGTTCGA,0,2925288
ompRp4,0.2,4,4,TAATGAAGTTCATGGACCAA,0,2909153
ompRp4,0.2,4,4,TAAGTTATATGCATGTAGAT,0,2920196
ompRp4,0.2,4,4,TAAGATCGCGGAGTCCTCTT,0,2936761
ompRp4,0.2,4,4,GTTTGGATTCTTTGCTCTAA,0,2922381
ompRp4,0.2,4,4,GTGTAGGTAGAGATGCTACG,0,2919917
ompRp4,0.2,4,4,GTGGCGACATCGCAACAGAT,0,2926802
ompRp4,0.2,4,4,GTCTTGGACATCATGGGGCG,0,2937273
ompRp4,0.2,4,4,GTCGCGTCAGAGCATATGAC,0,2922675
ompRp4,0.2,4,4,GTCGCATGTGGTCTTAGAAT,0,2916958
ompRp4,0.2,4,4,GTCCGCCATACAGCAAGACT,0,2931503
ompRp4,0.2,4,4,GTCATCCCTGTTGTAGCCAC,0,2931982
ompRp4,0.2,4,4,GTAGCGTTAGTTGGTCGTAT,0,2909651
ompRp4,0.2,4,4,GGGACTGATCTTTTGCGATA,0,2934278
ompRp4,0.2,4,4,GGGAACCCATTAGCTGGGCA,0,2931858
ompRp4,0.2,4,4,GGCCATCAGCTACCTGTGAT,0,2919842
ompRp4,0.2,4,4,GGCACTGCATCTATCGTGAC,0,2923346
ompRp4,0.2,4,4,GGAGTCCGTCGCGGGGCTCC,0,2932845
ompRp4,0.2,4,4,GGAGGGGTCTTTTAAACTAC,0,2923068
ompRp4,0.2,4,4,GGAAACTTCGGCCTGCAGCT,0,2923501
ompRp4,0.2,4,4,GCTACACGCAAGGGGACGAT,0,2910316
ompRp4,0.2,4,4,GCGGATTTTTGCAGGTTAGG,0,2923908
ompRp4,0.2,4,4,GCGATAAGGATGTTTTTGTT,0,2934792
ompRp4,0.2,4,4,GCGATAAATTTTCTGGTTTA,0,2916365
ompRp4,0.2,4,4,GCGAGCCAGCTCGTTGTGGA,0,2915504
ompRp4,0.2,4,4,GCATTTGCAGGCTCAAGGTC,0,2912046
ompRp4,0.2,4,4,GATCCGGTAAACTGGTTGTT,0,2929935
ompRp4,0.2,4,4,GATCAGATCGTTAGGTGCTA,0,2916837
ompRp4,0.2,4,4,GAGTGCCTTGGAGCGGTGGA,0,2933584
ompRp4,0.2,4,4,GAGAGTATGAACTCTCGTAG,0,2915732
ompRp4,0.2,4,4,GACTGCCAACTGGGTAGCTA,0,2928243
ompRp4,0.2,4,4,GACCCGCACTGAACGAATCA,0,2929951
ompRp4,0.2,4,4,GACAGGGGCTTAGGAGGACT,0,2930097
ompRp4,0.2,4,4,GAACAAGGGAGAACTAGAGC,0,2908162
ompRp4,0.2,4,4,GAAAGCTATGACACCAGGAG,0,2935999
ompRp4,0.2,4,4,CTTGATTGGTCCACATGGAA,0,2918546
ompRp4,0.2,4,4,CTTAGCTGTACCGAGGTCGC,0,2912167
ompRp4,0.2,4,4,CTTAAAAGATGGGTTTGGGG,0,2938067
ompRp4,0.2,4,4,CTGTAGATACGCAGAGACCT,0,2910618
ompRp4,0.2,4,4,CTGAAGCCCGCTTTTTACTT,0,2924152
ompRp4,0.2,4,4,CTCTTTGGGAACTAGAGAGC,0,2917170
ompRp4,0.2,4,4,CTCTTCCTGGGGCCTTTAGA,0,2935916
ompRp4,0.2,4,4,CTCGGGCTTGGGCTTACAAT,0,2912421
ompRp4,0.2,4,4,CTCGCTACATTCCTAGGTCA,0,2924513
ompRp4,0.2,4,4,CTCCCCACCAGCGTTGGCTT,0,2926343
ompRp4,0.2,4,4,CTCAGCGGATGCCACTGCGC,0,2917441
ompRp4,0.2,4,4,CTCACCAAGGGAGAACTCGG,0,2912502
ompRp4,0.2,4,4,CTATGACTATCTCCCTATCT,0,2936240
ompRp4,0.2,4,4,CTATAATGCCCCCCCACCTA,0,2909670
ompRp4,0.2,4,4,CTACAGTGGCCACTTTTTGC,0,2934311
ompRp4,0.2,4,4,CGTGTGGGAGCCAGTGGCTC,0,2908397
ompRp4,0.2,4,4,CGTGAGTGCTCCGCTCGGTT,0,2926435
ompRp4,0.2,4,4,CGTCTGACAAGCTGAATGCT,0,2907727
ompRp4,0.2,4,4,CGTCGCTGCTAGCTCATAGT,0,2923472
ompRp4,0.2,4,4,CGTATCATTACAACAGTCCT,0,2933919
ompRp4,0.2,4,4,CGGTTAGTATGGATGTCCTG,0,2927584
ompRp4,0.2,4,4,CGGTAATTTCATGGGACCGC,0,2912661
ompRp4,0.2,4,4,CGGGTGGTCCTATTCAAAGG,0,2917159
ompRp4,0.2,4,4,CGGGGTCAGGATCTGATATG,0,2909387
ompRp4,0.2,4,4,CGGATCCTGGTACCCGTCTG,0,2910243
ompRp4,0.2,4,4,CGGAACGCGTTCGTCAATCT,0,2920774
ompRp4,0.2,4,4,CGCTTGGATCAGCATTTTAC,0,2927533
ompRp4,0.2,4,4,CGCGGGGGTGGATGAAGCTG,0,2927837
ompRp4,0.2,4,4,CGCATATGGTGGCTTCCTCA,0,2919331
ompRp4,0.2,4,4,CGCATAACTAGCTGTACTAA,0,2913420
ompRp4,0.2,4,4,CGCACATTCTGTAGCCCCCA,0,2923745
ompRp4,0.2,4,4,CGATATTGAGCACTACAGTT,0,2911241
ompRp4,0.2,4,4,CGAGGACTGACACGCTTCTA,0,2934944
ompRp4,0.2,4,4,CCTTCTTCACGCAATAGACG,0,2916693
ompRp4,0.2,4,4,CCTTACTCCAGTGAAGTAAG,0,2922213
ompRp4,0.2,4,4,CCTGGAACCACACTGCCGCT,0,2927224
ompRp4,0.2,4,4,CCTGACCTCCGGTAGCGTCT,0,2916285
ompRp4,0.2,4,4,CCGTCCTACGAACGCGCTTT,0,2908694
ompRp4,0.2,4,4,CCGTAGTATCCTTGGATCAA,0,2926976
ompRp4,0.2,4,4,CCGGGTCGAATTTAGTATAG,0,2918923
ompRp4,0.2,4,4,CCGCTCTCTGGCTGTCAGTC,0,2922864
ompRp4,0.2,4,4,CCGCACGTTAATGGACGTAC,0,2930392
ompRp4,0.2,4,4,CCGACGTCAAAATTCCGATT,0,2932053
ompRp4,0.2,4,4,CCATTGGTTCACATTAAGGT,0,2911804
ompRp4,0.2,4,4,CCAGGACATCCAAGATCGGA,0,2913700
ompRp4,0.2,4,4,CCAACGCAGTCGGTGTCTGT,0,2914034
ompRp4,0.2,4,4,CATGGAGAACGTTATCTAAT,0,2926043
ompRp4,0.2,4,4,CATGCCATAGACGCATCTTT,0,2923888
ompRp4,0.2,4,4,CATCCTACAATCCGCTCGAG,0,2917309
ompRp4,0.2,4,4,CAGTGCTCATGCCTCCGACG,0,2932691
ompRp4,0.2,4,4,CAGGCCAATACTACCGGGTC,0,2909227
ompRp4,0.2,4,4,CAGGACGCGCCCGATGACTC,0,2910919
ompRp4,0.2,4,4,CAGCTTTGTTATGCCACTCA,0,2916867
ompRp4,0.2,4,4,CACTCATATTTACCAGCGGT,0,2927068
ompRp4,0.2,4,4,CACCGGTATGATCGACGTGA,0,2908412
ompRp4,0.2,4,4,CACCGATTGACGCCGCTTGT,0,2936257
ompRp4,0.2,4,4,CAACATCCATTTGTCGTTAT,0,2935107
ompRp4,0.2,4,4,ATTTCATGATACGCCTTGCT,0,2932807
ompRp4,0.2,4,4,ATTGGTCTTGGTCACGTAAA,0,2919905
ompRp4,0.2,4,4,ATTCACATTTGGGTTTAGAT,0,2934947
ompRp4,0.2,4,4,ATGATCAAATATACTCGCTA,0,2931934
ompRp4,0.2,4,4,ATGAAGAGAGGGTACGGTAG,0,2913984
ompRp4,0.2,4,4,AGTTGGGATTCAACGGCCGG,0,2915485
ompRp4,0.2,4,4,AGTGTAGGCTTTCCCTTCTG,0,2914959
ompRp4,0.2,4,4,AGTGCTACTACGTCGTGGCT,0,2930362
ompRp4,0.2,4,4,AGTGCCCGGAGATCTTACGA,0,2911389
ompRp4,0.2,4,4,AGTCGTCTCGCGCAATCGCA,0,2933662
ompRp4,0.2,4,4,AGGCTTAAACTAATGCTCCT,0,2923672
ompRp4,0.2,4,4,AGGATGGGTGAATGTAACTG,0,2930542
ompRp4,0.2,4,4,AGGAGAAACAGTGCGACCTC,0,2921515
ompRp4,0.2,4,4,AGCGTCGTCTACAAACTAAG,0,2916806
ompRp4,0.2,4,4,AGCGCCCATTCAGGAATTAA,0,2936839
ompRp4,0.2,4,4,AGCCCGACTAACTGTTCACT,0,2912307
ompRp4,0.2,4,4,AGATCGCTATGACTTAGGTA,0,2932484
ompRp4,0.2,4,4,AGAGTAAATTATCATGGCGG,0,2909478
ompRp4,0.2,4,4,AGAACCAGTTTTTCCGATGC,0,2920350
ompRp4,0.2,4,4,ACTTAGGTTGTCACGCCCAA,0,2920416
ompRp4,0.2,4,4,ACTGGGAATTCGTATGTAGA,0,2913866
ompRp4,0.2,4,4,ACTGGCTAGCGCCCTCAGAA,0,2917522
ompRp4,0.2,4,4,ACTGCAAAATAATATCGGTG,0,2909399
ompRp4,0.2,4,4,ACGGCTCCGTGAAATGTCTG,0,2932210
ompRp4,0.2,4,4,ACGGAAAAGCACAAAATGAT,0,2921707
ompRp4,0.2,4,4,ACGCCGATGTTATGAGAGCC,0,2920750
ompRp4,0.2,4,4,ACGACAATGCCAGTTTGGCT,0,2938113
ompRp4,0.2,4,4,ACCATGCGAGCAGGCCAGTT,0,2936404
ompRp4,0.2,4,4,ACACAGATCGTGGAGCGGGT,0,2907843
ompRp4,0.2,4,4,AATTGAGTCTCTCAGTCGCT,0,2915965
ompRp4,0.2,4,4,AATCGCGGCAGTACAGCCTA,0,2915973
ompRp4,0.2,4,4,AATCAGACACGTCATCGCCA,0,2925648
ompRp4,0.2,4,4,AAGTTGTCGGTCATTGCCGC,0,2909071
ompRp4,0.2,4,4,AAGTGTCACCCGTCATAACA,0,2909869
ompRp4,0.2,4,4,AAGCGGTGATGATGAGATAT,0,2933444
ompRp4,0.2,4,4,AAGCGAGGCAGAAAAGGACA,0,2913682
ompRp4,0.2,4,4,AAGATCCAGTGGTGCTCATT,0,2907741
ompRp4,0.2,4,4,AACTGTAACCGACGCTTTCC,0,2916563
ompRp4,0.2,4,4,AACAGACATAAACCTCGGCA,0,2925490
ompRp4,0.2,4,4,AAATGTCTGTTTCCTGGGGC,0,2911759
ompRp4,0.25,3,3,TTTTATGCTATCTTGAGACT,0,2921136
ompRp4,0.25,3,3,TTTCCACCGGAAATGGTCCT,0,2932201
ompRp4,0.25,3,3,TTTACGCAAATCTGTTGCAA,0,2916181
ompRp4,0.25,3,3,TTGTAGGGTCAATGTCGGTG,0,2919104
ompRp4,0.25,3,3,TTGGTAAGAGCGTTTGAGCA,0,2911929
ompRp4,0.25,3,3,TTGGCCTGGATGCAAACCGA,0,2922617
ompRp4,0.25,3,3,TTGGATCATTGTGGCGTCAC,0,2937623
ompRp4,0.25,3,3,TTGGATAGCGTGCTCTTTAC,0,2929669
ompRp4,0.25,3,3,TTGGAATCGCTTGACGCCCC,0,2909275
ompRp4,0.25,3,3,TTGAGATCACTCATTTCGAT,0,2936659
ompRp4,0.25,3,3,TTGAAGCCGCGTGTCGCCCA,0,2930282
ompRp4,0.25,3,3,TTCTAAGGTACGCAAATCAT,0,2930315
ompRp4,0.25,3,3,TTATAAATTGCTAATAGGCA,0,2912404
ompRp4,0.25,3,3,TTAGGATCAGGTGGTCCGGC,0,2929553
ompRp4,0.25,3,3,TGTGATTGAGACTACCCGGA,0,2915344
ompRp4,0.25,3,3,TGTAGAAAAATCGAACCGGT,0,2921839
ompRp4,0.25,3,3,TGTAAGAAGGCGCATTCATA,0,2911207
ompRp4,0.25,3,3,TGTAAATGAGGATACCCGGG,0,2929184
ompRp4,0.25,3,3,TGGAGACTCTCGCTAAAGGT,0,2919938
ompRp4,0.25,3,3,TGGAGACGGGCTACGTCATG,0,2919315
ompRp4,0.25,3,3,TGGAACACACTATGTAACGC,0,2929042
ompRp4,0.25,3,3,TGCTCTGTGGGCATCCGTAA,0,2937861
ompRp4,0.25,3,3,TGCTACTGAACTTATTGCCA,0,2921265
ompRp4,0.25,3,3,TGCCGGAATTGCACGGGTTT,0,2926580
ompRp4,0.25,3,3,TGCCAATTGCGAAGCGTGCT,0,2909244
ompRp4,0.25,3,3,TGCACCGATGTGCGCCGTAC,0,2908403
ompRp4,0.25,3,3,TGATCCCCGTTACTTGCCCT,0,2938277
ompRp4,0.25,3,3,TGAGGTGCTGTTATTGTTAA,0,2916327
ompRp4,0.25,3,3,TCTTGTGCAATTATCACTCT,0,2934076
ompRp4,0.25,3,3,TCTCAGTTCTTCGGCTAAAG,0,2922729
ompRp4,0.25,3,3,TCTAGCCAAGAGTCGAAGGT,0,2911257
ompRp4,0.25,3,3,TCGCCGTAATTCCTTGAATA,0,2910933
ompRp4,0.25,3,3,TCGCCGTAAATCATAGGGAG,0,2915297
ompRp4,0.25,3,3,TCGAGGTACATAGCAGTTAT,0,2920656
ompRp4,0.25,3,3,TCCCTAGGGCATGTCCTCGT,0,2931568
ompRp4,0.25,3,3,TCCCGCGACCTTTTAATGCT,0,2932178
ompRp4,0.25,3,3,TCCACTCGCCTCACGGCCGG,0,2922925
ompRp4,0.25,3,3,TCCAAATGTTGTGACCCCGA,0,2933939
ompRp4,0.25,3,3,TCATGTATGATATACATTGT,0,2925761
ompRp4,0.25,3,3,TCAGTAAACCCTTTAAAGGG,0,2918467
ompRp4,0.25,3,3,TCAGGAGTAGCCAGGATGTT,0,2930276
ompRp4,0.25,3,3,TCAGGAGCGTGTTCAAGAAC,0,2929470
ompRp4,0.25,3,3,TCAGGACAGTAATTCTACTC,0,2914470
ompRp4,0.25,3,3,TCAAACCAGACTATTGTGTA,0,2920006
ompRp4,0.25,3,3,TATGGCCCGTCGAGAGGCGC,0,2918527
ompRp4,0.25,3,3,TATCTGGCACCTGAAGTAAC,0,2917715
ompRp4,0.25,3,3,TAGGGTAAAAATCGTTAGGT,0,2911316
ompRp4,0.25,3,3,TAGCTTATTAAGGCGTAGAG,0,2937536
ompRp4,0.25,3,3,TACGCTCTTAGCTTTCATGA,0,2931092
ompRp4,0.25,3,3,TACCGCTTGATGCCTGTACT,0,2913909
ompRp4,0.25,3,3,TACCCTAGCCGTCATTGAGT,0,2934772
ompRp4,0.25,3,3,TACACCGAGTGCCATTCACC,0,2927038
ompRp4,0.25,3,3,TAAGAATACCAGGCTGCTCA,0,2913419
ompRp4,0.25,3,3,TAACTATACCCTGCGGTCAC,0,2910328
ompRp4,0.25,3,3,TAACCAGACTCTTACAGAAT,0,2914755
ompRp4,0.25,3,3,TAAAATGGTGGTCGGTGGGT,0,2914793
ompRp4,0.25,3,3,TAAAACACTCTTCCTTAGAG,0,2928781
ompRp4,0.25,3,3,GTTGTCTGGTCTGGTCCCAA,0,2927982
ompRp4,0.25,3,3,GTTGCTGGGTGTGGTCTATT,0,2912229
ompRp4,0.25,3,3,GTTGAGGGGGGTCTCCTTTA,0,2908056
ompRp4,0.25,3,3,GTTGACCAATTACGGAGGGT,0,2928385
ompRp4,0.25,3,3,GTTCGTTCACGACAGTCCCG,0,2913662
ompRp4,0.25,3,3,GTTAGTTTTCGCCCGTAGAT,0,2924040
ompRp4,0.25,3,3,GTTACACGCAACGAGGTAAT,0,2910209
ompRp4,0.25,3,3,GTGTTGGGCGCTGAGGCACT,0,2912099
ompRp4,0.25,3,3,GTGGATTGAAGCACGCCTAT,0,2937347
ompRp4,0.25,3,3,GTGCTTAAATTCCGGAGCCA,0,2919162
ompRp4,0.25,3,3,GTGCTGCGAGCCTGGTTAGC,0,2908169
ompRp4,0.25,3,3,GTGAGGCAGCCAATCAGAGG,0,2925951
ompRp4,0.25,3,3,GTGAAGGTATGAGTTAAGTA,0,2937367
ompRp4,0.25,3,3,GTCTTGTACAACGGAGCCAG,0,2936546
ompRp4,0.25,3,3,GTCCGTACTTTAGTGATGGA,0,2936967
ompRp4,0.25,3,3,GTCATTCAATTTTAGAAGTA,0,2923324
ompRp4,0.25,3,3,GTCACCTTACGCGCCTCTTT,0,2912029
ompRp4,0.25,3,3,GTATGCCGGTAGCGACTTGT,0,2934780
ompRp4,0.25,3,3,GTATAGCTTTAACCGCTCCA,0,2937530
ompRp4,0.25,3,3,GTAGAGATCAATGTCACTTT,0,2915397
ompRp4,0.25,3,3,GTAATTACTGGTCTAATATG,0,2907707
ompRp4,0.25,3,3,GGTTTGACAACCCGCCTTGA,0,2928560
ompRp4,0.25,3,3,GGTTAAACCTCTCACCATCT,0,2926952
ompRp4,0.25,3,3,GGTGATTTGACGTTGGGAAC,0,2928464
ompRp4,0.25,3,3,GGTATTGTGGAACCTGAGTG,0,2920434
ompRp4,0.25,3,3,GGTAGCTAGCCTTCACGGCG,0,2932732
ompRp4,0.25,3,3,GGGGTTTGTAGAAAATCATC,0,2918656
ompRp4,0.25,3,3,GGGGTTCGCACCGGGAAGGT,0,2917135
ompRp4,0.25,3,3,GGGCTTCAGCGAAATATTGC,0,2916306
ompRp4,0.25,3,3,GGGCTGACCTATCCCCTTCG,0,2922757
ompRp4,0.25,3,3,GGGACTGTTTGGTCAGTTAG,0,2910461
ompRp4,0.25,3,3,GGGAACAACTGGTAGCGGAT,0,2922114
ompRp4,0.25,3,3,GGGAAACGTTACGTGTCGCC,0,2927402
ompRp4,0.25,3,3,GGCCTCACGACAGTGGAATT,0,2937335
ompRp4,0.25,3,3,GGCAACGGAACTGTTGAGTT,0,2919665
ompRp4,0.25,3,3,GGATGGGCCATTCAAACGGT,0,2938002
ompRp4,0.25,3,3,GGATCGGACGGCACGATGGG,0,2920208
ompRp4,0.25,3,3,GGATACAGCTAAGGATGTCC,0,2910408
ompRp4,0.25,3,3,GGAGGGACGTTAGATTATCT,0,2912544
ompRp4,0.25,3,3,GGAGGAAAGGACGATCCTTG,0,2932941
ompRp4,0.25,3,3,GGAGCTCGCGGATCGGTCTT,0,2913563
ompRp4,0.25,3,3,GGACCCCAGATCTGTTTATC,0,2931981
ompRp4,0.25,3,3,GGAACTCCGGACAATCTATA,0,2935391
ompRp4,0.25,3,3,GCTTCCAGACGGGGGGTGAT,0,2909364
ompRp4,0.25,3,3,GCTTAAGCACGAGCGTTCAT,0,2913033
ompRp4,0.25,3,3,GCTGCCACTTGACCGTGTGC,0,2925450
ompRp4,0.25,3,3,GCTCCCACTGCTAAGGTTCG,0,2908248
ompRp4,0.25,3,3,GCTAGAATTATGATTCGATA,0,2923211
ompRp4,0.25,3,3,GCGTTTGGCTACGCGTTCAT,0,2914398
ompRp4,0.25,3,3,GCGCGTTGGGGCGAGTGCGT,0,2918627
ompRp4,0.25,3,3,GCGCCCCTGGTCTTAATGGT,0,2914851
ompRp4,0.25,3,3,GCCTTGGTTTACGTTTAGCC,0,2934527
ompRp4,0.25,3,3,GCCGAGACATCAGGCTGTTG,0,2933595
ompRp4,0.25,3,3,GCCCGTCGGGTAAGAGTAGT,0,2932756
ompRp4,0.25,3,3,GCCCCAATATGTGTTCCTCG,0,2929539
ompRp4,0.25,3,3,GCAGGATTCTAATACCCATA,0,2922234
ompRp4,0.25,3,3,GCAGCAGTGGTGACCACCAG,0,2920900
ompRp4,0.25,3,3,GCACCACATCCGTAGAGTGA,0,2914858
ompRp4,0.25,3,3,GCAATGTGCTTTTTGTTGAG,0,2909181
ompRp4,0.25,3,3,GATTGCGAAACAGTTCCTAA,0,2920209
ompRp4,0.25,3,3,GATAATCGAGTGTCAGGCAA,0,2927831
ompRp4,0.25,3,3,GATAAGACGAATTAGTACCG,0,2918548
ompRp4,0.25,3,3,GAGCTATACACTCGCAGTCC,0,2925008
ompRp4,0.25,3,3,GAGACTCATAGAGCTTGGAT,0,2914975
ompRp4,0.25,3,3,GACTCCTATTAAAAGTCGAA,0,2920827
ompRp4,0.25,3,3,GACATATCGCTGTATCCGGA,0,2911936
ompRp4,0.25,3,3,GACAAGCAAGTAGACGATTG,0,2934431
ompRp4,0.25,3,3,CTTGCAAACAGCCGCTAGAT,0,2913627
ompRp4,0.25,3,3,CTTCGTGAGAAGTTTTAAAA,0,2911567
ompRp4,0.25,3,3,CTTATCCATAGGGATTTCAT,0,2909337
ompRp4,0.25,3,3,CTTAGGTAACAGTGTTTCAG,0,2919586
ompRp4,0.25,3,3,CTTACTAGGGGTGGGTAAAA,0,2910121
ompRp4,0.25,3,3,CTTAATTTTATCTAATATAG,0,2929813
ompRp4,0.25,3,3,CTGTTTTTCAAGCCCGGTCT,0,2921223
ompRp4,0.25,3,3,CTGTCTATGGCAACGTCAAC,0,2927190
ompRp4,0.25,3,3,CTGGCCGTATAGCGCAGAAA,0,2926893
ompRp4,0.25,3,3,CTCTGCGAAGTCACCTCACG,0,2936326
ompRp4,0.25,3,3,CTCTCGACTTTATGACCGGG,0,2938129
ompRp4,0.25,3,3,CTCCCAGGCAACCGAGTCCT,0,2923558
ompRp4,0.25,3,3,CTCATCCCGTGGGCGTATAT,0,2923673
ompRp4,0.25,3,3,CTCACTGGTCCACGGCGACA,0,2922315
ompRp4,0.25,3,3,CTAGCTTCGGCCGTGGATTA,0,2937951
ompRp4,0.25,3,3,CTAAGATGAGGACTCCCGCT,0,2928604
ompRp4,0.25,3,3,CGTTCTCTTCTGAACCACGA,0,2932473
ompRp4,0.25,3,3,CGTTATAATGGTGGTCACTT,0,2919642
ompRp4,0.25,3,3,CGTGTTCATCGGTGGTTTGA,0,2929648
ompRp4,0.25,3,3,CGTGCGGTGCTAGAATTCGC,0,2931105
ompRp4,0.25,3,3,CGTACAACTTTTAACCCTGC,0,2922905
ompRp4,0.25,3,3,CGGGTTTGTTATTGCAGTTA,0,2926491
ompRp4,0.25,3,3,CGGCTGGTACGGGTTGGTAG,0,2931187
ompRp4,0.25,3,3,CGGCATCGGAGCAGCTCATA,0,2920449
ompRp4,0.25,3,3,CGGCACCCATCGTTGTGTTT,0,2915672
ompRp4,0.25,3,3,CGGACGGGGGAGGATGTTCG,0,2934053
ompRp4,0.25,3,3,CGGACCACGGTTTCTTGCTT,0,2910443
ompRp4,0.25,3,3,CGGAACGTATAGTCGCGCAT,0,2926196
ompRp4,0.25,3,3,CGCGATCATGTACCCTGGAG,0,2913533
ompRp4,0.25,3,3,CGCCCTCTGGGTGTATGTCT,0,2924597
ompRp4,0.25,3,3,CGCACCGGGCTTCGCGTGCA,0,2930677
ompRp4,0.25,3,3,CGACTGGGCGCATTGGGAAA,0,2910017
ompRp4,0.25,3,3,CGAATTGTTCATTTTCGAGG,0,2913156
ompRp4,0.25,3,3,CCTTTTGGCACATCTTCGGA,0,2924579
ompRp4,0.25,3,3,CCTTAGATAACTCTCAAGGG,0,2935661
ompRp4,0.25,3,3,CCTGCACTGTCGTCATTATC,0,2925964
ompRp4,0.25,3,3,CCTGAAGAACCCGTCTAGAA,0,2917024
ompRp4,0.25,3,3,CCTCAAGCCAGGACGACGGT,0,2922115
ompRp4,0.25,3,3,CCTACGCGGGAGCGACCATT,0,2926736
ompRp4,0.25,3,3,CCGTGTTAATTTGTAATATT,0,2914512
ompRp4,0.25,3,3,CCGTAGGGGTTGAAAAGCTT,0,2923187
ompRp4,0.25,3,3,CCGGGGTATCGTGCTCGGGG,0,2913915
ompRp4,0.25,3,3,CCGGAAATCGCGCTCGGAAT,0,2930296
ompRp4,0.25,3,3,CCGCTATTGCCCAAATGTCA,0,2908045
ompRp4,0.25,3,3,CCGCACACGCCCTTTGTCGG,0,2937411
ompRp4,0.25,3,3,CCGAGATTACCGCGCGGCAT,0,2918006
ompRp4,0.25,3,3,CCCGCGTACTTAAAAGCGCT,0,2927284
ompRp4,0.25,3,3,CCATTGCGTGCGATTGAATA,0,2914775
ompRp4,0.25,3,3,CCATGAGTGACGACCTGGTC,0,2929565
ompRp4,0.25,3,3,CATTCTATTCTAGTTCCGAC,0,2928114
ompRp4,0.25,3,3,CATGTGGTGGGTGACAATCT,0,2916950
ompRp4,0.25,3,3,CATGCCCCTCGAGGGCTGGA,0,2909913
ompRp4,0.25,3,3,CATATTAGCTCCCACTGATG,0,2910347
ompRp4,0.25,3,3,CATATACCTCGTGGTCCAGG,0,2910341
ompRp4,0.25,3,3,CAGTTAACACGTAGTGTGGC,0,2922490
ompRp4,0.25,3,3,CAGTCTTAGGCTTCTGATGC,0,2921188
ompRp4,0.25,3,3,CAGTCATATGTTAGCAAGAT,0,2924964
ompRp4,0.25,3,3,CAGGGATCGGATGTTCTGGT,0,2926133
ompRp4,0.25,3,3,CAGGAGCATAACCACCCTGA,0,2911863
ompRp4,0.25,3,3,CAGCTGTGTGCTTCCCTACC,0,2920635
ompRp4,0.25,3,3,CACTCGTCTTTTCGGGCACA,0,2929135
ompRp4,0.25,3,3,CACTCGTAGATACGCAGTTC,0,2934110
ompRp4,0.25,3,3,CACTAGTCAGACAGGTCCAT,0,2916249
ompRp4,0.25,3,3,CACTAAAGTAAAGACGGAGT,0,2938283
ompRp4,0.25,3,3,CACGCTTAACAGGACACGGA,0,2913664
ompRp4,0.25,3,3,CACCGTGAGCAAGGCACATG,0,2934828
ompRp4,0.25,3,3,CACCAATGATATGACTCGAC,0,2917194
ompRp4,0.25,3,3,CAATTTCGAGTGACTTGGGT,0,2918000
ompRp4,0.25,3,3,CAATGACGCAGCGATTAACT,0,2908604
ompRp4,0.25,3,3,CAACCTAGCACCTCAAGATT,0,2932565
ompRp4,0.25,3,3,CAAATTCGTGCCAAAGCAAC,0,2912511
ompRp4,0.25,3,3,CAAAGGTCACATTCGTTGGA,0,2922553
ompRp4,0.25,3,3,CAAACTCTAGTTGCACTTTG,0,2927241
ompRp4,0.25,3,3,CAAAACAAGTCCTTAAGGAA,0,2936712
ompRp4,0.25,3,3,CAAAAAATTTAGCGTACTAT,0,2931186
ompRp4,0.25,3,3,ATTGTCGAATATTAACAGAC,0,2913246
ompRp4,0.25,3,3,ATTGAGAGACGTTAGAAGCA,0,2919058
ompRp4,0.25,3,3,ATTGACTTCCTAGGGATGGA,0,2907722
ompRp4,0.25,3,3,ATTCGGAATCTTGAACAGGC,0,2917354
ompRp4,0.25,3,3,ATTCCTCAATGAGGGCTGTT,0,2909625
ompRp4,0.25,3,3,ATTCAGCCGATACGGACAGA,0,2908252
ompRp4,0.25,3,3,ATTATAACAATCCATGAGTA,0,2924787
ompRp4,0.25,3,3,ATTACCATTAATAGAAGGAT,0,2931390
ompRp4,0.25,3,3,ATTAAACGGTTCTGAGTCAC,0,2931791
ompRp4,0.25,3,3,ATGTGCTCAACTTCGGCCAA,0,2912759
ompRp4,0.25,3,3,ATGGTGGAGGGAAGAGGCGT,0,2925244
ompRp4,0.25,3,3,ATGCCCATTTCGGTCTTGAA,0,2915416
ompRp4,0.25,3,3,ATCTTAATTTCGAGGCGCGC,0,2930397
ompRp4,0.25,3,3,ATCTATGTCCAGTGCGCAGG,0,2912736
ompRp4,0.25,3,3,ATCGTATCTCCGGGTACCTT,0,2930318
ompRp4,0.25,3,3,ATCCGAACCGCCCAGTAGGG,0,2920697
ompRp4,0.25,3,3,ATCCCTATAGCTAAAAGTGT,0,2926296
ompRp4,0.25,3,3,ATCAAAAACGTATGCTTCCG,0,2928038
ompRp4,0.25,3,3,ATATCTCTTTAAGGTCCGTC,0,2908068
ompRp4,0.25,3,3,ATATCTCCCACGGCAGATAG,0,2925860
ompRp4,0.25,3,3,ATATATGGGAGGTCGGGGCA,0,2936167
ompRp4,0.25,3,3,ATAGTCTTCTCATAATTCAT,0,2921224
ompRp4,0.25,3,3,ATAGTAAATAGCTCACCTAT,0,2909949
ompRp4,0.25,3,3,ATAGGGACATTCGATGCCGT,0,2931326
ompRp4,0.25,3,3,ATAGAGGGAAACTATAGGCG,0,2911038
ompRp4,0.25,3,3,ATAAGTTATCTGGCTCCACG,0,2920550
ompRp4,0.25,3,3,AGTTGTATATGGAATTTCGT,0,2908933
ompRp4,0.25,3,3,AGTTGAGTTAGTAAGATAGG,0,2908342
ompRp4,0.25,3,3,AGTTCAAGTCCGGTGCATAA,0,2922241
ompRp4,0.25,3,3,AGTTCAACCCCGTATCAATT,0,2912286
ompRp4,0.25,3,3,AGTGTGGAAGACGCAGTTAA,0,2916924
ompRp4,0.25,3,3,AGTGCCAGGGTCCCATACCA,0,2934915
ompRp4,0.25,3,3,AGTCGGGTTCTTTCGGGCGC,0,2914681
ompRp4,0.25,3,3,AGTCACCACGACGCTTCATC,0,2933241
ompRp4,0.25,3,3,AGTATATGGGATTCGACCAA,0,2910024
ompRp4,0.25,3,3,AGGCGGGACGACCCTCGTTC,0,2909914
ompRp4,0.25,3,3,AGCTTTACGTCAACCGTAAT,0,2937004
ompRp4,0.25,3,3,AGCCTGAGACACCCGCCTTT,0,2919950
ompRp4,0.25,3,3,AGCCGTTTCTTCGTCACACA,0,2936647
ompRp4,0.25,3,3,AGCCCTTATGGTTCCTTTTG,0,2922726
ompRp4,0.25,3,3,AGATGTGTGAACGGCACGTC,0,2935971
ompRp4,0.25,3,3,AGATGAAGAACACTGCAGAC,0,2909837
ompRp4,0.25,3,3,AGATATTGTATGTGTGGCAA,0,2932452
ompRp4,0.25,3,3,ACTGGTTTAAACATCCCGCG,0,2913376
ompRp4,0.25,3,3,ACTACTCTTGGGTAGCCTTT,0,2914766
ompRp4,0.25,3,3,ACTACCGACTTGTTGGGATC,0,2938062
ompRp4,0.25,3,3,ACGGCTAGTGACTTTCCTTA,0,2924692
ompRp4,0.25,3,3,ACGATCGGGGTTCAAGTAGA,0,2920512
ompRp4,0.25,3,3,ACGAGTGCGTCTTGTAGTTT,0,2932205
ompRp4,0.25,3,3,ACGAATGCTAGATGTAACTA,0,2915785
ompRp4,0.25,3,3,ACCGCGAAAAGGAGGGACCT,0,2925411
ompRp4,0.25,3,3,ACCCTTTTGGACAAAGGACC,0,2911669
ompRp4,0.25,3,3,ACCATTATACTGGCCTCGTG,0,2920725
ompRp4,0.25,3,3,ACATACAACTCCCCGTCGAA,0,2919646
ompRp4,0.25,3,3,ACACGCACGGTCATCTTCGC,0,2908666
ompRp4,0.25,3,3,ACAAGGAAGGGTTGGGACTC,0,2910019
ompRp4,0.25,3,3,ACAAGAGGCAAGCATGCAAT,0,2915919
ompRp4,0.25,3,3,AATTTACCTAATAGCGATAG,0,2915969
ompRp4,0.25,3,3,AATTATTGTAAGCACAGAAT,0,2928167
ompRp4,0.25,3,3,AATGGGCACAAGAGGTAGTG,0,2932825
ompRp4,0.25,3,3,AATGGCGCAAGACATCGTTT,0,2915619
ompRp4,0.25,3,3,AATCTACTCGCATTCCGTGA,0,2925855
ompRp4,0.25,3,3,AAGGTTCTGAGTACTATCAC,0,2911698
ompRp4,0.25,3,3,AAGGCCTCGGAGGATGAGGC,0,2924077
ompRp4,0.25,3,3,AAGGAATAATAGGCGCCTAC,0,2913736
ompRp4,0.25,3,3,AAGCTTTGGACCATAGAAAG,0,2907965
ompRp4,0.25,3,3,AAGACATTCGCGGATTGTCA,0,2918744
ompRp4,0.25,3,3,AACTGGCTAGAGACAAAAAG,0,2925426
ompRp4,0.25,3,3,AACTCTACAGCATTACTATT,0,2922838
ompRp4,0.25,3,3,AACTACAGGGGCCGTGCCGC,0,2936939
ompRp4,0.25,3,3,AACCGGGTGCTGAGCTTACT,0,2916540
ompRp4,0.25,3,3,AACCGGCTAACTATTAAGAC,0,2919724
ompRp4,0.25,3,3,AACAATGACTAGATGGATAC,0,2931283
ompRp4,0.25,3,3,AAACTGTCCAGCTCCCGAAC,0,2909613
ompRp4,0.25,3,3,AAAACCGGGTACCGGACAAT,0,2911245
ompRp4,0.25,3,3,AAAAAGGTTGTTCTTTAGAC,0,2913241
ompRp4,0.25,3,3,AAAAAGCAGGGACCAGAGAA,0,2920871
ompRp4,0.25,3,3,AAAAAACCAAGTAGTGTCGT,0,2935410
ompRp4,0.3333333333333333,2,2,TTTTAGCCTGCCCCTGGGGT,0,2924946
ompRp4,0.3333333333333333,2,2,TTTGGCACACCAAGGTCTTT,0,2926524
ompRp4,0.3333333333333333,2,2,TTTGGAGCATAGTTGAGTTG,0,2920695
ompRp4,0.3333333333333333,2,2,TTTCGGACCGTAGGGGCACG,0,2922895
ompRp4,0.3333333333333333,2,2,TTTAGTGCCAAATTCAAGAC,0,2920929
ompRp4,0.3333333333333333,2,2,TTTAGCGCAACCTAGTCTGT,0,2916430
ompRp4,0.3333333333333333,2,2,TTTAAAGTGTATGAGCTCTT,0,2934628
ompRp4,0.3333333333333333,2,2,TTGTCGTCAGTCTCTTTGAT,0,2911988
ompRp4,0.3333333333333333,2,2,TTGTATGGCAACCTCTGTAT,0,2928421
ompRp4,0.3333333333333333,2,2,TTGGCCATCAATGGTGCATG,0,2915074
ompRp4,0.3333333333333333,2,2,TTGGACGGGACTCATATGCA,0,2929229
ompRp4,0.3333333333333333,2,2,TTGATTAGACGCCATGGAGG,0,2934158
ompRp4,0.3333333333333333,2,2,TTCTGCCTCACCATAGCAAG,0,2909948
ompRp4,0.3333333333333333,2,2,TTCTGCACATTGCAGCATAT,0,2914612
ompRp4,0.3333333333333333,2,2,TTCTCTGTTAGCGAGCTCTA,0,2909617
ompRp4,0.3333333333333333,2,2,TTCTCTGGACCAACCCAACA,0,2915417
ompRp4,0.3333333333333333,2,2,TTCGGGCCGTACCACAATAG,0,2910198
ompRp4,0.3333333333333333,2,2,TTCGCCACTCAGGGACTTAA,0,2912465
ompRp4,0.3333333333333333,2,2,TTCCTTGCGGTGACGTGGGA,0,2916643
ompRp4,0.3333333333333333,2,2,TTCCCGAAAACAGCCAACGC,0,2927921
ompRp4,0.3333333333333333,2,2,TTCAGTTATTCTCCTGGCGA,0,2911010
ompRp4,0.3333333333333333,2,2,TTCACGGTACAAGGTATAAT,0,2930662
ompRp4,0.3333333333333333,2,2,TTCAAACCTATATCGCATAT,0,2926833
ompRp4,0.3333333333333333,2,2,TTCAAACAGCACTTGAGCAA,0,2909504
ompRp4,0.3333333333333333,2,2,TTAGTAAGGGACAATAGTAT,0,2928141
ompRp4,0.3333333333333333,2,2,TTAGCAATTGGCTATTCAAA,0,2910222
ompRp4,0.3333333333333333,2,2,TTAGCAAACCGTGGTCACCC,0,2916190
ompRp4,0.3333333333333333,2,2,TTACGTCTAAGGATCTCAGT,0,2917366
ompRp4,0.3333333333333333,2,2,TTACGCCAACTCAAGGTTAA,0,2912638
ompRp4,0.3333333333333333,2,2,TTACCTCGAACTCTTCTAGG,0,2932462
ompRp4,0.3333333333333333,2,2,TTACAAAGGTCCGTTCCAGT,0,2915218
ompRp4,0.3333333333333333,2,2,TTACAAAGATACGAGGCCAC,0,2929518
ompRp4,0.3333333333333333,2,2,TTAATGTTCGGCTAGGACTC,0,2935667
ompRp4,0.3333333333333333,2,2,TGTTATAGAACCCACGTCAC,0,2918087
ompRp4,0.3333333333333333,2,2,TGTGTGAAGGAATTGACCCA,0,2935130
ompRp4,0.3333333333333333,2,2,TGTGGACTGCCTTGGAGCGA,0,2909758
ompRp4,0.3333333333333333,2,2,TGTGCCAAATCACGATCATG,0,2920548
ompRp4,0.3333333333333333,2,2,TGTGATATACCAGTGTTGAA,0,2932812
ompRp4,0.3333333333333333,2,2,TGGTTACGGTGGGCAGTTGC,0,2915697
ompRp4,0.3333333333333333,2,2,TGGTGAACGAGGCGCTTATT,0,2925934
ompRp4,0.3333333333333333,2,2,TGGGGTCTAGTTCGGTGCTA,0,2925980
ompRp4,0.3333333333333333,2,2,TGGGGGCAAAGGTGACCGCG,0,2933728
ompRp4,0.3333333333333333,2,2,TGGGGGAGGTGAAAGAGGAC,0,2913879
ompRp4,0.3333333333333333,2,2,TGGGGGAGAAATCCTAACAT,0,2932875
ompRp4,0.3333333333333333,2,2,TGGGGAGTATGTTCTGGGCA,0,2923302
ompRp4,0.3333333333333333,2,2,TGGCGTACTAACAATTGTAA,0,2937221
ompRp4,0.3333333333333333,2,2,TGGATACAATTCTATACCTT,0,2934674
ompRp4,0.3333333333333333,2,2,TGGAGTGCCGTCAACAAGCG,0,2921645
ompRp4,0.3333333333333333,2,2,TGGAATTGTAAGTGTGTACA,0,2910248
ompRp4,0.3333333333333333,2,2,TGGAAATGGATCAGACACAA,0,2911026
ompRp4,0.3333333333333333,2,2,TGCTACGGTCCAAGAAGTTT,0,2927181
ompRp4,0.3333333333333333,2,2,TGCTAAGTTACGAATAAACG,0,2921624
ompRp4,0.3333333333333333,2,2,TGCGTATGACGGTACGTGCC,0,2913093
ompRp4,0.3333333333333333,2,2,TGCGGAATTCACAGCAGACA,0,2920779
ompRp4,0.3333333333333333,2,2,TGCCGTCTACAGACGGTAGC,0,2919160
ompRp4,0.3333333333333333,2,2,TGCCCTACAGGCCGTTCACT,0,2916694
ompRp4,0.3333333333333333,2,2,TGCCCGGAGATTCCTACTGT,0,2934896
ompRp4,0.3333333333333333,2,2,TGCCATAACTCTATTGGCGG,0,2913841
ompRp4,0.3333333333333333,2,2,TGCAGATTTCTGGTCCCCCG,0,2916999
ompRp4,0.3333333333333333,2,2,TGCAGAAGTCTATTGGGATT,0,2923240
ompRp4,0.3333333333333333,2,2,TGCACAGGCGGGGCTACAAC,0,2915897
ompRp4,0.3333333333333333,2,2,TGCACAAGTAATGTCGAATG,0,2934781
ompRp4,0.3333333333333333,2,2,TGATCTTTGAAATCTCTCCA,0,2908077
ompRp4,0.3333333333333333,2,2,TGATAATTGGTCCCATAGAG,0,2912484
ompRp4,0.3333333333333333,2,2,TGAGCTCCCGCCGGGTCGTT,0,2921572
ompRp4,0.3333333333333333,2,2,TGACTGTTGTCCAGCGATCC,0,2933373
ompRp4,0.3333333333333333,2,2,TGACTGGTCAAAGTTACTTA,0,2911366
ompRp4,0.3333333333333333,2,2,TGACTGAAGCCTCGGATCCC,0,2921328
ompRp4,0.3333333333333333,2,2,TGACGTTGATTGCTAAGTAT,0,2908322
ompRp4,0.3333333333333333,2,2,TGACGGTCGCTTTAAGGAGC,0,2920187
ompRp4,0.3333333333333333,2,2,TGACCTGTGTCTAGGAATCG,0,2912049
ompRp4,0.3333333333333333,2,2,TGAATCCTCAGTGAAACTTA,0,2937107
ompRp4,0.3333333333333333,2,2,TGAAAGGGACCGTGAAACGT,0,2938292
ompRp4,0.3333333333333333,2,2,TCTTTTAAAAAGCCCACGTA,0,2912409
ompRp4,0.3333333333333333,2,2,TCTGCGCTTGCAAGGGAAGA,0,2927829
ompRp4,0.3333333333333333,2,2,TCTGCCTCTCTACAAAGCTT,0,2927578
ompRp4,0.3333333333333333,2,2,TCTGAGATAAATCTGTCCCG,0,2923818
ompRp4,0.3333333333333333,2,2,TCTGAAATTCGATACATCAC,0,2911873
ompRp4,0.3333333333333333,2,2,TCTATCCGCTGAGAGTATGA,0,2920544
ompRp4,0.3333333333333333,2,2,TCTACGCTCTAGCGGAAATA,0,2937752
ompRp4,0.3333333333333333,2,2,TCGTTTGTATAGCGACTCTA,0,2931310
ompRp4,0.3333333333333333,2,2,TCGTGTGGGGGCGGATCTCA,0,2919136
ompRp4,0.3333333333333333,2,2,TCGTCCCCGGAATTTCGTTA,0,2916746
ompRp4,0.3333333333333333,2,2,TCGGTCGGATGTGTTACCTG,0,2920862
ompRp4,0.3333333333333333,2,2,TCGGGTGTCGTCCTGTCGGG,0,2930150
ompRp4,0.3333333333333333,2,2,TCGGGGCACGTGGATAATCG,0,2915390
ompRp4,0.3333333333333333,2,2,TCGGAGGGGACGCCGTATCT,0,2919774
ompRp4,0.3333333333333333,2,2,TCGCGGTACCTCACCGATTG,0,2915349
ompRp4,0.3333333333333333,2,2,TCGCAAATGTTCGGGTTTTA,0,2922342
ompRp4,0.3333333333333333,2,2,TCGAGGTCGGCAACGCAGCA,0,2925658
ompRp4,0.3333333333333333,2,2,TCGACTAAGTCGCGTTCACT,0,2914627
ompRp4,0.3333333333333333,2,2,TCCGCAGGGTGTGGTCATCA,0,2914545
ompRp4,0.3333333333333333,2,2,TCCCTAGCAATAAACGGATA,0,2911928
ompRp4,0.3333333333333333,2,2,TCCCTACCCTCCCGCTCAGG,0,2918889
ompRp4,0.3333333333333333,2,2,TCCCGGTCTATTGTGGGCCA,0,2910702
ompRp4,0.3333333333333333,2,2,TCCCGCTTTCCTTCGCGGCA,0,2911467
ompRp4,0.3333333333333333,2,2,TCCCGATGTTATAACAGCTC,0,2910099
ompRp4,0.3333333333333333,2,2,TCCCCCCGTGCGTTAGCCCA,0,2916744
ompRp4,0.3333333333333333,2,2,TCCCCAATGGAGCATGACTA,0,2930454
ompRp4,0.3333333333333333,2,2,TCCAGTGGGTCGCCGGAACT,0,2908321
ompRp4,0.3333333333333333,2,2,TCCAAGGGGATGAACGCATG,0,2925468
ompRp4,0.3333333333333333,2,2,TCAGCTTTTATACCTACAGG,0,2937778
ompRp4,0.3333333333333333,2,2,TCAGCTAGGATTCGCTGTAA,0,2912891
ompRp4,0.3333333333333333,2,2,TCAGAGACGCCTAGTAGTGT,0,2927956
ompRp4,0.3333333333333333,2,2,TATTATTTTATGGTAGTCAA,0,2916625
ompRp4,0.3333333333333333,2,2,TATGTATAGCCGCAGGGCTC,0,2912679
ompRp4,0.3333333333333333,2,2,TATGGCATATTCTGCGTTTC,0,2919521
ompRp4,0.3333333333333333,2,2,TATGCTTTAGAAGACGCCCG,0,2928568
ompRp4,0.3333333333333333,2,2,TATGCTTGATACTTCATCGT,0,2937068
ompRp4,0.3333333333333333,2,2,TATGAAGTCCAGAGCGGTAT,0,2909507
ompRp4,0.3333333333333333,2,2,TATATGCTCACCCCCATCTA,0,2928956
ompRp4,0.3333333333333333,2,2,TATAGTCGCAGTCTTCCGCA,0,2913211
ompRp4,0.3333333333333333,2,2,TATAGCTCATACAGTGTCCC,0,2909503
ompRp4,0.3333333333333333,2,2,TATAATCGTGGTTTAGACCA,0,2922784
ompRp4,0.3333333333333333,2,2,TAGGTTGTTTGTGGAGTTGA,0,2930286
ompRp4,0.3333333333333333,2,2,TAGCTAGCAGGAGGGTTCCT,0,2932192
ompRp4,0.3333333333333333,2,2,TAGAGGTGGGGAGCTCTATA,0,2932207
ompRp4,0.3333333333333333,2,2,TACTGAGGATTTCTGGTTAC,0,2913893
ompRp4,0.3333333333333333,2,2,TACTAGCGACCGCACCCTCA,0,2931958
ompRp4,0.3333333333333333,2,2,TACGTTGAAATCCCGTGCGG,0,2915347
ompRp4,0.3333333333333333,2,2,TACGTGAAAGGCGGCTTGGT,0,2931925
ompRp4,0.3333333333333333,2,2,TACCAAGGCATGAGTACGGG,0,2915374
ompRp4,0.3333333333333333,2,2,TACACGGGTCTCACGTTGGA,0,2924970
ompRp4,0.3333333333333333,2,2,TAATGAAATGTTGTGGCATA,0,2936991
ompRp4,0.3333333333333333,2,2,TAATCTCCGGACATCGATGT,0,2927509
ompRp4,0.3333333333333333,2,2,TAATAGCCGCTTATGGCGGA,0,2930046
ompRp4,0.3333333333333333,2,2,TAAGCGTGGGGGGAATGGAC,0,2907974
ompRp4,0.3333333333333333,2,2,TAAGCCAGGTACGAGGTATT,0,2920469
ompRp4,0.3333333333333333,2,2,TAACTGCTTGGGATAAGAAA,0,2914408
ompRp4,0.3333333333333333,2,2,TAACTCTCACGAGTGCGCCC,0,2921316
ompRp4,0.3333333333333333,2,2,TAAATTGTGGGGGGTTGGAT,0,2912182
ompRp4,0.3333333333333333,2,2,TAAAGGTAAATTGGAGCCTC,0,2908952
ompRp4,0.3333333333333333,2,2,GTTTGCATCTGGAGCAGGGT,0,2920510
ompRp4,0.3333333333333333,2,2,GTTTCCGGTTGCGGTCCTGG,0,2927543
ompRp4,0.3333333333333333,2,2,GTTGTTACTCTGCAGTTAGT,0,2932134
ompRp4,0.3333333333333333,2,2,GTTGGGTCCACACCTTATTG,0,2916961
ompRp4,0.3333333333333333,2,2,GTTGGGGCCTCGGCCCTCAA,0,2932044
ompRp4,0.3333333333333333,2,2,GTTCTGCAGGGATTGGACAT,0,2916928
ompRp4,0.3333333333333333,2,2,GTTCCAGCATCCTACATGAA,0,2934188
ompRp4,0.3333333333333333,2,2,GTTCACTGACTTTGAGTATA,0,2914329
ompRp4,0.3333333333333333,2,2,GTTACGCTCCGAGCTTACCT,0,2923714
ompRp4,0.3333333333333333,2,2,GTGGGTCCATGGCTCCATTT,0,2923826
ompRp4,0.3333333333333333,2,2,GTGCCTCGGAGGACTTGCGA,0,2930031
ompRp4,0.3333333333333333,2,2,GTGCACCTGCAGCATGTGTA,0,2918425
ompRp4,0.3333333333333333,2,2,GTGAATGTAGCCAGATCCTA,0,2921520
ompRp4,0.3333333333333333,2,2,GTCTGAGAAGATTAGTTCAA,0,2909692
ompRp4,0.3333333333333333,2,2,GTCTCACTGAAGTTCACCGC,0,2909212
ompRp4,0.3333333333333333,2,2,GTCGGGTAAATGCAATACTT,0,2932130
ompRp4,0.3333333333333333,2,2,GTCGCAGGAAGGGTGCCAAA,0,2925842
ompRp4,0.3333333333333333,2,2,GTCGATGCGGGTAGTTCCCA,0,2932905
ompRp4,0.3333333333333333,2,2,GTCATCCGAGAGTAAGTGGC,0,2926839
ompRp4,0.3333333333333333,2,2,GTCACTCAGCACGGTGGGGA,0,2913644
ompRp4,0.3333333333333333,2,2,GTCACAGCGTCGGGCCTGAT,0,2917854
ompRp4,0.3333333333333333,2,2,GTATAGGTTACGGTCGAGCG,0,2928904
ompRp4,0.3333333333333333,2,2,GTAGTATGGATGATGACGTA,0,2914844
ompRp4,0.3333333333333333,2,2,GTAGACTCGTGCTCTTAAAG,0,2931024
ompRp4,0.3333333333333333,2,2,GTACTCTACCGCTATTCGAT,0,2929950
ompRp4,0.3333333333333333,2,2,GTACTCCTGCATGATCTGAT,0,2917216
ompRp4,0.3333333333333333,2,2,GTACGTGCCCATCCTACTGC,0,2924128
ompRp4,0.3333333333333333,2,2,GTAACTGCTGGACCTGATAT,0,2910964
ompRp4,0.3333333333333333,2,2,GTAACGCGCGCGAAGAAACT,0,2925176
ompRp4,0.3333333333333333,2,2,GGTTTACAACGCTTTGGGCT,0,2917361
ompRp4,0.3333333333333333,2,2,GGTGTAACGGGTCCACGGAC,0,2924561
ompRp4,0.3333333333333333,2,2,GGTGGTTAGGCACTCTACGT,0,2937082
ompRp4,0.3333333333333333,2,2,GGTGGTCCCATTTACGTGCA,0,2911342
ompRp4,0.3333333333333333,2,2,GGTCGTGCGACCTATGGACC,0,2915070
ompRp4,0.3333333333333333,2,2,GGTCACGCTGAAATAAACCA,0,2909367
ompRp4,0.3333333333333333,2,2,GGTATCGGCGTCAAACGAGT,0,2930120
ompRp4,0.3333333333333333,2,2,GGTAGGCACTGCTACTCATT,0,2918242
ompRp4,0.3333333333333333,2,2,GGGTGTGCGCCTTATGTCTG,0,2911882
ompRp4,0.3333333333333333,2,2,GGGTGCCTGAAGCCATCATA,0,2935928
ompRp4,0.3333333333333333,2,2,GGGGTCTGGTTCGGTGATCA,0,2934765
ompRp4,0.3333333333333333,2,2,GGGGTCATCGTAAGAATACT,0,2931897
ompRp4,0.3333333333333333,2,2,GGGGTACACATAAATGAACA,0,2922468
ompRp4,0.3333333333333333,2,2,GGGGGGGTCTACACCACGGT,0,2916669
ompRp4,0.3333333333333333,2,2,GGGGGCGGTAGGCCTCGAGA,0,2911790
ompRp4,0.3333333333333333,2,2,GGGGCGCGGAACTGCAGTAC,0,2918257
ompRp4,0.3333333333333333,2,2,GGGCCTTACCGCTTTTCATT,0,2911821
ompRp4,0.3333333333333333,2,2,GGGCCTAATCGGGGGTAGGT,0,2932015
ompRp4,0.3333333333333333,2,2,GGGAGCCTTACCGGGGAATA,0,2916528
ompRp4,0.3333333333333333,2,2,GGGAGCACGATGCCAAGTTA,0,2930998
ompRp4,0.3333333333333333,2,2,GGGACGTTTCAGCGTGCGGT,0,2920723
ompRp4,0.3333333333333333,2,2,GGGACCACGAATCTTAATTA,0,2916712
ompRp4,0.3333333333333333,2,2,GGCTGAGGTCGGCGAACCAA,0,2934316
ompRp4,0.3333333333333333,2,2,GGCTGAAATTACCCGTAGGT,0,2928270
ompRp4,0.3333333333333333,2,2,GGCGTTACTACTATCCGCTT,0,2917876
ompRp4,0.3333333333333333,2,2,GGCGAACCTAGTGATTCGCG,0,2920244
ompRp4,0.3333333333333333,2,2,GGCCGCTTCTGGATCAACGT,0,2935910
ompRp4,0.3333333333333333,2,2,GGCCCCTTTCCGCACGCCAA,0,2937850
ompRp4,0.3333333333333333,2,2,GGCAGACCGCCTACCTTGGG,0,2915927
ompRp4,0.3333333333333333,2,2,GGCAAGGTTGAATAGGGTTC,0,2933167
ompRp4,0.3333333333333333,2,2,GGATTTAAGCAATTCAATTT,0,2922841
ompRp4,0.3333333333333333,2,2,GGATTCGGCTTCTATGAAGG,0,2912130
ompRp4,0.3333333333333333,2,2,GGATGGCAACGTGTATTTCA,0,2916970
ompRp4,0.3333333333333333,2,2,GGAGGTATTGGTCCCCGCCC,0,2922971
ompRp4,0.3333333333333333,2,2,GGACTTCAGCGTGTCGTGGA,0,2937899
ompRp4,0.3333333333333333,2,2,GGACGGACAAACGTGTGAAA,0,2928783
ompRp4,0.3333333333333333,2,2,GGACAATGAATTAATTTGGT,0,2913846
ompRp4,0.3333333333333333,2,2,GGAATTAGCTGTTACCCGCT,0,2916681
ompRp4,0.3333333333333333,2,2,GCTTTTTGGACTTTAAGGCT,0,2912056
ompRp4,0.3333333333333333,2,2,GCTTGTAACGCCTTTACGAT,0,2918675
ompRp4,0.3333333333333333,2,2,GCTTCCGTCAAATCAGCTTA,0,2909197
ompRp4,0.3333333333333333,2,2,GCTCTTAAGCCAAGTAACGA,0,2926704
ompRp4,0.3333333333333333,2,2,GCTCTCACCCGACGAACTCG,0,2921612
ompRp4,0.3333333333333333,2,2,GCTCCCTAGGCTCACACATT,0,2916965
ompRp4,0.3333333333333333,2,2,GCTCAGAAGTAGCAAGGAAT,0,2920821
ompRp4,0.3333333333333333,2,2,GCGTTTTAGCGGATTGCCAA,0,2927501
ompRp4,0.3333333333333333,2,2,GCGTTCGGAAGGTGGGTCCG,0,2935535
ompRp4,0.3333333333333333,2,2,GCGTGCCCTAGTAACGTGAA,0,2927397
ompRp4,0.3333333333333333,2,2,GCGTGCACCGTGTCCCGTGA,0,2908333
ompRp4,0.3333333333333333,2,2,GCGTCGAGAGGCGATATCAG,0,2917824
ompRp4,0.3333333333333333,2,2,GCGTACGCGACACAGTTGCA,0,2931384
ompRp4,0.3333333333333333,2,2,GCGGGTAGCACTATTGATGT,0,2915078
ompRp4,0.3333333333333333,2,2,GCGGGCTATAACAGCAAGTC,0,2918070
ompRp4,0.3333333333333333,2,2,GCGGGACTGAGCAAGAAGGT,0,2927846
ompRp4,0.3333333333333333,2,2,GCGGCTACGAGGTGTAACGG,0,2916706
ompRp4,0.3333333333333333,2,2,GCGGCCATCAGCCAATACCT,0,2935149
ompRp4,0.3333333333333333,2,2,GCGCTTCGCCGCTTCACTTA,0,2934161
ompRp4,0.3333333333333333,2,2,GCGCGGTATGCTTGTCCTTA,0,2911300
ompRp4,0.3333333333333333,2,2,GCGCCCCGACCGTCCCTGGG,0,2933209
ompRp4,0.3333333333333333,2,2,GCGCACTCGGAGGCACAATT,0,2922269
ompRp4,0.3333333333333333,2,2,GCCTTCTCCGTATTGTGCCC,0,2933409
ompRp4,0.3333333333333333,2,2,GCCTCCTAGTGGATTAATTG,0,2935096
ompRp4,0.3333333333333333,2,2,GCCGCGCGATTAGATATCTT,0,2927802
ompRp4,0.3333333333333333,2,2,GCCGCAGACAGAGTCAGAGC,0,2938091
ompRp4,0.3333333333333333,2,2,GCCCGACGTACAGTCACTGA,0,2928040
ompRp4,0.3333333333333333,2,2,GCCCCCTCCATTCTCGTCTG,0,2927069
ompRp4,0.3333333333333333,2,2,GCCCAGGTGAAGATCGGCAG,0,2934952
ompRp4,0.3333333333333333,2,2,GCCCACATTGGCTAGCGTCT,0,2923482
ompRp4,0.3333333333333333,2,2,GCCATGGTGGCGAAAAAAAC,0,2925793
ompRp4,0.3333333333333333,2,2,GCCAGATCGTGGTTTGGCGC,0,2913753
ompRp4,0.3333333333333333,2,2,GCCAGATAGTTTGGGGATGG,0,2916214
ompRp4,0.3333333333333333,2,2,GCATCCCTGACTTGTAACGT,0,2926059
ompRp4,0.3333333333333333,2,2,GCATAATGTTTTGTCAGTTT,0,2914191
ompRp4,0.3333333333333333,2,2,GCATAATATAAAGTTTACCA,0,2928224
ompRp4,0.3333333333333333,2,2,GCAGTCGCTTCCGCCACGAC,0,2933762
ompRp4,0.3333333333333333,2,2,GCAGATTCTGGCTAAGACGA,0,2934626
ompRp4,0.3333333333333333,2,2,GCAGAGTCACTTTGTGTGTA,0,2910140
ompRp4,0.3333333333333333,2,2,GCAGAAGTACCATTTCGTCG,0,2917750
ompRp4,0.3333333333333333,2,2,GCACGTACCGGTAGCTCGGG,0,2909146
ompRp4,0.3333333333333333,2,2,GCAAGCTTTAAGCACCAGGG,0,2929233
ompRp4,0.3333333333333333,2,2,GCAACTTTTAATGGGATAAA,0,2928952
ompRp4,0.3333333333333333,2,2,GATTCGAGGACCGTCACTTG,0,2932823
ompRp4,0.3333333333333333,2,2,GATGCACATTTATCGCAGTG,0,2937138
ompRp4,0.3333333333333333,2,2,GATAGAGTGGAGCAGGGATG,0,2936631
ompRp4,0.3333333333333333,2,2,GATAAGCATGGGCTAACATG,0,2923643
ompRp4,0.3333333333333333,2,2,GAGTACATCGTGGGTGAGCC,0,2911871
ompRp4,0.3333333333333333,2,2,GAGGTTCTGTGCAGGCGAGG,0,2929537
ompRp4,0.3333333333333333,2,2,GAGGGGGCTGATGCCACGTA,0,2920671
ompRp4,0.3333333333333333,2,2,GAGGGCGCGGGAGGGAGGGT,0,2910633
ompRp4,0.3333333333333333,2,2,GAGCTCGTGGATTCAACGAT,0,2915625
ompRp4,0.3333333333333333,2,2,GAGCTCAGCTGGGGTTAACC,0,2922351
ompRp4,0.3333333333333333,2,2,GAGACTAGGTCTCGCTGTAC,0,2910741
ompRp4,0.3333333333333333,2,2,GAGACCACCTACAAATAGGT,0,2919919
ompRp4,0.3333333333333333,2,2,GACTGAGGGAATCGTACGAT,0,2920479
ompRp4,0.3333333333333333,2,2,GACTCCTTGACCCCTTACAC,0,2909653
ompRp4,0.3333333333333333,2,2,GACTCCGACTAGGGATACTG,0,2912156
ompRp4,0.3333333333333333,2,2,GACTAGCTCATAATGGCAGG,0,2911573
ompRp4,0.3333333333333333,2,2,GACGCTGAACACCAAGTCGG,0,2928578
ompRp4,0.3333333333333333,2,2,GACGCTATCGAACTGATGGC,0,2911829
ompRp4,0.3333333333333333,2,2,GACATCTCACGGTGGTGAAG,0,2908292
ompRp4,0.3333333333333333,2,2,GACATCGCACACCCTGTGGC,0,2909884
ompRp4,0.3333333333333333,2,2,GACAGCGTGTTTGGCAAACG,0,2923067
ompRp4,0.3333333333333333,2,2,GACACGTATCCAACTGAGAC,0,2937488
ompRp4,0.3333333333333333,2,2,GAATTCCTAGATCCGTACTT,0,2909862
ompRp4,0.3333333333333333,2,2,GAATGCGTGTTTTCGCGGCT,0,2918082
ompRp4,0.3333333333333333,2,2,GAATCGGAATCGCTTGACAA,0,2915122
ompRp4,0.3333333333333333,2,2,GAATATATACACAACATGCC,0,2915492
ompRp4,0.3333333333333333,2,2,GAATAACCACAGCGGCGTCA,0,2916877
ompRp4,0.3333333333333333,2,2,GAACGGCAGTGAGGTGAAGC,0,2908579
ompRp4,0.3333333333333333,2,2,GAACGGAGGCGGTAATAAGA,0,2916024
ompRp4,0.3333333333333333,2,2,GAAATGCTCGACTTAATAGT,0,2909028
ompRp4,0.3333333333333333,2,2,GAAAGTGAATGGCCATTGTA,0,2923046
ompRp4,0.3333333333333333,2,2,GAAAGGCAAGACAGCGGGCA,0,2928593
ompRp4,0.3333333333333333,2,2,GAAACGGAGTTCATGTCATA,0,2921330
ompRp4,0.3333333333333333,2,2,CTTTTTTCGGGATCCTGGTT,0,2914045
ompRp4,0.3333333333333333,2,2,CTTTTTCTGATGGCGTCGTA,0,2931339
ompRp4,0.3333333333333333,2,2,CTTTATTAGTTGGATTATAA,0,2924525
ompRp4,0.3333333333333333,2,2,CTTTAGCGCCCCGTACACTT,0,2926888
ompRp4,0.3333333333333333,2,2,CTTGATTCTTTGGTTCGTAC,0,2917938
ompRp4,0.3333333333333333,2,2,CTTCGTCCACTTTCTGCCAT,0,2933594
ompRp4,0.3333333333333333,2,2,CTTCGGCGTTTCGCTATGAC,0,2915929
ompRp4,0.3333333333333333,2,2,CTTCGACGCATCTCATAGAT,0,2928838
ompRp4,0.3333333333333333,2,2,CTTAGCGAAATATTAAGGCC,0,2928829
ompRp4,0.3333333333333333,2,2,CTGTTGTAATCGGGGTATCT,0,2919669
ompRp4,0.3333333333333333,2,2,CTGTCTCCACAAGCTAAAAT,0,2922039
ompRp4,0.3333333333333333,2,2,CTGGTGATCAGGTTTAGGTA,0,2915183
ompRp4,0.3333333333333333,2,2,CTGGGGAAACCGGAATTTTC,0,2923852
ompRp4,0.3333333333333333,2,2,CTGATAAGGCCGTATATATG,0,2921263
ompRp4,0.3333333333333333,2,2,CTGAGACTGCTGGTTAAATT,0,2908094
ompRp4,0.3333333333333333,2,2,CTGACAAAAGAAGAGAGTTT,0,2921791
ompRp4,0.3333333333333333,2,2,CTGAAATGCTCATCCTAGGT,0,2924024
ompRp4,0.3333333333333333,2,2,CTGAAACCCATTACGAAGAG,0,2936847
ompRp4,0.3333333333333333,2,2,CTCTGCACGCCAGGAGTTCA,0,2923759
ompRp4,0.3333333333333333,2,2,CTCGGTGCGACACGTTTAGG,0,2921997
ompRp4,0.3333333333333333,2,2,CTCGATCTGCGCATGCAGAC,0,2935897
ompRp4,0.3333333333333333,2,2,CTCAGTTAGAATGCATGTAG,0,2915896
ompRp4,0.3333333333333333,2,2,CTCAGCGCCCTATTGTTCAC,0,2928927
ompRp4,0.3333333333333333,2,2,CTCACCTGGCGCCACAGAAT,0,2929132
ompRp4,0.3333333333333333,2,2,CTCACATCTGTAACAAATTC,0,2918836
ompRp4,0.3333333333333333,2,2,CTATATGGCATGATGCCGGT,0,2912358
ompRp4,0.3333333333333333,2,2,CTAGTGTGTGCTGCTACCGG,0,2916464
ompRp4,0.3333333333333333,2,2,CTAGGTGCGCCAGTGCACGA,0,2923778
ompRp4,0.3333333333333333,2,2,CTACATGTGCGTCCCCCGGT,0,2909462
ompRp4,0.3333333333333333,2,2,CTAATGCCCTAGTAAATTGA,0,2919708
ompRp4,0.3333333333333333,2,2,CTAACGCGCGGAAAAGAAGA,0,2932488
ompRp4,0.3333333333333333,2,2,CGTTCTGGGGTACGCTGGAT,0,2910563
ompRp4,0.3333333333333333,2,2,CGTTCGTGGCACAATCTGCT,0,2910735
ompRp4,0.3333333333333333,2,2,CGTGTGCGGATATGGGGGCT,0,2938181
ompRp4,0.3333333333333333,2,2,CGTGTAGGGCGACAGGCGGT,0,2914905
ompRp4,0.3333333333333333,2,2,CGTGAATCGCATGTCTGATA,0,2930466
ompRp4,0.3333333333333333,2,2,CGTCGTCGGCCATTATATTT,0,2916021
ompRp4,0.3333333333333333,2,2,CGTCCTGTACTCGTCTGAAT,0,2924123
ompRp4,0.3333333333333333,2,2,CGTCCGGCGTAACTGGACAA,0,2935558
ompRp4,0.3333333333333333,2,2,CGGTTTTCAGAAAGACTGCA,0,2907754
ompRp4,0.3333333333333333,2,2,CGGTAGTGACTCGATAAAGA,0,2926836
ompRp4,0.3333333333333333,2,2,CGGTAAGACATCTTGCTGTT,0,2913080
ompRp4,0.3333333333333333,2,2,CGGGGACACGGTAAACCGAC,0,2932304
ompRp4,0.3333333333333333,2,2,CGGCTGCGGAGGCACTTCTC,0,2914140
ompRp4,0.3333333333333333,2,2,CGGCGGACGAATCGGTAGTT,0,2930534
ompRp4,0.3333333333333333,2,2,CGGCATGTACCGACAACAGA,0,2923465
ompRp4,0.3333333333333333,2,2,CGGATAATTGTACAAAGAAA,0,2924440
ompRp4,0.3333333333333333,2,2,CGGACTTTTGGCTTAAACCA,0,2913901
ompRp4,0.3333333333333333,2,2,CGGACGGAGCGCGGTTTCGT,0,2926725
ompRp4,0.3333333333333333,2,2,CGCTTTTGCAGTTGAGGGAC,0,2910146
ompRp4,0.3333333333333333,2,2,CGCTGGTTCCTCTTTTCACA,0,2915131
ompRp4,0.3333333333333333,2,2,CGCTCGGTGCAAACGGGTTT,0,2914774
ompRp4,0.3333333333333333,2,2,CGCATCCTCAATAGGAGGCA,0,2924096
ompRp4,0.3333333333333333,2,2,CGCATAGTGTGCTAGGGCTA,0,2912855
ompRp4,0.3333333333333333,2,2,CGCACGCCTCTTATAGGGTC,0,2937746
ompRp4,0.3333333333333333,2,2,CGAGCAGATAGTGGCCTGGC,0,2923260
ompRp4,0.3333333333333333,2,2,CGAGATGGGAGATGGCGCCA,0,2926134
ompRp4,0.3333333333333333,2,2,CGAGAGCATTCTGAACAGGT,0,2908856
ompRp4,0.3333333333333333,2,2,CGAGACCACCGGTCCGGCGG,0,2908012
ompRp4,0.3333333333333333,2,2,CGACTATCGAGCTGTCCTCT,0,2924026
ompRp4,0.3333333333333333,2,2,CGACGGGCCGATCCGCGGGG,0,2922732
ompRp4,0.3333333333333333,2,2,CGACGGCAAAGGGACGACGT,0,2926278
ompRp4,0.3333333333333333,2,2,CGACGCTAATCTCCGCCTAA,0,2917856
ompRp4,0.3333333333333333,2,2,CGACATGGCTCGGGGTCATC,0,2926318
ompRp4,0.3333333333333333,2,2,CGACAAGTCAGAATGCGCTT,0,2938034
ompRp4,0.3333333333333333,2,2,CGAATGTGTCCATTTGAGTC,0,2929904
ompRp4,0.3333333333333333,2,2,CCTTGTGAGGACATTGGCCA,0,2937112
ompRp4,0.3333333333333333,2,2,CCTGTTGACGAGGGGGTGAA,0,2932197
ompRp4,0.3333333333333333,2,2,CCTGGTGTTTGTCTGGGTCT,0,2931510
ompRp4,0.3333333333333333,2,2,CCTGATGGCCGGGAAAGTCA,0,2921933
ompRp4,0.3333333333333333,2,2,CCTGATCTTGTCGAGTAGGA,0,2931458
ompRp4,0.3333333333333333,2,2,CCTCCTAAAGCATAAGCTGA,0,2909341
ompRp4,0.3333333333333333,2,2,CCTCACTTCAGTGCATTATA,0,2919655
ompRp4,0.3333333333333333,2,2,CCTCAACGTTCGATAGCTGC,0,2932621
ompRp4,0.3333333333333333,2,2,CCTACGCTGACTTATAGGTC,0,2930701
ompRp4,0.3333333333333333,2,2,CCTAAGTTATGTCAGTCGCA,0,2932840
ompRp4,0.3333333333333333,2,2,CCGGTTGAACGAGTGCTTAT,0,2924396
ompRp4,0.3333333333333333,2,2,CCGGTTCAGCACTCAGGTGG,0,2919194
ompRp4,0.3333333333333333,2,2,CCGCGTCGAAGGGGCTTTAG,0,2928699
ompRp4,0.3333333333333333,2,2,CCGCACATGTTTCCCCGCCT,0,2912285
ompRp4,0.3333333333333333,2,2,CCGATTTTATCAGTGAGGTA,0,2916026
ompRp4,0.3333333333333333,2,2,CCGAGGCAATACACTCGTCT,0,2915233
ompRp4,0.3333333333333333,2,2,CCGACCACACCGATAAGTTT,0,2931139
ompRp4,0.3333333333333333,2,2,CCCTCCTACGGCTTTAAGTT,0,2933938
ompRp4,0.3333333333333333,2,2,CCCGTAACTTTCGGGATTCA,0,2933057
ompRp4,0.3333333333333333,2,2,CCCGATTTCCGGCAAACGGG,0,2909258
ompRp4,0.3333333333333333,2,2,CCAGTTAAATGGGGACAGAG,0,2915286
ompRp4,0.3333333333333333,2,2,CCAGTAATGCGAGATGTATA,0,2934127
ompRp4,0.3333333333333333,2,2,CCAGGCCACGGGGCTTAGTT,0,2927776
ompRp4,0.3333333333333333,2,2,CCACTGCAACGGGGCTTCTG,0,2927339
ompRp4,0.3333333333333333,2,2,CCACAATCTCGTTTACACGG,0,2922271
ompRp4,0.3333333333333333,2,2,CCAATGCTCGTTATAGTTAG,0,2930822
ompRp4,0.3333333333333333,2,2,CCAATGACTTGGCGATTCTT,0,2929694
ompRp4,0.3333333333333333,2,2,CCAAGTCACCCTTAACGGAT,0,2909135
ompRp4,0.3333333333333333,2,2,CCAACGATTCTTCGGAATTT,0,2923024
ompRp4,0.3333333333333333,2,2,CATTTTGATACGTAGACGGA,0,2914422
ompRp4,0.3333333333333333,2,2,CATTTCTAGACCGTCGTTTA,0,2917890
ompRp4,0.3333333333333333,2,2,CATTCGTTGTTGGACTGGCC,0,2918788
ompRp4,0.3333333333333333,2,2,CATTAGGGTGCTGGGAAATC,0,2910097
ompRp4,0.3333333333333333,2,2,CATGGTCGGTTTCCTTTCCT,0,2934844
ompRp4,0.3333333333333333,2,2,CATGGGCTGCTCTAACGTCA,0,2937621
ompRp4,0.3333333333333333,2,2,CATGGCTGTGTATGTCTTCT,0,2915252
ompRp4,0.3333333333333333,2,2,CATGGCGTGCAGACCTGGGA,0,2912403
ompRp4,0.3333333333333333,2,2,CATGCTGGGACAAGTTTGAA,0,2932664
ompRp4,0.3333333333333333,2,2,CATCTGGTGGACATTTCTAC,0,2911032
ompRp4,0.3333333333333333,2,2,CATCACATGGCTGGCTCCCA,0,2931883
ompRp4,0.3333333333333333,2,2,CATACCATCGATAAATTCGT,0,2908104
ompRp4,0.3333333333333333,2,2,CAGTCTTAATATATGGTGGG,0,2937638
ompRp4,0.3333333333333333,2,2,CAGTAAGCGCAGCAGGGATT,0,2929181
ompRp4,0.3333333333333333,2,2,CAGGTGAAGGACCCACAGAT,0,2910390
ompRp4,0.3333333333333333,2,2,CAGGGGCCAGGGGTATGTGT,0,2937008
ompRp4,0.3333333333333333,2,2,CAGGACCTTTTATGGTGCCT,0,2918602
ompRp4,0.3333333333333333,2,2,CAGCTACCTCGGCCCTGAGC,0,2925604
ompRp4,0.3333333333333333,2,2,CAGCCGTGTATGGGCCTAGT,0,2918252
ompRp4,0.3333333333333333,2,2,CAGATTAGAGGGGTCTTCTA,0,2923374
ompRp4,0.3333333333333333,2,2,CAGATCCTTATCACGCTTGC,0,2935313
ompRp4,0.3333333333333333,2,2,CACTGGTATATATTAATTAA,0,2913728
ompRp4,0.3333333333333333,2,2,CACTAATGGGAGCGACCGTT,0,2914540
ompRp4,0.3333333333333333,2,2,CACGTTGAGGGACAGAGGCT,0,2933852
ompRp4,0.3333333333333333,2,2,CACCAGTGTATCCACACGTT,0,2908078
ompRp4,0.3333333333333333,2,2,CAATTTGGCTGAACCGCGCT,0,2937332
ompRp4,0.3333333333333333,2,2,CAATGCCAATCTGGACTTGC,0,2922197
ompRp4,0.3333333333333333,2,2,CAATAAAAAATAGGTGCTTC,0,2927361
ompRp4,0.3333333333333333,2,2,CAAGGGACAAACCCTGTCTC,0,2913299
ompRp4,0.3333333333333333,2,2,CAAGGCGCTAGTTTGCTATA,0,2937356
ompRp4,0.3333333333333333,2,2,CAAGCCCCGTCATTGTGCCT,0,2910423
ompRp4,0.3333333333333333,2,2,CAAGCACAGCACACTGGGCG,0,2933538
ompRp4,0.3333333333333333,2,2,CAACGATGTCATTCTTTACC,0,2935127
ompRp4,0.3333333333333333,2,2,CAAATTTAGTAAGTATTCAA,0,2912810
ompRp4,0.3333333333333333,2,2,CAAATATGGGAAAATGTAGA,0,2909063
ompRp4,0.3333333333333333,2,2,CAAAGTGAGGGCTTATTCTA,0,2924861
ompRp4,0.3333333333333333,2,2,ATTTTTAAAACGTGGATAGT,0,2922196
ompRp4,0.3333333333333333,2,2,ATTGAATCAAGGCGGGAACT,0,2929328
ompRp4,0.3333333333333333,2,2,ATTCTTTCTCAGACGAAGAA,0,2912460
ompRp4,0.3333333333333333,2,2,ATGTCTTCCTTTCTAGCGTG,0,2929344
ompRp4,0.3333333333333333,2,2,ATGTCGAGGTAAACCGTAAT,0,2914052
ompRp4,0.3333333333333333,2,2,ATGCTTTACGTAAGAAGCAA,0,2933585
ompRp4,0.3333333333333333,2,2,ATGCTCTTAGACGGCGTCCC,0,2924681
ompRp4,0.3333333333333333,2,2,ATGCCGGGGGGGAACGGTCA,0,2921090
ompRp4,0.3333333333333333,2,2,ATGCCCATCGCTTGATAGAT,0,2915421
ompRp4,0.3333333333333333,2,2,ATGCATTCTGAATAGTCTGA,0,2916011
ompRp4,0.3333333333333333,2,2,ATCTTCAAGTTTCGAAGGGT,0,2932350
ompRp4,0.3333333333333333,2,2,ATCTGAGCAGGAGGGGCTAT,0,2911079
ompRp4,0.3333333333333333,2,2,ATCTCATTAGCTCAAGTATA,0,2938033
ompRp4,0.3333333333333333,2,2,ATCGTGAGAGATGTTACAAC,0,2923675
ompRp4,0.3333333333333333,2,2,ATCGTCCCTCTGCACATCGC,0,2912356
ompRp4,0.3333333333333333,2,2,ATCGCTCGATGTGAATTTAA,0,2921441
ompRp4,0.3333333333333333,2,2,ATCGAAATAAGTTATTATCG,0,2935167
ompRp4,0.3333333333333333,2,2,ATCCTCATGACGCACGGGGG,0,2922253
ompRp4,0.3333333333333333,2,2,ATCCTCATCGCCTACCATTA,0,2918170
ompRp4,0.3333333333333333,2,2,ATCCGAAAGCTTAGTCCTTA,0,2920157
ompRp4,0.3333333333333333,2,2,ATCATGAGTGCTGCGTCTTT,0,2907911
ompRp4,0.3333333333333333,2,2,ATCATAAGGCCTGACTGCCC,0,2923543
ompRp4,0.3333333333333333,2,2,ATCACTGAAGTCCACGGGGT,0,2927587
ompRp4,0.3333333333333333,2,2,ATCAATGGTGAGGTGACACT,0,2931362
ompRp4,0.3333333333333333,2,2,ATATGGGTTGAGGAAGCAAA,0,2938009
ompRp4,0.3333333333333333,2,2,ATATACAATTGAAAGCAGAT,0,2912168
ompRp4,0.3333333333333333,2,2,ATAGGTGGGTCATGGTAGAC,0,2932985
ompRp4,0.3333333333333333,2,2,ATACCAACTTAGTGAGATTT,0,2929469
ompRp4,0.3333333333333333,2,2,ATAATTTGCGTAACGTTCCT,0,2927449
ompRp4,0.3333333333333333,2,2,AGTTGTTGGGGTGTAATGCC,0,2913431
ompRp4,0.3333333333333333,2,2,AGTCTTGATGACGAAAGGCC,0,2914420
ompRp4,0.3333333333333333,2,2,AGTCACATTGTGTCTATAGT,0,2934216
ompRp4,0.3333333333333333,2,2,AGTAATTTTGCTAACGAGTT,0,2914692
ompRp4,0.3333333333333333,2,2,AGGTTCAACCACGTACGTGG,0,2924541
ompRp4,0.3333333333333333,2,2,AGGTAGCACTACCCTTCAAG,0,2926526
ompRp4,0.3333333333333333,2,2,AGGTACCCCAAATAACCGGG,0,2915444
ompRp4,0.3333333333333333,2,2,AGGTAATCCGTCTTTCGGAT,0,2931097
ompRp4,0.3333333333333333,2,2,AGGTAAGAAGGCCTGTTAGT,0,2911766
ompRp4,0.3333333333333333,2,2,AGGGTGCGAGGTGTGTAGGA,0,2936006
ompRp4,0.3333333333333333,2,2,AGGGCGAATTCGCTATAAGT,0,2925786
ompRp4,0.3333333333333333,2,2,AGGCGGTGTTGCTAGGCCGA,0,2918858
ompRp4,0.3333333333333333,2,2,AGGCCCATAAGAGGCCCCGA,0,2909486
ompRp4,0.3333333333333333,2,2,AGGCAAGGAGCACCCGGGTC,0,2926768
ompRp4,0.3333333333333333,2,2,AGGAGGTATGGCATCCACAG,0,2935460
ompRp4,0.3333333333333333,2,2,AGGAACTTTGCCCTTCGAAA,0,2934957
ompRp4,0.3333333333333333,2,2,AGCTTGTGCGAAATACCGGA,0,2931071
ompRp4,0.3333333333333333,2,2,AGCTTCAGGTAATCCAGGAT,0,2936606
ompRp4,0.3333333333333333,2,2,AGCTACACAGCCCGCATGGA,0,2919363
ompRp4,0.3333333333333333,2,2,AGCTAAAGTTCGCAGGAAGG,0,2908892
ompRp4,0.3333333333333333,2,2,AGCGCTATGACGGAACTTAC,0,2934471
ompRp4,0.3333333333333333,2,2,AGCCTCTTGGATTAAATGAG,0,2912312
ompRp4,0.3333333333333333,2,2,AGCCTAATCCGATGCGCTCA,0,2914063
ompRp4,0.3333333333333333,2,2,AGCATTGGAATGGATCACTC,0,2934621
ompRp4,0.3333333333333333,2,2,AGCACACCCGCCGGCGAGAC,0,2920138
ompRp4,0.3333333333333333,2,2,AGATACTTAGTGCCACTCAT,0,2921461
ompRp4,0.3333333333333333,2,2,AGAGGCCAAACTCGCGCCCC,0,2911154
ompRp4,0.3333333333333333,2,2,AGAGAGTATATTATAGATAG,0,2928286
ompRp4,0.3333333333333333,2,2,AGAAGATTGGTCTCCGTATA,0,2936584
ompRp4,0.3333333333333333,2,2,AGAACGCAGGTAATGTGGCA,0,2922396
ompRp4,0.3333333333333333,2,2,ACTTTTTCATCAACATTGTG,0,2920007
ompRp4,0.3333333333333333,2,2,ACTTAACTATTACCTACTGT,0,2924779
ompRp4,0.3333333333333333,2,2,ACTTAACGCGAAGGGCCTGT,0,2923506
ompRp4,0.3333333333333333,2,2,ACTGTTACTTGAAAAACGAT,0,2931914
ompRp4,0.3333333333333333,2,2,ACTGTCTTATGGCGCGGTCG,0,2910614
ompRp4,0.3333333333333333,2,2,ACTCTGAGGACCGCATGTCA,0,2916562
ompRp4,0.3333333333333333,2,2,ACTCTAGAGATCTGCGTACA,0,2913201
ompRp4,0.3333333333333333,2,2,ACTCGTTGCAATGTACGAGT,0,2915944
ompRp4,0.3333333333333333,2,2,ACTCCATGGGCGTATCGAAT,0,2936873
ompRp4,0.3333333333333333,2,2,ACTCATTGTTCCCGGGTTCA,0,2908178
ompRp4,0.3333333333333333,2,2,ACGTGGGAATGCTGGCAAGA,0,2922056
ompRp4,0.3333333333333333,2,2,ACGTCTATACTTGACACTCA,0,2909756
ompRp4,0.3333333333333333,2,2,ACGTCCGAAAACATTCCTTC,0,2938017
ompRp4,0.3333333333333333,2,2,ACGGTCAGGTAGCACATTGG,0,2911030
ompRp4,0.3333333333333333,2,2,ACGGTAAGTAGTTTTTTATC,0,2911784
ompRp4,0.3333333333333333,2,2,ACGGGCATCCTTCCGGCAGA,0,2930128
ompRp4,0.3333333333333333,2,2,ACGGCGCCGGGTCATCGCTG,0,2918679
ompRp4,0.3333333333333333,2,2,ACGGATACGGGTAGAACTAC,0,2921827
ompRp4,0.3333333333333333,2,2,ACGCTGTTCGGTTAAGTGTT,0,2929455
ompRp4,0.3333333333333333,2,2,ACGCTATGGCGCCACTGTTC,0,2926437
ompRp4,0.3333333333333333,2,2,ACGCTACACATCTAAACTTC,0,2913665
ompRp4,0.3333333333333333,2,2,ACGAGTCGCACGAATCAAAT,0,2912368
ompRp4,0.3333333333333333,2,2,ACGACAGTGGTTTCATGATA,0,2923276
ompRp4,0.3333333333333333,2,2,ACGAAGTTCGTTTAGCCTTG,0,2910949
ompRp4,0.3333333333333333,2,2,ACCGGAATACAAGTCGGATG,0,2937179
ompRp4,0.3333333333333333,2,2,ACCGCAACACACATAGTGGC,0,2913318
ompRp4,0.3333333333333333,2,2,ACCCGATTCAGCGTTATTTT,0,2910925
ompRp4,0.3333333333333333,2,2,ACCCCACATGCGGCTTGGTC,0,2909944
ompRp4,0.3333333333333333,2,2,ACCACTAGCGGGGCGGCTCC,0,2918733
ompRp4,0.3333333333333333,2,2,ACATTTGGCTCCTCCAGGAA,0,2922902
ompRp4,0.3333333333333333,2,2,ACAGTTTTCTTGCCTTGCTG,0,2907809
ompRp4,0.3333333333333333,2,2,ACAGCGTTAGTAGCGACACC,0,2918542
ompRp4,0.3333333333333333,2,2,ACACTTGGAGCCCTGAGGTA,0,2917917
ompRp4,0.3333333333333333,2,2,ACACCGCCCGGATTAATTAG,0,2937281
ompRp4,0.3333333333333333,2,2,ACACAACATTCCTCCTTCAC,0,2927716
ompRp4,0.3333333333333333,2,2,ACAAGAAAAGGGTGCTGGTG,0,2911543
ompRp4,0.3333333333333333,2,2,ACAACGAGCAGCAGGATATT,0,2914112
ompRp4,0.3333333333333333,2,2,ACAAACGGTGCGCCCGTGTG,0,2928618
ompRp4,0.3333333333333333,2,2,ACAAACAAAGGCGGCGAGTT,0,2917064
ompRp4,0.3333333333333333,2,2,AATTCATCTCTCGACCCGTT,0,2925111
ompRp4,0.3333333333333333,2,2,AATTAAGCGCTAATGTGACA,0,2934241
ompRp4,0.3333333333333333,2,2,AATGGGGGCCTTGAATACCC,0,2914804
ompRp4,0.3333333333333333,2,2,AATGGATTTGTACAACTAAA,0,2933361
ompRp4,0.3333333333333333,2,2,AATGCTTTTTCATCGTGTGG,0,2918881
ompRp4,0.3333333333333333,2,2,AATGAGTCAACGATATTTGT,0,2928369
ompRp4,0.3333333333333333,2,2,AATGACAGGGGATTAGCTAA,0,2924303
ompRp4,0.3333333333333333,2,2,AATCCTACACATAGGTGCTG,0,2912990
ompRp4,0.3333333333333333,2,2,AATAGCCCCCCCTCTTCTTA,0,2935420
ompRp4,0.3333333333333333,2,2,AATACTTATACAGAAAGACA,0,2910043
ompRp4,0.3333333333333333,2,2,AATACGCTGTAAACTATATG,0,2908527
ompRp4,0.3333333333333333,2,2,AATACCTGTTCGACTTGTAC,0,2918955
ompRp4,0.3333333333333333,2,2,AAGTTTATCTTTCGCGACTT,0,2915083
ompRp4,0.3333333333333333,2,2,AAGTCTCCCGCACTCAGTTG,0,2925691
ompRp4,0.3333333333333333,2,2,AAGTCTAGTGTTCCTGGTCT,0,2924923
ompRp4,0.3333333333333333,2,2,AAGTCACAATTAAGCGATTA,0,2918739
ompRp4,0.3333333333333333,2,2,AAGGTTCACTTGGCAAGCCT,0,2910426
ompRp4,0.3333333333333333,2,2,AAGGGGCACTTGCCGCGTCG,0,2918205
ompRp4,0.3333333333333333,2,2,AAGGGCGGTTTCTATAGACC,0,2934276
ompRp4,0.3333333333333333,2,2,AAGGACCCTGTCCCACGAAG,0,2918419
ompRp4,0.3333333333333333,2,2,AAGCCCGGCGTTTCAGCGGA,0,2917237
ompRp4,0.3333333333333333,2,2,AAGCCAGGATCGGTTGGACA,0,2926504
ompRp4,0.3333333333333333,2,2,AAGCAGAACACTAGGGCGAC,0,2926940
ompRp4,0.3333333333333333,2,2,AAGACGATGTAATCGCGCAT,0,2929319
ompRp4,0.3333333333333333,2,2,AACTTTTGTTGGCTGGAGGA,0,2909993
ompRp4,0.3333333333333333,2,2,AACTGCACCCGGTACCCGTT,0,2913959
ompRp4,0.3333333333333333,2,2,AACTGACACAGACGCTACTT,0,2912768
ompRp4,0.3333333333333333,2,2,AACTCACCGCGAACATCTCT,0,2922293
ompRp4,0.3333333333333333,2,2,AACGTCTTTATGGGCTTCCC,0,2932699
ompRp4,0.3333333333333333,2,2,AACCTCGACCGAATTTAAAT,0,2925002
ompRp4,0.3333333333333333,2,2,AACCCGGATCTCCCACTAAC,0,2926077
ompRp4,0.3333333333333333,2,2,AACACTCCCATTCGTGTAGA,0,2922906
ompRp4,0.3333333333333333,2,2,AACAACATCGCAACTGCCGA,0,2922200
ompRp4,0.3333333333333333,2,2,AAATATTAGCTTTCTGACTG,0,2931734
ompRp4,0.3333333333333333,2,2,AAACGTTGGGACGCACGTTG,0,2910100
ompRp4,0.3333333333333333,2,2,AAACCCTCTTCACCATCCTA,0,2917759
ompRp4,0.3333333333333333,2,2,AAAATCCGTCTGGAAGTAAC,0,2917252
ompRp4,0.3333333333333333,2,2,AAAAGATGATGCTTACCAGC,0,2924572
ompRp4,0.5,1,1,TTTTTTCTAGGACTTTGAGT,0,2923502
ompRp4,0.5,1,1,TTTTGTGGAGTGTAAGTTCG,0,2914995
ompRp4,0.5,1,1,TTTTGCCCGGGAGGTCAGAT,0,2927084
ompRp4,0.5,1,1,TTTTGCCCGATATGGTAAAA,0,2912513
ompRp4,0.5,1,1,TTTTATGCGGCGCTGGATGG,0,2930161
ompRp4,0.5,1,1,TTTGTGTGGCTTGCACGCGG,0,2914462
ompRp4,0.5,1,1,TTTGGCGGCAGAATAACTGT,0,2930303
ompRp4,0.5,1,1,TTTGGATGTAATCATTCAAT,0,2908727
ompRp4,0.5,1,1,TTTGACACCTCGTACGTTCA,0,2924154
ompRp4,0.5,1,1,TTTCTGGTACATTAGGGGAT,0,2917485
ompRp4,0.5,1,1,TTTCTCCTGCCTGGCCACCT,0,2920670
ompRp4,0.5,1,1,TTTCGCTCATTGAGGTGCTT,0,2925432
ompRp4,0.5,1,1,TTTCCCGTGAAAGGAAGCTT,0,2914424
ompRp4,0.5,1,1,TTTCACTGGGCGACAAGCAT,0,2931386
ompRp4,0.5,1,1,TTTAGTGACCGCCAGAAGAT,0,2915459
ompRp4,0.5,1,1,TTTACCATCTGACAGAGGAC,0,2911668
ompRp4,0.5,1,1,TTTACAGCTCTAATTAATTG,0,2920163
ompRp4,0.5,1,1,TTGTGGCTCTTAAACTTGCC,0,2908117
ompRp4,0.5,1,1,TTGTATGGATGGGTCGGTTA,0,2921277
ompRp4,0.5,1,1,TTGTACCGGAAAGTGGTGCA,0,2907892
ompRp4,0.5,1,1,TTGTACAGGAGACCCGGCCG,0,2929282
ompRp4,0.5,1,1,TTGGTGAACCTCGATCGCTA,0,2934548
ompRp4,0.5,1,1,TTGGGTGACGGATTGACGAA,0,2910868
ompRp4,0.5,1,1,TTGGCATACGTGACGCACTG,0,2924301
ompRp4,0.5,1,1,TTGGCAGGAGGTATGGTCCT,0,2916428
ompRp4,0.5,1,1,TTGCTACTAAAGCATTTTCC,0,2919186
ompRp4,0.5,1,1,TTGCCCTCAGTAAGGCACGG,0,2919280
ompRp4,0.5,1,1,TTGAGTGGCTATGTTCGCAT,0,2910407
ompRp4,0.5,1,1,TTGAGGGTCCCTACAAGTTG,0,2934677
ompRp4,0.5,1,1,TTGACAGACCACTCTCTCTA,0,2935634
ompRp4,0.5,1,1,TTGAACGAAATCCCAACTTA,0,2928547
ompRp4,0.5,1,1,TTCTTGAGGCTTACACTACT,0,2937766
ompRp4,0.5,1,1,TTCTATCTCGATAGATTATG,0,2936622
ompRp4,0.5,1,1,TTCGTGCCCGACTAATACTA,0,2936660
ompRp4,0.5,1,1,TTCGCTGTAATATATCCACG,0,2919373
ompRp4,0.5,1,1,TTCGCTAACTCGAGGGGAGC,0,2917701
ompRp4,0.5,1,1,TTCGCCGCTATCACCCAGCT,0,2917000
ompRp4,0.5,1,1,TTCATTGGGAATGACACTTA,0,2937003
ompRp4,0.5,1,1,TTCAGTATTATCTCCACTTC,0,2912143
ompRp4,0.5,1,1,TTATTTGTACTCAAAACGGC,0,2916386
ompRp4,0.5,1,1,TTATTTGGCGTGTGTTCCTC,0,2908120
ompRp4,0.5,1,1,TTATTGTTCGGCAACCCGTT,0,2908820
ompRp4,0.5,1,1,TTATTAACACACGAATATAA,0,2913848
ompRp4,0.5,1,1,TTATGTGGCTTTCAAAATAG,0,2931768
ompRp4,0.5,1,1,TTATGTCGAAAAGTATGTTT,0,2922160
ompRp4,0.5,1,1,TTATGTCCCCCAAGGTGCTT,0,2913814
ompRp4,0.5,1,1,TTATGGACTCTTCCCACGAT,0,2908306
ompRp4,0.5,1,1,TTATCCAAGAAGGCAGAGTG,0,2921344
ompRp4,0.5,1,1,TTAGTTGGCTCGCTTGAGTA,0,2914201
ompRp4,0.5,1,1,TTAGTGTCTTTAATAGAATA,0,2910828
ompRp4,0.5,1,1,TTAGTGGATTTAGTAATGTT,0,2917339
ompRp4,0.5,1,1,TTAGGGGCGGTCTCAATCGG,0,2918534
ompRp4,0.5,1,1,TTAGGAATTAGCTGTCACCT,0,2933050
ompRp4,0.5,1,1,TTACTTAGTTCGTGCACGTC,0,2916169
ompRp4,0.5,1,1,TTACGTCCTTAAGCAATGTC,0,2929561
ompRp4,0.5,1,1,TTACCATATAGTCGATAGTA,0,2922869
ompRp4,0.5,1,1,TTACCAACCCCCCTAGTTTA,0,2924999
ompRp4,0.5,1,1,TTACATGTCCGATCACCGTA,0,2918768
ompRp4,0.5,1,1,TTACAGCAGAGTCACAGCGG,0,2913349
ompRp4,0.5,1,1,TTACAAACCGACTGAGTAGA,0,2935226
ompRp4,0.5,1,1,TTAAGTCGCTAGCTTGGAGT,0,2936530
ompRp4,0.5,1,1,TTAACGTCTTCCATGTCTGC,0,2911236
ompRp4,0.5,1,1,TTAACAGCCCGCGGGCATCT,0,2924735
ompRp4,0.5,1,1,TGTTTTAAAGAGGGTCGCCG,0,2908546
ompRp4,0.5,1,1,TGTTGTCGTACTAGGCTGGT,0,2910884
ompRp4,0.5,1,1,TGTTCTTTCAGCTCTGAGTA,0,2925000
ompRp4,0.5,1,1,TGTTCAGACTCGAATTATTT,0,2913711
ompRp4,0.5,1,1,TGTTATACAACGACTATGTT,0,2931556
ompRp4,0.5,1,1,TGTGGGTGCGTCGGCTCTTA,0,2925818
ompRp4,0.5,1,1,TGTGGGCAAATATAGACCCT,0,2914469
ompRp4,0.5,1,1,TGTGCATGGAAGCGTAGTCA,0,2938139
ompRp4,0.5,1,1,TGTGAAGGCAGAGTCTTCAT,0,2920313
ompRp4,0.5,1,1,TGTCCTAGTTCTGGCTGGGC,0,2925383
ompRp4,0.5,1,1,TGTATATAATGACGGACGAC,0,2912341
ompRp4,0.5,1,1,TGTAGGGTGGGCCTGTCAGC,0,2916379
ompRp4,0.5,1,1,TGTAACAGCACCCAAGCGGA,0,2930511
ompRp4,0.5,1,1,TGTAAAGGGTCGGACATAGG,0,2912094
ompRp4,0.5,1,1,TGGTTTACTACAGATGCCCA,0,2930555
ompRp4,0.5,1,1,TGGTCACACCGTCCTCCATA,0,2935086
ompRp4,0.5,1,1,TGGTAGGTGTAGTTTTTGTG,0,2913107
ompRp4,0.5,1,1,TGGTAGGCATTACACCCGAC,0,2920857
ompRp4,0.5,1,1,TGGTACTTCGCGTAGTGTCA,0,2934297
ompRp4,0.5,1,1,TGGGTTTGCATTAAATGGTA,0,2932673
ompRp4,0.5,1,1,TGGGCTCCTTGTTCGTGGGG,0,2918481
ompRp4,0.5,1,1,TGGGAACTGTATCTTAAGAA,0,2934254
ompRp4,0.5,1,1,TGGCTTGGTAGACACCACCA,0,2920353
ompRp4,0.5,1,1,TGGCAGTAACTGATGTTTTA,0,2918144
ompRp4,0.5,1,1,TGGCAGACTTTCCTTCAGGC,0,2924686
ompRp4,0.5,1,1,TGGAGCGCCCTAATACACAT,0,2935301
ompRp4,0.5,1,1,TGGAGACAACTGTTTGCCCT,0,2909481
ompRp4,0.5,1,1,TGCTTTAGTTTGAGCCTCGG,0,2911338
ompRp4,0.5,1,1,TGCTACCGGTCTGCGTCTAT,0,2925758
ompRp4,0.5,1,1,TGCGTTAATAGCTCTTGGCA,0,2917681
ompRp4,0.5,1,1,TGCGTGCGCACCCGAGTCAA,0,2908415
ompRp4,0.5,1,1,TGCGTAGATGGTTAGTGCCT,0,2926507
ompRp4,0.5,1,1,TGCGCCCGAGGTCCCTTTCC,0,2936572
ompRp4,0.5,1,1,TGCGCATGGCTAAGTAACGA,0,2914638
ompRp4,0.5,1,1,TGCGCAGGTAGCACCACGCC,0,2926510
ompRp4,0.5,1,1,TGCCGTATTGCCGCCACGAC,0,2930936
ompRp4,0.5,1,1,TGCCGGGTTCCCCTGTGAAT,0,2923910
ompRp4,0.5,1,1,TGCCCTAGTTTTGCTGGGGG,0,2921259
ompRp4,0.5,1,1,TGCCCCCGGGGATGAACAGA,0,2921231
ompRp4,0.5,1,1,TGCAGTAACTATCCCGCGTA,0,2917910
ompRp4,0.5,1,1,TGCAGGTGGTCATTGGGTTG,0,2924250
ompRp4,0.5,1,1,TGCAGCGGGTCAAGAGCTTC,0,2919554
ompRp4,0.5,1,1,TGCAGAGGCTTGGACGGGCA,0,2910500
ompRp4,0.5,1,1,TGCACTTGGTGCCGATGGCG,0,2933165
ompRp4,0.5,1,1,TGCACAAGAGAGAGGATCCT,0,2918439
ompRp4,0.5,1,1,TGCAACCGCAGGGAAACTTT,0,2917911
ompRp4,0.5,1,1,TGCAACCAACAGTGCAGCTC,0,2938144
ompRp4,0.5,1,1,TGATTTACTGATGTTCGCGC,0,2934954
ompRp4,0.5,1,1,TGATTACGTGAAGGTCGGTT,0,2937357
ompRp4,0.5,1,1,TGATGCATCGTGGAAAACTC,0,2927548
ompRp4,0.5,1,1,TGATATAGTGTAGGTCGCGA,0,2918495
ompRp4,0.5,1,1,TGAGTGCAAGGTAAAGGGGC,0,2937386
ompRp4,0.5,1,1,TGAGGTTCGGAGGATCCAAG,0,2931340
ompRp4,0.5,1,1,TGAGGACCCCAGACGATAAA,0,2925845
ompRp4,0.5,1,1,TGAGCTCAGATTCAGGGTTA,0,2920380
ompRp4,0.5,1,1,TGAGCGGCGCTTGCTCTGAG,0,2937524
ompRp4,0.5,1,1,TGAGATCGACGCTCCGGCGA,0,2919459
ompRp4,0.5,1,1,TGAGATAGGGCTAACTAAAA,0,2932277
ompRp4,0.5,1,1,TGAGACTAGCAGCCGGTCTA,0,2925169
ompRp4,0.5,1,1,TGACTTTCCCTACCGCCAAA,0,2910173
ompRp4,0.5,1,1,TGACCCAAAGCTAGCCAATC,0,2927699
ompRp4,0.5,1,1,TGAAGTCTGCTCACGACGTA,0,2921299
ompRp4,0.5,1,1,TGAAGCCGAGGCTTGTTTCA,0,2924126
ompRp4,0.5,1,1,TGAAGCAGCAATTCTTTCGG,0,2910427
ompRp4,0.5,1,1,TGAACCGAGACAAGGACGCG,0,2924930
ompRp4,0.5,1,1,TGAAATGCGGACGATGGTCC,0,2930829
ompRp4,0.5,1,1,TCTTTTTTTACAGTCACCTT,0,2922559
ompRp4,0.5,1,1,TCTTCCGCGAGACAGCCATT,0,2920678
ompRp4,0.5,1,1,TCTTACCGCCGCGACCGGCA,0,2916281
ompRp4,0.5,1,1,TCTGTAACCGCTAGCTTGAG,0,2929106
ompRp4,0.5,1,1,TCTGTAAAGATGTTACGATG,0,2931041
ompRp4,0.5,1,1,TCTGGAAAGGCATTCACACT,0,2914254
ompRp4,0.5,1,1,TCTGCGTGCCAATGTACGTG,0,2918506
ompRp4,0.5,1,1,TCTGCGGATCATTCCCCTAA,0,2925797
ompRp4,0.5,1,1,TCTGATGCTGCACGCCAATG,0,2915652
ompRp4,0.5,1,1,TCTCCAGAACGCTACGTGAG,0,2937653
ompRp4,0.5,1,1,TCTAGGCTGCAACGGATGTA,0,2935121
ompRp4,0.5,1,1,TCTAGCCTTCATCATTGGTG,0,2920917
ompRp4,0.5,1,1,TCGTTGCCGAGGACGCAGCT,0,2929618
ompRp4,0.5,1,1,TCGTTCGTTGGCCTTCGGCA,0,2937312
ompRp4,0.5,1,1,TCGTTATGATGATTTTACTC,0,2915001
ompRp4,0.5,1,1,TCGTGGGTAGCGCGTTGCTA,0,2908076
ompRp4,0.5,1,1,TCGTGCGTATCAGGGCGCAA,0,2910956
ompRp4,0.5,1,1,TCGTGAGCCGGTTCGGGTGA,0,2933609
ompRp4,0.5,1,1,TCGTGACTATTTTCGTCTTT,0,2938219
ompRp4,0.5,1,1,TCGTACTCTATCCCCGTCTC,0,2927150
ompRp4,0.5,1,1,TCGGTTGAATTGGCTCATTA,0,2916708
ompRp4,0.5,1,1,TCGGTGTCCCGAAACGATCG,0,2926809
ompRp4,0.5,1,1,TCGGGCGCAAAGAATATCAT,0,2926193
ompRp4,0.5,1,1,TCGGAGGATTACAGGCCCCT,0,2910166
ompRp4,0.5,1,1,TCGCGCACCTGGGAAGGTAT,0,2910839
ompRp4,0.5,1,1,TCGCGAAGTGCATCAATCCA,0,2927031
ompRp4,0.5,1,1,TCGCCTTAGGGAGAATTATG,0,2930504
ompRp4,0.5,1,1,TCGCATTGGAGCAATTAATT,0,2934333
ompRp4,0.5,1,1,TCGATGCACTATTCGGGTGA,0,2922529
ompRp4,0.5,1,1,TCGAGGAGTCCGCAGAGTTG,0,2917662
ompRp4,0.5,1,1,TCGACTTTGGAATGTGTGAT,0,2934660
ompRp4,0.5,1,1,TCGACGGCCACGGGATTCAC,0,2931464
ompRp4,0.5,1,1,TCGACCATAGATCTAGGTCT,0,2917661
ompRp4,0.5,1,1,TCCGTTCAAAATATGGCATG,0,2910050
ompRp4,0.5,1,1,TCCGTATTGGGCGGAGAATG,0,2926282
ompRp4,0.5,1,1,TCCGGTCTCAGCCTCCAATG,0,2935327
ompRp4,0.5,1,1,TCCGACAGCATGCGTGAAAC,0,2936128
ompRp4,0.5,1,1,TCCAGGATCTCTTCTTCCGA,0,2910574
ompRp4,0.5,1,1,TCCACAAAGATTCATAGGGA,0,2937456
ompRp4,0.5,1,1,TCATTGCCTCAATGCACATG,0,2927265
ompRp4,0.5,1,1,TCATTATTGTCGAAAACATG,0,2936170
ompRp4,0.5,1,1,TCATATAGACTATCGGCTTA,0,2936072
ompRp4,0.5,1,1,TCAGTAGTGGTCGTGCTGTT,0,2929594
ompRp4,0.5,1,1,TCAGGCTGCGAGCGATCGCT,0,2923591
ompRp4,0.5,1,1,TCAGGCCTCCTTGATAATCG,0,2936525
ompRp4,0.5,1,1,TCAGGAATGTAAAATTTATC,0,2926044
ompRp4,0.5,1,1,TCAGCCTATGTTCCCTACTA,0,2921797
ompRp4,0.5,1,1,TCAGCAACATGCTAGCTTGT,0,2937682
ompRp4,0.5,1,1,TCAGACAAGTTGCTCAGGGT,0,2922433
ompRp4,0.5,1,1,TCACTTCCACGGTACATTAA,0,2915081
ompRp4,0.5,1,1,TCACGCTACCATGGATCAGC,0,2912552
ompRp4,0.5,1,1,TCAATGGTCCTACTAATCCC,0,2908648
ompRp4,0.5,1,1,TCAATGAACGTGGACGGTGC,0,2929037
ompRp4,0.5,1,1,TCAATAACTTACAGCCTTGG,0,2934402
ompRp4,0.5,1,1,TCAAGGAGATCAGCAGGGGA,0,2936808
ompRp4,0.5,1,1,TCAACGCCTCAATGCGGGAG,0,2924789
ompRp4,0.5,1,1,TCAACGACGAACCTTCGACG,0,2927504
ompRp4,0.5,1,1,TCAAATAATGGGGATTGCGT,0,2909733
ompRp4,0.5,1,1,TATGCCGCCTGACGTTGCGC,0,2913106
ompRp4,0.5,1,1,TATGCAAGGAGTGGTCTTTA,0,2921834
ompRp4,0.5,1,1,TATCTGTTGTCGGCCCAGAT,0,2926932
ompRp4,0.5,1,1,TATCTGCCGCTAGGGACGGA,0,2918928
ompRp4,0.5,1,1,TATCGTGCACGATCAGGAAG,0,2909997
ompRp4,0.5,1,1,TATCATCGGGTTGGGTAACT,0,2930569
ompRp4,0.5,1,1,TATCACTGCGGAATCCCAGT,0,2911013
ompRp4,0.5,1,1,TATACTACTTAATAGGTGCA,0,2924969
ompRp4,0.5,1,1,TATACGTGGGACCTAATCTG,0,2930152
ompRp4,0.5,1,1,TATACGCCTACGGTATCACA,0,2921856
ompRp4,0.5,1,1,TATACAGTAACGATTGGTGA,0,2929746
ompRp4,0.5,1,1,TAGGTGGTCGATTTCCGCTC,0,2925647
ompRp4,0.5,1,1,TAGGGCGTACGAGACATTGT,0,2924432
ompRp4,0.5,1,1,TAGGCTACAGGGATGAGAGT,0,2935538
ompRp4,0.5,1,1,TAGGATGGTACTTGTTCTTG,0,2909792
ompRp4,0.5,1,1,TAGGATCGGTTATCCGGTGG,0,2923480
ompRp4,0.5,1,1,TAGGACGACGAATACTTCGC,0,2928062
ompRp4,0.5,1,1,TAGGACAGGTCAAGTCTTTC,0,2922118
ompRp4,0.5,1,1,TAGCTGAAATATATGAGGAG,0,2924927
ompRp4,0.5,1,1,TAGCCTTGACACGGCGCAGG,0,2925774
ompRp4,0.5,1,1,TAGCCCTGTTTGGGTGGAGT,0,2907899
ompRp4,0.5,1,1,TAGAGAGAATTGCATTCGTT,0,2909223
ompRp4,0.5,1,1,TAGACATGATGATCCGCTCC,0,2918341
ompRp4,0.5,1,1,TACTTTTGGCCGCGGGATGC,0,2929366
ompRp4,0.5,1,1,TACTCCCCCCGGCCAGGGCT,0,2926242
ompRp4,0.5,1,1,TACTATGACAAATTACGAGG,0,2917927
ompRp4,0.5,1,1,TACGTTAGCCCACGCAATGT,0,2914551
ompRp4,0.5,1,1,TACGGGTTATGTAGATGCTT,0,2937000
ompRp4,0.5,1,1,TACGGCGATTCATCACGGCC,0,2926034
ompRp4,0.5,1,1,TACGCCTAGCAAGTGCGTGA,0,2915828
ompRp4,0.5,1,1,TACGATCCATGCTCCGAGCA,0,2929070
ompRp4,0.5,1,1,TACGATAGTAAAAGGAGACC,0,2926258
ompRp4,0.5,1,1,TACCTTTCGAACAGAGGCTC,0,2921666
ompRp4,0.5,1,1,TACCGCTACATCCGAGGGAG,0,2915378
ompRp4,0.5,1,1,TACATAAACGGTCTCCCAGC,0,2921177
ompRp4,0.5,1,1,TACACAACACGAAAAATCTA,0,2927936
ompRp4,0.5,1,1,TAATTCGCGCAAGGATGCGT,0,2920141
ompRp4,0.5,1,1,TAATTAGGCAGCCCTATCCA,0,2909775
ompRp4,0.5,1,1,TAATGTATATTCCGTATATG,0,2935666
ompRp4,0.5,1,1,TAATGACAAGGAGTTAACCT,0,2914593
ompRp4,0.5,1,1,TAATAAGTGCTGGGTATCAG,0,2911640
ompRp4,0.5,1,1,TAAGTGGTTGCTCTCGTGCT,0,2931056
ompRp4,0.5,1,1,TAAGGCCTCGCGGGATTCTA,0,2915142
ompRp4,0.5,1,1,TAAGAATCCTGAGCAAATTG,0,2910244
ompRp4,0.5,1,1,TAACTCGACATTATTCTTGG,0,2921370
ompRp4,0.5,1,1,TAACGTCCAACGGATGTTGT,0,2930577
ompRp4,0.5,1,1,TAACCGACATCTGCATCGCT,0,2929227
ompRp4,0.5,1,1,TAACCCTAACAAAGGATCAT,0,2928768
ompRp4,0.5,1,1,TAACATGGGGCGACCTGCTT,0,2923605
ompRp4,0.5,1,1,TAAATTTTATCGCGTCTCGT,0,2921216
ompRp4,0.5,1,1,TAAATTGTCCGAATGGTCCC,0,2934895
ompRp4,0.5,1,1,TAAATAAAAGGGCGGCGGTA,0,2913052
ompRp4,0.5,1,1,GTTTGGGCAGTGCTAAGGAC,0,2928905
ompRp4,0.5,1,1,GTTTGATATTTAATTTAGTG,0,2920429
ompRp4,0.5,1,1,GTTTCTAGGGATTTCGCAAG,0,2908049
ompRp4,0.5,1,1,GTTTACATGCATAATGATGT,0,2907784
ompRp4,0.5,1,1,GTTTAAGGGCTCCACAGTCC,0,2923138
ompRp4,0.5,1,1,GTTGTTGATCCGTAATAGGC,0,2927180
ompRp4,0.5,1,1,GTTGTCCTTTCATGGTCGAG,0,2933201
ompRp4,0.5,1,1,GTTGGTCTCCCAAGCAGGGT,0,2933293
ompRp4,0.5,1,1,GTTGGTCCTAACGGTCATTG,0,2914193
ompRp4,0.5,1,1,GTTGGGAAGCTGCCATGAGA,0,2919236
ompRp4,0.5,1,1,GTTGAACTTCAACGGTTGCA,0,2930133
ompRp4,0.5,1,1,GTTCGGACCGGGTCAGAAAC,0,2912949
ompRp4,0.5,1,1,GTTAGGATACCGGGTGCTAC,0,2917463
ompRp4,0.5,1,1,GTTAGCAAGTTAGACAGTTC,0,2908188
ompRp4,0.5,1,1,GTTACGCCTAGACCGTGCAT,0,2917632
ompRp4,0.5,1,1,GTTACAGTTCATCGTCTAGT,0,2912284
ompRp4,0.5,1,1,GTTAATAACGGAGTGGACTA,0,2925512
ompRp4,0.5,1,1,GTTAAGTTATAGCAGTGTGA,0,2920022
ompRp4,0.5,1,1,GTGTTGGCTGTTACATGTTA,0,2927390
ompRp4,0.5,1,1,GTGTTACGGGAACCATTATT,0,2913192
ompRp4,0.5,1,1,GTGTGTAGCGAAGGGTCCTA,0,2911521
ompRp4,0.5,1,1,GTGTCTGTGAATGTCGGGGT,0,2926592
ompRp4,0.5,1,1,GTGTCATAAAGGCGTGATAA,0,2911377
ompRp4,0.5,1,1,GTGTAACTAGATCGCTCGAG,0,2911724
ompRp4,0.5,1,1,GTGGTTTAGTCGTGCAGACA,0,2932749
ompRp4,0.5,1,1,GTGGGGCGTCTTCTGAGCGC,0,2934374
ompRp4,0.5,1,1,GTGGAGAAGGAGAGTATTAT,0,2922858
ompRp4,0.5,1,1,GTGGACAAAATCCACGATCT,0,2922642
ompRp4,0.5,1,1,GTGCCACTCTACATTATCCC,0,2915679
ompRp4,0.5,1,1,GTGCAGCAACAAGCGGACCC,0,2931294
ompRp4,0.5,1,1,GTGCACAGGTTCTTCATACA,0,2934970
ompRp4,0.5,1,1,GTGAGTATGTGCCTCTTTCT,0,2911761
ompRp4,0.5,1,1,GTGAAAGCGTTTGTGCTCTG,0,2924672
ompRp4,0.5,1,1,GTCTTACATCTATTTAAAGT,0,2933697
ompRp4,0.5,1,1,GTCTGGTTCCATAGTGGTCG,0,2917245
ompRp4,0.5,1,1,GTCTATGCGTGACTACATTA,0,2912830
ompRp4,0.5,1,1,GTCTAGCGGGCTGCTAAGCA,0,2933655
ompRp4,0.5,1,1,GTCTACAGACGAGCCATATC,0,2920397
ompRp4,0.5,1,1,GTCTACACAGGGCTTTAGAA,0,2911525
ompRp4,0.5,1,1,GTCGTTGGGACCGTAAGCGG,0,2912340
ompRp4,0.5,1,1,GTCGTGTCACCAGACCCTAT,0,2919820
ompRp4,0.5,1,1,GTCGGCCATTCGCGAGACAT,0,2928006
ompRp4,0.5,1,1,GTCGCCCTGAGATGTACGGG,0,2933736
ompRp4,0.5,1,1,GTCCGCGTAAATAGACTGGC,0,2911925
ompRp4,0.5,1,1,GTCCGATGTGCGAGGCTCAA,0,2916838
ompRp4,0.5,1,1,GTCCGAGTATAGCGTTTATT,0,2913944
ompRp4,0.5,1,1,GTCCAGCGTTCTAGAGATGG,0,2933247
ompRp4,0.5,1,1,GTCACGCGGGCCTACATGAG,0,2907782
ompRp4,0.5,1,1,GTATTGTCTGGGGGCGTTTA,0,2932070
ompRp4,0.5,1,1,GTATTCGTGCCATTACTTTA,0,2926376
ompRp4,0.5,1,1,GTATCTAAAGCGAGGTCTTT,0,2909202
ompRp4,0.5,1,1,GTATCGGGCTTCCATAAGTC,0,2913776
ompRp4,0.5,1,1,GTAGGACGCGTCAATGTCCA,0,2913602
ompRp4,0.5,1,1,GTAGATTAATGTGCAACCGG,0,2936774
ompRp4,0.5,1,1,GTACTTTGCGTCCCAGGTCT,0,2917952
ompRp4,0.5,1,1,GTACGTATTGTGGCTCGTCG,0,2909876
ompRp4,0.5,1,1,GTACAATTGCCCCGTGAATG,0,2916330
ompRp4,0.5,1,1,GTACAACAGACGGCTCCTAG,0,2908279
ompRp4,0.5,1,1,GTAATGGGCGACCAGAGGTA,0,2913249
ompRp4,0.5,1,1,GTAATGAAGCTGGTATCGAT,0,2908363
ompRp4,0.5,1,1,GGTTTGGAACGCCCACCGGG,0,2928906
ompRp4,0.5,1,1,GGTTTCGTGAGATCCTCTGT,0,2936773
ompRp4,0.5,1,1,GGTTGTTTGTCAATTGACGG,0,2931689
ompRp4,0.5,1,1,GGTTGTAGCTTGAACTTAAT,0,2920114
ompRp4,0.5,1,1,GGTTGGTTTCCGAAAGCGAG,0,2915226
ompRp4,0.5,1,1,GGTTCGCTATCGTAATTTTG,0,2911184
ompRp4,0.5,1,1,GGTTCGAAGCCCGGGGTAAT,0,2918161
ompRp4,0.5,1,1,GGTGTCATCATGCTCATTGG,0,2911097
ompRp4,0.5,1,1,GGTGTACTTTTAGCAGAGTC,0,2927715
ompRp4,0.5,1,1,GGTGGAACGAAGGATCCTTA,0,2932877
ompRp4,0.5,1,1,GGTGCGACAGTTATATCTCC,0,2917395
ompRp4,0.5,1,1,GGTCTAATCTTTGCACCCCT,0,2920516
ompRp4,0.5,1,1,GGTCCGATGCACTCGGGCGG,0,2923161
ompRp4,0.5,1,1,GGTCCATCACGTGCGCAACT,0,2920017
ompRp4,0.5,1,1,GGTCCACCAACTTGGACGTG,0,2931168
ompRp4,0.5,1,1,GGTCACTCAGCCGTATATAT,0,2909335
ompRp4,0.5,1,1,GGTAGTTCGACCTTGACTAT,0,2936978
ompRp4,0.5,1,1,GGTACTGTCTAACTTTATTT,0,2915303
ompRp4,0.5,1,1,GGTACGTACGTTAGACAGGC,0,2921766
ompRp4,0.5,1,1,GGTACGGACGCCACGGACAC,0,2912870
ompRp4,0.5,1,1,GGTACCTCGAATCGCATGTA,0,2910202
ompRp4,0.5,1,1,GGTAATATGTGGACCCCTCC,0,2917358
ompRp4,0.5,1,1,GGTAACGAGGCATGTATATG,0,2934130
ompRp4,0.5,1,1,GGGTTGGAGGGCACCACGAA,0,2917819
ompRp4,0.5,1,1,GGGTGGGCGGTCGTCTACAA,0,2919710
ompRp4,0.5,1,1,GGGTGGCCGGAAACGAGGGG,0,2935860
ompRp4,0.5,1,1,GGGTCGGCCACCTTGCTGGA,0,2916385
ompRp4,0.5,1,1,GGGTCAAATTCGGCATTAGG,0,2926973
ompRp4,0.5,1,1,GGGTATGCTAAGTGGGTTGT,0,2936541
ompRp4,0.5,1,1,GGGTATCAACTGCGCCGAGC,0,2935020
ompRp4,0.5,1,1,GGGGTCCCAATATTCCGTAG,0,2913258
ompRp4,0.5,1,1,GGGGTATAGGGGCATGCCCT,0,2925979
ompRp4,0.5,1,1,GGGGGCTAGGTAGAACTGAA,0,2922904
ompRp4,0.5,1,1,GGGGCGACCTTGGTGTCGGG,0,2927703
ompRp4,0.5,1,1,GGGCTTAGTAGAACTTATTA,0,2935785
ompRp4,0.5,1,1,GGGCTCTGGGGCTTGCTTCC,0,2931942
ompRp4,0.5,1,1,GGGCGTTTAATGCCAACATT,0,2908488
ompRp4,0.5,1,1,GGGCAAACTTCCTTGTACAT,0,2911185
ompRp4,0.5,1,1,GGGATACTAGCTTGGCTGTT,0,2912612
ompRp4,0.5,1,1,GGGACGGAAGCTGATGATTA,0,2930295
ompRp4,0.5,1,1,GGGAATTTAGAAAAAAGACG,0,2919874
ompRp4,0.5,1,1,GGGAATCTTGTCAAGTGCTC,0,2932989
ompRp4,0.5,1,1,GGCTTCCAGCTTAAGGTCGT,0,2931018
ompRp4,0.5,1,1,GGCTTCAGCGGGCCTAGCAG,0,2931814
ompRp4,0.5,1,1,GGCTTAATGAAGGTAGTCAG,0,2908696
ompRp4,0.5,1,1,GGCTGATTCCTCTGTTTTAA,0,2913136
ompRp4,0.5,1,1,GGCTCTTTTAAAGACGACGA,0,2934856
ompRp4,0.5,1,1,GGCTCACAAACGCAATGACC,0,2911104
ompRp4,0.5,1,1,GGCTATCAGTTTCACACCTA,0,2920051
ompRp4,0.5,1,1,GGCGTGGGGTACGAGGAAAG,0,2923326
ompRp4,0.5,1,1,GGCGTATCCATTTCGGAGCC,0,2914580
ompRp4,0.5,1,1,GGCGAAACTCATATTACATA,0,2934432
ompRp4,0.5,1,1,GGCCGTATGTCTGCGACTTT,0,2913948
ompRp4,0.5,1,1,GGCCGTAGATACAATTAATT,0,2936981
ompRp4,0.5,1,1,GGCCGGGCACTTCACATCGT,0,2923990
ompRp4,0.5,1,1,GGCCGCCAACAGCGTACATG,0,2926978
ompRp4,0.5,1,1,GGCCCGGCGTGCTGAAGACT,0,2909310
ompRp4,0.5,1,1,GGCCCAATCGTGTTTTCGAC,0,2911156
ompRp4,0.5,1,1,GGCCAGGATATCTATTTGTG,0,2927366
ompRp4,0.5,1,1,GGCCAAGCCTTAGCTACGCA,0,2911164
ompRp4,0.5,1,1,GGCATTATGTTTGGAGGACA,0,2918688
ompRp4,0.5,1,1,GGCAGATGACCTGTTGGTAG,0,2911717
ompRp4,0.5,1,1,GGCAAGCTCTTAATAAATCA,0,2923887
ompRp4,0.5,1,1,GGCAAGCCTGCCAGAATTGC,0,2914597
ompRp4,0.5,1,1,GGATGTCTATGTTAAGAAGG,0,2918652
ompRp4,0.5,1,1,GGATCCACCTTTGGCATTGA,0,2915715
ompRp4,0.5,1,1,GGATATCGGTTGCTTCTAAG,0,2930678
ompRp4,0.5,1,1,GGAGGCGTTAGTGCATAAAG,0,2908419
ompRp4,0.5,1,1,GGAGACGTGGTAGGAAGGTG,0,2928334
ompRp4,0.5,1,1,GGAGACAGTTACGCTCGCTA,0,2919057
ompRp4,0.5,1,1,GGACTCCCCCGGTGAGAGGT,0,2923943
ompRp4,0.5,1,1,GGACCATCAGGACCTCGGTA,0,2913212
ompRp4,0.5,1,1,GGACATTCCTCAGGGAACAT,0,2934507
ompRp4,0.5,1,1,GGACAGTCCAGGTAAGCTAT,0,2908416
ompRp4,0.5,1,1,GGAATTTCGGCCAAAGTGGC,0,2935004
ompRp4,0.5,1,1,GGAAGTCATCCCCCAAGTAT,0,2920023
ompRp4,0.5,1,1,GGAAGCTAAATCCTGAGAAG,0,2921110
ompRp4,0.5,1,1,GGAAGACGGGGTGGGCGCAA,0,2929023
ompRp4,0.5,1,1,GGAACTCAGGGTCGCACAAT,0,2911905
ompRp4,0.5,1,1,GGAAATCAAGTGGAACCTAT,0,2922406
ompRp4,0.5,1,1,GGAAACGCCCGCTTATAAAG,0,2920565
ompRp4,0.5,1,1,GGAAAACGCACGCAGCCCTG,0,2932920
ompRp4,0.5,1,1,GCTTTTGCACCTGCAAGGGC,0,2910113
ompRp4,0.5,1,1,GCTTGGTGCGGAATCAAACT,0,2911417
ompRp4,0.5,1,1,GCTTGACAGGACACCCCAAG,0,2913037
ompRp4,0.5,1,1,GCTTCGGACATCCTTATGTA,0,2908622
ompRp4,0.5,1,1,GCTGTCGGATCGGTTTAGGT,0,2913347
ompRp4,0.5,1,1,GCTGAGGAGCCCTGTTGGCC,0,2908944
ompRp4,0.5,1,1,GCTCGGGACATAGTTCGCAT,0,2930006
ompRp4,0.5,1,1,GCTCCACCCTTGCCCGGTCA,0,2924176
ompRp4,0.5,1,1,GCTCCAATGGATCTGAATCG,0,2926297
ompRp4,0.5,1,1,GCTCATGTTCGATCCGTGTA,0,2918023
ompRp4,0.5,1,1,GCTATGGCTACCCTTGGAAA,0,2932271
ompRp4,0.5,1,1,GCTACCCTGAGGCGTACAAT,0,2907746
ompRp4,0.5,1,1,GCTACCAGCGGTGTCGAGCC,0,2919592
ompRp4,0.5,1,1,GCGTTGTCACCTTTCCGTGT,0,2919203
ompRp4,0.5,1,1,GCGTTGCACAGGGGGGTAAA,0,2910463
ompRp4,0.5,1,1,GCGTGAAAGATTCTTTATTC,0,2924698
ompRp4,0.5,1,1,GCGTCGTATATTGTACCCTG,0,2929970
ompRp4,0.5,1,1,GCGGTGTCCTAAATTATAAA,0,2922540
ompRp4,0.5,1,1,GCGGTATACCCTTTGCACGA,0,2920680
ompRp4,0.5,1,1,GCGGGATACCTGATATCGAC,0,2915977
ompRp4,0.5,1,1,GCGGATAGGTGCCTATTCGG,0,2921883
ompRp4,0.5,1,1,GCGGAGTATTCTGCGGCCCC,0,2919379
ompRp4,0.5,1,1,GCGCTTAGGTGGTGTCTGAT,0,2916008
ompRp4,0.5,1,1,GCGCTCGATCAAACATGTCC,0,2926177
ompRp4,0.5,1,1,GCGCGTGTTCTGTAACTAAC,0,2930344
ompRp4,0.5,1,1,GCGCCAAACAAATAAACTCA,0,2923603
ompRp4,0.5,1,1,GCGACATTCTGCTTCCGGAT,0,2936871
ompRp4,0.5,1,1,GCGAAGGCTGAGGGCTCTAA,0,2934310
ompRp4,0.5,1,1,GCCTTAACTAACCCGTGGCG,0,2929147
ompRp4,0.5,1,1,GCCTGTGGTAGTCCTATGGC,0,2916626
ompRp4,0.5,1,1,GCCTCGACAAGAGGAGTTGT,0,2916227
ompRp4,0.5,1,1,GCCTCATCGTGGTCCAGCAA,0,2929560
ompRp4,0.5,1,1,GCCTACACAGTGGAAACGTT,0,2926903
ompRp4,0.5,1,1,GCCTAACTTACGGCTTCCTC,0,2915936
ompRp4,0.5,1,1,GCCGGTAAAGGGTCTAGCCA,0,2912317
ompRp4,0.5,1,1,GCCGGGCAGTATGGAATGTA,0,2926682
ompRp4,0.5,1,1,GCCGCAGCCCGCAGGACGAC,0,2929791
ompRp4,0.5,1,1,GCCGATTACCAAGAAGGTTG,0,2908449
ompRp4,0.5,1,1,GCCGAAGAACCGGAGTTGGA,0,2931304
ompRp4,0.5,1,1,GCCCTCTTCTGACTCGCGCA,0,2924015
ompRp4,0.5,1,1,GCCCGTCCGACTGTGCATAT,0,2927884
ompRp4,0.5,1,1,GCCCAGTACACGGATCGGGG,0,2919968
ompRp4,0.5,1,1,GCCCAGGCGGGACTGTCGTA,0,2913191
ompRp4,0.5,1,1,GCCCACCGTCGCGAGGATTA,0,2909842
ompRp4,0.5,1,1,GCCAGTGTAGGGAATTTGAA,0,2911741
ompRp4,0.5,1,1,GCCAGAGAGATGGCGATCGC,0,2934937
ompRp4,0.5,1,1,GCCACGTTGTCTCTGCTGCA,0,2909131
ompRp4,0.5,1,1,GCCACGAGACCTACCGGTGT,0,2908743
ompRp4,0.5,1,1,GCCACATTGAGCTGGGATAT,0,2927973
ompRp4,0.5,1,1,GCCAAAATGTTAAGGGGCAA,0,2920118
ompRp4,0.5,1,1,GCATTCTCAATTGCTTAGTT,0,2935542
ompRp4,0.5,1,1,GCATTCGGGCCTGTCGAACG,0,2928367
ompRp4,0.5,1,1,GCATGACAAAGCGTATGCCT,0,2924388
ompRp4,0.5,1,1,GCATCGGGCGCGGTTAAGCG,0,2910505
ompRp4,0.5,1,1,GCATCCACGAAGGTGACAGT,0,2911239
ompRp4,0.5,1,1,GCATCACTCTCTGAGACGAG,0,2919244
ompRp4,0.5,1,1,GCAGTAGCTTTTTATTTATC,0,2913071
ompRp4,0.5,1,1,GCAGGCACGACTCTGAGGGG,0,2909178
ompRp4,0.5,1,1,GCAGGAACTCGACGGAAGGA,0,2910473
ompRp4,0.5,1,1,GCAGCGGGTGTCAATGCGCT,0,2934405
ompRp4,0.5,1,1,GCAGCCAGCGTTCCAGTTAA,0,2931374
ompRp4,0.5,1,1,GCAGATTTTTTCATGGATAC,0,2917133
ompRp4,0.5,1,1,GCACGGTCCATACTTACAAG,0,2938044
ompRp4,0.5,1,1,GCACACCGAGTTGCAATCAT,0,2915254
ompRp4,0.5,1,1,GATTTAGCAGCTTTTTTCGC,0,2935055
ompRp4,0.5,1,1,GATTGCAGGGCTAGTCCAGG,0,2910164
ompRp4,0.5,1,1,GATGAGGACTTACTGCCGGT,0,2926413
ompRp4,0.5,1,1,GATCGATCTCCCTAATGACA,0,2937136
ompRp4,0.5,1,1,GATCCGGTATTACATAGGCC,0,2924279
ompRp4,0.5,1,1,GATCATCCCACATTCTGTGT,0,2925787
ompRp4,0.5,1,1,GATATTTGGTCGATATTGGT,0,2914932
ompRp4,0.5,1,1,GATATTCAGGCGACGTAATC,0,2927845
ompRp4,0.5,1,1,GATATGATCAAAGGCGAGAA,0,2926632
ompRp4,0.5,1,1,GATAACGAAATTGCCGGCGT,0,2936714
ompRp4,0.5,1,1,GAGGACGACCATTCCAGGAT,0,2934197
ompRp4,0.5,1,1,GAGCTGCACCGTTGGCATAC,0,2925427
ompRp4,0.5,1,1,GAGCTAGTAGCGTATGAAGA,0,2938209
ompRp4,0.5,1,1,GAGCAGACAAAGAGTGGCAA,0,2929272
ompRp4,0.5,1,1,GAGAGGTAGGGACATCGTTG,0,2910115
ompRp4,0.5,1,1,GAGAAACCACCGAAATCTCA,0,2932209
ompRp4,0.5,1,1,GACGCACCATTTGCAGATTG,0,2934820
ompRp4,0.5,1,1,GACGCAAAGATCAAGTGCGT,0,2924345
ompRp4,0.5,1,1,GACCCGTCCCGTCTGATTGG,0,2913375
ompRp4,0.5,1,1,GACACATGCAGAAAATCATG,0,2920016
ompRp4,0.5,1,1,GAATTTGAACAGGACTGAAA,0,2932213
ompRp4,0.5,1,1,GAATTCTCTGCATCGCCTTA,0,2934242
ompRp4,0.5,1,1,GAATATTCATCGTTCGTGAA,0,2909720
ompRp4,0.5,1,1,GAAGGCGGCAACAGGAGCCG,0,2918097
ompRp4,0.5,1,1,GAAGCGTATAGCCGCTACAG,0,2917887
ompRp4,0.5,1,1,GAAGCAGCTATATTTGACGA,0,2932987
ompRp4,0.5,1,1,GAAGATATCACAGGGAGGGA,0,2926440
ompRp4,0.5,1,1,GAAGAATACCGGTAGTACAG,0,2912126
ompRp4,0.5,1,1,GAACTGTCTTCACGGTTGCT,0,2920748
ompRp4,0.5,1,1,GAACTCTTAGCCAGGAGTAC,0,2935511
ompRp4,0.5,1,1,GAACAGTCCACGTGGTCTTT,0,2937735
ompRp4,0.5,1,1,GAACAATCCAGCACTTGGGT,0,2913316
ompRp4,0.5,1,1,GAAATGTCAGTGAATGTAGA,0,2929419
ompRp4,0.5,1,1,GAAAGCCAGCCCTGTGTGTT,0,2922047
ompRp4,0.5,1,1,GAAACAACCGTATGGTGATC,0,2933552
ompRp4,0.5,1,1,GAAAACGGTCATTATCCCTT,0,2926341
ompRp4,0.5,1,1,CTTTTTATCCATCTGAACTA,0,2913405
ompRp4,0.5,1,1,CTTTTGCCTTTGATAGACGG,0,2913754
ompRp4,0.5,1,1,CTTTTATCTCTGTATCCGTC,0,2931073
ompRp4,0.5,1,1,CTTTGGGTAACGCTCCCACA,0,2909469
ompRp4,0.5,1,1,CTTTGGGGCCGGGCGCCGAT,0,2923228
ompRp4,0.5,1,1,CTTTGGAGCTGCTGGGAGTG,0,2917761
ompRp4,0.5,1,1,CTTTCCGCAGACCCCACCCA,0,2928429
ompRp4,0.5,1,1,CTTTCACGGCCCTTCGTCGC,0,2908976
ompRp4,0.5,1,1,CTTGTGGACCTTCGAAGAGG,0,2931198
ompRp4,0.5,1,1,CTTGATAAGAGCCTTAGGAC,0,2924471
ompRp4,0.5,1,1,CTTCTACTCTTAAATTTGAT,0,2915291
ompRp4,0.5,1,1,CTTCGTTTGCAGCTTGGATT,0,2917950
ompRp4,0.5,1,1,CTTCGTTGATAGAGAAGAGA,0,2931612
ompRp4,0.5,1,1,CTTCGTCACTACCGGCTGTT,0,2915261
ompRp4,0.5,1,1,CTTCGGGCGTTCAGCACGAC,0,2929280
ompRp4,0.5,1,1,CTTCCTTGCACTACCGGCTT,0,2938145
ompRp4,0.5,1,1,CTTCAAGTGCGGAAACCGCA,0,2921348
ompRp4,0.5,1,1,CTTATTACCACCAAGTCCCT,0,2929405
ompRp4,0.5,1,1,CTTATATCACTGGCGCACGA,0,2937616
ompRp4,0.5,1,1,CTTACTTGGGTTATATAGCT,0,2924453
ompRp4,0.5,1,1,CTGTGATTGCCCGGTCACGG,0,2927087
ompRp4,0.5,1,1,CTGTCGAAGGCAATTTGTTA,0,2923160
ompRp4,0.5,1,1,CTGTCATTGGTCTATTGGGA,0,2911957
ompRp4,0.5,1,1,CTGGTTGGTACGCGGGTCTC,0,2922516
ompRp4,0.5,1,1,CTGGGGCTATAGCCTACGAG,0,2920489
ompRp4,0.5,1,1,CTGGAGTATCGATTACAACG,0,2914357
ompRp4,0.5,1,1,CTGCTGTGGGTAACGTAGGG,0,2921910
ompRp4,0.5,1,1,CTGCGTGGCCCGAGACAGGC,0,2935384
ompRp4,0.5,1,1,CTGCCGGAAAACCGTGGCCT,0,2925386
ompRp4,0.5,1,1,CTGCATTGTTTTGGTGAGAA,0,2918224
ompRp4,0.5,1,1,CTGCATCAGAACATCCAAAT,0,2933677
ompRp4,0.5,1,1,CTGACTAGGAAGTAGGGTTG,0,2934122
ompRp4,0.5,1,1,CTGACCAACGGCTAGGATGC,0,2927988
ompRp4,0.5,1,1,CTCTTCCGAGACCGGAACTA,0,2910350
ompRp4,0.5,1,1,CTCTTACTTCACATGCACGG,0,2912477
ompRp4,0.5,1,1,CTCTCTGTAAGTTGCTTCAC,0,2931020
ompRp4,0.5,1,1,CTCTCTGCATCTACTAATAA,0,2928247
ompRp4,0.5,1,1,CTCTCGCACGTCACACATGA,0,2916274
ompRp4,0.5,1,1,CTCTAGTGTCATGGTGATAT,0,2927454
ompRp4,0.5,1,1,CTCTACGCCCATTCCTACGC,0,2930427
ompRp4,0.5,1,1,CTCTAACTACTGCTAAGGGA,0,2922829
ompRp4,0.5,1,1,CTCGTTGGTTTTCTGTATGT,0,2910812
ompRp4,0.5,1,1,CTCGTGTTGTTTTGGGTTTG,0,2931813
ompRp4,0.5,1,1,CTCGGTGTATTAATTAACAA,0,2930623
ompRp4,0.5,1,1,CTCGCTGCCGGGATTCACAG,0,2910253
ompRp4,0.5,1,1,CTCCTCGGGGCAATTTGTGC,0,2928996
ompRp4,0.5,1,1,CTCCGCTCTTGAGCAATGAA,0,2908560
ompRp4,0.5,1,1,CTCCGAAGGTGGGGAGATAA,0,2923054
ompRp4,0.5,1,1,CTCCCCCTCTTACGGTTGAT,0,2921690
ompRp4,0.5,1,1,CTCCCCATCCAAGGCTTCCA,0,2923469
ompRp4,0.5,1,1,CTCATCCCGGGGGACGGGGA,0,2913934
ompRp4,0.5,1,1,CTCATACAGAGGAGTGACCG,0,2919295
ompRp4,0.5,1,1,CTCAGGGATGTCTGCTCGAG,0,2925791
ompRp4,0.5,1,1,CTCAGCTGTAGTATCACTCG,0,2928003
ompRp4,0.5,1,1,CTCACCGTTCTCTAGTTCCA,0,2924714
ompRp4,0.5,1,1,CTCAATTACTGGTAGGAAAA,0,2927240
ompRp4,0.5,1,1,CTCAATCACTATATAGAAGG,0,2908625
ompRp4,0.5,1,1,CTATTGAATCTGCGGTGTGA,0,2922374
ompRp4,0.5,1,1,CTATGCGTCTACCGGGTCAT,0,2917766
ompRp4,0.5,1,1,CTATGCCGTACGTTATCGGG,0,2911922
ompRp4,0.5,1,1,CTATCGTGACAATGTGGGAT,0,2921991
ompRp4,0.5,1,1,CTATCCGATACACTATGAAG,0,2928767
ompRp4,0.5,1,1,CTATCAATAGTTATCTGAAA,0,2908277
ompRp4,0.5,1,1,CTAGCCTTCATATCATACAA,0,2925770
ompRp4,0.5,1,1,CTAGATGGCACGGTCCATGC,0,2912025
ompRp4,0.5,1,1,CTAGAGCACGGTTGTTGATC,0,2929326
ompRp4,0.5,1,1,CTAGAACACAACCTTGCGAG,0,2917785
ompRp4,0.5,1,1,CTACTTTGCGCGAGACGTGT,0,2926074
ompRp4,0.5,1,1,CTACTGAACAGACGATTCGT,0,2936217
ompRp4,0.5,1,1,CTACGTCCGAGGGCTCAGAA,0,2938206
ompRp4,0.5,1,1,CTACGAACGCGATGGTTAGG,0,2927519
ompRp4,0.5,1,1,CTACCGTCCGGACAGGTCAC,0,2933272
ompRp4,0.5,1,1,CTACAGCGGGAAAGTCGGCA,0,2935015
ompRp4,0.5,1,1,CTAATGTCGGATACCTATAA,0,2909817
ompRp4,0.5,1,1,CTAAGCTGCGTACTCTGCAG,0,2913091
ompRp4,0.5,1,1,CGTTTGGATTCTCTGCTCGG,0,2930616
ompRp4,0.5,1,1,CGTTTGATAACATAATCAGG,0,2934143
ompRp4,0.5,1,1,CGTTGGTAACATTAGTAGGA,0,2921404
ompRp4,0.5,1,1,CGTTGCAGTAAAATTATCAT,0,2930947
ompRp4,0.5,1,1,CGTTCGGTGCTAATAAAAGA,0,2913912
ompRp4,0.5,1,1,CGTTCCGTTTTGGGTTTATC,0,2920133
ompRp4,0.5,1,1,CGTTAGGCGCATCAGATACG,0,2920761
ompRp4,0.5,1,1,CGTGTGCAACGTGCGGTGTC,0,2918347
ompRp4,0.5,1,1,CGTGGGCAGATGTGAAAGAG,0,2934685
ompRp4,0.5,1,1,CGTCGTGCAAGGGTCCTCCC,0,2924214
ompRp4,0.5,1,1,CGTCGTCTAGTAACCCGTGG,0,2933735
ompRp4,0.5,1,1,CGTCCTCATTGTCTCTATGT,0,2913320
ompRp4,0.5,1,1,CGTCCGTACTGCGGGGCACT,0,2911982
ompRp4,0.5,1,1,CGTCCCATGGATTAGTATGC,0,2938247
ompRp4,0.5,1,1,CGTCATGATTGCGGCTTCCA,0,2914261
ompRp4,0.5,1,1,CGTCACAAGTCCTACCGCCG,0,2920989
ompRp4,0.5,1,1,CGTAGTCTCTGCGTAAGGGT,0,2930328
ompRp4,0.5,1,1,CGTAAGGCGCGTCGCAACAT,0,2918595
ompRp4,0.5,1,1,CGGTTTTTTTTGGAAGGTTA,0,2927894
ompRp4,0.5,1,1,CGGTGCAACGGGCGGCATAA,0,2907824
ompRp4,0.5,1,1,CGGTCTATTGCGTTCGAAAA,0,2912344
ompRp4,0.5,1,1,CGGTCGAAGACAAGGCCCCT,0,2928132
ompRp4,0.5,1,1,CGGTATCCTTGCGGAAGGCA,0,2933243
ompRp4,0.5,1,1,CGGTAATTGCATCTAGGTCC,0,2926398
ompRp4,0.5,1,1,CGGTAATCTGTATGCAACCT,0,2919425
ompRp4,0.5,1,1,CGGGTTTCTCGCCGGGTTTC,0,2913998
ompRp4,0.5,1,1,CGGGTCTTTTCATTGCGCTC,0,2919456
ompRp4,0.5,1,1,CGGGTACGCATTACGTGCTA,0,2913383
ompRp4,0.5,1,1,CGGGGTCTGCATTGTAGGCG,0,2918118
ompRp4,0.5,1,1,CGGGGGTTAGCGAGCCCCAT,0,2927521
ompRp4,0.5,1,1,CGGGGGGCAGAGGCTGCCAT,0,2911033
ompRp4,0.5,1,1,CGGGACTCAGTATACACGTA,0,2931463
ompRp4,0.5,1,1,CGGCGTACCTGATATCTCGC,0,2926726
ompRp4,0.5,1,1,CGGCCTGGGGGACCTCAGGA,0,2908951
ompRp4,0.5,1,1,CGGCATATAAGGACTGAGCC,0,2928896
ompRp4,0.5,1,1,CGGCATAGGCCCAACCATAT,0,2919372
ompRp4,0.5,1,1,CGGATTCTTACTCACACATA,0,2914064
ompRp4,0.5,1,1,CGGATCCGGCAGTCCACCCC,0,2910891
ompRp4,0.5,1,1,CGCTATCTTTGACTTGAGGG,0,2931609
ompRp4,0.5,1,1,CGCTAGTCTTCAGGTGGTAT,0,2920991
ompRp4,0.5,1,1,CGCTAAGGCCACTTACTGTG,0,2934593
ompRp4,0.5,1,1,CGCGTATCACCGTGTCGCGT,0,2917634
ompRp4,0.5,1,1,CGCGTAATCTATGAATCCAA,0,2922081
ompRp4,0.5,1,1,CGCGGGGAGGGGTGCCACTG,0,2922888
ompRp4,0.5,1,1,CGCGCTGTCACTATTGTGTA,0,2935827
ompRp4,0.5,1,1,CGCGCGCCCTTACCGTAGAA,0,2918499
ompRp4,0.5,1,1,CGCCCGGACGTTCCAAGTCT,0,2921703
ompRp4,0.5,1,1,CGCCCGCCCGTCAACGCGGA,0,2914689
ompRp4,0.5,1,1,CGCCAGTAAATGCAACGAGC,0,2913905
ompRp4,0.5,1,1,CGCAGTTGAAGGCCAGCCTC,0,2914631
ompRp4,0.5,1,1,CGCAGTTCATCCTAGTGGTC,0,2910075
ompRp4,0.5,1,1,CGCACAAAACTGCGTCCGGG,0,2918654
ompRp4,0.5,1,1,CGCAATTACGCAACTGATCA,0,2908382
ompRp4,0.5,1,1,CGATTCCAAAGTCTCCGGAA,0,2914341
ompRp4,0.5,1,1,CGATGGCTTGGGGACTATTA,0,2930178
ompRp4,0.5,1,1,CGATAGACATGGATCTTCTG,0,2919370
ompRp4,0.5,1,1,CGAGCTCAAACCGATATCCA,0,2920442
ompRp4,0.5,1,1,CGAGAGTGGATACCATACAA,0,2916570
ompRp4,0.5,1,1,CGAGACCGTACACATTCCTG,0,2915393
ompRp4,0.5,1,1,CGACTTCAATCAAGACAGTG,0,2923855
ompRp4,0.5,1,1,CGAATCGTTGGCGCTGACAA,0,2931227
ompRp4,0.5,1,1,CGAATCGCCGATCACCCCAA,0,2920781
ompRp4,0.5,1,1,CGAATCCAGCTGGGTTAACC,0,2910103
ompRp4,0.5,1,1,CGAATAGAAGTATCCAATAG,0,2908325
ompRp4,0.5,1,1,CGAAGAAGAGACAGGACGAT,0,2936844
ompRp4,0.5,1,1,CGAACAGGGAGCCATATAGT,0,2915143
ompRp4,0.5,1,1,CGAAAGGCTCGAACCAGGGT,0,2918781
ompRp4,0.5,1,1,CGAAACCGTTCTGTTCACGC,0,2924363
ompRp4,0.5,1,1,CGAAAATCGCGAGTTCACAA,0,2917508
ompRp4,0.5,1,1,CCTTTCCCTGAGAGGTGGAG,0,2932391
ompRp4,0.5,1,1,CCTTTACCTTCGACAAGTAT,0,2910300
ompRp4,0.5,1,1,CCTTGTGCTCTGGTCGTTTG,0,2936241
ompRp4,0.5,1,1,CCTTCCGGCGTTATTGCCTG,0,2935588
ompRp4,0.5,1,1,CCTTCATTCTTAGTAACTTG,0,2919185
ompRp4,0.5,1,1,CCTTCACAGGGTCCAGGAAA,0,2912297
ompRp4,0.5,1,1,CCTTAAGTGGGAGTATAGCC,0,2934804
ompRp4,0.5,1,1,CCTGTACGCCCGGCGGGCTG,0,2912836
ompRp4,0.5,1,1,CCTGCACGAAGCGGCATTGC,0,2909789
ompRp4,0.5,1,1,CCTCGCGGTGATTATGGGTG,0,2937773
ompRp4,0.5,1,1,CCTCCGGCTTTGTCTTGCAT,0,2934827
ompRp4,0.5,1,1,CCTCCCGGGTCGGTAGAGGG,0,2913991
ompRp4,0.5,1,1,CCTCACAAGGGGCCCTAGTC,0,2909375
ompRp4,0.5,1,1,CCTATCATAGGGCACTGAGA,0,2916036
ompRp4,0.5,1,1,CCTAGGCCACTTTAGGCACG,0,2910409
ompRp4,0.5,1,1,CCTAAGAGTCGTTCCGGCAA,0,2916287
ompRp4,0.5,1,1,CCTAACCTTTGTAAGCGGGA,0,2931845
ompRp4,0.5,1,1,CCGTTTTTGTGTACATTGGG,0,2929837
ompRp4,0.5,1,1,CCGTTGTATGGCCCTTTCGA,0,2909510
ompRp4,0.5,1,1,CCGTGTCCTTACTGTTTGAT,0,2923191
ompRp4,0.5,1,1,CCGTCCAAATGGGGGTCGCC,0,2922534
ompRp4,0.5,1,1,CCGTATAGCATATGGAGCGG,0,2922517
ompRp4,0.5,1,1,CCGGTGTTATATCGTTGACG,0,2935049
ompRp4,0.5,1,1,CCGGTGCGTCTGGTGAGCGA,0,2933928
ompRp4,0.5,1,1,CCGGTCGCGTCTGACCGATT,0,2933544
ompRp4,0.5,1,1,CCGGTACCTTGAAGAGCTTT,0,2911115
ompRp4,0.5,1,1,CCGGCGCATGCACAGTCCCA,0,2932099
ompRp4,0.5,1,1,CCGGCACCCGAGGTTGTCCT,0,2934747
ompRp4,0.5,1,1,CCGGAGCAGATTCAAACATT,0,2911519
ompRp4,0.5,1,1,CCGGAATGACAGAGGGGCTT,0,2925699
ompRp4,0.5,1,1,CCGCTGCCGCCTGCATATCC,0,2911785
ompRp4,0.5,1,1,CCGCGGATTGATTAATCTTG,0,2932572
ompRp4,0.5,1,1,CCGCCGGCCTTAGAAGACAC,0,2917581
ompRp4,0.5,1,1,CCGCCCTATTCTCTACGTAT,0,2922041
ompRp4,0.5,1,1,CCGCCCCTGCGCCGAGCCAC,0,2911429
ompRp4,0.5,1,1,CCGCAAATATGAGAAGGTGA,0,2926960
ompRp4,0.5,1,1,CCGATTAGTCCTCTTGTTTA,0,2930294
ompRp4,0.5,1,1,CCGATACTGATTACTGAGGT,0,2912896
ompRp4,0.5,1,1,CCGAGGTTTTGAGGGAAGTA,0,2915598
ompRp4,0.5,1,1,CCGAGGGGGGGCGTAATCCG,0,2908092
ompRp4,0.5,1,1,CCGACGTCGCCGCACAAGGA,0,2917392
ompRp4,0.5,1,1,CCGACCTCGTCACCGTCAAA,0,2935353
ompRp4,0.5,1,1,CCGAATCCTTCGCTCATTGT,0,2931985
ompRp4,0.5,1,1,CCCTTGGCATTACGAATAAA,0,2913195
ompRp4,0.5,1,1,CCCTGGCAATGATCCTGCAG,0,2917402
ompRp4,0.5,1,1,CCCTGCTAACGTTATGGACA,0,2934902
ompRp4,0.5,1,1,CCCTCGATAACCATCATCTG,0,2936777
ompRp4,0.5,1,1,CCCGGGGAATAGGATACTCT,0,2912303
ompRp4,0.5,1,1,CCCGGGCCGGACAGACCGGG,0,2923607
ompRp4,0.5,1,1,CCCGGATTTGTAACCTCAGT,0,2925746
ompRp4,0.5,1,1,CCCGACGGAGATGGACATTG,0,2916815
ompRp4,0.5,1,1,CCCGAAAATACTGGCTACAT,0,2931081
ompRp4,0.5,1,1,CCCCGTATCAAGTCAAGGGT,0,2912230
ompRp4,0.5,1,1,CCCCCCGTACATCATGCGTG,0,2916886
ompRp4,0.5,1,1,CCCCAGTCATGTGAGGTTTA,0,2915006
ompRp4,0.5,1,1,CCCATGATGGTACAGGAGTC,0,2927561
ompRp4,0.5,1,1,CCCAGAACACACGTCAACTC,0,2927420
ompRp4,0.5,1,1,CCCACCCCTTCCGCTCAGAT,0,2912369
ompRp4,0.5,1,1,CCCACAGCAGATAAAATGAA,0,2909717
ompRp4,0.5,1,1,CCCAATCTATTACGGATGTA,0,2911585
ompRp4,0.5,1,1,CCATTCGTGTAATAGCTGAA,0,2917718
ompRp4,0.5,1,1,CCATCTTCACTGGCACCCGT,0,2912480
ompRp4,0.5,1,1,CCATATGAAAGTGAAGTCCA,0,2932946
ompRp4,0.5,1,1,CCATAAAGGCCGAAGTCATG,0,2909614
ompRp4,0.5,1,1,CCAGTGCAGGATACGTTAGC,0,2938151
ompRp4,0.5,1,1,CCAGGTTGCGCCCCGTCGGG,0,2927301
ompRp4,0.5,1,1,CCAGGTCAGGCGTTTCCCGT,0,2910171
ompRp4,0.5,1,1,CCAGGGAAATCGGGCAGCCA,0,2907947
ompRp4,0.5,1,1,CCAGCTTACGGGGTCTGAGG,0,2925072
ompRp4,0.5,1,1,CCAGCCTAGGCCGTGTTAGA,0,2917699
ompRp4,0.5,1,1,CCAGAGTAATCGCGACGCGT,0,2915523
ompRp4,0.5,1,1,CCACCGTGATACTGGATGGG,0,2910344
ompRp4,0.5,1,1,CCACCAAACGCGCCCGTGTA,0,2924785
ompRp4,0.5,1,1,CCACAGGTCTCGTGCGCGAT,0,2923462
ompRp4,0.5,1,1,CATTTTGTAATTTGCTGAGT,0,2919239
ompRp4,0.5,1,1,CATTTTGCACGAATTTTACG,0,2919296
ompRp4,0.5,1,1,CATTTTCTGCGAAAAGGACA,0,2916622
ompRp4,0.5,1,1,CATTCGCCGAACAGATCATT,0,2927225
ompRp4,0.5,1,1,CATTCATCCCATTCATCTTA,0,2928451
ompRp4,0.5,1,1,CATTAGATGTCTGTGTCGTC,0,2916264
ompRp4,0.5,1,1,CATGTTCAACTTTTGGACTT,0,2919468
ompRp4,0.5,1,1,CATGGGCCACAGGTGTCTTA,0,2918226
ompRp4,0.5,1,1,CATGGGAGGTACGTCCGCCA,0,2936141
ompRp4,0.5,1,1,CATGGAGTATACTTCGTGAT,0,2933753
ompRp4,0.5,1,1,CATGGAATTAGTTCGGTAAA,0,2917735
ompRp4,0.5,1,1,CATGCCGGTATCCTGTGACA,0,2933701
ompRp4,0.5,1,1,CATAGGCTTGGAGTACCGCT,0,2935995
ompRp4,0.5,1,1,CATAAAAATAAATTATCACG,0,2916494
ompRp4,0.5,1,1,CAGTGGACCGGGCACTCACG,0,2937147
ompRp4,0.5,1,1,CAGTGCCATCGGGGCCAGTC,0,2922524
ompRp4,0.5,1,1,CAGTGCATCGAGGCGTGCCA,0,2917400
ompRp4,0.5,1,1,CAGTGATGGGTATGGGGCCT,0,2930908
ompRp4,0.5,1,1,CAGTGATCGATTGACACGGA,0,2910193
ompRp4,0.5,1,1,CAGTGACGGGTTCCCTTATG,0,2909155
ompRp4,0.5,1,1,CAGTCAGTATCATGAGAGTG,0,2929924
ompRp4,0.5,1,1,CAGGACTCCCACGACCAGCG,0,2930871
ompRp4,0.5,1,1,CAGGACAGTGTATTTAGGAC,0,2922437
ompRp4,0.5,1,1,CAGGAAGTTCCGCAGTCTAC,0,2916696
ompRp4,0.5,1,1,CAGGAAATTGTCGTAACCTT,0,2928177
ompRp4,0.5,1,1,CAGCGTCGTGTATCGAACGT,0,2916029
ompRp4,0.5,1,1,CAGCGGGGTATGCCAATAGT,0,2929087
ompRp4,0.5,1,1,CAGCCTTATTCATCGAGAAG,0,2922875
ompRp4,0.5,1,1,CAGATCAGTCTGTCACAGGA,0,2919260
ompRp4,0.5,1,1,CACTGGCGGCGTCCGTCACG,0,2932618
ompRp4,0.5,1,1,CACTCTGTAGCATTCGGTGT,0,2923500
ompRp4,0.5,1,1,CACGTTTAGACTAGCAATGT,0,2917171
ompRp4,0.5,1,1,CACGGCGATCATGTTAGAAT,0,2938178
ompRp4,0.5,1,1,CACGCTCTTGCATTGTTCGT,0,2921132
ompRp4,0.5,1,1,CACGCTATGGAAGGCAGGAG,0,2929454
ompRp4,0.5,1,1,CACGCGTTGAATGGCGGAAC,0,2926170
ompRp4,0.5,1,1,CACCGTCATCACTCACCCAA,0,2925260
ompRp4,0.5,1,1,CACCCCTAAACAACGTACGC,0,2927410
ompRp4,0.5,1,1,CACCACTACCATCAGGGTTT,0,2907698
ompRp4,0.5,1,1,CACATACGCAACTTTGGTTA,0,2937199
ompRp4,0.5,1,1,CACAGTCAACAGAGCTATTA,0,2915761
ompRp4,0.5,1,1,CACAGGGGGTTATGGTAATT,0,2936625
ompRp4,0.5,1,1,CACAATCCGATCGTGTTTGT,0,2922613
ompRp4,0.5,1,1,CACAAGGATTTCTCTATGGG,0,2914443
ompRp4,0.5,1,1,CAATGAGGGTTACGAAGCCG,0,2931383
ompRp4,0.5,1,1,CAAGTTCCCGTTAGGACAGT,0,2936005
ompRp4,0.5,1,1,CAAGGGTAGCCCCCGATCCT,0,2915670
ompRp4,0.5,1,1,CAAGGAATGCCCACCTTCGA,0,2916509
ompRp4,0.5,1,1,CAAGCTTTGCTGTTAGTGGA,0,2908949
ompRp4,0.5,1,1,CAAGCACTGTTATGGCAATA,0,2912070
ompRp4,0.5,1,1,CAAGATCTAAATACCTGTGC,0,2936501
ompRp4,0.5,1,1,CAAGACGGAATCGGTAAAGG,0,2913039
ompRp4,0.5,1,1,CAAGACCACGAGTAAGACAG,0,2932965
ompRp4,0.5,1,1,CAAGAAGTCGAGGAAGCGGG,0,2917258
ompRp4,0.5,1,1,CAACTGAATGCCTCGTGCTG,0,2920884
ompRp4,0.5,1,1,CAACGCCCCAAAATCGTTCT,0,2923997
ompRp4,0.5,1,1,CAAATTCCTGACTGAGCCAT,0,2922238
ompRp4,0.5,1,1,CAAATCGGTACTTTCCTGTC,0,2930285
ompRp4,0.5,1,1,CAAAGACACTAACCCCTCGT,0,2930521
ompRp4,0.5,1,1,CAAAATCTCGCTAAAGGTAT,0,2935419
ompRp4,0.5,1,1,ATTTGTCTGAATCTAATCCT,0,2934493
ompRp4,0.5,1,1,ATTTGGACCTGAGGTCCGGA,0,2912239
ompRp4,0.5,1,1,ATTTGCGACAAGAGATAAGG,0,2935882
ompRp4,0.5,1,1,ATTTGATGTGGGTACATCCA,0,2919269
ompRp4,0.5,1,1,ATTTATGTACTTTCTTTTAG,0,2927686
ompRp4,0.5,1,1,ATTGTTCCCCGTAGATCTCT,0,2931537
ompRp4,0.5,1,1,ATTGGGTTCCTGATGAGCAT,0,2919181
ompRp4,0.5,1,1,ATTGCAAATCGAACCGCGCA,0,2908557
ompRp4,0.5,1,1,ATTCATTGGATGGAGATATC,0,2932795
ompRp4,0.5,1,1,ATTAACGTCGGCAGCTTGCA,0,2933628
ompRp4,0.5,1,1,ATTAACGTCATGCCATGGCC,0,2930393
ompRp4,0.5,1,1,ATGTTAGGCTCTTAAAGGTT,0,2926072
ompRp4,0.5,1,1,ATGTCTCTCCAACTTGCTAC,0,2927391
ompRp4,0.5,1,1,ATGTCGTTTGTGCTGTCTGT,0,2918485
ompRp4,0.5,1,1,ATGTCCACAATAGGTAGGCT,0,2911014
ompRp4,0.5,1,1,ATGTAATGCCTGTGTATAGA,0,2908746
ompRp4,0.5,1,1,ATGTAAGGCGTTGAATTGCA,0,2914150
ompRp4,0.5,1,1,ATGGTGTTGTGATGACGGCA,0,2935334
ompRp4,0.5,1,1,ATGGTAAGCATTACACTCCC,0,2934786
ompRp4,0.5,1,1,ATGGTAAATAGGACGTCCTC,0,2916367
ompRp4,0.5,1,1,ATGGGAATCGTTCCCGCGCT,0,2915327
ompRp4,0.5,1,1,ATGGCGGTGTTAGAAAATCG,0,2915488
ompRp4,0.5,1,1,ATGGCCATGTGGATACTACT,0,2936608
ompRp4,0.5,1,1,ATGGCCAGTTATTTTCGGGG,0,2922080
ompRp4,0.5,1,1,ATGCGGCTCCCGTCACTACA,0,2935689
ompRp4,0.5,1,1,ATGCGACAGAACTCTGCCCA,0,2917849
ompRp4,0.5,1,1,ATGCAGGATGAAATGAGCCT,0,2921976
ompRp4,0.5,1,1,ATGCAGCCCAGAACGAGCCG,0,2912057
ompRp4,0.5,1,1,ATGCAAACCCCTTCAAAATG,0,2911962
ompRp4,0.5,1,1,ATGATGACTGGCACGGGGTT,0,2927404
ompRp4,0.5,1,1,ATGATGAACAGTAGCGAGAT,0,2927398
ompRp4,0.5,1,1,ATGAGGACTTTCGTATGCTC,0,2927209
ompRp4,0.5,1,1,ATGAGAACAATGGTGTAATC,0,2913104
ompRp4,0.5,1,1,ATGAATTGGAGGGCGATATT,0,2937340
ompRp4,0.5,1,1,ATGAACTCCCGTTCGCTATG,0,2929219
ompRp4,0.5,1,1,ATCTTTAGCTCCTCGACGTT,0,2914861
ompRp4,0.5,1,1,ATCTGTATCCAGGCCGTGGG,0,2916893
ompRp4,0.5,1,1,ATCTGTACAGAACGTACTTC,0,2932665
ompRp4,0.5,1,1,ATCTGCTGACAGGTACCACG,0,2923704
ompRp4,0.5,1,1,ATCTGCCTGATCGTGACATT,0,2926494
ompRp4,0.5,1,1,ATCTCCAAGTAGCGTCACGA,0,2916627
ompRp4,0.5,1,1,ATCGTTAACCAGCTGTAAAA,0,2931941
ompRp4,0.5,1,1,ATCGTGGCCTTACCTCTGGT,0,2910863
ompRp4,0.5,1,1,ATCGTAAGATGAAACCCAGC,0,2930538
ompRp4,0.5,1,1,ATCGGGGGGAACTGGTACAC,0,2914374
ompRp4,0.5,1,1,ATCGGGCGCCTTCCTGCCAA,0,2921182
ompRp4,0.5,1,1,ATCGGATGTAACGTAGTTGT,0,2931003
ompRp4,0.5,1,1,ATCCGTCCACCCTGGTCTCG,0,2936658
ompRp4,0.5,1,1,ATCCCCGCTCGCCGAAACTG,0,2929334
ompRp4,0.5,1,1,ATCAGGCGTAACCGGACATA,0,2919656
ompRp4,0.5,1,1,ATCAGCGATCGAGGGACGGA,0,2907931
ompRp4,0.5,1,1,ATCAGCAAATCTGTTCTCTG,0,2925214
ompRp4,0.5,1,1,ATATCCCGGGAAATAGTAGG,0,2924855
ompRp4,0.5,1,1,ATATAATGCCGACCTCGATC,0,2915324
ompRp4,0.5,1,1,ATAGTCGGGTCGTAGGTCTA,0,2927295
ompRp4,0.5,1,1,ATACGTCGATAGATAGCAGG,0,2937652
ompRp4,0.5,1,1,ATACGCTGGGACGGAGAGTG,0,2931042
ompRp4,0.5,1,1,ATACCTCAGAGCCGTCACTG,0,2933980
ompRp4,0.5,1,1,ATACCGGAAGAAGCGAGCGG,0,2919291
ompRp4,0.5,1,1,ATACATTGGTGCCTGGCTTG,0,2937070
ompRp4,0.5,1,1,ATAAATTTCGTACGCGGGCA,0,2913453
ompRp4,0.5,1,1,ATAAAGCTGAGACCGCTGGG,0,2921824
ompRp4,0.5,1,1,AGTTTGAACGTACGGAGACA,0,2911607
ompRp4,0.5,1,1,AGTTTCTATTTCTATGCACT,0,2926097
ompRp4,0.5,1,1,AGTTGTCGCCGGGTAAAATT,0,2912255
ompRp4,0.5,1,1,AGTTCTCACTAGAATTAGCT,0,2911167
ompRp4,0.5,1,1,AGTTCCAGATAGAGCGGGTG,0,2908778
ompRp4,0.5,1,1,AGTTCATCTAGGTTCAGGAT,0,2932988
ompRp4,0.5,1,1,AGTTACAGTCCTCGGATTCG,0,2920557
ompRp4,0.5,1,1,AGTGTATAGTAAGACGAGCA,0,2933982
ompRp4,0.5,1,1,AGTGTAGGTTAACACTTTTA,0,2916655
ompRp4,0.5,1,1,AGTGTACCCATGTTTAGCGT,0,2938228
ompRp4,0.5,1,1,AGTGGCATACGCTTCGTAAT,0,2913055
ompRp4,0.5,1,1,AGTGCGGTCAGACGGAGCTT,0,2914265
ompRp4,0.5,1,1,AGTGACCTCAAGCTACCGAG,0,2911870
ompRp4,0.5,1,1,AGTCCGTCAACTCATGCAGT,0,2910871
ompRp4,0.5,1,1,AGTCCACGAATTTTACTCAC,0,2920088
ompRp4,0.5,1,1,AGTCACGGGGGAATGCCAGT,0,2925866
ompRp4,0.5,1,1,AGTATGTGCGGGGCTGACTT,0,2932021
ompRp4,0.5,1,1,AGTAGCTGGCTGTAATGCCA,0,2931072
ompRp4,0.5,1,1,AGTAGCCCGCCCACGGACTG,0,2929254
ompRp4,0.5,1,1,AGGTGCAATAGTTGGCTAGC,0,2924831
ompRp4,0.5,1,1,AGGTATCGTTGATTATTCTA,0,2932590
ompRp4,0.5,1,1,AGGGTTAATGCGGCGAGCGG,0,2933072
ompRp4,0.5,1,1,AGGGTGGCCATAAATTGTCG,0,2935907
ompRp4,0.5,1,1,AGGGTAAGCAGAGTACATGT,0,2921626
ompRp4,0.5,1,1,AGGGCATTGGCACTGACCTA,0,2909338
ompRp4,0.5,1,1,AGGGCACTCCTAGTCCTGGA,0,2909336
ompRp4,0.5,1,1,AGGCTGCCGAGTTTTCGATC,0,2928469
ompRp4,0.5,1,1,AGGCTCGTTCTCGGACGGCA,0,2921697
ompRp4,0.5,1,1,AGGCCCGAGCTCCGCGGAAT,0,2918536
ompRp4,0.5,1,1,AGGAGTTATAGGAATGTATT,0,2914969
ompRp4,0.5,1,1,AGGAGTCACCGTTGCCAGAA,0,2926046
ompRp4,0.5,1,1,AGGACGTACTGCCCCGCTTA,0,2917726
ompRp4,0.5,1,1,AGGACCATCTCCGCAATTAA,0,2919302
ompRp4,0.5,1,1,AGGAATTAAATTCAAGCGCT,0,2934897
ompRp4,0.5,1,1,AGCTTCGGTCCTCATGGGTT,0,2916446
ompRp4,0.5,1,1,AGCTTCACACACATTTGGAT,0,2919072
ompRp4,0.5,1,1,AGCTGCCTTGACAACGGGCG,0,2922663
ompRp4,0.5,1,1,AGCTAGGCTGCCAGTTTAGA,0,2931735
ompRp4,0.5,1,1,AGCGTCCTTTGCTATCCACA,0,2935036
ompRp4,0.5,1,1,AGCGTAGAACGGCAGAACAC,0,2936116
ompRp4,0.5,1,1,AGCGGGGCCTGTGAATGATG,0,2918545
ompRp4,0.5,1,1,AGCGGGCCCACCGTTCGACT,0,2913900
ompRp4,0.5,1,1,AGCGAAGAAACGCAGGTGGT,0,2931327
ompRp4,0.5,1,1,AGCCGTGGAAATAAACATAC,0,2934208
ompRp4,0.5,1,1,AGCCGTCTTTCAATAAGGTC,0,2915156
ompRp4,0.5,1,1,AGCCGGCTCCAGTGACCAGG,0,2934812
ompRp4,0.5,1,1,AGCCCTGAGTCCTCCATGAC,0,2911888
ompRp4,0.5,1,1,AGCCACTCTTGAGGGCGAAT,0,2935034
ompRp4,0.5,1,1,AGCATTAATAACAATGGAGG,0,2929682
ompRp4,0.5,1,1,AGCATGGGGTTGACACTATG,0,2927774
ompRp4,0.5,1,1,AGCACAAGGGCCGTACGTCG,0,2926374
ompRp4,0.5,1,1,AGATCCAGGGACCCATTGAA,0,2918037
ompRp4,0.5,1,1,AGAGTATTATCACAAGGGGA,0,2932810
ompRp4,0.5,1,1,AGAGATAAAAGTCCGATCGA,0,2927171
ompRp4,0.5,1,1,AGAGACGGACTCTCCTCTCG,0,2937355
ompRp4,0.5,1,1,AGACTTCCCAGCAGGAAGTC,0,2916874
ompRp4,0.5,1,1,AGACGGTCTTCATCAACGTG,0,2921848
ompRp4,0.5,1,1,AGACGCGAACGGTGAACGGC,0,2918996
ompRp4,0.5,1,1,AGACCTCGTATGAGCTGTCG,0,2915614
ompRp4,0.5,1,1,AGACCCAGTGTAATTGCAGC,0,2923167
ompRp4,0.5,1,1,AGACCAGGATCCTTGACCCA,0,2936480
ompRp4,0.5,1,1,AGACCAGCCGGATTAAGTTT,0,2935072
ompRp4,0.5,1,1,AGACAAATCTCTTTAGGGTC,0,2918051
ompRp4,0.5,1,1,AGAATCGTGTTTTGACCATC,0,2932464
ompRp4,0.5,1,1,AGAACTGATACGCTCTGTTG,0,2918592
ompRp4,0.5,1,1,AGAACGTCTCCTACCGCTAT,0,2912087
ompRp4,0.5,1,1,AGAACCCTGTACCAATCCAT,0,2916065
ompRp4,0.5,1,1,AGAAATCTGAGTTGGCGTTC,0,2932252
ompRp4,0.5,1,1,ACTTTTAGCTTTTATTACTA,0,2933353
ompRp4,0.5,1,1,ACTTTGGCCCATCCGTTTCT,0,2936740
ompRp4,0.5,1,1,ACTTTGCCGACGGCCTAGTC,0,2912345
ompRp4,0.5,1,1,ACTTTCGTATAAATCCAAAG,0,2927608
ompRp4,0.5,1,1,ACTTGAAGTACGGGGCTGAG,0,2933936
ompRp4,0.5,1,1,ACTGTTCGTCGTGCAATGAT,0,2937152
ompRp4,0.5,1,1,ACTGGGAAATACGCTCAGTA,0,2925209
ompRp4,0.5,1,1,ACTGCACCTTCGTGACCGGT,0,2931440
ompRp4,0.5,1,1,ACTGATTCGATTCGCAAACG,0,2933597
ompRp4,0.5,1,1,ACTCTCTTTATTGTTACCAT,0,2931674
ompRp4,0.5,1,1,ACTCTCTGCCGTATTCAAAA,0,2909738
ompRp4,0.5,1,1,ACTCCCGCTTACGGTGGATG,0,2935510
ompRp4,0.5,1,1,ACTATCACGAACGATTCAGC,0,2918001
ompRp4,0.5,1,1,ACTACGCGAAGTACCTACGT,0,2936600
ompRp4,0.5,1,1,ACTACGACCGTCCACGTGCG,0,2933134
ompRp4,0.5,1,1,ACTACCCTAGCAGAGGCTGG,0,2916084
ompRp4,0.5,1,1,ACTAATCTTGGTAACTGGGT,0,2909994
ompRp4,0.5,1,1,ACGTTTCATAAGGGATCGCC,0,2921358
ompRp4,0.5,1,1,ACGTGGCAAGCCGGCTAATA,0,2921955
ompRp4,0.5,1,1,ACGTCTATGAGTCATTTAAA,0,2929417
ompRp4,0.5,1,1,ACGGTGTAGGCAGAGCATTT,0,2911546
ompRp4,0.5,1,1,ACGGTGGACGCAGCATGGAT,0,2918653
ompRp4,0.5,1,1,ACGGGTTTTGGTTTGTCGAG,0,2928830
ompRp4,0.5,1,1,ACGGATGTTATGGTGACCTT,0,2918657
ompRp4,0.5,1,1,ACGGACTGGATACGTCCAAA,0,2936806
ompRp4,0.5,1,1,ACGCGTCCTATCGCTGCGGG,0,2927263
ompRp4,0.5,1,1,ACGCGAGCCCAGGCGACGTA,0,2921063
ompRp4,0.5,1,1,ACGCCTTCGATCGTCTGTAT,0,2923550
ompRp4,0.5,1,1,ACGCACCGTACGATCGAACG,0,2917972
ompRp4,0.5,1,1,ACGCAACGATACGGTAGCGT,0,2920432
ompRp4,0.5,1,1,ACGATCCGGTGAATATCTGC,0,2910032
ompRp4,0.5,1,1,ACGAGTCACAGGGGAACTAT,0,2912519
ompRp4,0.5,1,1,ACGAGCTTGTACCTATTGTA,0,2913660
ompRp4,0.5,1,1,ACGACTAAGACCCCGGCGTC,0,2936804
ompRp4,0.5,1,1,ACGACGTTCTTAAGGATGAG,0,2929943
ompRp4,0.5,1,1,ACGACATGCCCATAGGGTTT,0,2928640
ompRp4,0.5,1,1,ACGAACGGCTGTGGCTTGGG,0,2915518
ompRp4,0.5,1,1,ACCTTCGCGGTTGAACGGCC,0,2913941
ompRp4,0.5,1,1,ACCTGTGCGAATGGAGGGAT,0,2936374
ompRp4,0.5,1,1,ACCTGACTTAAATACCGGTC,0,2933333
ompRp4,0.5,1,1,ACCTGAACGATGTCGCCGTA,0,2935826
ompRp4,0.5,1,1,ACCTATCGAAACGTCTGGGT,0,2919049
ompRp4,0.5,1,1,ACCTAGGTATTAAAGCTGGG,0,2921851
ompRp4,0.5,1,1,ACCGTTGCCGTCGGTTCGAC,0,2916968
ompRp4,0.5,1,1,ACCGCTTGTAAAAAGTTCGT,0,2936772
ompRp4,0.5,1,1,ACCGCCAACTGTAGGTGGCA,0,2922736
ompRp4,0.5,1,1,ACCGCAACATCGAATACTTT,0,2924406
ompRp4,0.5,1,1,ACCGATTTATCCGCTATGAA,0,2923086
ompRp4,0.5,1,1,ACCGATGATGCCATTTCCAG,0,2937125
ompRp4,0.5,1,1,ACCGACTAATCTATCTAGCT,0,2908683
ompRp4,0.5,1,1,ACCCTTATTTTTGCGTTAAT,0,2920334
ompRp4,0.5,1,1,ACCCTATTCAAATGCCAGAG,0,2920803
ompRp4,0.5,1,1,ACCCGTTCCGCAGGGGTGCT,0,2913167
ompRp4,0.5,1,1,ACCCGGGGAGCTATCATCCC,0,2913199
ompRp4,0.5,1,1,ACCCGACTGGTAACAAAGAA,0,2923847
ompRp4,0.5,1,1,ACCACGTCAGCGTCAGCTGT,0,2922021
ompRp4,0.5,1,1,ACATATTAGAAATCCTCATT,0,2932297
ompRp4,0.5,1,1,ACATATGTTCTATGGAAAGG,0,2909247
ompRp4,0.5,1,1,ACATAACACTGTTAGGCCGT,0,2920546
ompRp4,0.5,1,1,ACAGTCTCTACGCAGCTGTT,0,2936745
ompRp4,0.5,1,1,ACAGGGCTCCAACTTGCAGA,0,2916963
ompRp4,0.5,1,1,ACAGAGGGAGTACGGCGGCT,0,2937728
ompRp4,0.5,1,1,ACACTGAGGCCTGTTTCTAA,0,2921502
ompRp4,0.5,1,1,ACACGCCAGTTGTATCTCAC,0,2938077
ompRp4,0.5,1,1,ACACAGGACCTTCATAATCT,0,2907945
ompRp4,0.5,1,1,ACACAATGTTTCGAAGCGGC,0,2913234
ompRp4,0.5,1,1,ACAAGTCTCGCCTCGCAGCA,0,2934831
ompRp4,0.5,1,1,ACAAGATATCGGAGGAACAC,0,2907800
ompRp4,0.5,1,1,ACAACCGTTGTAGTAGGCCC,0,2911426
ompRp4,0.5,1,1,AATTTCAAGTCGTCGTCGAT,0,2932349
ompRp4,0.5,1,1,AATTGCAAGTCATATCACGA,0,2908186
ompRp4,0.5,1,1,AATTCGACTCTTACTCTTGA,0,2935925
ompRp4,0.5,1,1,AATTCCTGCCCTCCCATAGC,0,2909680
ompRp4,0.5,1,1,AATTCCAGCGGCTTCGTGAG,0,2924378
ompRp4,0.5,1,1,AATTCAAGTAATGAAGAAAA,0,2927560
ompRp4,0.5,1,1,AATTCAACACTGTCTCGATA,0,2935224
ompRp4,0.5,1,1,AATGTGGGCTCTCAAACAAC,0,2933729
ompRp4,0.5,1,1,AATGCTTGAACCAAGTTAAC,0,2915329
ompRp4,0.5,1,1,AATGCCGTCCAGTTCGTTTG,0,2934547
ompRp4,0.5,1,1,AATGCAGAGGTGCTCGAGGG,0,2924266
ompRp4,0.5,1,1,AATGAGTATCTACAATGTCC,0,2923755
ompRp4,0.5,1,1,AATCGCAAGGGTACTGCAAC,0,2937589
ompRp4,0.5,1,1,AATCCCTGGTATCGGTTACC,0,2924122
ompRp4,0.5,1,1,AATATTATCGAACCCTTGAG,0,2930689
ompRp4,0.5,1,1,AATATACCAGCGAGCCGAGC,0,2911956
ompRp4,0.5,1,1,AATAATCACTCGACGCCAAT,0,2918084
ompRp4,0.5,1,1,AAGTTTCCACGCCTTATCCC,0,2919679
ompRp4,0.5,1,1,AAGTTGATTACGTCCCTCAG,0,2925516
ompRp4,0.5,1,1,AAGTGAGGACCTCCTGTCCT,0,2924798
ompRp4,0.5,1,1,AAGTCCCGTCGCGACCGGTC,0,2912737
ompRp4,0.5,1,1,AAGTCACTAGCTTTGCACGT,0,2917951
ompRp4,0.5,1,1,AAGTATTATATTTGAAGAGT,0,2922539
ompRp4,0.5,1,1,AAGTAGCATGGCTTGGGCTC,0,2910619
ompRp4,0.5,1,1,AAGGTGCTTGCATCTTGCAG,0,2922775
ompRp4,0.5,1,1,AAGGTGCCGTAGCGGTTGGA,0,2921890
ompRp4,0.5,1,1,AAGGTCACAAAAAGCCTTCA,0,2927343
ompRp4,0.5,1,1,AAGGCGCTTAATTGAAGTGT,0,2923705
ompRp4,0.5,1,1,AAGGCCATGGTTGAGCATGT,0,2916588
ompRp4,0.5,1,1,AAGGCAACACTCGGTGTCGT,0,2922470
ompRp4,0.5,1,1,AAGGACAGGAGATGACGGTC,0,2920483
ompRp4,0.5,1,1,AAGGAACGTGTAAGCGATCA,0,2936771
ompRp4,0.5,1,1,AAGCTTTGCCAGACCGCTCT,0,2912294
ompRp4,0.5,1,1,AAGCGTGCACCACCCCCTAA,0,2922778
ompRp4,0.5,1,1,AAGCATGGCGCAATTGTGCA,0,2927134
ompRp4,0.5,1,1,AAGCATAAAGGCTCCTCGCC,0,2913637
ompRp4,0.5,1,1,AAGATTTCACATTCAGCACT,0,2920255
ompRp4,0.5,1,1,AAGAGCCGCCAACTGCATCT,0,2935356
ompRp4,0.5,1,1,AACTGGGTGCCCTTTAGACC,0,2935320
ompRp4,0.5,1,1,AACTGCCAAAAGCCGTCTGT,0,2921218
ompRp4,0.5,1,1,AACTCGTACAGGAGGGACCA,0,2910836
ompRp4,0.5,1,1,AACTCAGAAGCAACTGGATT,0,2921701
ompRp4,0.5,1,1,AACTAGGGTCGGGACGTTCG,0,2915857
ompRp4,0.5,1,1,AACTAAACCGCAATGATGAC,0,2932592
ompRp4,0.5,1,1,AACGTTCAAAACGAATGGAA,0,2918890
ompRp4,0.5,1,1,AACGTACAGGGGACCCTGAC,0,2915941
ompRp4,0.5,1,1,AACGGTGCAAAGGCACTGTT,0,2929718
ompRp4,0.5,1,1,AACGGCGTACCAGGCTCTAA,0,2923656
ompRp4,0.5,1,1,AACGCTCCTCACGGCTGCCC,0,2918761
ompRp4,0.5,1,1,AACGCGCATCAGATTGCCTG,0,2936641
ompRp4,0.5,1,1,AACCGCCGACTGCATCGAGG,0,2921449
ompRp4,0.5,1,1,AACCAGGTGAAGTCCCTGCC,0,2924429
ompRp4,0.5,1,1,AACCAGGAGATGCGTATATC,0,2922812
ompRp4,0.5,1,1,AACCACGGAATGGTTATGTG,0,2938280
ompRp4,0.5,1,1,AACCACGCCCGGGTTCAGCG,0,2916207
ompRp4,0.5,1,1,AACATCCACATCTGGTGGTA,0,2924315
ompRp4,0.5,1,1,AACAGATGACCTTACTCGGC,0,2924965
ompRp4,0.5,1,1,AACACACACTGCTGGCAAGC,0,2911411
ompRp4,0.5,1,1,AACAAGTACGTGGCATTAAC,0,2933639
ompRp4,0.5,1,1,AAATTGTCTAAGTAATAAAG,0,2915250
ompRp4,0.5,1,1,AAATTCCAGCGAGGCGCCGT,0,2932220
ompRp4,0.5,1,1,AAATTATCCGAGGGAATCGT,0,2933983
ompRp4,0.5,1,1,AAATTAGTAGTTGAGATATT,0,2915412
ompRp4,0.5,1,1,AAATGGAGGGTCGCCACCGT,0,2937035
ompRp4,0.5,1,1,AAATGCCGTCCTGTGCGTAA,0,2929082
ompRp4,0.5,1,1,AAATCCCGTGCCTGAGTTCG,0,2928407
ompRp4,0.5,1,1,AAATCAGAAGTCTAGTCAAC,0,2930574
ompRp4,0.5,1,1,AAAGGGCTAGGTTATAGCAT,0,2927733
ompRp4,0.5,1,1,AAAGCCTTATATTGGGCGTA,0,2913105
ompRp4,0.5,1,1,AAAGCAGGAATATCAGGCCT,0,2924399
ompRp4,0.5,1,1,AAACTTAGTACAGACGAAGT,0,2914272
ompRp4,0.5,1,1,AAACTCTCGGTCGTTAAGGA,0,2919757
ompRp4,0.5,1,1,AAACGTTCTTTGGTCAGTCT,0,2925639
ompRp4,0.5,1,1,AAACGTGCCTGGGTGGCGAG,0,2909145
ompRp4,0.5,1,1,AAACGTCCTGAACTTCTTTT,0,2933786
ompRp4,0.5,1,1,AAACGAGTGCACGGCTTACT,0,2920351
ompRp4,0.5,1,1,AAAAGTGCAAAGTGTCAGGG,0,2935482
ompRp4,0.5,1,1,AAAACTTCCCTTACGTCGAG,0,2910398
ompRp4,0.5,1,1,AAAACTGGTGGCTTGAACGG,0,2908889
ompRp4,0.5,1,1,AAAACGCCGACTGGTAAGAC,0,2921913
ompRp4,0.5,1,1,AAAAATACTATGCAAGGCTT,0,2925931
ompRp4,307.0,306,0,CTCACCAGTGATAGGGCAGA,306,2911624
ompRp4,272.0,271,0,TCGTCAAGACCGATCTGAAG,271,2921360
ompRp4,261.0,260,0,AGGGCCAGTACCTGAGTGAT,260,2921746
ompRp4,252.0,251,0,CCGGTACTAGCTTCTGTTCA,251,2922360
ompRp4,247.0,246,0,TATGTCGGATGATTCGACCT,246,2926785
ompRp4,246.0,245,0,ACATAATTGATAGGTCAGAG,245,2912109
ompRp4,216.0,215,0,TCTACATTGGAAGTCCACCT,215,2918615
ompRp4,210.0,209,0,CCAAGCCGGGCGCGCTTCTG,209,2919518
ompRp4,200.0,199,0,TAGGAGTCTATACAGTGAAT,199,2929787
ompRp4,189.0,188,0,AAACTTGGAGTTCACATAGC,188,2922023
ompRp4,187.0,186,0,AGCACGCAACCCAGTGTGTA,186,2916165
ompRp4,187.0,186,0,AAACGGTACGCCCGCGATGT,186,2918728
ompRp4,181.0,180,0,ACAATGCACGTGCAGCACCA,180,2930729
ompRp4,175.0,174,0,CCTAACTCTATTAACCCAGG,174,2917758
ompRp4,172.0,171,0,TTCTGTCAAGCGCCGGTCAC,171,2927644
ompRp4,167.0,166,0,CACATATGGCATCAACGGGT,166,2936282
ompRp4,160.0,159,0,CTTCTGTACGGAAGGAGGTC,159,2936896
ompRp4,153.0,152,0,CCCGCTACTATGAAGCTCAT,152,2928219
ompRp4,150.0,149,0,TGCCATGCCCGTCAGTGATT,149,2930417
ompRp4,142.0,141,0,GACGCTCATAAGGCCTTTTT,141,2925550
ompRp4,140.0,139,0,TCTTAATCCAAGCCGAAACG,139,2926716
ompRp4,130.0,129,0,CAGCACGGCTTTTAATGTTA,129,2918405
ompRp4,129.0,128,0,TTTGATCCTCCTAGAAAGTA,128,2911637
ompRp4,126.0,125,0,TCCACACCTCCAAGATCTAA,125,2921189
ompRp4,123.0,122,0,GGAAAGTACGGCGTCCCGAG,122,2907857
ompRp4,123.0,122,0,AAGCCCCCGTACTAGAGCCC,122,2925501
ompRp4,122.0,121,0,CTGTAGCAATGAGTCGAGTG,121,2923143
ompRp4,120.0,119,0,GGGGGCAGGACTTCAATCGC,119,2921457
ompRp4,120.0,119,0,ACTTGTAACCGGTATGATAG,119,2919091
ompRp4,118.0,117,0,GCGCATGTTTAAAGTCGTAA,117,2936900
ompRp4,117.0,116,0,TCTCCCCTTACCGCTACTGA,116,2914485
ompRp4,116.0,115,0,GGCTTATAGGCTTTTTAGAT,115,2910139
ompRp4,112.0,111,0,TGCCTACCCTTTGAACACAT,111,2927057
ompRp4,112.0,111,0,TAAGCGGAAATGAAAGGTTG,111,2921445
ompRp4,109.0,108,0,AATTACTAGAGATAAACGAC,108,2909540
ompRp4,108.0,107,0,ACGGCCTGTGAATTATACTG,107,2923059
ompRp4,107.0,106,0,TAGGTTGAATTTTGCTTCTT,106,2915019
ompRp4,107.0,106,0,CTTTCAGCGGTCCAACACGT,106,2932444
ompRp4,107.0,106,0,CGATGTCCAGAGGTGTTTGG,106,2916240
ompRp4,106.0,105,0,GGTTATTTGGTTAACCCGGT,105,2914479
ompRp4,106.0,105,0,CGGAACCGGTCCCGGATAGA,105,2924377
ompRp4,105.0,104,0,TCGGCGGCAGCTGGTATCGT,104,2929749
ompRp4,105.0,104,0,CGTTTTGCAAAGGGCTCACC,104,2914313
ompRp4,105.0,104,0,ATTGTTGGTGGTAGTGCTAA,104,2911600
ompRp4,104.0,103,0,GTAGGTTTTCGGACAGTTAC,103,2910569
ompRp4,103.0,102,0,CCGACAAATCGGTTGCACGA,102,2923215
ompRp4,102.0,101,0,TGTGCGACGCGGAGATCACT,101,2916889
ompRp4,102.0,101,0,TCACGGTATTCAGCTGATTC,101,2929100
ompRp4,102.0,101,0,GTGGATAGCAAAGACGTGAA,101,2924183
ompRp4,102.0,101,0,ACAAGAGGTGAGAACTTGTG,101,2921663
ompRp4,101.0,100,0,AGCCGTCTGTTGATCAAATA,100,2916162
ompRp4,101.0,100,0,ACGCCCTTAACTTACAAACT,100,2915547
ompRp4,100.0,99,0,ATAGCCGTTGGAATCTCGCT,99,2923151
ompRp4,98.0,97,0,CAGTTAACAGAGATCCAGGA,97,2918715
ompRp4,96.0,95,0,TGCGAAGCAGTGCACGTTAG,95,2914437
ompRp4,96.0,95,0,GTGGGCTAAATACGGACCGC,95,2926540
ompRp4,96.0,95,0,AAGCAGGAGTGAGTATGCCG,95,2916378
ompRp4,94.0,93,0,CTAGTGAACACCTATTGGTT,93,2912141
ompRp4,94.0,93,0,CGATACTTCCACACCGTTCC,93,2911961
ompRp4,94.0,93,0,ACCATCATTTGAAGCAGAAT,93,2937047
ompRp4,94.0,93,0,AACACGATTTTGGGGATGAA,93,2917667
ompRp4,93.0,92,0,GGATAGGGTGATGGAGAGCG,92,2916037
ompRp4,93.0,92,0,CGGAAGAGCAGTTTTTGTTA,92,2919678
ompRp4,92.0,91,0,TTGACGACACGGATGTCGGT,91,2914383
ompRp4,92.0,91,0,CGAGGGCGCCGACCGGCAAT,91,2933439
ompRp4,92.0,91,0,ATAAAGTTGCTAGTCCATAT,91,2915185
ompRp4,91.0,90,0,GACTTCGTTAACGCTCCCAT,90,2910824
ompRp4,91.0,90,0,CAAAGACTGTAATCAGGTAT,90,2936918
ompRp4,90.0,89,0,CTTATGGTGCCCATCCCTTG,89,2914402
ompRp4,90.0,89,0,CGTGCTCGTACCTCTGGCGG,89,2927411
ompRp4,90.0,89,0,ATCCGAACTACTAAGGAAGC,89,2928516
ompRp4,89.0,88,0,CTCTACAACGATGAGCGCAT,88,2908138
ompRp4,89.0,88,0,CCTTAAATCCTAACGAACCC,88,2927230
ompRp4,89.0,88,0,AGGATCGTGTTGAGTTGCTT,88,2920983
ompRp4,88.0,87,0,TTGGACCCGGGCATGTATCA,87,2931787
ompRp4,88.0,87,0,ATAGGATTCGAAATTCAGGG,87,2918459
ompRp4,87.0,86,0,TGACTCATTGGATTAAGCTG,86,2926545
ompRp4,86.0,85,0,AATACAAGGAATTAAACCCT,85,2936598
ompRp4,86.0,85,0,AAGCCACAGTCCGATTTTAC,85,2909040
ompRp4,85.0,84,0,CGATCGCCGGACCATTCGGA,84,2921431
ompRp4,85.0,84,0,AGGTGATCCTATCATCTGAG,84,2935846
ompRp4,84.0,83,0,TTCAGGTGTTTGAGAAAAAA,83,2932666
ompRp4,84.0,83,0,TAGATAGAACATAGTCTGAA,83,2909102
ompRp4,83.0,82,0,TAAAGCGTACCACCCCTAGC,82,2919209
ompRp4,83.0,82,0,GCGGGATTACGTGCGTTTCT,82,2911450
ompRp4,82.0,81,0,CCTGTTCCGTCGCATTTAAT,81,2925211
ompRp4,81.0,80,0,GCCCAAGCAGGACTTCTCGA,80,2910926
ompRp4,81.0,80,0,AAAGGCTTGGTGGTGCGATA,80,2924486
ompRp4,80.0,79,0,TGGGGGCCAATAGGGGGGTA,79,2913797
ompRp4,80.0,79,0,CAGGAGAAAAATCAGTACTT,79,2913441
ompRp4,80.0,79,0,ACTATTCCCCAATCACTTAT,79,2913822
ompRp4,79.0,78,0,AGCATGCTGGTTCAGAGACT,78,2923940
ompRp4,79.0,78,0,AGAGTTGGTGCTTCAGGTCC,78,2935695
ompRp4,78.0,77,0,AAAACTTAGTGACCTAACAG,77,2914478
ompRp4,77.0,76,0,TGACCGTTGTTCGTATTATG,76,2919004
ompRp4,77.0,76,0,GAAACTCCGAGACTACGGTG,76,2909693
ompRp4,77.0,76,0,AGGCTAGCTAGATTCCAGGT,76,2936320
ompRp4,76.0,75,0,CACAGTCCAGCCGAAGGTCT,75,2922926
ompRp4,76.0,75,0,CAAGGGTTCACCCTTCACTT,75,2916589
ompRp4,75.0,74,0,TGAGGTTAGCAAGGAACCCT,74,2930244
ompRp4,75.0,74,0,CGTGGGGGGGCGGTCGGTCC,74,2920194
ompRp4,75.0,74,0,ATACGGGTCGAAAACTTTTC,74,2926635
ompRp4,75.0,74,0,ACGCAAAGTTCGGATGGTTG,74,2935053
ompRp4,74.0,73,0,TGGTAACAAACGATCGAAAG,73,2912708
ompRp4,74.0,73,0,TGAATTCAGAGCACACATAT,73,2922718
ompRp4,74.0,73,0,GGCACCGAGTGAATGGGTAA,73,2933257
ompRp4,74.0,73,0,CATTGTGTCATGATAGTTCT,73,2928231
ompRp4,73.0,72,0,TTTCCGGGGGTTCAAGTCCA,72,2926788
ompRp4,73.0,72,0,TTAGCGGATTCGGACCGAAG,72,2930608
ompRp4,72.0,71,0,TATCCACCAGTTATAGATTT,71,2925376
ompRp4,72.0,71,0,GGCTCCGAGTAGGTGTATGA,71,2936916
ompRp4,72.0,71,0,CTGCGCTGAATCACTAGGCT,71,2923146
ompRp4,72.0,71,0,CTCCTAGCACACCGAGACTA,71,2924157
ompRp4,72.0,71,0,ACGTTTTAGAACGGTCCAAA,71,2933711
ompRp4,71.0,70,0,TCCCCTACCCGGTGCATCAT,70,2910889
ompRp4,71.0,70,0,CCAACTATTTCCCAAATGGG,70,2926456
ompRp4,71.0,70,0,AGTTTCACCCGAACCAGTTG,70,2937771
ompRp4,70.0,69,0,TCGTATTGATATTTATATAA,69,2936756
ompRp4,70.0,69,0,TCGAACTTTCGGCTTTGCAT,69,2919069
ompRp4,70.0,69,0,TACACGTCCATTCTCGCGTT,69,2934036
ompRp4,70.0,69,0,GATAAGCGGAGTTCTTATGC,69,2919848
ompRp4,69.0,68,0,TGCTGCAGGGGATGCGTGGT,68,2937317
ompRp4,69.0,68,0,TCATCCTAAATCGTCATTGG,68,2921593
ompRp4,69.0,68,0,GTCGTACCGGCCTCACAGGG,68,2935868
ompRp4,69.0,68,0,GCTAGGCAACCGGCTAGACT,68,2918299
ompRp4,69.0,68,0,AGCAGCATGACAACCTTTGA,68,2914484
ompRp4,68.0,67,0,TCTGGCTGTGATCCCATACA,67,2923073
ompRp4,68.0,67,0,CGTACAAAGTTTTAGGAGCC,67,2917775
ompRp4,68.0,67,0,CGGTGATATAGGCGTTTGAA,67,2931276
ompRp4,68.0,67,0,CGATCGGCCAACTCCCATTG,67,2918686
ompRp4,68.0,67,0,ATGGTGGGGTTATTTGTGAA,67,2935274
ompRp4,67.0,66,0,TTGGCTAGAGCACGGCTTGC,66,2910790
ompRp4,67.0,66,0,GAAGGTGGCACGGTCCCTTC,66,2933691
ompRp4,67.0,66,0,CTACCTCTTTGTGTATTAGA,66,2934602
ompRp4,67.0,66,0,CGTATCTCGGGAGATTGGTG,66,2937976
ompRp4,67.0,66,0,CAGAATCGATACTCTCAAGA,66,2932688
ompRp4,67.0,66,0,CACGATCCCTCTTGCGACGT,66,2909385
ompRp4,67.0,66,0,CAAATCGGATCATGTACTAG,66,2910978
ompRp4,67.0,66,0,CAAAGCGTGGCGGCGTGCAG,66,2936312
ompRp4,67.0,66,0,ATGTGTAGATAAAGTGTCGG,66,2922098
ompRp4,67.0,66,0,AATTGTCTTTGGTTGATCTA,66,2910391
ompRp4,66.0,65,0,TGGAGTTCAGCATTCAATTG,65,2912686
ompRp4,66.0,65,0,TAGGCAGTATGGACTTGTGT,65,2925548
ompRp4,66.0,65,0,CGCCCGAAACGGTCCTAACG,65,2934775
ompRp4,66.0,65,0,AGGATTGCGGAACAAGCTAT,65,2921211
ompRp4,65.0,64,0,TGCTAAACCGCATAAGACCT,64,2908377
ompRp4,65.0,64,0,GTTTTCAGGGTAAAGCCAAA,64,2923777
ompRp4,65.0,64,0,CGTCAACGGGTTAATTCGCA,64,2914835
ompRp4,65.0,64,0,CGGACAAAATTTTCAATAAT,64,2929563
ompRp4,65.0,64,0,AGGTCAGCCTAATCAGATCA,64,2919087
ompRp4,65.0,64,0,AGACACAAATTGGAGAAGAT,64,2916126
ompRp4,65.0,64,0,ACGCGTAGGGCGAGCTATCT,64,2936468
ompRp4,65.0,64,0,ACGCGTAGATCTAACCCGTG,64,2917360
ompRp4,64.0,63,0,TCTTCCTGTTTATAAGTTAT,63,2910033
ompRp4,64.0,63,0,TAGCAGGGCATGGGTGTCAA,63,2925286
ompRp4,64.0,63,0,CGGTTTGGGTCGCATCCTAG,63,2932402
ompRp4,64.0,63,0,CCCTGATAGTGCTCGAATAA,63,2930275
ompRp4,64.0,63,0,CATTCCACTAAGCTTGTCTC,63,2928950
ompRp4,64.0,63,0,ACATCTGATTTCGGAAGCGT,63,2914353
ompRp4,64.0,63,0,AAATGATGCTTCTTTCCCGC,63,2914368
ompRp4,63.0,62,0,GCAATGTGCGTGGGCACCAA,62,2929074
ompRp4,63.0,62,0,GACATTACGACTTCGAGGCC,62,2910558
ompRp4,63.0,62,0,CCGAGTTCCACTCATAGGAG,62,2920545
ompRp4,63.0,62,0,AGGAATATTTTACTCCATGG,62,2910820
ompRp4,63.0,62,0,ACGGTAAGGGGTTTCCAATA,62,2916749
ompRp4,62.0,61,0,TGAGACGTTTAGTCACCAGA,61,2919346
ompRp4,62.0,61,0,TATCCTTTTCCCGCGTGCCG,61,2935619
ompRp4,62.0,61,0,GAGTCAGATACCGGCCTAAT,61,2916406
ompRp4,62.0,61,0,CGATGAGCGGAGAAACCAAA,61,2909548
ompRp4,62.0,61,0,CCAATATATGGCGACACGCT,61,2927112
ompRp4,62.0,61,0,CATTGTTCGATGATGAATAG,61,2927986
ompRp4,62.0,61,0,CACAGCTGATTGTAGGTCAA,61,2914384
ompRp4,61.0,60,0,TTACACATATTAAACTCCAT,60,2937387
ompRp4,61.0,60,0,CACTCAAGTCTCCAGCCACT,60,2922702
ompRp4,61.0,60,0,AACTCTGAGCCGGCGGCTAC,60,2922307
ompRp4,61.0,60,0,AAAGGACTTGTCGAACTGGA,60,2930145
ompRp4,60.0,59,0,TTGTGTCGCTGTTGCTAGAA,59,2935798
ompRp4,60.0,59,0,TTGGTATAAACAATGAAACT,59,2909311
ompRp4,60.0,59,0,TGTTGGAGAGGTAAAGCGTC,59,2917795
ompRp4,60.0,59,0,TGTGGGAGCAGTCTCATGGA,59,2918980
ompRp4,60.0,59,0,GTCACACCGAACACCGGGGT,59,2935222
ompRp4,60.0,59,0,GCCCTCTTAGGCACCGCACG,59,2920367
ompRp4,60.0,59,0,CTGCGGTGATCGGAGTGCTA,59,2935823
ompRp4,60.0,59,0,CCCAAAATGTACGGAGAATT,59,2912700
ompRp4,60.0,59,0,ATAATTGTTTTGCAAGAAAT,59,2911041
ompRp4,59.0,58,0,GTGGCAACGTTTGTGAAGGT,58,2913072
ompRp4,59.0,58,0,GTCTTCGGAAGATGGCGAAA,58,2909313
ompRp4,59.0,58,0,GCTTGTGTGAACGAACGAAT,58,2929575
ompRp4,59.0,58,0,CGGCGCGGGACGAGTCAATT,58,2916590
ompRp4,59.0,58,0,CCCTTTTCGATATAGGGTAG,58,2916419
ompRp4,59.0,58,0,CACGTTACGGTTGACTGAAG,58,2926787
ompRp4,59.0,58,0,CACACTCTATCGACCAAGTC,58,2913295
ompRp4,59.0,58,0,ATGGCCAGAGGGAGGTACCA,58,2933077
ompRp4,59.0,58,0,ATCGCGTAGGAGTTGTGGTT,58,2934225
ompRp4,59.0,58,0,ATAATGAATTGATCGGATTC,58,2921369
ompRp4,59.0,58,0,AATGCATGTGGGCGCCAATA,58,2916613
ompRp4,59.0,58,0,AAGGTATACCGTCGCTCATT,58,2923028
ompRp4,58.0,57,0,TTAAGGGTACTTCCATCTAT,57,2908760
ompRp4,58.0,57,0,TGGCGTTATCGAAGGGGTAG,57,2925495
ompRp4,58.0,57,0,TGCTAAACGTTGCATTGGTC,57,2928595
ompRp4,58.0,57,0,TCATTTCTCAAAACGCAACA,57,2910822
ompRp4,58.0,57,0,TAATGGGACAGGGATGCACT,57,2922694
ompRp4,58.0,57,0,GAAGGCACTGTTGCTGTAAA,57,2932956
ompRp4,58.0,57,0,ATGTCCCTACAGTCAGTTTT,57,2925130
ompRp4,57.0,56,0,TGTAGTTATGCGCGATCCAG,56,2913467
ompRp4,57.0,56,0,GGACTTATTTTATGTCTCAA,56,2916705
ompRp4,57.0,56,0,GCTTGGTAGGTAGCGGCTCA,56,2909349
ompRp4,57.0,56,0,GAGGTGTGTTGTCTGGCGGG,56,2911385
ompRp4,57.0,56,0,CCCAGGATTGAATTACTCCA,56,2932846
ompRp4,57.0,56,0,ATTCGCCGAAGATGCTTCTT,56,2936200
ompRp4,57.0,56,0,ATTAGACCACTTTCACAACT,56,2908421
ompRp4,57.0,56,0,ACTCCGGTTCAACCTGAAAC,56,2921477
ompRp4,57.0,56,0,ACCGCGCTCCAAAGTGATGT,56,2914938
ompRp4,57.0,56,0,ACACCCTACAGATAGTCAAA,56,2922216
ompRp4,57.0,56,0,AAGCAATAAGTAGCAGGCAA,56,2920004
ompRp4,56.0,55,0,TGTGTGCAGTACATCTGCGC,55,2918460
ompRp4,56.0,55,0,TCTTGTACCTCCCTAGTAAT,55,2930514
ompRp4,56.0,55,0,TCCGGCATCCATACCAGGGG,55,2925228
ompRp4,56.0,55,0,TCAACAACCAAAAAGGTGTG,55,2925500
ompRp4,56.0,55,0,GGGTATGAGCGTTCTTCTAT,55,2932435
ompRp4,56.0,55,0,GGACCGTATCACAAAGGCTT,55,2909669
ompRp4,56.0,55,0,GGACAGCAATCTATCTGCCT,55,2932430
ompRp4,56.0,55,0,GCGATGGCCTCGGGAGGATT,55,2937220
ompRp4,56.0,55,0,CGTCACCACATCGGTGGCGT,55,2919030
ompRp4,55.0,54,0,TCTTCGGGCGATCCTTTCGT,54,2911178
ompRp4,55.0,54,0,TATCAGAAAGGCGGCCCGTA,54,2934107
ompRp4,55.0,54,0,TAGAGCAAGACACGATGGAA,54,2931719
ompRp4,55.0,54,0,GTAATGTCAGGGCCACGTAG,54,2928406
ompRp4,55.0,54,0,CTCATGCTCCAATGGTCTGG,54,2911155
ompRp4,55.0,54,0,CGCTGACTACCCGGTTCCAA,54,2910663
ompRp4,55.0,54,0,ATCATTCTCATGGACTCGAT,54,2927634
ompRp4,55.0,54,0,AGCGGCCCGAGTGCCAAACT,54,2920089
ompRp4,55.0,54,0,AGACTATGCTGGGGGGATCA,54,2934407
ompRp4,55.0,54,0,ACTTTCCACTGCGTAACAAT,54,2924184
ompRp4,55.0,54,0,ACACTGTGATAGCTTAGGAA,54,2909632
ompRp4,55.0,54,0,AACGGCACTGTTTTTCTTAA,54,2925245
ompRp4,55.0,54,0,AACCTCAGGTTGGCACGCAG,54,2923645
ompRp4,54.0,53,0,TTCAAATATGGTTAATTGTT,53,2910372
ompRp4,54.0,53,0,TGTACGCACCCGGTTGTGTG,53,2910862
ompRp4,54.0,53,0,TATTCGAAAATTTTCTGTTT,53,2918346
ompRp4,54.0,53,0,TATGCGGCATATCGCTGAGT,53,2918372
ompRp4,54.0,53,0,TAGAGTGATGTTAGATTTGT,53,2930083
ompRp4,54.0,53,0,GTTGAGGGAATAAGTTCGAT,53,2917163
ompRp4,54.0,53,0,GCAAGCCCTAAAAGCATACT,53,2917999
ompRp4,54.0,53,0,GAACCCATTTAATGTGAACA,53,2921571
ompRp4,54.0,53,0,CGCCGTAGAGCATCCCTTTG,53,2933968
ompRp4,54.0,53,0,ACAACAAGCGGCCTGTTGAA,53,2927718
ompRp4,54.0,53,0,AACTATAGTGTCCGGCCGCA,53,2922226
ompRp4,53.0,52,0,TTTGTACCGTGGGAGTAACG,52,2908721
ompRp4,53.0,52,0,TTTAAATGGCACTAGCAAAT,52,2938221
ompRp4,53.0,52,0,TTGCGTGATTAACTTCCGGC,52,2916040
ompRp4,53.0,52,0,TTAACATGGATCGGACTCAC,52,2925349
ompRp4,53.0,52,0,TCGCTTTCGAACGGTTGATC,52,2916591
ompRp4,53.0,52,0,TCCTAGAAATTCGTCCCGCT,52,2929055
ompRp4,53.0,52,0,TAAATCATCCATCTACCTAA,52,2930946
ompRp4,53.0,52,0,GCTTGCTAAGCTTAGTGCCC,52,2935858
ompRp4,53.0,52,0,GCGCTTGGATGTGGCTTCTA,52,2918532
ompRp4,53.0,52,0,CGAGCTTGGTGCTCGTAGAT,52,2938300
ompRp4,53.0,52,0,CCGTTGGGCAAGTCATCCGA,52,2932975
ompRp4,53.0,52,0,ATATGAAGTGACCGGGATAG,52,2913592
ompRp4,52.0,51,0,TGTACCCATCATGCAATCCT,51,2913172
ompRp4,52.0,51,0,TGACCGACCAGCCGGCTAAA,51,2924829
ompRp4,52.0,51,0,TCTGTGTGGTATAGGTTTAG,51,2927238
ompRp4,52.0,51,0,TATTTGCGGCTCCGTGGCAA,51,2926619
ompRp4,52.0,51,0,GTGCTCAGTCTTCAAAAAGT,51,2910582
ompRp4,52.0,51,0,GGTGTAAGTTTGCCACCCGA,51,2915348
ompRp4,52.0,51,0,GCATAGTCGGCAGTTTTGCC,51,2921214
ompRp4,52.0,51,0,GAGTCTTTTCGACGTGCGAG,51,2909219
ompRp4,52.0,51,0,GAGGTCGATTTTTTATGCAA,51,2925351
ompRp4,52.0,51,0,CTTTCGAAATCCCAACATCG,51,2922714
ompRp4,52.0,51,0,CGCGGTTGAGCACTCATGGG,51,2929581
ompRp4,52.0,51,0,CATGCTGTTGTACACCCGGT,51,2935620
ompRp4,52.0,51,0,ATGCAACTAAATAAAGCACT,51,2932160
ompRp4,52.0,51,0,ATCAACTCGCCTGAGCGATC,51,2920525
ompRp4,52.0,51,0,AGTACGCGGTGAGGACGCAA,51,2915774
ompRp4,52.0,51,0,AGCTGTCTTGCAAGAAGAGT,51,2935890
ompRp4,51.0,50,0,TTTGGCCGGTAGCCCATCCG,50,2908896
ompRp4,51.0,50,0,TTCCGCAATGTATGTACCTA,50,2926415
ompRp4,51.0,50,0,TGCCAAGGGGAGATGTTTTG,50,2914115
ompRp4,51.0,50,0,TCCACAGAGCAAACAGCGGG,50,2930765
ompRp4,51.0,50,0,GTGATGCTGGTTGACTAAAG,50,2919797
ompRp4,51.0,50,0,GCGTTAGAATCTTATGGGAA,50,2913284
ompRp4,51.0,50,0,GAGCAAATGAGCTTCGCAGC,50,2926931
ompRp4,51.0,50,0,GACTTGTTGGTGTTAGTTTA,50,2917990
ompRp4,51.0,50,0,CTAGGGAGCACTAGCCTATA,50,2907864
ompRp4,51.0,50,0,CGTAGAGTGGAGCGCCACAT,50,2936377
ompRp4,51.0,50,0,CGGGGGTATCATCCCAGCGG,50,2917712
ompRp4,51.0,50,0,CCTATTCATCCTATCAGTGG,50,2907805
ompRp4,51.0,50,0,CCGGAAAAATCGAGGGTGGA,50,2924282
ompRp4,51.0,50,0,CCGCTTCGGAGCGAGTCCTA,50,2910899
ompRp4,51.0,50,0,CCGAGCCCGGTAATTTCGAG,50,2935152
ompRp4,51.0,50,0,CCATGGATATTTGATTATCG,50,2910245
ompRp4,51.0,50,0,CCATAAGAGCGGCTGTGGTC,50,2934368
ompRp4,51.0,50,0,ATGTAAACGTCGCTCGCTAA,50,2927287
ompRp4,51.0,50,0,AGCAGGCGGCAGTCTTTCAT,50,2924318
ompRp4,50.0,49,0,TCCTTCATGTAGACATTTCC,49,2927045
ompRp4,50.0,49,0,TCAATTCAGCTGAGTAGCCT,49,2932125
ompRp4,50.0,49,0,TACAATGTTGCCGCCTGGTG,49,2909111
ompRp4,50.0,49,0,GTGAGATGCGGTTAACTCCT,49,2909013
ompRp4,50.0,49,0,GGTTCATCAGGAATCATAAC,49,2927714
ompRp4,50.0,49,0,GCCGTACAAGCCCTGCGTTA,49,2933887
ompRp4,50.0,49,0,GATGCGCGCGGGTCATAGTA,49,2925027
ompRp4,50.0,49,0,GAAAGTAAGTGTGCTAGTCT,49,2938171
ompRp4,50.0,49,0,CTGATCCCGGGTGTTGGGTC,49,2916531
ompRp4,50.0,49,0,CGTATGCAAAGGGTCCAGAA,49,2921153
ompRp4,50.0,49,0,CGACCTACTATAGTCACACC,49,2908379
ompRp4,50.0,49,0,CACGATACTTAGCTCCGTTG,49,2921327
ompRp4,50.0,49,0,CACCGGACGGCATGATGATT,49,2910935
ompRp4,50.0,49,0,ATCCTACAATCAGGTTGGTA,49,2935295
ompRp4,50.0,49,0,AACTGAATTGTGGAATTTTA,49,2932253
ompRp4,49.0,48,0,TGTCTCGCCCGGATATCCTG,48,2932543
ompRp4,49.0,48,0,TCAGTGTGAAAGACCTTCGC,48,2922403
ompRp4,49.0,48,0,TATTATATTTTATATTAATT,48,2910481
ompRp4,49.0,48,0,GTTGAAATCGCGGGTTAATT,48,2923407
ompRp4,49.0,48,0,GTGCACCGCGGCAAAACAGC,48,2914642
ompRp4,49.0,48,0,CTATGACGTCACGCTTCGAT,48,2926110
ompRp4,49.0,48,0,CGGGCTGATGTAAGAAGAAA,48,2908249
ompRp4,49.0,48,0,CCTCGGTCCACTGATGTAAT,48,2913530
ompRp4,49.0,48,0,CAAGTCTGACAGAACGACAC,48,2921733
ompRp4,49.0,48,0,CAAGGCGGTTACGTCGAAGG,48,2921047
ompRp4,49.0,48,0,CAACTTCACACTAAGCGGCG,48,2918136
ompRp4,49.0,48,0,ACTTACGGGGCTACGAGTGG,48,2928233
ompRp4,48.0,47,0,TATCAACAGTACAATCAATA,47,2926964
ompRp4,48.0,47,0,TAATAGTCCAGGGTATATCC,47,2921048
ompRp4,48.0,47,0,GACCCGTAACCACTTAAAGG,47,2912863
ompRp4,48.0,47,0,GAATGTTTCGGGTGCCCCGG,47,2927623
ompRp4,48.0,47,0,CTTTGATAACCCCCTTTATC,47,2912948
ompRp4,48.0,47,0,CTTCAGGGCTCGCGTTAGAT,47,2926654
ompRp4,48.0,47,0,CTGTGCGTATAAATGGTATC,47,2929317
ompRp4,48.0,47,0,CTGGTATACAGCGGGGGTGT,47,2933745
ompRp4,48.0,47,0,CGATAACAGTAGTTCGCCTA,47,2917931
ompRp4,48.0,47,0,CGAGCCAAACACAACTTAGA,47,2921484
ompRp4,48.0,47,0,CGACAATCGCCGACCTTACA,47,2910615
ompRp4,48.0,47,0,CCGATCATAGGGACGCTGAG,47,2908573
ompRp4,48.0,47,0,CCCTCGAAGTGCTATTTCAT,47,2928638
ompRp4,48.0,47,0,CACGAGGGCACTTGGACTTT,47,2910560
ompRp4,48.0,47,0,AGTGCACGTATTGATTTCTG,47,2927216
ompRp4,48.0,47,0,AGTACGTGTAAGCAAGGTAT,47,2926283
ompRp4,48.0,47,0,ACTTCCTCTCTAGCTCCGTA,47,2928723
ompRp4,48.0,47,0,ACGAGTAGGACCGTATGGGC,47,2933629
ompRp4,48.0,47,0,ACCCTCGTGCACACCCGCGT,47,2921121
ompRp4,48.0,47,0,AATAAATTTCAATACCATAG,47,2918268
ompRp4,47.0,46,0,TTTGGATAGCCTGCTTTCGA,46,2908304
ompRp4,47.0,46,0,TTCTGCTTAGAAGATCCTTT,46,2926593
ompRp4,47.0,46,0,TTCCTTTCACGTATTAAACC,46,2928740
ompRp4,47.0,46,0,TTAATGCTGGTTTACAGCCC,46,2928924
ompRp4,47.0,46,0,TCGCTTGAGCTATACCGGAA,46,2929212
ompRp4,47.0,46,0,GACCACAGATCTATGAGATG,46,2925849
ompRp4,47.0,46,0,ATGTTGTAGACCTTGACCCA,46,2929593
ompRp4,47.0,46,0,AGTCCCTAGCCGAGCAAGAT,46,2909515
ompRp4,47.0,46,0,ACTAAAGGTACGCCTTGAGC,46,2911482
ompRp4,47.0,46,0,ACGGTAAGTATGCGAACCAC,46,2917591
ompRp4,47.0,46,0,ACACGTCAAGGCTCCCAGAA,46,2921511
ompRp4,47.0,46,0,AATTAAGCTGTCTGATTGGC,46,2910840
ompRp4,47.0,46,0,AATGCCTCGCCTGAATCCGT,46,2930567
ompRp4,47.0,46,0,AAGAGCTTTCAGGACCACAT,46,2917083
ompRp4,47.0,46,0,AACGCCCGAGCTTACATCAA,46,2920745
ompRp4,46.0,45,0,TTTAATACGTCTCGCATAGT,45,2928435
ompRp4,46.0,45,0,TGCATGCGGCCTTGTTACGG,45,2936966
ompRp4,46.0,45,0,TCTAACCCGTTGCGGTGAGA,45,2929944
ompRp4,46.0,45,0,TCGGCTGAAGACACTTATTA,45,2921105
ompRp4,46.0,45,0,GTTTTCACAATGTAGAAGTA,45,2913168
ompRp4,46.0,45,0,GTATGAGAACCGGTGTATGA,45,2936817
ompRp4,46.0,45,0,GGTAGATTGAACCGCTCACG,45,2911981
ompRp4,46.0,45,0,GGGCTGCCAGGCAAGGCTGA,45,2927126
ompRp4,46.0,45,0,GGCTACACTCTCTGTCGAGA,45,2925445
ompRp4,46.0,45,0,GCGTGTCAACACTTGCATCT,45,2937712
ompRp4,46.0,45,0,GCCTGGTTTTTCTTGGGTGC,45,2919743
ompRp4,46.0,45,0,GCCTGAATAATCTCCCATCT,45,2907696
ompRp4,46.0,45,0,GAGTGTCGCGAAGCCATCGG,45,2931757
ompRp4,46.0,45,0,GAGGTAAATAAGAGTCATTA,45,2932571
ompRp4,46.0,45,0,GACATGACGTTTTAACCGAG,45,2931363
ompRp4,46.0,45,0,CTTTTCTGGCATCGCACCTG,45,2932867
ompRp4,46.0,45,0,CTAGATAGAGAACGTCGTTT,45,2938142
ompRp4,46.0,45,0,CCTTCGGTTGGCGCAACGTG,45,2914659
ompRp4,46.0,45,0,CATTAATTCACAAACTAACG,45,2915624
ompRp4,46.0,45,0,ATGATACATCGGGATTGGGT,45,2914488
ompRp4,46.0,45,0,AGTTCCAGGTACCGCCCCAT,45,2913519
ompRp4,46.0,45,0,AGGTCGAACCCAGCAACCCA,45,2938119
ompRp4,46.0,45,0,AGCACTGCGGCTAGTTTCCC,45,2913522
ompRp4,46.0,45,0,AAAGCCCTGATACCGGCTTC,45,2926509
ompRp4,45.0,44,0,TTACCTGTAGTTATTTGCGA,44,2909307
ompRp4,45.0,44,0,TGCGACGCGGCGCACATGCC,44,2928778
ompRp4,45.0,44,0,TAACACTCCCCCTACTCGTC,44,2916006
ompRp4,45.0,44,0,GTTCATATTGGTGGATCGCC,44,2919503
ompRp4,45.0,44,0,GTCAGGACACCATTGTGAAC,44,2923749
ompRp4,45.0,44,0,GGCCCGAACTTTTACGCAAC,44,2911641
ompRp4,45.0,44,0,GACTAGAGTGGAGGACAAAC,44,2931245
ompRp4,45.0,44,0,GAATCACCGTATGCTGGAAT,44,2924086
ompRp4,45.0,44,0,CGGTTGTCTTCGATTAACAT,44,2936932
ompRp4,45.0,44,0,CGCAATAAATCGGTTAGGAA,44,2932958
ompRp4,45.0,44,0,CAGCGCAATGGTCCTCCTGT,44,2932658
ompRp4,45.0,44,0,CACCTAGTTATTTCTCATAT,44,2928424
ompRp4,45.0,44,0,ATTTCACCGGCCTAGTTAAA,44,2922482
ompRp4,45.0,44,0,ATTCATACCCAGGCATCGAT,44,2921646
ompRp4,45.0,44,0,ATAGTATGTTACTCCAGGTT,44,2922555
ompRp4,45.0,44,0,AGTCTTAAGATCACAGAGCA,44,2931344
ompRp4,45.0,44,0,AGGACTTTATGTAGGGTCCG,44,2916784
ompRp4,45.0,44,0,ACGTCTGGAAAATTGGAAAG,44,2924884
ompRp4,45.0,44,0,ACGATAGGCCATCCTAATCA,44,2914714
ompRp4,45.0,44,0,ACCTGCCGACCTAGGAATCC,44,2923688
ompRp4,45.0,44,0,AAAAGTTATTTTGCCGTCTG,44,2919214
ompRp4,44.0,43,0,TTTGTACCAACCGGACGGTA,43,2915415
ompRp4,44.0,43,0,TTCCGTTTAGGCTGTAATAT,43,2922198
ompRp4,44.0,43,0,TCTTTTTTCCATGCGTGGTT,43,2936905
ompRp4,44.0,43,0,TAAACACGCTTATGTGCAAT,43,2936222
ompRp4,44.0,43,0,GTTAGTTAACGCCATCGATT,43,2911688
ompRp4,44.0,43,0,GTTAAAGTCCAGCTATAAGC,43,2927906
ompRp4,44.0,43,0,GTGGAGAACGTGGCAAATAT,43,2917086
ompRp4,44.0,43,0,GTCTACATGCATCTTGAACT,43,2920369
ompRp4,44.0,43,0,GGTTTTTGGAATGCCACGGA,43,2919976
ompRp4,44.0,43,0,GCTTCGCGGACGGCACGAGT,43,2910224
ompRp4,44.0,43,0,GCGTGCATCAGTCCGATATT,43,2915871
ompRp4,44.0,43,0,GCATACCCTCGCTGGGTTTC,43,2916387
ompRp4,44.0,43,0,GACTCATCCGTGCTAAGCGG,43,2930828
ompRp4,44.0,43,0,GAATGCCTCACAGTGTACTA,43,2910639
ompRp4,44.0,43,0,CTATCAGGGTCGCTGTAAGC,43,2908367
ompRp4,44.0,43,0,CTAGAATTTGTGACTCCTGG,43,2920295
ompRp4,44.0,43,0,CTACATCTCGCCGAACCCAC,43,2927421
ompRp4,44.0,43,0,CGTCTATGCATTATTTCAGA,43,2909974
ompRp4,44.0,43,0,CGGGATTCGTATCACTCCCC,43,2915076
ompRp4,44.0,43,0,CGAGGTGCGTCCTCCATCCG,43,2927638
ompRp4,44.0,43,0,CCGAGGGTGAAAGCTTAGGC,43,2910307
ompRp4,44.0,43,0,CCCGGAGTGCGGAAGAGTAC,43,2928953
ompRp4,44.0,43,0,CAGTTTATCTCAGACCGTGA,43,2914901
ompRp4,44.0,43,0,ATTGTTCAGACCGCCTCACA,43,2934354
ompRp4,44.0,43,0,ATAAAACAGATCTGCAGAAC,43,2934108
ompRp4,44.0,43,0,AGTACAAGTGCTAGAGGGGG,43,2917796
ompRp4,44.0,43,0,ACGAATCAAGCCACCAACGC,43,2913586
ompRp4,44.0,43,0,ACCACCCAGAAATTCGTTCC,43,2924466
ompRp4,44.0,43,0,AACTCGTATCATTGTTCCTA,43,2918877
ompRp4,43.0,42,0,TTCTCGACTAAATTCCGCTC,42,2908751
ompRp4,43.0,42,0,TGGGTTACTGTATGCAGCCT,42,2931646
ompRp4,43.0,42,0,TGGGCAACATTCCAGAGGAG,42,2914177
ompRp4,43.0,42,0,TCTCCAGCACCTCCCCAGAA,42,2918767
ompRp4,43.0,42,0,TCGGAACATGGTTTCTTCAC,42,2924219
ompRp4,43.0,42,0,TCCCAATTCTCTGGATGAGC,42,2922889
ompRp4,43.0,42,0,TCACATACATTCATTACATA,42,2913139
ompRp4,43.0,42,0,GTGTTTTTCGGACCACGCAG,42,2909896
ompRp4,43.0,42,0,GTGCAACGGACTGAACGTCG,42,2930948
ompRp4,43.0,42,0,GGGCATGCAGGGTTTGTGCA,42,2922313
ompRp4,43.0,42,0,GGAGCGTAAACTCTGCTGGA,42,2917582
ompRp4,43.0,42,0,GGAGATCATACAATGCTGGA,42,2919504
ompRp4,43.0,42,0,GCTCCGCAAAGGTTTACTTG,42,2932784
ompRp4,43.0,42,0,GCATTGGATGCAATTGATCT,42,2937202
ompRp4,43.0,42,0,GAAACTCCTGTTTTCAATAG,42,2916415
ompRp4,43.0,42,0,CGGTGCCTTTCAGAACAAAC,42,2935876
ompRp4,43.0,42,0,CGGAAGTAATCTTCCATGCC,42,2925085
ompRp4,43.0,42,0,CGAATTGGACGTCGTCTATG,42,2929714
ompRp4,43.0,42,0,CACCTCCCCTCATTAGAAGC,42,2912485
ompRp4,43.0,42,0,CACCGATGACAGGATAAGGT,42,2910890
ompRp4,43.0,42,0,AGTGGAACAATATACCCGTA,42,2928061
ompRp4,43.0,42,0,ACTCATCGCACATACTTTTA,42,2933109
ompRp4,43.0,42,0,ACGGTGAACGTAGAGGGATC,42,2936713
ompRp4,43.0,42,0,ACACAGGGTGGTAATAGCAT,42,2923642
ompRp4,42.0,41,0,TTTGTGTTTTGCCCACCGAT,41,2912899
ompRp4,42.0,41,0,TTTCGTCTAACGCGTTGTGT,41,2920567
ompRp4,42.0,41,0,TGAGGGTCCGCCTAATTCCT,41,2929056
ompRp4,42.0,41,0,GTCGGTACATTTTGGAGTGT,41,2927782
ompRp4,42.0,41,0,GCGTTGAGTTCGTACCTGGG,41,2929347
ompRp4,42.0,41,0,GACACCGGTCAGTAATAGGG,41,2911356
ompRp4,42.0,41,0,CGGGTGATAGAAATAATTCA,41,2920829
ompRp4,42.0,41,0,CGCTACGTGTAATGAGGCTG,41,2916163
ompRp4,42.0,41,0,CCCACCAGTTTCAACGACGC,41,2907783
ompRp4,42.0,41,0,ATATAGTCAACGGCTACAAC,41,2910981
ompRp4,42.0,41,0,AGCTCAGGAGGCTTCCGCCT,41,2922338
ompRp4,42.0,41,0,AAGACCTCTTTGTGCTTGTC,41,2921738
ompRp4,42.0,41,0,AAAGCTGCTTAACCATCCAC,41,2908381
ompRp4,41.0,40,0,TTAGTAATAAATCCGATCCT,40,2937624
ompRp4,41.0,40,0,TGTACAACGCTCACGCTCTC,40,2919172
ompRp4,41.0,40,0,TCTTGAATTGGGGGTCTCTC,40,2923954
ompRp4,41.0,40,0,TCAGTTTGCGCGTTAGCGTT,40,2930339
ompRp4,41.0,40,0,TCACACTAGGCAAGGCTTAA,40,2928223
ompRp4,41.0,40,0,TACCTCATACGACGCAGTTG,40,2917464
ompRp4,41.0,40,0,TACCCATCATATTAGTTTTG,40,2908830
ompRp4,41.0,40,0,GTCGGCAGTCCAATTACTGT,40,2910579
ompRp4,41.0,40,0,GTCATAACAACATATCCTCT,40,2935114
ompRp4,41.0,40,0,GTAGAATCCGCATAGAAAAC,40,2937058
ompRp4,41.0,40,0,GGGATGGCGTGTTCGCTCAG,40,2930168
ompRp4,41.0,40,0,GCTAATCATTGCCTCAGATG,40,2922237
ompRp4,41.0,40,0,GCCGACAGCCCCAGGCTTGG,40,2935033
ompRp4,41.0,40,0,CGTACGCCGTTCAAGGGATC,40,2920339
ompRp4,41.0,40,0,CCTCCGTTTGACCACTGCAA,40,2921222
ompRp4,41.0,40,0,CCGCAGGCGTGGCAACTCAG,40,2938191
ompRp4,41.0,40,0,CCATCCTGAAGAATCAACGC,40,2930836
ompRp4,41.0,40,0,CCACGGAAATGGTGGGCTTA,40,2938087
ompRp4,41.0,40,0,ATTATGATAAATGTATATAC,40,2922371
ompRp4,41.0,40,0,ATGTTGGCACAGTGGATAAT,40,2909014
ompRp4,41.0,40,0,ACGATTGACGAGTTCCTCAC,40,2929125
ompRp4,41.0,40,0,AAAGTAGTCTTCTCGCGTCA,40,2934005
ompRp4,41.0,40,0,AAAATGATCGCGTATTTTGC,40,2919926
ompRp4,40.0,39,0,TTGCCCCTAAATTCTGCATG,39,2930062
ompRp4,40.0,39,0,TGCACTTCGAAGATCAATAA,39,2910102
ompRp4,40.0,39,0,TGATCCATCTGGACCTAGCA,39,2919765
ompRp4,40.0,39,0,TCCGGTTTGCAAATACCTGA,39,2936012
ompRp4,40.0,39,0,TCCGGCCTCAGGGCGGACTT,39,2930733
ompRp4,40.0,39,0,TAGCCACGGTTAGCTTCAAG,39,2936125
ompRp4,40.0,39,0,TAATATGCCCGCCTCCCAGG,39,2923025
ompRp4,40.0,39,0,TAAGCAGTACGGGGGGGGAA,39,2923620
ompRp4,40.0,39,0,GTTGCACCTAAAACTGAAAA,39,2934394
ompRp4,40.0,39,0,GTTCATACAGATCCCCTAGG,39,2911643
ompRp4,40.0,39,0,GTAATCCTACATGAGATTAG,39,2909564
ompRp4,40.0,39,0,GGTTTCTTGCACGCGTACCC,39,2917797
ompRp4,40.0,39,0,GGGACAGAAGGTATCGGACC,39,2926811
ompRp4,40.0,39,0,GCAGACAAAGGCGCCAGCCC,39,2911517
ompRp4,40.0,39,0,CTTCGCAGGCATACGGAGGT,39,2934214
ompRp4,40.0,39,0,CTCTGTTTAACCCCGTTCCT,39,2921226
ompRp4,40.0,39,0,CGTTGCTTTGCGGTTTATAT,39,2935267
ompRp4,40.0,39,0,CCGTTCACCGTATAGTTATC,39,2933707
ompRp4,40.0,39,0,CAGAACAAAATGTAGTTGTC,39,2931573
ompRp4,40.0,39,0,ATTTGATAACGTATGTGAAC,39,2928553
ompRp4,40.0,39,0,ATGTAAGCCATCATTCTTTC,39,2923009
ompRp4,40.0,39,0,ATGAGCATTGGACTCTCCTA,39,2926215
ompRp4,40.0,39,0,AGGTTCTCAACATAGGACTT,39,2936915
ompRp4,40.0,39,0,AGGTGAATGTCGGATACACT,39,2926983
ompRp4,40.0,39,0,AAGGTTATGTCCGCATCAGA,39,2917131
ompRp4,40.0,39,0,AAGGGCCAACACTGGTATTA,39,2925619
ompRp4,40.0,39,0,AAACATCAGGACCTCAGATA,39,2916369
ompRp4,39.0,38,0,TCCAGCCGAGCTGTCTTGGT,38,2910034
ompRp4,39.0,38,0,TCCAATAAAAGTCCGGGCCT,38,2912131
ompRp4,39.0,38,0,TATTCTATATAAAACCTGTA,38,2922963
ompRp4,39.0,38,0,TATATAAGTTTCGTTGAGGT,38,2929680
ompRp4,39.0,38,0,TAGAGGTAGCTACTCTAACG,38,2916618
ompRp4,39.0,38,0,TACCTTACGCGCAGTGTTAC,38,2934756
ompRp4,39.0,38,0,TACCTGGGTTGCCTCCTCGA,38,2910168
ompRp4,39.0,38,0,GCTATATGGAGTCTTGTTCA,38,2919888
ompRp4,39.0,38,0,GATGTTATTACGTTACGCGC,38,2930587
ompRp4,39.0,38,0,GATATACCCAAATGTAAGTG,38,2909970
ompRp4,39.0,38,0,GAAGTCCGGGGTCGTAGGTG,38,2938049
ompRp4,39.0,38,0,CGATCCCCCAATCCGGTTTC,38,2932461
ompRp4,39.0,38,0,CCTACTTCGGAGCAAGCACG,38,2929139
ompRp4,39.0,38,0,CCGTATGTTGGCCACATAAC,38,2911910
ompRp4,39.0,38,0,CCAACGCCAGTTGGTCAAGC,38,2925547
ompRp4,39.0,38,0,CATTGGTCCATTGTGTGACA,38,2911400
ompRp4,39.0,38,0,CAAAAGGTCACCTCGGATTA,38,2934642
ompRp4,39.0,38,0,AGTGACCCGTCCACCGGAGA,38,2918977
ompRp4,39.0,38,0,ACTAGAGTGGGGGTGAATAG,38,2925287
ompRp4,39.0,38,0,ACACCGACTTCATCTTCTAA,38,2908018
ompRp4,39.0,38,0,AAGTGTGGTATTTTTCCTAG,38,2924025
ompRp4,39.0,38,0,AAGGAGTTAGGTAATTACGA,38,2920259
ompRp4,38.0,37,0,TGAAATCAAGCTTGCGCCAT,37,2930955
ompRp4,38.0,37,0,TCATCAAGGGCAAGTGCGTT,37,2917410
ompRp4,38.0,37,0,TATTGCCGTAGTTGCTTACC,37,2911335
ompRp4,38.0,37,0,GGTGAATCAGCCAGGGTTAT,37,2910305
ompRp4,38.0,37,0,GCCCCGTGGCCTATCGCGCG,37,2936395
ompRp4,38.0,37,0,GCAAGGAGCTCGGCCGGTGC,37,2916032
ompRp4,38.0,37,0,GCAAAGGATCCTCTTAGCCC,37,2929259
ompRp4,38.0,37,0,GATGTATGTTCCATTCTCCA,37,2932241
ompRp4,38.0,37,0,GAATTTCACATATACTTCCC,37,2935373
ompRp4,38.0,37,0,CTTCGGAGCTGCTAGTCAAT,37,2910845
ompRp4,38.0,37,0,CTGTTGCAATGTTGATCAGC,37,2927839
ompRp4,38.0,37,0,CGCGTGATCGAGACTCGTAG,37,2916844
ompRp4,38.0,37,0,CGCAGTAAAGCCAGCGGTAC,37,2937767
ompRp4,38.0,37,0,CGCAAAACCCGTTGCGCCAG,37,2917379
ompRp4,38.0,37,0,CCATGTCGCTCGCATGTAAA,37,2932212
ompRp4,38.0,37,0,CAGCAGGTCGCCTTAACGCT,37,2915134
ompRp4,38.0,37,0,CACGAATAATAGTCCTCACG,37,2924319
ompRp4,38.0,37,0,ACTGCTATTGCGCGATGCTT,37,2913638
ompRp4,38.0,37,0,ACGGAATTCGATGTAGCCAC,37,2923370
ompRp4,38.0,37,0,ACGATTAGGGGTTAGGATGT,37,2916615
ompRp4,38.0,37,0,ACAACCGCCGCCAACAATCT,37,2924151
ompRp4,38.0,37,0,AAAACCCCAAGTTAGCCTTC,37,2913503
ompRp4,37.0,36,0,TTTCTTGTTGGGATTTAAGC,36,2919024
ompRp4,37.0,36,0,TGTGGCACATCTCCCGGCGT,36,2916724
ompRp4,37.0,36,0,TCGAAGGGTATTGGACTAAC,36,2928220
ompRp4,37.0,36,0,TCCTCGAGTTGCTGCCAAGG,36,2923056
ompRp4,37.0,36,0,TCCCGATGCTCGACCATCCT,36,2925473
ompRp4,37.0,36,0,TATCCCGGGTGGCGCCTTAT,36,2937458
ompRp4,37.0,36,0,TACTATTGTGCCTTGGGTAT,36,2909461
ompRp4,37.0,36,0,GTTAATGGGTTTACACCCCC,36,2919293
ompRp4,37.0,36,0,GTAAGTCCTGTTGGCATGGT,36,2937659
ompRp4,37.0,36,0,GGGTGTTAGTAGATCGACAG,36,2910801
ompRp4,37.0,36,0,GGAAATACCATGAGCGCGTA,36,2919727
ompRp4,37.0,36,0,GCTGACCATAAACTGGACCT,36,2930340
ompRp4,37.0,36,0,GCGACACGCTTAGGGGTCGT,36,2909844
ompRp4,37.0,36,0,GACTTAATCCTCCCATCTCC,36,2933089
ompRp4,37.0,36,0,CCTCTTGCATGCCTAGGGCG,36,2925621
ompRp4,37.0,36,0,CCTCTTATGTACTCAGCGTT,36,2917802
ompRp4,37.0,36,0,CCTCCAAACTTGCTGGGCTT,36,2928715
ompRp4,37.0,36,0,CCAGACCAGCCTCCGTTACT,36,2928447
ompRp4,37.0,36,0,CAGTCTCCTATCTTTGCTTC,36,2927640
ompRp4,37.0,36,0,CACGCCCGCGGCCTCGGTGT,36,2910566
ompRp4,37.0,36,0,ATGAGTTTGGAAACATCAAT,36,2911839
ompRp4,37.0,36,0,AGTACGATAAGACAGATCTG,36,2913440
ompRp4,37.0,36,0,AGGGTGTTGAACGAATTACC,36,2919201
ompRp4,37.0,36,0,AGGGCGTCCGGTTGACACCA,36,2932960
ompRp4,37.0,36,0,AATGAGCTTAGTATTCTCCC,36,2922703
ompRp4,37.0,36,0,AACCCTCTGAACACTGGGTC,36,2924821
ompRp4,36.0,35,0,TTTCCGAGGTCGCAACCTGA,35,2934000
ompRp4,36.0,35,0,TTCCCGTGAGCGTTCTTAAT,35,2930826
ompRp4,36.0,35,0,TTAGAATGGCACGTATATAC,35,2910732
ompRp4,36.0,35,0,TGGGCTCGCCGTGGAATGGG,35,2934664
ompRp4,36.0,35,0,TCGTGATCCAGTGTATATAA,35,2928965
ompRp4,36.0,35,0,TCGGCCCAAAATTCAAATGT,35,2917619
ompRp4,36.0,35,0,TCATAAGCCACGTGTTATAC,35,2910218
ompRp4,36.0,35,0,TAAGGTAGGGCTCACCGTCA,35,2930277
ompRp4,36.0,35,0,GTCCGCCTGAAAGGAATATA,35,2910860
ompRp4,36.0,35,0,GTAATCCTGTCCTAAGCAGA,35,2915695
ompRp4,36.0,35,0,GCAGTCTCTGCAGCTAGGGC,35,2935045
ompRp4,36.0,35,0,CTGCATAGCGCGGTTCATGC,35,2909691
ompRp4,36.0,35,0,CGTTGATTAGACGTCCCGGC,35,2936009
ompRp4,36.0,35,0,CGGTTAAATCTATGAGGAGT,35,2929639
ompRp4,36.0,35,0,CGGATCAAGGTTAAAAGACA,35,2937952
ompRp4,36.0,35,0,CGCAGGCAGAGGCTCCTAGA,35,2913927
ompRp4,36.0,35,0,CCTCGCGTGAGGCACTTTAG,35,2911357
ompRp4,36.0,35,0,CCATCAGCCGCACAACAACT,35,2921629
ompRp4,36.0,35,0,CATCCCGCCGAAAATCGTTT,35,2935786
ompRp4,36.0,35,0,CAGGTAGTTGCGGCTTCCGT,35,2910789
ompRp4,36.0,35,0,CAATGCTGAATGTCGCTCCT,35,2929327
ompRp4,36.0,35,0,ATTTTCCGAATTAATCGATA,35,2908563
ompRp4,36.0,35,0,ATGTGTTTTAGGTCTTCACG,35,2934427
ompRp4,36.0,35,0,ATCTGATCTATCTCGTGAAC,35,2926861
ompRp4,36.0,35,0,AGGTTTATACCCTCCAAATT,35,2931945
ompRp4,36.0,35,0,ACCTACATCTCCCGTGATGC,35,2916768
ompRp4,36.0,35,0,ACCCTTGACATGCACGATCG,35,2928649
ompRp4,36.0,35,0,ACCATAATCCTTTTCTTCCA,35,2910142
ompRp4,36.0,35,0,ACATACCCCGCCAAGGTGCC,35,2915013
ompRp4,36.0,35,0,AAACTCTCCCTGGCCACACA,35,2931816
ompRp4,35.0,34,0,TTGGCACTTACCTACTTTAC,34,2924470
ompRp4,35.0,34,0,TTGCGAACGTCCTTTATGTT,34,2912177
ompRp4,35.0,34,0,TGGGTCCACACGCAACCAAA,34,2925800
ompRp4,35.0,34,0,TGCAATGTGCACCCGATAGT,34,2921518
ompRp4,35.0,34,0,TCTGGAGAGAGCAGTTCCCC,34,2918596
ompRp4,35.0,34,0,TCGGGTCGGATTGATCTCCT,34,2927983
ompRp4,35.0,34,0,TAACCGGTTATCACCTATGT,34,2923735
ompRp4,35.0,34,0,GTACAGATCAAGATCTATGC,34,2918764
ompRp4,35.0,34,0,GTAAACGTTTTTACTAATAT,34,2934873
ompRp4,35.0,34,0,GGGGCGCGCATGCCAGTCGG,34,2920122
ompRp4,35.0,34,0,GGCCCCGGAAGAATTTATTG,34,2913228
ompRp4,35.0,34,0,GCTTCTCAACGCTCCGGTTC,34,2914178
ompRp4,35.0,34,0,GCGGATTGTTAATGTATTAC,34,2930884
ompRp4,35.0,34,0,GAGGGCTACCTTCCCTAGCC,34,2917084
ompRp4,35.0,34,0,CTGAACCATGAATTCGGGGG,34,2929077
ompRp4,35.0,34,0,CTACACGGAGATCAAGACCG,34,2937103
ompRp4,35.0,34,0,CGTGGTCCAATGCTCCGAGC,34,2922664
ompRp4,35.0,34,0,CGGCTAGTATCGGATTAAAG,34,2920288
ompRp4,35.0,34,0,CGCGAGGATTTGGAAATAGC,34,2910721
ompRp4,35.0,34,0,CGCCACCAGGCTCCTATAAC,34,2938056
ompRp4,35.0,34,0,CATTGAACACGTCTCTACAA,34,2934473
ompRp4,35.0,34,0,CATAAACTAATGCTTCGAAG,34,2916488
ompRp4,35.0,34,0,CACATCGAATTCGCTTAACG,34,2913439
ompRp4,35.0,34,0,ATATCAGGTGTTTATAGGCC,34,2937574
ompRp4,35.0,34,0,ATAGTCGGACTCCGTGTGCG,34,2937727
ompRp4,35.0,34,0,ATACTTGAGTTTCGGGTGAC,34,2925032
ompRp4,35.0,34,0,AGTACCATGGCACAAGTCGG,34,2933803
ompRp4,35.0,34,0,ACGTGCGGAGAAGGAGACAT,34,2914232
ompRp4,35.0,34,0,ACCTCCTGACCCTTTCACAT,34,2922591
ompRp4,35.0,34,0,ACCCATCGGGGACATATGGC,34,2916102
ompRp4,35.0,34,0,AAGGCGGGGTTGAGACAGCG,34,2921695
ompRp4,35.0,34,0,AAGAGAGAGATCTCATCGCC,34,2910697
ompRp4,35.0,34,0,AAATGCTGGTCGCTCCCCAG,34,2914297
ompRp4,34.0,33,0,TTTGGGATTCAATGTAGCGT,33,2910562
ompRp4,34.0,33,0,TTCTATCCCGCGAGCCAGAT,33,2921865
ompRp4,34.0,33,0,TGGGGCCAGCGTTCATGCAA,33,2929353
ompRp4,34.0,33,0,TGATGAAACGTCATCACTCT,33,2938096
ompRp4,34.0,33,0,TCGATCCTAATTCATGGGAC,33,2919089
ompRp4,34.0,33,0,GTCTTATCAGTATCCCGATT,33,2924008
ompRp4,34.0,33,0,GCCCAACGAACTGCCATACT,33,2908894
ompRp4,34.0,33,0,GCAGTATGGATGGCTCCGAT,33,2938229
ompRp4,34.0,33,0,GACGCGCTTGCCCCCCTCTT,33,2914133
ompRp4,34.0,33,0,CTGCTGTGCCGTCTTTGCGG,33,2918203
ompRp4,34.0,33,0,CGGCGCCCCGAAGCCACAGG,33,2916208
ompRp4,34.0,33,0,CGGAGGCAGAACAATCGGGT,33,2914919
ompRp4,34.0,33,0,CGGAGCCGTCCAACAGTTCA,33,2908037
ompRp4,34.0,33,0,CGACGAGACCCTAAGTTGGC,33,2930487
ompRp4,34.0,33,0,CCTGTCAGATGTACACAATA,33,2915499
ompRp4,34.0,33,0,CCAAGCGCGTCCAGACCAGC,33,2910181
ompRp4,34.0,33,0,CATGGCTCTGTCGTTGCGGT,33,2915380
ompRp4,34.0,33,0,CATCAACAACACCCTTTCCA,33,2925299
ompRp4,34.0,33,0,ATGGATCAGAAAGAAGACGC,33,2915077
ompRp4,34.0,33,0,ATAGCCACATTATGTAGACG,33,2927708
ompRp4,34.0,33,0,ATACCACTACCTCATGTTTC,33,2925363
ompRp4,34.0,33,0,ACCGAACTAGTATTTGCATC,33,2922586
ompRp4,34.0,33,0,ACAGCTAGTGCTGGCACAGG,33,2931257
ompRp4,34.0,33,0,AACGACACTCAAGCTAGAAG,33,2911664
ompRp4,33.0,32,0,TGGGGTGTTGCTACCCACGG,32,2922235
ompRp4,33.0,32,0,TGAGGCGATAGATATTCTTT,32,2910613
ompRp4,33.0,32,0,TCAAAGCGTATGCGTTTGTG,32,2908719
ompRp4,33.0,32,0,TAGGGGTCCTGCCTATGACG,32,2917127
ompRp4,33.0,32,0,TAGCTTGGACGCAGCTCGAT,32,2912178
ompRp4,33.0,32,0,TAATCCGACTGGTGTAGGGT,32,2910141
ompRp4,33.0,32,0,GTCTAGATCTTTATTCTATA,32,2923230
ompRp4,33.0,32,0,GCGTTCCGGGAACTGAAGCA,32,2936676
ompRp4,33.0,32,0,CTTCTTGACTGTGGCTGACT,32,2921386
ompRp4,33.0,32,0,CCAGGGGGAGTAGAGCTTCT,32,2909245
ompRp4,33.0,32,0,CCAGAGTCTCCTTATAGTTT,32,2933462
ompRp4,33.0,32,0,CAGGTTCGCCCTGTGCTCGC,32,2927163
ompRp4,33.0,32,0,CAACGACTAATAGCAACACT,32,2918755
ompRp4,33.0,32,0,ATTGCCTCTATTCGTACTGC,32,2925788
ompRp4,33.0,32,0,ATCACCATGGCCCCGTTTGT,32,2915928
ompRp4,33.0,32,0,AGCTCGGAAAAGTTCTGTGG,32,2930690
ompRp4,33.0,32,0,ACTGACACTGTAACTCCGAA,32,2916774
ompRp4,33.0,32,0,ACGTCCCAAAGTCCGGGTGC,32,2928485
ompRp4,32.0,31,0,TTCGTCCACCCACGACACTT,31,2916174
ompRp4,32.0,31,0,TCCGTAATTTTCTACGGCGA,31,2924990
ompRp4,32.0,31,0,TATTGGCGTATCCTATACGA,31,2922489
ompRp4,32.0,31,0,TATTAAGAAAATCATCTCAA,31,2932400
ompRp4,32.0,31,0,TATCCGACAGGTTCTCTATG,31,2911472
ompRp4,32.0,31,0,GTTTTGCCCTGCTGGAGGCA,31,2931822
ompRp4,32.0,31,0,GGATGCAGCCATTCACTTCA,31,2918463
ompRp4,32.0,31,0,GGAAACGGGCTGTTATGACT,31,2923828
ompRp4,32.0,31,0,GCGTGAGGCTAAGGGCGAGT,31,2928329
ompRp4,32.0,31,0,GAGGCTGCACTCCTTTTTAT,31,2929022
ompRp4,32.0,31,0,CGGAATATATGAGGGCACCC,31,2919792
ompRp4,32.0,31,0,CGATGGTTCCACGGCCTGGT,31,2928300
ompRp4,32.0,31,0,CCGGCATATCTCTACTCCGA,31,2923242
ompRp4,32.0,31,0,CCATCAATATCTGTTAGAAA,31,2910047
ompRp4,32.0,31,0,AGGCTAGCGCAGAGCCGCTA,31,2926969
ompRp4,32.0,31,0,AGCGACCTCGTGCACCGCTC,31,2908276
ompRp4,32.0,31,0,AGACAGCAACAGCATCCTGG,31,2913492
ompRp4,32.0,31,0,ACGGGATTTGGTTAACGGGT,31,2927041
ompRp4,32.0,31,0,ACGCCAATATGGGCTTTGCT,31,2929133
ompRp4,31.0,30,0,TCGAATGGTGTATATGCGAA,30,2936716
ompRp4,31.0,30,0,GGGTTTGCGAACTTGTGTTA,30,2911475
ompRp4,31.0,30,0,GCGTGGGGTGACCTTTTATT,30,2907807
ompRp4,31.0,30,0,GCGCAAACGTCACAGATATT,30,2925586
ompRp4,31.0,30,0,GATATGGAAGGTCGATTATA,30,2925223
ompRp4,31.0,30,0,GAGCACCCGCGAATAAGCAG,30,2915125
ompRp4,31.0,30,0,GACGAGACGGTCTGAGATAA,30,2914480
ompRp4,31.0,30,0,CTGCGCTCTGCTGTAAAATA,30,2910109
ompRp4,31.0,30,0,CTGATCCTTCCGGAAGCCAA,30,2922541
ompRp4,31.0,30,0,CTACCAGGTCTGAGGCCCGG,30,2910145
ompRp4,31.0,30,0,CCGCCAAAATGCGCCAGTTT,30,2921478
ompRp4,31.0,30,0,AGTTCCAGGGCACGGTTCGT,30,2916403
ompRp4,31.0,30,0,ACTTCTCATCGATTGAGTCG,30,2908860
ompRp4,31.0,30,0,ACGCCAGTTCGCACTCGCAT,30,2908485
ompRp4,31.0,30,0,AATATGTAGGTGGATCATAT,30,2919605
ompRp4,31.0,30,0,AAATGTTGTTTCTATTTTCG,30,2925270
ompRp4,30.0,29,0,TTGGCGTCTCATTCAGACAA,29,2910793
ompRp4,30.0,29,0,TTCTCACAGGAATTAATGGG,29,2915968
ompRp4,30.0,29,0,TTCTATTGGATTGTCGAGTG,29,2913489
ompRp4,30.0,29,0,TCCGCACTTAACGATGATAT,29,2910896
ompRp4,30.0,29,0,GTTGCCGCAGGCATGTCTGT,29,2930048
ompRp4,30.0,29,0,GGTCGATTATATGCCCGCAG,29,2935875
ompRp4,30.0,29,0,GCCTAGCATAATCAACCAAC,29,2920005
ompRp4,30.0,29,0,CAGCTAATAGATGACATACA,29,2914836
ompRp4,30.0,29,0,CAAATGTACCCAGAACTTAG,29,2910291
ompRp4,30.0,29,0,ATGACAAGAGAATTCTCCAA,29,2919474
ompRp4,30.0,29,0,ACCAAGGTACGAGTGTGCCT,29,2933120
ompRp4,29.0,28,0,TGTGCATTGAATCAAACGTC,28,2925145
ompRp4,29.0,28,0,TGGGCTATGGACGTGCTGAG,28,2913021
ompRp4,29.0,28,0,TCTGTGTGAGCTTAGCGTTT,28,2935165
ompRp4,29.0,28,0,TATGGGGTGTCTCCAAAACA,28,2931416
ompRp4,29.0,28,0,GGAATTGTCGCTGCCCAACT,28,2919728
ompRp4,29.0,28,0,GCGCCAAGCCGAGTTACCGA,28,2932619
ompRp4,29.0,28,0,GCGACTTAAATGTGTGGAGG,28,2920936
ompRp4,29.0,28,0,GCACCGCCCAAGTGTAGTGT,28,2916762
ompRp4,29.0,28,0,CTGAAGCGCTGGCTGCGATT,28,2923095
ompRp4,29.0,28,0,CTCAAGCCCACAGATACTAC,28,2930030
ompRp4,29.0,28,0,CGCTATGCTATCTGCTGACA,28,2926871
ompRp4,29.0,28,0,CATTGGACACTCGCGTGCAT,28,2938103
ompRp4,29.0,28,0,CAGCACGGTACCAAAAATCA,28,2911188
ompRp4,29.0,28,0,CAGAACCACAGGCGTAGACT,28,2925152
ompRp4,29.0,28,0,ATGACTGAACGCTGGTCTTG,28,2930861
ompRp4,29.0,28,0,ATCTGTTATTACGGAGTCCA,28,2930993
ompRp4,29.0,28,0,AGTTCCCGGAGGCCAGATCC,28,2938007
ompRp4,29.0,28,0,ACGGGACCCTTAGTGGTCTC,28,2931866
ompRp4,29.0,28,0,AAGTAAATACGTCGTGTCAT,28,2907847
ompRp4,28.0,27,0,TTAGGCTGCCGTTTATTTCC,27,2925769
ompRp4,28.0,27,0,TTAGGCATAGCCCCAATAAT,27,2933613
ompRp4,28.0,27,0,TGCGATGCCCTTCCAAGATC,27,2910903
ompRp4,28.0,27,0,TACGCGGCAGTGTGACTCAT,27,2919887
ompRp4,28.0,27,0,GTTTCGCATTTGTAATAATA,27,2918865
ompRp4,28.0,27,0,GTGTCCCACGTTATACAGTA,27,2926474
ompRp4,28.0,27,0,GTATTACTCTCTGGGTACGA,27,2923341
ompRp4,28.0,27,0,GGTAGGGACCTTAACCTCAG,27,2928104
ompRp4,28.0,27,0,GGCTTACCGCAACATAGCTT,27,2908281
ompRp4,28.0,27,0,GCATCCATTGGAGACAAGCC,27,2915852
ompRp4,28.0,27,0,CGCTGTCACAAGGCACTAGA,27,2922469
ompRp4,28.0,27,0,CCGTAGTTGCTACCATCAAT,27,2913359
ompRp4,28.0,27,0,CCACGTGTTGCCTGTTATAT,27,2908649
ompRp4,28.0,27,0,CCACCTATCCCGATAACGAG,27,2932395
ompRp4,28.0,27,0,ATTACATGTCATACGGAGTA,27,2929336
ompRp4,28.0,27,0,AGGAGAAGGGAAGAGCGTCT,27,2926810
ompRp4,28.0,27,0,AAGATCTCGGGTGTGAAAAC,27,2928360
ompRp4,27.0,26,0,TGGAACGTCGCACATCCGAA,26,2931191
ompRp4,27.0,26,0,TGCAGGCACTAAGGGTCCCA,26,2909230
ompRp4,27.0,26,0,TCTGTTAATCATCCGGAACG,26,2909710
ompRp4,27.0,26,0,TAATCGTCCTTGGCAGCCAG,26,2919522
ompRp4,27.0,26,0,GGATGATAAGGTAAAGCCAG,26,2912925
ompRp4,27.0,26,0,GCCTGAAAACCGATAAGTGT,26,2929122
ompRp4,27.0,26,0,GCATCGACCTCTCAGCCGTA,26,2927152
ompRp4,27.0,26,0,GAGTCGGCTCCAGGAGGATT,26,2910239
ompRp4,27.0,26,0,GAAAGTCCCTTTTGGGGCCT,26,2910534
ompRp4,27.0,26,0,CTGGCGGTTGCCCTGAGCCA,26,2909992
ompRp4,27.0,26,0,CTCGGGAGACGGCCGTGGGT,26,2935982
ompRp4,27.0,26,0,CTCAGGAATACGTCCATCCT,26,2912119
ompRp4,27.0,26,0,CTATACGCGCGCGCTCATAG,26,2916695
ompRp4,27.0,26,0,CTAACACTATATCCCGTGTA,26,2924168
ompRp4,27.0,26,0,CCGCGGGCTCCTACGCTACA,26,2936923
ompRp4,27.0,26,0,CACCTCCGCGCTCGAAATGA,26,2934454
ompRp4,27.0,26,0,CAATCGTTGTTGGTGCCGAG,26,2919795
ompRp4,27.0,26,0,AGTACTAGAACACCGCTTCT,26,2914763
ompRp4,27.0,26,0,ACTTGGATCCGCTGGAGGAG,26,2928235
ompRp4,26.0,25,0,TTGTTGGAAGCAGATAGTGA,25,2935450
ompRp4,26.0,25,0,TTGGACCCGCGTGGATCGAG,25,2908852
ompRp4,26.0,25,0,TTGCCCGGAAATAGGTAAGC,25,2916610
ompRp4,26.0,25,0,TTCCACTCTAAACCTCGGGG,25,2914301
ompRp4,26.0,25,0,TTACCTGAACAGGAGTCAAA,25,2928775
ompRp4,26.0,25,0,TCTTGTCCGTTACTCGACAG,25,2937277
ompRp4,26.0,25,0,TCGGTCAGTATAACTCGGAT,25,2928510
ompRp4,26.0,25,0,TCGAACACGTTATTGCGCCA,25,2919854
ompRp4,26.0,25,0,GTGAAGTTGAGATAAAACAG,25,2934020
ompRp4,26.0,25,0,GGAGCTGGCTCATGTACAAC,25,2929602
ompRp4,26.0,25,0,GCCGTGGCGGCAGGTTCTCG,25,2914438
ompRp4,26.0,25,0,GCATTTTGGATTGCACTGCA,25,2929980
ompRp4,26.0,25,0,CGTTAGACATCCGCCTTTAA,25,2927999
ompRp4,26.0,25,0,CGATGGCTATTAGAGATCCC,25,2908417
ompRp4,26.0,25,0,CGACTTAGTAACGGATAGTC,25,2935719
ompRp4,26.0,25,0,CATTTGGCAACTTCTAAGAA,25,2921524
ompRp4,26.0,25,0,ATAGAAGCCCTCGGAGGTTG,25,2917214
ompRp4,26.0,25,0,AGGCCTATCCCGGTTTACAG,25,2913426
ompRp4,26.0,25,0,AGGCATGGGTCACGGAGGTA,25,2931683
ompRp4,25.0,24,0,TTCACTCAGGCGAAACCCAA,24,2922179
ompRp4,25.0,24,0,TGGCAAATGTTTTGACTGCT,24,2910346
ompRp4,25.0,24,0,TGAGGGCATCACGTAAAGTG,24,2934872
ompRp4,25.0,24,0,TCTTGAAGACTGTTAGTCAC,24,2923323
ompRp4,25.0,24,0,TCCTGATCATGTCACCCCTG,24,2926674
ompRp4,25.0,24,0,TCCGCGGCCTTGTATTTGGC,24,2921999
ompRp4,25.0,24,0,TCAATTATACCGGGCAGTTA,24,2908685
ompRp4,25.0,24,0,TAATCTCATGGCATGCAAAC,24,2911027
ompRp4,25.0,24,0,GTAAGATAATCGGAGGTACG,24,2912201
ompRp4,25.0,24,0,GGGGTCCTTTTACCGGTGTC,24,2916578
ompRp4,25.0,24,0,GGACCAAGTCCCTGTGGTTC,24,2921302
ompRp4,25.0,24,0,CTTCTTCACCTTAGTTAGTA,24,2929299
ompRp4,25.0,24,0,CTGACTTAACACTTCATTCG,24,2910715
ompRp4,25.0,24,0,CTCCTATACCCCCCGCGGAT,24,2930305
ompRp4,25.0,24,0,CCGGGTGCGAAACGGATATT,24,2917919
ompRp4,25.0,24,0,CACTGATGTAATGCTTACCG,24,2930565
ompRp4,25.0,24,0,CACCCCTGGAGGACCCTCAT,24,2914461
ompRp4,25.0,24,0,AGTGTGCTTGCTAACCGGAG,24,2930414
ompRp4,25.0,24,0,AGTGGTGGTACCGCACTAGG,24,2935586
ompRp4,25.0,24,0,AAGCCGAGGTTCAGTTTCGG,24,2916785
ompRp4,25.0,24,0,AAACATTCACATTTGATTGG,24,2920988
ompRp4,24.0,23,0,TTTCCTGTCTGATGCACACG,23,2938190
ompRp4,24.0,23,0,TTATATTATCCCTACGGAGC,23,2931436
ompRp4,24.0,23,0,TGGTTGGCGTCCCTACGTTG,23,2931419
ompRp4,24.0,23,0,TCTACGGTTAGGATATGTCC,23,2929503
ompRp4,24.0,23,0,TCGGATCAGGCTCGCAGTAC,23,2922693
ompRp4,24.0,23,0,TCACTTAGGTCTTGTCCTGT,23,2914873
ompRp4,24.0,23,0,TATTCATGAAGTAGTCATAC,23,2931746
ompRp4,24.0,23,0,GTTCGGACACGATGACAGTA,23,2909578
ompRp4,24.0,23,0,GTTCCGAGCCTCCCTGACGA,23,2920134
ompRp4,24.0,23,0,GTTACGACTCATCTTCTGGG,23,2923122
ompRp4,24.0,23,0,GTGCGGGGCGAACTGGTGTT,23,2923224
ompRp4,24.0,23,0,GGTCTGTTAGTAGGGTTGCT,23,2927055
ompRp4,24.0,23,0,GCCGGTTCACACCTCCACAG,23,2920856
ompRp4,24.0,23,0,GCACGATAGACTATCTTGTG,23,2934868
ompRp4,24.0,23,0,CTGGTAGAGTCAGCGTGAGA,23,2933660
ompRp4,24.0,23,0,CTCCATGGGGCTTTAGGCGC,23,2931848
ompRp4,24.0,23,0,CTCAACTCGAACGGGCGTCC,23,2918860
ompRp4,24.0,23,0,CGGCCTTTCGCACAGACTAT,23,2926430
ompRp4,24.0,23,0,CCGCTGGAGGTCAGCAGAGG,23,2909754
ompRp4,24.0,23,0,CCATATTTTCTCCTCGTTTT,23,2933528
ompRp4,24.0,23,0,CACGCGGTGCTCGCTGCGAA,23,2930383
ompRp4,24.0,23,0,CACCGTGATTAGGAGCGTAC,23,2914346
ompRp4,24.0,23,0,CAAGCCTGAGTCAAATGCTT,23,2912532
ompRp4,24.0,23,0,CAACCTAGGGCTATCTCTCT,23,2937942
ompRp4,24.0,23,0,CAAATCACGAGCCGCTGGAT,23,2915486
ompRp4,24.0,23,0,CAAACGGTTTGGGTTTTCAC,23,2918480
ompRp4,24.0,23,0,ATTCTCATGGTCAGCGCTTC,23,2916284
ompRp4,24.0,23,0,ATTATGCTCGTCCATTGGAA,23,2938172
ompRp4,24.0,23,0,ATCCAAAACGCTCGTTTTAG,23,2928382
ompRp4,24.0,23,0,AGGGGTCGGCGGAGAACAGT,23,2914898
ompRp4,24.0,23,0,ACACTCTAATATGCCTACCT,23,2909575
ompRp4,24.0,23,0,AAGGCGCTGAACATGCTAAA,23,2935908
ompRp4,24.0,23,0,AAGGCCGATGGAACTTCACA,23,2920818
ompRp4,23.0,22,0,TTTAGGGGGGAGCCATATTA,22,2933292
ompRp4,23.0,22,0,TTTAACAGCTTCGTCGTCAT,22,2909552
ompRp4,23.0,22,0,TCGGGAAGCGGTAGAGGGTT,22,2920373
ompRp4,23.0,22,0,TCCGTCAAGTCACATGCACG,22,2917513
ompRp4,23.0,22,0,TATACAGTTTACAGCTACCC,22,2937045
ompRp4,23.0,22,0,GTTGCCTCTAGTCCTAGATA,22,2911991
ompRp4,23.0,22,0,GTACGCAGTTTTGAGTCACT,22,2935922
ompRp4,23.0,22,0,GGCTGCGTACTCAAGCGTCA,22,2935449
ompRp4,23.0,22,0,GGAATGCCGACCTTTTGGAT,22,2921039
ompRp4,23.0,22,0,GCTTTTATAACAGTCGAACA,22,2937742
ompRp4,23.0,22,0,GCAGGCGCGACAGAGCAATT,22,2935877
ompRp4,23.0,22,0,GCAAACCTTTGGAAATGCGT,22,2917496
ompRp4,23.0,22,0,GATGTTAGTACGTTACCCCC,22,2923069
ompRp4,23.0,22,0,CCGTTGGAGTGCTTCTGTGT,22,2921761
ompRp4,23.0,22,0,CATTATCATGATTGTAGCTT,22,2914291
ompRp4,23.0,22,0,CAGAAGAACGTGTAGCTAAA,22,2912061
ompRp4,23.0,22,0,CAAGGCCTGAGAGCACCTAT,22,2929373
ompRp4,23.0,22,0,ATGTTGTCCTCATACGGTTG,22,2912542
ompRp4,23.0,22,0,ATGCCAAGATCAGTTGTACA,22,2935629
ompRp4,23.0,22,0,ACAGCTGAGGGAGTGCACTT,22,2911601
ompRp4,23.0,22,0,AATCTCTTCACGGAGATTGG,22,2912062
ompRp4,23.0,22,0,AAGGGCCATACCATAAAGCT,22,2930591
ompRp4,22.0,21,0,TTGCTTCTATATCCAGGCGA,21,2908945
ompRp4,22.0,21,0,TCCCCCGTCCTGTGCCCGTA,21,2937911
ompRp4,22.0,21,0,GTCGCGATGTCCGGATAGTA,21,2924997
ompRp4,22.0,21,0,GGGGTCAGTTCCAAGGCTTA,21,2917440
ompRp4,22.0,21,0,GGCTCACTTAAGTGGCGATC,21,2917346
ompRp4,22.0,21,0,GCTCTAATCGGCCACACGCG,21,2936416
ompRp4,22.0,21,0,GAGACAGGGCGTTTCGTAAA,21,2919205
ompRp4,22.0,21,0,GACTATAGCATATGCGATTC,21,2925373
ompRp4,22.0,21,0,CTGTTCCAAGTCTGCTTGTC,21,2917195
ompRp4,22.0,21,0,CTGCAGTGGTGACCCATTAT,21,2936192
ompRp4,22.0,21,0,CTGCAACCTGTAGTGCCAAA,21,2909729
ompRp4,22.0,21,0,ATAATCACGACCATCAGTCA,21,2935443
ompRp4,22.0,21,0,ACTCCCGACAGAAGAGGACA,21,2922648
ompRp4,22.0,21,0,ACATACAATAACTCGCTAGG,21,2919501
ompRp4,22.0,21,0,AAGAGGATCCCGGAACTCGG,21,2929352
ompRp4,21.0,20,0,TGTGTGGGTCTTCGCTCGGA,20,2922100
ompRp4,21.0,20,0,TCACCTTAGTGGGATTCCGA,20,2915606
ompRp4,21.0,20,0,GTTATTAGGACTACGAGACA,20,2924948
ompRp4,21.0,20,0,GTCGGACCGTTATAGAACAG,20,2929939
ompRp4,21.0,20,0,CTCGACAACTGTTTTCAAGT,20,2912530
ompRp4,21.0,20,0,CTACTACGGGAGAGTGTTTG,20,2927004
ompRp4,21.0,20,0,CGGGGCGCGCTTTGGATCGA,20,2924379
ompRp4,21.0,20,0,CCGTGCCAATGTTGCCGAGT,20,2921197
ompRp4,21.0,20,0,CAGGGACTGTAGGCGGCTTG,20,2929281
ompRp4,21.0,20,0,AGTTAGATCATATTTCACGA,20,2916013
ompRp4,21.0,20,0,ACGTTCACATCATGACAGAA,20,2929933
ompRp4,21.0,20,0,AACCGAAGGTCATGGATCAC,20,2937661
ompRp4,21.0,20,0,AAAGAAATATACGGGTGCTA,20,2933636
ompRp4,20.0,19,0,TTTTAACTAAGTAAGACTGA,19,2920509
ompRp4,20.0,19,0,TGTATTAGGACGTAGCGAGG,19,2910667
ompRp4,20.0,19,0,TGCGGAGAGTCTTGCGTCAC,19,2908437
ompRp4,20.0,19,0,TGAGTCCCACCAGGAGTGTA,19,2926135
ompRp4,20.0,19,0,TCTTTCTCAAGAAAACACGG,19,2936895
ompRp4,20.0,19,0,TCTCGGCCTGAAGATAAGAT,19,2921460
ompRp4,20.0,19,0,TCGCTTAATGGGTACATCTC,19,2925496
ompRp4,20.0,19,0,TCCTGTTTGCCCGGCGCTAG,19,2922287
ompRp4,20.0,19,0,TCATGTAAATCGGCATGGAC,19,2910217
ompRp4,20.0,19,0,TCAGACCCGCGAGGGAGAGT,19,2933052
ompRp4,20.0,19,0,TAACGGACACTAGATCGCCC,19,2923583
ompRp4,20.0,19,0,TAACAATATGCCAATTTCTA,19,2908184
ompRp4,20.0,19,0,GGGCAGGGAAGGACGATTAC,19,2923991
ompRp4,20.0,19,0,GCGCCGCGTGCGATGGATAG,19,2928951
ompRp4,20.0,19,0,CCGTCTCCATTTTTGTACCT,19,2934411
ompRp4,20.0,19,0,CAGCGTACTAGGTAATTGCT,19,2930663
ompRp4,20.0,19,0,CAAATGTACTCTGAAAGGGA,19,2913599
ompRp4,20.0,19,0,CAAACTGTCCCCTTAAGGTA,19,2925732
ompRp4,20.0,19,0,ATTTTTCGTTTTTCAAGTTG,19,2915082
ompRp4,20.0,19,0,ATTCGGACAACGGTGCCTAA,19,2925127
ompRp4,20.0,19,0,ATTATATCCTCACTAGAGAA,19,2935720
ompRp4,20.0,19,0,AAATGACACTGGGGCTGTTA,19,2918047
ompRp4,19.0,18,0,TTGAGAAGAAAGCAGTGTAA,18,2929534
ompRp4,19.0,18,0,TCTCCCTAGATCTGACAGTG,18,2923773
ompRp4,19.0,18,0,TATTATAGCCCTTAGCTATC,18,2929061
ompRp4,19.0,18,0,TATATGACGGTCTTTAGGCA,18,2925406
ompRp4,19.0,18,0,GGACGCTAACGTATCAGTTC,18,2924983
ompRp4,19.0,18,0,GCTTATCAGCTAAGTCACTA,18,2924860
ompRp4,19.0,18,0,GCGTCTTGGTCCCCCGGATA,18,2931570
ompRp4,19.0,18,0,GCGGATGAATAACTCACTCT,18,2913924
ompRp4,19.0,18,0,CTGGTTTTCAGCAGTGGTGG,18,2914663
ompRp4,19.0,18,0,CGTGCCCGGTAGAGCCCCAG,18,2934377
ompRp4,19.0,18,0,CGGCGCCTCATGATCTGGTT,18,2935097
ompRp4,19.0,18,0,CGCCGTCACGTGTATACAGT,18,2928668
ompRp4,19.0,18,0,CGAGATTTACCAGTAACTTT,18,2937087
ompRp4,19.0,18,0,CCTTTGGAAGAGATCCCTAC,18,2922523
ompRp4,19.0,18,0,CATCGTCCCTGAGGGACGTT,18,2937278
ompRp4,19.0,18,0,ATACGAATGATTCACGTTTG,18,2923090
ompRp4,19.0,18,0,ATAACGACAGTGGCTCGTAA,18,2912851
ompRp4,19.0,18,0,AACCATTTTTCTAGACCTGC,18,2915802
ompRp4,18.0,17,0,TTTAGGCCGGGTGACTTCGT,17,2912396
ompRp4,18.0,17,0,TTGCCCCGTAGGTCAGGCAA,17,2910785
ompRp4,18.0,17,0,TTGAGCGGCCCAATAGCAAA,17,2924912
ompRp4,18.0,17,0,TTCTCTAATCTAAGCCCCAA,17,2920969
ompRp4,18.0,17,0,TGGTCTGGGAGAGATCCTCC,17,2909945
ompRp4,18.0,17,0,TGGGTCGGGTTACCCGTCGG,17,2935051
ompRp4,18.0,17,0,TCTGAGGAGGCAGAGCCGTA,17,2935997
ompRp4,18.0,17,0,TCGTGGCGCAGCGGAAGATC,17,2918982
ompRp4,18.0,17,0,TCGGCGGCGTCGCTGGGGAA,17,2909530
ompRp4,18.0,17,0,TACTTCGACGTATAGTATGG,17,2907729
ompRp4,18.0,17,0,GGAGAAGGCTCGGTCACGAT,17,2915401
ompRp4,18.0,17,0,CTGTTTGGAACCGTCTTGGG,17,2921507
ompRp4,18.0,17,0,CTGCGGCCGCAAGAGCCAGG,17,2923029
ompRp4,18.0,17,0,CGTGTTACTATGATGGGTAC,17,2926926
ompRp4,18.0,17,0,CGTCACTCTACCCACGATTC,17,2923452
ompRp4,18.0,17,0,CCAGTTCGTCTCTTGGATGA,17,2908997
ompRp4,18.0,17,0,AGTGGATTGAGCTGATTGAA,17,2913247
ompRp4,18.0,17,0,AGCTGGGGTTACATCCTTTT,17,2914386
ompRp4,18.0,17,0,AACTGACAGTGCACTACAAT,17,2932915
ompRp4,17.0,16,0,TGGGATGGTGGTGGGACCTA,16,2938195
ompRp4,17.0,16,0,TGGCTTTATAGAGCTACCAT,16,2911290
ompRp4,17.0,16,0,TGGCATCTGGATCCCGCAGT,16,2910832
ompRp4,17.0,16,0,GTGTTGTCCCCCCTGAAACG,16,2919457
ompRp4,17.0,16,0,GTGTGCAGCAGTAATCACGC,16,2926575
ompRp4,17.0,16,0,GTAGGGAGTGTGCCTACGTA,16,2921921
ompRp4,17.0,16,0,GCCTCTATATTGTCGAAGTC,16,2907936
ompRp4,17.0,16,0,GAGAAGAGCCTGAACTGGAG,16,2908998
ompRp4,17.0,16,0,CTATGTAAGTACTGGGATGG,16,2924508
ompRp4,17.0,16,0,ATCTCATCGTCGCTCAAGAT,16,2910429
ompRp4,17.0,16,0,AATAGTGGGATAGAGTACTA,16,2920262
ompRp4,16.0,15,0,TGTCATTGCTCCTCTTGTTT,15,2928425
ompRp4,16.0,15,0,TCGCTGCCGAGAGGGGGCTG,15,2914719
ompRp4,16.0,15,0,TCCCTGCTGGGACCGATCGT,15,2921228
ompRp4,16.0,15,0,GATTATGGTCGTCTGTTCAC,15,2921876
ompRp4,16.0,15,0,CTGTATGGTGAATGAAGGTA,15,2921958
ompRp4,16.0,15,0,CGCCACTCGGATTTTTGGAT,15,2928287
ompRp4,16.0,15,0,CCGCCCCGGCGGTTGCCTCC,15,2934396
ompRp4,16.0,15,0,ATGGTGTTGACTAGCAGAGC,15,2924611
ompRp4,16.0,15,0,AACGTCTGACAAATTACCGT,15,2908535
ompRp4,15.0,14,0,TTCTAAGGCTAATTCCGTAC,14,2923992
ompRp4,15.0,14,0,TGATCGCTTTGATCCTACTA,14,2936202
ompRp4,15.0,14,0,TCGGTATCAGCGTTGTTCAT,14,2910770
ompRp4,15.0,14,0,GTTTAGAATTCAGGTCAGCA,14,2934133
ompRp4,15.0,14,0,GTTCGCAAAGGTGATACTCT,14,2922336
ompRp4,15.0,14,0,GCCATATTCGATGGGCAGTT,14,2924498
ompRp4,15.0,14,0,GAGAATGATTATATGTTATC,14,2915521
ompRp4,15.0,14,0,CGGCCCCGGGTCAGTGGGCG,14,2935478
ompRp4,15.0,14,0,CCGTCAAATTCGGTTGGGGT,14,2926921
ompRp4,15.0,14,0,ATATTGTCGGACCAGGGAGA,14,2908278
ompRp4,14.0,13,0,TGCAAGTAACCCCTGTGCGA,13,2911175
ompRp4,14.0,13,0,TACCCCGGGATCGATAGTTC,13,2928988
ompRp4,14.0,13,0,TAACCAGCGCAGAAACACAC,13,2924934
ompRp4,14.0,13,0,GCCCATGTCTCCAGCGGTTG,13,2923205
ompRp4,14.0,13,0,CTGTCGTTTGACCGTGTTCG,13,2925553
ompRp4,14.0,13,0,CAGGCGTATACAGAGTAGCT,13,2916496
ompRp4,14.0,13,0,CAATGCCACTGTCCGGAAAT,13,2938237
ompRp4,14.0,13,0,AAGTCATGATCCTTGAAATC,13,2912942
ompRp4,14.0,13,0,AACGATATGAGCAACATATT,13,2928048
ompRp4,13.0,12,0,TAGCGGAACCCCCATTGGTT,12,2930322
ompRp4,13.0,12,0,GTGGTTGTAGATGGTAGACA,12,2921866
ompRp4,13.0,12,0,GTAATCCTTTAAATCATCTT,12,2924514
ompRp4,13.0,12,0,GGTAACCCCTCGAAGCCCAA,12,2907973
ompRp4,13.0,12,0,GAGGCACCCGTATAGTCGGG,12,2920247
ompRp4,13.0,12,0,CTGTTCTGCCGGGGGTTGCC,12,2908713
ompRp4,13.0,12,0,CGCTCACAGGTTTCCAACCT,12,2934351
ompRp4,13.0,12,0,CCGAAATGGCTTGAAAAAGA,12,2918887
ompRp4,13.0,12,0,CAACAAGGTAGCGCCAAGAA,12,2932176
ompRp4,13.0,12,0,ATTCGTGTACCTGGTCTGTC,12,2908323
ompRp4,13.0,12,0,AGGCTGCACGGCAGCGCTGC,12,2929421
ompRp4,13.0,12,0,AGAAACTGTGTTCAGGTGCA,12,2910366
ompRp4,13.0,12,0,AATACAGATACATGTCATGT,12,2929667
ompRp4,12.0,11,0,TACCACAAGCGACGTGTGGT,11,2925557
ompRp4,12.0,11,0,GTTTTCACGGAGGGACAACA,11,2920058
ompRp4,12.0,11,0,GTGGCAATATTGGAACCCCT,11,2926178
ompRp4,12.0,11,0,ACTGCTTCACACATGGGGGA,11,2931833
ompRp4,12.0,11,0,ACAGCTCAGCTCGATCTACT,11,2928529
ompRp4,11.0,10,0,TTTCGACCTAATTGTGTTTT,10,2936185
ompRp4,11.0,10,0,GTTTAAATACTGTCAACTGA,10,2927085
ompRp4,11.0,10,0,GTCAACGTATACCATCAAAG,10,2923111
ompRp4,11.0,10,0,GCCTCAAGCCAAATTGTTTC,10,2923577
ompRp4,11.0,10,0,GCCAGGCAATCGAAGCCAGG,10,2927365
ompRp4,11.0,10,0,CATCTATTTCATATTAAGGC,10,2915797
ompRp4,11.0,10,0,ATTGGCCCATGACTGAAATC,10,2920860
ompRp4,11.0,10,0,AGATCTGCTGGTAACTATAT,10,2930752
ompRp4,11.0,10,0,ACCTGACGTGAATTGAAAAG,10,2933137
ompRp4,11.0,10,0,ACACCCCGGGTATGGCACCA,10,2938137
ompRp4,10.0,9,0,TTGGTGTCTGGTACCACCAG,9,2912019
ompRp4,10.0,9,0,TACTGGGATACTAGCCCCCA,9,2932421
ompRp4,10.0,9,0,TACCTCTCTCGAGGCATCCA,9,2917160
ompRp4,10.0,9,0,GTAGAGTAGACAAGGCGTAT,9,2936092
ompRp4,10.0,9,0,GCTTTTGCCCGATGGTAGCC,9,2922818
ompRp4,10.0,9,0,CTACGGTTGCATGCAAATAT,9,2909929
ompRp4,10.0,9,0,CAGCCTAGCTCGCCTTTTGG,9,2908592
ompRp4,10.0,9,0,CAGATCGGACAATCTATTGC,9,2936279
ompRp4,10.0,9,0,ATTTTACAGGGAATGGGATT,9,2927414
ompRp4,10.0,9,0,ATACTGACATCTCATATCCT,9,2933132
ompRp4,10.0,9,0,ACACAGGGAGTAGTCACAGT,9,2916519
ompRp4,10.0,9,0,AACCATGCCCCCATCCACAG,9,2937622
ompRp4,9.0,8,0,TGCCTCTGGCGTTGCGGGTG,8,2920248
ompRp4,9.0,8,0,TCTGCTACGCAACGCATGAC,8,2921696
ompRp4,9.0,8,0,TATCCATGCATTCTTATTGG,8,2927833
ompRp4,9.0,8,0,TAAATGTACATCTATGCGTG,8,2922821
ompRp4,9.0,8,0,GCGGGTTGGTACGAACTAAG,8,2916596
ompRp4,9.0,8,0,GCAAATGCGGCATCCCAGGT,8,2915235
ompRp4,9.0,8,0,AGCCACCACCCGGTCTATCC,8,2919002
ompRp4,9.0,8,0,AAGGAACGATTGCGGGCACT,8,2920140
ompRp4,8.0,7,0,TGTAAACGTGGGTTCTCCTG,7,2909721
ompRp4,8.0,7,0,GTTAACGTCGTGTATGGATA,7,2938175
ompRp4,8.0,7,0,GCCTCGAATCCGACGCTATA,7,2924571
ompRp4,8.0,7,0,ACAACGGGGCTATCTTCTCG,7,2937654
ompRp4,8.0,7,0,AAATGGAGAGGCTCCTAAAG,7,2920285
ompRp4,8.0,7,0,AAACGTGTTACTGGCCTTCC,7,2928477
ompRp4,7.0,6,0,GGCATAGAGACCGAGTGCTA,6,2913070
ompRp4,7.0,6,0,GATCTAGTGTAGTGGATTAT,6,2922130
ompRp4,7.0,6,0,CTTTGTTTAGGACTAAACGG,6,2922643
ompRp4,7.0,6,0,CGGGGATAGCGTGAATCCTG,6,2936610
ompRp4,7.0,6,0,CGCGGGTACCACGTGTGGGC,6,2936506
ompRp4,7.0,6,0,CCTTGCAAAACAAAGTACTG,6,2919362
ompRp4,7.0,6,0,CCTATATAGTTCTCCCGGAC,6,2936307
ompRp4,7.0,6,0,CCCATATCCCTTGCTCTTCT,6,2915259
ompRp4,7.0,6,0,ACATAAGTTATCGAGAGATC,6,2936453
ompRp4,7.0,6,0,ACAACAGACCATACACGGAT,6,2911907
ompRp4,6.0,5,0,TGTGCATTAAGCTAATAGTG,5,2928622
ompRp4,6.0,5,0,TCACACGTGACTTATTGGGT,5,2936388
ompRp4,6.0,5,0,TATTTCCTCACGGGGTGAGT,5,2910110
ompRp4,6.0,5,0,GCGCACCCAGTCATCTGATC,5,2916571
ompRp4,6.0,5,0,GCCCCTCATTAGACTACAGA,5,2931533
ompRp4,6.0,5,0,GAATTCTTTCGATATCGAAA,5,2915601
ompRp4,6.0,5,0,CAGCCATCGAGGATAGGAAA,5,2921433
ompRp4,6.0,5,0,AGGATTCATCATCTCGTTCA,5,2913679
ompRp4,6.0,5,0,ACCGTATTCTGGGCCTAATT,5,2917612
ompRp4,6.0,5,0,AAGTCTGCAAAAGGTGCTCT,5,2914451
ompRp4,5.0,4,0,TTAGCACTCTTACATAGGCT,4,2923702
ompRp4,5.0,4,0,TGAAACATACATACTTGGCA,4,2931728
ompRp4,5.0,4,0,TCCACTTGTCGTCAACGAGT,4,2926529
ompRp4,5.0,4,0,TCAAGACCGTGTTTGCCCTA,4,2919845
ompRp4,5.0,4,0,TACTCGCAGACATATATTTC,4,2933369
ompRp4,5.0,4,0,AGCCGCCTGACATTATCAGG,4,2929506
ompRp4,5.0,4,0,AAGGCGGTGTGGGCCAGTTA,4,2937694
ompRp4,4.0,3,0,TGGAGCGGAATAACGTTTGA,3,2909225
ompRp4,4.0,3,0,TGCATATCTGAAGGGGACCA,3,2923179
ompRp4,4.0,3,0,GTTTGAACCGATTACAAACT,3,2920801
ompRp4,4.0,3,0,GCGGTTGGTCGTGGGGCGTC,3,2917697
ompRp4,4.0,3,0,GCAACAAGCATCTCCTCCTC,3,2923387
ompRp4,4.0,3,0,GACAATCGGCGTAAGGTTTT,3,2914260
ompRp4,4.0,3,0,CTTATCTCTCGACGTTGGTT,3,2929617
ompRp4,4.0,3,0,CCAATAGCGAGCTCAACGTG,3,2908715
ompRp4,4.0,3,0,AGATTCTATCGGCAAACTCA,3,2928316
ompRp4,3.0,2,0,TTTACTTGTCAAAAAATATA,2,2910792
ompRp4,3.0,2,0,TTGATCAAGTATCATCGTGC,2,2937099
ompRp4,3.0,2,0,TGTTCGCCTCTCGGCATGAC,2,2917389
ompRp4,3.0,2,0,TGACGCCCCCGACTCAAAGA,2,2928957
ompRp4,3.0,2,0,TCTTGCCTTTTCGTTCGGTT,2,2931381
ompRp4,3.0,2,0,GTATAAAGTCCCTATACGGG,2,2923774
ompRp4,3.0,2,0,GGGGGCCTAGTGCTTGGCCA,2,2930278
ompRp4,3.0,2,0,GCGAATGGTGAAATGGCCTT,2,2918326
ompRp4,3.0,2,0,GCCCCGGAATCTTCCTTCTT,2,2917187
ompRp4,3.0,2,0,GCCCACAGTGCAGTGTCAGA,2,2929601
ompRp4,3.0,2,0,GCAGTTACACAAAGTAGAGC,2,2937710
ompRp4,3.0,2,0,GATCCGGGAATATTTACTAT,2,2914184
ompRp4,3.0,2,0,GACAGCCGGTCGCGCTGCGA,2,2928201
ompRp4,3.0,2,0,CTGACGGAGCGGGACTACGC,2,2932863
ompRp4,3.0,2,0,CTCAAGATACCATGATGGAT,2,2931180
ompRp4,3.0,2,0,CGTGGAGCTCCTCTGGCGAT,2,2915921
ompRp4,3.0,2,0,CGTAGTTTGAACACCGTTGG,2,2937025
ompRp4,3.0,2,0,CGGATCTCGCGGTGAGCCGT,2,2923817
ompRp4,3.0,2,0,CGCCGGTGATGGATCTCGCT,2,2927121
ompRp4,3.0,2,0,CCTTTACCTCTGCAGGTCAT,2,2933256
ompRp4,3.0,2,0,CCTCGGGTTATCGGGTAAAA,2,2930499
ompRp4,3.0,2,0,CACTTGTACATAACTTTACA,2,2921258
ompRp4,3.0,2,0,ATACCCCTCGTAACGACACA,2,2921297
ompRp4,3.0,2,0,AGTACTGCCTTTGGCCCTTA,2,2931948
ompRp4,3.0,2,0,AAGCGGACTGGGTCTCTCTT,2,2914717
ompRp4,2.0,1,0,TTTGTGGTCACTGCGAGCAA,1,2924761
ompRp4,2.0,1,0,TTTCCAAATACAGCCAGACA,1,2914086
ompRp4,2.0,1,0,TTGTCTGTCGTTCCTGCTTT,1,2934620
ompRp4,2.0,1,0,TTGTATGCACGAGTGCGTAG,1,2911150
ompRp4,2.0,1,0,TTGTAAAATCGTATTGACGT,1,2920071
ompRp4,2.0,1,0,TTGCTCGGGCTACTCTCAGA,1,2933240
ompRp4,2.0,1,0,TTGCGCTCGTCGGCAGTAGC,1,2935325
ompRp4,2.0,1,0,TTCCATCACCGAGAAGACGA,1,2908254
ompRp4,2.0,1,0,TTATGTGAAGCTACCAGAAT,1,2920728
ompRp4,2.0,1,0,TTAGTCCTTGCAGGGCATCA,1,2925472
ompRp4,2.0,1,0,TTAGTCAAATTGTGCAGGAA,1,2928249
ompRp4,2.0,1,0,TTAGTAAAGTATCGTACGGT,1,2909211
ompRp4,2.0,1,0,TTAGGCATGAGACACCGTAT,1,2916719
ompRp4,2.0,1,0,TTAGACTGGACAGGAACACA,1,2931949
ompRp4,2.0,1,0,TTACATCTGGGCTGAGTGTC,1,2937649
ompRp4,2.0,1,0,TGTTGTTGAGTAGTGGCCGG,1,2909276
ompRp4,2.0,1,0,TGTCTGACATCCTAGGCTCA,1,2909053
ompRp4,2.0,1,0,TGTACCCGACTCGATGACCC,1,2938291
ompRp4,2.0,1,0,TGTAACGTGGGATGACCAAT,1,2925927
ompRp4,2.0,1,0,TGGGTAACAGACGTCTAGGC,1,2923541
ompRp4,2.0,1,0,TGGGCGGCGGAAGATACACA,1,2911972
ompRp4,2.0,1,0,TGGCGGACTCATCCTGTAGG,1,2922484
ompRp4,2.0,1,0,TGGCCTCTATCTAACAGTGA,1,2932144
ompRp4,2.0,1,0,TGGATCCAGCAGCGGGCCTT,1,2918502
ompRp4,2.0,1,0,TGGACTCGTTAGTGTGAATA,1,2930779
ompRp4,2.0,1,0,TGCGGCGGGCCACGGCGTTA,1,2935322
ompRp4,2.0,1,0,TGCGACAGCTTGAATGGTGG,1,2927854
ompRp4,2.0,1,0,TGCCTGGATTATGGCGCCAT,1,2935772
ompRp4,2.0,1,0,TGCCACAATGGTTACGCACC,1,2930572
ompRp4,2.0,1,0,TGATCACAAGCGCCTACGTT,1,2928097
ompRp4,2.0,1,0,TGACCCACCCGAAGTTTCTG,1,2922020
ompRp4,2.0,1,0,TGACCAGCGTACACCCCACC,1,2923098
ompRp4,2.0,1,0,TGACAGAATTGTGAAATGGT,1,2925834
ompRp4,2.0,1,0,TCTTTGAGACCTTTGTACTT,1,2909264
ompRp4,2.0,1,0,TCTGTGACCAGCCTAGTATG,1,2933012
ompRp4,2.0,1,0,TCTGGAACATAGATGTCGTC,1,2912805
ompRp4,2.0,1,0,TCTCCCTCATACAGGGCCAC,1,2928034
ompRp4,2.0,1,0,TCTAACTTCATTCCGTCTAC,1,2934583
ompRp4,2.0,1,0,TCTAACCTTGGCCCTAATGA,1,2921083
ompRp4,2.0,1,0,TCGCCGCCCTCGGGCCTGAT,1,2935182
ompRp4,2.0,1,0,TCGCAGCAAGCTACCAGACC,1,2938224
ompRp4,2.0,1,0,TCCTCGATTTTGCTTTAATG,1,2936835
ompRp4,2.0,1,0,TCCGCGCCAGTGCCTCACCC,1,2912906
ompRp4,2.0,1,0,TCCAGTCTAATCACTGCTCG,1,2923144
ompRp4,2.0,1,0,TCCAATGGTCAGTGCTTTGT,1,2922754
ompRp4,2.0,1,0,TCCAAGTTAGGAGTATTGCT,1,2913980
ompRp4,2.0,1,0,TCAGTTACATAAGAAGTGGG,1,2915514
ompRp4,2.0,1,0,TCAGGACACTGGATCCCGCT,1,2916275
ompRp4,2.0,1,0,TCACTAGACGGTGGAAGTTA,1,2920566
ompRp4,2.0,1,0,TATTCTGGCGGCATACCTTC,1,2913075
ompRp4,2.0,1,0,TATCCGTTACGGGCCATCCT,1,2932330
ompRp4,2.0,1,0,TATATCCCAGGTCAGCAAGC,1,2928171
ompRp4,2.0,1,0,TATACTGCATCCCTCTGCTA,1,2935560
ompRp4,2.0,1,0,TAGTTCTTTCAAAGCGGGGC,1,2931650
ompRp4,2.0,1,0,TAGGTGACTGCGTGGTCCGG,1,2914581
ompRp4,2.0,1,0,TAGGTCTGGGTAAGCAGTTA,1,2916224
ompRp4,2.0,1,0,TAGGCCTGTTAGTTCGATCT,1,2933104
ompRp4,2.0,1,0,TAGCTGGGTCGCCGTTCATA,1,2935780
ompRp4,2.0,1,0,TAGCGGACCGGGTCCGGGTC,1,2907720
ompRp4,2.0,1,0,TACTGCGGTGATGGGCGGTC,1,2917510
ompRp4,2.0,1,0,TACTCACGTGCATAAGATCG,1,2913474
ompRp4,2.0,1,0,TACGGCACGGTTAATTGCAT,1,2928281
ompRp4,2.0,1,0,TACCTGCATTTCGGACTTGA,1,2914243
ompRp4,2.0,1,0,TACCGACAGTAGGTGGTTCG,1,2927539
ompRp4,2.0,1,0,TACATTGCGCATGTTATCAT,1,2933214
ompRp4,2.0,1,0,TACAATCCCTGAAGCCTGGT,1,2922391
ompRp4,2.0,1,0,TAATGCCTGCCGTCATCAGC,1,2929965
ompRp4,2.0,1,0,TAAGTCTACATTATAGCTTC,1,2924467
ompRp4,2.0,1,0,TAACGCCCTGGAAACGCATG,1,2919955
ompRp4,2.0,1,0,GTTTTAAGTTTAGGAAGCAA,1,2930900
ompRp4,2.0,1,0,GTTATCTTATAGGGCGGCGC,1,2922305
ompRp4,2.0,1,0,GTTATACGAATTCTTCGTGC,1,2914872
ompRp4,2.0,1,0,GTGTCCTCCATATGAACGAC,1,2935081
ompRp4,2.0,1,0,GTGTCACTAATCCGCTGACA,1,2929972
ompRp4,2.0,1,0,GTGTACGAGATTCGGTTCAG,1,2918593
ompRp4,2.0,1,0,GTGGTTGTATTCGTACAGGG,1,2920839
ompRp4,2.0,1,0,GTGGCATCTGCACAGTTGCC,1,2908360
ompRp4,2.0,1,0,GTGCCGGTCCCTAGCGCTCA,1,2916709
ompRp4,2.0,1,0,GTGCCGCTTGTCCCACTAAT,1,2917730
ompRp4,2.0,1,0,GTGATCATTCTAACGGGAAT,1,2909647
ompRp4,2.0,1,0,GTCGGATGGGGTTGACGCAT,1,2907856
ompRp4,2.0,1,0,GTCGAAATCGTCAGCGAGGG,1,2937149
ompRp4,2.0,1,0,GTATTTTGTGTAACCGACGG,1,2922929
ompRp4,2.0,1,0,GTATGAATTGCTGTGATTGC,1,2935018
ompRp4,2.0,1,0,GTAGCATTGAACACACTAAT,1,2911344
ompRp4,2.0,1,0,GTACACTAATGAGAAGAGTG,1,2915868
ompRp4,2.0,1,0,GTAAGTAGATCAATAGAAAA,1,2929789
ompRp4,2.0,1,0,GTAAATGTTCATTAATTATA,1,2936350
ompRp4,2.0,1,0,GGTTGAAAATCAAATTGTAC,1,2911247
ompRp4,2.0,1,0,GGTTAAAGACGCCATAGATG,1,2924675
ompRp4,2.0,1,0,GGTCTCATTATTTCTAATAT,1,2908954
ompRp4,2.0,1,0,GGTCCTGGCCCTCTACTGCG,1,2915609
ompRp4,2.0,1,0,GGGTGTAGGGGTGAAAGCTG,1,2911720
ompRp4,2.0,1,0,GGGTGGCAGCATACATAGGA,1,2907830
ompRp4,2.0,1,0,GGGTCGGACAGGCTCATAGG,1,2907832
ompRp4,2.0,1,0,GGGTCAACTTACCTCTCATA,1,2929205
ompRp4,2.0,1,0,GGGGACTAAAACGCGTCGAA,1,2917430
ompRp4,2.0,1,0,GGGCTCCTGCTCCTCCCTCT,1,2912295
ompRp4,2.0,1,0,GGCCACAGCGGCTACACTTC,1,2937696
ompRp4,2.0,1,0,GGCATGATGCGCCGCGCGTC,1,2935834
ompRp4,2.0,1,0,GGAGGTATCTTAGCTCTGAC,1,2910571
ompRp4,2.0,1,0,GGAGATCAGTGGACACGTCT,1,2937797
ompRp4,2.0,1,0,GGACACGAGAACAGACCAGC,1,2929788
ompRp4,2.0,1,0,GGACACACTGGTGAGAAGTA,1,2935448
ompRp4,2.0,1,0,GGAAGGACGCACGGTCGGCG,1,2926709
ompRp4,2.0,1,0,GCTTAAAGGTAGTATATGGA,1,2922301
ompRp4,2.0,1,0,GCTGGCCCTCAAGGCGCCTA,1,2909047
ompRp4,2.0,1,0,GCGTGCCCAGAGGTGGACTC,1,2909991
ompRp4,2.0,1,0,GCGTCGCAATTTACAAAGTC,1,2910531
ompRp4,2.0,1,0,GCGGCGAAATGGCATGTTTT,1,2910779
ompRp4,2.0,1,0,GCGCCTGCTACTGACATGCC,1,2914217
ompRp4,2.0,1,0,GCGATGTGGTCCAGACGCGT,1,2922891
ompRp4,2.0,1,0,GCCTTTCAGGCCTCTAGGTC,1,2914831
ompRp4,2.0,1,0,GCCTCACGTTAATTGTCAGT,1,2924302
ompRp4,2.0,1,0,GCCGTGTCCCACTTGCTGAA,1,2909393
ompRp4,2.0,1,0,GCCGAATTACATTGCAAGTG,1,2913502
ompRp4,2.0,1,0,GCCCACCTGTTTGGAACACT,1,2930795
ompRp4,2.0,1,0,GCCACCCTTGCGAAACTTAT,1,2915970
ompRp4,2.0,1,0,GCAGACCGCCATTTCAACTT,1,2925097
ompRp4,2.0,1,0,GATTATACACCGACTGTCTC,1,2909707
ompRp4,2.0,1,0,GATGGCTGACGGAACGTCGT,1,2914837
ompRp4,2.0,1,0,GATAGCAGGGAATAAGCTAT,1,2919428
ompRp4,2.0,1,0,GAGGGACCGGAAGGGGGGGA,1,2937486
ompRp4,2.0,1,0,GAGGCCGAACACTTAGACGA,1,2929059
ompRp4,2.0,1,0,GAGCGCCTGCGAATGAGCTA,1,2937081
ompRp4,2.0,1,0,GACTTGCAACATGGAAGAGG,1,2909129
ompRp4,2.0,1,0,GACTAAAGCTGGGACAAGTA,1,2922488
ompRp4,2.0,1,0,GACAACGTCGGCTTCCCCTT,1,2908589
ompRp4,2.0,1,0,GAAGTATGCAAAAACTGGAC,1,2918114
ompRp4,2.0,1,0,GAAGACAGCGCGTAAAGAGT,1,2926786
ompRp4,2.0,1,0,GAACATGCTTGAACCCGTTT,1,2920668
ompRp4,2.0,1,0,GAAACGGTTCCGTTGTACGA,1,2912491
ompRp4,2.0,1,0,GAAAATCCGTGATTACATTG,1,2928380
ompRp4,2.0,1,0,CTTTGTGTCTAGCAGGGGCG,1,2919059
ompRp4,2.0,1,0,CTTGTCGGGGCTGGGTTTAT,1,2907811
ompRp4,2.0,1,0,CTTGGTTAAGCGCAGTGTGG,1,2909136
ompRp4,2.0,1,0,CTTGGGAACTCTGTTCATGC,1,2911250
ompRp4,2.0,1,0,CTTGACAGTAAAATAACTGA,1,2916175
ompRp4,2.0,1,0,CTTCGCGAATACAAACATTG,1,2937401
ompRp4,2.0,1,0,CTTCCAGAGCTGTAAGATCA,1,2916364
ompRp4,2.0,1,0,CTTATAGCTGGTCGTTGTAG,1,2909259
ompRp4,2.0,1,0,CTTAGTCCTTTAGCAATTAC,1,2912955
ompRp4,2.0,1,0,CTTAACTCGACACCTGGGTA,1,2938296
ompRp4,2.0,1,0,CTGGAGTCGAGTCCAGCGGT,1,2915922
ompRp4,2.0,1,0,CTGCTCTTTCATTAGAGACG,1,2932811
ompRp4,2.0,1,0,CTCTGGCGCTAAACGACGCT,1,2922232
ompRp4,2.0,1,0,CTCGTCCTACTACTTCCAGA,1,2929692
ompRp4,2.0,1,0,CTCGGGGTTCGCCGGGGCAG,1,2912375
ompRp4,2.0,1,0,CTCCTAGAAAAGGCACCCAT,1,2908121
ompRp4,2.0,1,0,CTCCGGTTCAGTGAAACGAA,1,2908537
ompRp4,2.0,1,0,CTATTGTGAAAGCGGCCGGG,1,2926681
ompRp4,2.0,1,0,CTAGGTCACGTTAAGCCGGC,1,2912808
ompRp4,2.0,1,0,CTAACTGCAGCCCGTGGGTT,1,2930634
ompRp4,2.0,1,0,CTAACTCGTCTGTTCTTGGG,1,2920933
ompRp4,2.0,1,0,CGTATCTACCCGACACAACC,1,2910660
ompRp4,2.0,1,0,CGGCAAGGCTTGACATGGTT,1,2933234
ompRp4,2.0,1,0,CGCGTGAGTTCCGCTCGATT,1,2919951
ompRp4,2.0,1,0,CGAGGTAGGATGCCATCTGG,1,2908109
ompRp4,2.0,1,0,CGACCTGACACTTCTACATA,1,2937006
ompRp4,2.0,1,0,CCTTGTACCCCCCACTAATG,1,2926098
ompRp4,2.0,1,0,CCTTCACGTGGCCAGAACCT,1,2923175
ompRp4,2.0,1,0,CCTGTTGAGGTTCTCTCAAT,1,2919572
ompRp4,2.0,1,0,CCGTACGAGACAGCTCAACG,1,2919086
ompRp4,2.0,1,0,CCGCTGGCTTCCACCGGAGC,1,2925536
ompRp4,2.0,1,0,CCGCTGACGTGGGTGGCAAG,1,2910716
ompRp4,2.0,1,0,CCGCGTCATTACAAATCAGG,1,2918050
ompRp4,2.0,1,0,CCGACACCCGGTTTCCGGGC,1,2933666
ompRp4,2.0,1,0,CCGAAGCGTCCAAGGTTACG,1,2908260
ompRp4,2.0,1,0,CCCTTTGAACGGTGCTTCCC,1,2912590
ompRp4,2.0,1,0,CCCATCTTAGCATGGCAGTG,1,2912005
ompRp4,2.0,1,0,CCCATACATTCTAATTGCGT,1,2917727
ompRp4,2.0,1,0,CCCAAGTGCGGAAGCTACTA,1,2917974
ompRp4,2.0,1,0,CCATGTGCCCCTCTGGTTGA,1,2927823
ompRp4,2.0,1,0,CCATGGTCCAGATCAATGAC,1,2923164
ompRp4,2.0,1,0,CCATGGTAGCTGTGCAGAGA,1,2920914
ompRp4,2.0,1,0,CCATCAGATGTTCAACTAAT,1,2922777
ompRp4,2.0,1,0,CCATACAGCCGAAAAAATCT,1,2922548
ompRp4,2.0,1,0,CCAGCATCTCTTCAACACAG,1,2915730
ompRp4,2.0,1,0,CATGTCGGTCCCCCGCTTGA,1,2926186
ompRp4,2.0,1,0,CATCCTCGAATCCGCCGAGA,1,2910301
ompRp4,2.0,1,0,CATAACTCCTCGTATAGCTC,1,2931188
ompRp4,2.0,1,0,CAGTCTGTACAACTGTCCGT,1,2927868
ompRp4,2.0,1,0,CAGTCTGTAAGGGCCCGGTT,1,2920231
ompRp4,2.0,1,0,CAGCCTGTACGAGCTCCCAC,1,2919361
ompRp4,2.0,1,0,CAGATCAATTGTATGGGCTA,1,2914444
ompRp4,2.0,1,0,CACGTTATAAACAAACGCAA,1,2934175
ompRp4,2.0,1,0,CAAGAGAAAATCAGCATGCG,1,2931910
ompRp4,2.0,1,0,CAAACCTACCTATGATAGGT,1,2929871
ompRp4,2.0,1,0,ATTTGGAATCCGAGTTAGTC,1,2930875
ompRp4,2.0,1,0,ATTTAGACATTTCAACACAT,1,2913594
ompRp4,2.0,1,0,ATTGCAGTATAGATGTTTTC,1,2936940
ompRp4,2.0,1,0,ATTCAGATTTACCCTAACCA,1,2908650
ompRp4,2.0,1,0,ATTCAACATCATACTTACGA,1,2932884
ompRp4,2.0,1,0,ATTAGAGAACGTCGCAGCGT,1,2928452
ompRp4,2.0,1,0,ATGGCGGACCGGCAATCCAC,1,2927812
ompRp4,2.0,1,0,ATCTTGGATGGGGTCCCTAC,1,2932986
ompRp4,2.0,1,0,ATCTGCTTTGACCGTCACGG,1,2919930
ompRp4,2.0,1,0,ATCTCCCGAGCCTAAGCCTA,1,2928130
ompRp4,2.0,1,0,ATCGAGGTAAATGTGTTTAT,1,2915762
ompRp4,2.0,1,0,ATCAGTTAGCCGGGCAAATG,1,2920195
ompRp4,2.0,1,0,ATATTTCCGACTGTTAAGAC,1,2911847
ompRp4,2.0,1,0,ATAGGTACAGCTCCTTTCCC,1,2910578
ompRp4,2.0,1,0,ATAGCGCCCTGATAGCGATT,1,2931740
ompRp4,2.0,1,0,ATACGGCCAAGTGCCCCGAG,1,2923113
ompRp4,2.0,1,0,ATACGGAAATATTTAACTAA,1,2928648
ompRp4,2.0,1,0,ATACATCTGCTCTAAAGTGC,1,2929747
ompRp4,2.0,1,0,AGTTCCGGTTTCTTCTGACG,1,2930493
ompRp4,2.0,1,0,AGTTCACAACCCTCAACTAT,1,2914926
ompRp4,2.0,1,0,AGTTACAAATCCAGAGAGTA,1,2911246
ompRp4,2.0,1,0,AGTGCGTCGGCCCTCGAATT,1,2914004
ompRp4,2.0,1,0,AGTCAATCGCAGGTGGCTTG,1,2923036
ompRp4,2.0,1,0,AGTCAAACCCTGTTCCTGAA,1,2911911
ompRp4,2.0,1,0,AGGGTGTCACGGCCTAATGT,1,2929482
ompRp4,2.0,1,0,AGGGTCATAGACAAGCAGCG,1,2937546
ompRp4,2.0,1,0,AGGGAACTCATGCCACCGCT,1,2912712
ompRp4,2.0,1,0,AGGCGTAGACACTCAACAGT,1,2927448
ompRp4,2.0,1,0,AGGCGCCGGAGCATGCTATA,1,2930596
ompRp4,2.0,1,0,AGGCACGAATGAGCCACACA,1,2933654
ompRp4,2.0,1,0,AGGACTTCTGGACATCCCAT,1,2937880
ompRp4,2.0,1,0,AGCTAAAGTTTATCCCTGGT,1,2926248
ompRp4,2.0,1,0,AGCGCACCTATAAGTAGCAA,1,2925021
ompRp4,2.0,1,0,AGCATCACACAGTGCCAAGC,1,2934665
ompRp4,2.0,1,0,AGATCTGCAAGTTAAATTTA,1,2911721
ompRp4,2.0,1,0,AGAGTTAAGGGAGACCGTTA,1,2936004
ompRp4,2.0,1,0,AGACAGTCGCGAATGCCACA,1,2925134
ompRp4,2.0,1,0,ACTCCTGACCAGGATCGGGC,1,2915325
ompRp4,2.0,1,0,ACTCCGGAACGTGTCTCGGT,1,2927506
ompRp4,2.0,1,0,ACTCCAACCGAGGGTCAGAG,1,2932075
ompRp4,2.0,1,0,ACGCTGCCTTGACCACCTGA,1,2926275
ompRp4,2.0,1,0,ACGCTGCATAAAGCTAATTG,1,2921725
ompRp4,2.0,1,0,ACGCTCATAGCCCAATGGGA,1,2914134
ompRp4,2.0,1,0,ACGCCGCAATTCAAGTATCG,1,2926950
ompRp4,2.0,1,0,ACATGTAGAGACTGGTTAGC,1,2921829
ompRp4,2.0,1,0,ACACCTCCGGCATAGGTCTT,1,2914996
ompRp4,2.0,1,0,ACACACGGGTAACTTTGACA,1,2930363
ompRp4,2.0,1,0,ACAAGTTACGAAACCTGCGG,1,2929006
ompRp4,2.0,1,0,AATTTGATGGTTCCGGACAC,1,2914271
ompRp4,2.0,1,0,AATGGAGGATTCTATCGTAA,1,2912983
ompRp4,2.0,1,0,AATCTCAACCTGCCTGGCCT,1,2918746
ompRp4,2.0,1,0,AATCGGCCCCCGACACAGAA,1,2914879
ompRp4,2.0,1,0,AATCAGTGTTATCTGCGAGC,1,2916758
ompRp4,2.0,1,0,AATAAGTAGTGGCTCTAAAT,1,2936304
ompRp4,2.0,1,0,AAGTTTTGAGGCACCTATGG,1,2924020
ompRp4,2.0,1,0,AAGCTCTAGTCTCAGCATGT,1,2930771
ompRp4,2.0,1,0,AAGAATCACGGGGCTGGTCG,1,2912546
ompRp4,2.0,1,0,AACTGGGACCGGGGCGTAGC,1,2930675
ompRp4,2.0,1,0,AACGCTAGGGTGTCACCCCT,1,2918256
ompRp4,2.0,1,0,AACCTTCTTTGCCCTATTAA,1,2919166
ompRp4,2.0,1,0,AACCCGTAACGCACACCTGG,1,2933959
ompRp4,2.0,1,0,AAAGGTCAGCAGAGTGCAAC,1,2932327
ompRp4,2.0,1,0,AAAGGGAGAAGATCATATCT,1,2930885
ompRp4,2.0,1,0,AAACCTGCGGCAGAACCCGT,1,2916154
ompRp4,2.0,1,0,AAAATTGCCATTCGCTATAG,1,2913120
ompRp4,2.0,1,0,AAAAGTGACCGGAGAGGATC,1,2911615
